"chr1","93323080","93323285","chr1","92548372","92548561","28","774708","AGGCTGGACAACAAAGCAAGACCCCATCTCTACAAAAAAAAATGAAAAAATTAGCTGAGCATGGTGGCACACACCTGTGATCCCAAGAACTTGGGAGGCTGAGGTAGGAGGATCACTTGAGCCGGGAGGTCAAGGCTGCAGTGAGCCATGATCATACCACCGCACTCCAACCTGGGCAACAGAGTGAGACCCTGTCTTGAAAGAAA","AGCCTGGACAACAAAGCAAGATCCCATCTCTACAAAAAAATGAAAAAATTAGCTGAGCATGGTAGCACACACCTGTGATCTCAGGAACTTGGGAGGCTGAGGTAGGAGGATCACTTGAGCCAGGAAGTCAAGGCTGCAGTGAGCACACCACTGCACTCCAATCTGGGCAACAGAATGAGACTCTGTCTCA"
"chr1","11665170","11665481","chr1","10945986","10946293","24","719184","GGCTGGGCATGGTGGCTCAAGCCTGTAATCCCAGCATTTTGGGAGGGTGAGAGGCAGGAGGATCACTTGAGCCCAGGAGTTTGAGACCAGCCTAGGCAACATGGGGAGACCCTGCCTCTGCAAAAAATTTGAAAAATCAGCCAGGTGTGGTGGTGCACACCTGTAATCCTAGCTACTCAGGAGGCTGAGGTAGGAGGATCCCTTGAGCCCAGGAGTTTCAGGCTGCAGTGAGCTATGATTGCCCCACTGCACTCTAGCCTGGGTGACAAGGAGAGAACCTGTCTCTGGGGAAAAAAAAAGAGAGAGAGAGAA","GGCTGGGCATGGTGGCTCAAGCCTGTAATCTCAGCATTTTGGGAGGCTGAGGCAGGAGGATCACTTGAGCCCCAGAGTTCGAGACCAGCCTAGGCAACATGGTGAGATCCTGCCTCTGCAAAAAATTTTAAAAATCAGCCAGGTGTGGTGGTGCACACCTGTAATCCTAGCTACCCAGGAGGCTGAGGTAGGAGGATCTCTTGAGCCCAGGAGTTTCAGGCTGCAGTGAGCTATGATTGCCCCACTGCACTTTAGCCTGGGTGACAAGGAGAGACCCTGTCTCTGGAAAAGAAAGAAAAAAAAAAAGA"
"chr1","11927552","11927782","chr19","37244182","37244407","53","25316630","CCAGGCTGAGTGACGGAGTGAGACTCAGTCTCTAAATAAATAAATAAATAAATATTTAAAAATTAACTGAATGTGATGGCACATGCCTGTAGTCCCAGCTTCTTGGGGGGCTGAGGCAGGAGGATCACTTGAACCCAGGGGTTTGAGGCTACAGTAAGCTATGATCCTGCCACTGCACTCCAGCCTGGATGACAAGAGTGACACCAAGTCTCAAAAAGAAAAAAAAATAAA","CCAGCCTGGCAACAGAGCAAGACTCCGTCCCAAAAAAAAATAAAAAATACAAAAAATTAGCCAGGCATTGTGGCACACGCCTGTGGTCCCAGCTCCTTGGGAGGCTGAGGTGGGAGGATCACTTGAGCCTGGAAGGTTGAGGCTGCAGTGAGCCAAGATCATGCCACTGCACTCCAATCTGGGTGACAGAGGGAGATCCTGTCTCAAAAAAATAAAAAAAAAAAAA"
"chr1","40501004","40501307","chr1","39161865","39162153","36","1339139","GGCCAGAAGTGCTGGCTCACTTCTGTAATCCCAGCAGTTTAGGAGGCCCAGGCAGGAGGATCACTTGAGCCCAGGAGTCGGTCACCAGCCTGGGCAACATAGCAAGACCTCATCTCTCAAAAAGAAAAAAAAATAGTAGGCGTGGTGGTATGGGTCTGCAGTCCCAGCTGGGGTGGGGTGATCGGGTGCTGAGTGGGAGGATTGTTTGAGCTCAGGAGGCCAAGGCTGCAGTGAGCTGTGATTGATTGCACCACTGCGCTGCAGCCTGGGCAACAGAGCAAGATCCTGTCTCAAAAAAAAAAAA","GACCAGAAGTGCTGGTTCACTCCTATAATCCCAGCAGTTTAGGAGGCCCAGGCAGGAGGATCACTTGAGGGAGGCGGTCACCAGCCTGGGCAACTTGCAAGACCTCATCTGTCAAAAAGAAAAAAAAAAATAGTGGGCGTGCAGTACCAACTGGGGTGGGGTGATGGGGTGCTGAGGTGGGAGGATTGTTTGAGCTCAGGAGGTCAAGACTGCAGTGAGCTGTAATTGATTGCACCACTGCACTGAAGCCTGGGCAACAGAGCAAGATCCTGTCTCAAAAAAAAAAAGA"
"chr1","94896107","94896264","chr3","42449035","42449193","49","52447072","TATTAATAATAAATAAACAAATAAAATTAGCCAGGTGAAAGGCGGAGGTGGGAGGATCCCTTGAGTCCAGGAATTCAAGTTACAGTGAGCTGTGACTGTGTCACTGCACTCCAGCCTGGGTGACAGTGAGATCCTGTCCACAGGAAAGGAAGGAAAAA","TTAGAAGATTAACCACACACCTGGGGTCTTAGCTACTTGCAGGCTGAGGTGGGAGGATTGCTTGAGCCCAGGAGGTTGAGGCTATAGTGAGCTATGATTGTACCCCTGCACTCCAGCCTGGGTGACAGAGCGAGACCCTATCTCTACAAAAGAAACAAA"
"chr1","110362457","110362738","chr1","109776679","109776938","40","585778","ACACCTGTAATTCCAGTGCTTTGGGTGACCAAGGTGGGAAGATCACTTGAGGTCAGGAGTTCGAGACTAGCCTGGGCAACATAACAAGACTCTGTCTCTACAAATTTTTTTTTAAATGTGCACCTATAGTCCTAGCTACTCAGGAGGCTGAGGCGGGAGGATGACTTGAGCCCAGGAGTTCAAGGCTGCAGTGAGATATGATCACCACTGCACTCCATCCTGGGTGACAGAGGGAGACCCTATCTCTAAAAATAAAAATGAATTAACAGCAAAAAAAAAAAA","ACACCTGTAATCCCAGTGCTTTTGGTGACCAAGGTGAGAAGGTCACTTGAGGTCGGGAGTTCAAGACTAGCCTGGGCAACATAGCAAGACTCTGTCTCTACAATTTTTTTTTTTTTAATGGGCACCTATAGTCCTAGCTACTCAGGAGGCTGAGGTGGGAGGATGACTTGAGCCCAGGAGTTCCAGGCTGCAGTGAGCTATGATCACCACTGCACTCCATCCTGGGTGACAGAGGGAGACCCTGTCTCTAAAAATAAAAA"
"chr1","123600874","123601156","chr1","115057188","115057483","34","8543686","GGCTGGGTGTGGTGTCTGTTGCATGTAATCCCAGCACTTTGGGAGGCTGAGGTAGAAGCATTGTTTGAGCTCAGGAGTTCAAAGCCAGCCTGGGCAACATAGTGAGACTCCATCTCTAGTTAAAAAAAATAACCAGGCATGGTGATATGCACCTGTAGTCCCAGCTACTCAGGAGGCTGATGTGGGAGGATTGCTTGAGCTTAAGAGATTGACACTGCAGTGAGCTATGATCATACCACAGCACTCCAACCTAAGTGAGACCAAGATCGAAAAAAAAAAAAAA","GCTGGGTGTGGTGTCTCTTGCATGTAATCCCAGCACTTTGGGAGGCTAAGGTAGAAGCATTGTTTGAGCTCAGGAGTTCAAAGCCAGCCTGGGCAACATAGTGAGACTCCATCTCTAGTTAAAAAAGAATAGCTAGGCATGGTGACATGCACCTGTAGTCCCAGCTACTCAGGAGGCTGATGTGGGAGAATTGCTTGAGCTTAAGAGATTGACACTGCAGTGAGCTATGATCATACCACTGCAGTGAGCTATGATAGTACCAGCCTCAAAAAAAAAAAAAAAAAAAAGAAAGAAAA"
"chr1","129761208","129761511","chr11","108122224","108122524","57","21638984","GGCTGGGTGTATGGTTCATGCCTGTAATCCCAGCACTTTGGGAGGCCAAGGGGGAAGGATCCTTTAAGGCCAGGAATTTGAGACCAGCCTAGGCAACATAGGGAGACCCTGTCTCTACAAAAAAAAAAAAAAAAATTAAAATAAGCTGGTTGTGGTGGTGCAGGCTTGCAGTCCTAGCTACTCGGGCAGCTGAGATGGGAGGATAGTTTGAGCCCAAGAGTTTGAGGCTGTAGTGAGCTATGATCATACCACTGCACTCCAGCCTGGGCAACAGAGCAAGACCCTGTCTAAAAAAAAAAAAAAA","GGCTGGGTGAGATGGCTCACACCTATAATCCCAGCACTTTGGGAGGCCAAGGCTGGAAGATGGCTTGAGGCCAGGAGTTAAAGACCAGTCTGGGCAACATAGCAAGACCCTGTGTCTACAAAAAAAATAAAATAAAATAGCTGGGCATGGTGGTGCATGCCTGTAGTCCTTGTTACTCAGGAGGCTGAGGTGGGAGGATTGTTTGAACCCAGGAGGTCGAGGCTGCTGTGAGCTATGATGATGCCACGGCACTTCAGCCTGGGTGACAGAGCAAGACCCTGCCTCTAAAAAACAAAAAGAA"
"chr1","129892308","129892606","chr1","125357713","125358008","18","4534595","GGCTGGGTATGGTGGCTCATACCTGTAATCCCAGCATTTTGGGAGGCTGAGGCAGCAGGATTGCTTGAGGCTAGGAGTTTGAGACCAGCCGGGGCAACATAGTGAGACCCGTCTCTCTAAAAAAGTTTAAAAATTAGCCAGGCAAGATGGTGCATGTCTGTACTCCCAGCTACTCAAGAGGCTGAAGTGGGATGATCACTTGAAGCCCGGAGGTCAAGGCCATAGTGAACCATGATAGCATCACTGTCTTCCAGCCTGGGTGACAGAGTGACAGCCTGTCCAAACAACAACAAAAAAAA","GACTGGGTATGGTGGCTCATACCTGTAATCCCAGCATTTTGGGAGGCTGAGGCAGCAGGATTGCTTGAGGCTAGGAGTTTGAGACCAGCCGGGGCAACATAGTGAGACCCCTCTGTCTAAAAAAATTGAAAAATTAGCCAGGCAAGATGGTGCATGTCTGTACTTCCAGTTTCTCAGGAGGCTGAAGTGGGATGATCACTTGAATCCCAGAGGTCAAGGCTATAGTAAACCATGATAGCATCACTGTCTTCCAGCCTGGGTGACAGAGTGACACCCGGTCCAAACAACAAAAAAAA"
"chr1","182058817","182059111","chr5","86925549","86925828","65","95133268","ACTTTGGGAAGCCAAGGCAGAAGGATCACTTGGGCCCAGGAGTTCAAAACCAGCCTGAGCAACAGAGCAAGACACTAGTCTACTCCAACAAAAAAAAAAAAAAAAAAAAAAATTAAATTAGCCAGGTGTGGTAGCATGTACCTGTGGTCCCAGTTACTCTGGAGGCTGAGGTGGGAGGATCGCTTCAGCCCAGGAGTTTGAGGCTGCTGTGAGCCATAATAGTGCCATCACACTCCAGACCTGGGCAACAGAGAGAGACCCTATCTCTAAAAGAAAAGATAAAAAGAAAAGAAAA","GCACTTTGGGAGGCCAAGGTGGGAGGATCGCTTGAGCCCAGGAGTTCGAGACCAGCCTGGGCAACATAGGGAGACCCTGTCTCTATAAAAATTAAAAATAAATAAAAAAAAATTAGCTGGGCATGGTGGTGTGTGCCTGTGGTCCCAGCTACTCAGGAGGCTGAGGTGGGAGGATCCAGCCCAGGAGGTCAAGGATGCGGTGAGCCATGATCATGCCACTGCACTCCAGCCTGGGCAACCCAGCAAGACCTTGTCTCAAAAAAAAAAAAAAAAAAAAAAA"
"chr1","224526078","224526368","chr1","219977188","219977496","31","4548890","GGCCAGGCATGGTGGCTCATGCCTGTAATCCCAGCACTTTGGGAGGCTGAGGTGGGAGGATCACTTGAGGCTAGGAGTTTGAGACCAGCATGGGCAACACAGTGAGACCCCATCTCTACAAGAAAAAGAAAAATCAGCTGGGCGTGGTGGCGCACTCCTAAGAAGGCTGCTAAGGCAGGCAGGAGAATCGCTTGAGCACAGGAGGTTGAGGCGCAGTGAGCTGTGATTACACCACTGTACTCCAGCCTGGATGATAGAGTGAGACCCAATCTCTTAAAAAAAAAAAAGAAA","GGCCAGGCATGGTGGCTCATGCCTGTAATCCCAGCACTTTGGAAGGCCGAGGTGGGAGGATCACTTGAGGCCAGGAGTTTGAGACCAGCATGGGCAACACAGTGAGACCCCATCTCTACAAGAAAAATAAAAAAATCAGTTGGGCGTGGTGGCACACTCCTGAGGAGGCTGCTAAGGCAGGCAGGAGAATCGCTTGAGCCCAGGAGGTTGAGGTTGAGGCTGCAGTGAGCTATGATTACACCACTGTACTCCAGCCTGGATGACAGAGTGAGACCCAATCGCTTAAAAAAAAAAAAAAAAAAAAAAGAA"
"chr1","792773","793045","chr3","13105019","13105290","58","12312246","GGCTGGGCATGGTGGCTCACACCTGTAATCCCAACACTTTAGAAGGCCAAGGCAGGAGTATCATGAGACCAGCCTGAGCAAAATAGTGAGATGCTGACTCTACAAAAAAAATAAAAATTAGATGAGCATGGTGGTGCATGCCTGTAATTACAGCTACTTGGGAGGCTGAGGTGGGAGGATCCCTTGAGGGCAGGAGGTCAAGGTTGCAGTGAGCTGTGATCATACCACTGTACTTCAGCCTGGGTGACAGACAGAGACACTGTCTCAAAAAAA","GGCTGGGCACAATAGCCCATGCCTGTAATCTCAGCACTTTGGGAGGCTGAGGTGGGAGGATTGCTTGAGACCAGCCTGAGCAATGTAGTGAGACCCCGTCTCTACAAAAAAAAAAAAATAGCTGAGCATGGTGGTGGGTGCCTATAGTCCCAGCGACTTGGGAGGCTGAGATGGGAGGATTGTTTAAGCCCAGGAGGTCAGGGCTGCAGTGAGCTGTGATTGCGCCACTGTACTCTAGCCTCGGTGACAGAGTGAGACTGTATCTTAAAAAA"
"chr1","894390","894513","chr13","46512186","46512305","24","45617796","GGAGGCTCACGCCTGCAGTCCCAGCACGTTGGGAGGCTGAGGCAGGAGCATCGTCTCAGGTCAGCAGTTCGAGACCAGCCTGGGCAACATAGGGAGATCCCCGTCTCTACAAAAAAAAATAAAA","GGTGGCTCATGCCTATAATCCCAGCACTTTGGGAGGCTGAAGCAGGAGGATTACTTGAGGCCAGGAGTTCAAGACCAGCCTGGGCAACATAGCAAGATCCCATGTCTACAAAAAAAAAAA"
"chr1","969318","969602","chr1","157235","157525","20","812083","GGGCGCGGTGGCTCACACCTGTCATCCCAGCACTTTGGGAGGCTGAGGCTGGAGGATCGCTTGAGGCCAAGAGTGGGAGATCAGCTTAGGCAACATAGTGAGACCCCATCTCTGCAAAAAAATTTCTTTAATTAGCCAGGCGTGGTGGTACACACCTGTAGCTCCAGCTGCTCGGGAGGCTGAGGCAGGAGGATCACTTGAATCCAGGAGGTTGAGGCAGCAGCAAGCTGTGATTGCACCACTGCACTCCAGCCTGGGTGACAGAGCAAGAACCTGTCTAAAAAA","GGGCGCCGTGGCTCACACCTGTAATCCTAGCACTTTGGGAGGCTGAGGCTGGAGGATCGCTTGAGGCCAGGAGTTTGAGACCAGCTTGGGCAACATAGTGAGACCACATCTCTGCAAAAAATTTTCTTTAATTAGCCAGGCGTGGTGGTACACACCTATAGCTCCAGCTACTCGGGAGGCTGAGGCAGGAGGATCACTTGAATCCAGGAGGTTGAGGCAGCAGTGAGCTGTGATTGCACCACTGCACTCCAGCCTGGGTGACAGAGCAAGAACCTGTCTAAAAAACAAAGA"
"chr1","1008455","1008696","chr2","61275500","61275760","71","60267045","AGGACTCTGGAAGGTGGGGGTGGTCGGAATGCTTGAGCTCAGGAGTTGGAGACCCACCCGGGCAACACAGCCCGTCTTTACAAAACGTTTAAAATTAGTCGGGCCTGGTGGCGGGAGCCTGAGGTCCCAGCTACTCAGGAGGCTGAGGTGGGATGATCACCTGAGCCCAGAAGGTGGAGGCTGCAGTGAACCGAGACTGCACTCCAGCCTGTGCAAGGGGAACTCCGTCTCAAAAACAAAAA","CAGCACTTTGGGAGGCTGAGGCAGGTGGATTGCTTGAGTCCAGGAATTTGAGAACAGCCTGGGCAACATGGCAAGACTCCGTCTCTATAAAAAATACAAAAATTAGTTTGGTGCGGTGATGCACACCTAGAGTCCCAGCTAGTCAAGAGGCTGAGGTGGGAGGATCACTTGAGCCCAGGAAGTGGAGGTTGCAGTGAGCCAAGATTGTGCCACTGCACTCCAGCCTGGGCAACAGAGCAAGACCCTGTCTCAAAAATAAAA"
"chr1","1011897","1012160","chr4","108000144","108000414","55","106988247","CGGGTGCTGTGGCTCCCACGTGTAATCCCAGCACTTTGGGAGGCTGAGGCAGGAGGATCACCTGAGGCCAGGAGTTCGAGACCAGCCTGGACAATATAGTGAGACCCTGTGTACAAAAAAAATTATACCTGTAGCCCCAGCTACTTGGGAGGCTGAGGTGGGAGGATCCCTTGATCCCAGGAGCTCAAGGCGGCAGTGAGCCATGATCGCACCACTACACTCCAGCCTGGCAACAGAGTGAGACCCTGTCTCTCTTTAAAAAAA","GGGTGCGGTGTCTCACACCTGTAATCCCAGCACTTTCAGAGGCTGAGGTAGGAGGATCACTTGAGTCCAGGAGTTGGAGACCAGCCTGGGCAATAAAGTGAGATCTCATCTCTACAAAAGATAAAAAGTTAGGCACCTGTGGTCGCAGCTACTTGGGAGGCTGAGGTGGGAGGATTGTTTGAGTACAGGAGGTTGAGGATGCAGTGAGCCCTGTTCACACCACTGCACTCCAGCCTGGGTGACAGAATGAGATCCTGTCTCAAAAATAAAA"
"chr1","1012432","1012724","chr7","96863166","96863444","60","95850734","GGTGGCTCACACCTGTAATCCCAGCACTTTGGGAGACCGAGGCAGGAGGATTGTTTGAGCCCAGGAGTTCAAGACCAGCAACATCATGCTTCAGTTTTGTTTCATAGCGAGACCCTGTCTCTACAAAAAATCAAAAAATTAGCCAGGTGTGGCAGCACTTGCTTGTGTTCCAGCTACTTGGGAGGCTGAGGTGGGAGGATGGCCTGGGCCTGGGAGACTGAGGCCGCGGTGAGCTGAGGTCACACCACTTTGCTCCAGCCTGGGTGACAGAGTGAGACCATGTCTCAAAATAA","GGGGGCTCACGCCTGTAATCCCAGCACTTTGGGAGGCTGAGGCAGGAGGATCACTTGAGTCCAAGAGTTCAAGACCAGCCTGGGCCACACAGTGAGACCCTGTCTCTACAAAAAAATTAAAAATTAGCCAAGTGTGGCAGCATGCACTTGTGGTCCCAGCTACTTGGGAGGCTGAGGTGAGAGGATTGCCTGAGCCCAGGAATCTGAGGCTGCAGTGAATTATGTTCATGCCATTGCACTCCAGCCTGGGTGACAGAGTGAGACCCTGTCTCAAAAAAA"
"chr1","1021637","1021889","chr10","12192602","12192874","77","11170965","GGCAGGGCAGCTCACTCCTGTAATCCCAGGATTTTGGGAGGCTGAGACAGAGAATTGCTTGAGGCCAGGCATTCGAGACCAGCCTGGGCAACACAGTCTCTACAAAAGAAAAGGACATTACCTGGGTGTAATGGTGTGCACCTGAGGTCCCAACTATTCAGGAGGCCGGGGTGAGAGGATCGCTGCCACTGCATTCCTGCCTGGGCGACAGAGGGAGAATGTGTCTCCAGAAAACAAACAAACAAAAAAGAAA","GGCCAGGTGCAGTGGCTCACACCTATAATCCTAGCATTTTGGGAGGCCGACGTGGATGGATCGCTTGAGTCTAGGCATTTAAGACCAGCCTGGGCAACATGGTGAGACCCCCCTCTCTATAAAAAATACAAAACATTAGCCAGGTGTGGTGACACCTGCCTGTAGTCCCAGCTATTCCGGAGGCTGAGGTGGGCAGGTCGAGTGCCACTGCACTCCAGCCTGGGTGACAGAGTGAGACCCTGTCTCAAAAAATAAAAGAAAAAGACAAAAAAA"
"chr1","1023149","1023439","chr8","39165024","39165322","64","38141875","GGCCAGGAGCAGTGGCTCACACCTGTAATCCCAGCACTTTGGAAGGCTGAGGCTGCAGGATCGCTTGAGGGCAGGAGTTTTAAGACCGGCCTGGGCAATACAACGAAACCCCTTACAGAAATCAGCCAGGCGTGATGGCACATGCCTGTGATCCCAGCTACTTGGGAGGGAGGTGGGAGGATCGCTTGAGTCCAGGAGGTTGACGCTGCAGTGAGCCGAGATCGCGCCACCACACCCTAGCCTGGATGACAGAGTAAGACCCCATCTCAAAAAAAATAAAATAAAAGTAAA","GACCAGGTGCCGTGGCTCATGCCTGTAATCCCAGCACTTTGGGAGGCTGAGGCAGGTGCATTGCTTGAGCTCAGGAGTTAGAAACCAGCCTGGGCAACAGAGTGAGACCTCATCTCTAAAAAAAAATTACACAGGCATGGTGGTGCATGCCTGTGGTCCCAGCTACTTGGGAGGCAGAGGTGAGAGGATCAGTTGATTCCAAGAGGTTGAGGCTGCAGTGAGCCATGATCACACCACTGCACTCCAGCCTGGATGACAGAGTGAGGCCCTGCCTCAAAAAAAAAAAAAAAAAAAAAAAA"
"chr1","1150664","1150951","chr1","212801492","212801783","65","211650828","GAGTGTGGTGGCTTATGCCTGTAATCCCAGTGCTTTGGGAGGCTGAGGCAAGAAGATCATATGAGGCCAGGCATTTGAAAGCAGCCTGGGCAACATAGTGAGACCCCATCTCTAAAAAACAAAATTAGCTCAGCATGGGAGTGTGCACCTGTAGTCCTCCTAGCTATTTAGGGGGCTGAGATGGGAGGATCACTTGAGCCCAGGAGGTCAAGGCTGCAGTGAGCCACAATCAAACCACATTACCCCAGCCTAGGCGACAGAACAAGACCCTGTTTCTAAAATAAAAAA","GCCAGGAGTGGTGGCTCGTGCCTGTAACGACAGCTACTCAGGAGGCTGAGGCAGGAGGATCACTTGAGACAGGAGTTTGAGGGCAGCCTGGGCAACACAGTGAGACCCGATCTCAAAAAAATTAAAAATTAGCCAGGCATGGTGGTGTGTGCCTGTAGTCCCAGCTACTTGGGAGGCTGAGAGGGGAGGATCGCTTGAGCCCAGGAGTTCAAGGCTGCAGTGAGCTCTGATCATGCCACTGCACTCCAGCCTGGGGGACAGAATGAGACCCTGTCTCCAAAAAAAGAAACAA"
"chr1","1152355","1152647","chr1","291224","291515","27","861131","GGTCGGGCGCATGGCTCACACCTGTAGTCCCAGCACTTTGGGAGGCTGAGGCAGGAGGATCGCTTGAGCTCAGGAGTCTGAGATCAGCCTGGGCAATATAGGGAGCCCTTGTCTCTACCAAAAAATTAAGCAAAATTAAGCTAAGCGTGGTGGTGTATGCCTGTAGTCCCACCCTACCTTGGGAGGGCTGAGGTGGGAGGACTGCTTGAGCCCAAGAGGCAGAGGCTGTGGTGAGCTGAGATTGTGCCACTGCACTCTAGCCTGGGTGACACAGTGAGACTGTCTAAAAAAAA","GGCCGGGCACATAGCTCACACCTGTAGTCCCAGCACTTTGGGAGGCCGAGGCGGGAAGATCACTTGAGCTCAGGAGTCTGAGATCAGCCTGGGCAATAAAGCAAGACCTTAGCTCTACAAAAAAATTAACAAAATTAGCTAAGCATGGTGGTGTGTGCCTGTAGTCCCACCTGCTTGGGAGGCTGAGGTGGGAGGACTGCTTGAGCCCAAGAGGCAGAGGCTGTGGTGAGCTGAGATTGTGCCACTGCACTCTAGCCTGGGCGACACAGTGAGACTGTCTAAAAAAAAGAAA"
"chr1","1166941","1167176","chr1","304698","304916","36","862243","GGCCGGTCACGGTGGCTCACGCCTAGAATCCTAGCACTTTGGGAGGCTGAGGCGAGACGATCGTCTGAGCTCAGGAGTTTGAGACCCGCCTGGGTAACATGGCAAGACCCTTTTTCTATGAAAAATAGAAAAAATCAGCCGGGTGTTGTGGTGCATGCCTGTGGTCCCAGCTACTTGGGAGGCCGAGGTGGGAGGATCACTTGAGCCCAAGAGATGGAGGCTGCAGTGAGACGTGA","CCGGGCACGGTGGCTCAGGCCTAGAATCCCAGCACTTTGGGAGGCTGAGGCAAGAGGCTCAAGAGTCTGAGACCTGCCTGGGTAACATGGCAAGACCCTTTCTCTATGAAAAACAGAAGAAATCAGCCAGGTGGACCATGCCTGTGGTCCCGGCTACTTGGGAGGCCAAGCTGGGAGGATCACTTGAGCCCAAGAGGTCGAGGCTGTAGTGAGATGTGA"
"chr1","1187518","1187839","chr1","324460","324762","51","863058","GACCGGGCACAGTGGCTCACGCCTGTAATCCCAGCACATTGGGAGACTGAGGCAAGAGGATCGCTTGAAGCCAGGAGTTTGAGACCAGCTTGAGCAATACAGCGAGACCCGTCTCTACAAAGAGTAAAATAAAAGTAAATTAGCTGGGCGTGGGGGTGCACGCCTGGTGTCGCAGCTGCTCCGGTGGCTGAGGCGAGAGCATCACCTGAGCCCAGAGCATCACCTGAGCCCAGGAGTTCATGGTCACGGTGAGCTGTGGTCACCGCTGCACTCCAGCCTGGGTGACAGAGCAAGACCCTGTTTCTAAAAATAAAGAAAAAAA","GACTAGGCACAGTGACTCATGCCTGTAATCCCAGCACCTTGGGAGACTGAGGCAAAAGGATCGCTTGAAGCCAGGAGTTTGAGACCAGCCTGGGCAATACAGCAAGACCTGTCTCTGCAAAAGATAAAATAAAAATAAATTAGCCCGGCATGGTGGTGCGCGCCTATGGTTGCAGCTGCTCGGGTGGCTGAGGCGAGAGCATCCCCTGAGCCCAGGAGTTTGTGGTTGCAGTGAGCCGTGGTCGCCACTGCACTCCAGCCTGGGTGACAGAGCAAGACCCTGTTTCTAAAAATAAAGAAAAAA"
"chr1","1189316","1189391","chr2","56197408","56197483","19","55008092","GGTTTACTTGAGGCAGGAGGATCGTGAGACCAGCCTAGGCAACACAGTGAGACTGCGTCTCTTTAAAAAACAAAAA","GGAGGATCACTTGAGGCCAGGAGTTTAAGACCAGCCTGGGCACCAGTGAGACACCGTATCTGTTAAAAAATAAAAA"
"chr1","1226797","1227076","chr1","361871","362138","33","864926","CCGGGTTGCCGTGGCTCCTGCCTGTGATTCCAGCACTTCCAGAGGCTGAGGCCTGAGAATCAGTTGATGCCAGGAGTTTGAGACCACCTTGGGCAACATAGTGAGATCCCAGCTCTACAAAAAATAAAAAATTAGCTAGGCGTGGTGGCATGCGTCTGTAGTCTCAGCTACTCAGGAGGCTGAGGTGGGAGGATTGCTTGAGCCGAGGTGGTCAAGGCCACAGTGACTCCAGCCTGGGCGACAGAGCAAGACCCTGTCTCACGAAAAATAAGTAAATAAA","GCAGTGGCTCATGCCTGTAATTCTAGCACTTCGGGAGGCTGAGGCGTGAGAATCACTTGAGGCCAGGAGTTTGAGACCAGCTTGGGCAACACAGTGAGATCCCATCTCTACAAAAAATAAAAAATTAGCTAGGCGTGGTGGCACGCGTCTGTAGTCTCAGCTACTCAGGAGGCTGGGGTGGTAGGATTGCTTGAGCCAAGGCGGTCAAGGCTGCAGTGACTCCAGCCTGGGCGACAGAGCAAGACCTTGTCTCACAAAAAATAAGAAA"
"chr1","1256787","1257089","chr1","392917","393230","59","863870","GGCTGGGCATGGTGGCTCACACCTGTAATCCCAGCGTTTGGGAGGCCAAGGCCAGAGAATGCCAGGAGTTTGAGACCAGCTTGGGCAACGTAGTGAGACCTCCATCTCTACAAAAAAAAAAAAAAAAAATTAAGATGGGCATGGTGGCACGTGCCTATGGTCCCAGCTATTCAGGGAGGATGAGGGTGGGGAGGATCAGTTGAGCCAGGAGGCGGAGGCAGCAGTGAGCCATGATTGTGCTACTGCACTCCAGCCTGGGTGACAGAGAGAGACTCCATACAAAAAAAAACAAAAACAAAAAGA","GACTGGGCACGGTGGCTCACACCTGTAATCTCAGTATTTGGGAGACTGAGTCCAGAGGATGCCAGGAGTTTGAGACCAGGCTGGGCAACATAATGAGGCCTCCATCTCTACAAAAAAAAAAAAAAAAAAGAAAAAATATATATTAGGTGGGCATGGTGGCACGCGCCTGTGGTCCCAGCTACTCAGGAGGATGAGGTGGGAGGATCAGTTAAGTTCAGGAGGCGGAGGCAGCAGTGAGCCATGATTGTGCCACTGCACTCCAGCCTCCAGCCTGGGCAACAGAGAGAGACCCTGTCTCAAACAAACAAACAAAA"
"chr1","1271959","1272102","chr7","2704009","2704157","41","1432050","AAATTAGCCCGGCGTGGTGGGTGCGTGCCTATAGTCCCAGCTATTTGGGAGGCGGAGGTGGAGGCGGGAGGACGCTTGAGCCCAGGAGTTTGAGTGAGCCATGATTGCGCCACTGCAGCCTGGGTGACAGCCCCACCCTGTCTC","TTAGCCAGGCATGGTGGCACGAGCTTGTAGTTCCAACTACTTGGGAGGCTGAGGTGGGCGGACCCGCTTGAGCCCAGGAGTTTAAGGTTCAGTGAGCAATGATGGTACCACTGCACTCCAGCCTGGGTGACAGAGTACGACCCTGTCTC"
"chr1","1324561","1324817","chr15","46265389","46265656","69","44940828","GCCTGTAATCCCGCACTTCAGGAGGCTGAAACAGGTGCATTACTTGAGCCTGGTAGGTCAAAGCCAGCCTAGGCAATGGAGCAAGACCCCATCTCTACAAAAAAAAAAAGCCAGGTGTGGTTGTGCCCACCTATGGTCCCAGCTACTCAGAACGCTGAGGTGGGAGGATCACTTGAGCCTGGGAGGTTGACCTGCAGTGAGCCAAGATCGCACCACTGCACTCCAGCCTGGGGCAANAGCGNGACCACTNTCAAANA","GCCTATAATCCCAGCATCTTGGGAGGCTAAGGCAAGAGGATCACTTGAGGCCAGGAGTTTGAGATTAGCCTAGGCAATACAGCAAGAACCTGTCTCTAAAAAATTAAAAATTAGCCAGGTATGGTGGCCTGTACCTGTAGTCCCAGCTAGTCAGGAGGCTGAGGTAGGAGGATCACTTGAGCCCAGGAATTTGAGACTGCAGTGAGCTATGATTGTACCACTGCACTCCAGCCTGGGTAACAGAGCCAGACCCTGTCTCAAAAAAAAA"
"chr1","1324970","1325249","chr2","124168334","124168607","59","122843364","GGCTGGGTGTGGTATCTCACACCTATAATCCCAACACTTTGGGAGGCCAAGGCAGGAGGATCATTTGAGGCCAGGAGTTTGAGACCAGGCTGGGCAACTTAGTGAGACTCTATCTCTGCTGGAAAAAACATTAGCTGGGCCTGGTGGTGTATGCCTGTAGCCCCAGCTACTTGGGAGGCTGGCTTGAGCCCAGGAGTTACAGGCTGCAGTGAGCTATAATGGCACCACTGCACTGCAGCCTGGGCGACAGAGGGAGACCCTGCCTCTTAAAAAATAAAAA","GGCTAGGTGCAGTGACTCATGCCTGTAACCCCAGCACTTTGGGAGGCTAAAGAAGGAGGATTGCTTGAGCCCAGGAGTTTGAGACCAGCCTGGGCAACATGGCAAGACTCTGTCTTACAAAAAAAAATTAGCTGGGCATGGTGGTGCATAACTGTAGTCCTAGCTACTTGGGAGGCTATGGTGGGAGCCCAAGAGTTCAAGGCTGCAATGTGCTATGATCACACCACTGCACTCCAGCCTGGGCAACAGAGTGAGACTCTGTCTTCCAAAAAAA"
"chr1","1346407","1346534","chr16","76744880","76745008","33","75398473","GCCTATGCTCCTAGCACTCTGGGACGCTGAGGCAGGACAATCACTTGAGGCCAGGAAATTCAAGAGCAGCCCGGCCAACATAGCAAGACCCAGACTCAACTAAAAAGATAAAGAATTAGCTAAGCACA","GCCTATAATCCCAGCACTTTGGGAGGCTGAGGCAGGAGGATCACTCGAGGCCAGAAGTTCAAGTCCAGCCCGGGCTACATAGTGAGACCCCATCTCTACAAAAAATTGTTTTAATTAGCCAGGCATGAA"
"chr1","1346827","1346987","chr3","126170332","126170491","31","124823505","TTAGCCAAGCATGGTGGCATGTGCCTGTAGTCCTAGCTATGCAGAAAGCTGAGGTGGGAGGATCACTTGAATCCAGGAGTTGGAAGCTGCAGTGAGCTGCGATCACACCACCATACTTCAGCCTGGGTGACAGAGACCCTGTCTACAAAAAAAAAAAAAAA","TTAGCTGGGCGTGGTGGTGCCACCTGTAGTCTTAGCTACTCAGGAGGCTGAGGTGGGAGGACTGCTTGAGTCCAGGAGTTCGAGGCTGCAGTGAGCTATGATTACACCACTGTACTCTTAGCCTGGGTGACAGAGACCCTGTCTCTAAAAAAGAAGAAAA"
"chr1","1363968","1364121","chr8","96729325","96729462","51","95365357","GGCGCGGTGGCTCAGGCCCGTAATCCCAGCAGAAGCCAGCAGTCCCAGAGCAGCCTGGCCAACGCAGGAAGACGCCCCCTCTACAAAAAACACAAAAAGTTAGCCGGGCGTGGCGGCGCGCGCCTGACGTCCCAGCTACTAGGAAGGCAGAGGC","GGCAGTGGATTTCTTGAGTCCAGGAGTTCAAGACCAACCTGGGCAACATGGTGAGACCCTGTCTCTACAAAAAATATAAAAAATTAGCTGGGCATGACGGCATGTGCCTGTAGTCCCAGCTACTCAGGAGGCTGAGAC"
"chr1","1364170","1364452","chr19","33783509","33783789","39","32419339","GCTGATGCCTGTAATCCCAGCACTTTCGGAGGCCGAGGGGGGAGGAACACTTGAGTCCAGGAGTTCAAGACCAGCCTGGGCAACATAGTGAGACCCCATCTCTACAAAAAATCAAAAAGAAATTAGCCGGGAGCGGTGGTGGCGCGCGCCTGAGGTCCCAGCTACTCAGGAGGCTGAGATGGGAGGCTCGCCTGAGCTCTGGAGGTGGAGGCTGCAGTGAGCTTAGATTGCACCACCGCGCAACAGCCTGGGCAGCGGAGCCAGAGTCTGTCCCCAAAAAAAA","CGCGGTGGTGCCAGTGCCTGCAATCCCAGCACTTTCGGGGGCCGAGGGGGGAGGATCACTTGAGTCCAGGAGTTCCAGACCAGCCTGGGCAAGATAGTGAGACCCCAAGCTCTACAAAAAATTAAAAAGAAATTAGCCGGGCGCGGTGATGGCGCGCGCCTGAGGTCCCTGCTACTCAGGAGGCTGAGGCGGGAGGCTCGCCTGAGCCCTGGAGGTGGAGGCTGCAGTGAGCTCAGATTGCACAACAGCCTGGGCAACGGAGCCAGAGTCTCTAACAAAAA"
"chr1","1421571","1421866","chr1","587937","588219","40","833634","GGCCGGGCATGGTGGTGGCTGATGCTTGTATTCCCAGCATTTGGGGAGGTCAAGTCAGCCAGATTATTTGAAACCAGGAGTTCAGGACCAGCCTGGAAAGCAAGTCAAGAACCCATCTCTACAAAAAATAAAAAAATTAGCTAGACGTAGTGGTGCATACCTGTGATGCCAGCTGCTTGAGAGGCTGAGGTGGGAGGATCACTTGAGTCCAGGAGGCGGAGGCTGCAGTGAGCTGTGATTGTGCCACTGCACTCCAGCCTGGGTTACAGAGTGAGACCCTGTCTTAAAAAATAAGA","GGCCGGGCGTGGTGGTGGCTGACACTTGTATTCACAGCATTTGGGGAGGTCAAGTCAGCCAGATTATTTGAAGCCAGGAGTTCAGGACCAGCCTGGAAATTTTACAAAAAATGAAAAAATTAGCCAGACCTGGTAGTGCATGCCTGTAATGCCAGCTGCTTGGGAGGCTGAGGTGGGAGGATCACTTGAGTCCAGGAGGTTGAGGCTGCAGTGAGCTGTGATTGTGCCACTGCACTCCAGCCTAGGCAACAGAGCGAGACCCTGTCTTAAAAAATAAGAATAA"
"chr1","1452904","1453203","chr1","587937","588219","38","864967","GGCCGGGTATGGTGGTGGCTGACGCTTGTATTCCCAGCATTTGGGGAGGCCAAGTCAGTCAGATTATTTGAAGCCAGGGGTTCAGGACCAGCCTGGAAAGCAAGGCAAGACCCCATCTCTACAAAAAATGAAAAAATTAGCTGGACCTGGTGGCACATGCCTGTAATGCCAGCTGCTTGGGAGGCTGAGGTGGGAGAATCACTTGAGTCCAGGAGGTGGAGGCTGCAGTGAGCTGTGATTGTGCCACTGCACTCCAGCCTGGATTACAGAGCAAGACCCTGTCTTAAAAACTAAGAATAA","GGCCGGGCGTGGTGGTGGCTGACACTTGTATTCACAGCATTTGGGGAGGTCAAGTCAGCCAGATTATTTGAAGCCAGGAGTTCAGGACCAGCCTGGAAATTTTACAAAAAATGAAAAAATTAGCCAGACCTGGTAGTGCATGCCTGTAATGCCAGCTGCTTGGGAGGCTGAGGTGGGAGGATCACTTGAGTCCAGGAGGTTGAGGCTGCAGTGAGCTGTGATTGTGCCACTGCACTCCAGCCTAGGCAACAGAGCGAGACCCTGTCTTAAAAAATAAGAATAA"
"chr1","1499262","1499327","chr1","54094474","54094540","16","52595212","GGTCTGGCACATTGGCTCATGCTTGTAATCCCAACACTTTGGGAGGCCAGTGTGAGAGAATCTCTG","GGCAGGGCATGGTGGCTCATGCCTGTAATCCCAGCACTTTGGGAGTCCTAGGCGGGAGGATCACTTG"
"chr1","1499609","1499681","chrX","15934857","15934923","16","14435248","GAGAGAATCTCTTGAGACCAGGAATTTGAGACCAAACTGGTCAATATAGCTAGATCCCTCTCTATTTAAAAAA","GAGGATCTCTTGAGGCCAAGAATTTGAGACCAGCCTGGGCAACAAAGAGATCCCATCTCTACAAAAA"
"chr1","1501716","1501981","chr1","637036","637326","48","864680","GGCATGGTGGCTCACACCTGTAGTCCCAACACCTTGGGAGGCTGAGGTGGGAGGGAGGATCACTTGAGCCCAGGAGTTCAAGATGAGCCCTGGAAACACAGCAAGACCTTGTCTCTAATGAAAATAAAAAACTAGCCAGGTAGAATGCTGCACGGCTGTATTCCCAGCTACTGGAGAGGCTGAGGTGGGTGGATCACTTGAGCTTGGGAGTTTGAGGCTGCAGTGAGCCACGATCCCACCACCGTACTCAAGCTTGGGCAATGAAG","GGCTGGGTATGGTGGCTCATACCTGTAATCCCAACACCTTGGGAGGCTGAGGTGGGAGGATCACTTGAGCCCAGGAGTTCAAGATGAGCCCTGGAAACATAGCAAGACCTTGTCTCTAATGAAAATAAAAAATTAGCCAGGCATAATGACGCATGGCTGGATTCCCAGCTACTTGAGAGGCTGAGGTGGGTGGATCACTTGAGCTTGGGAGTTTTGAGGCTGCAGTGAGCCATGATCCCACAACTGTACTCAAGCTTGGGTAACAGAGCAAGATCCTGTCTCAAAAAAAAA"
"chr1","1561470","1561580","chr1","694691","694801","10","866779","GCCAGGTGCAAGGGCTCAGGCCTGTAATTCCAGCACTTTGGGAGGGCAAGGCAGGAGGATTGCTTGAGCCCAGGAGTTCAAGTCCAGCCTGGCCAACATAGCAACACTCTG","GCCGGGTGTGAGGGCTCAGGCCTGTAACTCCAGCACTTCGGGAGGGCAAGGCAGGAGGATTGCTTGAGCCTAGGAGTTCAAGACCAGCCTCGCCAACACAGCAAGACTCTG"
"chr1","1561883","1562068","chr1","695415","695607","20","866468","AAAAACTCTTTTCTACAAAATAAAAAAATTAGCCAGGCATGGTGGCTTGCGCCTGTAGTTCCAGCTACTCAGGAGGCTGAGATGGGAGGATTGTTTGAGCCTGGGAGGTGGAGGCTGCAGTGAGCTATGATTAAGCCACTCCACTCCAGCCTGGGCGACAGAGACAGACCCAGTCTCCAAAAAAAA","AAAAACTGTGTTCTACAAAATTAAAAACTTAGCGCCAGGCAGTGGTAGATTGCGCTGTAGTCCCAGCTACAGTCTCAGGAGGCTGAGATGGGAGGATTGTCTGAGCCTGGGAGGTGTAGGCTGCAGTGAGCTATGATTAAGCCACTCCACTCCAGCCTGGGTGACAGAGCCAGACCCAGTCTCCAAAAAAAAA"
"chr1","1566866","1567115","chr1","700378","700618","23","866488","AGGCATGAGGGTTCCTTGAGCCCAGGAATTCAAGACCAGCCTGGGCAATACAGGGACACCTTGTTTCTACTGAAAAATGAGCCAGGTGTGGTGGCACACGCTACGCCTGTAGGTCCCAGCTACACGGGAGGCTGAGGTGGGAAGATTACTTGTGCCCAGGAGTTCGAGGTTGCAGTGAGCTATGATCGCTCCACTGCACTCCAGCCTGGGCAACAGAAGAAGACTCTGTCTCAAAACAACAACAACAAAA","AGGCATGAGGGTTCCTTGAGCCCAGGAATTCAAGAGCAGCCTGGGCAATACAGGGAGACCTTGTTTCTACTGAAAAATGAGCCGAGTGTGGTGCCACATGCCTGTCGTCCCAGCCACGTGGGAGGCTGAGGTGGGAAGATTACTTGTGCCCAGGAGTTCGAGGTTGCAGTGAGCTATGATTGCTCCACTGCACTCCATCCTGGACAACCGAACAAGACTCTGTCTCAAAACAACAAAAAAA"
"chr1","1571287","1571358","chr14","52690112","52690177","19","51118825","TGGGAGACTAAGGCCAGAGGACCGCATGACGCCAGCCTGGGCAACGTAGGGAGACCTTGTCTCTGACAAAAA","GAGGCTGAGGTGGGAGGATCGCTTGAAGCCAGCCTTGGCAACATAATGAGACCCTGTCTCTACAAA"
"chr1","1580026","1580157","chr6","84156665","84156798","38","82576639","AGTCAGGCAAGGTGGCGAGCGCCTGTAGTCCCATATACTCTGCAAGCTGAGATGGGAGACCGATTGAGCCCAGGAGTTCCAGGCTGAAGTGCGCTTGTGAACAGCCACTGCGCTGTGGCATGGGCGACAAAG","AGCCAGGTGTGGTGGCATGTGCCTGTAATCTCAGCTACTCAGGAGGCTGAGATGGGAGGATTGTTTGAGCCCAGAAGTTTGAGGTTGCAGTGAACTATGATCCTGCCACTGTACTCCAGCATGGGCAAACAGAG"
"chr1","1585664","1585949","chr1","142523424","142523705","59","140937760","CAGGTGTAGTAGCCCACGCCTATATTCTCGACACTACGGGAGGCTGAGTGGGAAGGATTGCTTGAGCCGAGGAGTTCAAGACCAGCCTGGGCAACAAAGCGAGAGCCCAGCTCAACAAAAAAATAGCCAGGCATGGTGGCACGTGCCTGTGGTTCCAGCCACATGGGAGGCTGAGGTGGGAGGATCACTTGAGCCCAGGAAGTCGAGGCTGCAGTGAGCCAAGATCATGGCACTGTACTCCAGCCTGGGTGACAGACAGAGCAAGACTGTCTCAAAAAAATAAAAA","GGCATGGTGGCTCACACCTGAAATCCCAACACTTTGGGAGACCAAGGTGGGAGGATCGCTTGAGCCTCGGAGTTCAAGACGAGCCTGAGCAACATAGCGAGAACCTGTCTCTACAAAAAAAAAGCCAGGCATGGTGGCATGCACCTGTCGTCCCAGCTATTTGGGAGGCTGAGGTGGGAGGATCACTTGAGCCCAGGAGGTCGAGGCTGCAGAGAGCCATGATTATGCCATTGCACCCCAGCCTGGGGGACAAAGTAAGATCCTGCCTCAAAAAAAAAGAAA"
"chr1","1633827","1633970","chr1","783882","784024","12","849945","GGCCAGGTGTGGTGGCTCATGCCTGTAATCCCAGCACTTTGGGAGGCTGGAGAGAAAGGATCAGTTGAGGCCAGGGGTTCAAGACCACTCTGGGCAACACAGAACTCTTCTCTAGCAAAAAAAAAATTAGCCGGGCATGGTAGC","GGCCAGGTGTGGTGGCTCATGCCTGTAAGCCCAGCACTTTGGGAGGCTGGGGAGAGAGGGTCAGTTGAGGCCAGGGGTTGAAGACCACTCTGGGCAACACAGAACTCTTCTCTACCAAAAAAACATGAGCCAGGCATGGTGAC"
"chr1","1634729","1634864","chr8","124405124","124405255","20","122770395","GGTCAGACACAGTGGCTCACACTTGTAATCCCAGCACTTTGGGAGGCCAAAGCAGGGGAATCACTTGAAGCCAGGAATTGGAGACCAGCCTGGGCAACACAGCAAGACCCCACCTCTACAAAAACATTAATAAAAA","GCCAGGCACAGTGGCTCACATCTGTAATCCCAGCACTTTGAGAGGCCAAGGCAGGAGGATCACTTGAGGCCAGAAGTTCGAGACCAGCCTAGGCAACAAAGCATGACCCCACCTCTACCAAAAATAAAAAAA"
"chr1","1635015","1635283","chr1","793738","793977","46","841277","GGCTGGGTGCAGTGGCTCATGCCTGTAATCCCAGTGCTTTGGGAGGTCAACACAGGAGGGCCACCAGAGCCCAGGAGTTCAAGGTCAGCCCGTTCAAGGTAGCGAGACCCTGTCTCTACAAAAAATTTAAAAATTAGCTGGACATAGTGGCTCATGCCTGTAGTCTCAGCTACGTGGGAGGATCCCTTGAGCCTGGGAGATTGAGGCTGCAGTAAGCTGTAATTGCACCACTGCACACCAGCTTAGGTGACAGAGCAAGACTCTACCTC","GGCTGGGTGCAGTGGCTTATGCCTGTAATCCCAGTGCTTTGGGAGGTCAATGCAGGAGGATCACCAGAGCCCAGGAGTTCAAGATCAGCCCGTTCGATGTAACAAGACCCTGTCTCTACAAAAATTTTAAAAATTAGCCAGACGTAGTGGCACATGCCTGTAGTCTTAGCTACATGGGAGGATCCCTTGAGCCTGGGAGATTGAGGCTGCAGTAAGCTGTAATTGCACCACTACACTCCA"
"chr1","1637982","1638256","chr1","796662","796935","13","841320","GTGGCTCATGTCTGTAAGATCAGCACTTTGGGAAGTGGAGGCAGGAGGATCTCTTGAGGCCAGGAGGTTGAGACCAGCCTGGACAACACAGTGAGACTCTATCTCTACAAAAAATTTTATAAATCAGCTAGGTGTGGTGGTGCAGGCCTGTAATCCCAGCTACTCATGAGGCTGAGGTGGGAGGATCAATTGAGCCCAGGAATTTGAGGTTACAGTGAGCTATAATCATGCCACTATAAACACGCCTGGAGGACAGAGTGAGGCCCTGTTTCTAA","GTGGCTCACCTCTGTAAGATCAGCACTTTGGGAAGTGGAGGCAGAAGGATATCTTGAGGCCAGGAGTTTGAGACCAGCCTGGACAACACAGTGAGACTCTGTCTCTACAAAAATTGTATAAATCAGCTAGGTGTGCTGGTGCAGGCCTGTAATCCCAGCTACTCAGGAGGCTGAGGTGGGAGGATCAATTGAGCCCAGGAATTTGAGGTTACGGTGAGCTATAATCATGCCACTATAAACACGCCTGGGGGACACAGTGAGGCCCTGTTTCTAA"
"chr1","1665949","1666212","chr1","825075","825341","18","840874","GCTGGACATGGTGGCTCATGCCTGTAACTGCAACACTCTGGGAGGCCAAGGTAGGAGGATAGCTTGGAGCCAGGGGTTCGAGACCAGCTGGGGCAACAAAGCTAGACCCCTTCTCTACAAAAAATGAAAAACAGCCACGCACAGTGGCGCACAACTATGGTCCCAGCTCCTCGGGAGGATGGCTCAAGCCTGGGTGGTTGAGGCTGCAGGGAGCTATGATTGCACCACTGCACTCCAGGCTGGGCGAAAGCGAGACCCTGTCTC","GCTGGACATGGTGGCTCATGCCTGTAATTACAGCATTCTGGGAGTCCAAGGTAGGAGAATAGCTTGGAGCCAGGAGTTCGAGACCAGCTGGGACAACAAAACTTAGACCCCTTCTCTACAAAAAAGGAAAAACTTAGCCACGCACAGTGGCGCACACCTGTGGTCCCAGCTCCTCGGGAGGATGGCTCAAGCCTGGGTGGTTGAGGCTGCAGGGAGCTATGATTGCACTACTGCACTCCAGGCTGGGTGAAAGTGAGACCCTGTCTC"
"chr1","1673138","1673269","chr3","55572998","55573128","28","53899860","GTGGTGGCTCATGCCTGTAACCCCAGCACTTTGGGAGGCTGAGATAAGAGGATTGGTTAAGTCCAGGAGTTTGAAACCAACATGGGCAACAAAGGGAGACCCTGTCTACCACAAAAAAAAAATATATATATA","GTGGTGGCTCATGCCTATAATCCCATCTCTTTGGGAGGCTGAGGCGGGAAGAATGCTTGAGGCCAGGAGTTTGAGACTAGCTTGGGCAACATAGGGAGACCCCATCTCTACAAAAAAACTTAAATATTAGA"
"chr1","1673547","1673733","chr13","26144064","26144247","42","24470517","CACAAAAAATTATTTTTTAAAAAATTAGCTGGGCACAGTGATGTGCACCCGTGGTACCAGCTACTCAGGAGGCTGAGGCAGGAGGATTGCTTGAGCACAGCAGTTCAAGGCTTCAGTAAGCTAGGATCGCACCACTGCATTCTAGCCTGGACGACAGAGTGAGACCCAGTCTACAAAAAAAAAAAAA","GAAAATAAAGTTTTAAAAATTAGCTGGGCATGGTGGCATGCGCTTGTGGTCCCCACTACTCAGGAAGCTGAGGCAGGAGGATCACCTGAGCCCAGGAGAGTGAGGCTGCAGTGAGCCATGATCACACCACTGCATTCCAGCCTGGCCGACAGAGCAAGACCCTGTCTCAAAAAAAAAAAAAAAA"
"chr1","1676953","1677254","chr2","104586853","104587152","61","102909900","GTGGTGGCTCACACCTATAATCTCAGCACTTTGGGAGGCTGAGGTGGAAGGATCACTTAGGGGCCAGGAGTTTGAGACCAGTGTCAGCAACAAAGGGAGACCCTGTCTCTGTAAAAAACCAAAAAATATTAGCCAGGCATGGTGGCACATGCCTGTGGCCTATGCCACTTGGGAGGCTGAGTAGGAAGGCTTGCTGGAGCCTAGGAGGTCGAGGCTGCAGTGAGATATGATCACACCACTGCACTCCAGCATGACTGACAGAGTGAGACCCTGCCTAACACAAAAAAAAAAAAAAAAAAAAA","GTGGTGGCTCACATGTATAATCTCAGCACTTTGGGAAGCTGAAGCAGGAGGACCATTTGGGGCCAGGAGTTCGAGACCAGCCTGGGCAACACAGTAAGACCCCGTCTCTAAAATGAAAAATAAAAATATTAGCCGGGTGTGGTGGTGCACACCTGTAGTCCCAGCTACTTGGGAGGCTGAGGTGGAAGATTGCATGGGCCCAGGAGGTCAATGCTGCAGTGAGCCATGTTCACACCACTACACTCCAGCCTGGGTGACAGAGTGAGACCTTGCCAAAAATAAAAATAAAAAATAAAAAAA"
"chr1","1693289","1693558","chr1","123553726","123553990","73","121860437","GGCTGGGTGTGGTGGCTCATGCAATAGATTAGAGTCTAGCGCTTTGGGAGGCCTTGGCAGGAGGATCACTTGAAGCCAAGAGTTTGAGACCAGCCCGGGCAACATAGCAAGGCCTCGTCTCTACCAAAAATTTCAAAAATAGCTGGGTGTGATGGGTGGAGTCTGCTTGTAGTCCTGGCTACTCTGGAGGCTAAGGTAGAAGGATGGCTTGAACTGCAGTGAGCTATGATCATGCCACTCACTCCACCCTGGGCAACAGTGTGAGACCCT","GGCCTGGGTGTGTTGGCTTATGCCTATAATTCCAGCACTCTGGGAGGCCAAGGTGGGAGGATCGCTTGAGTCCAGGAGTTTGAGACCAGCCTGGGCAACAAAGTGAGACCTAATCTCTGCAAAAAATAAACACAATTAGTCAGGCATGGTGATGTACGCCTATAGTCCTAGCTACTTGGGAGGCTTTGGTGGGAGGATTGGTTGAGCCTGCAGTCAGCCAAGATTGTACCACTGCATTTCAGTCTGGGCAACAGAGCAAGACCCT"
"chr1","1699227","1699380","chr8","14063264","14063418","44","12364037","GGCTAGGTACTATGGCTAACACCTGTAATCCCAGCACTTTGGGAGGAGGATTGCTTGAAGCCAGTTGTTCGATACCATCCTGGGCAATAAAGTGAGACCCCTGTCTCTTCAAAAAAAAAAAAGTTAGCAGTCGGGCATGGTGGCTCACACCTGT","GGCCAGCACCTGTGGCTAACACCGGTAATCCCAATACTTTTGGAGATAAGGTAGGAGATTTGCTTGAGGCCAGGAGCCGAGATCAACCAGGGCAACATAGTGAGACCCTGTCTTTACAAAAAAAAATAGCTAGGCATGGTGGTGCAAACCTGTAG"
"chr1","1713280","1713379","chr1","875941","876044","12","837339","GCCAGGCGTGGTGGCTCGTGCCTGTAATACCAGGGGGGATCACTTGAGGCCAGGAGTTTCAGACCAGCCTAGGCAACATAGCAAGATCCTGCCTCTCAAA","GCCAGACGTGGTGGCTGATGCCTGTAATACCAGGGGAGGATTACTTGAGGCCAGGAGTTTGAGACCAGCCTGGGCAACACAGCAAGATCCCGCCTCTCAAAAAA"
"chr1","1713671","1713841","chr3","127201134","127201313","44","125487463","TCAAAATATTTTTTAAAAAACTGGCATGGTGGTGCATACCTGTAGTCCTAGCTACTCCAGAGGCTAAGACAGGAGGACTGGTTGAGCCCAGGAGTTCAAGGCAGCAGCGAGCCACTGCATGTCAGCCTGGGCAACAGAGTGAGACTCTGTCTCTTAAGAAAAAAAAAAAAA","TGACAAAAATTTTTAAAAATTAGCCAGGTGTAATGGTGCACACCTGTCGTCCCAGCTACTCCGGAGGCTGAAGCAGGAGGATCAGTTGAGCCTGAGAGATCAAGGCTGCAGTAAGCTATAATCTGCACCCCAGCCTGGGCAACAGAGTGAGACTCCATATCTCTTTCATAAAAAAAAAAA"
"chr1","1717575","1717841","chr1","880370","880634","20","837205","TTCAGGAGGTTGTGGCAGGAGGATCACTTGAGGCTGAGAGTTTGAAAACAGCCTGGGCAATGTAGTGAGACCAGACCCATCTCTGAAAATATAAAAGTTAGCCAGGTGTGATGGCACATGCCTTTAGTCCTGGCTGCTCAGGAGACTGAGATGGGAGGATACTTGAGCCCAGGAATTTGAGGCTGCAGTGAGCTATGATGGTGCCACTGCACTCTAGCCTGGGTCACAGAGCAAGATCGCCATCTCTTAAAGGAGAAGAAGAAGAAA","TTCAGGAGGTTGTGGCAGGAGGATCACTTGAGGCTGAGAGTTTGAAAACAGCCTGGGCAACATAGCAAGACCCATCTCTGAAAATATAAAAATTAGCCAGGTGTGATGGCACATGCATTTAGTCCCAGCTACTCAGGAGACTGAGATGGGAGGATGCTTGAGCCCAGGAATTTGAGGCTGCAGTGAGTTATGATGGTGCCATTGCACTCTAGCCTGGGTCACAGAGCAAGAACCCCATCTCTTAAAAAAGGAGAAGAAGAAGAAA"
"chr1","1738590","1738710","chr10","62530419","62530538","27","60791829","TTAGCTGGGCCTGATGGTGTACACCTGTAGTCCCAGCTATCCAGGAGGCTAAGGTGGGAGGATTGCTTGAACCCAGGAGTTCGAGGCTGCAGTGACCTGATTGTACGACTGCACTCCAGCC","ATTAGCTGGGCATGGTGGCATGCACTTGTAGTCCCAGCTACTAAGGAGGCTGAGGTGGGAGGATCACTTCAGCCCAGGTTGAGGCTGCAGTGAGCCATGATCATGCGATTGCATTGCAGC"
"chr1","1739743","1739880","chr3","43002189","43002326","18","41262446","GGCTGGGCATGGTGGCTCATGCCTGTAATCTTAGCACTTTGGGAGGCTGAGGCAGGAGAATCACTTGAGGCCAGGAGTTTGAGACCAGCCTGGGCAACACAGCTAGACCCTGTCTCTATTTTTAAAAAATAAATAAAA","GGCCAGGGATGGTGGCTCATACCTGTAATCCCAGCACTTTGGGAAGCTAAGGCGGGAGGATCACTTGAGGCCAGGAGTTTGAGATGAGCCTGGGAAACATAGCAAGACCCTGTCTCTATTTTTAAAACAAAGATAAAA"
"chr1","1742159","1742471","chr3","123903117","123903425","60","122160958","GGCTGGGCGTGGTAGCTCACACCTGTAATCCCAGTGCTTTGGGAGGGCGAGGCAGGAGGATCACTTGAGGCTGAGATTTTAAGACCAGCCTGGGCAACATAGTGAGACCCCATCTCTACAAAAAATTTGAAAATTAGCCAGGCATGGTGGTGCGTGCCTGTGGTCCCATCTACTGGGGAGGCTGAGGCAGGAGGATTGATGGAGCCTGGCAGGTTGAGATTGCAGTGAGCTATGGTTGCACCATGGCACTCCAGCCTGGGTGACAGAGTGAGGCCCTATGTCTTAAAAAACAACAACAACAACAACAAAAAAA","GGCTAGGCCCAGTGGCTCACACCTGTAATCCCAGTGCTTTGGGAGGCCGAGGCAGGAGGATCACTTGAGCCCAGGAATTGGAGACCAGCCTGGGCAACATAGTGAGACCCCCATGTCTACAAAAGCATTTAAAAATTAGCTGGGCATGGTGGCACACACCTGTATTCCCAGCTATTTGGGAGGCTGAGGTAGGAGGATGGCTTGAGCCCAGAAGTTCAAAGCTGCAGTGAGCTATGATTGCACCACTGCACTCCAGCCTGGGCGACAGAGCAAGACCTTGTCTCTAAACAAGCAAACAAAACAAACAAA"
"chr1","1761189","1761479","chr4","87333067","87333363","67","85571878","GGCTGGGTGCCATGGTTCACGCCTACAATTCCAGCTCTTTAGGAGGCTGAGGCTGGAGCATTACTTCAGACCGGGAGTTTGAGACTAACATAGTGAGTGAGACCCCATCTCTGCTAAAAATAAAAAATTAGCCAGGCATGATGTCTCGTGCCTGAGGTACCAGCTACTCAGGAAGCTGAGGTGGGAGGATCGCTTGGGCAGGTGAGGTTGAGGCTGCAGTGAGCCATCATCGCGCCACTGCACTCAAACCTGGGTGACAGAGTGAGACCTTGTCTCAAAAACAAACAAAAA","GGCTGAGCATGATGGCTCATGCCTGCAGTCCCAGCACTTTGGGAGGCCGAGGTAGGAGGATTGCTTGAGTCCAGGAGTTCGAGACCAGCTTGGGCAACATAGTAAGACCTCATGTCTACCAAAAAAAAAAAATTGGCTGGGCATGGTGGCACGTGCCTGTAGGCCCAGCTAATCAGGAGGCTGACGTGGGAGGATCACTTGAGCCTGGGAGGTTGAGGCTGCAGTGAACCATGATCTTGCCACTGCACTCCAGCTTGGGAGACAGAGTGAGACCTTGTCTCAAAACAAAAAACAAAA"
"chr1","1801467","1801769","chr1","966393","966701","32","835074","GCCGGGCACAGTGGCTCACGCCTGTCATCCCAGGACGTTGGAAGGCTGAAGCGGGAGGATCGCTTGAGGCTATGAATTCAAGACCAGCTTGGGCAACATAGTGAGACCCCATCTCTACAAAAAATATAAAAGTTAGCCAGGCATGGTGGCGTGTTCCTGTAGTCCTAGCCACACTCAGGAGGCTGAGGTGGGAGGATCGCTTGAACACGGGAGGTGGAGGCTGCAGTGAGCCGTGATTGCACCCCTTGCATTCAAGCCTGGGTGACAGAGCAAGACCCTGTCTCAAAGAAAAAAAAATTAAAA","GCCAGGCGCAGTGGCTTACCCCTGTCATCTCAGCACATTTGGAGGCTGAAGTGGGAGGATCACTTGAGGCTATAAATTCAAGACCAGCTTGGGCAACACAGTGAGACCCCGTCTCAAATATACAAAAAATATAAAAATTAGCCAGGCATGGTGGTGTGTTCCTGTAGTCCTAGCCACACTCAGGAGGCTGAGGTGGGAGGATTGCTTGAACCGGGGAGGTGGAGGCTGCAGTGAGCCGTGATTGCACCACTGCACTCAAGCCTGGGTGACAGAGCAAGACCCTGTCTCAAAAAAAAAAAAAAAAAAAAA"
"chr1","1857272","1857561","chr1","1019697","1019997","44","837575","GTGGCTCAAGCCTTGTAATCCCAGCACTTTGGGAGGTTGAGGTGGGTGAATCCTGGCTGAGACCAGGAGTTCAAGACTAGCCTGGGCAACAAAGAGAGACCCACCATCTCAACCAATAATTTGAAAATTACCTGGGCATGGCGGCATGTGCGTGTAGTCTTAGCACTTGTGAAGCTGAGGCGGGAAGATTGCTTGAGCCCAGAAGTTTAAGGCTGCAGTAAACTGTGATTGCGTCACTGCACTCCAGCCTGGGCAACAGAGTGAGACCCTGTCACAAAAGAAAACAGAAA","GCCAGATGTAGTGGCTCAAGCTTGTAATCTCAGCACTTTGGGATTGAGGTGGGCAAATTGTGGCTGAGACCAGGAGTTCAAGACTAGCCTGGGCAACAATGAGAGACCCCCCCCCATCTCTACTACGAATTTAAAAATTACCTGGGCATGGTGGTATATGCATGTAGTCTTAGCTACTTGTGAAGCTGAGGCAGGAAGATTGCTCGAGGCCAGAAGTTTGAGGCTGCAGTGAACTATGATTGAGTCGCTGCACTACAGCCTGGGCAACAGAGTGAGACCCTGTCACAAAAGAAACAAGAAA"
"chr1","1859242","1859590","chr7","52112257","52112567","95","50253015","GCAGGGCACAGTGGCTCATGCCTGTAATCCCAGCAACATGGGAGCCTGAGGTGGGAGGCTCTCTTGAGGCCAGGAGTTTGAGACCAGCCTGGGCAACATAGTGAGACCCCCACCCCACCCCACTGCCATTTCTAGAAAAAAAAAAAAACGTGGCCAGGCACAGTGGCTCACGCCTGTAATCCCAGNNNNNNNNNNNNNNNNNNNNCACCTATTCAGGAGGCTGCAGTGGGAGGATCACTTGAGCCCAGGAGGTCGAGGCTGCCGTGAGCTGTGATTGTGCCACTGCAGCCCAGCCTGGGCGACAGAGCAAGACCCTGACTCTAAAAGGGTTAAAAAAAAAAAAAAAAAA","GGCCAGGCACAGTGGCTCATGCCTATACTCCCAGCACCTTGGGTGGCTGAGGTAGGAGGATCACTTGAGGCCAGGAGTTCGAGACCAGCCTGGCCACATAGTGAGACCCAATCTCTTAAAATAAAAAATAAAAAAATTAGCAGGGCATGGTGGCATGTGCCTATAATCCCAGCTAATCAAGAGGCTGAGGTGGGAGGATCACTTGAGTCTTGGAAGTAGAGGCTGCAGTGAGCTGTCATTGTGCCACTGCACTCCAGTCTGGGCAACAGAGCAAGACTCTGTCTCAAAGAAAAAACAAAACAAAACAAAAA"
"chr1","1875221","1875344","chr3","36373230","36373353","22","34498009","GGCCAGACGAGGTGGCTCACTCCGCTAATCCCAGCACTTTGGGAGGCTGAGGCAGGAGGGTTGCTTGAACCCAGGAGTTTGAGGCCAGCCTGGGCAACGTAGTGAGACGCTATCTCTATTTAAC","GCCAGGTGTGGTGGCTCACTCCTGTAATCCCAGCACTTTGGGAGGCCAAGGCAGGAGGATTGCTTGAAGCCAGGAGTTGAAGACCAGTCTGGGCAACATAGTGAGACCTCATCTCTACAAAAAA"
"chr1","1875374","1875515","chrX","8417026","8417160","26","6541652","ATTTTTAAAAAGCTGGGCATGGTGGCTCACTCCTGTAATCCCGGCACTTTGGGAGGCTGAGGCGGGTGGATCACTTGAGGTCAGGAGTTCAAGACCAGCCTGGCCAACATGGCAAAACCCTGTCTCTACTAAAAATACAAAA","GGCCAGGCATGGTGGCTCACTCCTGTAATCCCAGCACTTTGGGAGGCTGAGGTGGGCAGATCGCCTGAGGTCAGGAGTTCAAGACCAGCCTGGCCAACATGGCAAAACCCATCTCTATTAAAAATACAAAAATTA"
"chr1","1881346","1881645","chr1","1046226","1046513","33","835120","GGCTGGGCGCGGAGGCTCACGCCTGCAATCTCAGCACTTTGGGAGGCCACGGGGGAGGATCCCTTGAGGCCAGGAGTTTCAGACCAGCCTGGGAAACATAGTGAGACCCCATCTCTACAAAAAATAGAAAATTATCTGGGTGCAGTGACATGCCTCGGTGGTCCCAGCTCCTCCAGAAGCTGAGGTGCAAGGATCCCTTGAACCCGGGAGGTGGAGGCTACAGTGAGCTGAGATCGTGCCACTGCACTCCAGCCTGGGCCACAGAGCAAGACCTTGTCTCTTAAAAGAAAAAGAAGAAAA","GGAGGCTCACACCTGCAATCCCATTACTTTGGGAGGCCAAGGGGGAGGATCCCCTGAGGCCAGGAGTTTGAGACCAGCCTGGAAAACATAGTGAGACCCCATCTCTACAAAAAATAGAAAACTATCTGGGTACAGTGACGTGCCTCTGTAGTCTCAGTTCCTCCAGAAGCTGAGGTGGAAGGATCCCGTGAACCCAGGAGGTGGAGGCTACAGTGAGCTGAGATCGTGCTACTGCACTCCAGGCTGGGCTACAGAGCAAGACCTTGTCTCTTAAAAGAAAAAGAAGAA"
"chr1","1901997","1902265","chr16","51470636","51470915","62","49568639","CCCAGCACTTTGGGAGGTTGAGATGGGAGGATTTCTTGAGCTCAGGACTTCAACACCAGCCCAGGAGACATAAGGAAACCCCATCTCTGCAAAAGAAAATAGCCAGGTGTGGTGGTGTGCACCTGTGGTCCCAGCTACTTGGGAGGCTGAGGTGGGAGGATTGCTTCAGCCCAGGAATTCAAGGCTGTAGTGAGCTGTGACTGCACCACTGCACTCAGCCTGGGCAATAGAATGAGACCTGTCTCAAAAAAAAATTAAAAATAAATAAA","TCCCTGCACATTGGGAGGCTGAGGCAGGAGGACTGCTTGAGGTCAGGAGTTTGAGACCACCTGGGCAATATGGTGAAACCTCGTCTCTACCAAAAATATAAAAATCAGTCAGGTGTGGTGGTGCTCACCTGTGGTCCCAGCTACTCGGGAAGCTGAGGTGGGAGGATTGCTTGAGCCAGGAGGTCGAGGCTGCAGTGAGCTGTGATCACCACTGCACTCCAGCCTGGGTCACAGAATGAGATACTATCTCAAAAATTAAACAAGTAAATAAAACAAAAAA"
"chr1","1909810","1910122","chr1","1078974","1079270","31","830836","GGCCGGGCGCGGTGGCTCACGCCTGCATTCCCAGCACTTGGGAAGACCGAGGCGGGCGCATCGCTTGAGGCCTGGAGTTGGAGACAAGCCTGGGCAACATGGTGAAACCCCGTCTCTACAACAAGTTTAAAAATTAGCTGGGTGCGGTGGTGTGTGCTTGTGGTCCCAGCTGCTCAGGAGGCTGAGGTGAGAGGATCACCTGAGCCCAGGAGGTGGAGGCTGCAGTGAGCTGAGATATGGCACCACTGCACTCTAGCCTGGGCGACAGAGTGAAGCCCAGCCTCTAAAAAAAATAATAATAATAACTTAAAAA","GGCCGGGCGCGGTGGCTCACGCCTGCAATCCCAGCACCTGGGAAGAGCGAGGCAGGCGGATCGCTTGAGGCCTGGAGTTTGAGAAAATCCTGGGCAACATGGTGAATCCCGTCTCTACAAAAAGTTTAAAAATTAGCTGGGTGCGGTGGTGTGTGCTTGTGGTCCCAGCTGCTCGGGAGGCTGAGGTGAGAGGATCACCTGAGCCCAGGAGGTGGAGGCTGCAGTGAGCTGAGGTATGGCACCACTGCACTCCAGCCTGGGCAACAGAGCGAAGCCCAGCCTCTAAAAAAATAATAA"
"chr1","1931190","1931318","chr1","1101640","1101769","6","829550","GCCAGGCGCCATGGCTCATGCTTGTAATCTCAGTGCTTTGGGAGGCTGAAGAGGAAGGATCACTTGAGGCCAGGAGTTGGAGACCAGCCTTGGGCCACATGGCAAAACTGTGTTTCACACACACAAAAA","GCCAGGCGTGCCATGGCTCATGCCTGTAATCTCAGTGCTTTGGGAGGCTGAAGAGGGAGGATCACTTGAGGCCAGGAGTTGGAGACCAGCCTTGGGCCACATGGCAAAACTGTGTTTCACACACAGAAAA"
"chr1","1949467","1949770","chr18","6870105","6870403","51","4920638","GCCGGGCGCAGTGGCTCACGCCTGTCATCCCAGCACTTCGGGAGGCCTAGCCGGGTGGATCGCCTGAGCTCAGGAGTTTTCAAGACCAGCCTGGGCAACATGGCAAAACCCCATCTCTACAAAAAAATGTAAAAATTAGCCTGGTGTAGTGGTGCACACCTGTCGTTCCAGCTCCTCGGGGAGGCTGAGGTGGGAGGATCGCCTGAGCCCAGGAGTTCGAGGCTGCAGTGAGCTGAGATTGTGCCACTTCACTCCAGCCTGGGTGACAGAGCGAGACCCTCTTAAAAAAAGAAAAAAAAAAAGA","GACCAGGCGTGGTGGCTCACGTCTGTAATCCTAGCACTTTGGGAGGCCAAGGTGGGTGGATTGCTTGAGCTCAGGAGGTCAAGACCAGCCGGGCAACATGGCAAAACCCAGCCGCTACAAAAAAATCTAAAAATTAGCTGGGTGTAGTGGCGTGCACCTGTAGTCCCAACTACTCTGGAGGCTGAGGTGGGAGGATTGCTTGAGCCCTGGAGGTGGAGGCTGCAGTGAGCTGAGATTGTGCCACTGCACTCCAGCCTAGGTGACAAAGTGAGACCCCTTCTCCAAACAGAAAAAACAAA"
"chr1","1967291","1967529","chr1","1144526","1144790","49","822765","TCCCAGTACTTTGGGCGGGCGAAGTGGGAGAATCACTTGGGGCATTCGAGACCAGCCTGGGTAACAAATCAAGGCCCCCAACTCTACTAAAAATAAAAAATTAACCAAGCGTGGTGGTGCACGCCTGAAGTCCCAGCTAGTTGCGAGGCTGAGGTGGGAGGCTTGCTTGAGCCCGGCTGCAGTGAGCCGTGATTGTACCACTGTACTCCAGCCTGGGCAACAGAGCAAGACCCTGTCTC","GCCAGGTGCGGTGGCTCACACTTGTAATCCCAGCACTTTGGGAGGCCAAAGCAGAGAATCACTTGGGGCATTCGAGGCCAGCCTGGGTAACAAAGCAAGACCCCCATCTCTACTAAAAGCAAAATATTAGCCAAGTGTGGTGGTGCGCGCCTGAACTCCCAGCTAGTTGGGAGGCTGAGGTGGGAGGCTTGCTTGAGCCCAGCGGCAGTGAGCCGTGACTGTACCACTGTACTCCAGCCTGGGCGACAGAGCAAGACCCTGTCTC"
"chr1","2015073","2015230","chr1","1199057","1199214","13","816016","GGCAACACAGTAAAACCCTGCCTCTACAAAAAATAAAATTGCCGAGTGTGGCACGTATCTGTAGTCCCAGCTCCTCTGGAGGCTGAGGTGGGAGGATCGCTGGAGCTCCAGAGGTCGAGGCTGCAGTGAGCAGTAATCGCACCCCTGCACTCCAGCCT","GGCAACACAGTAAGACCCTGCCTCTGCAAAAAATAAAATTGCTGAGTGTGGTGTGTATCTGTGGTCCCAGCTCCTCTGGAGGCTGAAGTGGGAGGATTGCTGGAGCTCCAGAGGTCAAGGCTGCAGTGAGCAGTGATCACACCCCTGTACTCCAGCCT"
"chr1","2053913","2054176","chrX","30235373","30235651","52","28181460","GGCCGGGCACGGTGGCTCACGCCTGTAATCCCAGCCCTTTGGGAGGCTGAGGCAGGTGGGTTGCTGGAGCCCAGGAGTTTGAGACCAGCCTGGGCAACATGGCAAGATCCCATCTTTACACGCCTGGGCGTGGTGGCGCGTGCCTGTGGTCCTAGCTACTCTGGAGGCTGAAGTGGGAGGATTCCCTTGAGCCAGGAATTGGAGGCTGTAGTGATGTATGATTGCACCACTGCACTCCAGCCTGGGTGACAGAGTAAGACCCTG","GGCCACACACGGTGGCTCACACCTATAATCCCAGCACTTTGGGAGGCTGAGGCAGGAGGATTGCTTGAGTCCAGGAGTTTGAGACCAGCCTGGGCAACATAGCAAGACCTCATCTATACAAAAAAATAAAATTACCCGGGCATGGTGGTGCATGCCTGTAGTCCCAGCTGCTCAGGAGGCTGAGTGGGAGGATTGCCTGAGCCTAGGAGGTAGAGGCTGCAGTGAGTCATGATAGCACCACTGCACTCCAGCCTGGGTGACAGAGTGAGACCCTGTCTC"
"chr1","2057432","2057709","chr1","1247395","1247665","21","810037","GGCCAGGCCCAGCAGCCCATGCCTGTAATTCTAGGACTTGGGGAGGTCCAGGCAGGCAGATTGCTTGAGCCCAGGAGTTTGAGACCAGCCTGGGCAACATGGCAAGACCTTGTCTCTATAAATAAAAAATTAGCTGGGCATGGTGGCATGTGCCTGTGGTCCCACCTACTTGGGTGGCTAAGGTGGGAGGATCACCTGAGCCCAGGGAGGTGGGGGCTGCAGTGAGCCAAGATCGTGCCACTGCACTCTAGACCCCAACTCAAAAAAAAAAAAAAAAA","GCCAGGCCCAGTGGTTCATGCCTGTAATCCTAGGACTTGGAGAGGCCCAAGCAGGCAGATTGCTTGAGCCCAGGAGTTTGAGACCAGCCTGGGCAACATGGCAAGACCTTGTCTCTATAAATAAAAAAATTAGCTGGGCATGGTGGCATGTGCCTGTGGTCCCACCTACTTGGGGGGCTAAGGTGGGAGGATCACCTGAGCCCAGGGAGGTGGAGGCTGCAGTGAGCCAAGATCATGCCACTGCAGACCCCATCTCAAAAAAAAAAAAAAA"
"chr1","2064320","2064426","chr7","98100798","98100893","23","96036478","GCACTTTGGGAGGCCAAGGCAGGAGGATTGCTTGAGGCCAGGAGTTTGACGAGACCAGCCTGGACAATATTATGAGACCCTATCTTTACAAAAATAAAATTAGCCAG","ACTTTGGGAGGCCAAGGTGGGAGGAGAGCTTGAGGCCAGGAGTTTGAGACCAGCCTTGGCAATATAGTGAGACTGTCTTTAGAAAAATTAAAATTA"
"chr1","2083193","2083351","chr10","62247249","62247407","28","60164056","TAGCTATGCATGATGGCATGCACCTGTGGTCCCAGCAACTCAGGAAGCTGAGGAAGGAGGATTGGTTGAGCCAAGGAGTCCGAGGCTGCAGTGAGCTAGGATAGCATCAGTGCACTTCAGCCAGGACAACAGAGTGAGACCCTGTCTCTAAAAAAGAGA","TTAGCCAGGCATGGTGGCATGTACCTGTAGTCCCAGCTACTCAGGAAGCTGAGGCAAGAGGATCACTTGAGCCCAAAGAGTTTGAGGCTGCAGTGAGCTATGATAGCACCACTGCTCTCCAGCCTGGGCAAGAGTGAAACCCTGTCTCAAAAAGAGAGA"
"chr1","2135738","2136047","chr13","74579338","74579644","69","72443600","GGCCAGGCACGGTGGCTCACACCTGTCATCCCAACACTTTGGGAGGCTGAAGCAGGAGGATCGCTTGAGCCCAGGAGTTCTAGACCAGCCTGGACAACATGGCGAGACCCCATCTCTACCCAAAAAATATAAAACGTTAGCCAGATGTAGTGGTGTGTGCCTGTAGTCTCGGCTACTCATGAGGCTGAGGTGGGAGGATCACTTGAACCAACAAGGTTGAGGCCACAAGACTGTGCTGCTGCACTCCAGCCTGGGTGACAGAGCCAGAGCCAGACCCTGTCGAAAAAAGAAGAGGGAGAGAAGGAGAGAA","GGCCAGGTGCGGTGGCTCATGCCTGTAATCCCAGCACTTTGGGAGGCTGAGGCAGGAGGATCTCTTGAATCCAGGAGTTGGAGACCAGCCTGGGCAACAAAGTGAGACCCAGTCTCTACAAAAATAAAAATAAGAAAATTAGCCCGGTGTAGTGGCATGTGCCTGTTGTCCCAGCTATCCAGGAGGCTGAGGTGTTAGGATCACCTGAGCCCGGGAGGTTGAGGCTTCAGTGATAGTGCCACAGCATTCCAGCCTGGGTGACACAGCAAGACCCTGTCTTAAACAAAGAAGAGAAAAGAAAGAAAAA"
"chr1","2189918","2190222","chr4","13681799","13682071","90","11491881","GTGATCCCAGCACTTTGGGAGGCGGAGGTGGAAAGATTCTCCTGAGCCCAGGAGTTTGAGACCAACCTGGGCAACATAGTGAGACCTCCTCTCTAAAAATTTTTTTAATTATCTGGGCATGGTGGCACACTCCTGTGGTCCCATGGGCATGGTGGCACACTCCACACTCCTGTGGTCCCAGCTCCTTGGAAGGCTAAGGCGAGGGGATTGCTTGCTCAAGCCCAGGAGTTGGAGGCCACAGTGAGCTGGGATTATGCCGCTGCACTCTAGCCTGGGTCACAGAGCCAGACTCTATCTAGAGAAAG","GCCTGTAATCCCAGCACTTTGGGAGGCTGAGGCAGGAGGATCGCTTGAAACCAGGAGTTTGACACCAGCCTGGGCAACGTAGTGAGACACCGTCTCTACAAAAAAAAGTTTTTTAATGAGCCAGGCATGGTGGCACATGCCCACAGTCCCAGCTACTTGGGAGGCTGAGGTAGGAGGATTGTTTGAGCCCAGGAGGTTGGGGCTACAGTGAGCTATGACTGTGCCAGTGTACTCTAGCCTGGGTGACAGAGGGAGACCCTATCTCAAAGAAAA"
"chr1","2228335","2228649","chr1","1417943","1418259","34","810392","GGCCAGGCGTGGTGGCTCACACCTGTAATCCCAGCACTTTGGGAGGCCCAGGTGGGCAGATTGCTTGAGACCAGGAGTTAAAGAGCAGCCTGGGCAACAGAGTGAGACCTCATCTCTAAAAGAAAAAAAAATTTTTAAAATTAACCAGGCATGGTGGTGTGCACCTATAGTCCCAGCTACTCAGGAGGCTGAGGCAGGAGGATTACTTGAGCCCAGGAGGTCAAGGCTGCAGTGAGCTATGATTTCACTACTGTACTTCAGCCTGGGTGACAGAGTGAGAACTTGTCTCACAAAAAAAAAAAGTTAGAAAAAAAA","GGCCAGGCGTGGTGGCTCACACCTGTAATCCCAGCACTTCGGGAGGCCCAGGTGAGTGGATTGCTTGAGACCAGGAGTTTAAGAGCAGCCTGGGCAACAGAGTGATACCTCATCTCTACAAGAAAAAAATTTTTTTAATCGGCCAGGCGTGGTGGTGTGCACCTGCAGTCTCAGCTACTCAGGAGGCTGAGGCAGGAGGATCACTTGAGCCCAGGAGGTCGAGGCTGCAGTGAGCTATGATTTCACCATTGCACTTCTGCCTGGGTGACAGAGTGAGACCTTATCTCGGGAAAAAAAAAAAATCAGAGAAGATAAAA"
"chr1","2289143","2289186","chr1","1479515","1479562","9","809628","AGAACAGCAGCGACAACAGAGCAAGATCCCATCTCTTTAAAAAA","AGAACAACCGGGACAATATAGCAAGATCCCATCTCTTTAAAAAAAATA"
"chr1","2289768","2289812","chr1","1480145","1480189","2","809623","TGGGAGGCCAGGGTGGGAGCACCACTTGAAGACAGGGTTTGAGGC","TGGGGGGCCAGGGTGGGAGCACCACTTGAAGACAGGGTTTGAGGT"
"chr1","2482292","2482560","chr1","1687975","1688263","40","794317","CTCATGCCTGAATTCCCAGCAACTCTGGAGGCCGAGGTGGACCACTTGAGCCCAGGAGTTCCAGACCAGCCTGGGCAACACAGCGAGACCCTGTTCTAAAATAAATTTTTTAAAAAGGCATTCGGGAGAGGTGACACACATCTGTGATCCCAGCTACTCAGGAGGCTGAAGTGGGAGGATTGCTTAAGCCCAGGAGTTCAAGTAAGCTGTGATCACACCACTGCACTCCAGCCTGGGCAACAGAGTGAGACCCTGTCTCTAAAAATAAA","CTCATGCTGGAATTCCCAGCAACTCTGGAGGCCGAGGTGGGCCACCTGAGCCCAGGAGTTCCAGACCAGCCTGGGCAACACAGAGAGACCCTGTCTCTACACATAAATGTTTTTTGAAAAGCATTCAGGCAAGGTGGCACACATCTGTGATCCCAGCTACTCGGGAGGCTGAGGTGGGAGGATCATTTAAGCCCAGAAGTTCAAGGCTGCAGTGAGCTGTGATCACACCACTGCACTCCAGCCTGGGCCACAGAGTGAGACCCTGTCTCCAAAAATAAATAAGTGAAAA"
"chr1","2492163","2492461","chr1","1700019","1700313","27","792144","GCCAGGCGTGATGGCTCACACCTATAATCCTAGCACTTTGGGAGGCTGAGGCAGGAGGACTGCTCGAGCCCAGGAGTTTGAGACCAGCCTGGGCAACACAGAGAGACTCATCTTTACAAAAAATAGAAAAACCTAGCCAGGTGTGGTGGCATGTGCCTGTGGTCCCAGCTACTTGGGAGGCTGAGGTGGGAGGATCACTTGAGCCCAGGAGGTTGAGGCTGCAGTGAGCTGTGATTGCACCACTGCCCTCCAGCCTGAGTGACAGAGTGAGACCCTGTCTCAAAAACAAACAAACAAAA","GCCAGGCGTGGTGGCTCACACCTACAGTCCCAGCATGTTGGGAAGCTGAGGCGGGAGGACTGCTTGAGCCCAGGAGTTCGAGACCAGCTGGGGCAACACAGTGAGACCCATCTCTACAAAAAATAGAAAAACCTAGCCAGGTGTGGTGGCACGTGCCTGTGGTCCCAGCTACTTGGGAGGCCGAGGTGGGAGGATCACTTGAGCCCAGGAGGTCAAGGCTGCAGTGAGCTGTGATTGTACCACTGCCCTCCAGCCTGAGTGACAGAATGAGGCTCTGTCTCAAAAACAAACAAAA"
"chr1","2517684","2517970","chr1","1724256","1724542","17","793428","GGCCAGGTGTGGTAGCTCACACCTGTAATCCCAGTACTTTGGGAGGCCAAGGTGGGAGGATGGCTTGAGACCAGAAGTTCCATACCAGCCTGGGCAATATATCAAGACCCCATTTGTACAAAAAGATTTTAAAATGAGCTGGGTGTGGTGGCATGTGCCTGTGGTCCCAGCTACTCCGGAGGCAGAAGTGGGAGGATCACTTAAGCCCAGGAGTTCAAGGTTGCAGTGAACCAAGATCATGCCACTGCACTCCAGCCTGGGCAACAGACAGAGACCCTGTCTCAAAA","GGCTTGGTGTGGTGGCTCACACCTGTAATCCCAGCACTTTGGGAGGCCAAGGTGGGAGGATTGCTTGAGACCAGGAGTTCGATACCAGCCTAGGCAATATATCAAGACCCCATTTCTACAAAAAGTTTTTAAAATTAGCTGGGTGTGGTGGCATGCACCTGTGGTCCCAGCTACTCAGGAGGCAGAAGTGGGAGGATCACTTAAGCCCAGGAGTTCAAGGTTGCAGTGAACCAAGATCACACCACTGCACTCCAGCCTGGGCAACAGAGAGAGACCCTGTCTCAAAA"
"chr1","2650897","2651163","chr2","42959841","42960124","58","40308944","CAGGCATGGTGGCTCACGCCTGTAATCCCAGCACTTTGGGAGGCTGAGGTAGAAGGATTGCTTGAGCCCAGGAGTTTGAGACCAGCCTGGGCAATGCAATGAGACCCCATCTCTACAAAAATTAGCTGAGTGTGGTGGTGCACACTTGTCTCAGCTACTCAGGTAGCTGTGGTGGGAGGATCGCTTGAGCCTGGGAGTTCAAGCCTGCAGTGAGCCAAAATCAAACCACCGCACTCCAGACTGGGTGACAGAGCAAGTAAAAAAAAA","GGCCGGGCACGGTGACTCACGCCTGTAAATCCCAGCACTTTGGGAGGCTGAGGCGGGAGGATCACTTGAGCCCAGGAGTTTGAGACCAGCCTAGGAAATATAATAAGACTCTTTCTCTACAAAAAATTAACTGGGCTTGGTGGTGCACACCTGTAGTCCCGGCTACTCAGGAAGCTGAAGTGGGAAGATCACTTGAGCCCAGGAGGTTGAGGCTGCTGTGAGCCATAATCAAGCCACTGCACTCCAGCCAGGGTGACAGTGTGAGACCCTGTCTTAAAAAAAAA"
"chr1","3035794","3036077","chr1","2191858","2192143","14","843936","GCTGGGCATGGTGGCTCACATCTATAATCACAGAACTTTGGGAGGATTGCTGGAGTCCAGGAGTCCCAGCCTGGGCAACATAGTGAGACCCCATCTCTACAAAAAATAAAACAAATTAGCCGGGATGGTGGTGTGCTTGTTGTCCCAGCTACTCAGGAGGCTGAGTTGAGAGGATCGCTTGAGCTCAGGAGGCTGAGGCTGCAGTGAGCCATGATTGCACCACTGCACTCCAGCCTGGGTGAGACACCCTGTTTCAAAAAAAAAAAAAAACAGAAAAAGAAGAA","GACTGGGCATGGTGGCTCACATCTATAATCCCAGAACTTTGGGAGGATTGTTGGAGTCCAGGAGTCCCAGCCTGGGCAACAGAGTGAGACCCCATCTCTACAAAAAATAAAACAAATTAGCCAGGGTGGTGGTGTGCCTGTTGTCCCAGCTGCTCAGGAGGCTGAGTTGAGAGGATCGCTTGAGCTCAGGAGGCTGAGGCTGCAGTGAGCCATGATTGCACCCCTGCACTCCAGCCTGGGCGAGACACCCTGTTTCAAAAAAAAAAAAAAAAGAAGAAGAAGAAGA"
"chr1","3094236","3094547","chr1","2249173","2249474","37","845063","GGCCAGGCACAGTGGCTCATACCTGTAATCCCAACACTTTGGGAGGATAAAGAGGGCAGATTACTTGAGTCCAGGAGTTTGAGACCCACCTGGGAAACCTAGCAAGACCCTGTCTCTACAAAAAAATTAAAAATTAGCTGGATGTGATGGCATGTACCTGTAGTCCTAGCTACTCAGGAGGCTGAGGTTGGAGGATTGCTTGAGCTCTGGAGGTCAAGGCTGCAGTGAGCTGTGATATTGCACCACTGCCCTCCAGCCTGGGCAACAGAGCAAGATCCCATCTCAAAAAAAAAAGAAAAGAAAAGGAAGGAA","GGCCGGGCACAGTGGCTCATGCCCGTAATCCCAACACTTTGGGAGGACAAGGAGGGCAGATTGCTTGAGTCCAGGAGTTTGAGACCAGCCTGGGAAACCTAGCGAGGCCTTGTCTCTACAAAAACAATTAAAAATTAGCTGGATGTGGTGGCATGTACCTGTAGTCCCAGCTACTCGGGAGGCTGAAGTTGGAGGATCACCTGGAGGTCAAGGCTGCAAAGAGCTGTGATATTGCACCACTGCACTCCGGCCTGGGCAACAGAGCAAGACCCCATCTCACAAAAAAAATAAATAAATAAAGA"
"chr1","3138832","3139097","chr1","2292857","2293125","26","845975","GGCTGGGTGTGGTGGCTCATGCTGGTGATCCCAGTGCTCTGGGAAGCTGAGCTGGGAGGATCACTTGTGGCCAGGAGTTCTAGACCAGCCTGGACAACATAACAAGACTCCCTCTCTACAAAAACATTAAACAATTAGTCGGTTGCGATGGTGCACCGTCATAGTCCTAGCTACTTGCAAGGCTAAGGTGGGAAGATGGTTTGAGCCCAGGATCATGTCACTGCCCTCCAGCCTGGATAACAGAACAAGATCCCATCTAAAAAAAA","GCTGGGTGTGGTGGCTCATGCTAGTAATCCCAGTGATTTGGGAGGCTGAGCTGGGAGGATCACTTGTGGCCAGGAGTTCCAGGCCAGCCTGGGCAACATAACAAGACCCCCTCTCTACAAAAACATTAAACAATTAGCCTGTTGCAATGGTGTACAGCCATAGTCCTAGCTACTTGTAAGGCTAAGGTGGGAAGATGATTTGAGCCCAGGATCATGTCACTGCACTCCAGCCTGGACAGCAGAGCAAGATCCCATCTAAAAAAAAATAA"
"chr1","3201688","3201993","chr1","2357280","2357593","44","844408","GTGGTGGCTCACACCTGTAATCCCAACACTTTGGGCGACCCAGGCAGGAAGATCACCTGAGGCCAGGAGTTCAAGACCAGCCTGAGCAACGTAGCAAGACCCCATTTCTACCAAAAAAAAAATTTTTTTTTAATTAGCCAACCACGGTAGTGTGTGCCTGTGGTCCCAGCTACTCAGGGGGCTAAGGGCGAGAGGATGTCCTGAGCCCAGGAATTCGAGGCTGCAGTAAGCCAAGATCACACCACTGCACTCCAGCCTGGGCAACAGAGCAAGACTCTGTAAAGAAATAAAAATAAATAAGAGAAA","TGGCTCATGCCTGTAATCCCAGCACTTTGGGCGGCCCAGGCAGGAAGATCACCTGAGGCCAGGAGTTTAAGACCAGCCTAAGCAACATAGTAAGACGCCATGTCTACCGGAAAAAAAAAAAAAAAAAAGTTGTTTAATTAGCCAACCATGTGAGTGCGTGCCTGTGGCCCCAGCTACTCAGGGTGCTAAGGGTGGGAGGATGTCTTGAGCCCAGGAATTCAAGGCTGCAGTAAGCCAAGATCGCACTACTGCAGTCCAGCCTGGGCAACAGAGCAAGACTCTGTCTGTAAAGAAATAAAAATAAATAAGAGAGA"
"chr1","3245435","3245692","chr3","38934767","38935033","56","35689332","GCTGGGCGTGGTGCCGCATGCCTGTAATCCCAGCACTTGGGAAGGCTGAGATGGTGAGTTGCTTGAGTCCAGGAGTTCAAGACCAGCCTGGGCAACGTGGTGAAACCCCATCTCTACAAAAAATACAAAAAATTAGCTAGGTGAGCTACTCAGGAGACTGGGGTGGGAGGATCACTTGAGCCCAGGATTTGGAGGCTGCAGTGAGCTGAGCTCGCACCACTGCACTCCAGCCTGGGCAACAGAGCCAGACCGTGTCTC","GGCAAGGTGTGGTGGCTCACACCTGTAATCCCAGTACTTCAGGAGCCAAGATGGGAGGATTGCTTGAGGCCAGGAGTTCGAGACCAGTCTGGGCAACATAGTGAAACCCCATCTCTAAAAAAAAAAAAAAAAAATAGCCGGGCATGTAGTCCCAGCTACTTAGGAGACTGAGGTGGGAGGATCACTTGAGCCTGGAAGTCAAGGATTCAGTGAGCTATGATCACACCACTGCTCTACAGCCTGGGCAACAGAGCAAGACCCTGTCTC"
"chr1","3349363","3349656","chr1","2508332","2508618","32","841031","GCGTGGCGGCTCACACCCGTAATCCCAGCACTCTGGGAGGCCCAGGCCGGAGGATCTATTGAGGCCAGGACTTTGAGACCAGCCTGGGCAACATATGAGATCCCGTCTCTACAAAAAATAACAAATTAGCTAGGTGTGGTGGCGCACGCCTGTCATCCCAGCTACTCGGAGGCTAAGGCAGGAGGATCGACGGCCTGAGCCCGGGAGTTCAAGGCTGCAGTACGGTATGGTCACACCACTGCACTCCAGCCTCGGTAGCAAAGCAAGATTCTGTCTCTAAAAAAAGAAAAGAAA","GGCTCATGCCTGTAATCCCAGCACTCTGGGAGGCTCTGGCCGGAGGATCTATTGAGGCCAGGACTTTGAGACCAGCCTGGGCAACATATGAGATCCTGTCTCTACAAAAAATTAAAAATTAGCCAGGTGCAGTGGCGTATGCCTGTCGTCCCAGCTACTCGGAGGCTAAGGCAGGAGGATCGATGGCCTCAGCCCAAGAGTTCAAGGCTGCAGTGAAATATGGTCACACCGCTGCACTCCAGCCTGGGTAGCAAAGCAAGATCCTGTCTCTAAAAAAAGAAAAGAAA"
"chr1","3456172","3456333","chr19","33343579","33343740","29","29887407","AATTAGCTGGGTGTGGTGGTGCCCACCTGTCTCCCAGCTAATCAGGAGGCTGAGGTGGGAGGATCCCTTGAAGCCCAGGAGTTGAGGCTGCGATGAACTATGATGGTGCCACTGCACTCTAGCCTGGGTGACAGAGTGAGACCCTGTCTCAAAAAAAAAGAA","TTAGCTGGGTGTGGTGGCTCACACCTGTGATCCTAGCTACTGGAGAGGCTGAGGTGAAAGAATTCCTTGAGCTCAGGAGTTCAAGGTTGCAGTGAGCTATGATCATGCCACTGCACCCTAGCCTGGGTGACAGAGTGAGACCCTGTTTCAAAAAAAAAAGAA"
"chr1","3471635","3471929","chr3","86677534","86677827","71","83205899","GGCTGGGTGCAGTGGTTCATAACTGTAATCCCAACACTTTAGGAGGCCAAGGGTTTGAGACCAGCCTGGGCAACATAGGGAGACCTCAGCTCTCCAAAAACTTAAAAAATATTAGCTGGGCATGAGGGCATGATGGCATGTGCCTGCGGTCCAAACCACGCAGGGTGCTGAGGTGGGAGAATCACTTGAGCCCAGGGGCTCGAGGCTGCAGTGAGCCATGATTGCACCACTGCACTCCAGTCTGGGCAACAGAGCTAGACCCCAACTCTAAAAAAAAAAAAGGGAAGGAAGGAAA","GGCCAGGTGCAGTGGTCCATGCTTGTAATCCCAGCACTTTGGAAGGATTAGTTGAGTCCAGGAGTTCGAAACCAGCCTGGGCAACATAGCAAGACTTCATCTCTACAAAAAACTTAAAAATTAGCTGCGCATGGTGGCAGCTGCCTGTGGTCCCAGCTCCTCAGGAGGCTGAGGTGGAAGGATCACTTGAGCCTGGGAGGTCGAGGCTGCAGTGAGCCATAATCATACCACTGCACTCCAGCCTGGGCAACAGAGCAAGACCCTGTCTCCAAAAAAGAAAAGGGAAGAAAAAAA"
"chr1","3560569","3560870","chr15","43687639","43687935","54","40127070","GGCCAGGCACGGTGGCTCACACCTGTATTCCCAACACTTCGGGAGGCCAAGGCAGGCAGATTGCTGGAGCCCAGGAGTTCAAGACCAGCCTGGACAGCATAGTGAGACCGTCTCTACAAAAACCTTTTAAAATTGGCCAGGTATGGTGGCACATGCCTGTGGTCCCAGCTACTCAGGAGGCTGAGGTGAGATGATGACAGCTTGAGCCTGGGAGGGCAGGGCTGCAGTGAGCTGTTATCACCCCACTGCACTCCAGACTGGATGACAGAGAAAGACCCTGTCTCAAGAAAAAAAAAAAAAAA","GGCCAGGCACAGTGGCTCATGCCTGTAATCCCAGCACTTTGGGAGGCCAAGGAGAGAGAATTGCTTGAGGCAGGAGTTCAATACCAGCTTGGGCAATATAGTGAGACCCCTGCCTCTACAAAAAATTTTAAAAATTAGCCAGGTGTGGTGGTGCACACCTGTAGTCCCAGCTACTCAGGAGGCTGAGGTGGGAGGATCACTTGAGCTGGGAGGTCAAGGCTGCAGTGAGCCATGATTGCGCCACTGCACTCCAGCCTGGGTGACAGAGCGAGACCCTGTTTCAAAAAAAAAAAAAAA"
"chr1","3603373","3603591","chr10","71004722","71004936","45","67401349","GCCTGGGCAACATGGTGAGAACCCACCTCTACTATACATATATATACAAAAATTAGCTGGGGGTGGTGGCTTGTGCCTGTAGTCCCAGCTACTCAGGAGACTGACGTGGGAAGATGGCTTGAGCCCTGGAGTTGGAGACTGCAGTGAGTCATGGTAGCACCACTGCACTCCAGCCTGGGCAACAGAGTGAGACCCTGTCTCTGGAATTAAAAAAAAAAA","ATCAGCCTGGGCAACATAGCGAGATCCCATCTCTACACAAAATACAAAAATTAGCTGGGCGTGGTGGCACGTGCCTGTAGTCCCAGCTACTGGGGAGGCTGAGGTGGGAGGACTGCTTGAGCCCAGGCCGTCGGGGCTGCAGTGAGCTATGACTGCATCACTGCACTCCAGCCTGGGTGACAGAGTGAGACCCTGTCTAATAAAAAAAAGAAAAA"
"chr1","3657446","3657748","chr1","2836381","2836681","28","821065","GGCTGGGCGCGGTGGCTCACGCCTGTAATCCCAGCACTTTCAGAGACCGAGGTGGGAGAATCACTTAAGGGCAGGAGTTTGAGACCAACCTGGCAACCAAGACCCCATCTCTAAAAAAAGAAGCAAGACCCCCATCTCTAAAACAAATCATAATAATTAGCTGCACATGGGGGTGCACACCTGTAGTCCCAGTTACTTGGGAGGCTGAGGTAGGGGGATCGCTTGAGCCCAGGAGTTCAGGGTTGCAGTGAGCCATGATTGCCACTGCACTCCAACCTGGGCAACAGAGTGAGACCCTGTCTC","GACTGGGCACAGTGGCTCACGCCTATAATCCCAGCACTTTCAGAGACCAAGGTGGAAGAATCACTTAAGGGCAGGAGTTTGAGACCAACCTGGCAACCAACACTTCCATCTCTAAAAAAAAAAAAGCAAGACCCCATCTCTAAAAAAAAAATAATTAGTTGCACATGGTGGTGCACACCTGTAGTCCCAGCTACTTGGGAGGCTGAGGTAGAAGGATTGCTTGAGCCCAGGAGTTTAGGGTTACAGTGAGCCATAATTGCCACTGCACTCCAACCTGGGCAACAGAGCCAGACCCTGTCTC"
"chr1","3685972","3686268","chr1","2867891","2868191","29","818081","GGTGTGATAGCTCACACCTGTAATCCCAGCTACTTGGGAAGCTGAGGTAGGAGGATCGCTCGAGCCCAGGAGTTCAAGACCAGCCTGGGCAATACAGCGAGAGCCCATCTTTAAAAATTTTTAAAAATTAGCCAGGTGTGGTGGTGTGCACCTGTAGTCCCAGCTATGTGGGAGGCTGAGGTGAGAGGATCGCTTGATCCCAGGAGTCTAAGGCTGCAGTGAGCTATGACTGCACCACTGCACTCCACCTGGGTGACAGAGTGAGACCGTGTCTCTGAAAAAATAATAATAATAAAA","GGTGTGATAGCTCATACCTGTAATCCCAGCTACTTCGGAGGCTGAGGTAGGAGGACTGCTTGAGCCCAGGAGTTCAAGACCAGCCTGGGCAACACAGCGAGATCCCATCTTTAAAAAAATTAAAAAAAAAATTAGCCAGGTGTGGTGGTGTGCACCTCTAGTTCCAGCTACATGAGAGGCTGAGGTGAGAGGATCGCTTGATCCCAGGAGTTTGAGGCTGCAGTGAGCTATGACTGCACCACTGCACTCCACTCAGGTGACAGAGTAAGACCATGTCTGTGAAAAAATAATAATAGTAAAA"
"chr1","3742467","3742713","chr4","11862374","11862624","54","8119907","GCTGAGGCAGGAGGATTGCTTCAGGCCAGGAGTTTGAGACTAGCCTGGGCAACATAGCAAGACCTTATCTCTATCAAAAAAAAATAATAAAAAACAGGGCATGGCGGCACATACCTGTAGTCCCAGCTACAAGAGGCTGAGCAGGGAGGATTGCTTGCACTCAGGAGGTCAAGGCTGCAGTGAGCCGAGATCGTGCCACTGCACTCCAGCCTGGGCCACAGAGTGAGACTGTCTCAAAAAAAAAAAA","CTGGGGCAGGAGGATTGCATGAGGCCAGGAGTTTGAGACCAGACTGGGCAACATAGCAAGACCCCATCTCTACAAAAAAATTTTAAAACATAGCTGGACATGGTGGTGCATACCTGTAGTTTCTGCTACTCAGAGGCTGAGGTGTAAGAGGATGGCTTGAGCCCAGGAGTTTGAGATTGCGGTGAGCTATAATTGTGCCATTGCACTGCAGCCTGGGTGACAGAGCGAGACCCTGTCTCAAAAAGAAAAAA"
"chr1","3777507","3777649","chr1","3136850","3137006","24","640657","TAGCTGGGTGTGGTGGTGCCTGTAGTCCCAGCACTTTGGGAGGCTGAGGTAGGAGGATCGCTTGAGCCCAGGGATTTGAGGCTGCAGTGAGCTGTGATGGCATCACGGCACTCCAGCCTGGGTGACAGAGCGAAACCCTATCT","TAGCTGGGTGTGGTGGTGCCTGTAGTCCCAGCACTTTGGGAGGCTGAGGTAGGAGGATTGCTTGGGCCCAGGAGTTTGAGGCTGCAGTGAGCTATGATGGCGCCACGGCACTCCAGCCTAGGTGACACAGCGAAACCCTCTCTGTAGAAAAAAAAAA"
"chr1","3789670","3789965","chr7","125197753","125198061","65","121408083","GGCCAGGCATGGTGGCTCACTCCTAGCACTGTGGGGGGTGGAGACAAGAGGATTGCTTAAGCCCAGGAGTGTGACATCAGCCTGGGCAGCATAGCAAGACCCCAACTCTACAAAAAATAAAAATTAACCATGCGGTAGCAAATGCCTGTAGTCCCAGCTACTAGAGAGGTTGAAGTGGGAGGATTGCTTGAGACCAGGGAGTCGAGGCTGCAGTGAGCCGTGATCACACCACTGCACCGCGGCCTGGGAGACAGAGTGAGACCCTGTCTCACAAAAATAAAATAAATAAATAAAAA","GGCCAGGTGTGGTGACTCACGCCTATCATCCTAGCACTTTGGGGGGGCCAAGGTGGGAGGATTGCTTGAGCCCAGGAGTTCAAGACCAGCCTGGGCAACATAGTGAGACCCCATCTCTACAAAAAAATTAAAAATTGGCTGGGTGTGGTGGCATGTGCCTGTAGTCCAAGCTGCTTGGGAGGCTGAAGTGGGAGGATTGCTTGAGCCCGGGAGTCTGAAGCTGCAGTGAGCCATGATCACGCCACTGCACTCCAGCCTGGGCAATAGATTGAGATCCTGTCTCAAAAAATAAAATAAAGTAAAATAAAA"
"chr1","3805359","3805647","chr1","3167887","3168174","22","637472","GATGTCTCAACACCCGTAATCTTAGCACTTTGGGAGGCCAAGGTGGGTGGATGGCTTGAGCCCAAGAGTTTGAGACCAGCTTGAGCAACGTAGTGAAACCCTATCTCTACAAAAAATTAGCAGGGCGTGTGCCTGTAGTCCCAGTTACTCGGGAGGCTGAGGTGGGAGGACCTGAGCCCAGGGAGACTGAGGCTGCAGTGAGCCCTGATTGCGCCACTGCACTCTAGCCTGGGAGTGCAGTCTCAAAGAAAACCCAGTCTCAAGAAACAAAACAAAACAACCCAAAAAA","CAGTGGCTCACACCTGTAATCTTAGCACTTTGGGAGGCCAAGGTGGGTGAATTGCTTGAGCCCAAGAGTTTGAGATCAGCTTTAGCAATGCAGTGAAACTCCATCTCTACAAAAAATTAGCAGGGTGTGTGCCTGTAGTCCCAGTTACTCGGGAGGCTGAGGTGGGAGGACCTGAGCCCAGGGAGGTTGAGGCTGCAGTGAGCCCTGATTGCGCCACTGCACTGCAGCCTGGGAGTGCAGTCTCAAAGAAAACCCAGTCTCAAAAAATGAAACAAAACACCCAAAAAA"
"chr1","3950713","3950848","chr2","189451666","189451801","33","185500953","TTAACCCAGCATGGTGGTGGGCGCCTGTGATCCCAGCTACTCAGGAGACCGAGATGGGAGGATGGCTTAAGCCCAGGTGGTCAAGGCTGCAGTNAGTTGTGACTGTGCCACTGCACTCCAGCCTGGGCAATGGAGC","TTAGCCCGGCATGGTGGCATGTGCCTGTAATCCTAGCTACCTGAGAGACTGAGCTGGCAAGATCGCTTGAGCCCAGGACTTAAAGATTGCAGTGAGCTATGATTATGCTACTGCACTCCAGCCTGGGTAAAACAGC"
"chr1","3951145","3951284","chr1","3309195","3309336","15","641950","GGCTGGGTGCAGTGCCTCATGACTGTAATCCCAGCACTTTGGGAGGCCAAGGCAGAAGGATCACTTGAGGCCTGGAGTTTGAGACCAGCCTGGAATAACATGGCAAAACCCCAACTCTACAAATAATTTTTTTTAAATGT","GGCTGGGTGCAGCGGCTCATGACTGTAATCCCAGCACTGTGGGAGGCCAAGGCAGGAGGATCACTTGAGGCCAGGAGTTTGAGACCAGCCTGGGGTAACATGGCAAAACCCCAACTCTACAAATAATTAGAAAAAGAAATGT"
"chr1","4003797","4004100","chr1","3351568","3351861","38","652229","GACCTGGTGCAGTGGCTCACACCTGTAATCCCAATTCTTTGGGATGCCAAGGCGGGAGGATTGCTTGAGCCCAGGAGCTCGAGACCAGCCTAGGCAACATAGCATAACTCCATCTCTACAAAAAATTTAAAAAGTAGCCAGGCGTGTTGGTGCATGCCTGTAGTCCCAGCTAGTCAGGAGGTAGAGATGGGAGGATCTCTTGAGCCCAGGAGTTCAAAGCTGAAGGGAACCGTGATCACACCACTGCTCTCCAGCCTAGGTGATAGAGTGAGACTCTGTCTCAAAAAATGAAAACAAAAACAAA","GACCTGGTGCCGTGGTTTATGCCTGTAATCCCAATACTTTGGGATGCCAAGATGGGAGGATTATTTGAGCCCAGGAGTTCAAGACCAGCCTAGGCAACATAACAAGACTCCATCTCTACAAAAAATTTTAAAACTAGCCAGGCGTGTTGGCGCATGTCTGTAGTCCCAGCTAGTCAGGAGGTAGAGGTGGAAGGATCTCTTGAGCCCAGGAGTTCAAAGCTGAAGGGAACCGTGATCACACCATCATTCTTCAGCCTAGGTGATAGAGTGAGACCCTGTCTCAAAAAACGAAAA"
"chr1","4200159","4200462","chr1","3528356","3528663","42","671803","GGCTGTGCACAGTGGCTCACGTCTGTAACCCCAGCACTTTGGGAGGCTGAGGCAGGAGAATTGCTTGAGGCCAGGAGCTTAAGACCAGCCTGGGCAACACAGCAAGAACCCTGTCTCTACAGTAAAATAAAATTAGCCATATATGGTGGCACATACCTGTAGTCATAGCTACTCAAAAGACTGAGGCAGGAAGATCGATTGAGCCCAGGAATTTGAGGCTGCAGTGAGCTACTATCGCACCACTATATGCCAGCCTGGGCAACAGAGCAAGACCTTGTCTCAGAGGGGAAAAAATAAAAGGAAA","GCATGGTGGTTTGTGTCTGTAATCGCAGCACTTTGGGAGGCTGAGGCAGGAGAATTGCTTGAGGCCAGGAATTTACGACCATCCTGGGCAACATAGCAAGAACCCTGTCTCTACAATAAAATAAAATAAAATGAGCCAGATATGGTGGCACATACCTGTAGTCATAGTTAGTCAGTCAAAAGACTGAGGCAGGAATATCGATTAAGCCCAGGAATTTGAGGCTGCAGTGAGCCGTGATTGCACCACCATATGCCAGCCTGGGCAACAGAGCAAGACCTTGCCTCAAAGGGGAAAAAAATAAAAAGAAA"
"chr1","4360694","4360983","chr1","3698501","3698790","31","662193","GCCAGGCTCAGTGGCTCCCATCTGTAATCCCAGCACTTTGGGAGGCCGAGGCAGGAAGATTGCTTGAGTCCAGGAGTTCAAGACAAGCCTGGGCAACATAGGGAGACCTCCCAATGTCTACAAAAAATAAAAAATTAGCCGGGCTTGGTGGTGCATGCCTGTAGTCCCAGCTACTCGGGAGGCTGAGGAGGGAGGATCACTTGAGCCCAGGTATTAAACGCTGCAGTGAGCTATGATCGCACCATTGCATTCCAGCCTGGGTTACAGAGAGAAACCCTGTCTCTAAAAAA","GCCAGGCCCTGTGGCTCACTTCTGTAATCCCAGCACTTTGAGAGGCCGAGGCAGGAAGATTGCTTGAGTCCAGGAGTTCAAGACACGTCTGGGCAACATAGGGAGGCCCCACATCTCTACAAAAAACAAAAATTTAGCCAGGCTTGGTGGTGCATGCCTGTAGCCCCAGCTACTTGGGAGGCTGAGGAGGGAGGATCTCTTGAGCCCAGGAGTTGAAGGCTTCAGTGAGCTGTGACTGCACCATTGCACTCCAGCCTGGGTTACAGAGAGAGATCCTGTTTCTAAAAAAA"
"chr1","4408239","4408529","chr1","3745322","3745629","36","662917","GCTGGGGCAGTGGCTCACACCTGTAATCCCAGCACTTTGGGAGGCCAAGACAAAAGAATTGCTTGAGCTCAGGAGATTGGGACCAGCTTGGGCAACATAGTGAGACATCATCTCTACAAGCAATAATAATTTAAAAAAAAAGCTATGGTGGCACATACCTGTGGTCCTAGCTACACGGGAGGCCGAGGTGGGAGGATTGCTTGAGCCTAGGGTGTCAAAGCTGCAGTGAGCCAAGACCTTGCCACTGCACAACAGCCTGGGTAACACAGAAAGACCCTGTCTCCAAAAAAA","GCCAGGGGCAGTGGCTCACACCTGTAATCACAGCACTTTGGGATGCCAAGGCAAAAGAATTGCTTGAGCTCAGGAGATTGAGACCAGCTTGGGCAACATAGTGAGACCTCATCTCTACAAACAATAATAATTTTAAAAAATAGCTATGGTGGCACACACCTGTAGTCCTAGTTACATGGGAGGCTGAGGTGGGAGGATTGCTTGAGCCTAGGGGGTTGAAGCTGCAGTGAGCCAAGACCTTGCCACTGCACTACAGCCTGGGTAACACAGTAAGACCCTGTCTCCAAAAAAAAAAAAAAAAAAAAAAA"
"chr1","4592487","4592778","chr1","3928185","3928473","27","664302","GACCAGATGTGGTGGCTCATGCTGGTAACCCAGTGCTTTGGGAGGCTGAGGCAGGAGGATTGCTTCAGGCCAGGAGTTCAAGACTAGCCTGGGCAACAGAATGAGACCATGTTCGTACAAAAAATTTAAAAATTAGATGGGCATGGTGCCTGCGCCTGTATTCCCAGCTACTCAGGAGGCCAAGGAAGGAGGATTGCTTGAGCCCAGGAGTTTGAGGCTGTAGTGAGCTATGATTGTGCCAATGCACTCCAGCCTGGGTGACAGAGCAAGACCCTGTCTCGAAAGAAAGAAA","GACCAGACGTGGTGGCTCATGCAGGTAATCCAGTGCTTTGGGAGGCCAAGGCAGGAGGACTGCTTCAGGCCAGGAGTTCAAGACTAGCCTGCGTAACAGAATGAGATCATGTTCCTACAAAAAATATTAAAAATTAGATGGGCATGGTGCGTACGCCTGTATTCCCAGCCACTCAGGAGGCTGAGGAAGGAGTATCACTGGAGCCCAGGAGTTTGAGGCTGTAGTGAGCTATGACTGTGCCACTGCACTCCAGTCTGGGTGACAGAGCAAGACCCTGTCTGGAAAGAAA"
"chr1","4614405","4614700","chr10","12389093","12389387","65","7774688","GGCAGGGTATGGTGGCTCACACCTGTAATGCCAGAACTTTGGGAGGCCAAGGCAGGAGGATGGATCACTTAAGCCCAGCAGTTAGAGACCAGCCTGGACAACATAGCAAGACCCTGGACTCTAATTAAAAAAAATTAGCCAAGAGTGGTGGCACTGGCCTGTAGTTCCAGCTACCCAGGTGGCTCAGGTGGGAGCACTGCTTGAGCCCAAGAACTGAAGGCTGCAGGAAGTTGTGATTGCACCATTGCACTCAGCCTGGGTGACAGAGCAACACTCTGTCTCAAAAAAAAAACAAA","GGCCGGGCGTGGTGGCTCACACCTGTAATCCCAGCACTTTGGGAGGCCTAGGCAGGAGGATCACTTGAACCTAGGAGTTTGATACCAGCCCGGGCAACATAGTGAGATCCCATCTCTACAGAAAATAAAAATTAGCCAAGCATAGTGGTGTGTGCCTGTAGTCCCAGCTCTACTCAGAAGGCTGAGGTGGGAGGACTGCTTGAGCCTGGGAGTTTGAGGCTGCAGTGAGCTGTGATTGCACCTTGCACTCCAGCCTGGGTGACAAAGCGAGACCTTGTCTCAAAAAGAAAGAGAA"
"chr1","4744326","4744642","chr1","4070505","4070817","31","673821","GGCCAGGTGCAGTGGCTTATGCCTATAATCCCAGCACTTTGGGAGGCCAATGTGGGAAGATAGCTTGAGGCCAGGAATTCAAGACCAGCCTGGGCAACATAGTGAGACCTGGTCTCTACCACAAAAAGCATGAAAATTAGCTGGGCATGGTGGCATGCACCCACAGTCCTAGCTACTCAGGAGGCTGAGGTGGGAAGATCGCTTGAGCCCAGGAGTTCCAAGCTGCAGTGAGCTATAATCTCGCCACTGATCCCCAGCCTCGGTGACAGAGCAAGACCATCTCTAAAAAGAAAGCAAAAGCAAAAAGCAAAACAAAA","GGCCAGGTGCAGTGGCTCATGCCTATAATCCCAGCCCTTTGGGAGGCCGATGTGGGAAGATTGCTTGAGACCAGGAAGTCAAGACCAGCCTAGGCGACATAGTGAGACTTGGTCTGTACCAAAAAAAAAGTATGAAAATTAGCTAGGCATGGTGGCATGCACCCACAGTCCTAGCTACTTGGGAGGCTGAGGTGGGAAGATAGCTTGAGCCCAGGAGTTCCAAGCTACAGTGAGCTATAATCATGCCACTGCTCCCCAGCCTCGGTGACAGATCTAGACCATCTCTAAAAAGAAAGCAAAAACAAAAAGCAAA"
"chr1","4758631","4758932","chr2","95955285","95955580","58","91196654","GGCCAGTCACAGTGGCTCACGTTTGTAATCCCAGCACTTTGGGAGGTCGAGGGGGGAGGATCACTTGAGGCCAGGAGTTCCAGACCAGCCTGGCCAGCACAGCTAGACCCCACCTCTACAAATAAAACAAAACAAACAAAAAATTAGCCAGGCATGGTGGTGCGTATCTGTAGTCCTAGCTACTAGGAAGGCTGAGGTGGGAGGATCACTGGAGCCCAGGAGTTCAAGGCTGCAATGAGCCATGATTATGCTACTGCACTTCAGCCTGGGTGACAGGGTGAGACCTCAACTCTACAAATAAA","GGACAGGCACAGTGGCTCACGCCTGGAATCCCAGCACTTTGGCAGGTTGAGGCAGGAGGACCACTTGAGGCAAGGAGTTTGAGACCATTCTGGGCAGCATAACAAGATCTCATCTCTACAAGAAAAAAAAAATACAAAAATTAGCGGGGTGTGGTGGTGCACACGTGTAGTCCCAACTACTCCGAAGACTGAGGCGGGAGGATCCCTTGAGCCCAGGAGTTCAAGGCTGCAGTGAGCTATGATAGCGCCACTGCACTCCAGCCTAGGTGACAGAGTGAGATCTCATCTCTAAAAAA"
"chr1","4772658","4772954","chr1","4100499","4100800","21","672159","GGCTGGGTGTGGAGGCTCACGTCTGTTCTCCCAGTGCTTTGGCAGGCTGAGGTGGGAGGATCCCTTGAGCCTAGGAGTTCAAGACTAGCCTGGGCAACATAGTGAGACCCTTTCTCTACAAAAAACAAAAAATTAGCTGTGCATGGTGACATGCTCCTGTAGTCCCAGATACTCAAGAGGCTGAGGTGGGAGGATCACTTGGGCCCAGGAGTTTAAGGCAGGCTGCAGTCAGCTGTAATCGTGCCACTGCACCCAGCCTAGGTGACAGAGTGAGACCCTGTCTCAAAAACAAACAAA","GGCTGGATGTGGAGGCTCAGGTCTGGACTCCCAGTGCTTTGGGAGACTGAGGTGGGAGGATCCCTTGAGCCTAGGAGTTCAAGACCAGCCTGGGCAACATAGTGAGACTCCTTCTCTACAAAAAATAAAAAATTAGTTGTGCATAGTGACATGCTCCTGTGGTCCTAGATACTCAAGAGGCTGAGGTGGGAGGATCACTTGGGCCCAGGAGTTTAAGGCAGGCTGCAGTCAGCTGTAATCGTGCCACTGCACCCAGCCTGGGTGACAGAGTGATACCCTGTCTCAAAAACAGACAAACAAAA"
"chr1","4802731","4803038","chr1","4131757","4132050","26","670974","CCAGGCATGGTGACTCATGCCTGTAATCCCAGCAGTTTGGGAGTCTGAGGCAGGAGGATCACTTGAGGCCAGGAGTTCAAGAGCAGCCTGGACAACATAGTGAGGCCCCATGTCTACAAAAAATTAAAACAAAGTAGCTGGGCATAGTGGCATGCACCTGTAGCCCCAGCTACTCTGGAGGCTGAGGTGGGAGGATCACTTGAACCCAGGAGTTCGAGGCTGCAGTGAGCTATAATTGCACCATTGCATTCCAGTCTGGGCAACAGAGCAAGACTTCATCTCAAAAACAAACAAACAAACAAACAAAA","GGTGGCTCATGCCTGTAATCCCAGCAGTTTGGGAGTCTGAGGCAGAATGATCACTTGAGGCCAGGAGTTCAAGACCAGCCTAGACAACATAGTGAGGTCCTATGTCTACAAAAAATAAAAATAATGTAGCTGGGCATAGTGGCATGCACCTGTAGCCCCAGCTACTCTGGAGGCTGAGGTGAGAGGATCACTTGAGCCCAGGAGTTCAAGGCTGCAGTGAGCTATAATTGCACCATTGCATTCCAGTCTGGGCAACAGAGCAAGACTTCATCTCAAAAAAAAAAAAAAAAAAAA"
"chr1","4882619","4882892","chr1","4204217","4204491","16","678402","TGGCTCGTTCCTGTAATCCCAGCACTTTGGGAGGCTTAGGTGGAAGGATTGCTTAAGGCCAGGTGTTCAATCTAGCCTGGGTAACATAGTGAGACCCCCATTTCTAAAAAAATTTTAAAAATTATCTGGGCATGGTGGTGCATGCCTGTAGTCCCAGCCACTTGGGAGACTGAGGTAGGAGGATTGCTTGAGTCTAGGAGTTTGAGGCTGCAGTGAGCTATGATCTTGACACTGCACTCCAGCAGGACAACAGAGCAAGACCCTGTCAAAAAAA","TGGCTCGTTCCTGTAATCCCAGCACTTTGGGAGGCTTAAGTGGAAGGAGTGCTTAAGGCCAGGTGTTCAAGTCCAGCCTGGGTAACACAGCGAGACCCCCATTTCTACAATAAATTAAAAAAATTACCTGGGCATGGCGGTGCATGCCTGTAGTCCCAGCCACTTGGGAGACTGAGGTAGGAGGATTGCTTGCACCTAGGAGTTTGAGGCTGCAGTGAGCTATGATCTTGACACTGCACTCCAGCAGGACAACAGAGCAAGACCCTGTCAAAAAA"
"chr1","4887923","4888197","chr11","1767086","1767360","59","3120837","GGCTAGGCATGGTGGCTCACGCCTGTAATCCCAACACTTTGGGAGGCCAAGACTAGAGTATCGCTTGAGCCCAGAAGTTCAAGACCAGCCTGAGCAACATAGGGAGACTTCTTCTCTACAATGGTAGTGCACATCTGTGGTCCCAGCTACTTGGGAGGCTGGAGGTGGGAAGATCACTTCAGTCCTAGAGATGGAGGCTACAGTGAGCCATGATCATGCCACTGCACTCCAGCCTGGATGACAGAGACATCCTGTCTCAATTTAACAACAAAAAA","GGCTGGGCATGGTGGCCTACACCTGTCATCCCAGCACTTTGGGAGGCCGAGGCGGGAGGATCACTTGAGTCCAGGAGTTCAAGACCAGCCTGAGCAACATAGTGAGACCCTTTTAAAAATAACCAGTGTGGGCACACCTGTAGTCCCAGCTACTTGGAAGGCTGAGGTTGGAGGTTTGCTTGAGTCCAGGAGGTTGAGGCTGCAGTGAGCCATGATCAAGCCACTGCACTCCAGTCTGGGCAACAGAGCAAGATCCTGTATTCAAAAAAAAAAAA"
"chr1","5030144","5030388","chr1","4345286","4345537","19","684858","TTCAGGAGGCTGAGGCAGGAGGATAGCTTGAGCCCAGGAGTTCAAGACCAGCCTGGGCAACATAGGGAGACCCTGTCTCTACAAAACACATTTAAAAATTAGTCAAGCATAGCAGCACATGCTTGTGGTCACAGATACTCAGGAGGCTGAGGTAGGAGGATTGCTTGAGCTCAGGAGTTCAAGGCTGCAGTGAGCTGTGATCACACCTGGGGAACAGAACAAAACCTTGTCTCAAAAAAAAAAAA","TTTAGGAGGCTGAGGCAGGAGGATAGCTTGAGCCCAGGAGTTCAAGACCAGCCTGGGCAACATAGGGAGACCCTGTCTCTACAAAACACATTTAAAAATTAGTCAGGCATAGAAGCACACGGCTGTGGTCCCAGATACTCAGGAGGCTGAGGTAGGAGGATCGCTTGAGTTCAGGAGTTCAAGGCTGCAGCGAGCTGTGATCACACCTGGGGAACAGAACAAAACTCTGTCTCAAATAAAAAAAAAAAAAAA"
"chr1","5047834","5048123","chr1","4362229","4362517","26","685605","GGCTGGGTGTGGTGGCTCAGGCCTGTAATCCCAGCACTTTGGGAACCCAAGGTGGTAGGATTCCTTGAGACCAGGATTTCAAGACTAGCCTAGGCAACACAGCAAGACCCTGTCTCTATAAAAAATAAATAAGTAGCCAGGTGCGGTGGCACGTGTCTGTATTCCTATCTACTTAGGAGGCTGAGGCAGAAGGATCACTTGAACCCAGGAGTTCGAGGCTGCAGTGAGCTATGATTGCACCATTGCACCCCCACCTGGGTAACATAATGAGACATTGTCTATAAAAAAAA","GGCTGGATGTGGTGGCTCATACCTGTAATCTCAGCACTTTGGGAACCCAAGGTGGCAGGATTCCTCGAGGCCAGGATTTCAAGACTAGCTTAGGCAACACAGCAAGACCCTGTCTTTATAAAAAATAAATAATTAGCCAGGTGCGATGGCACATGTCTGCGGTCCTATCTGCTTAGGAGGCTGAGGCAGAAGGATCACTTGAACCCAAGAGTTTGAGGCTGCAGTGAGCTATGATGGCACCATTGCACCCCAGCCTGGGTGACAGAATGAGACACTGTCTATTAAAAAA"
"chr1","5778644","5778953","chr1","4884638","4884942","29","894006","GGCAGGGCTTGGTGGCTTATGCCTGTAATCCCAGCACTTTGGGAGGCTGAGGCAGAAGGATCACTTGGGGCCAAAAGTTCAAGACCAGCCTAGGCAACATAGCAAGACCCTGCCTCTATAAAAAAATTAAAAATTAGCCAGGTATAGTGTAATGGAGCTGTAGTCCCAGTTACTAGGGAAGATGAGGTACGAGGATCCCTTGAGCCCAAGTGGTCAAAGTTGCAGTGAGCCATGATCACAGCACTGCACTCCAGCCTAGGTGACAGAGAGAGACCCTGTCTCAAAAAAATAAATAAATAAAATAAATAAA","GGCAGGGCTTGGTGGCTCATGCCTGTAATCCCAGCACTTTGGGAGGCTGAGGCAGAAGGATCACTTGGGGCCAAAAGTTCAAGACCAGCCCGGGCAACATAGCAAAATGCTGCCTCTATAAAAAATTTAAAAATTAGCCAGGTATAGTGGCATGCACCTGTAGTCCCAGCTACTAAGGAGGATGAGGTAGGAGGATCCCTTGAGCCCAGGAGGTCAAAGCTGCAGTGAACCACGATCACACCACTGCATTCCAGCCTAGGTGACAGAGACAGACCCTTTCTCAAATAAATAAATAAATAAATAAA"
"chr1","5788723","5789021","chr1","4893735","4894039","30","894988","GGTGGCTCATGCCTGTAACTTCAGCACTCTGGGAGGCTAAGGCAGGAGAATGGCTTGAGACCAGAAGTTCTTGACCAGCCAGGGCAACATAGTGAGACCCTGTCTCTACAAAAAAAACAAAAATTTAATTAAAACATTAGCCAGGCGTGGTGTGCATACCTATAGTCCTAGCTACTCAAGAGGCTGAGGTGGGAGGGTGGCTTAAGCCCAGGAGTTTGAAGCTACAGTGAGCTATGATCATGCCACTGCAGTCCAACCTGGGTGACAGAGCAAGATCCTGTCCTTTAAAAAAAAAAAAA","GGTGGCTCATGCCTGTGACTTCAGCACTCTGGGAGGCCAAGGTGGGAGAATGGCTTGAAGCCAGAAGTTCTAGACCAGCCAAGGCAACATAGTGAGACCCTGTCTCTAAAAAAAAAAAAAAATTTAATTAAAACATTAGCCACGTGGCAGTGCATACCTATAGTCCTAGCTACTCAAGAGGTTGAGGTGGGAGGGTGGCTTAAGCCCAGAAGTTTGAAGCTACAATGAGCTATGATCATGCCACTGCAGTTCAACCTGGGTGACAGAGCAAGACCCTATCCCTCCGCCAAAAAAAAAAAAAAAAA"
"chr1","5851836","5852078","chr1","4955551","4955794","25","896285","GGCTGGGTGCGGTGGCTCATGTCTATAATCCCAGCCTTTTGGGAGGCCGAAGTGGGAGGATTGCTTGAGCCCAGAAGTTCAAGACTAGCCTGGGCAACATGGTGAGACCCTCGTCTTTACCGAAAATGAAAAAAATATCCGGGCATGGTGGTGTGCACCTGTGGTCCCCGCTGAGGTGGGAGGATAGCTCGGACTCAGGAGTTTGAAGTTACAGTGAGCTATGACTGCAGTACTGCACTCTAG","GGCTGGGCGCGGAGGCTCATGTCTATAATCCCAGCCTTTTGGGAGCCCGAAGTGGGAGGACTGCTTGAGCCCAGAAGTTCAAGACTAGCCTGGGCAACATGGTGAGACCCCCGTGTCTACCAAAAATAAAAAAAAAAATCTGGGCATGGTGGCATGCACCTGTGGTCCCAGCTGAGGTGGGAGGATGGCTTGGACTCGGGAGTTTGAGGTTCCAGTGGGCTGTGATTGCAACACTGCACTCTAG"
"chr1","5934783","5934958","chr1","5036188","5036389","33","898595","AGTAAATAAATGCATACAGTAGCTGGGTGTGGTAGCATGTGCCTGTAGTCTCAGCTACTTGGGAGGCTGAGGCAGGAGAATTGCTTGAACCCAGGAATTCGAGGCTGCAGTGAACTATGATCACGTCACTGTACTCTAGCCTGGGCATCAGAGCCAGACTTTGCCTCTAAAAAAAA","AGCTAGCTAGCTAGCTAGATAGATGCATGCAGTAGCTGGGTGTGGTAGCATGTGCCTGTAGTCTCAGCTACTTGGGAGGCTGAGGCAGGAGGATTGCTTGAACCCAGGAGTTTGAGGCTGCAGTGAGCTATGATCACATCACTGTACTGTAGCCTGGGCATCAGAGCCAGACTTTGCCTCTAAAAAACAAAAACAAAAAAAA"
"chr1","5935269","5935398","chr1","5036669","5036794","16","898600","GGCCGGGCGCAGTGGCTCATGCCTATAATCCCAGCATGTTGGGAGGCTGAGGTGGGAGGATGGCTTGAAGCCAAGAGTTCGAGATCAGCCTGGGTAACATGGCAAGGCCCTGACTCTACAAAAAACTTAA","GGGCGCAGTGGCTCACACCTATAATCCCAGCACGCTGGGAGGCTGAGGTGGGAGGATGGCTTGAGGCCAAGAGTTTGAGACCAGCCTGGGCAACATAGTAAGACCCTAACTCTACAAAAAACTTAA"
"chr1","5946874","5947161","chr1","5049800","5050075","29","897074","GGTATGGTGACTCACGCCTATAATCCCAACACTCTGGGAGGCCAAGGTAGGAGGATCCCTTGAACCCAGGAGCTCAAGATGATCCCAGGAAACACAGCAAGACCTCAACTCTACAAAAATTAAAAAATTACCCAGGCATGGTGGCACATGCCTGTAGTCCTAGCTACTCAGGACACTGAGGTGTGAGGATTGCTGGAGCATAGGAGTTCAAGGCTGCAGTGAACTATGATCGTGCCACTGCACTCCAGCCAGGGCAACAGAGTAAGACCCTGTCTCAAAAAAAAAAAA","GGTATGGTGACTCACGCCTATAATCCCAACACTTTGGGAGGCCAAGGTGGGAGGATCCCTTGAACCCAGGAGCTCAAGATCATCCTGGGCAACACAGCAAGACCTCAACTCTACAAAAATTAAAACATTAGCCAGGCATGGTGGCACATGCCTGTAGTCCTAGCTACTCAGGATGCTGAGGTGTGAGGATCGCTTGAGCCTAGGAGTTCAAGGCTGCAGTGAACTATGATGATGCCACTGCACTCCAGCCAGGGCAACAGCGTAAGACCTTGTCTC"
"chr1","5983456","5983763","chr1","5086241","5086541","37","897215","GCCGGGTGCAGTGGCTCACACCTGTAATCCCAACACTTAGAGAGGCTGAGGTGGGCAGATTGCTTAAGGCCAGGAGTTTGAAACCATCGTGGGCAACATAGTGAGACCCCATCTCTACAAAAAAATACAAACATTAACTGGGTATGGCGGTGCGCCCCTGTGGTCATAGCTACTTGGGAGGCTGAGGTGGGTAGGATTGCTGAGCCCAGGAGTTTTAGGTCGTGCAGTGAGCCATGATTGTCACCACCTGCACTCCAGCCTGGGCGGGCGGTGAGACCCTCGCCTCCAAAAAAAAAAAAAATAAAAAA","GCCGGGTGCAGTGGCTCACACTTGTAATCCCAACACTTTGAGAGGCTGAGGTGGGCAGATTGCTTGAAACCAGGAGTGAGACCACCCTGGGCAACATAGTGAGACCGCATCTCTACAAAAAATACAAAAATTAACTGGGTGTGGTGGTGCGCCCCTGTGGTCATAGCTACTTGGGAGGCTGAGGTGGGAGGATTGCTTGAGCCCAGGAGTTTGAGGCTGCAGTGAGCCATGATTGCACCACTGCACTCCAGCCTGGGTGACAGTGAGACCCTGTCCCCACCCCCCAAAAAAATACATAAAA"
"chr1","5992315","5992502","chr1","5094992","5095186","19","897323","ACCCCAGCTCTACCAAAATAAAAACATTTAGCTGGGTCTGGTGATGCATGCCTGTAGTCCCAGCTACTTGGGAGGCTGAGGAGGGAGGATCACTTGAGCCCAGGAGTCCAAGGCTGCAATGAGCTATGATTGCACCATTGCACTCCAGCCTGGGCAACATAGTGAGACCCCATCTCTTAGAAAAGAAA","ACCCCAGCTCTACCAAAATAAAAAAAATTGAGCTGGGTGCAGTAGTGCATGCCTGTAGTCCCAGCTACTTGGGAGGCTGAGGAGGGAGGATCACTTGAGCCCAGGAGTCCAAGGCTGCAATGAACTAGGACTGTACCATTGCACTCCAGCCTGGGCAACAAAGTGAGACCCCATCTCTTAAAAAAGGAAAAGAAA"
"chr1","6037014","6037326","chr1","5139902","5140238","44","897112","GGCTGGGCGCAGTGGCTCATGCTTGTAATCCCAGCACTTTGGGATTGGGAGGCTGTGGTGGGAGGATTGCTTGAGCTGAGTTCAAAACCAGCCTGGGCAACACAGTGAGACACCTTTTCTACAAAATTACAAAAAAATTAGTTGGGTGTGGTTTACAGCTATGGGATTACAGGTGGGTGCCTGTAGTACCAACTACTTGCAAGGCTCAGGTGGGAAGACTGCTTGAGCCTGGCAGGTCAAGGCTGCAGTCGCCTATGATCACACTATTGCATTCCCGCCTAGGCAACTGAGTGAGATCTTGTCTAAAAAAAAA","GGCTGGGTGCAGTGGCTCGTGCTTGTAATCCCAGCACTTTGAGATTGGGAGGCTGTGGTGGGAGGATTGCTTGAGCTCAGGAGTTCAAAACCAGCCTGGGCAACACAGTGAGACATCTTCTCTACAAAATTACAAAAAAATTAGCTGGGTGTGGTTTACGGCTATGGGATCACAGGTGTGCGCCTGTAGTACCAACTACCTGGGAGGTTCACGTGGGAAGACTGCTTGAGCCTGGCAGGTCAAGTCTGCAGTCACCTATGATCACACTATTGCACTCCCACCTAGGCAACTGAGCGAGATCTTGTCTCAAAATAAAATAAAATAAAATAAAATAAAA"
"chr1","6038099","6038413","chr1","5141024","5141339","40","897075","GACTGGGCACAGTGGTTCACACCTGTAATCCCAGCACTATGGGAGGCTGAGGCAAGAGGACAGTGTAAGGCCAAGAGTCTGAGACCAGCCTGGGCAACATAACAAGATTCTGTCTCTACAAAAAATTATAAAATTAGCCGGTGGGGGGGGGTGGCACACACATGTAGTTCCAGCTACTTGGGAGGCTGAGGCAGACGGATCACTTGAGCCCAGGAGTTCAAGGCTGCAGTGAGCTGTGATCATGCCACTGTACTCCAGCCTGGGCAACAGAGTAAGTTCCCTTCTCCTAAAAAAAATTAAATGAAATAAATAAAA","GGCACAGTGGTTCACACCTGTAATCCCAGCACTTTGGGAGGCTGAGGCAAGAGGACAGTGTAAGGCCAGGAATCTGAGACCAGCCTGGACAACATAGCAAGACTCTGTCTCTACAGAAAAATTTTAAAATTAGCCGGGGGTGGTGGCACACACATATAGTTCCAGCTGCTTGGGAGGCTGAGGCAGACAGATCACTTGAGCCCGGGAGTTCAAGGCTACAGTGAGCTGTGATCGTGCCACTGCACTCCAGCCTGGGCAACAGAGCAAGTGCCCTTCTCAAAAAAAAAAATTGAATGAATTAAATAAAACAAAAAAA"
"chr1","6042128","6042304","chr19","28356007","28356185","33","22313879","TTAGTCATTCATGGTGGTGCATGCCAGTGGTCCCAGCTATTTAGGAGGCTGAGGTGGGAGGATCCCTTGAGCCCAGGAGTTTGAGGCTACAGTGAGTTATGATCATGCCACTGGACTCCAGCCTGGGCAACATAAGAAGACCCACCTCTATAAATAAATAGGTAAAGAAAAATAGAA","TTAGCAAGGCATGGTGGTGCATGACTGTGGTCCCAGCTACTTGGGAGGCTGAGGTAGGAGGATCACTTGAGCCCAGGAGGTTGAGGCTGCAATAAGCTATGATCATGCCACTGCACTCCAGCCTGGGCAACAGAGCGAGACCCTGTCTCAAAAAAAAAAAAAAAGAAAGAAAGAAAGAA"
"chr1","6042603","6042743","chr1","5145796","5145928","20","896807","GGCTGGGTGCGGTGGCTCACACCTGTAACCCAGCACTTTGGAGGCCAGGGTGGGAGGATTGCTTGAGGCCAGGAGTTCGAGACCAGTCTGGGCAACATAGTGAGACCCAATCTCTAACAAAAATTTAAAAATTAGCCTGGC","GGCTGGGTGTGGTGGCTCACACCTGGAGCTGGAGGCCAAGGTGGAAGGACTGCTTGAGGTCAGGAGTTTGAGACCAGTCTGGGCAACACAGTGAGACCCAATCTCTAACACAAAATTTAAAAATTCGCCAGGC"
"chr1","6050436","6050739","chr11","107411569","107411871","57","101361133","GGCCAGGTGCAGTGGCTCACGCCTGTAATCCCAACCCTTTGGGAGACTGAGGCAGGAGGATGGCTTGAGCCCAGGAGTTTGAGACTAGCCTGGGCTGCAGAGTAAGGCCTCATCTCTAATTAAAAAAAAAAAAAATAGCCAGGCTGGGTGGCACACATCTCTGATCCCAGCTAATTGGGAGGCTGAGGTGGAAGGATCCCTTGAGCCCCATAGGTCAGGGCTGCAGTGAGCCGTGATCATGCCACTGCACTCCAGCCTGGGGAACAAAGCAAGACCCTGTCTCAAAAAAAGAAAGAAAGAGAGA","GGCCAGGTGCAGTGACTCACACCTGTAATCCCAGCACTTTGGGAGGCTGATGCGAGGGGATTGCTTGAGCCCAGGAGTTTGAGACCATCTTGGGCAACATAGTGAGACTTTGTCTCTACAAAAAATAAAACAAAATTAGCCAGGTATGGTGGCACGCACCTGTAGTCCCAGCTACTCGGAAGGCTGAAGTGGGAGGATTCCTTGAGCACTGGAGGTCAAGACTGCAGTGAGTCATGATCACGCCTCTGCACTCCAGCCTGGGTGACAGAGCAAGATCCTGTCTCAAGAAAAGAAAGAAAGAAA"
"chr1","6159033","6159156","chr1","5260890","5261020","16","898143","GGCCAGGTGCGGTAGCTCACGCCTGTATTCCCAGTACATTGGGAGACTGAGGCAGGAGGATTGCTTGAGGCCGGGAGTTTGAAGCCAGCCTAGTTAACATAGAGAGATCTCTCTCCAAAAGACA","GGCCAGGTGCGGTGACTCATGCCTGTATTCCCAGTACATTGGGAGACTGAGGCAGGAGAATTGCTTGAGGCCAGGAGTTTGAAACCAGCCTGGTTAACATAGTGAGATCTCCTCTCTCCAAAAAACAAAAA"
"chr1","6215676","6215963","chr1","5321344","5321635","23","894332","GGCTGGGTGCAGTAGCTCACACCTGTAATCCCGGCACTTTGGGAAGCCAAGGCAGGAAGATTGCTCAAGCCCAGGAGTTCAAGACAAGCCTGGGCAACTTAGGAAGACCCTTCCTCTACAAAAAAATTTAAAAATTAGCTAGGTATGGTGGTGCATGCCTGTGGTGCCAGCTATTCCAGAGGCTGAGGTGGGAGGATCACTTGGGCCTATGAGGTTGAGGCTGCAGTGAGCCAGGATCATGCTACTGCCCTCCAGCCTGGACAACAGACCCTTTCTCAAAAATAAAAA","GGCTGGGTGCAGTAGCTCATGCCTGTAAACCCGGCACGTTGGGAAGCCAAGGCAGGAAGATCGCTTGAGCCCTCAAGTTCAAGACAAGCCTGGGCAACTTAGTTGGAAGATCCTTTTTCTATAAAAGAATTTAAAAATTAGCTCAGTATGGTGGTGCATGCCTGTGGTCCCAGCTATTCCAGAGGCTGAGGTGGAAGGATCACTTGGGCCTATGAGGTTGAGGCTGCAGTGAGCCAGGATCATGCTACTGCCCTCCAGCCTGGACAACAGACCCTTTCTCAAAAAATAAAAA"
"chr1","6216689","6216981","chr1","5318510","5318798","19","898179","GGCTGGGCACAGTGGCTTATGCTTGTAATCCCAGCACTTTGGGAGGGTGATACAGGAGTATTGCTTGAGCCCAGGAGTTTGAGACCAGCCTGGGCAACATAGTGAGACCCCCATCTCTACAAGAGTTAAAATTAGCTGGGCATGGTGACATGTGCCTGTAGTCCAGCCACTTGGGGAGCTGAAGTGGGAGGATGGCTTGAGCCCAGCAGGTTAGGGTTCTAATGAGCTGTGATTGTGCCACTGCAGGCCAGCCTGGGTGACACAGTGAGACCCTATCTCAATTAAAAAAAAAA","GGCTGGGCACAGTGGCTTATGCTTGTAATCCCAGCACTTTGGGAGGCTGATACAGGATGATTGCTTGAGCCCAGGAGTTTGAGACCAGCCTGGGCAACATAGTGAGACCTCCGTCTCTACAAGAGTTAAAATTAGCTGGGCATGGTGACATGTGCCTGTAGTCCAGCCACTTGGGGGGCTGAAGTGGGAGGATGGCTTGAGTCCAGGAGGTCAGGGTTGTAATGAGCTGTGATTATGCCACTGCAGGTCAGCTTGGGTGACAGAGTGAGACCCTATTTCAAAAAAAAAA"
"chr1","6224353","6224657","chr1","5333795","5334106","26","890558","GGCTGGGCGCAGTGGCCCACACCCGTAATCCCAGCACTTTGGGAGGCCAGCGTGCGTGAATCTCTTGAGCCCAGGAGTTCAAGACCAGCTTGGGCAACATAGCAAGACTCCCCCCTCTATAAAAAATACTAAAACTTAGCTGGGCATGGTGGCTCGTGCTTGTAGTCCCAGCTACTTGAGAGGCTGAGGTGGAAGGATTGCTTGAGCCAGGAGGTTGAGGCTGCAGTGAGCTGTGACTGCAACTCTGCAGTCCCACCTGGGTGATAGAGTAAGACCCTGTCTCGAAAGAAAAACAAAAAAGAAAA","GGCTGGGCATAGTGGCTCACACCCGTAATCCTAGCACTTTGGGAGGCCAGCGTGGGTGAATCTCTTGAGCCCAGGAGTTCGAGACCAACTTGGGCAATATAGCAAGACTCCCCCTATCTATAAAAAATACTAAAACTTAGCTGGGCATGGTGGCTCCCGCTTGTAGTCCCAGCTACTTGAGAGGCTGAGGTGGAAGGATCGCTTGAGCCAGGCGGTTGAGGCTGCAGTGAGCTGTCACTGCACCTCTGCAGTCCCACCTTAGGTGACAGAGTAAGACCCTGTCTGAAAAGAAAAACAAACAAAAAAAGAAAA"
"chr1","6227266","6227534","chr20","20626690","20626960","56","14399424","GGCTGGGTTCAGTGGCTCACACCTGTAATCCCAGCACTTTGGGAGGCCAAGGTGGGTGGATCACCTGAGGTCAGGAGTTCGAGACCAGCCTGGTCAACATGGCGAAACCCCGTCTCTACTAAAAATACAAAAAATTAGCCGGGCATGGTGGTGCGCGGCTGTAGTCCCAGCTACTTGGGAGGCTGAGGTGGAAGGAAGCCAAGGCTGCAGTTAGATATGATCACGCGGCGACAGAGTGAGATCCTGTCTTAAACAAAACAAAACGAAAA","GGCCAGGCGCCGTGGCTCACACCTGTAATCCCAGCACTTTGGGAGGTCAGGGAGGGTGGATCACCTGAGGCCAGGAGTTTGAGACCAGCCTGGGCATCATGACAAAACCCCGTCTCTACAAAAAATACAAAAAAGATTAGCTGGGTGTGGTGGCGCGTGCCTGTAGTCCCAGCTACCTGGGAGGCTGAGATGGGAGGATCACCTGAGACTGGGCAATCGCTGTACTCCAGTCTGGGCAACAGAGTGAGACCCTATCTTTAAAAACAAAAAA"
"chr1","6316368","6316568","chr4","167948312","167948510","46","161631944","GTGAGCCGCTGTCTCTACAAAAAATACAAAATACAAAAATTAGCTGGTTGTGGTGGTGCATGTCTGTAGTCCCGGCTACCTGGGAGGCTGAGGTGAGAGGATTGCTTGAGCACGGAAGTGCAAGGCTACAGTGAGCAGGGATTGCAGCACTGTACTCCGGCCTGGGTGACAGAATAAGATCGTGTTGTGGAAAAAAGAAAA","GACCCCATCTCTACAAAAAATTTAAAAAGTCAAAAAATTAACTGGGTATGGTGGCGCACACCTGTAGTCCCAGCTACTTGGGAGGCTGAGGTAAGAGGATTGCTTAAGCCCAAGAGTTCAAGGCTTCAGTGAGCCGTGATTGTGCCACTGCACTCCAGCCTGGGTGACAGAGCAAGACCCTGTCAAAAAAAAAAAAAAA"
"chr1","6363650","6363831","chr1","5479559","5479740","7","884091","AAAAAAAAGTTAGGTGTGGTTGCATGTGCCTGTAGTCGCAGCTACTCAGGAGGCTGAGGCTGGAGGATCGCTTGAGCCCAGGAGGAGTTTGAGGCTGCAGTGAGCATGATTGTGCCTGTGAATAGCCATTGCATTCCTGCCTGGGCAACACAGCGAGGTCCTGTCTCTATAAATGATAATAA","AAAAAAAAGTTAGGTATGGTTGCATGTGCCTGTAGTCGCAGCTACTTAGGAGGCTGAGGCTGGAGGATCACTTGAGCCCAGGAGGAGTTTGAGGCTGCAGTGAGCATGATAGTGCCTGTGAATAGCCATTGCATTCCTGCCTGGGCAACACAGCAAGGTCCTGTCTCTAAAAATAATAATAA"
"chr1","6403519","6403833","chr1","5526863","5527183","33","876656","GGGTATGGTGACTCATGCCCACAATTCCAGCACTTTGGGAGGCCGAGGTGGGAAGATCACTTGAGCCCAGGAGTTCAAGACCCACCTGGGCAACAAAGTGAGATCATGTCTCTACAAAAAATCTTTTTAACATTAGCCAGGCACAGAGGCGTGCACTCGTAGTTCCAGCTACTCGAGAGGCTGAGGTGGGAGAATCCCTTGAGCCCAGAAGGTCGGGGCTGCAGAGAACCATGATTGCACCACTGCACCACTTAGTTGCCTGGCCAACTAAGCGAGACCCTGTCTCAAATAAAAATAAAAACCACAAAACAAAGA","GGGCATGGTGACTCATGCCCATGCCCATAATTTCAGCACTTTGGGAGGCCAAGGTGGGAAGAGCACCTGAGCCCAGGAGTTCCAGACCCGCCTAGGCAACAAAGTGAGACCATGTCTCCGCAAAAAAAACTTATTTTAACATTAGCCAGGCCCAGAGGCATGCACTCATAGTCCCAGCTACTCGAGAGGCTGAGGTGGGAGAATCCCTTGAGCCCAGGAGGTTGGGGCTGTAGAGAACCATGATTGCACCACTGCACCACTTAGTTGCCTGGGCAACTAAGCGAGACCCTGCCTCAAATAAAAATAAAAACCACAAAACAA"
"chr1","6420273","6420565","chr1","5540990","5541257","41","879283","GGCCAGGCACAGTGACTCACGCCTGTAATCCCAGCACTTCGGGAGGCCAAGGCAGGAGGATCACTTGAGTCCAGGACTTCGAGACCAGCCTGGGAAACATACTGAGACCCCGTCTCTATAAAAATCAAAAGAATTAGCTGGCCATGGTTGGTGGTGCACACCTGTAGTCCCAGCTACTCAGGAGGCTCAGGTGGGAGAACCTCTTTAGTCCAGGAGGTTGAGGCTGCAGTGAGCTGTGATCATGCCACTGTACTCCAGCCTGGGGGACAGAGCAAGACATTGTCTCAAAGAAA","GGTCAGGCACAGTGACTCATGCCTGTAATCTCAGCACTTTGGGAGGCCAAAGCAGGAGGATCACTTGAGTCCAGGACTTTGAGACCAGTCTGGATGACATACTGAGACCTCTGTCTCCATAAAAATCAAAAGAATTAGCTGGCCATGGTTGGTGGTGCACACCTGTAGTCCCAGCTACTCAGGAGGCTCAGGTGGGAGAACCTCTTTAGTCCAGGAGGTTGAGGCTGCAGTGAGCTGTGATCATGCCACTGCACTCTAGCCTGGGTGA"
"chr1","6428076","6428365","chr1","5551141","5551437","32","876935","GGACGTGGTAGCTCACGCCTGTAATCCCAGCACTTTGGGAGGGCAAGACAGGAGGATTGCTTGAGCCCAGGAGTTTGAGACTAGCCTATGCAACACAGTGAGACCTCATCTTTACTAAAAATCAAAAAAATTAGCCAGGCATGGTGGCGTGTGCCTATAGTCCCAGCTACTCAGGTGGCTGAGGTGGGAGGATTGCTTGAGCCTGGTAAATCAAGGCTGCAGTGAGCCATAATGACACCACTGCACTCCAGCCTGGACCACAGAGCAAGACCCTATCTCAAAAAAATAAA","GCCGGGCACAGTATCTCACGTCTGTAATCCCAGCACTTTGGGAGGGCAAGATGAGAGGATTGCTTGAGCCCAGGAGTTTGAGACCAGCCTGGGCAACACAGTGAGACCTCATCTTTACTAAAAATCAAAAGAAATAGCCAGGCGTGGTAGCGTGTGCCTACAATCCCAGCTACTTAGGAGGCTGAGGTGGGAGGATTGCTTGAGCCTGGTAAATCAAGGCTGCAGTGAGCCAAAATGACACCACTGCATTCCAGCGTAGACCACAGAGCAAGACCCTGTCTCAAAAAAATAAATAAA"
"chr1","6430909","6431191","chr1","5553962","5554236","23","876947","GGCTGGGCGAGGTGGCTCATACCTGTAATTCCAGCATTTTAGGAGGCTGAAGTGGGGGAGGATCGCTTGAGCCCAGGAGTTCAAGACCAGCATGGGCAATGTAGCAAGACCTCATCTCTACAAAAAATCAAAAAATTAGCCGGGTGTGGCAGCGTGTGCCCGTAGTCCCAGCTAGTCAGGAGGCTGAGGTGGGAGGACGGCTTGAGCCCAGGAACTCAAGGCTGTAGTGAGCCATTATTGCACCACTACACTCCAGACAGAGCAAGACCCTGTCTCAAAACAA","CTGGGCGAGGTGGCTCATCCTGTAATTCCAGCACTTTAGGAGGGTGAAGTGGGGGAGGATCGCTTGAGCCCAGGAGTTCAAGACCAGCATGGGCAATGCAGCAAGACCTCATCTCTACAAACAAACAAAAAATTAGCTGGGCGCGGCAGCGTGCGCCTGTAGTCCCAGCTAGTCAGGAGGCTGAAGTGGGAGGATGGCTTGAGCCCAGGAATTCAAGGCTGTAGTGAGCCGTGATTGCACCACTACACTCCAGACAGAGCAAGACCCTGTCTCAA"
"chr1","6473518","6473727","chr3","170242210","170242417","41","163768692","CCAGCCTAGGTGACAGAGCGAGACTCTGTCTCAAATAAAAAAAAAAAATTAGCTGGGCGTAGTGGCACACATCTGTGGTTCCAGCTACTTGGGAGGCTGAGGTGGGAGGATTACGTGAGCCCAGGAGGTTGAGGCTGCAGTGAGCCATGATCTCACCACCGCACTCCACCCTGGCAACAGAGCGAGACCCTGTCTCAAATAATAATAAAA","AGCCTGGGCAACATAGTGAGATACTATCTCAATAAAAAAAATAAAAAAATTAGCCAGGTGTGGTGACACGTACCTGTAGTCCCAGCTACTTGGGAGGCTGAGGTGAGATAATCACTTGAGCCCAGGAGTTTGAGGCTGCAGTGAGCCATGATTGCACCACTGCACTCTAACCTTGGCAACAGAGCTAGACCCTGTCTCAAAAATAAAA"
"chr1","6497862","6498069","chr1","5626734","5626940","19","871128","CCAGCCCGGGCCACACAGTGAGATCCTGCCTCTACAAAAAACAAACAAAATTAGCCGGGTGTGGTGGCGCTCTCTTGTAGTCCCAGCTACTTGGGAGGCTGAGGTGGGAAGATTGCTGGAGCCCAGGAGGTTGAGGCTGCAGTGAGCCATGATCACATTGCTGCACTCCAGCCTGGGTGACACAGTGAGACCCCGTCTCAGAAAAAAA","CCAGCCCGGGCAACCCAGTGAGATCCTGTCTCTACAAAAAACAAACAAAATTAGCTGGCTGTGGTAATACTCTCCTGTAGTCCCAGCTACTTGGGAGGCTGAGGCGGGAAGATTGCTTGAGCCCAGGAGATGGAGGCTGCAGTGAGCCATGATCACATTGCTGCACTCCAGTCTGGGCGACAGAGTGAGACCCTGTCTCAGAAAAAA"
"chr1","6515400","6515683","chr1","5643507","5643791","15","871893","GATGGCTCAACAACTATAATCTCAGCACTTTAGGAGGCCAAGGCAGGAGGATCCCTTGAAGCCAGGAGTTCGAGACCAGCCTGGGAAACATAGTGAGACCTCCCTTGCTATAAAAAATTAAAAAGTTAGCCAGGTATGGTGGTGTGCACCGGTGGTCCCAGTTACTCGGTAGGCTGACGTGGGAAGATCACTTGTGCCCAGGAGGTCGAGGCTGCAGTGAGCCCTGATCACAACACTGCACTCCAGCCTGGGTAACAGAGCAAGACCCTGTCTCAAAAAATAAA","GATGGCTCAACAACTCTAATCTCAGCACTTTAGGAGGCCAAGGCAGGAGGATCCCTTGAGGCCAGGAGTTTGAGACCAGCCTGGGAAACATAGTGAGACCTCCTTTGCTATAAAAAAATTAAAAAGTTAGCCAGGTATGGTGGTGTGCACCAGTGGTCCCAGCTACTCGGTTGGCTGATGTGGGAGGATCACTTGTGCCCAGGAGGTCGAGGCTGCAGTGAGCCATGATCACAACACTGCACTCTAGCCTAGGTAACAGAGCGAAACCCTGTCTCAAAAAATAAA"
"chr1","6531181","6531315","chr1","5658987","5659111","17","872194","GGTTGGGCATGGTTGTTCACACCTATAATCCCAGCACTTGGGAAGGCTGAGGTGGGAGAATCATTTGAGGCCAGGAGTTGAAACCAGCCTGGACAACAGAGCAAGACTCTGTCTCAGCAAAAAATTAAATAAAAA","GGTCGGACATGGTTGTTGACACCTGTAATCCCAGCGCTTGGGAAGGCTGAGGTGGAAGAATCATTTGAGGCCAGGAGTTGAAACCAGCCTGGACAACAGAGCAAGACCCTGTCTCAGCAAAAAAT"
"chr1","6559736","6559880","chr6","144363682","144363828","26","137803946","GGCATGGTGGCTTATATCTGTAATCCCAGCAGTTTGTGAGGCCAAGGTAGGAGGATTGCTTGAGCCCAGGAGTTCAAGACCAGCCTGGGCAACATGGCAAGATCCTCTGTCTACAAAAGCAAAACAAACAAAAAAATTAGCCAGA","GGCTTGGTGGCTCACACCTGTAGTCCCAGCATTTTGGGAGGCCAAGGCAGGAGGATAGCTTGAAGCCAGGAGTTCAAGACCAGCCTGGGCAATACAGCAAGGCCCTGTCTCTACAAACATTAAAAAAAAAAAAAAAAACTTAGCCAA"
"chr1","6560171","6560343","chr10","22553987","22554163","39","15993816","CTAGCCAGGTGTGGTGGTGCGCTAGTGTGGTCCCTGCTACTTGGGAGGCTGAAGTGGGAGGACTGCTTGAACCCAGGACGTCAAGGCTGCAGCAAGCCGCGTTTGTGCCACTACACTTTTTGCTGGGCAACACAGTCAGACCCGGTCTCAAAAAAAAAAAAATTAAAAGAAAA","TAGCCAGGTGTGGTCGTGCACAGCTGTGGTCCCAGCTGCTCCAGAGGCTGAAGTAGGAGAATTGCTTGAGCCCAGGAGGTCAAGGGTGCAGTGAGCCGTGATTGTGCCACTGCGCTCCATCCTGGGTGACAGAGCCAGACCCTGTCTAAAACAAAACAAAACAAAAATAAAATAAAA"
"chr1","6574299","6574607","chr3","123903117","123903425","64","117328818","GGCACAGTGGCTCACCTAGAATCCCAATGCTGTGGGAGGCCCAGGCAGGAGAATCACTTGAGACCAGGAGTTTGAGACCAGCCTGAGCAACACAGTGAGACCACCTTCTCCACAAAAAATTAAAAAATTAGCCAGGAGTGGTGGTGCATGCCTGTAGTCCCAGCTACTTGGGAGGCTGGGGCAGGAGAATCACTTGAGCTTCAATGAGGCCCAAGTAAGGCTGCAGTGAGCTATGATTGCACCACTACACTCCAGCATGGGGGAAACAGCAAGACCTCATCTCTATAAATAAACAAATAAACAAACAAA","GGCTAGGCCCAGTGGCTCACACCTGTAATCCCAGTGCTTTGGGAGGCCGAGGCAGGAGGATCACTTGAGCCCAGGAATTGGAGACCAGCCTGGGCAACATAGTGAGACCCCCATGTCTACAAAAGCATTTAAAAATTAGCTGGGCATGGTGGCACACACCTGTATTCCCAGCTATTTGGGAGGCTGAGGTAGGAGGATGGCTTGAGCCCAGAAGTTCAAAGCTGCAGTGAGCTATGATTGCACCACTGCACTCCAGCCTGGGCGACAGAGCAAGACCTTGTCTCTAAACAAGCAAACAAAACAAACAAA"
"chr1","6608789","6609090","chr4","151163740","151164021","75","144554951","GCTGGGCGTGGTGGTTCACGCCTATAATCCCAGCACTTTGGGAGGCTGAGACAGGAGGGTCACTTGAGGCCAGGAGTGTGAGACCAGCCTGGGTAACACAGCAAGACCCTGTCTCTATAAAAATTTTAAGAATATCCTTTTGTATCTACATATGAGAAAAAAAATTACTGGGTGTGGTGGCACACGCCTGTAGTCTCAGCTATGCAGGAAGGTGCGGTGGGTGGAGGCTGCAGTGAGCCATGATTGCACCACTGCACTCCAGCCTGGGTGACAGAGCAAGACCCTGTCTCAAAAATAAAAAA","GGTTGGGCATGGTGGCTCATGCCTGTAATCCCAGCACTTTGGGAAGCTGAGGCAGGAGGATCACTTGAATCCAGGAGTTTGAGACCAGCCTGAACAGCATAGTGAGACCCCAGCTCTAAAAAAAAAAAAAAAAAAAAAAAAATTAGCTGGGCGTGGTGGCGCATGCCTTTAGCCCCATCTAATTGGGAGGCTGAGATGGGAGGATTGCTGGAGTGAGCCATGATGGTGCCACTGCACTTCAACCTGGGCAACAGAGCAAGACCCTGTCTTAAAAAAAAAAAA"
"chr1","6618954","6619159","chr1","5747454","5747661","10","871500","TTTGAGACCAGCCTGGGCAACATAGTGGGACCCAATATTTTGTCTCAACAAAAAGTTTTCAAATTGGCCAGGCGTGGTGGCATGCATCTTTAGTCTCGGCTACTTGGGAGGCTGAAGTGGGAAGATCACATAAGCCCAGATGACAGTGAGCTGTCATTGTTCCACTGCTCCCACTCTGCCTGCCCCACCCCTGAAAAAAAGAAAGA","TTTGAGACCAGCCTGGGCAACATAGTGAGACCCAATATTTTGAGTCTTAACAAAAAGTTTTCAAATTAGCCAGGCGTGGTGGCATGCACCTGTAGTCTCAGCTACTTGGGAGGCTGAAGTGGGAAGATCACATAAGCCCAGGTAACAGTGAGCTGTCATTGTTCCACTGCTCCCACTCTGCCTGCCCCACCCCTGAAAAAAAGAAAGA"
"chr1","6642209","6642505","chr1","5769010","5769307","16","873199","GCTGGGCGCGGTGGCTCAAGCCTGTCATCCCAGCACTTTGGGAGGCCGAGGCGGGAGGATCGCTTGAGCCTGGGAGTTCGAGACCTGCCTGGGCAACAGAAGGAGACCCTACCTCTACAAATAATTTTAAAAAATTAGCCAGGCAAGGTGGTGTGCACCTGTAGTCCCAGCTGCTCGGGAGACTGAAGTAGGAGGATCGCTTGAACCCAGCTTCGAGGCTGCAGTGAGCTATAATCTTGCCACTGCACTCCAGCCTGGGTGACAGAGCGATACCTCATCTCAAAATAAGAAATAAAA","GGCTGGGCGCGGTGGCTCAAGTCTGTCATCCTAGCACTTTGGGAGGCCGAGGCGGGAGGATCGCTTGAGCCTGGGAGTTCGAGATCAGCCTGGGCAACAGAATGAGACCCTGTCTCTACAAATAATTTTTACAAATTAGCCAGGCAAGGTGGCGTGCCCCTGTAGTCCCAGCTGCTCGGGAGGGTGAAGTAGGAGGATTGCTTGAACCCAGGTTCGAGGCTGCAGTGAGCTATAATCTTGCCACTGCACTCCAGCCTGGGTGACAGAGCGATACCTCATCTCAAAATAAGAAATAAAA"
"chr1","6647119","6647419","chr3","127162429","127162726","62","120515310","GGCCAGGTGCGGTGGCTCCCGCCTATAATTCCAGCACTTTGGGGGGCCAAGGCAGGAGAATCCCTTGAATCCAAGAGTTTGAGACCAGACTGGGCAAGACAGCAAGACCCCCATCTCTAAAAAAAAAAAAAAATTTAATTAGCTGGGCATGGTAGCACATGCTTGTGGTCCCAGCCACTTGGGAGGCTCAGGTGGGAGGATGGCTTGATCCTGGGAGGTTGAGGCTGCTGCGAGCCATGACTGCACCACTGTACAGAGCCTGAGCAACAGAGTGAGACCCTGTCTCAAAAACAAAGAAAAA","CCAGGCACGGTGGCTCACGCCTGTAATCCCAGCACTTTGGGAGGCTAGGGCAGGAGGATCACTTGAGACCAGGAGTTTGAGACCAGCCTGGGCAGCATAGCAAGATTCCACCTCTACAAAAAATAAAAATAAAAAATTAGCTAGGGGTGGTGGCACATGCCTGTGGTCCCAGCTACCTGGGAGGCTGAGGTGGGAGGATTGCTTGAGACCAGGAGTTAGAGGCTGCAGTGAGCTATGATTGCACCACTGCACTCCAGCCTGGGTGATACAGTGAGATCCTGTCTCTAAAAAATAAAAA"
"chr1","6658254","6658382","chr1","5785082","5785210","10","873172","GGCTGGGCGCTGTGGCTCACACCTGTAATCCTAACACTTTAGGAGGCCGAAGCGGGAGAACTACTTGAAGCCAGGAGTTCAAAACCAACCTGGGCAACCAAATGAGACCCTGTCTCTATAAAAATAAAA","GGCTGGGCGCTGTGGCTCACACCTGTAATCCTAACACTTTGGGAGGCCAAAGCGGGATAACTGCTTAAAGTCAGGAGTTCAAAACCAGCCTGGGCAACCAAGTGAGACTCTGTCTCTATAGAAATAAAA"
"chr1","6665808","6666103","chr1","27049076","27049368","72","20383268","GTGGCTCATGCTTCTAATCTCAGTGCTTTGGGAGGCCAAGGTGGGAGGACTGCTTGAATCCAGGAGCTTGAGACCAGCCTAGGCAACATAGAGATAACTTATCCCTAAAAAAAAACTAAACAATGAGCCAGGCATGTTGGCACACGCCTGTAGTCCTAGTTTTTCGGGAGGTTGAGGGAGGAGGACTGCTTGACCCCAGGAGTTCAAGGCTGCAGTGGACTATGACCGGACTATTGCACTCTAGCCTAGGCAACAGAACAAAACCTCGTCTCTAACAAAAATAAAGTAAAATAAAA","GTGGTTCATGCCTGTAATCCCAGAACTTTGGGAGGCGTAGGTAGGAGGATTGCTTGAAGCCAGGAGTTCGGGACCAGCCTGGGCAACATAGCAAGATCTTGTTTCTACACAAAATTTTAAAAATTAGCTGAGCATGATGACATGCACCTGTAGTCCCAGCTACTCAGAGGCTGAGGCAGGAGGATACCTTGAGCCCAGGAGCTCAAGGCTGAAGTGAGCTATGATCGTGCCACTGTACTCCAGCCTAGGCAACAGAGGGAGACTCTGTCTCTAAAAAAACAAACAAACAAAAA"
"chr1","6684060","6684181","chr1","5811010","5811142","14","873050","CCAGACATGGTGGCTCGTGCCTGCAATCCCAGCACTTTGGGAGGCTGATGTGGGAGGATCCTTTGAGGCCAAGAGTTTGAGGCCAACCTGGGCAATATAGCAAGACCCCGTTTCTACAACAA","CCAGACATGGTGGCTCATGCCTGCAATCCCAGCACTTTGGGAGGCTGATGTGGGAGGATCCTTTGAGGCCAAGAGTTTGAGGCCAACCTGGGCAACATAGCAAGACCCCGTCTCTACAGCAACAGAATAAAAA"
"chr1","6691545","6691811","chr1","5819632","5819900","21","871913","GGCTGGGCGCGGTGGCTCACACCTGTAATCCCAGCGCTTTGGGAGGCTGAGGTGGGAGGGTAGCTTCAGGCTAGGAGTTTGAGACCAGCCTGGGCAACATAGAAAGACCCCATCTCTACAAAAATTAAAAATTAGCTAGGCATGGTGGTGTGTGCCTGTAGTCACAGCTACTTGGGAGGCTGAGGTGGGAGACTCACTTGAGCCTGGGAGGTCGAGGGTGCAGTGAGCCGTGATGGCACCAACACACTGCAGCCTGGGCGACAGAGC","GGCTGGGCATGGTGGCTCACACCTGTAATCCCAGCGCTTTGGGAGGCTGAGGTGGGAGGGTAGCTTGAGGGCAGGAATTTGAGACCAGCCTGGGCAACATAGCAAGACCCCATCTCTACAAAAAATAAAAAAATTAGCTAGGCATGGTGGTGTGTGCCTGTAGTTGCAGCTACTTGGAAGGCTGAGGTGGGAGACTCACTTGAGCCCAGGAGGTCAAGGCTGCAGTGAGCCGTGATGGCACCAATGCACTGCAGCCTGGGCAACACAGC"
"chr1","6692456","6692756","chr1","5820608","5820914","23","871848","CCAGGCAAAGTGGCTCACACCTGTAATCCTAACACTCTGGGGAGCCAGGCTGGGAGGATCACATGAGGCCAGGAGTTCGAGACCAGCCTGAGAAACATAGCAAGACCCTGTCTCTACAAAACATTTTTTAAAAAATTAGGCGGGCTTGGTGGCGCACACCTGTATTCCCAGCTATTCAGGAGGCTGAGATGGGAGAATCACTTGAGCACAGGAGGTTGAGGCTGCAGTGAGCTATGATCACGCCACTACACTCTAACGTGGGCAACAGAGCAAGACCCTGTCTCACAAAAAAAGAAAGAAA","CCAGGCAAAGTGGCTCACACCTGTAATCCTAACACTTTGGGGAGCCAGGCTGGGAGGATCACATGAGGCCAAGAGTTTGAGACCAGCCTGAGAAAAAACATAGCAAGACCTTGTCTCTACAAAACATTTTTTTTTAAAATTAAGCGGGCTTGGTGGTGCACACCTGTATTCGCAGCTACTCAGGAGGCTGAGATGGGAGAATCACTTGAGCACAGGAGGTTGAGGCTGCAGTGAGCTATGATCACGCCACTGCACTCCAACATGGGCAACAGAGCGAGACCTTGTCTCAAAAAAGGAAAAAAAGAAA"
"chr1","6693835","6694109","chr1","5821990","5822264","14","871845","GCTGGGTGCAGTGGCTCACACCTGTAATCCCAACATTTTGCAAGGCCAAGGCAGGAGAATCATTTGAGGCCAGGAATTCGAGATCAGCCTAGGCAACATAGTGAGACCCCATCTCTACAAAAAATAAATTAGCTGGGCATGGTGGCACACACCTGTAATCCCAGCTGCTTGGAAAGCTAGAGCAGGAGGATTAGTTAAGCCCAGGAATTCAAGGCTGCAGTGAGCTATGATCTTACCATTGCACTCCAGCCAGGACAACAGAGAAGGACCCTGTC","GCCGGGTGCAGTGGCTCACCCCTGTAATCCCAACACTATGCAAGGCCAAGGCAAGAGAATCATTTGAGGCCAGGAATTCAAGATCAGCCTAGGCAACATAGTGAGACCCCATCTCTACAAAAAATAAATTAACTGGGCATGTGTGCACACACCTGTAATCCCAGCTGCTTGGGAAGCTGGAGCAGGAGGATTAGTTAAGCCCAGGAATTCAAGGCTGCAGTGAGCTATGATCTTACCACTGCACTTCAGCCAGGACAACAGAGAAGGACCGTGTC"
"chr1","6713672","6713934","chrX","67448189","67448456","54","60734517","GGCTGGGTGCCGTGGCTCATGCCTGTAATCCCAGCACTTTAGGAGGCTAAGATGGGCGGACTGCTTGAGCTCAGGAGTTTGAGACCAGCCTGGGCAACACAGTGAGACCCTGTCTCTAACAAAACAACAAAATCAGCTGGCTGTGGTGGTGTGTGCCTGCAATACCAGCTACTCTGGTGGCTGAGGTGGGAGGATCACCTGAGCCGGGGAAGGTCGAGGCTGCTATGAGCCACGACTGCGCCACTGCACTCCAGCCTGGGTGA","GGCCGGGTGTGGTGGCTCATGCCTGTAATCCTAGCACTTTGAGAGGCCTAGGAGGGTGAAATTGCTTGAGTCGAGGAGTTTGAGACCAGCCTGGGCAACATAGCAAAACCTTGTCTCTACAAAAAATACAAAAATTAGCCAGATGTGGTGGCATATACCTGTAGTCCCAACTACTCAGGAGGCTGAGGTGGGAGGATCACCTGAGCCTGGGAGTTTGAGGCTGCAGTGAGCCATGATCGTGCCACTGCACTTCAGCCTGGGCGACAGA"
"chr1","6720392","6720688","chr15","43687639","43687935","57","36967247","GGCCAGGCACGGTGGCTCACACCTGTCATCTCAGCACTTTGAGAGGCTGAGGCGGGCAGATCACTTGAGACGGGAGTTCCAGAACAGCCCGGCAACGTAGCAAGACCCTGTCTCTACAAAAAATACAAAGCTTAACCAAGTGTGGTGGCGGGCACCTGTAGTCCTAGCTACTCTGGAGGCTGAGGTGGGAGAATTACCTAAGCTTGAAGAGGTGGAGGCTGCAGTGAGCCATGATTGCACCACTGTACTGCAGCCTGGGTGACAGAGTGAGACCTCGTCTCAAAAAAAAAAAAAAAA","GGCCAGGCACAGTGGCTCATGCCTGTAATCCCAGCACTTTGGGAGGCCAAGGAGAGAGAATTGCTTGAGGCAGGAGTTCAATACCAGCTTGGGCAATATAGTGAGACCCCTGCCTCTACAAAAAATTTTAAAAATTAGCCAGGTGTGGTGGTGCACACCTGTAGTCCCAGCTACTCAGGAGGCTGAGGTGGGAGGATCACTTGAGCTGGGAGGTCAAGGCTGCAGTGAGCCATGATTGCGCCACTGCACTCCAGCCTGGGTGACAGAGCGAGACCCTGTTTCAAAAAAAAAAAAAAA"
"chr1","6731452","6731747","chr1","5858937","5859229","36","872515","GCCGGCCATGGTGGCAGGCACCTGTAATCCCAGCTACTCAGGAAGCTTGAGCCCAGGAATTTGAGACCAGCCTGAGTAACATAGTGAGACCCCATCTCTACAAAAAATGTTGAAAAATTAGCCGGGTGTGGTGGCACATGCCTGTAGTCCCAGCTACTTGGGAGGCTGAGGTGAGACGATCGCTTGAGTCCTGGAGGTTGAGGCTACAGTGGGCTGTGATGGCACCATTGCACTCCAGCCTGGGTGACAAAACAAGACTCTGTCTAAAAAAAAAAACAAAAAAAACAAACAAAAAA","GCTGGGCATGGTAGTGTGCACCTGTAATCTCAGCTACTCGGGACGTTTGAGCCCAGGAGTTTGAGACCAGCCTGAGTAACATAGTGAAACCCCATCTCTACAAAAAATGTTTTAAAATTAGCCGGGTGTGGTGGCATGTGCCTATAGTCCCAGCTACTTGGGATGCTGAGATGAGAGGATCGCTTGAGTCCAGGCGGATGAGGCTACAGTGGGCTATGATGGCACCATTGCACTCCAGCCTAGGTGACGAAGCAAGACTCTGTCTCAAAAAACCCCAAAAACAAACAAAAAAA"
"chr1","6742187","6742461","chr3","39231940","39232206","64","32489753","GGGCACAGTGGTTCATGCCTGTGATCCCAGCACTTTGGGAGGCCAAGGCGGGAGGATCACTTGAGGCTAGGAGTTTGAGTCTGGGCAACATAGTGAAACCCCCATCTCCAAGAAAAATACAAAAAAAATACACACAAAAAAATTACAGGCATAGCAGTATGTGCCTGTAGTCCCTGCTACTTGGGAGGCTGAGGTGGGAGCATTGCTTGAGCCCAGGAGGTCAAGGCTGCAATGAGCCAGGATCATGCCACTCTACTCCAGCCTGGGTGACAGAG","GGCTGGGCACAGTGGCTCATGCTTATAATCCTAGTGCTTTAGGAGGTCAAGGTGGGAGGATCGCTTGAGGCCAGAAGTTTAGCCTGGGCAACATAGCAAGACCCTATCTCTAAAAAAAAAAAAAAAAATCATATAAATTAGCCAGGAGTGGCGGCATGTGCCTGGAGTCCCAGCTACTCAGGAGGCTGAGGTGGGAGGATCGCTTGAGCTCATGAATCCAAGGCTGCAATGAGCTATGATCATGCCACGGCACTCCAGCCTAGACAA"
"chr1","6746987","6747154","chr1","5875681","5875836","22","871306","TACAAAGAAATTTTACAGGTATGGTGGCGCGCCTGTAGTAACAGCTACTTGGGATGCCGAGGTGGGAGGATTGTTTGAGGTTGGGAGTTCAAGGCTGCAGTGAGCTATGATCGCACCCCAGCACTCCAGTCTGGGTGACAGAGTGAGACCCTGTTTCAAAAAAAGAAA","TTTACAGGTATGGTAATATGCCTGTAGTAACAGCTACTTGGGATACTGAGGTGGTAGGATTGTTTGAGATTGGGAGTTCAAGGCTGCAGTGAGCTATGATCGCACCCCAGCACTCCAGTCTGGGTGACAGAGTGAGACCCTGTTTCAAAAAACAAA"
"chr1","6747389","6747489","chr1","5876339","5876453","24","871050","TGGCCCATGCGTGTAATCCCAACACTTTGGGAGGCCGAAGTGGGAAGACTGCTTGAGATCAGCAGTCTCAAAAAAAAATCTTGTTTTTTTTGAGACAGGGT","TGGCCCATGTGTGTAATCCCAACACTTTGGGAGGCCAAAGTGGGAAGATTGCTTGAGACCAGGAGTCTCAAAAAAAAAAAATTTTGTTTTTGAGACAGGGTCTCACTCTGTCACC"
"chr1","6749336","6749636","chr1","5877948","5878245","29","871388","GGCCGGGCATGTTGGCTCACATCTGCAGTCCCAGACCTTTGGGAAGTGGAGGCAGGAGGATTGCTTGACCTGAGGAGACCAAGACCAGCCTAGGCAACATAGCAAGACCTCATCTCGACTAAAAATTAAAAAAAAAAAATTAGCCAGGCATGATGGTGCACGCCTGTGGTCCCAGCTACTAGGGAGGCTGAGGTGGGAGGATCACTTGAGCCTGGGAAGTTCACCAGAGTGCCACTGCACTCCAGCCTGGGCAACAGAGTGAGCCTGTCTTAAAAAAAAAAAAAAAAGAAAAGAAAGAAAA","GGCCGGGCCTGTTGGCTCACATCTGTAGTCCCAGACCTTTGATGAGTGGAGGTGGGAGGATTACTTGACCTGAGGAGACCAAGACCAGCCTGGGCAACATAGCAAGACCTTGTCTCTACTAAAAATTAAAAAAAAAAAAAAAATGAGCCAGGCATGATGGTGCACGCCTGTGGTCCCAACTACTAGGGAGGCTGAGGTGGGAAGATCACTTGAGCCTGGGAAGTTAGCCAGAGTGCCACTGCACTCCAGCCTGGGCAACAGAGTGAGCCTGTCTAAAAAAAGAAAAGAAAAGAAAAAA"
"chr1","6760793","6761065","chr1","5887205","5887513","57","873588","TTTGGGAGGCAGAGGTCGGGAGGATTGCTTGAGCCCAGGAGTTTGAGATCAGCTTGGGTAATATAGCTAGGTCCCATCTCTCCAAAAAATAAATAAATGAGACAGGCATGATGGCGTGTGTCTGTAGTCTCAGCTACTCGGTGGGAGGCTGAGGTGGGGGAGGATCACTTGAGCCCAGTAAGTCGAGGCTGCAGTGAGCTATGATCACACCACTGCGCTCCAGCCTAGGTGACAAAGTGAGACCTGGTCTCAAAATCAAAAACAAAACAAAAA","GGCTGGGCACAGTGACTCACACCTGTAATCTCAACACTTTAGGAGGCAGAGGTGGGAGGATCGCTTGAGCCCAGGAGTTTGAGATCAGCTTAGGTAATATAGCTAGGTCCCACCTTTCCAAAAAATAAATAGATGAGACAGGCATGATAGCGTGTGTCTGTAGTCTCAGCTACTCGGTGGGAGGCTGAGGTGGGAGGATCACTTGAGCCCAATAAGTCGAGGCTGCAGTGAACTATGATCACACAGATTCACTCCAGCCTGGGTGACAAAGCGAGACCTGGTCTCAAAATCAAAAACAAAAGCAAAAAA"
"chr1","6764578","6764872","chr1","5890161","5890453","18","874417","GCCAGGTGAGGTAACTCATGCCTGTAATCTCAGCACTCTGGGAGGCTAAGGCAGGAGGATCACTTGAGCCCAAGAGTTTAGACAAGCCTGGGCAACATAGCAAAACCTCATCTCTACAAATATTTTTTAAAAAAATAATCGGGCATGGTGGTGTGCATCTGTGGTCCCAGCTACTCAGGAGGAAGGTTGAGGTGGGAGGATGGCTTGGGCCCAAGATGTTGAAGGCAGTGAGCTATGATCATGCCATTGCACTTCAGCCTGGGCAACAGAATGAGACCCTCTCTCAAAAGAAGAA","GCCAGGTGAGGTAACTCATGCCTGTAATCTCAGCACTCTGGGAGGCCAAGGCAGGAGGATCACTTGAGCCCAAGAGTTTAAGACAATCCTAGGCAACATAGCAAAACCTCATCTCTACAAATTTTTTTTAAAATAATCAGGCATGGTGGTGTGCATCTGTGGTCCCAGCTACTCAGGAGGGAGTTTGAGGTGAGAGGATTGCTTGGGCCCAAGATGTTGAGGGCAGTGAGCCATGATCATGCCATTGCACTTCAGCCTGGGCAACAGAATGAGACCCCATGTCAAAAGAAGAA"
"chr1","6765549","6765860","chr1","5891047","5891360","36","874502","GGGCATAGTGGCTCATGCCTGTAATCCCAACACCTTGGGAGGCTGACATAGAAAGATCACTTGAGGCCAGGAGTTCAAGACCAGCCTGGGCAACATAGCATGACTCTATCTCTACCCAAAAAAAAAATTAATTAGTGGGGTGTGGTGGCACATGCCTGTAGTCCCAGCTACTCAGAAGGCTGAGGCAGGAGGGTTGCTTGATCACAGGAATTGGAGACTGCAGTGAGCTATGATTGTGCCACTGCACTCCAGCCTGGAGGAGACAGCAAGCCCCTCTATGAAAAAAAAAAAAGAAATCAAGAAAGAAAGAAA","GGGCATGGTGGCTCATGCCTATAATCCCAACACTTTGGGAAGCTGACATAGAAGGATCGCTTGAGGCCAGGAGTTCAAGACCAGCCTGGGCAACACAGCATGACTCTGTCTCTACAAAAAAATATATATATATATTTAATTAGTGGAGTGTGGTGGCACATGCCTGTGGTCCCAGCTACTCAGAAGGCTGAGGTGGGAGGATTGCTTGAGCACAGGAATTGGAGACTGCAGTGAGCTATGATTGTGCCACTGCACTCCAGCCTGGAGGAGAGAGCAAATCCTTCTATGAGAAAAAAGAAAAAAAAAAAAAGAAA"
"chr1","6771614","6771950","chr1","5897687","5897998","55","873927","GGCTGGGCACGATGGCTCACACCTACAATCCCAGCACTTTGGGCAGCTGAGGCAGGAAGGTTGCTTGAGCCCAGGAGTTCAGGACCATCTTGGGCAATATAGATAGATCTCATCTCTACAAAGATTTTTTTTAATTGGCTGAGCATGTGGCACACACCTGTAATCACAGCTTCTCAGAAGGCTGAGGTGGGAGGATTGTTTGAGCCCGGGAGGTCGAGACTGCAGTGAACCAGATCATGCCACTGTACTCCAGCCTGGGCAACAGAGGAAGAGCCTATCTCAACAAACAAAAAAATAAAGAAATAAAAAAGAAAGAAAGAAACAAAAGAAAAAGAAA","CTGGGCACGGTGGCTCACACCTACAATCCCAGCATTTTTGGGCAGCTGAGATAGGAAGGCTGCTTGAGCCCAGGAGTTCAAGACCACCCTGGGCAATATAGATAGACCTCATATCTACACAGATCGTTTTAAAAATTAGCTGAGCGTGTGGCACACACCTGTAATCACAGCTTCTCAGAAGACTGAGGTAGGAGGATTGTTTGAGCTGGGGAGGTCGAGACTACAGTGAACCAGATCACGCCTCTGTACTCCAGCCTGGGCAACAGAGGAAGAGCCTATCAGGAAAAAAAAAAAAAAAAAAAAAAAAAAAAA"
"chr1","6776647","6776857","chr3","35639309","35639528","51","28862662","GCCAGGCATGGTGGCTTACAACTATCTCAGCACTTTAAGAGACCAGTGTGGGAGGATTGCTTGTGGTCGGGAGTTCCAGACCAGCCTGGACAACATAGGGAGACCCTGTATCCACTAAAAAATTTAAAATTATCCAGGTGGTGCAGTCCTGTAGTCCTAGCTACTTGAGAGGCTGAGGTGGGAGGATCGCCTGAGCCCAGGAGTTTGAGAC","GGCCAGGTGCAGTGGCTCACACCTGTAATCCCAGCACTTTGAGAGACCAAGGTAGGAGGATCACTTAAGTCCAGGAATTTGAGACCAGTCTGGGCAACATAGGGAGACTCTGTCTCTACAAAAAAAAAAAAAATTAGCCAGGCATGGTGGCATGTGCCTGTAGTCCCAGCTATGTGGGATGCTGAGGTGGGAGGATTACTTGAGCCAGAAAGTTTGAGAC"
"chr1","6784918","6785226","chr1","5910945","5911247","33","873973","GGCCGAGTGCTATAGCTCACACAAGTAGTTCTAGCACTTTGGGAGGCCAAGGCAGGAGGATTACCTGAGCCCAGGAGTTTGAGAACAGCCTGGACAACATAGTGAGACCCCATCTCTACAAAACAAAAAAAAAAGAATTATTAGCCAGGTGTGATGGTTTGCACCTGTAATCCTAACTACTCAGGAGGCTGAGATGGGAGAATCCCTTGAGCCCAGGAGTTTGAGGCTACAGAGAGCTGTGATCATGCCACTGCCCTCTAACATAGGTGACAGAGCAAGAACTTTTCTCAAAAAAAAAAAGAAAAGAAA","GGCGGAGTGCTATAGCTCACACAAGTAGTTCTAGCACTTCGGGAGGCCAAGGCAGGAGGATTGTCCAGGTGTCCAGGAGTTTGAGACCAGCCTGGACACCATAACGAGACCCCATCTCTCCAAAAGAAAATAATTATTAGCCAGGTGTGATGGTTTGCACCTGTAATCCTAACTACTCAGGAGGCTGAAACAGGAGGATCCCTTCAGCCCAGGAGTTTGAGGCTACAGAGAGCCATGATCATGCCACTGCCCTCTAACATAGGCGACAGAGCAAGACCCTTTCTCAAAAAAAGAGAAAAGAAA"
"chr1","6791218","6791525","chr1","5916869","5917175","20","874349","GGCTAGGCCCAGTAGTTCATGCCGTAATCCCAGCACTTTGGGGCCGAGGCAGAATAATCACTTGAGGCCATGAGTTCTAGATCAGTCTGGGCAACACAGCAAGATGTCACTACAAAAGAATATAAAAGATTAGCAAGGTGTGGTGGTGTGCACCTGTAGTCCCAGCTACTCAGGAAGCGAAGGCAGAAGGATCACTTGAAGCCAGGAGTTCGAGGGTGCAGTAAGCTATGATCGCGCCACTGCACTTCAGCCTGGGTGACAAAGCAAGACCCTGTCTCAAAAAAAAAAAAGAAGAAGAAGAAGAAGAA","GGCTAGGTCCAGTAGTTCATGCCTGTAATCCCAGCACTTTGGGGCCGAGGCAGAAGAATCACTTGAGGCCAAGAGTTCTAGATCAGTCTAGGCAACACAGCAAGACGTCGCTACAAAAAAATATAAAAGATTAGCAAGGTGTGGTGGTGCACGCCTGTAGTCCCAGCTACTCAGGAAGCGAAGGCAGAAGGATCACTTGAAGCCAGGAGTTCGAGGGTGCAATGAGCTATGATCACGCCACTGCACTTCAGCCTCGGTGACAGAGCAAGACCCTGTCTCAGAAAAAAAAAAAAAAAAAGAAGAAGAA"
"chr1","6791769","6792067","chr1","5917424","5917708","31","874345","GGCTGGGTGAGGTGGCTCACGCCTGTAATCCCAGCACTTTGGGAGCCCAAGGTGAGTGGATGGCTTGAGGCCAGGAGTTCGAGATCAGCCTGAGCAACATGGCAAAACCCTGTCTTTACAAAAAATACAAAAGTATGCCAAGTGTGGTGGTGCACGCCTGTAGTCCCAGCCACTTGGGAGTCTGAGGTGGGAGGATCATCTGAGTCCAGGGATGCAGAGGTTGCAGTGAGCTGTGGTTGTGCCACTGCACTCCAGCCTGGGTGACAGAGCAACACACTGTCTCAAAAAATAAAATAAAA","GCTCACACCTGTAATCCCAGCACTTTGGGAGCCCAAGGTGGGTGGATGGCTTGAGGCCAGGAATTTGAGATCAGCCTGAGTAATATGGCAAAGCCCCGTCTTTACAAAAAATACAAAAGTATGCTGAGTGTGGTGGTGCACGCCTTTAGTCCCAGCTGCTTGGGAGGCTGAGGTGGGAGGATCATCTGAGTCCAGGGATGCAGAGGCTGCAGTGAGCTGTGGTTGTGCCACCGCACTCCAGCCTGGGTGACAGAGCAACACCCTGTCTCAAAAAATAAAATAAAA"
"chr1","6800087","6800371","chr1","191690399","191690678","53","184890312","GGTCAGGTGTGGTGGCTTATGCCTGTAATCCGTGCACTTCAAGAGGCTGAGGTGGGAGGATCACTCGAGCTCAGGAGTTTGAGACCAGCCTGGGCAACAAGGTGAGACCCTGTCTCTACAAAACTTAAAAATTAGCTGGGCATGGTGGTGCATGCTTGTGGTTCTAGCTACTGGGGAGGCTGAGGTGGGAGGATTACTGCAGCCCAGGAGTTCGAGGCTGCAGTGAGCTTTGATGTCACTACTGAACTCCAGCCTGGGCGACAGAGCAGGACCCTGTCTAAAAAA","GGCCTGGCCCAGTGGTTCATGTCTGTAATCCCAGCACTTTGGGAGGCTGAGGCAGGAAGATCACTTGAGCCCAGGAATTTGAGATCAGCCTGGGCAACATCGACCCTATCTCTACAAAAATAAAAAATTAGCTGGGCATGGTGGTGCATGCCTGTAGTCCCAGCTATTTGGGAGGCTGAGGTGGGAGGATTGCTTGAGCCCAGGAGTTGGAGGCTGCAGTGAGCCATGATGGTGCCACTGCACTCCAGCCTGGGCAACAGAGTGAGACCCTGTCTCTAAA"
"chr1","6813103","6813410","chr1","5944697","5945009","25","868406","GGCAGGGCATGGTAGCTCACACTTGTAAATCCCAGCACTTCGGGAGGCTGAGGCAGACGGACTGCTTGAGACCAGGAGTTCAACACCAGCCTGGGCAATACAGCAAGACCCCACCTCTATGAAAAAGAGAAAAAAAACCTAAGCAGCCATGGTGACACACACCTGTAGTCCCAGTCACTCAGGGGGCTGAGGCAGGAGGATCATTTCAGCACAGGAGGCCAAGGCTGCAGTGAGCTATGGATTGCACTACTGCACTCTAGTCTGGGCAACAGAGCGAGACCCTGTCTCTAAAAAAAAGTAAGATAAAA","GGCGGGCCATGGTAGCTCATACCTGTAAATCCCAGCACTTTGGGAGGCTGAGGCAGATGGACTGCTTGAGACCAGGAGTTGAAGACCAGCCTGGGCAACACAGCAAGACCCCATCTCTACCAAAAAGAGAAAAAAAACCTAAGCAGGCAAGGTGACACACACCGGTAGTCCCAGTTACTCAGGGGGCTGAGGCAGGAGGATCATTTCAGCACAGGAGGCCAAGGTTGCAGTGAGCTATGGATTGCACTACTGCACTCCAGTCTGGGCAACAGAGCGAGACCCTGTCTCTAAAAAAAAAACAAGATAAAATAAA"
"chr1","6820448","6820773","chr1","5952712","5953020","35","867736","GGCCGGGCACGGTGGCTCACGCCTGTAATTCCAGCCCTTTGAGAGACTGAGGCAGGTGGATTGCTTGAGCTGGCCAAGAGTTCAAGACCAGCCTAGGCAACATAATGAAACCCCTGTCTCTACTAAAAACATAAAAATCAGCCGGGCATTGTGGCATATGCCTGTATTTTCCAGCTAAGTCCTCAGCTTGGGGGACTGAGGTGGGAGGATCACTTGAGCCCAGGCTGTCGAGGCTTCAGTGAGCTGAAATTGTGCTACTGCACTCCAGCCTGGGCGACAGAATAAGACCTTGTCTCAAAAAAAAAGAAGAGAGAGAGAGAGACAAA","GGCCAGGCACGGTGGCTCACACCTGTAATCCCAGCCCTCTGAGAGACTGAGGCAGGTGGATCGCTTGAGCTGGCCAGGAGTTCAAGACCAGCCTAGGCAACACAATGAAACCCCTGTCTCTACTAAAAACATAAAAATTAGCCGGGCAAGGTGGCATATGCCTGTGTTTCCAGCTAAGTCCTCAGCCTGGGGCGCTGAAGTGGGAGGATCACTTGAGCCCAGGCTGTCGAGGCTTCAGTGAGCTGAAATTGCGCCACTGCACTCCAGCCTGGGCAACAGAATAAGACCTTGTCTCAAAAAAAAAAAAAA"
"chr1","6823226","6823522","chr1","211353988","211354282","65","204530762","GGCCAGCACAGCAGCTCATACTTGTAATCCCAGCATTTTGGGAGGCCAAGGCAGGAGGATCACTTGAGCCCAGGAGTTCAAGACCAGCCTGGGCATAATATAATATAGAGACTCCGTTTCTATTAAAAAATTTCTAAATTAGCCAGACCAGTGGTGCCCCCCTGTAGTCCCAGCTGCTCAGGAGACTAAGGTGGGAGGACCGCTTAAGCCCAGGCAGGCAAGACTGCAGGGAGACATGACTGCATCACTACACTCCTGCCTGGGTGACAGAATGAGACCCTCTCTCAAAAAACAAAA","GCCAGGCACAGTGGTTCATATCTGTAATCCCAGCACTTTGGGAGGCTCAGGTGGGAGGATCCTTCGAGCCCAGGAGTTCAAGACCAGCCTGGGCAACACAGCAAAACCCCATCTCTACAAAAATATTTTTAAAAATTAGCCAGGCATGGTGGTGCACACCTGCAGTCCCAGCTACTCAGGAAGCTGAGGCGGGAGGATCACTTGAGCCCAGGAGTCTGAGGCTGCAGTGAGCTATGATCACACCACTACACTCCAGCCTGGGACACAGAGTGAGACCCTGTCTCAAAAAATAAAA"
"chr1","6852167","6852459","chr1","5985420","5985722","39","866747","GCGGGAGCTCCCACCTATAATCCCAGCACTTTGGGAGGCTGAGGCAGGAAGACTGCTTGAGCCCAGGAGTTCAAGACCAGCCTGGGCAACATGGCAAGCGAGATTCCATCTCCAAAAACAATGTATAAATTAGCTGGGCATGGCACACGCCTATAGACCCAGCTACTCAGAAGGCTGAGGTGGGAGGATAGCTTGAGCCCGGAAGGTCGAGGCTGCGGTAAGTTATGATTGCGCCACTACACTCCAGCCAGGGCAACAGAGCACGACTCTGTCTCAAAAAAAAAAATTAAAAA","GGCCGAGCATGGGCGGGAGCTCCCACTCATAATCCCAGCACTTTGGGAGGCTGAGGCAGGAAGATTGCTTGAGTCCGGGAGTTCAAGCCCAGCCTGGGCAACATGGCGAGCGAGAGACTGTCTCCAAAAACAATGTATAAATTAGCTGGGCGTGGCACACGCCTATAGACCCAGCTACTCAGGAAGCTGAGGTGGGGGCATAGCTTGAGCCTGGAAGGTTAAGGCTGCGGTGAGTTATGACTGCGCCACTACACTCCAGCCAGGGCAACAGAGCGAGACTCTGCCTCAAAAAAAAATGAAAAA"
"chr1","6856335","6856617","chr1","5989198","5989480","17","867137","GGCTGAGCACGATGGCTCACACCTGTAATCCCAGCACTTTGGGAGGCTGAGGCAGGAGGATCATTTGAGGCCAGGAATTCAAGACCAGCCTGGGCAAGACAGCAAGATCCTGTCTCCACAAAAAATAAAAAACATTGCCAGGCATGGTGTCCCATGCCTGTAGTCCTAACCATTCAGGAGGCTGAGGCAGGAGGATCTCTTGGGTCCAGGAATTTGAAGCTGCAGTGAGCTATAATCGCACCATTGCACTCCAGCCTGGGTGACAGAGAGAGAATCTGTCTCA","GGCCGAGCACGGCGGCTCACTCCTGTAATCCCAGCACTTTGGGAGGCTGAGGCAGGAGGATCATTTGAGGCCAGGAATTCAAGACCAGCGTGGGCAAGACAGCAAGATCCTGTCTCTACAAAAAATAAAAAACGTTCTCAGGCATGGTGTCCCATGCCTGTAGTCCTAGCCATTCAGGAGGTTGAGGCAGGAGGATCTCTTGGGCCCAGGAATTTGAAGTTGCAGTGAACTATGATCGCACCACTGCACTCCAGCCTGGGTGACAGAGAAAGAATCTGTCTCA"
"chr1","6865779","6866064","chr1","6000471","6000747","30","865308","GGCCAGGTGCAGTAGCTTATACCTGTAATCCCAATACTTTGGGAGGACGAAATGGGAGGATCACTTGAGACTAGGAGTTCAAGGCCGGGGAAATGTAGGGAGACTCTGTCTTTACAAAATAAAAATAAAACTATTAGCCAGATATGGTGGTGCACCCCTGTGGTCTCAGCCACTCTGGAGGCTGAGGTATGAGAGGATTGTTTGAGGCCAAGGAGTTGAAGTCTATGGTGAGCTATGATCAAGCTGGGAGACAGAGTGAGACCTTCAAAGAAAACAACAACAAAAA","GGCCAGGTGCAGTAACTTATGCCTATAATCCCAACACTTTGGGAGGACAAAATTGGAAGATCGCTTGAGGTTAGGAGTTCAAGGCCGGGAAGGAGACTCCGTCTTTACAAAATAAAAATAAAACTATTAGCCAGGTATGGTTGGCGCAGCCCTGTGGTCTCAGCCACTCTGGAGGCTGAGGTATGAGGGGACTGTTTGAGGCCGAGGAGTTCAAGGCTATGGTGAGCTATGATCAAGCTGGGAGACAGAGTGAGACCTTCAAAGAAAACAAACAAAA"
"chr1","6897558","6897844","chr8","38149121","38149408","76","31251563","GGCTGGGCATGGTGGCTCATGCCTGTAACCCCACACGTTGGGAGGTTGAGACAGGAGGATCATTTGAGGCCAACAGCTCAAGACCAACCTGGACACATAGCGAAACCCTGTCTATACAAGAAAAACAAAAAGTTAGCTGGGCGTGGTGGTATGCACCTCTGGTCCCAGCTACTCCAGAGGCAAGCCTAGGCATTTGAGGTCACAGTGATGATCATCGTGCCACTGAACTCCAGGCTGGACAACAGAATAAAACCCTGTCTCTATTAAATTAAAAATAAATATAAAAA","GGTTGGGCATGGTGGCTCACACCTGTAATCCCTGAACTTTGGGAGCCTGAGGCAGGAGGATCACTTGAGGCCAGGAATTCAAGACCAGCCTGGGCAATATTGCAAGACTGCATCTCTATAAAAAATTTTAAAAATTTGCTGGCATGGTGGCGTGCGCCTATACTCCCAGCTACTCAACATAAGCCTAGGAATTCGAGGCTGCAGTGAGCTATCATTGCACCACTGTACTCTAGTCTGGATGACAAAGTGAGACTCTGTTTCTAAAAATAAATAAATAAAAATAAAGAA"
"chr1","6907991","6908293","chr1","6043638","6043911","49","864353","GGCTGGGCAGGGTGGCTCATCACCTATAATCCTAGCATTTGGGGAGGAAAGCAGGAAAACTGCTTGAGGCCAGGAGTTCCAAGACCAGCCTGGGCCAAATAGCAAGACCTCGACTCCACAGAAAAATTAAGAAATCAGCTGGGCATGGTGGCCCCCACCTGTGGTCCTAGCTACTCAGGAGGCTAAGGCAGGAGGATCACTTGAGCTCAGGAGGTCAAGGCTGCAATAAGCTGTGATCATACCACTGCACTCCCTCCAGCCTGGGCAATAGAGTGAGACTTCACCTTAACAAAAAAAAAGAAA","GGCTGGGCGGGGTGCCTCATCGCCTATAATCTTAGCATTTTGGGAGGAGAGCAAGAAAACTGCTTAAGGCCAGGAGTTCTAAGACCAGACTGGGCAAAATAGCAAGACCTCGACTCCACAGAAAAATGAGGAAATCAGCCAGGCATGGTGGCCCCCAGGTCCGAGCTACTCAGGAGGCTAAGGCAGGAGGAGCACTTGAGCTCAGGAGGTCAAGGCTGCAGTAAGCTGGAATCATACCACTGCACTCCCTCCAGCCTGGGCAATAGAGTGAGAC"
"chr1","6921975","6922280","chr3","105829916","105830219","67","98907941","GGCCAGGTGTGGCGGCTCACGCCTGTAATCCCAGCAGTTTGGAAGGCCGAGGCGGGAGGATCGCTTGAGCTCAGGAGTTCGAGATCAGTCTAGGCAACACAGCAAGACCTCGTCTCTGCCAAAAAATTAAAAAAAAAAAAAAAAAAATTAAGCTGGCGATGGTGGCGCATGCCTGTAGTTCCAGATATCGAGTGGCTGAGGTGGGAGGATTGCTTGAGCCTGGAAGTTTGAGGCTGCTGTGAGCTATGTTGTTCATGCTACTGCATTCCAGCCTGGGGCGATAGAGCAAGACTCTGTCTCAAAAAA","GGCCAGGCACGGTGGCTCACCCCTGTAATCCCAGCACTTTGGGAGGCCAAGGCAGGAGGATCGCTTCAGCCCAGGAGTTGGAGACCAGTCTGGGCAACACAGCAAGACTTCATTTCTACTAAAAATAAAATAAGTAAATAAAAAATAGCCAAGCATGGTGGCAAATGCCTGTAGTTCCAGCTACTTGAGAGGCTAAGTTGGGAGGATCTCTTGAGCCCAGTAGTTCAAGTTACCGTGAGCTATGATCTCGCCACTGCACTTCAGCCTGGGCAACAGAGCAAGACTCTGTCTCAGAAAAAAAAAA"
"chr1","6944114","6944374","chr1","124615453","124615689","65","117671339","GGCTGGGTGCAGTGGCTCACACCTGCAGTCTCAGCGCGTTGGGAGGCTGACGTGGTCTATTGCTTGAGGCCAGTTCAAGATCAGCCTGAGCAACATGGCAAAATCCCATCTCTACAAAATAAATGAATGAATGAATGAATATTAGCTGGGCATGGTGGTGCATGCCTGTGGTCCTAGCTACTCAGGAGGCTGAGGCAGGAGGATCACCTGAGCCCTAGAGTTTGAGGCTACAGTGAGTTATGATTGTGCCACTGCACTCTA","GGCCAAGCATAGGGCTCACACCTGTAATCTCACTTTGGAAGGCTGAGGAGGATTGCTTCAGGAGTTCAAGACCAGCCTGGGCAACATGGCGAGACCCTGTATCTACAAAAAATAAAAAATTAGCTGGCTGTGGTGGTGCCCACCTGTGGTCCCAGCTACTCAGGAGGCTGGAGTGGGAGGATCGCCTGAGCCCAGGAGGTTGAGGCTAGAGTGAGCTGTCATTTTGCCACTGCACTC"
"chr1","6960208","6960508","chr1","6095512","6095811","21","864696","GTGGCTCATGCTATAATCCCAGCACTTTGGGAGGCTGAAGCAGGAGGATCACTTGAGTCCAGGAGTTCGAGAGCAGCCTGGGCAACATAGTGAGACCCCTATTTCTACACAAAAATAATGATAAAAAATTAGCTGGATGTGGTGGCCTATAATCCCAGCTACTTGGGAGGCTAAGGTGAGAGGATCACCTGAGCCCAGGAGATCAAGGCTGCAGTGAGCTATGATTGTGCCATTGCACTCCAGCCTGGGTGACAGAGTGAGACCCTGTCTCTAAAAAAATAAAAAATAAAACCAAAACAAA","GTGGCTCACGCTGTATTCCCAGCACTTTGGGAGGCTGAAGCAGGAGGATCACTTGAGTCCAGGAGTTCAAGAGTAGCCTGGTCAACATAGTGAGACCCCTATTTCTACACAAAAATAATGATAAAAAATTAGCTGGATGTGGTGGCCTATAATCCCAGCTACTTGGGAGGTTAAGGTGAGAGGATCACCTGAGCCCAGGAGATCGAGGCTGCACTGAGCTATGATTGTGCCGGCACACTCCAGCCTGGGTGACAGAGTGAGACCCTGTCTCTAAAAAAAATAGTAATAATAAAACCAAAA"
"chr1","6963892","6964192","chr1","6099265","6099566","30","864627","GATGGCTCATCCCTGTAATCCTGGCACTGTGTGAGGCTAAGACAAGAGTTCAGAAGGCCAGGAGTTCAAGGACCAGCCTTGGCAGTATAGCAAGACCTCAGCTCTAAAAAAATCTTTTAAAAATTAGCCAAGCATAGTGGCATGTGCTTGCAGTCCTAGCTATTCAGGAGGCTTAGGGAGGAGGATCGCTTGAGCCCAGGTATTTAGGCTGTAGTGAGCTATGATCACACCACTGTACTCCAGCCTGGGTGACAGATTGAGACCTTGTCTCTAAAAAAAGAAAAAAAGAAGAAGAGAAAGA","GGTGGCTCATCCCTGTAATCCTAGCACTGTGCGAGGCTAAGACAAGAGTTCTGGAGGCCAGGAGTTCAAGGACCAGCCTTAGCAGTATAGCAAGACCTCGTCTCTAAAAAAAAATTTTAAAAATTGGCCAGCCATAGTGGCATGTGCTTGCAGTCCTAGCTACTCAGGAGGCTTAGGCAGGAGGATTGCTTGAGCCCAGGTGTTCAGGCTGTAGTGAGCTATGATCACACCACTGTTCTCCAGCTTGGGTGACAGAATGAGACCTTGCCTATAAACAAAGAAGAAAAAAAAAAAGAAGAGAA"
"chr1","6999104","6999409","chr1","6136275","6136590","23","862829","GGCCAGGCATGGTGGCTCATGCCTGTAATTCCAGCACTTTGGGAAGCTGAGGTAGGAGGATCACTTGAATCCAGGAGTTTAAGACCACCCTAGGCAACATAATAGGGAGACCTTGTCTCCACAAAAAATTAAAAATTAGCCATGTGTAGTGGTGCATGCCTATGGTCCCAGCTACTCAGAAGGCTGAGATGGGAGGATCACTTGAGCCCAGGAGGTTAAGGCTGCGGTGAGCCATGATCACACTACTGCACTCCAGCCTGGGTTTCAGAGTGAGACCCTGCCTCAAAAAAATAAATAAAATAATAA","GGCCAGGCATGGTGGCTCATGCCTGTAATTCCATCACTTTGGGAAGCTGAGGTAGGAGGATTACTTGAATACAGGAATTTAAGACCATCCTGGGCAACATAATAGGGAGACCTCGTCTCCACAAAAAAATTTAAAAATTAGCCATGTGTAGTGGTGTATGCCTGTGGTCCCAGCTACTCAGAAGGCTGAGATGGGAGGATCACTTGAGCCCAGGAGGTTAAGGCTGCAAGTGAGCCATGATCACACTACTGTACTCCGGCCTGGGTTTCAGAGTGAGACCCTGCCTCAAAAATAAATAAATAAATAAATAAAACAA"
"chr1","7134611","7134828","chr1","6273895","6274107","25","860716","CAGCCTGGGGAACACATGAAGACCCCAACTCTCCAAAAAAAAATTTTTTTTAATTAGCCAGGCATGGTGATGTACTCCTGTGGTCCCAGCTACTCAGGAGGCTGAAGTGAGAGACTCACTTGAGCCCAGGAGATCGAGGTTGCAGTGAGCCAAGATTGCACCACTGCACTCCAGCCTGGGTGGCAGAGCAAGACCCTGTCTACAAAAAAAAAAAAAAA","AGCCTGGGGAACACAGGAAGACCCCATCTCTCCAAAAAAAAAAAATTTTTTTTAAATTAGCCAGGCGTGGTGATGTACTCCTGTGGTCCCAGCTACTCAAGAGGCTGAGGTGAGAGACTTGCTTAAGCCTAGGAGATCAAGGTTGCAGTGAGCCAAGATTGCACCACTGCACTCCAGCCTGGGCAGCAGAGCAAGACCCTGTCTCAAAAAAAA"
"chr1","7146812","7147008","chr1","6287865","6288061","15","858947","CCATCCTGGGAAACATAGTGAGACCCTGTCTTTACAAAAAATACAAAAATCAGCCGAGCATGGTGATACACACCTGTAGTCCTAGCTACCCAGGAGGCTGAAGTGGGAGGATCGTTTGAGCCCAGGAGTTCAAGGCTGCAGTGAGCTATGATCACATACCACTGCACTCCAGCCTGGGCAAGAGAACAAGACTCTGT","CCATCTTGGGAAACACAGTGAGACCCCGTCTCTACAAAAACTACAAAAATCAGCCGAGCATGGTGATACATGCCTGTAGTCCTAGCTACCCAGAAGGCTGAGGTGGGAGAATCGTTTGAGCCCAGGAGTTCAAGGCTGCAGGGAGCTATGATCACACACCACCACACTCCAGCCTGGGAAAGAGAACAAGACTCTGT"
"chr1","7152503","7152814","chr1","6293664","6293944","49","858839","GGCCAAGCACTGTGGCTCACACCTAGAATCCCAGCACTTTGGGAGGCCAAGGTGGGAGGATTGCTTGAGCTCAGGAGTTAGAGATGAGACCAGCCTGGACAACATAGTGAGACCCCATCTCTACAAAAATTTTAAAAATTAGCTGGGCATGGTGGTGCGCACCAGTGGTCCCAGCTACTTGGGTGGCTGATGTGGGAGGATCACTTGTGCCCAGGAGGTCAAGGCTGCAGTGAGCCATGATTGTGCCACTGCACTCCAGCCTGGGCAACAGAGCAAGACTGTCTCTCAAAAAAATAAATAAATAAAATAAAA","GGCCAAGCACTGTGGCTCACACCTAGAATCCCAGCACTTTGGGAGGTCAAAGTGGGAGGATTGCTTGAGCTCGGGAGGTTGAAACCAGCCTGGACAACATAGTGAGACCCCGTCTCTACAAAAATTTTAAAAATTAGCTGGGCATGGTGATGTGTGTGGTGGTCCCAGCTACTCAGGAGGCTGATGTGGGAGGATCACTTGTGCCCAGAAGGTCAAGGCTGCAGTGAGCCATGATTGTGCCACTGCACTCCAGCCTGGGCAACAGAGCAAGACCCTGTCTC"
"chr1","7173688","7174000","chr1","6316566","6316866","39","857122","GGCCAGGGGTGGTAGCTCATGCCTGTAATTCCCAGCACTTTGGGAGGCCAAGGCAGGAGGATCACTTGAGGCCAGGAGTTTGGGAACAGCCTGTGCAACACAGCATGTCCCCATCTCTACAAAAAAATTTTTTTAATTAGCCAGGTATGATCCTGTGCAACTGTAGCCCTAGCTACTTGCGAGACTGAGGTGGGAGGATTGCTCGAGCCCAGGAGTTCAAGGCTGCAGTGAGCTATGATTGCGTCATTGCACTTCAGCCTGGGTGACAGAGCAAGACCCTGTCTCAAAAACAAAAACAAGAACGAAAACAAAA","GGCCAGAGGTGGTGGCTCATGCCCGTAATCCCAGCACTTTGGGAGGCCAAGGCGGGAGGATCACTTGAGGCAAGGAGTTTGGGAACACAGCAAGACCCCATGTCCACAAATTTTTTTTAAAAAATTAGCCAGGTATGATCCTGTGCAACTGTAGTCCTAGCTACTTGGGAGACTGAGGTGGGAGGATTGCTTGAGCCCAGGAATTCAAGGTTGCAGTGATCTATGATTGTGCCATTACACTTCAGCCTGGGTGACAGAGCAAGACCCTGTCTCAAAAACAAAAACAAGAATGAAAACAAAA"
"chr1","7181953","7182225","chr1","6325766","6326039","16","856187","GCTGGGTACAGTGGCTCACACCTGTAATCCCAGGACTTTGGGAGGATTGTTTGAAGCCAGAAATTTGAGACCAGTCTGGGCAACATAGTGAGACCCTGTCTCTACCAAAAATGTAAAAATTAGCTGGGTATGGTGGCACATGCCTGTAGTCCTAGCTACTCGGGAGGCTGAGGTGGGAGGATCACTTGAGGCTAGGAATTCGAGGCTGCAGTGAGCTATGATTACCCCACTGCATTCCAGACTGGGTGACAGAGCAAGACTCTGTCTCTAAAA","GCTGGGTACAGTGGCTCACACCTGTAATCCCAGGACTTTGGGAGGATTGTTTGAGGCCAGAAATTTGAGACTGGTCTGGGCAACATAGTGAGACCCCATCCCTACCAAAAAATTTAAAAATTAGCCGGGTATGATGGCACATGCCTGTAGTCCTAGCTACTTGGGAGGCTGAGGTGGGAGGATCACCTGAGGCTAGGAATTTGAGGCTGCGGCGAGCTATGATCACCCCACTGCATTCCAGACTGGGTGACAGAGCAAGACTCTGTCTCTAAAA"
"chr1","7405844","7405957","chr1","6542885","6543001","6","862959","GGCTGGGCACTGTGGCTCATGCCTGTAATTCCAACACTTTGGGAGGCCAAGGTGAGAGGATTGCTTGAGGCCAGGAGTTTGAGACCCTCCAAACCTCAACATGGTGAGACCCCG","GGCTGGGCACTGTGGCTCATGCCTGTAATTCCAACACTTTGGGAGGCCAAGGTGATAGGATTGCTTGAGGCCAGGAGTTTGAGACCCTCCAAACCTCAACATGGCGAGACCCACATC"
"chr1","7545317","7545587","chr1","6668555","6668832","21","876762","TCGGGGGGCCGAAATGGGAGGATTGATTGAGCCCAGGAGTTCAAGACCAAGCTGGGCAACATGGTAAGAGCCCCGTCCCTAAAACAAACATAAAATAAAAATTAGCTGGGCATAGGGGTGTGTGCCTGTAGTCCCAGATACTTGGGAGGCTGAGGTGGGAGGATCACTTGAGCCCAGGAGGCTGCGGTGTGCTGTGACTATACCACTGCACTCCAGTCTGGGCAACAGAGTGAAATCTGTCTCTAAAAAAAAATAGAAAGAAATGAAAGAA","TCGGGGGGCCAAAATGGGAGGACTGACTGATTGAGCCCAGGAGTTCAAGACCAACCTGGGCAACATGGTGAGAGCCCCGTCCCTAAAAAATAAAATAAATTAAAAATTAGCTGGGCATAGGGGTGCGTGCCTGTAGTCCCAGATACTTGGGAGGCTGAGGTGGGAGGATCACTTGAGCCCAGGAGGCTGCAGTGTGCTGTGACTGCACCACTGCACTCCAGTCTGGGCAACAGAGCGAAATCTGTCTCTAAAAAAAATAGAAAGAAAGAAATGAAAGA"
"chr1","7657479","7657785","chr9","128228335","128228636","58","120570856","CCGGACGTGGTGGCTTACGCTTGTAATCCCAGCACTCTGGGTGGCCGAGGCAGGAGGGTTACTTGAGCCCAGGAGTTCAAGATCAGCCTGGGCAACATGGCGAGACCCTGTCTCTACAAAAAATAGAAAAATTAGCCAGATGTGGTGGTGCACACCAGTAGCCCCAGCTACTTGGGAGGCTGAGGTGGAAGGAACACTTGAACCTAGGGAGTTCAGGGCTGCAGTGAGCTGAGATGGCGCCACTGCACTCCAGCCTGGGTGACAGAGCAAGACCTTGTCTAAAGAAAAGAAGAGAGAGAAGAGAAGA","GGCTGGGCGCAGTGGCTCACTTCTGTAATCCCAGCACTTTGGGAGGCCAAGGCAGGAGGATCACTGGAGCCCAGGAGTTCAAGACCAACCTGGGCAACACAGGGAGACCCTGTCTCTACAACAAATTTAAAAATTAGCTGGACATGGTGGTGCACACCTGTAGTCCCAGCTACTCGGGAGGCTGAGGTGGGAGGACCACTTGAACTCATGAGGTTGAGGCTGCAGTGAGCTGTGATTGTGCCACTGCACTTCAGCCTGGGGGACAGAGCAAGATGCTGTCAAAAAAAAAAAAAAAAAAAAAA"
"chr1","7718548","7718708","chr8","43486431","43486585","32","35767883","TAGCCAGGCGTGGTGGCTTTCACCTCTAATCTCTGCACTTTGGGAGGCCAAGGCAGAAGGATCGCTTGAGCCCAGGAGTTCAAGGCTGCAGTGAGCCATGATCATGCCACTGCTATGCAGCCTGGGCAACAGCAAGACCCTGATTCAAAAAAAGAAAAAGA","TTAGCCACGCGTTGTGGTATGCACCTGTAGTCCCTGTACTTGGGAGGCAGAGGCAGAAATATCGCTTGAGCCCAGGAGTTCGAGGCTGCACTGAGCTATGATTGTGCCACTGCAGTCCAGCCTGGGCAACAGAGACCCTGTCCAATAAATAAAAA"
"chr1","7720517","7720809","chr1","6839781","6840078","37","880736","TGGCTCACACCTGTAATCCCAGCATGTTGGGAGGTTAAGGCAGGAGGATCTCTTGAAGCCAGGAGTCTGAGACTAGCCTAGGCAACATAGCAACACCTCATCTTTAAAAAAATTTGAAACAAATAGCTGGACACAGTGGCACACACTTATAGTCCCAGCTACTCAGGAGGCTGAAGCAGGAGGATTGCTTGAGCCCAGGAGTTTGAGGCTGTGGGTGAGCCACGATTACACCACTGCACTCCAGCCTGGGTGACAGAACAAGACCCTGTCTCAAAAAAAAAAAAAAAAAGGAA","GGCCAAGTGTGGTGACTCACACCTGTAGTCCCAGCACTTTGGGAGGTCAAGGCAGGAGGATCTCTTGAGGCCAGGAGTCTGAGACTAGCCTAAGCAACATGGCAAGACCTCATCTTTAAAAAAAATTTAAAACAAATAGCTGGACACAGTGGCACACGCCTATAGTCCCAGCTACTCGGGAGGCTGAAGCAGGAGGATTGCTTGAGCCCAGGAGTTTGAGGCTGCAGTGAGCCACAATTACACCACTGCCCTCCAGCCTGGGTGACAGCAAGACCCTGTCTCAAAAAAAAAAAAAAAA"
"chr1","7726215","7726518","chr1","6845768","6846074","26","880447","GCTGGGCACAGTGTCTCATGCCTGTAATCCCAGCACTTTGAGGCTGAGGCAGGAGGATCACTTGAACTCAGGAGTTGGAGACCAGCCTGGGCCACATAGTAAGACCCTATCTCAACAAAACATAAAAAAATTAGCTGGGCATGGTGGCATGAGCCTGTAGTCCCAGCTACTCTGGAGGCTGAGATGGGGGGATCACGTGAGCCCAGAAGGTGGAGGCCACAGTGAGCTTCAATCATACCGCTGCACTCCAGCCCGGGCAACAGAGTGAGACCCTGTTTCAAAAACAAAATAAAACAAAGCAAAA","GCTGGGCACAGTGTCTCATGCCTGAAATTCCAGCACTTTGAGGCTGAGGCAGCAGGATCACTTGAACTCAGGAGTTGGAGACCAGCCTGGGCAGCACAGTAAGACCCTGTCTCAACAAAACATAAAAAAATTAGCTGGGCATGGTGGCATGTGCCTGTAGACCCAGCTCCTCTGGAGGTCGAGATGGGGGGATCACATGAGCCCAGAAGGTGGAGGTTACAGCAAGCTTCCATCATGCTGCTGCACTCCAGCCCAGGCAACAGAGTGAGACCTTGTCTCAAAAACAAAATAAAACAAAGCAAAACAA"
"chr1","7744663","7744975","chr1","6863286","6863588","34","881377","GGCTGGGCATGGTGGCTCACGCCTATAATCCCAGCGCTGTAGGAGGCCAAGACGGGAGGATTGCTTGAGCCCAGGAGTTCAAGACCAGCCTGAGCAACATACTGAGACCCTGTCTCTATAGAAAAAAAAATTTTTTTTAAATTAGCCAGGCGTGGTGGGACATCCCTGTGGTCCCAGCTACTCAGGAGGCTGAAGTGGGAGGATCATTTGAGCCCGGGAGGTTGAGGCTGCAGTGAGCCATGATCACTCCACTGCACTCTGACCTGGTCAACAGAATAAGACCCTGTCTCAAAGAGAAGAAAAAAAAAAAAAA","GCTGGGCGTGGTGGCTCACACCTATAATCCCAGCACTTTAGGAGGCCAAGACGGGAGGATTGCTTGAGCCCAGGAGTTCAAGACCAGCCTGGGCAACATACTGAGACCCTGTCTCTCTAAAAAAAAATCTAAAAGTTAGGCGTGGTGGTACATCCCTGTGATCCCAGCTATTCAGGAGGCTGAAGTGGGAGGATCACTTGAGCCTGGGAGTTGAGGCTGCAGTGAGCCATGATCACTCCACTGCACTCCAACCTGGTCAATAGAATAAGACCCTATCTCTCAAAAAAAAAAAAAAAAAAAAAA"
"chr1","7789821","7790085","chr1","6908613","6908879","16","881208","GGCTAGGTGCGGTGACTCATACCTGTAATCCCAAAGCTTTGGGAGGCCAGGAGTTTGAGACCAGCCTGGGCAACATAGCATCTCTACAAACAATTGTTAATAATTAACCAGGCATGGTAGTGCACACCTGTAAGTCCCAGCTACTCAGGAGGCTGAGACAGGAGGATTGCTTGAGCCCAGGAATTCAAGGCTGCAGTGAGCCGTGATCATGCCACTGCCCTCTAGTCTGGGTGACAGAGTGAGACCTTTTCTCAAAAAAAATAAA","GGCTAGGCGTGGTGACTCATACCTGTAATCCCAAAGCTTTGGGAGGCCAGGAGTTCGAGACCAGCCTGGGCACCATAGCATCTTTACAAACAATTGTTAATAATTAACCAGGCATGGTAGTGTACACCTGTAAGTCCCCGCTACTCAGGAGGCTGAGACAGGAGGATTGTTTGAGCCCAGGAATTCGAGGCTGCAGTGAGCCATGATCATGCCACTGCACTCTAGACTAGGTGACACAGTGAGACCTTTTCTCAAAAAAAAATAAAA"
"chr1","7810819","7811126","chr1","6929678","6929980","28","881141","GATGGCTCACATCTATAATCCCAGCACTTTAGGAGGCCAAGGCAGGAGGATCACTAGAGCCCAGGAGTTCGAGAACAGCCTGGGCAACACAGTGTGACCCTGTCTCTACAAAAAATAAATAAATAAATAAAATTAGTCAGGCGTGATGGTGCGTGCCTGTGGTCCTAACTACCCTGGAGGCTGGGGTGGGAGGATCACTGAAGCCCGGGAGTCTGAGGCTGCAATGAGCCATGATCACACACTGCACTCCAGCCTGAGTGACAGAGCAAAACCCTGTCTCAAAGCAAAGCAAAACAACAACAAAAAAA","GTGTGATGGTTGACATCTATAATCCCAGCACTTTAGGAGGCCAAGGCAGGAGGATCACTAGAGCCCAGGAGTTCGAGACCAGCCTGGGCAACATAGTGTGACCCTGTCTGTACAAAAACAAATAAGATTAGTTGGGCGTGATGGTGCGTGCCTGTGGTCCTAACTACCCTGGAGGCTGGGGCGGGAGGATCACTTAAGCCCGGGAGTCTGAGGCTGCAATGAACCATGATCATACACTGCACTCCAGCCTAAGTGACAGAGCAAAACCCTGTCTCAAAACAAAGCAAAACAACAACAAAAAAA"
"chr1","7817559","7817848","chr1","6936711","6936985","41","880848","GTGTCTCATGCTTATAATCCCAGCACTTTGGGAGGCTGAGGCAGGAGAATCACTTGAGGCCAGGAGTTCAAGACTGGCCTGGGCAACATAGTGAGACCCCATCTCTACAAAAAATTTAAAACAAAAATTAGTTGGGCATGGTGGTACGTGCCTGTAGTCCCAGCTACTTAGGAGGCTGAGGCAAGAGGGTTGCTTGAGTCCAGGTGTTCAAGGCAGTAGTGAGCCAGAATTGCATCACTGCACTCCAGGCTGGGCAGCAGAGCAAGACCCTGTATCTTAAAAAAAAAAAA","TCATTCTTATAATCCCAGCACTTTGAGAGGCTGAGGCAGGAGGATCCCTTGAGGCCAGGAGTTCAAGACTGGCCTGGGCAACATAGCAAGACCCCATCTCTACAAAAAATGTAAAAACAAAAATTAGCTGAGCATAGTGGTACGTGCCTGTAGTCCTCCCAGCTACTTAGGAGGCTGAGGCAAGAGGATTGCTTGAGTCCAGGTGTTCAAGGCAGTAGTGAGCCAGAATTGTACCACTGCACTCTAGGCTGGGCAATAGAGCAAAACCCTGTCTC"
"chr1","7833772","7834072","chr1","6953882","6954183","19","879890","GGCCAAGCATAGTGGTTCACAGCTGTAACCCCAGGGACTCAGGAGGCCAAGGAGGTAAGATTGCTTGAGGCCAGGAGTTTGAGACCAGCCTGGGCAATACAGTGAAACCCCATCTCTACAAAAAATGTTTAAATTAGCCAAGTGTGGTGACCCACACCTGTAGTCCCAGCTACTTGGGAGGCTGAGGCAGGAGGATCAATTGAGCCTAGCTTGAGCCCATCTTGGGTTCATTGCTACAGTGAGTTCTGATCACATTACTGTACTCCAGCTGAGGGACAGAGCAAGACCCTGTCTCTAAAAA","GGCCAAGAATAGTGGTTCACACCTGTAATCCCAGGGACTCACGAGGCTGAGCAGGTAAGATTGTTTGAGGCCAGGAGTTTGAGACCAGCCTGGGCAATACAGTGAAACCCCATCTCTACAAAAAATTTTTAAACTAGCCAGGTGTGGTGACCCACACCTGTAATCCCAGCTACTTGGGAGGCTGAGGCAGGAGGATCAGTTGAGCCCAGCTTGAGCCCGTCTTGGGTTCATTGCTACAGTGAGCTCTGATCACATTACTGTACTCCAGCCTGAGTGACAGAGCAAGATCCTGTCTCTAAAAA"
"chr1","7845222","7845522","chr1","6964451","6964748","19","880771","GGTTGGGCGTGGTGGCTCACACCTGTAATCCTGGCACTTTGGGAGGCCAAGATGAGAGGACTGCTTGAGGCCAAGAGTTTGAAACCAGCCTGGGCAACACAGTGAGGTTCCGTCTCCATAAAAATAAAAAATTAGCTGAGTGTGGTGGTACATGCCTGTAGTCCTAGCCACTCAGGAGGCTAAGGTTGGAGGATTGCTTGAGCCCAGGAGTTTGAGGCTACAGTGAGCTATGACTGCATCAGTGCACTCTAGCCTGGGTAACAGAGTGACACCTTGTGTCAAAACAACAACAAAAACAAAA","GGTTGGGCATGGTGGCTCACGCCTGTAATCCTGGCACTCTGGGAGGCCAAGATGAGAGGATTGCTTGAGGCCAGGAGTTTGAAACCAGCCTGGGCAACATAGTGAGGTTCCATTTCCATAAAAATAAAAAATTAGCTGAGTGTGGTGGTACGTGCTGGTAGTCCCAGCTACTCAGGAGGCTGAGGTTGGAGGATTGCTTGAGCCCAGGAGTTTGAGGCTACAGTGAGCTATGATTGCATCAGTGCACTCTAGCCTGGGTAACAGAGTGAGACCTTGTGTCAAAACAACAACAACAAAA"
"chr1","7851081","7851373","chr1","6970645","6970940","34","880436","GCTGGGTGTAGTGGCTCATACCTATAATCCTAGCACTTTGGGTGGCTGAGGCAGGTGGACTGCTTGAGCTCAAGAGTTCAAGACCAGCCTGGGCAACGTGGCAAAACTCCATCTCTACGAAATTAAAAATTAGCTGGGCATGGTGGTGTGTGCTAGCTACTCGGGAGGCTGAGGTGGGAGGATTGCTTGAGCCCAGGAGACTGAGGCTGCAGTGAGCCATGATCATGCCACTGCACTCCAGCCTGGGTGACAGAGTGAGACCTTGTACTAAAAAAAAAAAAAGAAAAAGAAAA","GCTGGGTGTGGTGGCTTATACCTATAATCACAGCACCTCAGGTGGCTGAGGCAGGTGGACTGCTTGAGCTCAAGAGCTCCAGGTTGGGCAACGTGGCAAAATCCCATCTCTACAAAAATTAAAAAATTAGCTGGGCATGGGTGGTGTGTGCTAGCTACTTGGGAGGCTGAGGTGGGAGGATTGCTTGAGCCCAGGACACTGAGGCTGCAATGAGCCATGATCATGCCACTGCACTCTAGCCTGGGCAACAGAGTGAGACCTTGTCTAAAAAAGAAAAAAGAAAGAAAAAGAAAAAA"
"chr1","7866379","7866660","chr1","6987250","6987541","46","879129","GCCATGCATGGTGGTTTGCGCCTGTAATCCCAGAGGGTTGGAAGGCTGAGGCTGAGGCAGGAGGATTGCTTGAGGTTAAGATTTTGAGACCAGCCTGGGCAACACAGTGAGACCCCATCTGAAAAAAAAGAACTAGCTCAGTGTGGTGGCATGTGCCTGTGGTTCCAGCTATTTGGAAGGCCAAGGTAGAATTGCTTGAGCCTGGGAGGTCAAGGCTACAGTGAATCATGATCATGCCACTGAACTCCAGCCTGGGTGACAGAGTGAGATCCTGTCTCAAAA","GGTGGCTTGTGCCTGCAATCCCAGAGGGTTGGAAGGCTGAGGCTGAGACAGGAGGATTGCTTGAGGTCAAGATTTTGAGACCAGCCTGGGCAATACAGTGAGACCCCATCTGTAAAAAAAAAAAAAAAAAAAGGAAAAAAAGTTAGCTGGCCATGGTGGCATGTGCCTGTGGTTCCAGCTATTTGGAAGGCCAAGGTAGAATTGCTTGAGCCTGGGAGGTCAAGGCTGCAATGAGCCATGATCATGCCACTGAACTCAAGCCTGGGTGACAGAGTGAGATCTTGTCTTAAAA"
"chr1","7875751","7876048","chr1","63043764","63044066","54","55168013","GGCTGAGCATGGTGGTTCTGTAATCCCAGAACTTTGGGAGGCTGAGGCGAGAAGATCACTTGAGGCCAGGAGTTCCAGACCAGCCCGAGCAACACAGGGAGACCCCATCTCTACAAATACAATTTTAAAAATTAGCCAGGCTTGGTAGCACACACCTGTGGTCCCAGCTACTCGGGAGGCTGAGGTGGGAGGATCATTTGAGCCCAGGAGGTCAAGGCTGCCATGAGCCAAGATTGTGCCACTGCACTCAGCCTAGGTGACAGAGTGAGACCCTGTCTCAAATAAACAAATAAACAAA","GGCCTGGGTGCAGTGGCTCATGACTGCGATCCCAGCACTTTGGGAGGCACAGGCACGAGGATCACTTGAGCCCAGCAGTTCAAGACCAGCCTGGACAACACAGGGAGACCCCATCTCTACAAAAAAATTTTAAAAATTATCTGGGTGTGGTGGCACACACCTGTGGTCCCAGCTACTTGGGAGGCTGAGGTGGAAGGATCACATGAGCCCAGGAGGTTGAGGATGCAGTGAACCATGATTGTGCAGCTGCACTCCAGCCTAGATGACAGAGTAAGATCCTGTCTCAAAGAAACGAAAAGAAAA"
"chr1","7890058","7890331","chrX","52930864","52931128","51","45040806","TGGCTAACACCTGTAATCCCAACACTTTGGGAGGCTGAAGGGGGAGCATTGATTGAGCCTGGGAGTTTTAGATCAGCCTGGGCAACATAGTGAGACTCCATCAGTATAAAAAATTCTAAAAAATAGGCAGGCATGGTGGCACACACCTATAGTCCCAGCTACTCAGGAGGCTGAGATGGGAGGATCACCTGAGCCCAGGAGGTCAAGGCTGCAGTGAGCTGTGATCGTGCCACTGCACTCTAGCCTGGGTGACAGAGCAAGACCCTGTCTCAAA","CAAGCCTGTAATCCCAACACTTTGGGAGGCTGAGGTGGGAGGACTGCTTGAGCCCAGGAGTTTGAGACCACCCTGGGCAACATAGCAAGACCCCATCCCTACAAAAAATAAAAAATTAGCTGGGTATGGTGGTACATGCCTGTAGTCCCAGCTACTCAGAAGGCTGAGGTGGAAGGATGACTTGAGCCCAGGGGGTCAAGGCTGCAGTGAGCCATGATTGTGCCACTGCACTCCAGCCTGGGCCAACAGAGTAAGACCCTGTCTC"
"chr1","7892129","7892445","chr1","7012604","7012905","37","879525","CCAGGTGTGGTGGCATATGTGTGTAACCCCAACACTTTGGGAGGCCAAGGTGGGAGTATTGCTTGGGCCCTGGAGATCAAGACAAGCCTGGGCAACAAAGGGAGACGCCATCTCTACAAACACTTTAAAAATTAGCTGAGTGTAGTGGATAGTGCCTGTAGTTCCAGCTACTTGGGAGGCTTAGGTGGAAGTATTGCTTGAGCCCAGGAAGTCAAGGCTGCAGTGAACTATGATAGTGCCACTGCACTCCAGCCTGGGCAACAGAGTGAGTTCCTGACTCTAAATAAATAAATAAATAAATAAATAAATAAATAAAT","GGCCAAGTGTGGTAGCATATGTGTGTAACCCCAATACTTTGAGAGGCCAAGGTGGGAGGATTGCTTGGGCCCTGGAGATCAAGACCAGCCTGGGCAACAAAGGGAGACCCCATCTCTACAAAAACTTTAAAAATTAGCCGAGTGTAGTGGATAGTGCCCGTAGTTCCAGCTACTTGGGAGGCTCGGGTGGAAGTACTGCTTGAGCCCAGGAAGTCAAAGCTACAGTGAACTATGATAGTGCCGCTGCACTCCAGCCTGGACAACAGAGTAAGTTCCTGACTCTAAATAAATAAATAAATAAA"
"chr1","7897492","7897769","chr1","7018191","7018463","58","879301","GTGGCTCATGCCTATAATCCTAGCCTTTCGGAGGCTGAGGCAGGTGGTTTACTTGAGCCCAGGAGTTTGAGACCAGCCTGGACAACATGAGACCCAGTCTCTAACAAAAAAAAAAAAAAATTAAGCTGGACATGGTAGCGCATGAATGTAGTCCCAGCTACTCGGGAGGCTGAGGTGGGAGGATCACTTGAGTCCAAGAGGAGGTGGAGGTTGCGGTGACCCACCACTCCAGCCTGGGCAACAGGGCAAGACCCTGTCTCCAAAAGGAAAAAAAAAAA","GTGGCTCACTCCTATAATCCCAGCCTTTTGGAGGCTGAGGCAGGTGATTTACTTGAGCCCAGGAGTTTGACACCAGCCTGGACAACATAGTGATACCCTGTCTCTACAAAAAAAGAAAAAATGAGCTGGACATGGTAGCACATGACTGTAGTCCCAGCTACTCGGGAGGCTGAAGTGGGAGGACTGCTTGAGTCCAAGAGGAGGCANNNNNNNNNNNNNNNNNNNNGGGCAACAGAGCGAGACCCTGTCTCCAAAAGGGAAAAAAAAAAAAAA"
"chr1","7900908","7900984","chr16","44594351","44594426","15","36693443","AAAAAAAAAAATGAACCAGGCATGGTGGCATGCACCTGTGGTCCCAGCTACTCGAGAGGCTGAGGTGGAAGGATCAC","AAAAAAAAAAATCTGGGCATGGTGGTGAGCACCTGTAGTCCAAGATACTGGAGAGGCTGAGGTGGGAGGATCACCT"
"chr1","7912901","7913021","chr1","7034260","7034380","9","878641","GGCCGGGGAAGCTGGCTCACTTCTTCAGCACTTTGGGAGGCCGAGGTGGGAAGATCACGTGAGGTCAGGAGTTCAAGACCAGCCTGGCCAACATAGCGAGACCCCCGTCCCTATAAAAAAT","GGCTGGGGACCCTGGCTCACTTCTTCAGCACTTTGGGAGGCCGAGGTAGTAACATCACGTGAGGTCAGGAGTTCAAGACCAGCCTGGCCAACATAGCGAGACCCCGGTCTCTATGAAAAAT"
"chr1","7917367","7917661","chr5","169543224","169543530","78","161625857","GCCAGGTACAATGACTCACGCCTGCAATCCCAGCACTTTGCGAGGCTGAGGCGGGAGGATTTCTGAACACAAGGAGTTTGAGACCAGCAGGGCATCATAGCAAGACTTCATCTTTACAAAAAAATTCAAACATTTTTTTAAATTTAAAAAAAGTTAAAAATTAGAAGTCGTAGCTACTCAGGAGGCTGAAGTAGGAACCCAGGAGTTCAAGGCTGCAGTGAGCTATGATCACACCACTGCACTCCAGCTTAAGCAACAGAGCCAGACCATGTCTCTAAAAAAAAAAAAAAAAAAA","GCTAGGCACAGTGACTCACATCTATAATTCCCAGTGTTTTTGGAGGCTGAGGCAGGAGGATTGCTTGAGATCAGGAGTCTGAGACCAGCCTGGGCAACATAGCAAGACTCCATCTCTACAAAAAAATTTTTTTTAATTAGCCAGACATAGTGGTGTGCACCAGCAGTCCTAGCTACTCAGGAGGCTGAGGTGGGAGGATTGCTTGAGCCCAGGAGTTTGAGACTGCAGTGAGCTATGATCACACCACTGCACTCCAACCTAGATGACACAGTGAGACCCTGTCTCTAAAAAGGAAAAAAAAAAAAAA"
"chr1","7932542","7932832","chr1","7052589","7052879","16","879953","CTGGGGGTGGGGGCTCACGCCTGTAATCCCAGTACTATGGGGGCCAAGGCAGGAGGATCGCTTGAGTCCAGGAGTTCTAGACCAGCTTGGGTAACAGAGCAAGACCCTGTCTCTACAAAACATTTAAAAATTAGCCAGGGGTGGTGGCACATGACTGTGGTCTCAGCTACTCTGGAGGCTGAGGTGGGAGGATCACTTGAGCCCAGGAAGTTGAGGCTGCATTGAGCCGTGATCATGCCACTGCACTCCCGCCTGGGTAATAGAGCAAGCAAGACCCTGTCTTCTAAAAAA","CTGGGCGTGGGGGCTCACGCCTGTAATCCCAGTACTATGGGGGCCAAGGCAGGAGGATTGCTTGAGTCCAGGAGTTCTAGACCATCTTTGGTAACACAGCAAGGCCCTGTCTCTACAAAACATTTAAAAGTTAGCCAGGGGTGGTGGCACATGCCAGTGGTCTCAGCTACTCTGGAGACTGAGGTGGGAGGATCACTTGAGCCCAGGAGGTTGAGGCTGCAGTGAGCCGTGATCATGCCACTGCACTCCAACCTGGGTAATACAGCAAGCAAGACCCTGTCTTCAAAAAAA"
"chr1","7944886","7945104","chr19","2956619","2956834","46","4988267","GCATGGTGGCTCACGCCTATAATCTCAACACTTTGGTAGGCTGAGGCCAGAGGATCACTTGAGACCAGGCGTTGGAGACCAGCCTGAGCAACATAGCAAGACCCCATCTCTACAAAAATTAAAAGACAAACAAAAATTAACTGATGGTGCATGCCTGTGGCCCCAGCTACTCGGGAGACTGAGGTGGGAGGATCACTTGAACCCAGGAGTTTGAGGCTG","GGATGCGGTGGCTCACACCTGTAATCCCAACACTTTGGGAGGCTGAGGCGAGAGGATCACTTGAGCCCAGGAGTTCATGACCAGCCTGGGCAACAGAGCAAGACCCCGTCTCTACAAAAATTTTAAAAATTAGCTGGGTGTGGTGGTGCACACTTGTAACCCCAGCTACTTAGGAGGCTGAGCTGGGAGGATCACTTGAGGCCAGGAGTTAGAGGC"
"chr1","7974520","7974823","chr1","7095020","7095322","26","879500","GGCCAAGTGCAGTGGCTCACCTGTAATCCCAGCACTTTAGGAGGCCAAAGTGGGAGGATCACTTGGGACCAGGAGTTTGAGACCAGCCTGAGCAACATAGCGAGACCGTTTCTCTTTAAATTAAAAATTTGTAAAAGCCAGGTGTGGTGGTGCATGCCTGTAGTTCTAGCTACTTAAGAGGCTGAGGCAAGAGGATCACTTGAGCCTAGACGGTTGCTTGAGCCCAGGAATTTGAGACAGCAGTGAACTGTGATTGTGCCATTGCCCTTCAGCCTGGGTGACAGAGCGAGACCCGTCTCAAAAA","GGCCAAGTGCAGTGGCTCACCTGTAATCCCAGCACTTTAGGAGGCCAAAGTGGGAGGATCACTTGGGGCCAGGAGTTTGAGACCACCCCAGGCAAGATAGTGAGACCCTTTCTCTGCAAATTAAAAATGTTAAAAGCCAGGCATGGTGGTGCATGCCTGTAGTTCTAGCTACTCAAGAGGCTGAGGCAAGAGGATCACTTGGGCTCAGACGATTGCTCGAGCCCAGGAATTTGAGACTGCAGCGAACTGTGGTTGTGCCATTGCCCTCAGCCTGGGTGACAGAGCAAGACCCTGTCTCAAAAA"
"chr1","7975736","7976024","chr1","7096242","7096531","28","879494","GCCAGCCACAGTGGTTCACACCTGAAATCCTAGCACTTTGTGAGGCTGAGGCAGGAGGATTACTTGAGCCTAGGAGTTTTGAGACTAGCCTGGGCAATGAAGCGAGACCCTGTCTCTACAAAAATAAAAAAATTAGCTGGCTGTGGTGGTGCATGCCTGTAGTCCTAGCTCCTGCGGAGGCTGAAGTGGGAGAGTTGCTTGAGCCCAGGAGTTCAAGGCTGTAGTGAGCCATGATTGCATCACGGCACTCTAGCCTGGGTGACGGAGTGAGGGCTTCTCTCTAAAAAAA","GCCAGCCACAGTGGTTCACACCTGAAATCCTAGCACTTTGTGAGGCTGAGGCAGGAGGATTACTTGAGCCCAGGAGTTTCGAGACCATCCTGGGCAATGTAGTGAGACTCTGTCTCTACAAAAATAAAAAAAATTAGCTGGCTGTGGTGGTGCATACCTGTAGTCCTAGCTACAGGGGAGGTTGAAGTGGGAGAATTGCTTGAGTCCAGGAGTTCAAGGCTATAGTGAGCTATGATTGCACCACTGCACTGTAGCCTAGGTGACAGAATGAGACCCTGTCTCTCAAAAAA"
"chr1","7978252","7978551","chr1","7098529","7098833","35","879723","GGTCAGGTGCAGTGGCTCAACGTCTATAATCCCAGTGGTTTGGGAGGCTGAGACAGGAGGATTGCTTGAGGCCAAGAGTTTGAGACCAGCCTAAGTAACACAAAGCGACGCCATCTCTACAAAAAATTTTCTTTTAATTAGCTGGGCACGGTGGTGCACACTTGTAGTCCCAGCTACTTGGGAGGCTATGGTGGGAGGATGACTTGAGGCCAGGGATTTGAGGCTGCAGTGAGCTGTGAATGCACCACTGCGTTCTAGCCTGGGCAACAAAGCAAGAACCTGTCTTATCAGAAAAAAAAA","GGTCAGGCGCAGTGGCTTACACCTATAATCCCAGTGCTTTGGGAGGCTGAGGCAGGAGGATTACTGGAGGCCAAGAGTTTGAGACTAGCCTAAGTAACACATCGAGACCCCATCTCTACAAAAATTTTTGTTTTAATTAGCTGGGCACAGTGGTGCACACTTGTAGTCCCAGCTACTCGGGAGGCTATGGTGGGAGGACGGCTTGAACCCAGAAGTTTGAGGCTGCGGTGAGCTGTGAATGCACCACTGCATTCTAGCCTGGGCAGCAAAGCAAGAACCTGTCTTATCCAAAAAAAAAAAAAAAA"
"chr1","7980525","7980810","chr1","7101124","7101404","20","879401","GGCCAGGTGTGGTGGCTCATGCCTGTAATCCCAGCATTTTGGGAGGCCAAGGCAGAAGGATCTCTTGAAAGCCAGGAGTTTGAGACTAACCTTGGCAACATAGCCAGACCCCCATCTCAACAAACAAACAAAAAAGTAGCCAAGCACAGTACTGCATGCATGTAGTCCCAGCTACTCAGGAGGCTGAGATGGGAGGATCACTTGAAGGCAAGAGTTAGAGGCTGCAGTGAGCTATGATTGCACTCCAGCCTGGGCAGCAGAGTGACACCATGTCTTTCAAACAAAA","GGCCAGGTGTGGTGGCTCATGCCTGTAATCCCAGCACTTTGGGAGGCCAAGGCAGAAGGATCTCTTGAAAGCCAGGAGTTTGAGACTAACCTTGGCAACATAGACCCCATCTCAGCAAACAAACAAACAATTAGCCGAGCACAGTGCTGCATACCTGTAGTCCCAGCTACTCAGGAGGCTGAGATGGGAGGGTTGCTTGAGGGCAAGAGTTAGAGGCTGCAGTGAGCTATGATTGCACTCCAGCCTGGGCAACAGATTGAGACCATGTCTTTCAAACAAAA"
"chr1","7987820","7988104","chr1","7108464","7108752","15","879356","GCGGGGCACAGTGGCTCACATCTGTAATCCTAGTACTTTGGGAGGCCAAGCCAGAAGGATCGCTTGAGGCCAGGAGTTCAAGACCAGACTGTGCAATATAGTTAGACCCTGTCTCTACAAAAAAATTTAAAAATTAGCCAAGTGTGGTGGCTCATACCCATAGTTCCAGCTACTCGGGAGGCTGAGGTGAGAGGATTGCCTGATCCCAAGAGGTGGAGGTTACAATGAACTGAGATCGCACCACTGCACTCCTGCCTGGGTGACAGAGCAAGCCTCTGTCTCAAA","GCAGGGCACAGTGGCTCACATCTATAATCCTAGTACTTCGAGAGGCCAAGCCAGAAGGATTGCTTGAGGCCAGGAGTTCAAGACCAGACTGTGCAATATAGTTAGACCCTGTCTCTACAAAAAAATTTAAAAATTAGCCAAGTGTGGTGGTTCATGCCCATAGTTCCAGCTACTTGGGAGGCTGAGGTGAGAGGATTGCCTGATCCCAAGACGTGGAGGTTACAATGAACTGAGATCACACCACTGCACTCCAGCCTGGGTGACAGAGCAAGCCTCTGTCTCAAATAAA"
"chr1","7993494","7993798","chr1","7114733","7115046","27","878761","GGCTGGGTGTGGTGGCTCATGCCTGTAATCCCAGCACTTTAGGAAACCGAGCCAGGAGGATTGCTTGAGGCCAGGAGTTCAAGACCAGCCTGGGCAACATAGCAAGTCTCCATCTCTACAAAAAAATACAAAAACTAGCCAGGCATGGTGGCATGCACCTGTAGTCCCAGCTACTTAGGAGCCTGAGGTGAGAGGATCACTTGAGCCCCAGGGGGTCAAGGCTACAATGAGCTATGATCACACCACTGCACCCCAGCCTGGGTGTCACAGCAAGACCCTGTCTCCAAAAAAAAAAGAAGAAAAAA","GGCTGGGTGTGGTGGCTCATGTCTGTAATCCCAGCACTTTGGGAAGCCGAGCCAGGAGGATTGCTTGAGGCCAGGAGTTCAAGACCAGCCTGGGCAACATAGCAAGTCTCCATCTCTACAAAAAAAATACAAAAATTAGCCAGGCATGGTTGAATACACCTGTAGTCCCAGCTACTTAAGAACCTGAGGTGAGAGGATCACTTGAACCCAGGAGATCAAGGCTGCAATGAGCTATGATCACACCACTGAACTCCAGCCTGGGTGACACAGCAAGACCCTGTCTCCAAAAAAACAAAAAGAGAAAAGAAAAAAAA"
"chr1","8003194","8003241","chr1","7125876","7125923","1","877318","CCAGCCTGGGTGACAGAGCTAGAGTCTGTCTCAAATAATAATAATAAT","CCAGCCTGGGTGACAGAGCTAGACTCTGTCTCAAATAATAATAATAAT"
"chr1","8042024","8042339","chr1","7162036","7162351","24","879988","GCCGAGCATGGTGGCTCACACCTGTAATCCCAGCACTTTGGGAGGTCAAGGCGGAAGTATCCCTTGAGCCCAAGAATTCGAGACCAGCCTGGGAGACATGGCAAGATGCCATCTCTACAAAAAAAAAGTTTTTTTAAACAGTAGTGGGACATGGTGGCACACCACGTAGGCCACACCTGTGGCCCCAACTACTCTGGAGGCTGAGGCGGGAGGATCGCTAGAGCCCAGGATCAAGGCTGCAGTGAGTGTTTGCACTGCTGCACTCCAGCCTGGGCACAGAGTGAGACTCTGGCTCAAAAAATAAAAATAATAAAAA","GCCAAGTACAGTGGCTCACACCTGTAATCCCAGCACTTTGGGAGGCCAAAGCAGAAGTATCCCTTGAGCCCAAGAATTCGAGACCAGCCTGGGCGACATGGCAAGACCCCATCTCTACAAAAAAAGGTTTTTTAAACAGTAGTTGGACATGGTGGCACACCATGTGGGCCACACCTGTGGCCCCAACAACTCTGGATGCTGAGGCGGGAGGATCACTAAAGCCCAGGAGGTCAAGGCTGCAGTGAGTGTTTGCACTGCTGCACTCCAGCCTGGGCACAAAGTAAGACTCTGGCTCAAAAAATAAAAATAATAAAAA"
"chr1","8058481","8058760","chr1","7183552","7183862","41","874929","GGCCAGGTGTGGTGGTGCACGCCTGTAATCCCAGCACTTTGGGAGGTTGAGGGGGGTAGATCACTTGAGCCCAGGAGTTCGAGACCAGCCTGGAAAACACAGTGAGACCTTGTCTCTAAAAAAAATTTTTTAATTAGCTGGGCATGGTGGTGCATGCCTGTAGTCCCAGCTACTAGGGAGGCTGAGGTGGGAGGATTGCCTGAGCTCAGGAGGTCAAGGCTGCAGTGACCCATGATGACACCACTGCACTCCAGCCTGGGTGACAGGGAGACCCTGTCTC","GGCCAGGTGTGGTGGTGCACGCCTATAATCCCAGCACTTTGGGAGGCTGAGGGGGGTAGATCACTTGAGCCCAGGAGTTCAAGTCCAGCCTGGAAAACATAGTGAGACCTTGTCTCTAAAAAACTTTTTTGTTAATTAGCTGGGCATGGTGGTGCATGCCTGTAGTCCCAGCTACTAGGGAGGCTGAGGTGGGAAGATTGCCTGAGCTCAGGAGGTCAAGGCTGCAGTGAGCCATGATGAGACCACTGCACTCCAGCCTGGGTGACAGGGAGACCCTGTCTCAAAAAAAATAAAATAAAATAAAAATAAAA"
"chr1","8062682","8062804","chr1","7187546","7187661","17","875136","GACCAGGGGCAGGGTCTCACACTTGTAATTCCAACACTCCGGGAGGTTGAGGTAGGATTGTCTGAAGCCAGGAGTTTGAGACCAGCCTGAGCAACAAAGCAAGACCCCTGTCTCTACAAAGAA","GGCCAGACGCAGGGTCTCACACTTGTAATCCCAACACTTCAGGGAGTTGAGGTGGGATTGTCTGAAGCCAGGAGTTTGAGACCAGCCTGAGCAACAAAACAAGATCCCTGTCTCTA"
"chr1","8065520","8065802","chr11","128872693","128872966","61","120807173","GCCAGGCACAGTGGCTCATGCCTATAATCCTAGCACTTTGGGAGGCTGAGACATGAGGATCACTTGAGCCCACGAGTTGGAGACCAGCCTGGGCAACATAGTGAGACCCTGTCTACTAAACAAAAAAAAAAAAAAAAACTTAAAAATAAGACTAAGGCATGGTGGCACACGCCTGAGGTCCCAGCACTCTGGGTGGCTCAGGAGAGAGGGTCACTTGAGGACAGGAGTTTGAGACCAGCCTGAGCAACATAGCAAGACCCCATCTCTATGAAATAAAAATAAA","GCCAAGCATGGCAGCCCATGCCTGTAATCCCAGCACTTTGGGAGACTGAGGCAGGAGGATCACTTGAAGCTAGGAGTTGAAGACCAACCTGGACAACATAGCAAGATCCTGTCTCTACAAGAAAAGAAAAAAATTAAAATTATCTGGGCATGGTGACACTTGCCTATGTTCCCAGCACTTTGGCAGGCCAAGGTGGGAGGATCACTTGAGGCCAGGAGTTCAAGACCAGCCTGGGCAACATAGTGAGACCCCATCTCAAAAAAAAAGAATAGAA"
"chr1","8084776","8085077","chr1","17737031","17737327","58","9652255","GGCTGGGTGTGGTGGCTCACATCTGTAATCCCAGCACTTTGGGAGGCCAAGGTGGGTGGATTGCTTGAGCTATAGTCAGCTTGGGAAACATGGCAAGACCCTGTCTCTACAAAAAGTACAAAAATTAGCTGGGCATGGTGGTGCACACCTATATTACCAGCTACTCAGGAGGCTGAGGTGGGAGGATCACTTGAGCCCAGGAAGTTAAGGCTGCAGTGAGCTATGATCATGCTACTACACTCCAGCCTGGGCATCACAGCAAGACCCTGTCTCAAAATTTAAAAAAGATAAAAATGGAAAAA","GGCTGGGTGCAGTGGCTCGTACTTGTAATCCCAGCACTTCAGGAGGCCAAGGTGGGATGATTGCTTGAGTCCAGGAGTTGACCAGCCTGGGCAACATGCCAAGACCCTGTCCCTACAACAAATTTAAAAATTAGTCAGGCATGGTGGTGTACACCCATAGTTCTAGCTACTCAGGAGGCTGAGGTGGGAGGATCTCTTGAATCCGAGAGGTAAAGGCTGAAGTGAGCTATGATCATGCCACTGCACTCCAGCCTGGGCAATAGAGCAAGACCCTGTCTCAAAAAAAAAAAAAAAAAA"
"chr1","8095982","8096296","chr4","104021076","104021374","68","95925094","GCCAGGAGAGGTGGCTCATGCCTGTAATCCTAGCACTTTGAGAGGCCATGGAGAATTGCTTGAGGCCAGGAATTTGAGACCAGCCTGAGCAACATGGCAAGACCCCATCTCTACAAAATATATTTTTTTTCCAAGAAGAAAACAAAGTTAACTGGGCATGGTGGCATGCACCTCTAGTCCTAGCTACTCAGGAGGCTGAGGCAGGAGGACCACTTGACCCTGGAAGGTGGAGGCTGCAGTGAACTATGATCGCGCCACTGCACTCCAGCCTGAGTGACAGAGCGGACTCTGTCTCCAAAAAAAAAAAAACAAAAA","GCTGGGCATGGTGGCTCATGCCTGTAATCGTAACACTTTACGAGGCCAAGACGGGCAGATTGCTTGAGCCCAGGAGTTTGAGACCAGCCTGGGCAACATAGCAAGACTCCATCTCTACAAAAATCAAAAAAATTACCTGGGCACGGTGGCACACACCTGTAGTCCCAGCTACTTGGGAGCCTGAGGTGGGAGGATCACTTGAGCCTGGAGGCCGAGGCTGCTGTGAGCTGTGATCACACCACAGCACTCCAGCCTGGGTGACAAAGTGAGACCCTGTCTCAAAAAAAAAAAAAAAAAAA"
"chr1","8115466","8115756","chr1","7242270","7242556","13","873196","GGCTCACACCTGTAATCCCAGCACTTTGGGAGGCCGAGGTGGGAGGATTGCTTGAGCCCAGGAGTTCAAGACCAGCCTGGGCAACATAGTGAGATCCCATCTCTACAAATAATAATACTAAAAATTAGCCAGGCTTGATGGCACATGCCTGTGCTCCCAGCTACTTGGGAGGCTGTGGTCGGAGGATCGCTTGAGCCCAGGTGGTAGAGGCTGCAGTGAGTTGTGATCACACCACTGCACTCCAGGCTGGGCGACAGAGCGAGACCCTGTCTCCAAAACAACAACAACAAA","GCTCACACCTGCAATCCCAGCACTTTGGGAGGCCGAGGTGGGAGGATTGCTTGAGCCCAGGAGTTCAAGACCAACCTGGGCAGCATAGTGAGATCCCATCTCTACAAATAATAATACTAAAAACTAGCCAGGCTTGATGGCACATGCCTGTGGTCCCAGCTACTTGGGAGGCTGTGGTCGGAGGATTGCTTGAGCCCAGGTGGTAGAGGCTGCAGTGAGTTGTGATCACACCACTGCACTCCAGGCTGGGCGACAGAGCGGGACCCTGTTTCCAGAACAACAACAAA"
"chr1","8130374","8130697","chr1","7257606","7257928","24","872768","GACTGGGCACAGTGGCTCACACCTGTAATCCCAGCACATTGGGAAGCCAAGGAAGGAGGATTGCTTGAGGACAGGAGTTTGGGATTAGCCTGGGCAAAATAGCAAGACCCCTTCTCTATAAAAAAATTCAAAATAAAAATTAACCAGGTGTGGTGGCACACACCTGTAGTCTCAGCTACTTGGAAGCCTGGGGCAGGAACCTTGGGGATTGCTTGAGCCCAGGGGTTCAAGGCTTCAGTGAGCTATGACTGTAGCACTTCACTCCAGCCTGGCGACAGAGGGAGATCCTGCCTACAAAAAAAAAAAAAAAAAAAAAAAAAAAAA","GACTGGGCACAGCGGCTCACACCTGTAATCCCAGCACATTAGGAAGCCAAGGAAGGAGGATTGCTTGAGGACAGGAGTTTGGGATTAGCCTGGGCAACATAGCAAGACCCCTTCTCTATAAAAAAAATTTGAAATAAAAATTAACCAGGTGTGGTGGCACACACCTGTAGTCTCAGCTACTTGGAAGGCTGGGGCAGGAACCTTGGGGACTGCTTGAGCCCAGGGGTCCAAGGCTTCAGTGAGCTATGATTATAGTACTGAACTCCAGCCTGGGTGACAGAGGGAGATCATGCCTCAAAAAAAAATAAAAATAAAAAGATAAA"
"chr1","8132608","8132905","chr1","7259482","7259755","50","873126","GGCTGACGCCTGTAATCCTACTACTTTGGGAGGCCAAGGCGAGAGGATGGCTTGAAGCCAGGAGTTCAAGACCAGCCTGGGCAACATAATAAGACCCAATATTCTGAGTCTCTACATAAAATTTAAAAATTAGCCAAGGTGGTGGTGTGCCTGTAGTCCTAGCTACTCTAGAGGCTGAGACAGGAAGATCACTTGAGCCCAGGAGTTTGAAGCTGTAGCAAACCATGATCGTGCCACTGCGCTCCAACCTGGGCGACAGAGTGAGAGCCTCTCCCTAAAAATATAAAATAAAATAAAA","GGCTGACACCTGTAATCCTACTAATTTGGGAGGCGGAGGCGAGAGGATGGCTTGAAGTCAGGAGTTCAAGACCAGCCTGGGCAACATAATGAGACCTAATATTTTGAGTCTCTACAAAATATTTAAAAATTAGCCAAGGCAGTGGTGTGCCTGTAGTCCTAGCTACTCTGGAGGCTGAGACAGGAGGATCACTTGAGCCCAGGATTATGGAAGCTGCAGTGAACCATGATGGTGCTCCAACCTGGGAGACAGAGTAAGAGCTTGTCTCTAAAAA"
"chr1","8144624","8144907","chr1","7270845","7271103","32","873779","GGCCGGGCTTGGTGGCTCCTTCCTGTAATGCCAGCACTTTGAGAGGCCAAGGCAGGAGGATTGCTTGAGGCCAGGAGTTCAATATCAGCCTGGGCAACATAGCAAGATCCCATCTCTACAAAAAAATAAAATTAGCTGGGCGTGCCTGTAGTCCTAGCTACTGGTGAGGTTGAGGCGGGAGGATCACCTGAGCCCAGGGGATTGAGGCTGCAGTGAGTGGTAATCTCACCACTGCACTGCAGCCTGGGTGACAGAGCAAGACCTTGTCTCAAAACAAAGCAAAA","GGCCGGGCTTGGTGGCTTATCCCTGTAATGCCAGCACTTTGAGAGGCCAAGGCAGGAGGATTGCTTGAGGCCAGGAGTTCAAGGTCAGCCTGGGCAACATAGCAAGATCCCATCTCTACAAAAGAATAAAATTAGCTGGGCGTGCCTGTAGTCCTAGCTACTGGTGAGGCTGAGGCGGGAGGATCACCTGAGCCCAGGGGATTGAGGCTGCAGTGAGTGGTAATCTCACCACTGCACTGCAGCCTGGGTGACAAAACAA"
"chr1","8167950","8168121","chr1","7295173","7295334","27","872777","CTTGAAGCTGCATGGTTAGGCACATGGCTGTAGTCTTACCTTTCTACTCAGTAGGCTGAAGTACGAGAATCACTTGAGCCCAGGGGTTTGAGGCTGCCCTGAGCCACGATTGTACCATTGTACTTGAGCCTGGGTGACAGAGCAAGACACTGCCAAAAAAAGGAAAAAAAAA","GCTGCGTGGGGTGCACATGCCTGTAGTCTTACCTTTCTGCTCAGTAGGCTGAAGTAAGAGCATTACTTGAGCCAAGGAGTTTGGGGCTGCACTGAGCCACGATCGTGCCATTGCACTTGAGCCAGGGTGACAGAGCAAGACACTGCCAAAAAAAAAAAAAAA"
"chr1","8168377","8168513","chr1","7295599","7295735","11","872778","GCTGGGCACAGTGGCTCATGCCTGTAATCCCCAGCAGGCTTTGAGAGGCCGAGGCAGGAGGATCACTCAAGGGGAGGAGTTCAAGACCAGCCTGGGCAACAAAGCGAGACCTCGTCTCTACAAAATAAAAAATTAGC","GCTGGGCACAGTGGCTCATGCCTTAATCCCCAGCAGGCTTTGAGAGGCCGAGGCAGGAGGATGGCTTGAGGAGGGGAGTTCAAGACCAGCCGGGGCAACAAAGTGAGACCTCATCTCTACAAAATAAAAAAATTAGC"
"chr1","8199450","8199728","chr1","7328835","7329076","51","870615","GCTGGGTGTTGTGGATCATGCTTGTAATTCCCGATACTGAGGCAGGAGAATTGCTTGAGGCCAGGAGTTCAAGACCAGGCTGGGCAACATGGCGAGACCCCATCTCTACAAAAATACAGAAAAATGAGCTGGGCGTGGTGGCACGTGCCTGTGGTCCCATGACTCGGGAGGCTGAAGTGGGAGGATCACTTTAGCTGGGGAGGTGGAGGTTGCAGTGAGTTGAGCACTCCAGCCTGGGCTACAGAGTGAGACGCTGTCAAGAAAAAAAAAGAAAAAAAA","GCTGGGTGTTGTGGCTCATGCTTGTAATTCCCAATACTAAGGCAGGAGAATTGCTTGAGGCCAGGAGTTCAAGATCAGGCTGGGCAACATGGCGAGACCCCATCTCTACAAAAACACAGAAAAATGAGCTGGGCGTGGCAGCACCTGCCTGTGGTCCCAGGACTCGGGAGGCTGAAGTGGGAGGATCACTCCAGCCTGAGCTACAGAGTGAGACACTGTCTCGAAAAAAAAAAAAAAAAAAA"
"chr1","8210154","8210446","chr1","7338604","7338899","20","871550","GGCCGGGGTGGTGACTCACACCTAGAATCCCAACACTTTGAGAGGCCGAGGTGGGAGGATCGCTTGAGGCCAGGAGTTCAAGACCAGCCTGGGCAACACAGCGGGACTCCCTCTCTACAAAAAATAAAAATAAGCCAGGCATGATGGTGTGTGCTTGTAGTCCCAGCTACGCAGGAGGCTGAGGTGGGAGCATTGCTTGAGCCCGGGAGGTTGAGGCCACGGTGAGTAGTGATTGTGCCACTACACTGCAGCCTGGGCGACAGAGTAAGACCCTATCTCAAAAAAAGAGAAAA","GGCCAGGGGTGGTGACTCACACCTAGAATCCCAACACCTCAAGAGGCCAAGGTGGGAGGATTGCTTGAGGCCAGGAGTTCAAGACCAGCCTGGGCAACATAGTGGGACTCCATCTCTACAAAAAATAAAAATAAGCCAGGCAGGATGGTGTGTGCTCGTAGTCCCAGTTACGCAGGAGGCTGAGGTGGGAGCATTGCTTGAGCCCGGGAGATTGAGGCCGCAGTGAGTAGTGATCGTGCCGCTACACTGCAGCCTGGGTGACAGAGTAAGACCCTATCTCAAAAAAAGAGAGAAAA"
"chr1","8219515","8219819","chr1","7348808","7349096","32","870707","GGCCGGGAGCGATGGCTCCAGCCTGTAATCCCAGCACTTTGGGAAGCCGAGGCAGGAGGATCGCTTGAGACCAGGAGTTGGAAACCAGCCTGAGCAACGTAGGGAGACCCTATCTCTACAATTAAAAAAAAAAAAAAAAAAAAAAAAAAAAGACTAGTCGTGGTGGTGCATGCCTGTAGTCCCAGCTACTTGGGAAGCTGAGGCAGGAGGATCACTTGAGCCCAGTGGGTTGAGGCTGCAGTAAGCCATGATCATGCCATTGAACTCCAGCCTGGGTGACAGTGAGCCCCTGTCTCAAAATAAAA","GACCTGGAGTGGTGGCTCAAGCCTGTAATCCCAGCACTTTGGGAGGCCGAGGCAGGAGGATCGCCTGAGACCAGGAGTTGGAAACCAGCCTGAGCAACATAGGGAGACCCTATCTCTACAATTTAAAAAAAAAAAAGCTAGTCGCGGTGGTACATGCCAGTAGTCCCAGCTACTTGGGAAGCTGAGGCAGGAGGATCACTTGAGCCCAGTGGGTTGAGGCTACAGTGAGCCATGATCATGCCACTGAACTCCAGCCTAGGTGACAGTGAGCCCCTGTCTCAAAATAAAA"
"chr1","8221139","8221255","chr1","7350440","7350556","9","870699","GGCTGGACACAGTGGCTCATGCCTGTAATCCCAGCACTTTGGGAGGCCAAGGCAAGTGGATCACTTGAGGCCAGGAGTTCCAGACCAGCCTGGACAACATAGTGAGACCCTGTCTCT","GGCTGGACACAGTGGCTCATGCCTGTGATCCCAGCAATTTGGGAGGCCAAGGTGAGCAGACCACTTGAGGCCAGGAGTTCCAGACCAGCCTGGACAACATAGTGAGACCCCGCCTCT"
"chr1","8237616","8237913","chr1","7368800","7369093","31","868816","GGGTACAGTGGCTCTCACACCTGTAATCCCAGCACTTTGGGAGGCTGAGGCAGAAGGATTGCTTGAGGCCAGGAGTTTGAAACCAGCCAGGGCAACCTAGTGAGAGCCCATCTCTAGAAAACTTAAAAAACATTAGCCAGGTGTGGTGGTGCACGCCTGAAGGCCCAACTACTCAGGAGGCTGAGGCAGAGGATTGCTTGAGCCCAGGAGTTCAAGAATACAATGAACTATGATGGCACCAGTGCACTCCAGCCTGGGAGACAGAGAAAGACGCTGTCTCTAAAAGAAAAAAAAAAAA","GGGTACAGTGGCTCTCACACCTGTAATCCCAGCACTTTGGGAGGCTGAGGCAGGAGGATTGCTTGAGGCCAGGAGTTTGAGACCAGCCAGGGCAACATAGCAAGACCCCATCTCTAGAAAACTTAAAAAAAAAATTAGCCAGGTGTGGTGGAACCTGCCTGAAGTCCCAACTACTCAGGAGACTGAGGCAGAAGGATTGTTTGAACCCAGGAGTTCAAGGATACAGTGAACTATGATTGCACCACTGCACTCCAGCCTGGGAGACAAAGACCCTGTCTCTAAAAGAAAATAAAA"
"chr1","8290197","8290500","chr1","7447808","7448116","35","842389","GGTCAGGCGCAGTGGCTCATGCCTGTAATCCCAACACTTTGGGAGGCTAAGGTGGGAGGATCGCTTGAAGCCAGGAGTTTGAGACCAGCCTGGGCAACGTTGCCAGACCTCATCTCTACAAAAAATACAAAAATTAGCTGGGCATGATGGCACCTGCCTGTAGTCTCAGCTACTCAGGAGGTCAAGGCAGGAGGATTGCTTGAGTCCAGGAGGTCAAGGCTGCAGTGAGTCATGATCGCACCACTGTGCTCCAACCTGGGCAACAGAGTGAGCAACAGAGTGGGACCCTGTCTCAAAAAAAAAA","GGTCAGGCACAGTGGCTCATGCCTGTAATCCCAACATTGGGAGGCTAAGGTGGGAGGATCGCTTGAAGCCAGGAGTTTGAGTCCAGCCTGGGCAACATTTCCAGACCTCATCTCCACAAAAAATACAAAAATTAGCTGGGCATGATGGCACCTGCCTGTAGTGCTGACTACTCAGGAGGTCAAGGCAGGAGGATTGCTTGAGTCCAGGGGGTCAAGGCTGCAGTGAGTCATGATCACACCACTGTGCTCCAGCCTGGGCAACAGAGTGAGACCCTGTCTCAAAAACAAAACAAAACAAAACAAAAAAAA"
"chr1","8301241","8301418","chr1","7458483","7458657","12","842758","GGCCAGGTGTGGTGGCTCATGCCTATAATTCCAGCACTTTACGAGGCCAAGGCAGGAGAATTGCTTGAGGCCAGGAGCCTGGGCAACAAAGCAAAAACCCCATCTCAAAAAGAAAGAAAGAAAGAAATGCTGGGCACTGTGGTGTGTGCCTGCAATCCCAGTTACTTGGGAGGCTGAG","GGCCAGGTGTGGTGGTTCATGCCTATAATTCCAGCACTTTGGGAGGTCAAGGCAGGAGAATTGCTTGAGGCCAGGAGCCTGGGCAACAAAGCAAAACCCCATCTTGAAAAAAAAAAGAAATAAATGCTGGGCACAGTGGTGTGTGCCTGCAATCCCAGTTACTTGGGAGACTGAG"
"chr1","8331095","8331356","chr1","7488262","7488521","29","842833","CCAAGGTGGGAGGACCACTTGAGGCCAGGAGTTTGAGACCAGTCTGGGCAACATAGTGAGACCCCATCTCTGTAACAATTTTTTAAAAATTAGCCAGGTGTGGTGGTGCTCGCCTGTAGTCCCAGCTACTTGGGAGGCTGAGGTGGGAGGATCACTTGAGCCCAGGAGGTCGAGGCTGCAGTGAGCCATGACCACACCGCTGCACTCCAGCCCGGGCGACAGAGCGAGACTGTCTCTAAAACAACAACAACAACAACAACAA","AGGAGGGAGGATCACTTGAGGCCAGGAGTTTGAGACCAGCCTGGGCGACATAGTGAGACCTCATCTTCGTAACAATTTTTTTAAAATTAGCCAGGCGTGGTGGTGCACGCCTGTAGTCCCAGCTACTCAGTAGGCTGAGGTAGGAGGATCACTTGAGCCCAGGAGGCTGAGGCTGCAGTAAGCCATGACTGTACCACTGCACTCCAGCCTGGGCGACAGAGCAAGACTCTGTCTCTAAAACAACAACAACAACAACAAAA"
"chr1","8338777","8339006","chr1","7495568","7495795","25","843209","CAGTCTGGGCAACGTAGTCAGACCCCATCTCTAAAAAAATAAAATTAAAAATTAGCCAAGTGTGGTGGCATGCACCGGTAGTTCCAGCTACTTGGGAGGCTGAGGTGGGAGGATCACTTGAGCCCAGGAGGCTGAGGCTGTAGTGGGCTGAGATTGTGCCACTGCACTCCAGCCTGGGCAACAGAGCAAGACCCTGTCTCAAAAAAAAAAAAAGAAGAAAAGAGGAAAGA","CAGCCTGGGCAACATAGTCAGACCCATCTCTTAAAAAAAAAATTAAAAATTAGCCAGACGTGGTGGCATGCACCTGTAGTCCCAGCTATTCAGGAGGCTGAGGTGGGAGGATCACCTGAGCCCAGGAGGCTGAGGCTGCAGTGGGCTGAGATTGTGCCACTGCGCTCCAGCTTGGGCAACAGAGCAAGACCCTGTCTCAATAAAGAAAAAGAAAAAGGAAGGAAGGAA"
"chr1","8395780","8396057","chr1","7553352","7553628","18","842428","GGCCAGGTGAGGTGACTCACTCCTATAATCTCAGTGCTTTGGGAGGCCAAAGAGGGAGGATCACTTGAGGCCAAAATTTCAAGACCAACCTGGGTAACATAGAAAGACCTCATTTCTACAAAAAATAAAAATATTAGCCGGCCATGGTGGCATGCGCCTGTAGTCCCACTACTTGGGAGGCTGAGGTGGGAGGATTGCTTGAGCCCAGGGGTTCAAGTTATAGTGAGCTATGATCATACCTCTGCACTCCAGTCTGGGTAACAGAGCATGACTTTGTC","GGCCAGGTGAAGTCACTCACTCCTGTAATCTCAGTGCTTTGAGAGGCCAAAGAGGGAGGATCACTTGAGGCCAAAATTTCAAGACCAACCTGGGTAACATAGAAAGACCCCATTTCTACAAAAATAAAAATATTAGCCAGCCATGGTGGCGTGTGCCTGTAGCCCCACTACTTGGAAGGCTGAGGTGGGAGGACTGCTTGAGGCCAGGGGTTCAAGTTACAGTGAGCTGTGATCATACCTCTGCACTCCAGTCTGGGCAACAGAGCGTGAGTTTGTC"
"chr1","8399715","8399814","chr11","118237427","118237525","20","109837712","GGCTCACGAACCTGTAATCTCAGCACTTTGGGAGGCTGAGGCAAGAGGATCATTTGAGGCCAGGAGTTTGAGACCAGTCTGAACATAGTGAGACTCCGTC","TGGCTCACGCCTGTAATCCTGGCACTTTGGGAGGCTGGGGTGGGAGGATGGTTTGAGGCCAGGAGTTTGAGAACAGCCTGGGCAACATAGTGAGACCCC"
"chr1","8456636","8456863","chr1","7607940","7608150","28","848696","AGCCTGGTCAACACAGCAAGACCTTGTCTCCACAAAAAAATTAAAAACATAATAAAATAGCTGAACATGGTGCCATGTGCCTGTAGTCCCAGTTACTTGGGAGGCTGAGGTTGGAGAATCGCTTGAGTCCAGGGGTTAGAGGCTGCAGTGAGCTGTGATCATGGCACTGCACTCCAGCCTGGGCAACAGAGCGAGACTCTGTTTCCAAAAAAAATAATAATAATAAAA","AGCCTGGTCAACACAGCAAGACCTTGTCTCCACAAAAAATTAAAAACATAATAAAATAGTTGAACATAGTGCCATGTGCCTGTAGTCCCAGCTACTTGGGAGGCTGAGGTTGGAGAATCACTTGAGTCCAGGAGTTCAAGGCTGCAGTGAGCCGTAATCATGGCACTGCACTCCAGCCTGGGCAACGGAGCGAGACTCTGTCTCCAAAAAA"
"chr1","8474172","8474295","chr1","7626778","7626901","11","847394","GCTGGGCAAGATAGCTCACACCTGTAATCCCAGCACTTTCAGAAACCAAGGCAAGAGGACTTCTTGAGGCCAAGAGTTTGAGATCAGCCTGGACAACACAGTGAGAACCTGTCTCTACAAAAAA","GCCGGGCAAGGTGGCTCACACCTGTAATCCCAGCACTTTCAGAGGCCAAGGCAGGACGACTTCTTGAGGTCAAGAGTTTGAGACCAGCCAGGACAACACAGTGAGACCCTGTCTCTACAAAAAA"
"chr1","8487644","8487783","chr1","142183123","142183260","24","133695479","GGCCAGACATGGTGGCCCATGCCTGTAATCCTAGCACTTTGGGAGTCTGAGACAGGAGGATTACTTAAGACCAGGAGTTTGAAATCAGCCCTGGCAACAAAGTAAGACGATGTCTCTACAAAAAAAAAAACTTAAAAAAA","GGCCAGGCATGGTGGCTCAGGCCTGTAATCCCAGCAATTTAGGAGGCTGAGGCAGGAGGATCACTTGAGCCAGGAGTTGGAGACCAGCCTGGACAACATAGTGAGACCCTGTCTCTACAAGAAAAAAAAAAAAAAAAA"
"chr1","8488085","8488269","chr15","8429087","8429254","40","58998","TTAGCTGAGTGCGGTGGCACATGCCTGTAATCCCAGCTACAGCTACTCAGGAAGCTGAAGTGGGAGGATCACTTGAGCCTGGGAGGTCAAGCCTGCAGTGAGCCTGCAGTGAGCTGTGACTGTGCCACTGCACTCCAGCCTGGGTGACAGAGCGAGACTTTGCCTCAAGAAAAAACAACAACAAA","TTAGCTGAGCATGGTGGTGCATGCCTGTAGTCCCAGCTACTCAGGAGGTTGAAGAGGGAGGATCACTTGAGCCCAGGAGTTTGAGCCTGCAGTGAACCATGATCGTGCCACTGCACTCCAGCCTGGGTGACAGAGTGAGACCCTGTCTCAAAAAAAAAAAAAAAGAAA"
"chr1","8491061","8491337","chr1","7645614","7645902","46","845447","GGCTGGGTGTGATGGCTCACGCCCGTAATCCCAGCACTCTGGGAGCCTGATGCCAGAGGACTGCTTGAGGCCAGAGAGTTCAAAATCAGCCCTGACAACACAGAGAGAGAAAAAAAATATATTAGCCAGGTATGGTGGTGCATGCCTGTAGTCCTAGCTACTGGGGAGGACGAGGTGGGAGGATGAGTTGAGCCCAGGAGGTTAAGGCTGTAATGAGTCATGATTATGCCACTGCACTCCAGTGTGAGACCCTGTACTTTAAAAAAAAAAAAAAAAA","GGCTGGGTGTGATGGCTCATGCTTGTAATCCCAGCACTCTGGGAACCTGACATGGAAGGACTGCTTGAGGTCAGAGAGTTCAAAATCAGCCCTCACAACAGAGAGACCCCATCTCTACAAAAACTTTAAAAAATATATTAGCCAGGTATGGTGGTGCATGTCTGTAGTCCTAGCTACTGGGGAGGACGAGGTGGGAGGATCACTTGAGCCCAGGAGGTTAAGGCTGTAAGGAGTTGTGATTACACCACTGCACTCCAGCGTGAGATCCTATCTTCAAAAAAAAAAAAAA"
"chr1","8491451","8491681","chr13","33765890","33766118","54","25274439","GGGCAACACAGAAAGGACCCCATCTCAACCAAAAACAAAATTAAAATAGCCGGGCATGGTGCCACGGGTCTATAACCCTAGCTACTCAGGAGGCTGAGGCAGGAGGATCGCTTGAGCTCAGGAAGTTAAGGCTGTAGTGAGCTATAATTGTGCCACTGTACTCCAGCCTGGGTGACACAGCAAGACCCTGTTTCAAAAAAACAAACAAGTAACAACCAAAAAAAAGAAAAA","AGCCTGGGCAACATAGCAAGGCCCTATCTCTACAAAAAAAATTTTTTTTTTATTAGCTGGACATGGTGGCTCATGTCTATAGTCCCAGCTACTCAGGAGACTGAGGCGGGAGGATCGCTTGAGCCCAGGAGGTCAAGGCTGCAGTGAGCTATGGTTGCACCACTGTACTCCAGCCTGGGTGACAGAGCCAGACCCTGTCTCTGAAAAAAAAAAAAAAAAAAAAAAAAAA"
"chr1","8513334","8513442","chr1","7668725","7668832","5","844609","GGCCAGGCACAGTGGCTCATGCCTATAATCCTACTATTTTGGGAGGCCAAGACAGGAAGATAGTTTGAGGCCAGGAGTTCAAGACCAACCCAGGCAACAAAGTGAGACC","GCCAGGCACAGTGGCTCATGCCTATAATCCTACCACTTTGGGAGGCCAAGACAGGAAGATAGTTTGAGGCCAGGAGTTTGAGACCAACCCAGGCAACAAAGTGAGACC"
"chr1","8535206","8535322","chr1","7692362","7692473","16","842844","GCCAGGCACAGTGGCTTCACACCTGGAATCCCAGCACTTTGGGAGGCTACGGCAGGAGGATTATTTGAGGCCAGGAATTCAAGACAAACTTGGGCAACATTAGTTGAGACCCCATCT","GCCAGGCACAGTGGTTTCATATCTGTAATCCCAGCACTTTGGGAGGTTAGGGCAGGAGGATTATTTAAGACCAGGAATTCGAGACAAACTTGGGCAACATTAGCGAGATCCC"
"chr1","8562183","8562476","chr1","7716827","7717123","26","845356","GGTTGGGCACAGTGGCTCACATCTGTAATTCCAGCACTTTGGAAGGCAGAGGCATGAAGACCGCGTGAGCCCAGTAGTTTGAGACCAACTTGGACAACAAAGTGAGACTCTGCCTTTACAAAAATTTAAACATTAGACAGGCATGGTGTCATGCTCTTGTAGTCCCAGTTATTCTGGAGACTGAGGCGGGAGGATCTCCTGAGCCCAACAGCTAAAGGCTGCAATAAGCTATGATGGCACTGCCACACTCCAGCCTGGGTGACAGAGCTAGACCCTGTCTAAAAAAAAAGAAAA","GGTTGGGCACAGTGGCTCATGACTGCAATTCCAGCACTTTGGAAGGCAGAGGCATGAAGACTGCTTGAGCCCAGTAGTTTGAGACCAACTTGGGCAACAAAGTGACACTCTGTCTTTACAAAAAATTTAAAAATGAGACAGGCATGGTGACATGCTCTTGTAGTCCCAGTTATTCTGGAGACTGAGGAGGGAGGATCTCTTGAGCACAAGAGCTCAAGGTTGCAACAAGCTATGATGGCACTGCCACACTCCAGCCTGGCGACAGAGCAAGACCCTGTCTAAAAAAAAAAAAGAAAA"
"chr1","8587325","8587624","chr1","7745081","7745384","27","842244","GGCCAGGCACAGTGGCTCACACCTGTAATCCCAGTGCCTTGGGAGGCCAAGGCAGGAGGATCATTTGAGGCCAGGAGTCTGATACCAGCCCGGGCAACATAGTGAGACTTCATCTCTACAAAACATTACAAAATTAGCCAGGTGTGGTGGCATGTGCTTGTGTGGTCCCAGCTACTCAAAACGCTGAGGCAGGAGGATCGCTTGAGCCCAGGAGCTTAAGGCTGCAGTGCCCTATGATCACACCACTCATTCCAGCCTAGGTGACAGAGCAAGACCGTGTACAAAAAAAAAAAAAAAAAA","GGCCAGGCACAGGGGCTCACATCTATAATCCCAGTGCTTTGGGAGGCCAGGACAGGAGGATCATTTGAGGCCAGGAGTCTGATACCAGCCTCGGCAACATAGTGAGACTTCATCTCTACAAAACATTACAAAATTAGCCGGGCGTGGTGGCATGTGCTTGTGGTCCCAGCTACTCAAAAGGCTGAGGCAGGAGGAGTGCTTGGGCCCAGGAGGTTGAGGCTGCAGTGCTCTATGATCACACCATTCATTCCAGCCTAGGTGACAGAGCAAGACCGTGTCAAAAAAAAAAAAAAAAAAAAAAAAA"
"chr1","8588990","8589277","chr1","7746613","7746935","54","842377","GGCCAGGTGTGTTAGCTCACACCTATAATCCCAGCACTTTGGGGAGTTGGAGATGGGAGGATCACTTGAGGCCAGGAGTTTGAGACCAGCCCTGGCAACTTAGCAAGACCTTGTCTCTACCAAGAAAAAAAAAAAAAAAAAAAAAGCCAGGCATGGTAGCTTGTGGCTATAGTCCCAACTACTTGGGAGGCCACAGACAAGAGAATTGCTTGAGCATAGGCGGTCCAGGTTATAGTGAGCTTATGATTGTACTACTACACCCCAGCCTGGGTAACAGAGCAAGACCCT","GGCCAGGTGTGGTAGCTCACACCTATAATCCCAGCACTTTGGGGAGTTGGAGATGGAAGGATCACTTGAGGCCGGGAGTTTGAGACCAGCCCTGGCAACATAGCAAGACCTTGTCTCTACCAGAAAAAATAAAAATAAAATAAGAGCCAGGCATGGTAGCTTGTAGCTGTAGTCCCAACTACTTGGGAGGCCAAAGACAGGAGAATAGCTTGAACATAGGAGGTCCAGGTTATAGTCAGCTATGATTGTACTACTACACCCCAGCCTGGGTAACAGAGCAAGACCGTCTTAGTTAAGTAAAAAAAAGAGAGAGAGAAAGAGAA"
"chr1","8596930","8597157","chr1","7753709","7753921","30","843221","CAGAAGTTCCACATCCTCAACGTAAGCAACATAAGGAGGAGACCCTGTCTTTACAAAAAATTTTAAAATTAGCAGGGCATGGTGGCCCGTGCCTGTAGTCCCAGCTACTCAGGAGGCTGAGACAGAGAGGCCGAGGCTGTAGTGAGCGCTAAACATGCCACTGTACTCTAGGTGGGTAACAAAGCGAGACCCTGTCTCAAAAAAAAAAAAAAAAAAAAGAAAAAAGAA","CAGAAGTTCCACATCTTTAACTTAAACAACATAAGGAGACCCCGTCTTTACAAAAAATTTTAAAATTAGCAGGGTGTGGTGGCACGTGCCTATAGTCCCAGCTACTCAGGAGGTTGAGACAGAGACCGAGGCTGCAGTGAGCCCTGAACATGCCACTGTACTCTAGGTGGGTGACAAAGCGAGACCCTGTCTCAAAAAAAAAAAGAAGAAAAA"
"chr1","8600916","8601059","chr4","36960164","36960294","31","28359248","GCTGGGTGTGGTGGCTCATGCCTATAATCCCAGCACCTTGGGAGGCTAAGGAGAGAGGAGTGCTTGAGGCCAGGAGTTCAAGACCAGGTTGAACTGGTAAGACCAGTCTCTGACCAGACCCTGTCTCTACAGAAAGTAAAAAAA","GACTGGGTGTGGTGGCTCATCCCTATAATCCCAGCACTTTGGGAGGCCAACGTGGGAGAAATGCTTGAGGCCAGGAGTTTGAGACCAGCCTGGGCAACACAGTAAGACCCTATCTCTACAAAATAAATAAA"
"chr1","8625981","8626264","chr1","7783865","7784149","41","842116","GGCCAAGCTTAGTGGCTCACACTTATAATCCCAACACATTGGGAGGTGGAGGCAGGAGGATCACTTCAGGTCAGAAGTTCGAGACCAGCCTGAGCAACATAGCGAGACTCCATCTCTACAAAAAAATTTTTTTAAATAGCTGGGCACGGTGGCAGGCACCTGCAGTCCCAGCTGCTTAGGAGGTTGAGGTGGGAGGATCACTTAAGCCCAGGAGGTTGAGGCTGCAGTGAGCTGTAATAGCACCACTGCGTGCCAGCCTGGGGAACAAAGCAAGATCCTGTCTC","GTGGCTCACACTTACAATCCCAACATATTGGGAGCTGGAGGCAGGAGGATCGCTTCAGGCCAGAAGTTTGAGACCAGCCTGAGCAACACAGCGAGACTCCATCTCTACAAAAAAAAAAAAAAAAAATTTACATAGCTGGGCATGGCGGCAGGCACCTGTAGTCCCAGCTGCTTAGGAGGTTGAGGTGGGAGGATCACTTAAGCCCAGGAGGTTGAGGCTGCAGTGAGCTATAATATAATAGCACCACTGCGTGCCAGCCTGGGAAACAAAGCAAGATGCTGTCTC"
"chr1","8638966","8639274","chr1","7796805","7797118","28","842161","GGCCAGGCACAGTGGCTCATGCCCGTAATCTCAACACTTTGAGATGCTGAGGCAAGACTCCTGGCTTGAGTCCAGGAGTTCAAGACCAGCCTAGACAACAAAACAAGATCCCTTCTCTAAAAAAAATTAGAAACTAGCTGGGCACAGTGCCATGCACCTGTAGTTCCAGCTACTTGAGAGGCTGAGGCAGGAGGACCACTTGAGCTCGGGAGTTCAAGGCTGCAGTAAGCCGTGTTCATGTCACTGCACTGTTGTCTGGACAACAGAGTGAGACCCTTCCCCGCCACTCAAAAAAAAAAAAAAAAAAAA","GGCCAGACACAGTGGCTCATGACCGTAATCTCAACATTTTGAGATGCTGAGGCAAGATGATGTCTTGAGGCCAGGAGTTCAAGACCAGCCTAGACAACAAAACAAGATCCCTTCTCTAAAAAAAATTTAGAAACTAGCTGAGTACAGTGGCGTACACCTGTAGTTCCAGCTACTTGAGAGGCTGAGGCAGGAGGATCACTTGAGCCCGGGAGTTCAAAGCTACAGTAAGCCATGTTCATGTCACTGCACTGCAGCCTAGACAACAGAGTGAGACCCTTCCCCTGCCACTCAAAAAAATAAAAATGAAAAAAAAA"
"chr1","8646739","8647016","chr3","123351694","123351976","61","114704955","GGCTGGGCGCGGTGGCTCATGACTGTAATCCCAGCACTTTGAGAGGCTGAGGCGGCAGGAGGATTGCTTGAGTAATGTGGAGACCAGCCTGGGCAACATAGTGAGACCGTATCTCTACAAAACAGTAAAAAATTAGCTGGGAGTGTGATGAGACTGCAGTCCCAGCTACTCAGGAGGCTGAGGTAGAAGAATCCCTTGAGCTCAGGAGGGCAAGGCTGCAGTAAGCCCCGTTCACATCATAGCACTCCAGCCTGTGCAGCAGAGCAAAACCCTGTCTC","GGCCGAGTGCAGTGGCTCACGCCTGTAATTCCAACACTTTGAGAGGCTGAGGTGGAAGGATCGCTTGAGCCCAAGAGTTCAAGACCAGCCTGGGCAACATAGTGAGACCCCATCTCTACAAAAAAAGTTTGAAAATTAGCCAAGTATGGTAGCACATGCCTGTAGTCCCAGCTACTCAGGAGGCTGAGGTGGGAGAATCGCTTGAGCCCAGGAGTTCGAGGCTGCAGTGAGCCATGATCACACCACTGCATTCCAGCCTGGGCAACAGAGCAAGACCCTGTTT"
"chr1","8649514","8649640","chr1","7807389","7807519","16","842125","CCAGGCACTGTGGCTCATGCCTTGTAATCCCAGCATTTTGAGAGGCCAAGCCAGAAGGACCACTTGAAGCCAGGAGTTCAAGACCAACCTTGGCAACAAAGTGAGATCCCATCTCCAACATAAAATA","GGCCAGGCACTGTGGCTCATGCCTGTAATCCCAGCACTTTGGGATGCCAAGCCAGAAGGACTGCTTGAAGTCAGGAATTCACGACCAACCTTGGCAACAAAGTAAGATCCCATCTCCACCATAAAATAAAA"
"chr1","8655067","8655392","chr1","7812977","7813296","23","842090","GGCTGGATACAGCGGCTCATGCCTATAATCCCAGCACTGTGGGATAACAAAGTGGGGAAATCATTTGAGGCAAGGAGGCAATCATTTGAGACCAGCCTGGGAAACACAGCAAGACCCCATCTTTACAAAAGAAAAATAAATTTAAAAATTAGCTATGTGTGGTGGTGCAGACCTGTAGTCCTAGCTACTAGGGAGGCTGAGGTGGGAGGTGGGAGGATTGTTTGAGGCCAAGAGTTCAAGGCTACAATGGGCTGTGATCACCACCACTGCACTCCAGCCTAGGGAACAGAGTGAGACCCTGTCTCTTAAAAATCAAAAAAAGAAAA","GGCTGGGTACAGCTGCTCATGCCTATAATCCCAGCACTGTGGGATAACAAAGTGGGGAAATCATTTGAGGCAAGGAGGCAATCATTTGAGACCAGCCTGGGAAACACAGCAAGACCCCATCTTTACAAAAGAAAAATAAATTTAAAAATTAGCTATGCATGGTGGTGCAGACCTGTAGTCCTAGCTACTCCGGAGGCTGAGGTGGGAGGTGGGAGGATTGTTTGAGGCCAGGAGTTCAAGGCTATAATGAGCTGTGATCACCACCACTGCACTCTGGCCTAGGGGAGAGAGACCCTCTTAAAAAACAAAAAAAAAGAAAA"
"chr1","8664853","8664987","chr1","7822741","7822870","12","842112","GCCGGGTGTGGTGGCTCATCCCTAAAATTCTATCTAGCACTTTGGGAGGCTGAGGCAGGAGGATCATCACTACAGGCCAGGAGTTTGAGACCAGCCTGGGCAACATAGCGAGCTCCCATATCTCCACAAAAAATA","GCCGGGCGTGGTGGCTCATCCCTAAAATTCTATCTAGCACTTTGCGAGGCTGAGGCAGGAAGATCACTACAGGCTAGGAGTTTGAGACAAGTGTGGGCAACATAGCGAGCTCCCATCTCCACAAAAAATA"
"chr1","8665038","8665338","chr1","7822922","7823220","15","842116","GGCTGAGCATGGTGGCTCACACCTGTAGCCCAGGATTTTGGGAGGCCATGGTGTGAGGATTGCTTGAGCCCAGGAGTTTGAGACTAGCCTGGGAAACCTAGCAAGATCCCTTCTCTACAGAAATTAAGGAAACTTAGCCAGGTGTGGTGATACATACCTGTAGTCCCAGCTACTCTGGAGGTAAAGGTGGGAGGATTGCTTGAGCCTAGGACGTGGAGGCTGCAGTGAGCCATGATCATGCCTCGGCATCCCAGCCTGGGTGACAGAGGGAGACGCTGACTCAAAAAAACACAACAAAAAA","GGCTGAGCATGGTGGCTCACACCTGTAGCCCCAGGATTTTGGGAGGCCATGGTGTGAGGATTGCTTGAGCTCAGGAGTTTGAGACTAGCCTGCGAAACCTAGCAAGATCCCTTCTCTACAAAAATTAAGGAAACTGCCAGGTGTGGTGATACATACCTGTAGTCCCAGCTACTCTGGAGGTAAAGGTGGGAGGATTGCTTGAGCCTAGGACGTCGAGGCTGCAGTGAGCCATGATCATGCCTCAGCATCCAAGCCTGGGTGACAAAGGGAAACCCTAACTCAAAAAAACAAGCAAAAAA"
"chr1","8680794","8680917","chr5","8654908","8655033","28","25886","GGGCACAGCGACTAACGCCTATAATCTCAACACTTTGGAAGGCCAAGTCAGGAGGATCGCTTGAACCAACGAGTTTGAGAGGAGCCTGGAGAACATGAGACCCCTATCTCTACAAAAAATTTAA","CTGGGTGCGGTGACTCACGCCTATAATCCCAGCACTTTGGGAGGCCAAGGCAGGAGGATCACTTGAGGCCAGGAGTTCGAGACCAGCCTGAGCAACGTAGTGACACCTCATCTCTACAAAAAATAA"
"chr1","8681230","8681311","chr7","651487","651564","20","8029743","TTAAGCCAGGCATAGTGGCACACACCTGTAGCCTCCCAGCTACTCCAGAAGCTAAGGTGGGAGGATAACTTGAGCATGGGAG","ATTAGCTGGGTGTAGTGACACACACCTGTAGTCCCAGCTACTCAGGAGACTGAGATGGGAGGATCACTTGAGCCCAGG"
"chr1","8768783","8769094","chr1","7919354","7919666","27","849429","GGCCGGGAACAGTGGCTCACACCTATAATCCCAACACTTTGGGAGGCCAAAGCAGGAAGACTTCTTGAAGCTAGGCATTCAAGACCAGCCTGGGCAAGAAAGTAAGACCCTGACCCTGTCTCAGCAAAAAATAAAAAATAAAAATTAGCCAGATGTGGTGGCACGCACCTGTAGTCCCAGCTACTCAGGAGGCTGAAATGAGAGGATCTCTTGAGCCCAGAAGGTAGAGGCTGCAGTGAGCTACAATCACGCCACTGCACTGCAGCCTGGGCAACACAGTAAGATCTTGCCTTTAAAAACTAAACAAATAAA","GGCCAGGAACAGTGGCTCACACCTATAATCCCAACAATTTGGGAGGCTGAGGCAGGAAGACTTCTTAAAGCTAAACATTCAAGACCAGCATGGGCAACAAAGTAAGACCCTGACCCGGTCTCAGCAAAAATCAAAAAAAAATAAAATTAGCCAGATGTGGTGGCACACACCTGTAGTTCCAGGTACTCAGGAGGCTGAGATGAGAGGATCTCTTGAGCCCAGAAGCAGAGGCTGCAGTGAGCTACAATCACGCCACTGTGCTCCAGCCTGGACAACACAGTAAGATCTTGCCTCTAAAAACTAAACAAATAAA"
"chr1","8791495","8791617","chr11","71555756","71555880","20","62764261","GGCCAGGCGCAGTCTCATTCCTGTAATCCCAACACTTTGGAAGGCCAAGGTGGGAGGATCGATTGAGGCCAGGAGTTTGAAACCAATCTGGGAAACACAGCAAGACCCCATTTCTATAAAAAA","GGCTGGGCATGGCGGCTCATGCCTGTAATCTCAACACTTTGGGAGGCCAAGGTGGGAGGATCACTTGAGGCCAGGAGTTTGATACCAACCTGGGAAACAGAGAGGGACCCCATCTCTATGAAAAA"
"chr1","8793068","8793171","chr16","70044060","70044158","25","61250992","AAAATTAGCCAGGCATGGTGACATGCCCCTGTAATCGCAGCTACTCAGGAGGAGGCTTAAACAGGAGGATCGCTTGAGCCCAGGAATTTGAGGATGCAGTAAGC","TATTAGCCAGGTGTGGTGGCATGCACCTATAGTCCCAGGTACTCAGGAGGCTGAGGTGGGAGGATCACTTGAGTCCAGGAGATGGAGGTTGCAGTAAGC"
"chr1","8793709","8793784","chr1","31653913","31653986","15","22860204","CAGTGAGCCATGATCACACCACTGCACTCCAGCATGGGCTACAGAGTGAGACTCTATGTCAAAAAATAAAATAAAA","GCAGTGAGCTTTGATCACACCACTGCACTGCAGCCTGGGCAACAGAGCAAGATCCTGTCTCAAAACAAAATAAA"
"chr1","8800486","8800781","chr1","7953099","7953379","44","847387","GCTGGATGTGGTGGCTCACAACTGTAATCCTAGTGCTTTGGGAGGTCGAGGCAGGAGGCTTCCTTGAGACCAGGAGTTTGAGACCAGCCTGGGCAACGTAACAAGACCCCCATCTCTGCAAAAAAAATTAAAAATTAGCCAGGCGTGCTAGCACGTGCCTGTAGTCCAAGCTACTCAGAAGGCTGAGGCGGGAGGATTGTTTGAGCCCAGGAGGTCAAGGCTGCAGTGAGCCAATATCGTGCCATTGCTTTCCAGCCTGGGAGACAGAGTGAGACCCTGTCTCAACAACAACAAAA","GGCTAGATGTGGTGGCTCACAACTGTAATCCTAGTGCTTTGGGAGGTCAAGGCAGGAGGATCACTTGAGACCAGGAGTTTGAGACCAGCCTGGGCAATGTAACAAGACCCCCGTCTCTGTCAAAAAAATTAAAAATTAACCAGGTGTGGTAGCACGTGCCTATAGTCCTAACTACTTAGGAGGCTGAGGCGGGAGGATTGTTTGAGCCTACAAGGTCAAGGCTGCAATGAACCAAGATGGTGCCATTGCTCTTCAGCCTGGGAGACAGAGTGAGATCCTGT"
"chr1","8818510","8818632","chr13","25546692","25546816","19","16728182","GCTGGGTGTGGTGGCTCACTCCTATAATCCCAGCACTTTGAGAGCCAAAGGCAGGAGGATCCCTTGAGGCCAGGAGTTAGAGACCAGCCTGAGCAAAATGGTGAGACTCCGGCTCCACAAAAA","GGCCAGGCACAGTGGCTCACGCCTGTAATCCCAGCACTTTGAGAAGCCAAGGCAGGAGGATCCCTTGAGGCCAGGAGTTTGAGACCAGCCTGGGCAACATAGTGAGACTCCATCTCTACAAAAAA"
"chr1","8832636","8832760","chr9","82847515","82847637","14","74014879","GGCTGGGCACAGCGGCTCATGCCTGTAATCCCAGCACTTTGGGAGGCCAAGGTGGACAGATCTCTTGAGGCCAGGAGTTCGAGACCAGCCTGGGCAACACAGGGAGACCTTGTCTCTACAAAAAA","GGCTGGGCACAGTGGCTCACGCCTGTAATCCCAGCACTTTAGGAGGCCAAGGTGGGAGGATCGCTTGAGGTCAGGAGTACAAGACCAGCCTGGGCAACATAGGGAGACCCGTCTCTACAAAAA"
"chr1","8844353","8844670","chr7","16836681","16836985","60","7992328","GGCTGTGCATGGTGGCTCACGCCTGTAATCCTAGCACCTTGGGAGGCCAAGGCAGGAGGATGGCTTGCACTCAAGCCGGGCTCAAGACCAGCCTGGGCAACATAGTGAGACCTCATCTCTACAAAAAAATTTTGAAAAATTAGCTGGATGTGGTGGCGTGCACCTCTAGTCCCAGCTACTTGGGGGGCTGAGTGAGGGGATCGCTTGAGCCCAGGAGTTTGAGGTTGCAGTGAGCTATGACTGTTCCACTGTACTCCAGCCTGGGTGACAAAGCAAGAACCTGGCTACAAAAAAATAAATAAATAAAAGTAAATAAAA","GGCCGTGCAAGGTGGCTCATGCCTGTAATCTCAGCACTTTGGGAGGCAAGGTAGGAGGATCGCTTGAGTTCAGGAGTTCAAGATCAGCCTGGGTAACATAGTGAGCCCTCCTCTCTATAAAAAAAAATTTAAAAATTAGCCAGGTGTGATGGCATGTACCTGTAGTCCTGGCTACTTGGAAGGCTGAGGAGAGAGGACGCTTGAGCCCAGGAGTTAGAGGCTGCAGTGAGCTATGATTGCACCACTGCACTCCAGCCTGGGTGACAGAGCAAGATCTTGTCTCTAAAAAAAATAATAATAATAAA"
"chr1","8849071","8849213","chr1","8013002","8013143","9","836069","GGCCAGGCACGGTGGCTTATGCCTGTAATCTCTGTACTTTGGGAGGCAGGAGGATTGCGTAAACCCAGGAGTTGGAGACCAGCCTGGGTAATACAGCAAGACCTTGTCTACTAAAAAAAAAGTTTTAAAATTAGCCAGGCATC","GGCCAGGCACGGTGGCTTATGCCTGTAATCCCCGTACTTTGGGAGGCAGGAGGATTGCTTAAGCCCAGGAGTTGGAGACCAGCCTGAGTAATACAGCAAGACCTTGTCTCTAAACAAAAAGTTTTAAAATTATCCAGGCATT"
"chr1","8849525","8849660","chr1","8013451","8013564","29","836074","GCCAGGCATGGTGGCATGTGCCTGTAGTCACAGCTACTCAAAAGACTGAGGTGGGAGGATCGCTTGAGGCCAGGAGGCGGAAGATGCAGTGAGTCCTGGTCACGCCACTGCACTCAGTCTGGCTGACACAGTAAAA","GCCAGGCATGGTGGCTTGTGCCTGTAGTCACAGCTGCTCAAAAGACTGAGGTGGGAGGATCGCTTGAGCCCAGGAGGCGGAAGATGCCGTGAGTCCTGATAAGCCGCAGCACTC"
"chr1","8851787","8851896","chr1","141319339","141319440","29","132467552","AAAAAGTGAAAAATTAGCTGGGCAGGGTGACATGGTCCCTGTAGTCCCAGCTACTCAGGAGGCTGCGGTGGAGAGATCACTTGAGCCCAGGAGTTGTGAGCTGTGATCAC","CAAAAGACAAATAACTTAGCTGGGCATGATGGCATGAACCTGTAGTCCCGGCTATGAGGGAGGCTGAGGTGAGAGTATCACTTGAGCCCAGGAGTTCAAGAC"
"chr1","8858407","8858675","chr1","8022860","8023120","47","835547","GGCTGGGCATATGGTGGCTCACACCTGGAATCCTAGCGCTTGGAGAGGCTGAAATGGCATCACTTGAGCCCAGGAGTTTGAAATCAGCCTAGGGAACATAGCAAGACTCCATTTCTACTAAAATAAAATAAAATAAGTAGCTGGGGGGGTTGGCATACCCCTGTAGTCCCAGCGACTCAGGAAGCTGAGGTGGGAGGATCATTTGATTCCAGGATTTCACAGCTGCACTTAGCTATGATTGCACCCTGCACTCAAGCCTGGGTGACAGA","GTGGCTTACGCCTGGAATCCCAGCGCTTGGAGAGACTAAAACGGCATCACTTGAACCCCAGGAGTTTGAGATCAGCCTAGTGAACATAGCAAGACTTCATTTCTGCAAAAAAATTAAAATAAGTAGCTGAATGGGTGGGAAACCCCTGTAGTCCCAGCGACTCAGGAGGCTGAGGTGGGAGAATCATTTGATCCCGGGATTTCGCAGCTACAGTTAGCTATGATTGCACCTCTGCACTCAAGCCTGGGTGACAGAGTGAGA"
"chr1","8875658","8875932","chr1","8039004","8039298","53","836654","GTACTCCCAGCACTTAGGGAGGCTGAGGCAGGAGGATTGCTTGAGCCCAGGAGTTCTAGAACAGCAGGACAGCCTGGGCAACGTGGGGGAGACCCCAGTCTCTGTAAAAACTAAAAAATTGGGCAGATGTGGCACATGCCTGTAGTCCCATCCCAGCTACTTGGGAGACTCGGGTGGGAGTGTCACTTGAGCCCAGGAGGTTAAGATTACAATGAGCTACGATTGTACCAGTGCACTCCAGCCTGGGAGATAAAGACCTGTCTCAAAGGAAGAAA","CCAGGCTCAGTGACTCACATCAGTAATCCCAGCACTTTGGGAGGCTGAGGCAGGAGGATTGCTTGAGCCCAGGAGTTCCAGAACAGCTTGGGCAACGTGGGGGAGACCCCATTCTCTGTAATAAATAAAAAATTAGCCAGATGTGATGGCACATGCTTGTAGTCCCATCCCAGCTACTTGGGAGACTCAGGTGGGAGGGTCACTTGAGCCCAGGAGGTTAAGGCTACAATGAGCTATGATTGTACCGGTGCCCTCCAGCCTGGGAGTAAAGAAAGACCTGTCTCAAAAGAAGAAA"
"chr1","8881811","8882101","chr1","8045083","8045378","24","836728","GGCTGGGCAGTGGCTCATGCCCATAATCCTGGCACTTTGGGAGTCCAAGCTGGTGAATCGCTTGAACCCAAGAGTTCTAGATCAGCTTGGACAACAAAGTGAGACTTCTCTCTACCAAAAAAAATTAAAATTAGCCAGGCGTGGTGGTACATGCCTGTAGTCCCAGCTACTCAGGAGGCTAAGATGGGAGGATCACTTGAACCCTGGAGGCTGAAACTGCAATGAGCTGTGATCATGCCACTGCACTCCAGCCTCAGTGACAGAGCAAGACCCTGTCTTAAAAAAAAGAAA","GGCTGGGCACAGTGGCTCACGCCCATAATCCCAGCACTTTGGGAGGCCAAGATGGTGAATCGCTTGAACCCAAGAGTTCTAGATCAGCTTGGCCAACAAAGTGAGACTCTCTCTACCAACAAATAAAAATAAAAAATTAGCCAGGCGTGGTGGTACGTGCCTGTGGTCCCAGCTACTCAGGAGGCTAAGATGGGAGGATCACTTGAACCCTGGAGGCTGAAGCTGCAATGAACTCTGATCATACCACTGCACTCCAGCCTCAGTGACAGAGCAAGAACCTGTCTTAAAGAAAGAAA"
"chr1","8892717","8892971","chr1","8752314","8752565","66","140403","GGCCAGGCACAGTGGCTCACACCTATAATCCCAGCACTTTGGGACGACCAGGAGGGAGGACTGCTTGAGACCAGGAGCTCGAGACCAGTGTAGGCAGCACAGTGAGACCCCTGTCTCTACAAAAAAAATTGGCAGGGCATGGCGGTGTGCCAGCTACTCAGGAGACTGAGGCAGGAGGATCTCTTGAGCCCAGGAGATTGAGGCTGCAGTGAGCTATGATTGTGCCACTGAGACCCTGTCTCAAAGAAAAAAAAA","CACGGTAGCTCACACCTGTAATCCCAGCACTTTGGGAGGCTGAGGAAGGAGAATTGCTTGAGGCCAGGAGTTCAAGGCCAGCCTGGGCAACATAGGGAGACCCTGTCTTTACAAAAAATTAGTTGAGCATGCACCTGTAGTCCCAGCTACTTGGGAGGCTGAGGTGGGAGGATCCCTTGAGCCCAGGAGGTTGAGGCTGCAGTGAGCCATGGGATCATGCCACTGTACCCCAATCTGGATGACAGAGCAAGA"
"chr1","8898240","8898487","chr20","10685324","10685570","51","1787084","CACTTTGTAAGGCCGAAGTAGACAGATTGCTTGAGCCCAGGAGTTGAAGACTAGGCTGGACAACATGGCAAAACTCCGTCTCTACCAAAAAAAATATAAAAATTAGCCATGTATAGTGGCACGTGCCTGTAGTCCCAGCTCCTCAGAAGGCTAAGGTGAGAGGATTGCTTGAGCCCAGGAGGTGGAGGTTGCAGTGAGCCAAGATCACACCACTGCACTCCAGCCTGGGCAACAGAGCAAGACCCTGT","CACTTTGGGAGGCTGAGGCAGGAGGATCACTTGAGGCCAAGAGTTTGAGACCAGCCTGGACAACATAGCAAGACCCCATCTCTAAAAAAAAAAAAATACAAAAATTAGCCAGGGATGGTGGCATGTACCTGTAGTCCCAGCTACTCAGGAGGCTGAGGCAGAAGGATTGCTTAAGCCCAGGAGTTGGAGGCTGCAGTGAGTTATGATTGCACCATTGCACTCCACCCTGGGCAACAGAGCAACGCCC"
"chr1","8911494","8911813","chr1","8084194","8084516","22","827300","GGCTGGGAGCAGTGGCTCACTACTGTAATCTCAACACTTTGGGAGGCTGAGGCAGGAGGATTGCTTGAGGTCAGGAGTTCAAGACTAGCCTGGGCAATATAGCAAGACTCTGTCTCTACCAAAGCCAGAAAAAAAAAAATCTAAAATAAAGTATTCTTAGGGACACCTCTCAAGAATTGTAACTAAGAGGTGGGCAAGGTGGTGCCTGCCTGTTGTTTCAGCTACTGAGTTTCAGGCTGCAGCGTGCTAGGATCGCACTTGTGAATAGCCACAGCTCTCCAGTCTTGGCAACATAGCAAGACCCTGTCTTTAAAAAAAAA","GGCTGGGAGCAGTGGCTCACCACTGTAATCTCAACACTTTGGGAGGCTGAGGCAGGAGGATTGCTTGAGGTCAGGAGTTTGAGACTAACCTGGGCAATATAGCAAGACTCTGTCTCTATCAATGCAAAAAAGAAAAAAAAAATTCTAAAATAAAGTATTCTTAGGGACACCTCTCAGGAATTGTAACTAAGAGATGGGCAAGGTGGTACATGCCTGTAGTTTCAGCTACTGAGTTTCAGGCTGCAGCGTGCTGGGATCGCACTTGTGAATAGCCACTGCTCTTCAGTCTCGGCAACATAGCAAGACCCTGTCTTTAAAAAAAA"
"chr1","8921773","8921940","chr1","8093677","8093848","17","828096","TTAACCAGACGTGGTGGCATACACCTGTGGTCCCAGCTACTGGGGAGGCTGAGATAGGAGGATACTTGAGCCCAGGAGGTAGAGGCTACAGTGAACTGTGATCGCGCCACTGCAGTCTAGCCTGGACAACAGAACCAGATCCTGTCTCGAAAAAAGAAAAACGAAAAA","TTAGCCAGATGTGGTGGCATACACCTGTGGTCCCAGCTATTGGGGAGGCTGAGATAGGAGGATCACCTGAGCCCAAGAGGTAGAGGCTACAGTGAACTGTGATTGTGCCACTGCAGTCTAGCCTGGGCAACAGAACCAGACCCTGTCTCAAAAAAAGAACGACAAAAAACAA"
"chr1","8922223","8922367","chr1","8094151","8094298","14","828072","CTGGGCACGGTGGTTTATACTTGTAATCCCAGCACTTTGGGAGGCTGAGGCGGGAGGATCACTTGAGGCTAGGAGTTTGAGACCAGCCTGGGCAACAAAGTGAGACTCCATCTACTATAAAAAAATGTAAAAATTAGCCAGGCAT","CTGGGCACGGTGGCTTATGCTTGTAATCCCAGCACTTTAGGAGACTGAGGCAGGAGGATCACTTGAGGCTGGGAGTTTGAGACCAGCCTGGGCAACAAAGTGAGACTCTATCTCTACAAAAAAAAAAAGTAAAAAATTAGCCAGCCAT"
"chr1","8926757","8926875","chr1","8097834","8097959","16","828923","GGGCATGGTAGCTCTCACCTGTACCCAGCACTTTGGGAGGCCAAGGTAGATCACTTAAGGCCAGGAGCTCAAGATCAGCCTGGACAACACAGCAAGACCACATCTCTACCCCCAAAAAA","GGGCATGGTAGCTCTTATCTGTACCCAGCACTTTGGGAGGCCAAGGTAGATCACTTGATGCCAGGAATTCAAGATCAGCCTGGACAACATAGCAAGACCCCAACTCTACCCCCCAAAAAAGAAAAA"
"chr1","8949753","8950027","chr1","8123622","8123892","25","826131","GGCCGGGTGCACTGGCTCACACCTGTAATTCCACCACTTTGGGAGGCCAAGGCAGGGGAATTGCTTGAGCCCAGGAGTTGTAGATCAGCCTGGGCAATGTAGCGAGATCTTGTGTCTGCAAAAAAAAAAAAAAAAAATTAGCCAGGAGTGGTGGTACACGCCTATAGTTCCATCTTCTGAGGAGGCTGAGGTGGGAGGATCACTTGAGGCCAGGAGGCTGAGGCTGCAGTAAGTCCTGATCATGCCGCTGCACTCCGGTCTGAGTAACAAAACAA","GGCTGGGTGCACTGGCTCACACCTGTAATTCCAGCACTTTGGGAGGCCAAGGCAGGGGAATTGCTTGAGCCCAAGAGTTCTAGATCAGCCTGGGCAACGTAGCAAGATCCTGTGACTAAAAAAAAAAAAAAAAATTAGCCAGAGTGGTGGCGCACACCTATAGTTCCAGCTTCTGAAGAGGCTAAGGTGGGAGGATGGCTTGAGACCAGGAGGTTGAGGCTGCAGTGAGTCCTGATCATGCTGCTGCACTCCAGTCTGAGTAACAAAACAA"
"chr1","8958788","8958911","chr1","200289163","200289285","17","191330375","GGCCGGGCACAGTGGCTCACACTTGTAATCTCAACACTCTGGGAGGCCAAGGCGGGAGGATTGCTTGGGGCCAAGAGTTCAAGACCAGCCTGGGCAACACAGGGAGGCCCCGTCTCTACAATAA","GGCTGGGCACAGTGGCTCACACCTGTAATCCTAGCACTTTGGGAGGCCAAGGCAGGAGGGTTGCTTGAGGCCAAGAGTTCAAGACCAACCTGGCCAACATAGTGAGACCCTGTCTCTAAAAAA"
"chr1","8963231","8963529","chr1","8140002","8140309","32","823229","GGCCGAACGAGGTGGCTTGTGCCTATAATCCCAGCACTTTGGGAGGCTGAGGGGGAGGATTGCTTGTGGCCAGGAGTTTGAGACCAGTCTGAGCAACATAGTAAGAGTCCATCTCTACAAAAAATACAAAAAAAATTAGCTGGGTGTGGTGGTGTGTGCCTGCAGTCTCTGCTACTGGGGAGGCTGAGGTGGGAGGATCACTTGAGCCTGGATGGTTGAGGCTGCAGTGAGCCGTGATTGTGCCACTGAGCTCCAGTCTGGGCAACAGACTGAGACCTTGTCTCAAAAAAGAAAAAAAA","GGCCGAATGAGGTGGCTCGTGCCTATAATCCCAGCACTTTGGGAGGCTGAGTGGGGAGGATTGCTTGAGGCCAGGGGTTTGAGACCAGGCTGAGCAACATAGTAAGATTTCATCTCTACAAAAAATACAAAAAAAATTAGCTGGCTGTGGTGGTGTGTACCTGCAGTCTCCATTACTGGGGAGGCAGAGGTGGGAGGATCGCTTGAGCCTAGACGGTTGAGGCTGCAGTGAGCTGTGATTGTGCCACTAAGCACCAGCCTGGGTAACAGAGTAAGACCTTGTCTCAAAAAAGAAAAAAAAAAAAAAAA"
"chr1","8978337","8978632","chr1","8154719","8154995","41","823618","GGCTGGGCATGGTGGCTCATGCTCGTAATCCCAGCACTTTGGGAGGCCGAGGCAGTAGGACTGCTTGAGCCCAGGAGTTTGAGACCAGCCTGGGCAACATAGCAAGACCCTGTCTCTACAAAAAATAAACAATTAGCTGGGCATGGTGCTGCACACCTGTGGTCCCAGCTACTCCGGAGGCTGGGGTGGGAGGATTGCTTGAGCCCTGGAGGCAGAGGTTGCAGTGAGCTGAGATTGCACCACTGCACTCCAGCCTGGGCGACAGAGCAAGACCCTGCCACAAACAAACAAACAAA","GGCCAGGCACGGTGGCTCACACTCATAATCCCAGTACTTTGGGAGGCTGAGGCAGTACGACTGCTTGAGCCCAGGAGTTTGAGACCAGTCTGGGCAACATAGCAAGACCCTGTCTCTATAAAAAATAAACAATTAGCTGGGCATGGTGCTGCACACCTGTGGTCTCAGCTACTCTGGAGGCTGGGGTGGAAGGATCACTTGAGCACTGGAGGCGGAGGTTGCAGTGAGCTGAGACTGTACCACTGCACTCCAGCCTGGGTGACAGAGCGAGACCCTG"
"chr1","8982760","8983029","chr15","14646159","14646430","54","5663399","GCTGGGTGTGGTGGCTCATGCCTGTAATCCCAGCACTTTAGGAGGCTGAGGCAGGAGGATCTGTTGAGGCCAGTAGTTTAAGACCAGCCTGGGCAACATAGTGAGACCCTGTCTCTACAAAAAATGGTAGTGTGTGCCTGTAATCCCAGCTACTCAGGAGGCTGAGGCAGGAGGATGGCTTGAGCATAGGAGTTGGAGGCTGCAGTGAGTCATGACTGTACCACTCCACTCCAGCCTGGGTGGCAGAGTGAGACCCAGTCTCCAAAACAA","GGCTGGGTGTGGTGGCTCACACCTGTAATCCCAGCATTTTGGGAGGCCGAGGTGGGAGGACTGCTTGAGTCTAGGAGTTTGAGACCAGCCTGGGCAATATGGCAAGGCCCCATCTCTACAAAAAAATACAAAAATTAGCCAGGTGTAGTCCCAGCTACTCAGGAGGCTGAGGTGGGAGGATTGCTTGAGCTGGGGAGGTTGAGGCTACAGTGAGCCATGATAATACCACTGTACTCCAGCCTGGGTGACAGAGTGAGACCCTGTCTCAAAAA"
"chr1","8995675","8995947","chr1","8173167","8173436","21","822508","GGTTGGGTGCTGTGGCTCACACCTATAATCCCAGCACTTTCGAAGTTTGAGACCAGCCTGGGCAATATAGCAAGACCCCATCCCTAAAATAAATAAATAAATAAATAGCCATGTGTGGTGGCCCATGCCTGTGGTCCCAGCGACTTGGGAGGCTGAGGTGGGAGGATCACTTAAGCCTGGGAGGTCAAGGCTGCTATGAGCTGTGGTTGCACCACTGCATTCCAGCCTGGGTGACAGAGCAAGGCCCTGTCTAAAAAAAAAAAAAAAAAAGAA","GGTCAGGTGCCATGGCTCACACCCATAATCCCAGTGCTTTGGAAGTTTGAGACCAGCCTGGGCAATATAGCAAGACCCCATCCCTAAAAAAAAAATTAAAACAATAGCCATGTGTGGTAGCCCATGCCTGTGGTCCCAGCGACTTGGGAGGCTGAGGTGAGAGGATCACTTAAGCCTGGGAGTCGAGGCTGCTGTGAGCTGCGTTTGCACCACTGCATTCCAGCCTGGGTGACAGAGCAAGGCCCTGTCTAAAAAAAAAAAAAAAAAAAA"
"chr1","9007285","9007588","chr4","142473682","142473973","68","133466397","GCTGGGTGCAGTGGCTCATGCCCAGCATTTTGGGAGGACAAGGCAGGAGGATCATTTGAGCCCAAGAGTTCACGACCAGCCTGGGCAACATAGCAAGACTCTGTCTCTACTAAAAATTTAAAAAAAAAAAAATGAGCCAGGTGCAGTAATGCACGCATGTAGTTCCAGCCACTCAGGAAGCTGTGGTGGGAGGATCACATGAGCCTGGGAGATTGAGGTTGCAGTGGGCTATGATCGCACCATTGCACTTCAGCTTGGCTGATAGAGCTAGACTCTGTCTACAAAAAAAAAAAAAAAAAAGAAA","GCCAGGTGCAGTGGTTCCTGGCACTTTGGGAGGCCAAGGCGGGAGGATCACTTGAGCCCAGGAGTTCAAGACCAGCCCAGACAACATAGCAAAACCCTGCTTCTACAAAAAATAGAAATAAATAAATTGGGCATGGTGATGCATGTCTGTATTCCCAGCTACTTGGGAGGCTGAGGTGGGAGGATTGCTTGAGCCCAGGAGTTTGAGGTTGCAGTGAGCTATGATTGCATCATTGCACTCTAGTCTGGGCTGGACAAAGTAAGACTCTGTCTTAAAAAAAAAAAAAAAAAAA"
"chr1","9025080","9025382","chr1","8203338","8203635","27","821742","GGCTGGGTGTGCTGGCTCATGCCTGGAATCTCGGCACTTAGGGAGGTTGAGGTGGGAGGATTACTTAAGGCCATGAGTTCGAGACCAGCCCGGGCAACACAGTGAGAAACCCCCGCCCCCCACCATGTCTACAAAAAGTAAAAATAAAAATAATTAACTGAATGTGGTGATACACACCTGTAGTCCCAGCAACACGGGTGTCTGAGGCAGGAGGATCGCTTGTGCCTAGAAGTCATGATCACACCAGTGCACTTCAGCCTGGGCAACAGAGCAAGACCTTGTCTCTAATAAATAAATAAATAA","GGCTGGGTGTGCTGGCTCATGCCCGAATCTCGGTACTTAGGGAGGTTGAGGTGGGAGGATTGCTTGAGGTCACGAGTTGGAGACCAGCCTGGGCAACATAGTGAGACACCCTCGCCCCCACCATCTCCACAAAAAGTAAAAATAAAAATAATTAACTGAATATGATGGTGCACACCTGTAGTCCCAGCAACACAGGTGTCTGAGGCAGGAGGATCGGTTGTGCCTAAAAGTCATGATCATACCAGTGTACTTCAGCCTGGGCAACAGAGCAAGACCTTGTCTCTAATAAATAAATAAA"
"chr1","9034120","9034247","chr2","44878801","44878925","25","35844681","GCTGGGTGTGATGGCTCGTGCCTGTAATTTCAGCACTTGGGGAGGCTAAGTGGGGAGGATAAATTACTTGGGGTCAGGAGTTTGAGACCAGCCTGGGCAACATAGTGGAACCATTTCCACTAAAAATA","GGCTAGGTGTGGTGGCTCACGCTTGTAATCTCAGCACTTTGGGAGGCTGAGGTGGGAGGATTGCTTGAGGCCAGGAGTTTAAGACCAGCCTGGGCAACATAGTGAGACCCCATTTCTACAAAAAA"
"chr1","9041663","9041796","chr10","30449663","30449796","24","21408000","GGCTGGGTGCAGTGCTCATGCCTGTAATCTCAGCACTTTTGGACACTGAGGTAGGAGGATCACTTGTGTACAGAAGTTCCAGACCAGCCTGGGCAACATAGTGAGACGCCATCTCTAGAAAACAATAATAAATT","GGCTGGGTGCAGTGGCTCATGCCTGTAATCCTAGCACTCTGGGAGGCCAAGGTAGGAGGACTGCTTAAGGCCAGGAGTTCAAGACCTGCCTGGGCAACATGGTGAGACCCCATCTCTACAAAAAATAAAAAATT"
"chr1","9042112","9042293","chrX","97446542","97446722","35","88404430","TTAGCTGGGCACTACTGGTGGTGCACTCCTGTAGTCCCAGCTACTGGAGAGGCTGAGGCGGGAGTATTGCTTGAGCTAGGAAGTTTGAGGCTGCAGCAAGATGTGATTGTGTCACTGCACTCAGCCTGGGTGACAGAGTGACACCCTGTCTCAAAAACAAAAAACAAAAAAAGGAAAGAAAA","TTAGCTGGGCATGGTGGTGCACATCTGTAGTCCTAGCTACTTGGGAGGCTGAGGTGGGAGGATTGCTTGAGCCCAGGAGTTTGAGGTTACAGTGAGCTGTGATTGCACCACTGTACTCTAGCCTGAGTGACAGAGTGAGACCCTGACTCTAACAACAAAAAAAAAAGTAAGAAAAAAAAAA"
"chr1","9044527","9044761","chr3","74945806","74946044","62","65901279","GGCAGGACATGGTGGCTCATGCCAGTAATCTCAGCACTTTCAGAGGCCAAGGTGGGAGGATGGCTTGAGGCCAGGAGTTCAAGACCAGACTGAGCAACATAGCAAGACCCCATCCCTGTAGTCTCAGCTACTAGAGAAGAGGATCATGTGAGCACAGGAGGTGGAGTCTGCAGTGAGCCATAATCGCACCACTGCACTCCAACCTGGGCGACAGAGTAAGACCATATTTCAAAAA","GGCGAGGCACAGTGGTTCATGTCTGTAATGCCAGCACTTTGAGAGGCCAAGCCAGGAGAATTGGTTCAGGCCAGGAGTTTGAGACCAGTCTGGGCAACATAGCAAGACCCCATCTCTCCCCCTAAAAAAAAATATTAGCCAGTCTACCACTTGAGCCCAGGAGTTGAGGCTACAGTGAGCCATGATTGCGCCACTGCACTCCAGCCTGGGCAACAAAGCCAGACCCTGTCTCTTAAAAA"
"chr1","9050383","9050700","chr1","8229384","8229686","28","820999","GGCCGGGCACAGTGGCTCATGCCTACAATCCCAGGCACTTTGGGAGGCTGAGGCAGGAGGATCGCTTGAGCCCAGGAGTTTGAGACCAGTCTTGGACCTAATATAATCGAGACCCCTGTCTCTATAAAAATATATTTTTTAATTAGTCCAGGGCATGATGGCATGCACCTGTAGTCCCAGCTACGTCGGGGAAGCTGGAGGTGGGAGGATCACTTGAGCCCAGGAGGTTGAGGTCGCAGTGAGCTATAATAGCACCACAGCACTCCAGCCAGGGCAAGAAAGCAAGACTCTGTCTCAGAAAAAAAAAAAAAAAAAAGA","GGCTGGGCACAGTGGCTCATGCCTACAATCCCAGCACTTCGGGAGGCCGAGGCAGCAGGATCGCTTGAGCTCAGGAGTTTGAGACCAGCTTGGACAATATAATGAGACCTCTGTCTCTATAAAAAAATTTTTTTAATTAGCCAGGCGTGATGGCATGCACCTGTAGTCCCAGCTACTCGGGAGGCTGAGGTGGGAGGATCACTTGAGCCCAGGAGGCTGAGGTCGCAGTGAGCTATAATAGCATCTCAGCACTCCAGCCAGGGCAAGAAAGCAAGACCCTGTCTCAAAAAAAAAAAAAAAAAA"
"chr1","9051826","9052131","chr6","100949181","100949485","37","91897355","CTGAGTGTGATGGCAAACGCTTAAATCCCAGCACTTCGAGAAGCTAAGTAAGGTAGGAGGATCACTTGAGCCCTGGAGTTTGAGACCAGATTGGGCAACATAGGGAAATCCTGTCTCTCCCCCCAAAAATTTAAAAATTAGCTGGGTGTGGTGGCACACGCCTGTGGTCCCAGCTACTCACGAGGCTGAGGTGGGAGGATCGCTTGAGCCCAGGAATTCAAGGTTGCAGTGAGCTATGGTTGCACCACTGCACTCCAGCCTGGGCCACAAAATGAGACCCTGTCTCACAAAAAAAAAAAAAAAAAA","CTGGGTGTGATGGCAAATGCTCGTAATCCCAGCACTTTGAGAAGCTAAGGTAGGAGGATCGCTTGAGTCCGGGAGTTTGAGACCAGATTGGGCAACATAGGGAGACCTGTCTCTACCAAAAACAAAATTAAAAATTAGCTGGGTGTGGTGGTGAATATGCCTGTGGTCCCAGCTACTCAGGAGGCGGAGGTGGGAGGATCGCTCGAGCCCAGGAATTCAAGGCTGCAGTGAGCTATGGTCGCACCACTGCACTCCAGCCTGGGCAACAAAGTGAGACCCTATCTCAAAAAAAATAAAAATAAAAA"
"chr1","9053803","9053872","chr1","8232496","8232577","19","821307","GTATACAGGCTGGGCATGGCAGCTCACACCTGTAATACCAGCACTTTGAGAGGCTGAGGCAGGAGGATTG","TTTAAATAAATAAAGTATACAGGCTGGGCGTGGCAGCTCACACCTGTAATACCAGCACTTCGGGAGGCTGAGGCAGGAGGAT"
"chr1","9054176","9054317","chr1","8232891","8233021","16","821285","GGCACTGTGGCTCACACTTATAAAACCAACACTTTGGGAGGCTGAGGCGAGAGGATTGCTTGAGACCAGGAGTTCAAGACTAGCTTGGGCAACATAGCAAGACCCTGTCTCTATAAAAAATGTAAATAATAGCTTGATGTGT","GGCACTGTGGCTCACACTTATAAAACCAGCACTTTAGGAGGCTGAGGTGAGAGGATTGCTTGAGACCGGGAGTTCAAGACTAGCTTGGGCAACATAGCGAGACCCTGTCTCTATAAAAAATGTAAATAATA"
"chr1","9056894","9057204","chr1","8235562","8235859","41","821332","GGCTGAGTGCAGTGGCTCAGGCCTACAATCCAAGGGCTTTGGGAGGCTGAGGCAGAAGGCACACTTGAGCCCAGTAGCCCAAGACCAGCCTGGGTATAGTGAGACCCCGTCTCTTCAAAATATTTAAAAATTAGCCAAGCGTGGTGCTACATGCCTGTAGTCCCAGCTACTCGGGAGGCTGAGGTGGGAGGATTGCTGGAGCCCCGGACTTCAAGGCCGCAGTGAGCTATGATCCCACCATTGCACTCTGGCCTGGCCAACAGAGTAAGACCCTGTCTCAAAATTAAAAAAAAAAAAAAAAGGAAAAAGAA","GGCTGAGTGCAGTGGCTCAGGCCTACAATCCAAGCACTTGGGGAGGCCTTGAGCCCAGGAGCCCAAAACCAGCCTGGGTATAAGGAGACACCGTCTCTTCAAAGTATTTAAAAATTAGCCAAGCGTGGTGCCGCATGCCTGCAGTCCCAGCTACTCTGGAGGCTGAGGTGGGAGGATTGCTGGAGCCCAGGACTTCAAGGCTGCAGTGAGCTATGATCCCACCATTGCACTCTGGCCTGATCAACAGAGTAAGACCCTGTCTCAAAATTTTAAAAAAATAAATAAATTTTAAAAAAAA"
"chr1","9106242","9106533","chr1","8286836","8287111","30","819406","GACCGGGCATGGCGGCTCTTGTCTGTAATCCCAGCACTTTGAGAGGCCAGGGCGAGAAGATAACTTGAAGCCAGGAGTTCAAGACCAGCCTGGGCAATAAAGCAAGACTTTGTCTCTACAAAAAGCAAAAAATAAGCCGGGCATGGTAGCATGTGTCTGTAGTACCCCCTACTCTGGAGGTTGAGGTGAGAGGATTACTTGAGTCCGAGATTTGGAGGCTGCAGTGAGCCATGACTATGCCACTGCACTCCAGTCTGAGCAACAGAGCAAGACCCTGTCTCTAAAATAACAA","GGCATGGCAGCTCATGTCTGTAATCCCAGCACTTTGAAAGGCCAGGGTGAGAAGATCACTTGAAGCCAGGAGTTCAAGACCAGCCTGGGCAATAAAGCAAGACTTTGTCTCTACAAAAAGCAAAAAGTAAGCCAGGCATGGTGGCATGTGTCTGTAGTACCCCCTATTCTGGAGGTTGAGGTGAGAGGATTACTTGAGCCCGAGATTTGGAGGCTGCAGTGAGCCATGATTGTGCTACTGCACTCCAGTCTGGGCAACAGAGCAAGACCCTGTCTC"
"chr1","9122223","9122348","chr6","32660972","32661093","27","23538749","GGCCGGGCGCAGTGGCCTGTAATCCCAGCTCTTTGGGAGGCTAAGATGGGAGAAACACTTGAGAGGCCAGGAGTTTAAGACCAGCCTAGACGACTTAGTGAGACTCCATCTCATACAAAAATAAAA","GTGCGGTCCCTAATGCCTGTAATCCCAGCACTTTGGGAGGCTGAGATGGGAGGACTGCTTGAGGCCAGGAGTTCAAGACCAGCCTGGTCAACATAGCGAGACTACATCTGTATAAAATAATA"
"chr1","9135334","9135644","chr1","8315082","8315388","26","820252","GCCAGGTGTGGTGGCTCACACCTGTAATCTCAGCACTTTGGGAGGCTGAGGTGGGAGGACTGCTTGAGTCGAGGAGTTAGAGACCAGCCTGGGCAACATAATGAGACCCCTTGTCTTTAGAAAAAATGTAAACATTTGCCAAGTGTGATGGTGTACACCTGTAGTCCCAGCTACTTAGGAGGCTGAGGTGGGAGGCTCGCCTAAGCCCAAGAGGTCAAGGTTGCAGTGAGCCATGATCGCACACTGCACTTCAGCCTGGGCAACAGAGCAAGACCCTGTCTCGGGAAAAAAAAAAAAAAAGGAAAAGAAAA","GCCAGGTGTGGTGGCTCCCACCTGTAATCTCAGCACTTTGGGAAGCTGAGGCGGGAGGATTGCTTGAGTCCAGGAGTTCGAGACCAGCCTGGGCAACATAATGAGCTCCCCCTTGTCTTTAGAAAAAACGTAAACATTTGCCAAGTGTGACAGTGCACACCTGTAGTCCCAGCTACTTAGGAGGCTGAGGTGGGAGACTCGCCTGAGCCCAAGAGGTCAAGGCTGCAGTGAGCCATGATCGCACACTGCACTTCAGCATGGGCAGCAGAGCAAGACCCTGTCTCAGGGAAAAAAAAGGAAAAGAAAA"
"chr1","9141518","9141761","chr1","8321138","8321382","22","820380","GGAGGCCGAGGTGGGAGGATCGCTTCAGGCCAGGAGTTCAAGACCAGCCCAGGCAACTAGCAAGACTCCATCTCTACAAAAAAATTTTAAAATTAGCCAGGCATGGTGATATGCGTGCCTGTAGTCCTAGCTACTGGAGAGGCCAGGGCAGGAGGATCGCTTGAGCCCAGGAGTTGAGGCTGCAGGGAGCTGTGATTGCACCAGTCTGGGTGACAGGGTGAGACCCCGTCTTCAAAAATAAAAA","GGAGGCTGAGGCGGGAGGATCACTTCAGGCCGGGAGTTCAAGACCAGCCCAGGCAACACGGCAAGACTCCATCTCTACAAAAAAAATTAAAAAATTAGCCAGCAAGGTGGTATGCGTGCCTGTAGTCCTAGCTACTGGAGAGGCCAGAGCAGGAGGATCACTTGAGCCCAGGAGTTGAGGCTGCAGGCAGCCATGATTGCACCAGTCTGGGTGACAGAGTGAGACCCTGTCTCTAAAAATAAAAA"
"chr1","9141766","9141904","chr1","8321387","8321526","10","820379","GTGATGGCTCACACCTGTAATCCCAGCAATTTTAGAGGCCAAGACAGGAGGATCACTTGAGGCGAGAAGTTCAAAACCAGCCTGGTCAACATAGCCAGACCCCCACCTTCAGCAACTGTCTCTACAAAATGAAAATAAA","GTGGTGGCTCACACCTGTAATCCCAGAAACTTTGGAGGCCAAGGCGGGAGGATCACTTGAGGCCAGAAGTTCAAAACCAGCCTGGTCAACATAGCCAGACCCCACCTTCAGCAACTGTCTCTACAAAATGAAAATAAAAA"
"chr1","9146828","9147100","chr1","8327872","8328124","43","818956","GGCCTGGTGTGGTGGCTCACGCATATAATCTCCAACACTTTGAGGGGCTGAGGAGGGAGGACTGCTTGAGGACACGAGTTCAAGACCTGTCTGGGCAACATTGCAAGGTGCTATCTCTACAAAAAATTAAAAAGTGAGCTGGGCATGGTGGTGCACGCCTGTGAGGCAGGAGGATCACCTGAGCCTGGGAGGCGGAGGCTGCAGTGAGCCGTGATCACACCACTGCACTCCAGCCTGGGTGATACAGCGAGACCTTGTCTCTAAAAAAATAAA","GGCCTGGCGCGATGGCTGACCCATATAATCCCCAACACTTTTTGGGGCTGAGGAGGGAGGATCGCTTGAGGACAGGAGTTCAAGACCAGTCTGGGCAACACTGCAAGGTGCTATCTCTACAAAAAATTAAAAAGTGAGTAGTGGTGCATGCCTGTGAGGCAGGAGGATCACCTGAGCCTGGGTGAGTCGTGATCGCACCACTGCACTCCAGCCTGGGTAAGACAGAGTGAAACCTTGTCTCTAAAAAAATAAA"
"chr1","9157199","9157493","chr1","8336851","8337140","18","820348","GACCAGGCACGGTGGCTCACACCTGTAATCCTAATGCTTTGGGAAGCTGAGGTGGGAGGATCTCTTGAGCCCAGGAGTTTGAGACCAGCTTGGGCAACACAGGGAGAGGCCATCTCTAAAAATATATTTTAAAATCATCCAGGTGTGCACCTGTAGTCCCAGTTACTCAAGAGGCTGAGGAGCGAGAATCGCTTGAACCCAGGAGTTTGAGGCTGCAGTAGGCTATGATCACACCACTGTACTCTAGCCTGAGCAACAGAGCAAGACCCTGTCTCTAAAAATAAAATAAAATAAA","GACCTGGCGCAGTGGCTCACACCTGTAATCCTAATGCTTTGGGCAGCTGAGGTGGGAGGATCTCTTGAGCCCAGGAGTTTGAGACCAGCTTGGGCAACATAGGGAGAGGCCATCTTTAAAAAAATATTTTAAAATCATCCAGGTGTGCACCTGTAGTCCCAGTTACTCAAGAGGCTGAGGAGGGAGGATCGCTTGAACCCAGGAGTTCGAGGCTGCAGTAGGCTATAATCACACCACTGTACTCCAGCCTGAGCCACAGAGCAAGACCCTGTCTCTAAAAATAAAATAAA"
"chr1","9175588","9175800","chr1","8357064","8357294","28","818524","GAGCTTGAGACCAGCCAGGGCACCATAGTGAGACCCCATCTCTACAAAAAATTTTAAAATTAGCCGGACATGGTGGTGCACACTTGTAGTCCCAGCTACTCAGGAGGCTGAGGCAGGAGGATCACTTGAGGCAGGAGTCTGAGGCTGCAATGAGCCAAGATCACACCAGTGCACTTCAGCCTGGACAACAGAGGGAGACCCTGTCTCTAAAAA","GAGCTTAAGATCAGCCAGGGCAACATAGTGAGACCCCAGCTCTACAAAAAATTTTAAAAGTAGCCGGACATGGTGGTGCACACCTGTAGTCCCAGCTACTTGGGAGGCTGAGGCAGGAGGATCGCTTAAGGCAGGAGGATCACTTGAGGCAGGAGTCTGAGGCTGCAATGAGCCAAGATCATACCAGTGCACTTCAACCTGGACAACAGAGGGAGATCCTGTCTCTAAAAA"
"chr1","9179321","9179618","chr1","8361608","8361902","22","817713","GCCAGGTGTGATGGCTCACACCTGTAATCCCAGCACTTTGGGAGGCTGAGGTGAGCAGATCACTTAAGTCCAGGAGTTTGAGACCAGCCTGGGAAACATAGCGAAATCCTATCTCTAAAAAAATTTGCTGGTCATGGTGGCATGCAATTAACTACTCAGGAGGCTGAGATGGGAGGATCGCTTAAGCTCTGGAAGAGGAGGTTGCAGATAGCTTGAGCTCTGGAGGCAGAGCTGAGTTTGCACTACTGCACTCCAGCCTGGGCAACAGAGTGAGACCCTGTGTCAAAACAGAGAACAA","GCCGGGTGTGATGGCTCACACCTGTAATCCCAGCACTTTGGGAGGCCAAGGTGAGCAGATTACTTAAATCCAGGAGTTTGAGACCAGCCTGGGAAACATAGCGAAATCCTATCTCTAAAAAAAATGAGCTGGTCATAGTGGCATGCAATTAGCTACTCAGGAGGCTGAGATGGGAGGATCGCTTAAGCTCTGGAAGCAGAGGTTGGGATAGCTTGAGTTCCGGAGGCAGAGCTGAGATTGCACCACTGCACTCCAGCCTGGGCAACAGAGTGAGACCCTGTGTCAAAAAAGAGAA"
"chr1","9183468","9183595","chr1","8365831","8365960","7","817637","GGCTGGACATGGTGGCTTATGTCTGTAATCCCAGCACTTTGGGAGGCTGGAGTGGGAAGATTGCTTGAGGCCAGAAGTTGGAGACCAGCCTGGACAACATAGCGAGACCCCATTTAAATAAAATAATA","GGTTGGGCATGGTGGCTTATGTCTGTAATCCCAGCACTTTGGGAGGCTGGAGTGGGAAGATTGCTTGAGGCCAGAAGTTTGAGACCAGCCTGGACAACATAGTGAGATCCCATTTAAATAAAATAATAAA"
"chr1","9199197","9199335","chr1","8382441","8382582","15","816756","GGCCAGGCATGGTGGCTCACGCCAGTAATTCCAACACTTTGGAAGGCTGAGCTGGGAGGGTTGCTTGAGCTCAGGAGTTCAAAACCAGCCTGGGCAACATAGTGAGACTCTGTCTCTAATTAAAAAAAAAAATTAAAAT","GGCCGGGCGCATTGGCTCACGCCAGTAATCCCAGCACTTTGGAAGGCTGAGCTGGGAGGGTTGCTTGAGCTCAGGAGTTCAAAACCAGCCTGGGCAACATAGTGAGACTCCGTCTCTATAAAAAAATAAAATAAATTTAAAA"
"chr1","9199639","9199836","chr1","8382897","8383078","34","816742","TACAACTGGCGATGGTGGTGTGTGCCTACTAGTCCCACGCTACTCGGAGCCTCGAGGTGGGAGGAATTAGCGTTCGTAGGCCCGGGGACGGGTGGAGGAACTGCAGTGAGTCATGACTGTGCCACTACACTCCACGCCTCGGGTGGATAGAGCAAGAAGACCTGTCTCCAAACAAAAAAAAAAAAAAGAAAAGAAAAA","TCATCCGGGCATGGTGGTGTGTGCCTATGGTCCCAGCTACTCGGGAGCCTGAGGTGGGAGAATTGCTTGAGCCCAGGAGGTGGAGACTGCAGTGAGCCATGATTGTGCCACTACACTCCAGCCTGGGTGACAGAGCAAGAAGACCCTGTCTTAAAAAAAAAAAAAAAAAAGAGAAAAGAAAA"
"chr1","9210466","9210765","chr10","25367339","25367629","74","16156873","GGCTGGGTGCAGTGGTGCATGCCTGTAATCCCAGCACTTTGGGAAGCCAAGGCGGGAGGATCACTTGAGGCCATAAGTTCAAGTCCAGCCTGGGCAACATGGTAAGACCCTGTCTAAACCAAAAAATTTGTTTAATTAGCTGGGTATGGTGGCGCATGCCTTTACTCCCAGCTGCTAAAGAGGCTGAGGTGGGAGGATCACTTGAGCCCAGGAGGTCAAGGCTGCAGTGAGTTGTGATCATGCCACTGCACNNNNNNNNNNNNNNNNNNNNNAAAAAACAAACAAAAAAAAAAAAAAAGA","GGCTGGGCACAATGGCTCATGCCTGTCGTCCCAGCACTTTGGGATGCCGAGGTGGGAGGATCACTTGAGGCCAGGAGTTCGAGATCAGCCTGCTTAACATGGTGAGACCCTGTCTCTACCAAAAGAATTTTTTTTAATTAGCTGGACATGGTGGTGCATGCCTGTAATCCCAGCTACTCAGGAGGCTGAGGTGGGAGGATAGCTTGAGCCCAGGAGGTCAAGGCTGCACTCTAGCCTAGGTGGTAGAGCAACACTCTGTCTCAAAAAAAAAAAAAAAAAAAAAAAAGAAAA"
"chr1","9259736","9260027","chr4","6937789","6938091","60","2321947","GTGGGTCATGCCTGTAATCCCAGCACTATGGGAGGCTGAGGTGAGAGGATCACTTGAGCCCAGAAGGTTGAAACCAGCCTGGGCAACATAGTGAGACCCCATCTCTACAAAAAGTTTTAAAACCAGGTATGGTGGTGCCCTCCTGTGGTCCCAGCTACTCGGGAGTCTGAGGTGGGAGGATCACCTGAGCCCAGGAGACTGAGGCTGCAGTAAGGTGTGATTGCACTATTGCTCTCTAGCCTGGAAAACAGAGTGAGACCCTGTCTACAAAAAAAAAAAAAAAAAGGAAAGA","GGAGCAGTGGCATAGGCCTGTAATCCCAGCAATTTGGGAGGCTGAGGTGAGAGGATCACTTGAGCCCAGGAGTTTGAGACCAGCCTGGGCAACAGAGCAAGACCCCATCTCTACAAAAAAATTAAACATTAGCCAGGTGTGATAGTGCGTGCCTGTAGTCCCAGCTACTCAGGAGGCTGAGGTGGGAGGACAGCTTGAGCCCAGGAGTTGGAGGCTGCAGTGAGCTGTGGTTGTACCACTATACTCCAGCCTGGGCAACAGAGTGAGACCCTGTCCCGAAAAGAAAAGAAAACAATAAAGAAA"
"chr1","9275332","9275612","chr3","155129902","155130173","67","145854570","GGCCAGGCACAGTGGCTCATGCCTGGAATCCCAACACTTTGGTAGGCCAAGGCTGAAGGATCACTTGAGGCCAGGAGTTTGAAACCAGCCTGGGCGACATAGAAAGACCCTGTCTCTACCAAAAAAAAAAAAGCTAGCTGGGCATTGTGGCATGTGCCTGTAGTCTACAGGCAATAATTGGGAGGCTGAGGTGGGAGGATCACTTGAGGCTGCAGTGAGCTAGGATCATGCCACTGCACTGCAGCCTGACTCTAAAAAAAAGAAAAAGAAAAGAAAAGGAA","GGCCAGGAGCAGTGGCTCATGCCTGTAATCCCAGCACTTTGGGAGGCAAAGGTGGGAGGATCACTTGAGCCCAAGAGTGTGAGCCCAGCCTGGGCAACAAAATGAGACTCTGTCTCTACAAAAAATTTAAAAATTAGCTGGGCATGGCGGCATGTGCCTGTAGTCCCAGCTACTCAGGAGACTGAGGTGGAAGATTGAGGCTGCAGTGAGCTGAGATGTTGCCACTACACTGTAGCCTGGGCAACAGAGCAAGATTCTGTCTTAAAAAAGAA"
"chr1","9294062","9294368","chr1","8472703","8473013","27","821359","GGCCTGGCATAGTGGCTCACACCTGTAATCCCAGCACTTTGGGAGGCCAAGGTGGGAGGATTGCTTGAGCCCAAGGAGTTCGAGACCAGCCTGAGCAACATAGTGAGACTCCCCCCCCGCCCGCCATCTCTACAAAAATAAAAAATTAGCTGGGCGTGGTAGCTCATGCCTGCAGTCCCAGCTACTTGGGAGGCTGAGGTGGGAGGATCACTTGAGCCTAGGAGGTTGAGGCTGCAGTGAGTTGTGATTGCTCCAGCCTGGGCAACAGAATGAGACCCTGTATCAAAAAACCCAACCAAACAAAAAA","GGCCTGACATAGTGGCTCACACCTGTAATCCCAGCACTTTGGCAGGCCAAGGTGGGAGGATTGCTTGAGCCCAAGGAATTCGAGACCAGCCTGGACAACGTAGTGAGACTCCCCGTCCCCCATCTCTAAAAAAAAAAATTAAAAATTAGCTGGGCATGGTAGCTCATGCCTGCAGTCCCAGCTACTTGGGAGGCTGAGGTGGGAGGATCACTTGAGCCTAGGAGGTTGAGGCTGCAGTGAGCTGTGATTGCTCCGGCCTAGGCAACAGAATGAGACCCTGTATCGAAAAACCCAACCAAACAAAAAAGAAA"
"chr1","9297615","9297801","chr1","8476238","8476418","21","821377","GAGCGCTGTGGCTCATGCCCATGATCCTAGCACTTTGGGAGGATTGCTCGAACCCAGGAGTTCGAGACCAGCCTGGGCAACATAGGGAGACACCGTCTTTGTGAGAAATTTAAAAATTAGCTGGGGGTGGTGGTGTGTACCGATAGTCCCAGCTACTGGGGGGCTGAGGTGGGAGGATTGCTTGCGC","GTGGCTCATGCCCATAATCCTAGCACTTTGGGAGGATTGCTTGAGCCCAGGAGTTTGAGACCAGTCTGGACAACATAGGGAGATCCCGTCTCTGTGAGAAATTTAAAAATTAGCTGGAGGTGGTGGTGTGCTCCGATAGTCCCAGCTACTAGGGGGGCTGAGGTGGGAGGATTGCTTGAGC"
"chr1","9302156","9302345","chr1","218511627","218511810","40","209209471","AGACTGGGCAACATGGCGAGACCCCATCTCTACAAAAACTTTTAAAAATTAGCCAGGTATGGTGACACATACCTATAATCCCCGCTACTCAGGACGCTGAGGTGGGAAGATCGCTTGAGCCCAGGAGTTCGAGGCTGCAGTGAGCTGTGACCGCACCACTGCACTCCAGCCTGGGGGACAGAGAGAGATC","GCCTGGGCAACATGGTGAGATCCGCATCTCTACAAAACATTTTTAAAATTAGCCAGGCACAGTGGTGCTTGCCTGTAGTCCCAGCTACTCAGGAGGCTGAGATGGGAGGATCACCTGAGCCCAGGAGGTCAAGGCTGCAGTAAACTAGGATCACGCCACTGCACTCCAGCCTGGGCGAAAGAGC"
"chr1","9304769","9305078","chr9","28922132","28922420","80","19617363","GACCGGACACAATGGCTCGTGCCTGTAATCCCAGAGCTTTGGGAGGCCAAGTTGGGAAGACTGCTTGAGCCCAGGACGGGTTCGAGACCAACCTGAGCAACATAGCACTGCAGCCTGGGTGACAGAGCGAGATTCTGCCTCGAAAAAAATTAAAAATTAAAAAATTAAAATAAAATAAAAATTAGCCAAGCGTGGTGGCATGTGTCTGTGGTCCCAGCTACTCAGGAGGCTGAGGAGGGAGGATGACTTGAGGAGTTTGAGGTGCAGTGAGCTATGATCACGCCACTGCACTCCAGCCTGGGTGACAGAG","GGCCAGGCACAGTGGCTCATGCCTATAATCCCAGCGCTTTGGGAGGCCAAGGTGGGAGAATGGCTTAAGCCCAGGAGTTCCAGATCAGCCTGGGCAGCATAGCAAGATCCCATCTCCCAAAAAATAAAAAATAATAAAAAAAAAAAGAAAATTAGCTGGATATGGTGGTGTATGCCTGTAGTCTCAGCTACCCAGGAGGCTGAGGAGGGAGGATCACTTGAGCCAAGGAGTTCGAGGTTGCAGTGAGCTATGATTGCCCCACTGCACTCCAGCCTGGGTGGCAGAGTGA"
"chr1","9429611","9429786","chr1","8604962","8605143","15","824649","CAAAACGTACAGTCATAAGCTGGGTGTGGTGACGCATGCCTGTAGTCCCAGCTACAGGCTAAGGTGGGGGCATCACTTGAGCTCAGGAGTTCGAGACTGCAGTGAACTATGACTGCTCCTGTGAAGAGCCACTGCACCCAGCCTGGGCGACAGACCCTAGCTCTTAAAAAAAAAAA","CAAAACGTACAGTCACATAAGCTGTGTGTGGTGATGCATGCCTGTAGTCCCAGCTACAGGCTAAGGTGGGGGCATTACTTGAGACCAGGAGTTCCAGGCTGCAGTGAACTATGACTGCTCCTGTGAATAGCCACTGCACCCAGCCTGAGCGACAGACCCTAGCTCTTAAAAAACAAAAGAAA"
"chr1","9486528","9486553","chr16","41419029","41419053","5","31932501","CCAGCCTGGGCAACATAGTGAGGCCC","CAGCCTAGGCAACATAGCGAGATCC"
"chr1","9486882","9486973","chr2","148733834","148733921","16","139246952","GCTGGGTGCAGTGGTTCACGCTGGTAATCCCAGCACTTTGGAAGGCCAAGGCAAGAGGATCCCTTGAGGGTAGGAGTTCAAAACCAGCCTGG","GGATGGGTGCAGTGGTTCATGCCTGTAATCCCAGCACTTTGGGAGGCCAAGGCAGGAGGATCACTTGAGGCTAGGAGTTCAAGACAAG"
"chr1","9509836","9510113","chr1","18486288","18486580","61","8976452","GGCCAGGTGTGGTGGCTCATGGCTGTAATCCCAACACTTTAGGAAGTGGGTAAATTGCCTGAGTTTAGGAGTCTGAGACCAGCCTGGGCAACATAGGGAGACCCAGTCTCTATTAAAAAAATAAAACTTACTCAGGCATGGTGCCATGCACCTGTAGGCCCAGCTACTTGGGAGGCCAAGGTAGGAGGATCACTTGAGTATGAGTGAGCCGTGACTGCGCCACTGCACTCCAGCCTGGGCGACAGAGCAAGACCCTGTCTCAAAAAAAAAAAAAAAAA","GGCCAGATGCGGTAGCTCACTCCTGTAAATCCCAGCACTTTAGGAGGCTAAGGTGGGAGGATTACCTGAGTCCAGCAGTTTGAGACCAGCCTGGGCAACATAGCAAGACCTCATCTCTACTAAAATTTTAAAAATCAGCCAGGTGTGATGACAGACACCTGTAGTCCCAGCTCCTTGGGAGGCAAAGGCAGGAGAATCACTTGAGCCTGTGAGATCGAGCCTGCAGATTGCGCCACAGCACTCCAGCCTGGGCTACAGAGGGAGACCCTGTCTCAAAAAAGAAAAATTAAAAA"
"chr1","9570448","9570572","chr1","8744078","8744207","12","826370","GGCTGGGCGCAGTGGCTCACACCTGTAATCCCAGCACTTTGGGAGGCCAAGGCGGGAGGACTGCTTGAGGCCAGGAGTTCAAGACCAGCCTGGCCAATGTAGTGAGGCTCTATCTCTACAAAAAA","GGCTAGGCGCAGTGGCTCACACCTGTAATCCCAGCACTTCGGGAGGCTGAGGCGGAAGGACTGCTTGAGGCCAGGAGTTCAAGACCAGCCTGGCCAATGTAGTGAGGCCCCATCTCTACAAAAAAATAAA"
"chr1","9576485","9576767","chr1","8750476","8750756","23","826009","CTGTAATTCCAGTGCTTTGGGAGGCTGAGGAGGTAAGATCGCTTCTGGCCAGTAGTCTGAGACCAGCCTGGACAACATAGCAAAACCTCGTCTGCACAAAAATGAAAAACATTAGCTGGGCATGGTGGTACTTTCCTGTGGTCCAAGCTACTTGGGAGGCTGAGATGGGAGGATCCCTTGTGCCCAGGAGTTTGAGGTTACAGTGAGCTATGATCTTGCCACTGTATCCAGCTTCAGTGATCGAGTGATACCTTGTCTCAAAACAACAACAACAACAAAGGAA","CTGTAATCCCAGTCCTTTGGGAGGCTGAGGAGATAAGATCGCTTCTGGCCAGTAGTCTAAGACCAGCCTGGGCAATATAGCAAAACCTTGTCTGCACAAAGAATGAAAAAACATTAGCTGGGCATGGTGGTACTTTCCTGTGGTCCAAGCTACTTTGGGAGGCTGAGGTGGGAGGATCCCTTGTGCCCAGGAGTTTGAGGTTACAGTGAGCTATGACCTTGCCACTGTATCCAGCTTCAGTGACTCAGTGGTACCTTGTCTGAAAACAGTAACAACAAAAA"
"chr1","9577945","9578194","chr1","8752314","8752565","13","825631","GGTAGCTCACACCTGTAATCCCAGCACTTTGGGAGGCTGAGGAAGGAGAATTGCTTGAGGCCAGGAGTTCAAGGCCAGCCTGGGCAACATAGGGAGACCTTCTCTTTACAAAAAAATTAGCTGAGCATGCACCTGTAGTCCCAGCTACTTGGGAGGCTGAGGTGGGAGGATCCCTTGAGCCCAGGAGGTTGAGGCTGCAGTGAGCCATGGGATTGTGCCACTCTACTCCAATCTGGACGGCAGAGCAAGA","CACGGTAGCTCACACCTGTAATCCCAGCACTTTGGGAGGCTGAGGAAGGAGAATTGCTTGAGGCCAGGAGTTCAAGGCCAGCCTGGGCAACATAGGGAGACCCTGTCTTTACAAAAAATTAGTTGAGCATGCACCTGTAGTCCCAGCTACTTGGGAGGCTGAGGTGGGAGGATCCCTTGAGCCCAGGAGGTTGAGGCTGCAGTGAGCCATGGGATCATGCCACTGTACCCCAATCTGGATGACAGAGCAAGA"
"chr1","9599218","9599507","chr1","8774097","8774382","21","825121","GGTGGCTCATGCCTTTAATCCCAGCACTTTAGGAGGCCAAGGTGGGAGGATGGCTTGAGGCTAGGAGTTCAAGACCAGCCTGGGCAACATAGGGAGACGCTGTCTCTACAAAAAAAGTTGTTTTAATTAACTGGGCATGGTGGCGTACACCTATAGTCCCAGCTATTTAGGCTGAGGTGGGAGGATCGGTTGAACCCAGGAGTTGGAAGCTGCAGTGAGCTATGATCACGCCACTGCATTCCACCATGGGCAACAGAGCAAGACCCTGTCTCAACAAAAATAAAAATAAA","GGTGGCTCATGCCTTTAATCCCAGCACTTTGGGAGGCCAAGGTGGGAGGATGGCTTGAGGCTGGGAGTTCAAGACCAGCCTGGGCAACATAGGGAGACGCTGTCTCTACAAAAAAGGTGTTTTAATTAACTGGGCATGATGTCGTGCGCCTGTAGTGCCAGCTATTTAGGCTGAGGTGGGAGGATCACTTGAACCCAGGAGTTGGTAGCCGCAGTGAGCTATGATCACACCACTGCTCTCCACCATGGGCAACAAAGCAAGACCCTGTCAAAAAAATAAAAATAAA"
"chr1","9619310","9619580","chr1","8798660","8798961","49","820650","GGCTGGGCATGGTGGCTTACACCTGTAATCCCGGCACTTTGAGAGGCCAAGGCAGGAGGACTGCTTGAGCCCACAAGTTCAAGATCAGCCCGGGCAACACAGTTGAGACCCCATCTCTAAAAAAAATTAAAAAGTTGAGGGTGGTGGCCTGCCCCTGCAGTCCCAGCTACACAGGAGGCTGAGGTAGGAGGCTCGCCTGAGCCCAGCAGTTCAAGGCTGCAGTGAGCAGTGATCGTGCCACTGCACTCCATCCTGTCTCAAAAAAAAAAAA","GGCTGGGCATGGTGGCTCACACCTGTAATCCCAGCACTTTGAGAGGCCAAGGCAGGAGGATTGCTTGAGCCCAGAAGTTCAAGATCAGCCTGGGCAACATAGTGAGACCCCCCATTTCTAAAAAAAATTTAAAAGTCGAGGGTGGTGGGATGGCCCTGTAGTCCCAGCTACACAGGAGGCTGAGGTAGGAGGATCGCCTGAGCCCAGCAGTTCAAGGCTGCAGTGAGCTGTGATTGTGCCACTGCACTCCATCCCGGGAGACAGAGGGAGACCCTGTCTCAAAAAAAAAAAAAAAAAAAAAA"
"chr1","9642925","9643180","chr1","8824971","8825247","38","817954","GATGACTCACACCTGGAATTCCAACACTTTGGGAGGCTGGGGCTAGAGGATCAAGACCAGCCTGAGCAACATAGTGAGACCTCATCTTTACAAAAAATAAAACATTAGCCAGGCATGGTGGCATGTGCCTGTAGTTTTAGCTACTTGGGAGGCTGAGGTAGAAGGAGGATCCTTTGAGCCCAGAAATTCAAGGTTGCAGTGAGCTGTCATCTCACCTCTGCAATCCAGCCTGGGTGACAAAGTGAGACCACGTCTC","GGTGACTCATGCCTGAAATTCCAACATTTTGGGAGGCTGAGGCTAGAGGATCAAGACCAGCCTGAGCAACACAGTGAGACCTCATCTTTACAAAAAATAAAACATTAGCCAGGCATGGTGGCATGTGCCTGTAGTTTTAGCTACTTGGGAGGCTGAGGTAGGAGGATCACTTGAGCCCAGAAATTCAAGGTTGCAGTGAGCTGTGATCTCACCTCTGCAATCCAGCCTGGGTGACAAAGTGAGACCATGTCTCTAAAAATAAGAATAATAATAAGAA"
"chr1","9644600","9644911","chr1","8826972","8827290","37","817628","GGCCAGGCATGATGGCTCAGGCCTGTAGTCCCAGCACTTTGGGAGGACGAGGCTGGAGGATCCCTTGAGGCCAGGAGTTTGAGACCAGCCTGGGTGATATGGCAAAACCCAGTCTCTACAAAAAAATAGAAAAAATTAGCCGGGTTTAGTGGTGTGCACCTGTAGTTCCAGATTCTCGGGAGGCTGAGGTGGGAGGATCACCTGAGCCCTGGAGGTTGAGACTGCAGTGAACCATAACTGTGCCACTGCACTCCAGCCTGGGTGACGGAGTGAGATTCTGCTTTGAAAAAAAAAGAAAAAGAGAGAGAGAGA","GGTCAGGCATGATGGCTCGTGCCTGTAGTCCCAGTACTTTGGGAGGACGAGGCTGGAGGATCACTTGAGGCCAGGAGTTTGAGACCAGCCTGGGTAACATGGCAAAACCCAGTCTCTACAAACAACAACAAAAAAAAAAATAGAAAAAATTAGCCGGTGTAGTGGTGTGCACCTGTAGTTCCAGCTTCTTGGGAGGCTGAGGTGGAAGGATCACCTGAGCCCTGGAGGTCGAGGCTGCAGTGAGCCATAACTGTTCCACTGCACTCCAGCCTGGGTGACGGAGTGAGATTCTGCCTTGAAAAAAAGAAAAAAAGAGAGA"
"chr1","9654507","9654803","chr1","8836388","8836696","36","818119","GGCTGGGCATGGTGGTTCATGCTTGTATTCCTAATGCTTTGGGAGGCTAAGGAAGGAGGATCACTTGAGCCCAGGAGTTTGAGACGAGCCTGGGCAACATAGTAAGACCTCCATCTCTGCAAAAAATAAAATAAATTAGCTGGGCCTTGTGATGCACGCCTGTAGCCCCAGCTATGTGGAAGACTGAGGTGGGAGGATTACTTGAGTCCAGGAGTTCAAGGCTGCAGTGAGCTATGGTTGCAACACTGCACTCTAGCCTGCGTGACAGAGTGAGACCCTGTCTCAAAAAAAAAAAAA","GGCTAGGCATGGTGGTTCATGCCTGTATTCCTAACACTTTGGGAGGCTAGGGAAGGAGGATCATTTGAGCCTAGGAGTTTGAGACCAGCCTGGGCAATACAGTGAGACCCCCATCTCTGCAAAAAATAAAAACAAATTAGCTGGGCATTGTGATGCACGCCTGTAGCCCCAGCTACGTGGGAGACTAAGGTGGGAGGATTACGTGAGTCCAGGAATTTAAGGCTGCAGTGAGCTATGGTTGCAACACTGCACTCCAGCCTGGGTGACAGAGCGAGACCTTGTCTCAGAAAAAAAAAAAAAAAAAAAAGA"
"chr1","9680074","9680358","chr1","8858356","8858647","45","821718","GGGTGTGATGGCTCACATCTGTAATCCCAACACTTTGTGAGGCCGAGGCAGGCAGATCCCTTGAGCCTGGGAGTTTGAGACCAGCCTGGACAACATAGCAAGGCCTCAAGACCTCATCGCTACAAAAATTAAAAATGAGTTGGCACACACCTCAGCTACTCGGGAGGCTGAGGTGGGAGGATCACCTGAGTCCACAAGGTCAAGCACCTGTGATCGCGCCACTGCACTCCAGCCTGGGTCACAGTGTGAGACCCTGTCTCAAAAAAAAAAAGAAAGAAAAAAGAA","GCCAGATGCGATGGCTCACATCTGTAATCCCAACACTTTGTGAGGCCGAGGCAGGCAGATCCCTTGAGCCTAGGAGTTTGAGACCAGCCTGGACAACACAGCAAGACCTCATCGCTACAAAAATTAAAAATTAGTTGGGCATGGTGGCACACACTCAGCTACTTGGGAGGCTGAGGTGGGAGGACCACCCAAGTCCCTGAGGTTGAGTACCTGTGATTGCGTCTCTGCACTCCAGCCTAGGCCACAGTGTGAGACGCTGTCTCAAAAAAAAAAAAAAGAAAAAAAAGGAAAA"
"chr1","9681737","9681988","chr19","31804372","31804611","64","22122635","CGGGCATGGTGGCTCACGCCTGTAATCTCAGCACTTTGGGAGGCCGAGGTGGGAGGATCATTTAAGGCCAGGAGTTTAAGAACAACCTGGGCAAAACAGCGAGACCTCGTCTCTACTAAAAATAAAAAAAATAAAAATAAATAAAAAATAGAGCCTGGCATGGTGGCATTTGCCTGTAGTCCTAGCTACTTAGGAGGCCAAGGGAGAAGGATTGCTTGGCCCAGAAGTCTGCGGTGAGCTATGATGGAGCCA","GTGCAGTGGCTCATGCCTGTAATCTCAGCAATTTGGGAGACTGAGGTGGAAGGATCACTTGAGTCCAGGAGTTCAAGACCAGCTTGGGCAACATAGTGAGACACAGTCTCTAAAAAAAAAAAGAAAAGAAAAGAAAAAAATAATTAGCCAGGCATGGTGGTAAGTGCCTCTAGTTCCAGCTACTCAGGAGGCTGAAGTGGGAGAATTGCTTGAGCCTAAGAGGTAGAGGCTGCAGAAAGC"
"chr1","9684059","9684325","chr1","8862978","8863242","23","821081","CCGAGCACTTTGGGAGGCTGACGCGGTAGGATGGCTTGAGCCCAGGAGTTCGAGACCAGCGTAGGCAACATAGTTAGACCCCCGCCTCTACAAAAAATTTTTAAAAATTAGCTGAGTGAGGTGGTGCGCACTTGAGGTCTCAGCTACACGGGAGGCTGGGGTGAGAGGATCGATTGAGCCAGAGAGGTAGAGGCTACAGTGAGCTATGATCGCACCACTGCACCCCAGCCAGGGCAACAGAGCAAGACCCTGTCTCAAAAACAAAAA","AGCACTTTGGGAGGCTGACACGGTAGGATGGCTTGAGCCCAGGAGTTTGAGACCAGCGTAGGCAACATGGTTAGACCCCCACCTCTACAAAAAAAAATTTTTAAATTAGCTAGGTGAGGTGGTGCGCACTTGTGGCCCCAGCTACACGGGAGGCTGGGGTGGGAGGATCGATTGAGCCAGAGAGGTAGAGACTGTAGTGAGCTATGATCGCACCACTGCACCACAGCCAGGGCAACAGACCAAGACCCTGTCTCAAAAACAAAAA"
"chr1","9702215","9702519","chr1","8883079","8883384","25","819136","GGCTGGGCTCATGGTGGCTCATGCCTGTAATCCCAGTGCTTTGGGAGGCCAAGGTAGGAGGATCACTTGAGGCCAGTAGTTAGAGACCAGCCTGGGCAACATAGTGAGAGCCCATCTCTACAAAAAAAAAATTAAAATTAGCCAAGCATGGTGGAGCGTGCCTGTAGTCGCAGCTACTTGGAAGCTGAGGTGGAAGGATCACTTGAGCCTGGGAGTTTGAGATGCTATGATGGATCACTACACACCAGCTTGGCAATACAGCAAAATCATGTCTCAAAAAAAAAGAAAAAAGTGAAAAAAAAGAA","GGCTGGGCTCAAGGTGGCTCATGCCTGTCATCCCAGTGCTTCGGGAGGCCAAGGTAGGAGGATCACTTAAGGCCAGGAGTTAGAGACTAGCCTGGGCAACATAGTGAGAGTCCATCTCTACAAAAAAAAAATTAAAAATTAGCCGAGCATGGTGGAGTGTGCCTGTAGTCCCAGCTACTTGGAAGCTGAGGTGGAAGGCTCACTTGAGCCTGGGAGTTTGAGATGCTATGATGGCTCACTGCACGCCAGCTTGGCAACACAGCAAGATCGTGTCTCAAAAAAAGAAAAAAAAAAAGGAAAAAGAAA"
"chr1","9709345","9709566","chr1","8890842","8891058","23","818503","AGCTTGGGCAACATGGCAAGGTCCACCGTTACAAAAATAATAATAATAATAATAAATAAAATTAGCCAGGCGTGGTGGTGCATGCCTATAGTCCCAGCTACTCAGCAGGCTAAGATGGGAAGATCGCTTGGGCCCAGGATGTCAAGGCTGCAGAGAGCTAGGATTATGCCACTGCATTCCAGCCTGTGCAACAAAGTGAGACCATTCTCAAGCAAAATAAAA","AGCTTGGGCAACATGGCAAGGTCCTACTGCTACAAAAATAAATAACTAAATAAAATTAGCCAGGCGTGGTGGTGTATGCCTGTAGTCTCAGCTACTCAGCAGGCTAAGATGGGAAGATCGCTTGAGCCCAGGAGGTCGAGGCTGCAGAGGAGCTAGGATTACACCACTGCATTCCAGCCTGGGCAACAAAGTGAGATCCTTCTCAAGCAAAATAAAA"
"chr1","9709583","9709894","chr1","8891075","8891385","15","818508","GGTCAGGTGCGATGGCTTACTCCTGTAATCCCAATACTTTGGGAGGCTGAGGTGGGAGGATCACTTGAGCACAGGAGTTCACGGCCAGCCTGGGCAACATAATAAGACTCCATCTCTACAAAAAAATAAAAATTAGCTGGTTATGGTGGCATGCACCTGTAGTCCCAGCTACTCAGGAGGCTGAGATGGGGGAATCATTTGAGCCCAGGAGGTTGAGGCTGCCATGAGCTGTGATCATGCCACTGCACTACAGCCTGGATGACAGAGCAAGACCCTGTCTACAAAAAAAAAAAAAAGTATAAAAATAAAAAA","GGTCAGGTGCGGTGGCTCACTCCTGTAATCCCAGCACTTTGGGAGGCTGAGATGGGAGGATCACTTGAGCACAGGAGATCACGGCCAGCCTGGGCAACATAATAAGACTCCATCTCTACAAAAAATAAAAAAATTAGCTGGTTATGGTGGCATGCCCCTGTAGTCCCAGCTACTCAGGAGGCTGAGGTGGGGGAATCATTTGAGCCCAGGAGGTTGAGGCTGCCGTGAGCTGTGATCATGCCACTGCACTACAGCCCAGATGACAGAGCAAGACCCTGTCTCAAAAAAAAAAAAAGTATAAAAATAAAAAA"
"chr1","9750079","9750376","chr1","8932674","8932973","29","817405","GGCCAGGTGCAGTGGCTCACACCTATAATCCCAGCACTTTGGGAGGCTGAGGTGGGAAGATTGCTTGAGCCTAGGAGTTTGAGAGCAGCCTAGACAATGTAGGAGATGCCATCTCTACAAAACATAAACAGCCAGGTATGGTGGCACATGCCTGTGGTCTCAGCTACTTGGGAGGCTAAGGCGGGAGGATTGCTTGAGCCCGAGAGGTTGAGGCTGCAGTGAGCCATGATTGTGCCACTGTACTCCAGTCTGAGTGTCAGAATGAGACCCTGTCCCTAAAAAACAATAACAACAAAAA","GGCCAGGCGCAGTGGCTCACACCCATAATCCCAGCACTTTGGGAGGCTGAGGTGGGAGATCACTTGAGACCAGGAGTTTGAGACCAGCCTAGACAATGTAGAAGATGCCGTCTCTACAAAACATAAGCAGTTAGCCAGGCATGGTGTCGCATGCCTGTGGTCTCAGCTACTTGGGAGGCTAAGGCAGGAGGATTGCTTGAGCCCAGGAGGTTGAGGATGCAGTGAGCCATGATTGTGCCACTGCACTCCAGCCTGAGTGTCAGAGTGAGACCCTGTCCCTAAAAAAACAACAAAAAAAAA"
"chr1","9793817","9794120","chr1","8973858","8974139","41","819959","GGCTGGGTGCGGTGGCTCATGCCTGCAATCCCAGCACTTTGGGGAGGCCAACGCAGGAGGATCACTTGAGGCCAGGAGTTAGAGACCAGCCTGGGCAACATGGTGAGACCCTGTATCTACAGAAAAATTTAAAATTAGCCAAGCATGGTGGTGCATGCCTATAGTCCTGGCTACTTGGGAGGTTGAGGCAGGAGAACTGCTTGAGCCCAGGAGGCTGAGGCTGCAGTGAGCGATGATCACACTACTGCACTCCAGCGTGAGCAACAGAACAAGACCCTGTCCCCACCTACCAAAAAAAAAAAAA","CTGGGCGCAGTGGCTCACGCCTGAAATCCCAGCACTCTGGGGAGGCCAACGCAGGAGGATCACTTGAGGCCAGGAGTTAGAGACCAGCCTGGGCAACATGGTGAGACCCTGTCTCTACAGAAAAATTTAAAATTAGCCAAGCATGGTGGTGCATGCCTATAGTCCTGGCTACTTGGGAGGCTGAGGCGGGAGAACTGCTTGAGCCCAGAAGATCGAGGCTGCAGCGAACGATGATGGCACTACTGAACTCCAGCCTGGGCAACAGAACAAGACCCTGTCCCA"
"chr1","9795499","9795807","chr1","8975181","8975479","41","820318","GGCTGGCCATGGTGGCTCATGCCTGTAATTCTATCCCTCTGGAGGCCAAGGTGGGGACAATCACTTAAGCCAGTAGTTCAAGACCAACCTGGTCAACATTAATGAGACCTCAATCTCTAAAAAATAAATTTTTTAAAATTAGCCTGGTGTGGTGGTGCATGTCTGTAGTCTCATCTACTTGGGAGGCTCAGGCGGGAGGATCATGTGAGCCCAGGAGTTGGAGGTTGCAGTGAGATATGATTATGCTACTGCACCCCAGTCTGGGTGACAAAGCAAGACCCTGTCTCAAAAGAAGAGAAGAGAAGAGAA","GGCTGGCCATGGTGGCTCATGCCTGTAACTCTATCCCTTTAGAGGCCAAGGTGGGGATGATCACTTAAGCCAGTAGTTCAAGACCAACCTGGTCAACATTAACGAGACCCCAATCTCTAAAATATATATATATTTTTAAATTAGCCTGGCATGGTGGTGCATGTCTGTAGTCCCACCTACTTGGGAGGCTCAGGCAGGAGGATCATGTGAGCCCAGGTGCTGGAGGTTGCAGTGAGCTATGATTATGCTACTATACCCCTGCCTGGGTGACAAAGCAAGACCGTGTCCCCCCAAAAAAA"
"chr1","9797454","9797749","chr1","8977428","8977732","34","820026","GGCTGCGTGTGATGGCTCGCACCTGTAATCCCAGCACACTTTGGGAGGGCGGGGCAGGAGGATCACTTGAGCCCAGGAGTTTGAGCCCATTCTGGCAACAAAGTGAGACCTCATCTCCTACTAAATCAAAATAAATTAGCCAGACATAGTGGCGCACGCCCATGGTCCCAGCTACTCAGGGAGCAGAGATGGGAGGACCACTTGAGCCCAGGAGGTCGAGGATCCAGTGAGCCCTGATCGTGCCACTGAACTCCAGCCTGGGTGAGAGCAAGACCCTGTCTCAAAAAAGAAAAAAA","GGCCGGGTGTGGTGGCTCGAACCTGTAATCCCAGCACACTTTGGGAAGGCAGGGCAGGAGGATCACTTAAGCCCAGGAGTTTGAGACCAGCCTGGCAACAAAGTGAGACCTCATCTCTACTAAATCAAAATAAATTAGCCGGGCATAGTGGCACGCACCCATGGTCCCAGCTACTCAGGAGGCAGAGATGGGAGGACCACCTGAGCCCAGGAGGTTGAGGATCCAGTGAGCCTTGATCATGCCACTGCACTCCAGCCTGGGTGACAGAGCAAGATCCTGTCTCAAAAAAGAAAAAAATAAATAAA"
"chr1","9801195","9801501","chr1","8981776","8982081","22","819419","GCTGGGCGTGGTGGCTTATGCCTGTAATCCCAGCACTTTGGGAGGCTGAGGCGGGAGGATCACTTGAGCCAGGAGTTTGAGACCAGCCTGGACAACATAGCGAAACCTTGTCTCTACAAAGAATAAAAAATTACCTAAGTGTGGTGGTGGGTGCCTGTGGCCCCACTTACTTGAGATGCTTAGGTGGGAGGATCATTTGAGCCCTGGAGCTTGAGGCTGCAGTGAGCCCTGATTGTGTCACTGCACTCCAGCCTGGGTGACAAAGTGAGACTCTGTCTACAAAAAAAAAAAAAAAAAAAAATAAGAA","GCCGGGCGTGGTGGCTCATGCCTGTAATCCCAGCACTTTGGGAGGCTGAGGCAGGAGGATCGCTTGAGCCCAGGAGTTTGAGACCAGCCTGGACAACATAGCGAGACCTTGTCTCTACAAAAAATAAAAAATTAGCTAGGCGTGGTGGCGGGTGCCTGTGGCCCCAGTTACTTGAGATGCTGAGGTGGGAGGATCATTTGAGCCCTGGAGCTTGAGGCTGCAGTGAGCCCTTATCGTGCCACTGCACTCCAGCCTGGGCGACAAAGTGAGACTCTGTCAAAAAAAAAAAAAAGAAAAAAAAAAAAA"
"chr1","9813563","9813855","chr2","57517560","57517862","55","47703997","GCTGGACATGGTGGCTCACGCCTATAATCCCAGCACTTTGGAGGGCCAAATAGGGCAGATTGCTTGAGCCCAAAAGTTCGAGACCAGCCTGGGCAACATAGGAAGATCCTGTCTCTACAAAAATTTTAAAATTAGCCAGGCATGGCGGTGTGCACACCTAGTCAGGAGGCTGAGGTGGGAGGATAGTTTAAGCCCAGGGAGGTTGAGGCTGCAGTGAGCTGTGATTGTGCCACTGCACTCCAGCCTGGGCAACAGAGCAAGATCCTGTCTCAAAAAAAAAAGAAAAAGAAAAA","GGCTGGACGTGGTGGCTCAACACCTGTAATCCCAGCACTTTGAGAGGCCAAGCAAGGTGGGAGGATCACTTGAGCCTAGGAGTTTGAAACCAGCCTGGGCAACACAGGGAGATGCCATCTCTACAAAATATTTAAAAATTAGCCAGACATGGTGGTATGTACCTGTAACTACTCAGGAGACTGTGGTGGGAGGATTCCTTGAGCCCAGGAGGTTGAGGCTACAGTGAGCTGTGATTGTACCACTACACTCCAGCCTGAGTGACAGAGCAACACCCTGTCTCAAAAAAAAAAAAAAAAAAAAAA"
"chr1","9828043","9828194","chr11","105301908","105302057","30","95473865","AGCCGGGTGTGGGGGTTGCACACCTGAAGTCCCAGTGAGTCAGGAGGCTGAGGCAGGAGGATCGCTTGAGCCCAGGAGTTTGAGGCTGCAGTGAGCTATGATCAATGATCACCACTGTACTCCAGCCTGGGTGACAGAACAAGACCCTGTTT","ATTAGCCAGGTGTGGTGGCACACACCTACAGTCCCAGCTACTCTGGAGGCTGAGGTGGGAGGATTGCATGAGCCCAGGAGTTTGAGGCTACAGTGAGCTATGATTGCACCACTGCACTCCATCCTGGGCCACAGAACAAGACCCTGTCTC"
"chr1","9831682","9831973","chrX","15902142","15902434","53","6070460","GACCAGGCACAGTGGCTCACACCAGTAATCTTAATTCTTTGATGAGGCTGAGACGGAAGGATATCTTGAGGCCAGGAGTTCAAGACCAGCCTGGGCAATATAGTGAAACCTCATTTCTACCAAAAAAAAAAAAAGTTAGTTGGGCATGGTAGCAGGTGCCTGTAGTCCCAGCTGCTCGGGAGGCTGAGGCAGGAGGATCACTTGAGCCCAGGAGTTCAAGGCTGCAGTGAGCTATGATGGCACCACTGCACTCCAGCCTAGGTGACAAAGCAAGACCCTGTCTCTGAAAAAA","GGCCAGGCATGGTGGCTCACACCTGTAATCCCAGTACTTTGAGAGGCTGAAGTGGGAGTATTGCTTCAGTCCAGGAGTTCTAGGCCAGCCTGGGCAACATAGTGAGACCCCATTCCTACAAAAAATAAAAATAAAAGGTTAGCTGGGCATGGTGGCGTGTGCCTGTAGTCCCAGCTACTCGGGATGCTGAGGTGGGAGGATCGCTTGAGTCCAGAGGTTGAGGCTGCAGTAAGCTGTGATCGTGCCACTGCACTCCAGCCTGGGTGACAGAGCAAGATCCTGTCTCAAAAAAA"
"chr1","9853954","9854131","chr13","86759325","86759498","37","76905371","AAAAAAAATTAATTAGCCGAGTGTAGCAGTGTGGGCCTGTGGTCCCAGCTCCTCAGGAGGCTGAGGTGAGAGAATCAATTGAGTCCAGAAGGTCAAGGCTGCTCTGAGTGCTGATTGTACCACTGCACTCTAGCCTGCGTGACAGAGCAAGACCCTGTCCAGGAAAAAAAAAAAAAAA","AAAAATAAAAGTTAGCTAAGTGTGGTGGTGTGTGCCTGTAGACCCAGCTTCTCAGGAGGCTGAGGTGGGAGAATTGCTTCAGCCCAGGAGGTCGAGGCTGCTGTGAGTTATGATCATGCAACTGCACTCTAGCCTGCAGACAGAGCAAACCCTGACTCCAAAAAAAGAAAAAAA"
"chr1","9854401","9854532","chr13","93907128","93907264","29","84052727","GCCAGGCGTGGAGGCTCATTCCTGTAATCCCAGTACTTTACATGGCAGAGGCAAGAGGATGGCTTGAGCCCAGGAGTTCAAGACCAGCCTGGGCAACAGAGGAAGATACCCCATCTGTCAAAACAATTTTTC","GGCCAGGCGTGGTGGCTCACACCTGTAATCCCAGCACTCTAGGAGTCCAAGGTAGAGGATGGCTTGAGCCCAGGAGTCCAAGACCAGCCTAGGCAACACAGCAAGACCCCATCTCTACAAAACAATAAAAAATTTGC"
"chr1","9872088","9872345","chr1","9056448","9056712","29","815640","TTGGGGAGGATGAGGTGGGAGGATCACTTGAGCCCAGGAGTTTGAGACCAGCCTGGGCAACATAGCAAGACCCTGTCTCTACAAAAAAATGTTTTTAAATTAGCCAAGCGTGGTGATGTGCACCTGTGGCCCTAGCTTACTCAGGAGGCTGAGTTGGGAGGACTGCTAAAGCCCAGCAGGTTGAGGCAGCAGTGAGCTATGATCGCGCCACTACACTCCAGCCTGGGCGACAGAGGGAGACCCTGTGTCAAAAAATAA","TTGGGGAGGATGAGGTGGGAGGATCACTTGAGCCCAGGAGTTTGAGACCAGCCTGGGCAACATAGCAAGACTTTTTCTACAGAAAAAAATTTTTTAAATGAGCCAAGCGTGGTGATGTGTACCTGTGATCCTAGCTACTCAGGAGGCTGAGTTGGGAGGATTGCTAAAGCCCAGCAGGTCGATGCTGCAGTGAGCTATGATCACGCCACTGCACTCCAGTCTGGGCGACAGAGGGAGACCCTGTGTCAAAAAAAAAAAAAAAAAA"
"chr1","9872629","9872892","chr1","9056998","9057261","15","815631","CGGGCATGGTGGCTCATGCCTGTTAATTCCAATATTTTGGGAGACCAAGGCAGGAGGATTGCTTGAGACCAGGAGTTTGAGACCAACCTGGCTGTGCAACATAACAAGACTTCTACAAAAAAATTTAAAAGTGGCAGGGTGTTGTGGCATGCTTCTGTGGTCCCAGCTAGTTAGGAGGCTGAGGCAGGAGGATCGCTTAAGCCCAGGAGTTCAGGGCTGCAGTGAGTTCTGATCATACCACTGTACTCCTGGGCACCAGAGCAA","CGGGCATGGTGGCTCATGCCTGTTAATTCCAATATTTTCGGAGGCCGAGGCAGGAGGATTGCTTGAGGCCGGGAGTTTGAGACCAACCTGGCTGGGCAACATAGCAAGACCTCTACAAAAAAATTTAAAAGTGGCAGGGTGTTGTGGCGTGCTCCTGTGATCCCAGCTACTTAGGAGACTGAGGCAGGAGGATCGCTTGAGCCCAGGAGTTCAGGGCTGCAGTGAGTTCTGATCGTACCACTGTACTCCTGGGCACCAGAGCAA"
"chr1","9879358","9879646","chr1","9064295","9064588","21","815063","GGCTGGGTGTGGTGGCTCATGCCTGTAATGAGAGGCGGAGGTGGGAGGATTGCTTGAGCCCAGGAGTTCAAGACCACCCTGGGCAACATAATGAGAACCTGTCGCTACAAAAAATATAAAAATTAGCCGGGTATGGTGGTGCATGCCTGTGGTTCAGCCATGCAGGAGGCTGAGGTGGGTGGATTGCTTGAGCTAGGGAGTTCGAGGCTGCAGTGAGCCATGATTGCACCACTGTACTCCAGCTGGAGCAACAGAGCAAGACCCTCTCTCTCAAAAGAAAAAAAAAGAA","GGCTGGGTGTGGTGGCTCATGCCTGTAATGGGAGGCCGAGGTGGGAGGATTGCTTGAACCCAGGAGTTCAAGACCACCCTAGGCAACATAATGAGAACCTGTCACTATAAAAAATGTAAAAATTAGCTGGGTATGGTGGTGCGTGCCTGTGGTTCAGCCATGCAGGAGGCTGAGGTGGGTGGATTGCTTGAGCCAGGGAGTTCAAGGCTGCAGTGAGCCATGATTGCACCGCTGTACTGTGGCTGGGGCAACAGAGCAAGACCCTCTCTCTCAAAAGAAAAAAAAAAAAAAGAA"
"chr1","9890001","9890120","chr1","9076778","9076896","15","813223","GGGCACAGTGGCAAATGCCTGTAATCCCAGCACTTTGGGAGACTGAGGTAGGAGAATTGCTTGAGGCCTGGACTTCAAAACCAGCCTGGGCAATAAAGTAAGACCCCATCTCTTTTTAAA","GCTGGGCACAATGGCAAACGCCTGTAACCCCTGCACTTTGGGAGACTGAGGTAGGAGAATTGCTTGAGTCCTGGACTTCAAAACCAGCCTGGGCAATATAGCAAGACCCCATCTCTTTC"
"chr1","9890444","9890481","chr1","9077221","9077259","6","813223","TTCTACAAAAAATCTTTAAAAGATTAGCTGGGTGCAGC","TCTACAAAAAATATTTAAAAGGATTAGCTGGTGCAGCAG"
"chr1","9890774","9890943","chr1","9077554","9077734","30","813220","TATTAGCTGGGTGTGCAGTGGCTTGCACCTGTAGGCCCAGTTACTTGGGAGGCTGAGGTGGGAGGATCCCAAGAGCCCAGGAGTCTGAGGTTGCAGTGAGCTATGATCACACCACTGCACCCCAGCCTGGGCAACAGAGCGAGACTGTCTCAAAAAAAAAAAGAAAAGAA","TTAGCTGGGTGCAGTGGTGTGCACCTGTAGGCCCAGTTACTTGGGAGGCTGAGGTGGGGAGAATCCCATGAGCCCCAAGGAGTTCTGAGGTTACAGTGAGCTACGATCACCACCACTTGCACCCCCGCCTGGCAACAGAACAAGACCCTGTCTCCAAAAAGAAAAAAAAAAAAGAAAAGAA"
"chr1","9913144","9913329","chr1","135834735","135834928","50","125921591","GCCTATAATCCTAGTGCTTTGAGAGGCCGAGGTGGGAGGAGGATTGATTGAGACCAGGAGTTAAGAGAGCTGCCTGGGCAACATGGTGAACCCCATCTCAAAAAAAAAAAAAAAAGTACGTCGGTGCGGTGGCACATGCCTGTAATCCCAGCAGTTCAGGAGGCCGAGGCGGGTGGATCACCTGAG","GCCTGTAATCCCAGCTCTTTGGGAGGCTGAGGTGGGAGGATTGCTTGAGGCCAGGAGTTCAAGATCAGCCTGAGCAACATGGCGAGACCATCTCTACAAAAAAAATAAATAAAAAAATAACTGCTGTGGTGGCACATGTCTGTAGTCCCAGCTACTTGGGAGGCTGAGGCAGAAGGATCACTTGAGCCCAGGAG"
"chr1","9921013","9921312","chr1","9109304","9109611","32","811709","GGCTGGGCATGGCGGCTTACACCTATAATCTCAACACTTTGGGAGGCTGAGGTGGAAGGATTGCTTGAGCCCAGGAACTTGAGACCAGCCTGGGCAACACATTAATCGCTAGACCATCTCTACAAAAAAATGTAAAAATCAGCTGGGCATGGTGGCGTGTGTTTGTGGTACCAGCTATTTGGGAGGCTGAGGTGGGAGGATTGCCTGCACCCAGGAGGTTGAAGCTTCAGTGAGCCTTGACTGTGCCACTGCACTCCAGCCTTGGCAACCAAGCGAGGCACTATCTCAGAAAAAAAAAAA","GGCTGGGCACGGTGGCTTACACCTATAATCTCAACACTTAGGGAGGCTGAGATGTAAGTATTGCTTGACCCCAGGAGTTTGAGACCAGCCTGCATGACACATTAATAGCTAGACCTCATCTCTACAAAAAAATGTAAAAATTAGCTGGGCATGGTGGTGTGTGTTTGTGGTCCCAGCTATTTGGGAGGCTGAGGTGGGAGGATTGCCTGAACCCAGGAGGTTGAAGCTTCAGCAAGCCTTGAATGTGCCACTGCACTCCAGCCTTGGCAACAGAGCGAGACACTATCTCAGGAAAAAAAAAGAAAAAA"
"chr1","9930798","9930960","chr1","9116695","9116833","35","814103","TTAAAAAGAAAAAAATTAGCTAGGTGTGGTGGCATGCACTTACAGTTCTAGCTACTTGAGAGGCTGAGGCAGGAGGATCACTTGAACCCAGATATTTGAGGCTGCAGTGAGCCAAGATCATGCCATTGTACTCCAGCCTGGGTGACAGAGCAAGACCTGTCTC","GAAATAGCTAGGTACCTAGAGTTTTAGCTACTTGAGAAGCTGAGGCAGTAGGATCACTTGAGCCCAGACGTTTAAGGCTGCAGTGAGCCAAGATCATGCCATTGCACTCTAGCCTGGGTGATAGAGCAAGACCTGTCTC"
"chr1","9931273","9931350","chr1","9117452","9117526","8","813821","TTGAGGCCAGGAGTTCTAGACCAGCCTGGGCAACATGGTGAGACCCTTTGTCTTCAAAATTAAAAAGAGGGAGGCCGA","CTTGAGGCCAGGAGTTCTAGACCAGCCTGGGCAACATGGTAAGACCCTTTGTCTTCAAAATTTAAAAAAGACCGA"
"chr1","9934824","9934958","chr7","20208738","20208869","25","10273914","GACTGGGTGTGGTGACTTATGCGTATAATCCCACCTCTTTGGGAGTCCAAGATGGGAGGGTCACTTTAGGCTAGATGTTCCGAGACCAGCCTGGGCAACATAGTGAGACTCTGTCTCTACAAAAAATAAAACTTA","GCTGGGTGTGGTAGCTTATGCTTGTAATCTCAGCACTTTGGGAAGCCAAGGTGGGAGGCTCACTTCAGGCCAGGAGTTCCAGACTAGCCTGGGCAACATGGCGAGACCTTGTCTCTACAAAAAATAAAAAAT"
"chr1","9953263","9953552","chrX","49513581","49513873","59","39560318","GGCTGGGTCCAGTGGCTCATGCCTGTAACCCCAACACTTTGAGGCTGAGGTGGGAGGATCGTGTGAAGTCAGGAGTTCAAGACCAGCCTGGGCAACATGGTGAGACATCATCTCTACAAAAAATAGAAAAAGTTAGCTGGGCATGGTGTCATGCACCTGTAGTCGCTGCTACTTGGGAGGCTGAAGTAAGAGGGTCACTAAAGCCCAGGAGGTGGAGGGTGCAGTGAGTCATGTCATTGCACTCCAGCCTGGGTGACAGAGGGAGGCCCCTATCTCCAAAAAAAAGGAAA","GGCTGGGCTCAGTGGCTCATGCCTGTAATCGCAGCACTTTGGGAGGCTGAGGCAGGAGGATTGCTTGAGGCCAGGAGTTCAAGAGGAGCCTGGGCAACATAGTGAGACCTCATCTCTTAAAAAAAAAGAAAAAACAAGACGGGCATGCTGGAATGCACCCGTAGTCCCTGCTACTGGGGAGGCTGAGGTGGGAGGATCATTTGAGCCCAGGAGGTTGACGCTGCAGTGAGTCATGATTGTGCCACTGCACCCCAGCCTTGGTGACACAGCGAGACCCTATCTCAAAAAAAAAA"
"chr1","9958384","9958561","chr14","64804258","64804431","32","54845874","TTAGCCAGGAGTGATGGCGTGTGCTTGTAGTACTAGCTACTTGGCAGGCTGAGGTGGGAGGATCTCTTGAGCCTGGGATTTGAAGGCTGCAGTGAGCAATGATTGTGCCACTGTACTGCAGCCTAGGCAACAGAGCGATACCCTATCTCTAAAAAAAACAAAAACAAAAACAAAAAAA","ATTAGTCAGACATGGTGGAATGTGCCTGTAGTCACAGCTACTCGGGAGGCTGAGGTGGGAGGATCGCTTGAGCCTGGGAGGTTGAGGCTGCAGTGAGCCATGAGCATGCCACTGCACTCCAGCCTGGGCAACAGAGCGAGACCCTGTCTCTAAAAAAACGAACAAACAAAAAAA"
"chr1","9958628","9958754","chr4","73819458","73819584","15","63860830","GGCCAGGTGTGGTGGCTCATGCCTCTAATCCCAGCACCATGGGAGGCCAAGGTGGGAGGATCACTTGAGGCCAGGAGTTTGACACCAGCCTGGGCAACACAGCGAGACCCCATCTCTACCAATAATA","GGCTGGGTGTGGTGGCTCACACTTATAATCCCAGCACTTTGGGAGGCCAAGGTGGGAGGATCACTTGAAGCCAGGAGTTTGAGACCAGCCTGGGCAACATAGCGAGACCCCATCTCCAAAAAAAATA"
"chr1","9969746","9970044","chr1","9175478","9175780","25","794268","GGCTGGGCGTGGTGACTCATGCTTGTAATCCCAGCACTTTGAGAGACTGAGGTGGAAGGACTGCTTGAGACCAGTAGTCTGAGACCAGCAAGCAACATAGCAAGACCCCCATCTCTACAAAAATTAGTCTTTAAAATAATTAGCCAGGCTATTGGTATGTGCCTGTGTTCCCAGCTACTTGAGAGGCTGAGGTGGGAGCATCACTTGAGCCCAGGAGTTTGAGGGTGCAGTCAGCTGTGGTTGCATCACTACACTCTAGCCAGGGTGGCAGAGCAAGACCTTATCTTAGGGAAAAAAAA","GGCTGGGCGTGGTGACTCATGCTTGTAATCCCAGCACTTTGAGAGACTGAGGTGGAAGGATTGCTTGAGACTAGTAGTCTGATACCAGCCTGGGCAACATAGCAAGACCCCCATCTCTACAAAAATTAGTTTTTAAAATAATTAGCCCATCTATTTGGTATGTGCCTGTGTTCCCAGCTACTTTAGAGGCTGAGGTGAGAGCATCACTTGAGCCCAGGAGTCTGAGGGTGCTGTCAGCTGTGGTTGCACCACTATGTTCTAGCCAGGGTAGCAGAGCAAGACCTCATCTTAGAAAAAAAAAAA"
"chr1","9970746","9971025","chr1","9176472","9176770","30","794274","GCCAGGTACAGTGGCTCACATCTGTAATCCCAGTGCTTTGGGAGGCCGAGGTGGGAGGATCACCTGAGGCCAGGAGTTTGAGACCAACCTGGGAAACAGAGAGAGACCTCATCTCTACAAAAAAAATTGTAAACATTAGCCAGGTATGGTGGCATGTGCCTGTGGTCCCAGCTACTCAGGAGACTGAAGTAGGAGGATTGCTTGAGCCCGGGAGGTCTAGGCTACCGTGAGCCATGATTGCACCTTTGCCCACCAGCCTGGACATCAGAGCAAGACCCTG","GCCAGGTACAGTGGCTCACACCTGTAATCGCAGTGCTTCGGGAGGCTGAGGTGGGAGGATCACTTGAGGCCAGGAGTTTGAGACCAACCTGGGAAACATAGAGAGACCTCATCTTTACAAAAAAATTATAAACATTAGCCAGGTATGGTGGCATGTGCCTGTGGTCCCAGCTACTCAGGAGACTGAAGTAGGAGGACTGCTTGAGCCCGGGAGGTCTAGGCTACCGTGAGCCATGATTGCACCTTTGCCCACCAGCCTGGACATCAGAGCAAGACCCTGACCACCCCTCCAAGAAAAAA"
"chr1","9976432","9976729","chr1","9183116","9183415","19","793316","GGCTGGTCATGGTGGCTCACATCTATAATCCCAGCACTTTGGGAGTCTGAGGCAGGAGGATTGCTTGAGGCCAGGAGTTCAAGACCAGTGTGGGCAACATAGTGAGACCTCATCTCTCAAAAAACTAAAGTTAGCTGAACATGGTGGCACGTGCCTGTAGTCGCAGCTATTTGGCAGGCTGAGGCGGTAGGATCACTTGAGCCCAGGAGTTTTGGTTGCAGCGAGCTATGATTGTGCCACTGTGCTCCATCCTGGGCAATAGAGTGAGCCTGTGTCTCTGAAAAACAAACCAAAAAAA","GGCTGGTCATGGTGGCTCACATCTGTAATCCCAGCACTTTGGGAGTCTGAGGCAGGAGGATTGCTTGAGGCCAGGAGTTCAAGACCAGTGTGGGCAACATAGTGAGGCCTCATCTCTCAAAAAAACAAAACATAGCTGAACATGGTGGCACGTGCCTGTAGTCCCAGCTATTTGGGAGTTTGAGGCAATAGGATCACTTGAGCCCAGGAGTTCTTGGTTGCGGCGAGCTACGATTGTGCCACTGCGCTCCATCCTGGTCAATAGAGTGAGCCTGTGTCTCTAAAAAACAAACTAAAAAAA"
"chr1","10000167","10000412","chr1","9206214","9206460","16","793953","AGGCAGAGGCAGGAGGATTGCATGTGGCCAGGAGTTTGAGACCAGCCTGGACAACATAGCAAGACACCGTCTCTACAAAAAAATTGAAAAATTAGCCAAGTGTGGTGGTATGCACCTGTTGTCCCAGCTACTTGGAAGGCTGAGGTGGGAGGATCGCCTGAGCCCAGGAAGTGAAGGCTGCAGTGAGCCATGATCGCACCACTGCACTACAGCCTGAGCGACAGAGCAAGACCCTATCTCAAAAAA","AGGCTGAGGCAGGAGGATTGCATGTGGCCAGGAGTTTGAGACCAGCCTGGGCAACATAGCAAGACACCGTTCTCTGCAAAAAAATTGAAAAATTAGCCAAGTGTGGCGGTATGCTCCTGTTGTCCCAGACACTTGGAAGGCTGAGGTGGGAGGATCGCCTGAGCACAGGAATTCAAGGTTGCAGTGAGCCATGATCGCACCACTGCACTCCAGCCTGAGTGACGGAGCAAGACGCTATCTCAAAAAA"
"chr1","10012497","10012622","chr1","9222804","9222928","9","789693","GCTGGGTGTGGTGGTTCACTTCCGTAATCCCAGCACTTTGGGAGGACACGGCAAGAGGATCACTGGAGTCCAGGAGTTTAATACCAGCCTGGGCAGCATAGTGTGACTCTGTCTCTACAAAAAATT","CTGGGTGTGGTGGTTCATTCCCGTAATCCCAGCACTTTGCAGGGACACAGCAAGAGGATCACTGGAGTCCAGGAGTTTAACACCAGCCTGGGCAACATAGTGTGACTCTGTCTCTACAAAAAATT"
"chr1","10012921","10013082","chr1","9223228","9223392","17","789693","TATTAGCTGGGCATGGTGACGGGTGCCTGTAGTCCCAGCTACTTGGATGGCTGAGGTGGGAGGATTACTTAGGCCCAGAAAGTTGAGGCTAAGGTGAGCCATGACTGCACCACCGCATTCCAGCCTGGGCGAAGGAGTAAGACCCTATCTCCAAATAAAAAA","TATTAGCAGGGCGTGGTGACAGGTGCCCATAGTCCCAGCTACTTGGGTGGCTGAGGTGGGAAGATTACTTAAGCCCAGGAAGTTGAGGCTAAGGTTAGCCATGACTGCACCACTGCATTCCAGCCTGGGCGAAGGAGTAAGACCCTGTCTCAAAGTTAAAAAAAA"
"chr1","10022623","10022706","chr1","9235443","9235526","7","787180","TCACACTTGTAATCCTAGCACTTTGGGAGGCTGACGTAGGAGGATCACTTGAAGCCAGGGGTTTGAGACCAGCCTGGGCAACAT","TCACACTTTTAATCTCAGCACTTTGGGAGGCTGACATAGGAGGATCACTTGAGGCCAGGAGTTTGAGACCAGCTTGGGCAACAT"
"chr1","10023462","10023742","chr1","9235975","9236256","19","787487","TCACACTTGTAATCCCAGCACTTTGGGAGGCTGATGTAGGAGGATCGCTTGAGGCCAGGTGTTTGAGACCAGCCTGGGCAACATAGGGAGACCCTGTCTCTACAAAAAATACAAAAATTAGTTGGGTGTGATGGTTCATGCCTGTAGTCTCAGCTACTCAGGAGGCTGAGGTGGGAGGATTACTTGGGCCCAGGAGGTCGGGGCTGCAGTGAGCCAGTGACCATGCCAGTATACTCCAGCCCTGATTACAGAACAAACCCCTATCTCAAACAAACAAACAA","TCACACTTGTAATCCCAGCACTTTGGGAGGCTGACATAGGAGGATCACTTGAGGCCAGGAGTTTGAGACCAGCCTGGGCAACATAGGGAGACGATGTCTCGACAAAAAATACAAAAGTTACTTGGGTGTGATGGTGCATGCTTGTAGTCTCAGCTACTCAGGAGGCTGAGGTGGGAGGATTGCTTGGGCCCAGGAGGTCGAGGCTGCAGTGAGCCAGTGACCATGCCAGTACACTCCAGCCCGGATTCCAGAACAAACTGCTATCTCAAACAAACAAACAAA"
"chr1","10027799","10027965","chr8","11306109","11306271","36","1278310","TCCAGGCTCAGTGGTGCCTGCCTATAGTCCCAGCTACCCAGGAGGCTGAGACAGGATGATCACTTGAGTCCGGGAGATCATGGCTGCAGTGAGCTATTATCATGCCATAACACTCCAGTCTGGGTGAGAAAGTGAGACCTTGTCTCTAAAAACTAAACTGAAAAAAA","TCTAGGCGTGGTGATGCATACATGTAATCCCAGCTGCTCAGGAGGCTGAGGCAGGAGGATCACCTGAGCCCAGGAGTTCGAGGCTGCAGTGAGCTATGATCGTGCCACTGCACTCCAGTATAGGTGACAAAGTGAGACCCTGTTTCAAAAAAAAGAAAAAAAA"
"chr1","10028259","10028413","chr1","27684255","27684415","42","17655996","GGCCTGATATAGTGGTTCACACCTGTAATTCCAGCACTTTGGGAGGCCGAGGTGAGGGGATCGCCTGAGGCCAGCACCAGCCTGGGCAACATAGCGACCCTATCTCTACAGAAAACAAAACAAATCAAAACAAAACAAAAAATAGTCAGGCTCAT","GGCCGGGCATGGTGGCTCATGCCTGTAAACCCAGCACTTTGGGAGGCCAAGATGGGAGGGTCGCTTGAGCCTGGAAGTTCAACACCAGCCTGGGTAACATAGCAAGACCCTGTCTCTACAAAAAAAAAAAAAAATTAAATAAGATAAAAAATTAGCCAGAT"
"chr1","10036248","10036339","chr3","158873113","158873201","17","148836865","CACTTTGGGAGGCTGAAGTGGGAGGATCGCTTGAGGTCAGGAGTATCAGACCATCCTGGGAAACATGGCAAGACCCCCGTCTCTACAAAAAA","CACTTTGGGAGGCCAAGGTGGGAGGATCGCTTGAGGCCAGGAGGTCAAGAGCAGCCTGGGCAACATAGCGAGATCCTGTCTACAAAAAA"
"chr1","10047559","10047838","chr1","9254499","9254783","25","793060","GGACGGATGCAGTGGCTCATGCCTATAATCCCAGGGCCTTGGGAAGCCAAGGAAGGAGGATTGTTTGAAGTCAGGAGTTCAAGACCAGCCTAGGCAACATAGTGAGACCCTCGTCTCTAATAAAAATTTAAAAATTAGCTGGGCACAGTGGCACACACCTCCCAGTTACTCAGGAGACTAAGGCAGAAGGATCACTTGAACCCAGGAGTTAGAGGCTGCACTGTACTCTAGCCTGGGTGACAAAAAATACCTTGTCTCTAAAAAAGTAAAATAAATAAAA","GGCTGGATGCGGTGGCTCATGCCTGTAATCCCAGGGTCTTGGGAAGCCGAGGAAGGAGGACTGTTTGAAGTCGGGAGTTCAAGACCAGCCTGGGCAAGATAGTGAGACCCTCGTCTCTAATAAAAATTTAAAAATTAGCTGGGCACAGTGGCACACACCTCCCAGTTACTCAGGAGACTGAGGCAGGAGGATCACTTGAGCCCAGGAGTTAGAGGCTGCACTGCATGCTAGCCTAGGTGACAGAAAAGACCTTGTCTCTGAAAAAGTAAAATAAATAAAATAAAA"
"chr1","10051747","10052046","chrX","101668164","101668460","44","91616417","GACCAGGCCCAGTGGCTCATGCCTATAATCCCAGCATTTTGGGAGGCTAAGGCCGGAGGATCATTTGAGCCCAGGAGTTCAAGACCAGCCTGGGCAACATAGTGAGACCCTGTCTCTACAAAAAAAAATTAAAAATCAGCCAGGTATGGTGGCATGCACCTATAGTCCCAGCTACTTGGGAGGCTGAGGTGGAAGGATTGCTTGAACCCAGGAGGCGGAGGTTGCAGTGAGCCAAGATGGCACCACTACACTCCAGCCTGGGTGACAGAGCAAGACCCCGTCTCAAAAAAAAAAAAAAAA","GCTGGGTGCGGTGGCTCATGCCTATAATCCCAGCATTTTGGGAGCTGAGGCGGGAGGATCACTTGAGCCCAGGAGTTCAAGACCAGCTTGGACAACATAGTGAGACCCCATCTCTACAAAAAATTTTTAAAAATTAGCCAGGTGTGGTGACATGTGCCTATGGTCCCAGCTACTTAGGAGGCTGAGCTGGGAGGATTGCTTGAACCCAGGAGGTTGAGGCTGCAGTGAGCTGAGATCATGATACTGCACTATAGCCTTGGTGACAGAGCAAGACCCTATCTCAAAAAAAAAAAAAAA"
"chr1","10052735","10052812","chr13","9337444","9337520","21","715291","GCCATGCACGGTTGTAAACACCTGTGGTCCCAGTTACTCGGGAGGCTGAGGTGGGAGGGTCGCTGATGAAATTAGGAG","AGCCAGGCGTGGTGGTGTGCTCCCGTAGTCCCAGCTACTCGGGAGGCTGAGGTAGGAGGATCACTCAAGTTCAGGAG"
"chr1","10053141","10053200","chr2","93331141","93331204","15","83278000","CCAGCCTGGGCGACGAGCAAAATTCCATCTCAAAAAAATTAAATAAAAAATCAATAAATA","CCAGCCTGGGCAACAAGAGCAAAACTCCGTCTCAAAACAAAAAAGTCTATTAAAAACAAAAATA"
"chr1","10070929","10071220","chr1","9278418","9278699","28","792511","GGCTGGGCATGGTGCTTCATGCCCATAATCCTAGTACTCTGGGAGGCCAAGGTGGGAGGATCACTTGGGGCCAGGAGGTTGAGACCAGCCTGGGCAACATAGTGAGACCTCGTCTCTGTCAAAAATTAAAAAAATTAATTAGCTGGACATGGTGGTTTGCACCTGCAGTGTTAGATACTTAGGAGGCCGAGGTGGGAAGATTACTTGAGCCCAGGAGTTTAAGGCTGCAGTGAGCTATGATTGAAATACTGCACTCCAGCTTGGGTGACAGAGAGACTCTCTCTAAAATAAA","GGCTGGACATGGTGCTTCACGCTCATAATCCTAGTACTCTGGGAGGCCAAGATGGGAGGATCACTTGGGGCCAGGAGGTTGAGACCAGCCTGGGCAACATAGTGAGACCTCATCTCTGCCAAAAATTAAAGAAATTAATTAGCTGGGCATGGTAGTGTGCACCTATAGTCTTAGATACTTAGGAGGCTGAGGTGGGAAGATTACTTGAGCCCAGGAGTTCAAGGCTGCAGTGAGCTATGATTGAAATACTGCACTCCAGCTTGGATGACAGAGAGAGGCTCT"
"chr1","10078470","10078735","chr1","9286269","9286533","15","792201","CACGCCTGTAATCCCAACACTTTGAGAGACTGAGGCAGGAAGATCGCTTGAGGCCAGGAGTTCAAAACCAGCCTAGGCAACACAGTAAAACTTCATCTCTACAAAAAAAATTTAAAAATTAGCCGGGCATGGTGGCGCGCACCTGTAGTCTCAGCTACTTCTGAGGCTGAAGCAGGAGGACCACTTAAGCTCAGGAGTTTGTGGCCGCAATGAGCTATGGTCGCACCACTGTACTCCAGCCTGACTTTGTCTTAGAAAAACAAAAA","CATGCCTGTAATCCCAACACTTTGAGAGACTGAGGCAGGAAGATCGCTTGAGGCCAGGAGTTCAAAACCAGCCTAGGCAACATAGTAAGACTTCATCTCTACAAAGAAATTAAAAAATTAGCCAGGCATGATGGCTCACACCTGTAGTCCCAGCTACTTCTGAGGCTGAGGCAGTAGGACCACTTAAGCTCAGGAGTTTGTGGCCGCAATGAGCCATGGTCTCACCACTGTACTCCAGCCTGACTTTGTCTTAGAAAAACAAAAA"
"chr1","10090461","10090624","chr18","36720775","36720932","41","26630314","TTAGGCATGGTGGCATGCACCTGTAATCTTAGCTACTTGAGAGGGTGAGGTGGAAGGATTGCTTGAGCCCAGGAATTAGAAGCTGCAGTGGGCTACAATTATACCACTGCACTCCAGCATGGGCAACAGATGGGTCTTTTTTAAGACCCTGTGTCAAAAAAAAA","TTAGCTGGGCATGGTGGCAGGCAACTGTAGTCCTAGCTACTTGAGAGGCTGAGGTGGGAGGATTGCTTGAGCCCAGGAAGTCGAGGCTTCAGTGAGCTGTGATTGTGCTACTGCACTCTAGCCTGGATGACAGAGTGAGATCCTGTCTAAAAATAAAA"
"chr1","10090916","10091050","chr12","27091688","27091821","28","17000772","GTGCCTCACATCTGTAATCCCAGCACTTTTGGGGAGTCAAGGAGAGAGGATCACTTGAGGCCAGGAGTTTGAGACCAGCCTGGGCAACACAGAGACCCTGTCTCTACAAAATACTTAAAAAATTAGTCAGGTAGT","TGGCTCACACCTGTAATCCCAGCACTTTGGGAGGCCAAGACAGAAGGATCACTTGATCTCAGAAGTTTGAGACCAGCCTAGGCAAAATAGCAAGACCCTGTCTCTACAAAAAATTTTAAAAATTAGCTTGGCTT"
"chr1","10132362","10132671","chr1","9336393","9336697","25","795969","CTGGGCATGGTGGCTGGTGCATGCCTATAGTTTCAGCTACTTGGGAGGCTGAGGCAAGAAAAGGATCACTTGAACCAGGGAGGTCGAGACCAGCCTGGGCAACATAGGGAGACCCTGTCTCTACAAAAAAAATAAAAAATTAGCCAGTGTAGTGGCATAGACCTGTAGACCCAGTTATTCAGGAGGCTGAAGTGGGAGGATCACTTAAGCCCAGGAGGTTGAGGCTGCAGTGAGCTATGTTTGCACCACTGCACTACAGCCTGGGCAACAGAGTAAAACCCTGTCTACAAAAAAAAAAGAAAGAAAGAAA","CTGGGCATGGTGGCTGGCGCATACCCACAGTTTCAGCTACTTGGGAGGCTGAGGCGAGAGGATCACTTGAGCCAAGGAGGTCGAGATCAGCCTGGGCAACATAGGGAGACCCTGTCTCTACAAAAAAAATAAAAAATTTAGCTCAGTGTAGTGGCATACACCTGTAGACCCAGTTATTCAGGAGGCTAAAGTGGGAAGATTGCTTAAGCCCAGGAGGTTGAGGCTGTAGTGAGCTATGTTTGCACCACTGTACTACAGCCCGGGCAACAGAGTAAAACCCTGTCTCAAAAAAAAAAAGAAAGAAA"
"chr1","10150912","10151194","chr1","9357279","9357571","37","793633","GGCTGGGCATGGTGACTCCAGCTAATAATCCTAGCACTTTAGGAGGCCAAGGTGGGAGGATCGTTTGAGCCTAAGAGTTGGAGACCAGCCTGGGCAACATGGCGAGACCCCATCTCTACGAAAAATTTAAAAATTAGATGCCTGTTGTCCCAGCTACTAAGGAGGCAGAGGTGGGAGGAAGGCTTGAGCCCAGGAGTTCAAGGCTGCAGTGAGCTATGATCTTGCTGCTGCACTCCAGCCTGTGAAACAGAGCAAGACCCTGTTTCTAAACAAACAAAAAAAA","GGCCACGCACGGAGGCTCCAGCAAATAATCCCAGCACTTTAGGAGGGCAAGGTGGGAGGATCGCTTGAGCCCAGGAGTTGTAGACCAGCCTGGGCAACATGACGAGACCCCATCTCTGTGAAAAATTTAAAAATTAGATGCCTGTTGTCGCAGCTACTAAGGAGGCTGAGGTGGGAGGAAGGCTTGAGCCCAGGAGTTAAAGGCTGCAGTGAGCTGTGATCTTGCCACTGCATTCCAGCCTGGGAAACAGAGCAAGACCCTGTCTCTAAAAAAATAAATAAATAAAATAAAAA"
"chr1","10153983","10154112","chr19","8153130","8153252","28","2000853","GTGGCTCACACCTGTAATCTCAGTACTTTGGAAGGACGATGTAGGAGGATCACTTGAGGCAGGAATTTGAAACCAGCCTAGGCAACATAGTGAGACCCCATCTGTAAAAAAATTAAAAGTGAAAAAAAAA","GGCTCACGCCTATAATCCCAGTACGTTGGGAGGCTGAGGTAGGAGGATCACTTGAGGCTAGGAGTTTAAGACCAGCCTGGGCAACATAGTGAGACTCCATCTCAACAAAAAATAAAAACATTA"
"chr1","10154406","10154570","chr19","8026553","8026714","33","2127853","ATAAAAAATAAGCCACGCGTGGTGGATACACCTCCAGTCCCAGCTACTTGGGATGCTGAGGTGGGAGGATCACTTGAGCCCGAGAGGTTGAAGCTTCAGTGAGCCATTATTCACACCACTGCACTTTACCCTGGGTGACAGGGCAAGACCCTGTCTCCAAAAAAA","AAAAACTAGCCAGGCATGGTGGTGCACACCTGTAGTCCCAGCTACTCAGGAAGCTGAGGCAGGAGGATCGCTTGAGCCCAGGAGTTCAAGGCTGCAGTGAGCTATGTTCACACCAGTGCACTCCAGCCTGGGTGACAGAGTAAGACCCTGTCTCTAAAAAAA"
"chr1","10160166","10160354","chr1","15335340","15335517","53","5175174","GTGAGACCTTGTCTCTATAAAAAAATTTTTTTAATTAGCCAAGCGTGGTGGTACATGCTTGTAGATCCAGCTCTTTGGATCTACAAAGGCTGAGGCAGGAGGATCACTTGAGCCCAGGAGGTTGAGGCTGTGGTGTGCTATGATCCTGCCAGTGCACTCCAGCCAAGGCGACAGATCAACACTCTGTCT","AACTCTGTCTCTATAGAAAATTTTAGAAATTAGCCAGGCACAGTGGCACATGCTTGTAGTCCCAGCTACTCAGGAGGCTGAGGTGGAAGGATTACTTGAGCCCCAGAGGTAGAGGCTGCAGTGAGGTAGGATCACACCACTGCACTCCAGCCTGGGTGACAGAGCAAGGCCCTGCCTC"
"chr1","10175062","10175218","chr12","85591604","85591764","26","75416542","AAAATTAACTGGGCGTAGTGGCATGCACCTGTAGTCCCAGCTACTTGGGTGGCTAAGGTGAGAGGATTGCTGGAGCCCAGGAGTTTGAGGCTGCAGTGAGCCATGATTGCACCACTGCACTCCAGCCTGAGTGACAGAATGAGACTCTGTCTCAAAA","AAAAATGAGCTGGTTGTAGTGACATGTGCCTGTAGTCCCAGCTACTTGGGAGGCTGAGGCAGGTGGATTGCTTGAGCCCAGGAGTTCGAGGCTACAGTGAGCTATAATTGTGCCACTGCACTACAGCCTGGGTGACAGAATGAGACTCTGTCTCTAAAAAA"
"chr1","10211892","10212184","chr1","9434285","9434588","28","777607","GGCCAGGCATGGTTCCTCACGCCTATAATCCCAACACTTTGGGAGGCTGAAGTGAAAGAATTGCTTGAGGCCAGAAGTTCAAGACCAGCCTGGGCAACATATTGAGACACTCTCTACCAAAAAACATTTTTGTTTAAATTAGCTGGGTGTGGTGGCATGCATCGGTAATCCCAGCTACTTGAGAGGCTGAGGTGGATAGATCACTTGAGCCCAGGAGTTGGAGGCTGCAATTAGCCATGATTCCATCACTGCACTCCAGTTTGGACAACAGAGCCAACAACATCTCAAAAAAA","GGCCAGGCATGGTGCCTCACGCCTGTAATTCCAACACTTTGGGAGGCTGAAGTGAAAGAATCGCTTGAGGCCAGAAGTTCAAGACTAGCCTGGGCAACATATTGAGATACTCTCCACCAAAAAGCATTTTTGTTCCAATTAGCTGGGTGTGGTGGCATGCACCGGTTATCTTAGCTACTGGAGAGGGTGAGGTGGATAGATCACTTGAGCCCAGGAGTTGGAGGCTGCAATTAGCCATGATTCCAGCACTGCACTCCAGTTTGGACAACAGAGCCAACAACATCTCTTAAAAAACACAAAACAA"
"chr1","10236792","10237090","chr1","9463211","9463510","24","773581","GGCTGGGTCCGGTGGCCCACACTTGTAATCCTAGCACTTTGGGAGGCCAAAACAGGAGAATTGCTTCAGCCCAGGAGTTCGAGACCAGCTGGAGCAACCTAGGGAGACCCTGTCTCTACAAAAAAATAAACAAATTAGCCGTGCATGGTGGCACGTGCCTGTGGTCCCAGTTACTCAGGAGGCTGAGGTGGGAGGATCACTTGAGCCCAGGAGGCTGAGGATGCGTGAGCTGTAATCTCACCACTGCACTCCAGCCTAGGGCGACAGAGCAAGACCCTGTCTCTAAAAGAGAAAAGAAA","GGCTGGCTATGGTGGCCCACACTTGTAATCCTAGCACTTTGGGAGGCCAAAACAGGAGAATTACTTCAGCCCAGTAGTTTGAGACCAGCTGGAGCAACCTAGGGAGACCCTGTCTCTACAAAAAAATAGACAAATTAGCTGTGCATGTTGGCACATGCCTATGGTCCCAGTTACTCAGGAGGTTGAGGTGGGAGGATCAGTTGAGCCCAGGAGTTCAGTGACTGTGTGAGCTGTGATCTTGCCACTGTACTCCAGCCTAGGGTGACAGAGCAAGACCCTGTCTCTAAAAGAGAAAAGAAA"
"chr1","10237729","10237994","chr1","9464163","9464443","38","773566","GCCAGGCATGGTAGCTCATGACTTTGGGAGGGCAAGGAAAGAGGATTGCTTGAGCCAAGAGTCTCAGTCCAGCCTAGGCAACATGGCAAAGCCCCATCTCTGCAAAAAAAATTAAAATTTGGCTTGGCATGGTAGTGCACACCTATAGGCCCAATTACTTGGGAGGCAGAGGTGAGAGGTTCACTTGAGCCCAGGAGTTGCAGGCTGCAGTAAGCCATGATTGAGCCACTGTACTCCAGCCTGGGTGACAGACCGTGACGCTGTCT","GACCAGGCATGGTAGCTCATGTCTGTAGTTCAAGCACTTTGGGAGGGCAAGGAAAGAGCATTGCTTGAGCCAAGAGTTTCAGTCCAGCCCAGGCAACATGGCAGAGCCCCATCTCTACAAAAAAATTTTAAAATTGGCTTGGCATGGTAGCGCATGCCTGTAGGCCCAGCTGCTTGGGAGGCTGAGGTGAGAGATTCACTTGAGCCCAGGAGTTGCAGGCTGCAGTAAGGCATGGTTGAGCCACTGCACTCCAGCCTGGTTGACAGACCATGACACTGTCT"
"chr1","10240536","10240830","chrX","2057493","2057787","50","8183043","GGTCTGGTGTGGTGGCTCACACCTGTAATCCCAGCACTTTGGGAAGCTGAGGCATGAGGATGGCTTGAGCCCAGGAGTTTGAGACCAGCCTGGGCAACATAGTGAGACTCCCATCTCTACAAAAAAGAAAAATAATTAGCCGGGTGTAGTGGCATGAACCTGTGGTCCCATCTACTCCAGAGGCTGAGGTGGGAGGATCACTGGAGCCCAGGAGGTTGAGTCTGTAGTGAATTGTGGTTGTACCACTGTACTCCAGTCTGGGCCTCAGAGTTAGATCCTGTCTCAGAAAAAAAAA","GGTCAGGCGTGGTAGCTCATATCTGTAATCCTAGCACTTTGGGAGGCTGAGGCAGGAGGATTGCTTCAGCCCAGGAGTTTGAGACCAGACTGGGCAATATAGTGAGCTCCCATCTCTACAAAAAATGTACAGAATTAGCCAGGCTTGGTGGCATGTACCTGTGGTCTCAGCTCCTTGGGAGGATGAGGTGGAAGGATCACTTGAGCCCAGGAGGTCGAGGCTGCAGTGAGTCATGATTGCACCACTGCACTCCAGCCTGGGCAACAGAGTTGGACCTTGTCTCAAAATAAATAAA"
"chr1","10249080","10249360","chr16","21941769","21942047","63","11692689","GGCTGGGCTCAGTGATTCACACTGCAACCCCAGCATTTTCAGAGGTGGAGGAGGCAAGATTGCTTGAGCCCAAGAGTTCAACACCAACCTGGGCAACATAGGGAAACTCCATCTCTACAAAAATATCAATTATCTAGGGGTGGTGGTGGCACACACCTGTTGTCCCAGCTACTTGAGAAGCTGAGGGGGTAAGATCGCTTTGGCCCAGAAGGTCAAGGCTGCAGTGAGCTGTGATCACGCCACTGCACTCCAGGGCCTGGGCAACAGAGTGAGACCCTGTC","GGCTGGGCACAGTGGCTCACACCTGTAATCCCAGCACTTTGGGAGGCTGAGGCAGGAGGATTGCTTGAGCCCAGGAATTCATGACCAGCCTGAGCAATATAGGGAGACCGCCATCTCTACAAAAAATTAAAGAGTTAGCCGGGCATGGTGGCACACGCCTGTGGTCCCAGCTACTCAAGAGCCTGAGGTGGGAGGTTTGCTTGAGCCCGGGAAGTCGAGGCTGCAGTGAGCTGTGATTGCTCCATTGCACTCCAGCTTGGGCAACAGAATGAGACCTTG"
"chr1","10263935","10264231","chr1","9494490","9494795","25","769445","GGCAGCTCACACCTGTAATCCCAACACTTTAGGAGGCCAAGTGGGGAGGATCACTTGAGGCCAGGAATTTGAAACCAGCCTGAGTAACCTAACAAGACCCCCCATCTCTACAAGAAATTTTTAAAAATTAGCCAGGCCTAGTGGCATGCGCCTATAGTTTTAGCTACTTGAGAGGCTGAAGTAGGAGAATCACACGAGCCCAGGTGTCTGAGGCTGCAGTGAGCTACAATCTTGCCACTGCACTCCAGCTTGGGCCACATAGCAAGACTCAAAAACAAAAACTAACAAACAAAAAAA","GGCAGCTCACACCTGTAATCCCAACACTTTTGGTGGCCAAGTGGGGAGGATCACATGAGGCCAGGAATTTGAAACCAGCCTGAATAACATAACAAGACCCCCGATCCCTACAAGAAATTTTTAAAAATCAGCCAGGCCTAGTGGCATGTGCCTGTAGTTTTAGCTACTTGGGAGGCTGAAGTAGGAGCATCACACGAGCCCAGATGTCTGAGGCTGCAGTGAGCTACAATCTTGCCACTGCACTCCAGCTTGGGCCACACAGCAAAAGACTCCATTACAAAAACAAAAACTAAAAAGCAAAAAAAA"
"chr1","10266352","10266661","chr1","9496843","9497153","33","769509","GGTTGGGTGTGGTGGTTGACATCTATAATCCTAGCAGTTTGGAAGGCCGAGGCAGGAGGACTGCTTGAGGTCAGGGGTTCCAGACCAGCCTGGGAAACACAGCAAGACGCCTCACCTCTACAAATTAAAAATTAAAAAATTAGCCAGGTGTGGCAGCGAACAACTGTAGTCTCAGATACTCAGGAGGCTGAGCTGGAAAGATCACTTGAGCCCAAGAGTTCAAGGTTACAGTGGGCCATGATCATGTCATTACACTCCAGCTTGGGTGACAAGAGTGAGACTGTCTAAAAAAAAAAAAAAAAGGAAAAAA","GGCTGGGTGTGGTGGCTCACATCTGTAATCCTAGCACTTTGGGAGGCCGAGACAGGAGGACTGCTTGAGGCCAGGGGTTCCAGACCAGCCTGGGAAACATAGCAAGACCCCCATCTCTACAAACAAAAAATTTAAAAATCAGCCAGGCGTGGCAGTAAACAACTGTAGTCTCGGATACTCAAGAGGCTGAGATGGAAAGATCACTTGAGCCCAAGAGTTCAAGCTTGCAGTGGGCCATGATCACGTCATTACACTCCAGCTTGGGTGACAGAATCAGACCATCTCAAAAAAAAAAAAAAAAAAGGAAAAAA"
"chr1","10314512","10314802","chr19","25476896","25477182","61","15162384","CCAGGTGCAGTGGCTCACACCTGTAATCTCAGCAACTCTGGAGGCTGAGGCCAGAAGTTTGAGACCAGAGTGGGCAACATAGTGAGACCCTGTCTCTTTGAAAATTTAAAAAACAATTAGCTGGGTGTTGTGGTGCATGCCTGTAGTCCCAGCTTCTTGGAAGGCTAAGGCAGGAGGATAATTTGAGCCCAAGAGTTTGAGGCTGCAGTGAGCCATGATTGCACCACTGCACTCCAGCCTGGGGACAGAGCAAGACCCCAACTCTACCAAAAAATATAAAATAAAATAAAA","GGCCTGGCGTGGTGGCTCACACCTATAATCCCAGCACTTTGGAAGGCCTAGAAGTTCAAGACCAACCTAGGTAACATAGTGAGACCTCCTCTTTACAAAAAATTTAAAAAAAATTAGCCGGGTGTGGTAGCCTGTGCCTGTAGTCCCAGCTACTTGGGAGGCTGAGGCAGGAGGATCACTTGAGCCCAGGAGCTTGAGGCTGCAGTGAGCTATGATTGCATCACTGCCCTCCAGCCTAGGAGACACAGCAAGACCCCATTTCTTAAAAAAAAAAAAAAAAAAAAAGA"
"chr1","10321199","10321508","chr11","121456453","121456756","66","111135254","GGCCGGGTGCAATGGCCCACACCCGTAATCCTAACATTTTGGGAGGCCAGGGCAGGAAGATCGCTTGAACTCAGGAGTTCGATCGAGACTATGCTGGGCAGCATAATGAGACCCCAACTCTATAAAATTTATAAACTTAAAAATTAGCTGGGATGGTGGTGTGCATCTGTAGTTCCGGCTATTCAGGTGGCTGAGGTGGGAGGATGGCTGAGCCTGGAGGTGAAGGATGCAGTGAGATATGATTGCACCATTGCACTCCAGCCTGGACGGCAAAGTGAGACCCTGTCTACAAAAAAAAAACAACAAAAAA","GACCAGGTGCAGTGGCTCACACCTGCAATCCTAACACTTTAGGAGGCCGAGGCAGGTGGATTGCTTGAGCTAGGAGTTTGAGACCAGCCTGGGCAATATAATGAGACTCCGTCTCTACAAAAAAATTTTAAAAATTAGCTGGGCATGGTGGCGTGCACCTGTAGTCCTAGCTACTCAGGAGGCTGAGGTGGGAGGATCGCTTGAGCCTGGGAGGCAGAGGTTGCAGTGAGCTATAATCGCACCAAGTCCACTCCAACCTGGGTGACAGAGTGAGACTCTGTCTCAGAAACAAAACAAAACAAAA"
"chr1","10337930","10338246","chr1","9592227","9592514","54","745703","GGCCAGGTGTGGTGGCTCATGCCTGTAATCCCAGCACTTTGGGAGGCCAAGGCAGGAGGATCGTTTGAGCTCAGGAGTTCGAGACCAGCCTGAGCAACATAGTGGGGCCCCGTCTCTACAAAAAAATAAAATAAAATAAAATAGCTGGATGTGGTGCTGCAGGCCTAAAGTCCCAGTTACTTAGGTGGCTTAGGTGGGAGGATCACTTCAGCCCAGGAATTCAAGGCTGCAGTGAGCTATGATTGAACCACTGCTCTTCAGCCTGGGAGACAGACCAAGACATTGTTTCAAAAAAAAAAAAACAAAAAAACAAGAAA","GGCCAGGTGCAGTGGCTCATGCCTATAATCTCAGCACTTTGGGAGGCTAAGGCAGGAGGATCGTTTGAGCCCAGGAGTTCGAGACCAGCCTGAGCAACATAGTGGGGCCCTGTCTCTACAATAAAATGAAATAAAATAGCTGGATATGGTGCTACAGGCCTAAAGTCCCAGTTCCTCAGGTGGCTTACGTGGGAGGATCACTTGAGCCCAGGAATTAGCTATGATTGCACCACCGTACTCCAGCCTGGGGGACAGACCAAGACCCTATTTAAGAAAAACAACAAAAAA"
"chr1","10342949","10343197","chr13","70892536","70892787","55","60549587","GGTCAGTTGTGGTAGCTCACACCTGTAATCCCAGCACTATGGGAGATAAAAGTGGGAAGATCACTTGAGGCCAGGAATTTGAGGCCAGCGTGGGCAATACAGCGAGACCCCGTCTCTACAAAAAAATTTTAAATTAGCTAGGCATGGTGGCACGTGTCTGGAGTCCCACCTATTCGGGAGGCTGAGGCGGGAGGACTGCTTGAGCCCAGGAATTCAAGGTTGCAGTGAGCTATGATCATGCTACTGCAC","GGTCAGGTGTAGTAGCTAACACCTGTAATCCCAGTGATTTGGGAGGCCAAGGCAGAAGGATCACTTAAGCCCAGGAGATCATGACCAGCCTGAGCAACATAGGGAGACCCCATCTCTACAAAAAATTTAAAAAATTAGCCAGGCATGGTGGCATGCACCTGTGGTCCCAGCCATTCTGGAGGCTGAGGTCAGAGGATTCTTTGAGCCCAGGAGGTTCAAGACTGCAGTGAGCTGTGATCATGCCACTGCACT"
"chr1","10343484","10343743","chr7","95863189","95863435","68","85519705","TGGCTCACACCTGTAATACTAGCACTTTCCTACTAAGGTAGGAAGATCACTTGAGCCCAAGAGTTCAAGACCTGCCTGGGCAATGTAGAACTTGTCTCTAAAGAAAAAAAAAAATTTAATTAGCCGGGTGTGGTGGTTCGTGTCTATATTCCCAGCTACTCAGGAGGCTGAGGTGGGAAGATCACTTGAGCCCAGGAGTTAGATTGCACCAGTGCACTCCAGCCTGGGCAACAGAGCAAGACCCTTGTCTAAAAATAAAA","GGTGGCTCACACTTGTCCTAGCACTCTGGGAGCCCAAGGCTGGCAGATCACTTGAGCCCAGTAGTTGGAGACCAGCCTGGGCAACATAGCAAACCTTTTTCTACAAAAAAAAAAAATTAGCCAGGTGTGGTGGCGCATGCCTGTATTCCCAGCTACTCAGGAGGCTGAGGTGGCAGAGAAGCTTGAGCCGAGATCATGCCACTGCACCCTAGACTGGGTGACAGAGCAAGACTGTCAAAAAAAGAAA"
"chr1","10348882","10349173","chr1","9604297","9604574","29","744585","GGGCATGGTGGCTTATGCCTATAATCTCAGCACTTTTTGATGCCAAGGTGGAAGGATCACTTGAGGCCAGGAGTTCAAGACCAGCCTGGGCAACATAAGGAGACCCTATCTCTACAAAAAAACTTAAAAATTAGCTGGGTATAGTGGTGTATGCCTGAAGTCCCAACTACTAAGGAGGCTGAGGCAGAAGGATCACATTAGTCCAGGAGTTCGAGGCTGCAGTGAGTTGTGATTACATCACTGCACTCCAGCCTGGGTGACACAGGGAAACCCTATCTATAAAAAAATAAAA","ATGCATATAATCTCAGCACTTTTTGATGCCAAGGTGGAAGGATCACTTGAGGCCAGGAGTTCAAGACCAGCCTGGGCAACATAGTGAGACCCTGTCTCTACAAAAAAATTTAAAAATTAGCTGGGTATGGTGGTGCATGCCTGAAGTCCCAACCACTCAGGAGGCTGAGGCAGGAGGATCACATGAGTCCAGGAGTTTGAGGCTGCAGTGAGCTGTGATTACACCACTGCACTCCAGCCTGGGTGACACAGGGAAATCCTATCTCTAAAAAAATAAAA"
"chr1","10355902","10356171","chr6","179154659","179154925","55","168798757","GGCTGGGTGTGGTGGTGCATACCTGTAATCCCAGCACTTTGGGAGGCCAAGATGAGGGGATCGCTTGAGGCCAATAGGTTGAGACCAGCCTGGGCAATATAGCACAAATACCCTATCTCTACAAAAAAAATTTTGAAAAATTAGCCAAATGTGGTGGTACACACCTATAGTCCTAGCTACTCAGGAGGCCAAGGCAGGATTGCCTGAGCCCAGGAGTTTGAGGCTGCAGTGAGGTATGATTGTGCCATTGCACCCCAACCTGTGTGACAG","GGGCAGGCATGGTGGCTCACAACTGTAAACCCAACACTTTGGAGGTGAAGGTGGGAGGATCTTTTGAGGTCAGGGGTTCAAGACCAGCCTGGGCAACATAGCAAGATCTTATCTCTACAAAGAAGATTTTAAAAATTAGCCAAGCATGCTGGTGCACACCTATAGTCCTAGCTACTCAGGAGGCTAAAGCAGGAGGATCCCTTGAGCCCAGGAGTTTGAGGCTGCAGTGAGCTATGATTGCACCACTGCACTCCAGCCTGGGTGGCA"
"chr1","10357751","10358031","chr1","9616845","9617129","20","740906","TCCCAGCACTTTCGGATGCCAAGGCAGGAGGATTGCTTGAGGCTGGGAGTTCGAGACCAGGCTGGGCAACATAGCGATATGCTGTCTCTACAAAAAATAAATAAGATACCCAGGCGTGGTGGTCTGTGCCTGTGGTCCCAGCTACTCGGGAGGCTGAAGTGGGAGGATCGCTTGAATCCAGGAGTTCAAGGTTGCAGTGAGGTTTTATTATTGCACCACTGCATTCCACCCTGGGCGACAGAGCAAGACCCTGTCCCTAAAAAAAATTAAAAAAAGACAAA","TCCCAGCACTTTGGGATGCCAAGGCAGGAGGATTGCTTGAGGCTGGGAGTTCGAGACCAGCCTTGGCAACATAGCAATATGCCATCTCTACAAAAAATAAATAAGATAGTCAGGCGTGGTGGCCTGTGTCTGTGGTCCCAGCTACTTGGGAGGCTGAAGTGGGAGGATTGCTTGAATCCAGGAGTTCAAGGTTGCAGTGAGGTTTTATTATTGCACGACTGCATTCCACCCTGGGTGACAGAGCAAGACCCTGTCCCTAAAAAAAAAGAGAAAGAAAAAGACAAA"
"chr1","10358322","10358595","chrX","123773493","123773766","53","113415171","GGCTGAGTGCAGTGGCTCATACCTGTAATCCCAGCACTTTCAGGGGCTGAGGTGGGAGGATTGCTTCAGCCCACAAGTTTGAGACCAGCCTGGGCAACATAGGGAGACCCCCATCTCTACAAAAAATAAATAAAATAGTTGGACATGATGGCATGCGCCTGCGGTTCCAGCTACTCAGGAGGCTCACATGGGAGGATTGCTTGAGCCCGGGAGGTTGAGGCTGCAGTGAGCCATGGTTGCACCATTGCACTCCAGCCTGGGTGACAGAGCAAGA","GGCTGGGCATGGTGACTCATGCCTGTAATCTCAGCACTTTGGGAGGCCAAGGAGGGTGAATTGCTTGAGCCCATGAGTTTGAAGCCAGTCTGGGCAACATAGGGAGACCCCCGTCTCTACAAAAAATTTAAAAATTAGCCGAGTGTGGTGGCATGCGCCTGTGGTCCCAGGTACTCAGGAGGCTGAGGTGGGAGGATCACTTGAGCCTGGGAGTTTGAGGCTGTGGTGAGCTATGATTGTGCCACCATACTCCAGCCTGGGTGACAGAGCAAGA"
"chr1","10373605","10373898","chr1","9632102","9632392","26","741503","CAGGCATGGTGGCTTACACCTGTAATCCCAGCACTTTGAGAGGCCGTGGCAGGAGGATCACTTGAAGCCAGAGCTCAAAACCAGCCTGGGCAACTTAGTGAGCCCCCATTTCTACAAAAATAAAAACAATTAACTGGGCATGGTGGTACACACCTGTAGCCTCAGCTACTCAGGAAGCTGAGATGGGAGGATCCCTTGAGCCCAGGAGTTTGAGACTGCAGTGAGCTATGATGGTGCCACTGGCGCCTGGGTAACAAAGCAAGACCCTGTCTCAAAAAAAACAAAAAAAAAAAA","GGGCAGGCATGGTGGCTTACACCTGTAATCCCAGCACTGTGAGAGGCTGTGGCAGGAGGATCACTTGAAGCCAGAGTTCAAAACCAGCCTGGGCAACTTAGTGACCCCCCATTTCTACAAAAAATAGAGAACTAACTGGGCATGGTGGTACACACCTGTAGCCTCAGCTACTCAGGAAGCTGAGAGGAGAGGATTCCTAGAGCCCAGGAGTTTGAGGCTGCAGTGAGCCATGATGGTGCCACTGGCGCCTGAGTAACAGAGCAAGACCCTGTCTCAAAAAAAAAGAAAAAA"
"chr1","10376165","10376291","chr1","9635436","9635564","7","740729","GGCTGGGCACGGTAGCTTGCACCTGTAATCTCCCAACACTTTGGGAAGCAAAGGTGGGAAGTTGGCTGGAGGACAGGAGTTCAAGGCCAGCCTATGCAACCAAGCAAGACCCTGTCTCTACAAAAAA","GGCTGGGCACGGTAGCTCGCGCCTGTAATCTCCCAACACTTTGGGAAGCAAAGGTGGGAAGATGGCTGGAGGACAGGAGTTCAAGGCCAGCCTGTGCAACAAAGCAAGACCCTGTCTCTACAAAAAATA"
"chr1","10393146","10393434","chr1","9653153","9653441","14","739993","GCCAGGCATGGTGGCTCACGCCTATGGTCCCAGCACTTTGGGAAGCTGAGGTGTGAGGATTGCTTGAGGCCAGGAGCTCAACACCAGCCTGGGCAACATAGCAAGATCCTGTCCCTACAAAAAAAAGTTTTTAATTAGCTGGGTGTGATGGCACACACCTGTAGCCCCACCTACTTGGGAGACTGAGGCAGGAGGATCACCTAAGTCCAGGAGTTTGAGGCTGCAGGGAGCCGTGATTGTGCCACTGCACTCCAGCCTGGGCAACAGAGTGAGACCCTGTCTCTAAGAA","GCCAGGCGTGGTTGCTCATGCCCATGGTCCCAGCACTTTGGGAAGCTGAAGTGTGAGGATTGCTTGAGGCCAGGAGCTCAACACCAACCTGGGCAACATAGCAAGATCCTGTCCCTACAAAAAAATGTTTTTAATTAGCTGGCTGTGATGGCACACACCTGTAGCCCCATCTACTTGGGAGGCTGAGGCAGGAGGATCATCTAAGTCCAGGAGTTTGAGGCTGCAGAGAGCCGTGATTGCGCCACTGCAGTCCAGCCTGGGCAACAGAGTGAGACCCTGTCTCTAAGAA"
"chr1","10406674","10406968","chr1","9667825","9668136","57","738849","GGCTGGGTGCGCTGGCTCACACCGTAAGCCCGGCACTTTGGAAGGCCGAGGTGGGAGGAGTGCTTGAGCCCAGGAGTCTGAGACCAGCCTGGGCAACATAGTGAGACCCCCATCTCTACAAAAAATAAATATTAGCTGGGCGCAGTGGTGCACACCTATGACCCCAGCTAGGTGGCAGGCTGAGGTGGGAGGGTCGCTTAAGCCCAGGAGACGGAGGTTGCAGTGACCATGACGACACCACTGTACTCCAGCCTCGGTGATAAAGCAAAACCCTGTCTCAAAAAAAAAAAAAAAA","GGCTGGGTGCGGTGGCTCACACCTGTAATCCCAGCACTTTGGAAGGCTGAGGTGGGAGGACTGCTTGAGCCCAGGAGTTTGAGACCAGCCTGGGCAACATAGTAAGGCCCCCATCTCTACAAAAAAATAAGAATTACGCTGGGCGCGAGTGGTTGGGCACACCTATGGATCCCAGTCCCTGCAAGGCTGAGGTGGGGATCGCTTGAGCCCAGGAAGATCCAGGTTGCAGAAGACCATTATCACACCACTGTACTCCAGCCTAGGGATAAAGCAAACCGTCTCAAAAAAAAAAAAACAAAAAAACAAAAAAAA"
"chr1","10408487","10408785","chr1","9669063","9669352","23","739424","GGCCAGGCGTGGTGGCTCATGCCTGTGGTCTCAGCACTTGGGAGGCTGAGGCGGGAGGATCGCTTGAGCCCAGGAGTTGAAGATCAGCCTGGGCAACATAGGGAGAGCTCATCTCTACAAAAAGTTTAGAAATTAGCCAGGCGTGGCGGTGTGCACCTGGAGTCCCAGCTAGCCAGGAGGCTGAGTTGGGAGGATCACCTGAGCCCAGGAGGTTGAGGCTGCAGTGAGCCATGATAGTGCCACGCTGCACTCCAGCCTGGGCCACAGAATGAGACCTTGTCTCAAAAAAAAGATAGAAA","CCAGGCATGGTGGTTCCTGCCTGTGGTCTCAGCACTTGGGAGGCTGAGGCCGGAGGATCGCTTGAGCCCAGGAGTTGATCAGCCTGGGCAACATAGGGAGAGCCCATCTCTACAAAAAGTTTAGAAATTAGCCAGACGTGGTGGTGTGCACGCGGAGTCCCAGCTAGCCAGGAGGCTGAGTTAGGAGGATCACCTGAGCCCAGGAGGTTGAGGCTGCAGTGAGCTGTGATAGTGCCTCTGCACTCCAGCCTGGGCCACAGAACGAGACCTTGTCTCAAAAAAAAGAGAAA"
"chr1","10415325","10415634","chr1","9672263","9672571","16","743062","GGCAGGGCATGGTGGCTCACACCTGTAATTCCAGCACTTTGGGAGGCTGAGATGGGATGATTGTTTGAAGCCAGGAGTTTGATACCAGCCTGGGCAACATAGTGAGACCTGGTCTCTACAAAAAATAAAAATTAGCCAGGTGCGCTGATGCAGGCTTGTGGTCCCAGCTACTTGGGAGGCTGAAGTGGGAGGATCACCTGAGCCCAGGAGGTGGAGGTTACAGTGAATCTTGGTGGTGCCACTGCACTCCAGCCTGGGCGGCAGAGCGAGACCCTGCCTCTCAAAAAACTACAATAAAAACAAACCAAAA","GGCAGGGCATGGTGGCTCACACCTGTAATTCCAGCACTTTGGGAGGCTGAGGTGGGATGATTGTTTGAAGCCAGGAGTTTGATACCAGCCTGGGCAACAATAGTGAGACCTGGTCTCCACAAAAAATAGAAATTAGCCAGGTGCGCTGATGCGGGCTTGTGGTCCCAGCTACTTGGGAGGCTGGAGTGGGAGGATCACCTGAGCCCAGGAGGTGGAGGTTACAGTAAGCCTTGGTCGTGCCACTGCACTCCAGCCTGGGCGGCACAGCGAGACCCCTGCCTCTCAAAAAACAATGAAAACAAACCAAAA"
"chr1","10442467","10442683","chr1","9700344","9700560","16","742123","GACCAACCTGGGGAACATAGCAAGACCCCATCTCCACAAAAATGTAAAAAATAAAAATTAGCCGGGTGTAGTGGCACATGCCTGTAATCCTAGGTACTCGGGAGGCTAAGGCAGAAGGATCACTTGAGCCCAGGAGTTCGAGGCTGCAATGAGCTGTGATCGTGCCACTGCACTCCATCCTGGGTGGCAGAGTGAGGCCCTGTCTCAAAATAAATAA","GACCGACCTGGGGAACATAGCAAGACCCTATCTCTACAAAAATTTAAAAACTAAAAATGAGCCGGGTGTAGTGGCACATGCCTGTAATCCTAGATACTCAGGAGGTCAAGGCAGAAGGATCACGTGAGCCCAGGAGTTTGAGGCTGCAATGAGCTATGATCGTGCCACTGCACTTCACCCTGGGTGACAGAGTGAGGCCCTGTCTCAAAATAAATAA"
"chr1","10443234","10443338","chr1","9701072","9701171","8","742162","GGCTGGGTGTGGTGGCTCATGCCTGTAATCCCAAAATTCTGGGAAGCTGATGTGGGAGGATTGCTTGAGGCCTGGAGTTTGAGACCAGCCTGGGTAACATGGTGA","GGCTGTGTGTGGTGGCTCATGCCTGTAATCCCAAAACTCTGGGAAGCTGATGTGGGAGCATTGCTTGAGGCCTGGTTTGAGACCAGCCTGGGTAACATGG"
"chr1","10445038","10445238","chr17","5229611","5229823","53","5215427","CAGCTTAGGCAACATAGCAAGACCCTGTCTCTACAAAAAAAATTTTAAGTTAGCCAGGCATGGTGGCACTGAACTATAATCCTAGCTACTCTGGAGGCTAAGGCGAGAGGATCACTTGAGCCCAGGAGCTCAAGGCTGATCATGCCACCATACTCCAGCCTGGATGATAGAGTAAGACCCTACTTTTTTTTTTAAAAAAAA","CAGCCTGGGCAACATAGCAAGACCCTATCTCTACAAAAAACTTTTAAAATAGCTGGGCATGATGGCACGTACCTGTAGTCCCAGCTACTTAGGAGGCTGAGGTGGGAGGATCGCTTGAGCCCAGGATTTTGAGGCTGCAGTGAACAATGATCGCATCACTGCACTCCAGCCTGGGGGACAGAGTGAGACCCTGTCTCTTAAAGAAAAAGAGAA"
"chr1","10464065","10464345","chr1","129543506","129543782","51","119079441","GGCTGGGCGTGATGACTCATACCTGTAATCTTAGCACTTTGGGAGGCTGAGGCGGGAGGATCGCTTGAGGCCAGGAGTTTGAGACCAGCCTTTGCAATATAGGGAGACCTCGTTCCTACTGAAAATTAAAAAATTAGCCAGGCATGGTAGCGCTTGCCTGTGGTCCCAGCTACTTTGGAGGCTGAGGTGAGAGCATCACTTGGGCCTGGGAGGTTGAGGCTGCAGTGAGCGGTGATTGTGCCATTGCCCTCCAGCCTGGGTGAGAGAGCAAGACCCTGTTT","GCCAGGTGCAGTGGCTCATGCCTGTAATTCTAGCACTTTGAGAGGCCGAGGCAGGAGGATCGCTTCAGCTCAGGAGTTTGAGACCAGCCTGGGCCATATAGTGAGACCCCTTCTAAACAAAACAAAAAATTAGCTGGGCATGGTAGTGCATGCCTGTGGTCCCAGCTACTTGGGAGGCTGAGGTGGGAGGATCGCTTGAGCCCAGGAGGTCAAGGCTGTAGTGAGCTGTGATTGTGCCACTGCACTCCAGCCTGGGGAATAGAGTGAGACCCTGTCT"
"chr1","10475652","10475938","chr10","14283283","14283568","56","3807631","GTGGCTTACACCTTAAACCCAGCACAGCACTCTGGGAGGGTACAATGGGAGGATCCCTTAAGGCCAGGAGTTTGAGACCAGCCTGGGCAACACAGCGAGACCCCATCTCTACAAAAAATTTAAAAATTAGCCGGGTGTGGTGGTGCATCCTATAGTCCCAGCTACTCAGGAGGCTGGGGAAGGAGGCTCGCTTGATCCCAGGAGGCAGAGATTGCAGTGAGCTATGATGGTGCCATTGTATTCCAGCTTGGTCAACAGAGCAAGACTCTGTCTCAAAAAGAAAAAAA","GTGGCTCACACCTGTAATCCCAGTGCTTCGGGAGGTTGAGGTGGGAGGATCACTTGAGGCCAGGAGTTTGAGACCATCCTGGGTAACATAGCGAGACACCATCTCTTAAAAAAAAAACAAAAATTAGCTGGATGTGGTGGTGTCCATCTGTAGTCCTAGCTACTCAGGAGGCTGGGGTGGGAGGATCACTTGAGCTCAGGAGTTTGAGGTTACAGTGAGCTGTGAATGTGCCACTGCATTCCAGCCTGGACAACAGGGCAAGACCCTGTCTCTAAAATACAAAAAA"
"chr1","10482571","10482875","chr1","9743572","9743882","25","738999","GGCCAGGTGCAGTGGCTCATGCCTATCATCCCAGCACTTTGGGAGGCCAAGGTCGGGGGATCACTTGAGGCCAAGAGTTTGAGACCAGCCTGCACAAAATAGAGAGACCCCATCTCTATTATAAATTTTAACATTAGCCGGGCTTGGTGCCTCATGCCTATACTCTCAGCTGCTCAGGAGGCAGAAGCCAGAGGATTGCTTGAGCTCAGGAGTTTGAGGCTGCAGTGAGCTATGATCATGCCACTGCACTCCAGCCTGAGCAACAGAGCAAGACCCTGTCTCTAAAACAAAACAAAAGAATAAAA","GGCCGGGTGCAGTGGCTCATGCCTATAATCCCAGCACTTTGGGAGGCCAAGGTCAGGGGATCACTTGAGGCCGGGAGTTTGAGACCAGCCTGCACTAAATAGAGAGCTCCCATCTCTATTACAAATTTTAACATTAGCTGGGCTTGGTGGCTCAGGCCTATACTCTCAGCTGCTCAGGAGGCAGAAGCCAGAGGATCGCTTGAGCTCAGGAGTTCGAGGCTGCAGTGAGCTATGATCATGCCACTCTCTCCAGCCTGGGCAACAGAGCAAGACTCTGTCTCTACAACAACAACAACAACAAAGAATGAAAA"
"chr1","10485051","10485332","chr1","9747194","9747438","55","737857","GGCTGAGCGTGGTGGCTCACGCCTGTAATCCTTGCACTTTGGAAGGAAGAAGCGGGAGGATTGCTTGAGTTCCGGAGTTTGAGACCAGATTCGGCAACATAGTGAAACCCTGTCTTTACAAAAAATTTAAAAAAATTTAGCCAGATGTGGTGGCGAGTGCCTGTAGTCCTTGGGAGGCTGAGGTGGGAGGATTGCTTAAGCCTAGTGGGTTGAGGCTACATTGAGCTGTGATCCCCCCACTGCACTCCAGCTTGGGCAACAGAGCAAGACTCTGTCTCAAAA","GGCTGAGTGTGGTGGCTCACGCCTGTAGTCCTTGCACTTTGGAAGGAAGAGGCGAGAGGATTGCTTGAGTTCCGGGGTTTGAGACCAGCTTCAGCAACATTTAGCCAGATATGGTGGTGAGTGCCTGTAGTCCTTGGGAGGCTGAGGTGGGAGGATTCCTTAAGCCCAGTGGGTTGAGGCTACAGTGAGCTGTGATCGTACCACTGCACTCCAGTGTGGCAACAGAGCAAGACCCTGTCTCAAAA"
"chr1","10486204","10486519","chr1","154261716","154262030","52","143775512","GGCAGGGCGTGGTGGCTCACACCTGTAATCCCAGCACTTTGGGAGACTGAGGCGGGGGATCGCTTGAGCCCAGGAGTTCGAGATCAGCCTGAGCAACATAGTGAGACCTCATCTCTACACAATTTTTTTAAAAAATTAGCTGGGCATGGTGGTGTGCACCGGTAGTCCCAGCTACTGGGGAGGCTGAGGTGGGAGAATCACCTGAGCCCAAGAGGTGGGGGGCTGCAACGAGCCATGATTGTGCCACTGCACTCCAGCCTGAGTGACAGAGAAAGACCCTGTCAATTAAAAAAAAAAAGAAAAAAGAAAAAGAAAA","GGCTGGGCGTGATGGCTCATGCCTGTAATCCCAGCACTTTGGGAGGCTGAGACAGGGGGAATGCATGAGCTCAGGAGTTTGAGACCAGCCTGGGCAACATAGTGAGACTCCATCTCTACAAAAAATATTTGTTAAAAATTAGCTGGGCATGGTGGTGTGCACCTATAGTCCCAGCTACTCAGGAGACCGAGGTGGGAAGATCACTTGTGCCTAGGAGGTCAAGGCTGCAGTGAGCCAAGATTGTGCCACTGCACTGCAGCCTGGGTGACAGAACAAGACACTGTCTCAAAAAAAAAAAAAAAAAGAGAAAAAAAA"
"chr1","10504285","10504598","chr8","78850789","78851109","56","68346504","GGCCGCCCATGGTGGTTCATGACTGTAATCCAGCACTCTGGGAGGCCAAGGTGGGAGGATCACTTGAGGCCAAGAGTTTGAGACCAGCCTAGACAACACAGTGAAATCCTGTCTCTTCAAAAAATTTAAAAATTAGCTGGGCATGTTGGCATATGCCTGTGGTCCTAGCTACTTGGGAGGCTGGGGCAGGAGGATCGCTTGAGCTCAGAAGGTTGAGGCTGCAGTGACCTATGACCGCACCACTGCACTCCAGCCTGGGGTGACAGAGTGAGACCTTGTCTCTAGTTAAAAAAACAAAAAAAAAAAAAGAAGAA","GGCTGGCCATGGTGGCTCAGGCCTATAATCCCAGAACTTTGGGAGGCCAAGGTGGGAGAATCACTTGAGTCCAGGAGTTTGAGACCAGCTTAGGCAACATAGTGAGACCCTGTCTCTACAAAAAATAAAAAAATTAGCCAGGCACAGTGGCTTGTGCCTGTGGTCCCAGCTACTCTGGAGGCTGAGGTGGGAGGATTGCTTGAGCCCAAGGAGGTTGAGGCTGCTGTGAACTATGATCACACCACTGCACTCCAGCCTGGGTGACAAAGTGAGACCCTGTCTCCTTCACCACAAAAAAAAAAAAAAAAAGGAAAGAAAAAA"
"chr1","10508831","10509113","chr1","9770637","9770912","34","738194","GGCCAGGCATGGTGGCCCACGCCTATAATTCAGCACTTTGGGAGGCTGAGGCAGGAGGATGGCTGGAGGCCAAGAGTTCGGGACCAGCCTGGGCAACATAGCGAGACTCCATTGTTTCAAAAAAAATTTGTTTTTTTTAAATAGCTTGGCGTAGTGGCGCTCCAGCTACTCGGGGAGCTCGGTGGGAGGATGGCTTGAGCTCAGGAGTTTGAGGTTACACTGAGCTATGATTGTACCGCTTCACTCTAGCCTGGGTGACAGAGTGAGACCCCGTCTCTAAAAA","GGCTGGGCATGGTGGCCCACACCTATAATTCAGCACTTTGGGAGGTGGGACGGCTTGAGGCCAGGAGTTCAGGACCAGCCTGGGCAACATAGCAAGACTCCATTGTTTCAAAAGAAAAAATTGTTTTTTTTAAATAGCTGGGTGTAGTGGCACTCCAGCTACTTGGGAGGCTAGGTAGGAGGATGGCTGGAGCTCAGGAGTTTGAGGTTACACTGAGCTATGACTGTGCCACTTCACTCTAGCCTGGGTGACAGAGTGAGAGCCTGTCTCTAAAAA"
"chr1","10528087","10528344","chr1","9789874","9790151","38","738213","GGCCAGGTGCCGTGGTTCATGTCTGTAATTCCAATGCTTTGGGAAGGCAAGGCAGAAGGATGACTTGAGGCCGAGAGTTTGAGACCAGCCTGGGAAACACAGTGAGACCCTGTCTCTACAAAAAAATTCACCAGGTGTGGTGGCACGTGCCTGTAGTCCCAGCTACTCGGGAGGCTAAGGCAGAAGGATCGCTTGAGCCCAGAAGTTCAAGGCTTCAGTGAGCTATGATCATGCCATTACATTCCAGCCTAGGCAATA","GGCCAGGTGCTGTGGTTCATGTCTGTAATTCCAATGCTTTGGGCAGGCAAGGCAGGAGGATGACTTGAGGCCAAGAGTTTGAGACCAGCCTGGGCAACGCAGTGAGACCCTGTCTCTACAAAAAAATTTAAAAAATTTTTTTAAAATTAACCAGGTGTCATGGCATGTACCTGTAGTTCCAGCTACTTGGGTGGCTAAGGCAGAAGGATCGCTTGAGCCCAGAAGTTCAAGGCTTCAGTGAGCTATGATCATGCCACTACATTCTGGCCTAGGCGATA"
"chr1","10530199","10530489","chr10","31869665","31869954","55","21339466","GGCTGGGTGTGGTGGCTCAAGCCTGTAATCCCAACACTTTGGGAGACTGAGACAGAAGGATTGCTTTAGATGGAAGGGTTGAGACCAGCCTAGACAACACAGTGAGATCCTGTCTCTACAAAAAAAATTAAAAATTAGCTGGGCGTGGTGGTGCATGCCTGTGGTTCCAGCTACTTGAGAGGCTAAGGCAGGAGGATTGCTTGAGCCTTGGAGTTTGAGCTTACAGGGAGCTATGATTGTGCCACTGCACTGTAGCCTGGGTGACAGAGCAAGACACCGTCTCAAAAAAAA","GGCCAGGTGTGGTAGCTCATGCCTGTAATCTCAGCACTCTGGGAGGCCGAGGCAGAAGGATCACTTGAGGTCAGGAGTTCAAGACCAGCCTAGACAACATAGTGAGACCCTGACTCTACAAAAAATTTAAAAATTAGCTGGGCGTGGTGGTGCACACCTGTAGTCCCAGCTACTAGGGAGGCTGAGATGGAAGGATTTCTTGCATCTAAGAGGTTGAGGCTTCAGTGATGTGTGACTGTGCCACTGTACTGTAGCCTGGGCCACAGAGTAAGACTCCGTCTCAAAAAAAA"
"chr1","10549739","10549941","chr1","9812291","9812493","14","737448","CTGAGTGCAATGGCTTGAGCCTGTAATCCCAGCTACTTGGGAGGCTGAGGCAGGAGGATTGCTTGAGGCTAGGAGTTTGAGACCAGCCTGGGCGGCCTCATTGCTACAAAAAACACAAAATTAGATGGGTGTGGTAAGCACATGCCTGTAGTCCCAGCTACTTGGGAGGCTGAGGTGGGAAGATCTCTTAAGCCCAGGAGTTC","CTGGGTGCGATGGCTTGAGCCTGTAATCCCAGCTACTTGGGAGGCTGAGGCAGGAGGATTGCTTGAGGCTAGGAGTTTGAGACCAGCCTGGGCAACCTCATCTCTACATAAAATACAAAAATTAGATGGGCGTGGTAGCACACGCCTGTAGTCCCAGCTACTCCGGAGGCTGAGGTGGGAAGATCTCTTAAGCCCAGGAGTTC"
"chr1","10558761","10559028","chr1","9822420","9822684","33","736341","GGCCGGGTGTGGTGGCTCACACTAGTGATCCCAGAGCTTAGGGGGCTGAGGCAGGAGGATGGCTTGAGGCCAGGAGTTCGAGACCAGCCTGGGCAACATGGTGAGACCCCCATCTGAAAAAATTCGTAAAAGATAAACCAGGTATGGTGGTGTGCACTTGTAGTCCCAGCTGCTCAGGAGGCTGATGTGGGAGGGTAGCTTGAGCTGCACTCCTAGACAACAGAGCAAGAACCCGTCTCTAACAAAAAAAAAAAAAAAGGAAAGAAAA","GGCTGGGTGTGGTGGCTCACACTAGTGATCCCAGAGCTTAGGGGGCCGAGGCAGGAGGATGGCTTGAGGCCAGGAGTTCGAGACCAGCCTGGACAACATGGTGAGACCCCCCCCACCTCAACAAAAAAATTGTAAGAGATGAACCAGGCATGGTGGTGTGCACCTGTAGTCCCAGCATGTTCAGGAGGCTGATGTGGGAGGATAGCTTGAGCTGTACTCCTAGACAACAGAGCAAGAACCTGTCTCCAAAAATAAAAAAAGGAAA"
"chr1","10587888","10588166","chr1","9852624","9852906","20","735264","CGCCTGTAATCCCAACTCTTTGAGAGGCCGAGACAGGAGGAGCACTTTGAAGCTAGGAGTTCAAGACCAGCCTGGGCAACATAGTGAGATGCCATCTCTGTAAAAAAATTTAAAAAACAAAACTAGCCAGGCATGGTGGTGTGTGTACTTGGGAGGCTGAGGTGGGAGGATTGCTTGAGCCCAGGAGATCGAGTCTGCAGTGAACCATGATTGTACCCCTGCACTCCAGCCTGGGCTCCAGAGCAAGGCCCTGCCTCTAAAAAACCAAAAAGAAAGAAA","CGCCTGTAATCCCAAATCTTTGGGAGTCCGAGACGGGAGGAGCACTTTGAAGCTAGGAGTTCAAGACCAGCCTGGGCAACATAGTGAGATGCCATCTCTTTAAAAAAATTTAAAAACCAAAACTAGCCAGGCATGGTGGTGCATGTACTTAGGAGGCTGAGGTGGGAGGATTGCTTGAGCCCAGGAGGTTGAGTCCGCAGTGAACCATGATTGTACCACTGCACTCCAGCCTGGGCGCCAGAGCAAGACCCTGTCTCTAAAAAACCAAAACGAAAGAAAGAAA"
"chr1","10722969","10723276","chr1","9989186","9989491","37","733783","GGGCACAATCACTCATGCCTGTAATCCCAGCACTTTGGGATGCCAAGGCGGGTGGATTGCTTGATGCCAGGAGTTCAAGACCAGCCTGGGCAATACAGTGAGACCCTGTGTCTCCACAAAAAAATTTTTTTTAATTAGCTGGTTGGGGTGGCGCATACCTGTAGTTCCGGCTCCTTGGGAGGCTAAAGTGGGAGGAATCCTTGAGCCCAGGAGGTGGAGGCTTCAGTGAGCTATGATCGCTTCACTGCACTCCAGCCTGGGCGACAGGGTGAGACCCTGTCTGGAACAAAAAAGAAAAAGAAAAAAAA","GGGCACAATGGCTCATACCTGTCATCCCAGAACTTTGGGATGCCAAGGTGGGTGGATTGCTTGAGGTCAGGCGTTTAAGACCAGCCTGGGCAACACAGTGAGACCCTGTGTCTCCACAAAAAAAAATTTTTTTTTTTAAATTAGCTGGACGGGGTGGTGCACACCTGTAGTTCTGGCTCCTTGGGAGGCTAAAGTGAGAGGATCACTTGAGCCCAGGAGGTGGAGGCTGCAGTGAGCTATGATCGCTCCACTGCACTCCAGCCTGGGTGACAGGGTGAGACCCTGTCTGAAAAAAGAAAAAAAGAA"
"chr1","10732199","10732501","chr1","9998082","9998388","29","734117","GGCTGGGCACGGTGGCTCACGCCTGTAATCCCAGCGTTTTGGAAGGCTGAGGCGAGAATCGCTTGACGCCAGGGGTTCAAGACTCCCATCTCTTAAAAAAAAATTAAAAATAAAAATTAGCCAGGTGTGGTGGCGCACGCACCTGTAGTCCTACCTATTTGGGAGGGGAGGCTGAGGTGGGAGGATCACTGGAGCCCAGGAGGTTGAGGCTGTAGTGAGCTGTGATCGCACCACTGCACCCCAGCCTTGGCAGCAGAGCAAGACCCTGTCTCTTAAAAAGTAGAAGAAGAAAAGAAAAGAAAA","GGCTGGGCACGGTAACTCACGCCTGTAATCCCAGCATTTTGGAAGGCTGAGGTGAGAATCGCTTGATGCCAGGGGTTCAAGACTCCCATCTCTTAAAAAAAAAAAGTTAAAAAATAAAAGTTAGCCAGGTGTGGTGGTGCACGCACCTGTAGTCCTGGCTATTTGGGAGGGGAGGCTGAAGTGGGAGAATCACTTGAGCCCCGGAGGTTGAGGCTGTAGTGAGCTGTGATTACACCACTGTACCCCAGCCTTGGCAGCAGAACAAGATCCTCTCTCTTTAACAATTAGAAGAAAAAAAAAAGAAAAA"
"chr1","10803895","10804195","chr1","10069591","10069890","27","734304","GGTCGGGCATGGTGGCTCACACCTGATTTCCAGCAATTTAGGAGGCCGAGGCGGGGAGAGTGCTTGAGACCAGGAGTTCAAGACCAGCCTGGGCAACATGGTGAGACCCCATCTCTACAAAAAAATTTTTAAAAATTAGCCAGGTGTGGTGGCAAGCACCTGTGGTCCCAGCTACAAGGGAGGCTGAGCCAGGAATCACTTGAGTCCAGGAGGTTGAGGCCGCAGTGAGCTGTGTTCACACCACTGCACTCCAGCTTGGGAGACAGAGTGAGACCTTGTCTCTAAAAAAAAACAAACAAAA","GGTCAGGCGTGGTGGCTCACACCCGACTTCCGGCACTTTAGGAAGCCAAGGCAGGGAGAGTGCTTGAGACCAGGAGTTCAAGACCAGCCTGGGCAACATGGTGAGATGCCATCTCTACAAAAAACTTTTAAAAATTAGCCAGGTGTGGTGGCACGCTCCTGTGGTCCCAGCTATAAGGGAGGTTGAGGCAGGAGGATCACTTGAGTCCAGGAGGTCGAGGCTGCAGTGAGCTGTGTTCACACCACTGCACTCCAGCTTGGGAGACAGAGTGAGACCTTGTCTCTAAAAAAAGAGAGAAAA"
"chr1","10825122","10825450","chr1","10090882","10091206","27","734240","CTGGGCATAGTACCTCACATCTGTAATCCCAGCACGTTGGGAGGCCAAAGTGGGAGGATCACTCAGGTCCAGGAGTTTGAGACCAGCCCAGGTAACAGAGTGAGACCTCGTCTCTACAAAAAAAAATTTAAAAACTAGCTGGGCATGGTGGTGCATGCCTGTAGTTCCAGCTACTCAGGAGGCTGAGGCGGGAGGATCCCTTGAGCCCAAGAGGCTAAGACTGCAGTGAGCTATGATTTCGCCATTACACTCCTGCCTGGGTGACAGAGTGCAACCATGTCTCAGTAAATAAATAAATAAATAAATAAATAAATAAATAAATAAATAAA","CTGGGCGTAGTACCCCACATCTGTAATCCCAGCACTTTGGGAGGCCAACATGGAAGGATCACTCGGGTCCAGGAGTTTGAGACCAGCCCGGCTAACACAGTGAGACCTCATCTCTACAAAAAAATTTTTAAAAACTAGCTGGGCATGGTGGTGCATGCCTGTAGTTCCAGCTACTCAGGAGGCTGAGGCGGGAGGATCCCTTGAGCCCAAGAGGCTGAGACTGCAATGAGCTACGATTTTGCCATTACACTCCTCTCTGGGTTACAGAGTGTGACCCTGTCTCAATAAATAAATAAATAAATAAATAAATAAATAAATAAATAAA"
"chr1","10826925","10827127","chr7","53643903","53644105","47","42816978","TCGTGACCAGCCTGGGCAACACAGAGAGACCTGGTCTCTACAAAATAACAAACAAGAAATTAGCTGGGCATGGTGGCATGCACCTGTAGTCCCCATTAATAGGGAGGCTGAAGTGGGAGGTTGAGGCTGCAGTGAGCTGTGATCATGCCACTGCACTCCAGCCTGAATGACAGAGTGAGATTCAGTTTCAAAAAAAAAAAAGA","GACCAGCCTGGGCAACATAGGGAGACCCCATCTCTACAAAAAAATTTTAAACATTAGCTGGGCATGGTGTTGCACACCTGTGGTCCCAACTACTAGGGAGGCTGAGGTGGGAGGGCTGGCTGAGGCTGTAGTGAGCTGTGATCACACCACTGCACTCCAGTCTGGGTGACAAAGTGAGACCCTGTCTTCAAATAAATAAGGAA"
"chr1","10868709","10869000","chr1","10135340","10135635","21","733369","GCTGGGTGCAGTGACTCATGCCTGTAATCCCAGCACTTTGGGAGGCTGAGGCAGGAGGATCATTTGAGGTCAGGAGTTCAAGACCAGCCTGGACAACATAGCAAGACTCAGTCTCTACGGAAAATGCAGAAGTTAGCTGGGTGTCATGGTGTGCGCCTGTAATCCCAGCTACTTGGGAAGCTGAGATGGGAGGATCGCTAGAGGCCAAGAGTTGGAGGCTGCAGTGAGCTATGATCACACCACTGCACCCTAGCCTAGGCAAGAGAATGAAACCCTGTCTCAAAAATAATAA","GCTGGGTAAAGTGACTCACGCCTGTAATCCCAGCACTTTGGGAGGCTGAGGCAGGAGGATCATTTGAGGCCAGGAGTTAAAGACCAGCCTGGACAACATAGCAAGACTCAGTCTCTACAGAAAATGCAAAAGTTAACTGGGTGTCATGGTGTGCACCTGTAGTCCCAGCTACTTGGGAAGCTGAGATGAGAGGATCGCTTGAGGCCAAGAGTTGGAGGCTGCAATGAGCTATGATCATACCACTGCACCCCAGCCTAGGCAAGAGAATGAGACCTTGTCTCAATAATAATAATAAA"
"chr1","10905780","10906064","chr1","10172167","10172453","24","733613","GTGGCTCATCCCTGTAATCCCAGTGCTTTGGGAGACCAAGGCAGAAGGATCGCTTGAGGGCAGGAGTTTGAGACCAGCCTGGGCAACACCCTGTCTCTACAAAAAATAAAAATAAAATAAAATTAGGCATGGTGGTGTGTGCCTGTAGTCCTAGCTACTCGTGAGGCTGAGGTGGGAGGATCACTTGGGCCCAGGAGTTCAAGGCTGCAGTGAGCCATGATTGTGCCATTGCACTCCAGCCTGAGTTACAGAACAAGAGCCTGACTCTAAAAAAAAAAAAAAGAA","GTGGCTCATCCCTGTAATCCCAGGGCTTTGGGACACCAAGGCAGAAGGATCACTTGAGGGCAGGAGTTTGAGACCAGCCTGGGCAACATAGCAAGACCCTGTCTCTACAAAAAATAAAAATAAAATAAAATTAGGCATGGTGGTGTGTGCCTGTAGTCCTAGCAACTCATGAGGCTGAGGTGGGAGGATCGCTTGGGCCCAGGAGTGCAAGGCTGCAGTGAGCCATGATTGTGCCACTGCACTCCAGCCTGATTTACAGAACAAGAGCCTGACTCTAAAGAAAAGAA"
"chr1","10913227","10913351","chr1","10178461","10178583","9","734766","GGCCAGACAGGGTGGCTCATATCTATAATCCCAACACGTTGGGAGACTGAAGCAGGAGGATCCCTTGAGACCAGGAATTTGAGACTAGCCTGGGCAACATAGTAAGACCCTGTTACCACAAAACA","GGCCAGACAGGGTGGCTCATATCTGTAATCCCAACACATTGGGAGACTGAAGCAGGAGGATCCCTTGAGACTGGGAATTTGAGACTAGCCTGGGTAGCATAGTAAGACCTTGTTACCACAAAA"
"chr1","10913650","10913828","chr20","23185454","23185631","39","12271804","TACAAAACACTTTTAAAAATTAGCTCGACATGGTAGCACATGCCTGTAGTCCCAGCTACTTGGGAGGTTAAGGGCAGGAGGATCGCTTGAGCCCAGAAGTTCGAGACTGAAGTCAGCTGTGATAACGTCACTGCACCTCAGCCTGAGTGACAGAATGAGACTCTCTTCAAAAAAAAAAA","TACAAAAAATATTTTTTAAACTAGCTGGGCACGGTGGCACATGCCTGTAGTCCCAGCTACTCAGGAGGCTGTGGCAGGAGGATCACTTGAGCTCTGGAGGTCGAGGCTGCAGTGAGCTGTGATCACACCACGGTACTTCAGCCTGGGTGACAGAGCAAGATCCTGTCTCAAAAAAAAA"
"chr1","10915222","10915349","chr7","121189198","121189333","27","110273976","GGGTGCAGTGGTTTAGGCCTGTAATCCCAGCACCTGGGGAGGCTGAGACAGGAGGATCGCTTGAGGCCAGAAGTTTGAGACCTGGGCAATCTAGTGAGACCCTGTCTCTACCAAAAATAAAGAGGTTA","GGCTAGGTATGGTGGCTTATGCCTGTAATCCCAGCACTTTGGGAGGCCGAGGAAGGAGGATTGCTTGAGGCCAGAAGTTCGAGAACAACCTGGGCAACATAGTGAGACCCTGTCTCTACAAAAAATACAAAAATGA"
"chr1","10926446","10926739","chr1","10191794","10192082","29","734652","GGCTGGGCACAGTGGTTCATGCCTTCCGGCACGTTAGGAGGCTGAGGTGGTAGGAGCCCAGGAGCTGGAGACCAGCTTGGGCAGCAGAGCGAGACCTTGTGTCTACAGAAAGAACTTTTTAAAGCTAGCCAAGTGTGGTGGGGCGTGCCTGTACTCCCAGCTACTAGGGAGGCTGAGATGGGAAAATCACCTGACCCCAGGAGGTCGAGGCTGCGGTGAGCTATGATTGCACCACTGCACTCCAACCTGGGCAACAGAGCAGGATCTTACCTCAAAAACAAAACCAAAAACAAA","GGCTGGACACAGTAGTTCACGCCTTCTAGCGCATTAGGAGGCTGAGGTGGGAGGAGCCCAGGAGCTGGAGACCAGCTTGGGCAGCAGAGCAAGACCTCGTGTCTACCAAAAAAAATTTTTTAAAGCTAGCCAGGTGTGGTGGAGCATGCCTGTACTCCCAGCTACTAGGGAGGCTGAGGTGGGAAAATCACATGAGCCCAGAAGGTCGAGGCTGCAGTGAGCTATGATTGCACCACTGCACTCCAGCCTGGGCAACAGAGCAGGATCTTACCTCAAAAACAAAAACAAA"
"chr1","10945924","10946153","chr1","213911110","213911337","40","202965186","GGCCAGGCGTAGTGGCCCACGCCTATAATCCCAGGGCTTTGAGAGGCCAAGGTGAGAGGATCGCTTGAAGCCAGGAGTTTGAGACCAGCCTGGGCAACACAGTGAGACGCCGTCTCTACAAAAAATTTGAACATTAGCTGGGCATGGTGTCATATGCCTATAGTCCCAGCTACTTGGGAGGCTGAAGTGGGAGGATCCCTTAAGCTCAGGAGGTCAAGGCTGCAGTGAGC","GGCTGGGCGTGGTGGCTCACACTTGTAATCCCAGCACTTTGGGAGGCTAAGGTGGGAGGACTGCTTAAGCCTCGGAGTTTGAGACCAGCCTGGGCAACATAGTGAGAGACTGTCTCTATGAAAAATTTTAAAATTAGCTGGGCATGGTGCACATGCGTGTAGTCCCAGCTACTCAGGGGGCTGAGGTGGGAGGATGGCTTGAGCCCAGGAGGTTGAGGCTGCAGTGAG"
"chr1","10962646","10962945","chr1","10223429","10223722","23","739217","GCTGGGTATGGTGGCTTACGCCTATAATCCCAACACTTTGGGAGACTGAGGCAGGAGGATCACTTGAGCCCAGGAGTTTGAGACCAGCCTGGGCAGCATAGCAAGACTTGATGTCTACAAAAAAATTTTAAAATTAACTTGGTGTGGTGGCATGCGCTTGTGGTCCCAGCTACTCAGGAGGCTGAGGTGGGAGGATTGCTTGAGCCTGGGAGGTCTAGGATGCAATGAGCAATGATTGTCCCACTGCACTCCAGCCTGGGTAACAAAGCGAGACCCTGTCTCAAAATAAAAAAAAAAAGA","CTGGGCATGGTGGCTTACGCCTATAATCCCAACACTTTGGGAGACTGAGGCAGGAGAATCACTTGAGCCCAGGAGTTTGAGACCAGCCTGGGCAACACAGCAAGACTCGATGTCTACAAAAAAATTTTAAAATTAACCTGGCGTGGTGGCACGCGCTGTGGTCCCAGTTACTCAGGAGGCTGAGGTGGGAGGATTGCTTGCACCTGGGAGGTCTAGGCTGTGAGCAATGATCATGCCAATGCACTCCAGCCTGGGTAACAAAGCGAGACCCTGTCTCAAAAAAAAAAAAAAAAA"
"chr1","10965384","10965675","chr3","165868043","165868332","54","154902659","GGCCAAGTGCAGTGAGTCATGCCCATAATCCCAATACTTTGGGAGGCCGAGACAGGAGGATGGCTTGAACCCAGGAGTTTAAGACCAGCCTGGGCAACACAGTAAGACCCTGTCTCTACAAAAAAATTTAAAAATTACCAAAGTGTGGTGGCACATGCCTATGGTCCCAGCTACTCAGGAGGCTAAAGTGGGATGATCACTTGAGCCCAGGAGTTAAGAGATGACAGTGAACTATGATCTTGCCACTGCACTCCAGCCTGGGCAACAGAGCAAGACTCTATCTCAGGAAGAA","GGCCAAGCGCAGTGGCTCACATCTGTAATCCCAGCACATTGGTAGGCCAAGGCAGGAGGATCACTTGAGACCAGCAGTTCCAGACCAGCCTGGGCAACATAGCAAGACACCATCTCTAAAAAAAATTTTAAAAATTACCCGAGTGTGGTGGCACTGCCTGTGGTCCCAGCTACTCAGGAGGCTGAGGTGGGAGGATTGCTTGAGCCCAGGAGTCGAGGCTGCAGTGAGCTATGACTGTGCCACTGCACTCCAGCCTTGGCAACAGAGCAAGAACTTATTGCTAAAAAAAA"
"chr1","10966685","10966987","chr1","10227902","10228202","16","738783","GGCCAGGCATGGTGGCTCATGCCTGTAACCCCAGCACTTTGGGATGCAGAGATGGGCAGATTGTTTGAGGTCAGGAGTTCGAAACAAGCCAGGGGAACATGGCAAGACCCTGTCTCTACAAAAAATTTAAAAACTAGCTGGGCATGGTGGCACACACCTGTGGTCCTAGCTACTCAGGAGGCTGAGGTGAGAGGATTGCTTGAGCCCAGGAGGTTGAGGCTGCAGTGAGCCCTGATTGTGCTACTGCACTCCAGCCTGGGCAACAGAACAAGACCCTGTACTAAAAAAAAAAAAAAAAAAAAA","GGCCAGGCCTGGTGGCTCATGCCTGCAACCCCAACACTTTGGGAGGCAGAGGTGGGCAGATCACTCGAGGTCAGGAGTTCGAAACAAGCCAGGGGAACATGGCAAGACCCTGTCTCTACAAAAAATTTAAAAACTAGCTGGGCATGGTGGCACACACCTGTGGTCCTAGCTACTCAGGAGGCTGAGGTGGGAGGATTGCTTGAGCCCAGGAGGTTGAGGCTACAGTGAGCCGTGATTGTGCTACTGTACTCCAGCCTGGGCAACAGAACAAGACCCTGTCTCAAAAAAAAAAAAAAAAAAA"
"chr1","10986276","10986559","chr1","10251940","10252243","34","734336","GGCTGGGTGCAGTGGCTTATGCCTATAATCCTAGCACTTTGGAAGCTGAGGCAGGTAGATTGCTAGAGCCCAGGAGTTCAAGACCAGCCTGTACAACATAGGGAGACCCCATCTCTACAAAAAATTTAAAAACTAGCCAGATGTGGTGGTGCACACCTGTAGTCCCAGCTACTTGGGAGGCTGAGGTGGGAGAATCAGTTGAGCCGGGAGGCGAAGGTTGCAGTGAGCCAAGATCATGCCACTGCACTCCAGCCTAGGAGACAGAGTGAGACCCTGTCTCAAAA","GGCTGGTTGCAGTGGCTTATGCCTATAATCGTAGCACTTTGGAAGCTGAGGCAGGTGGATTGCTAGAGCCCAGGAGTTCAACACCAGCCTGCACAACATAGGGAGACCCCATCTCTACAAAAAATTTAAAAATTAGCCAGATGTGGTGGTACACACCTGTAGTCCCAGCTACTTGGGAGGCTGAGGTGGGAGAATCAGTTGAGCCAGGAGGGGAAGGTTGCAGTCAGTGAGCCGAGATTGTGCCATTGCACTCCAGCCTAGGAGGCAGAGTGAGACCCTGTCTCACAAAGAAAAAAAAAAATAA"
"chr1","10986737","10987033","chr2","109967146","109967434","69","98980409","TGACTCATGCCAGTAATCCCAGCACATTGGGAGGCCGAGACGGGAGGATCGCTTAGGGCCAAGAACATGAGACCAGTCTGGGCAACGTAGGAAGACCCCGTCTCTACAAAAAATTTTAAAATAAAAAAAATTAGCCAGACATGGTGGTGCACTTGTAGCCCCAGCTACTCTGGAAGATGAGGCAGAAGGATCGCTTCAGCCCAGGAGGCCAAGGCTGTGGTAAGCCATGATCGCACCACTGCACTCCAGGGTGGGCGACAGAGTGAGACCCTATCCCTAAAAAAATAAAAATAAAAA","TGGCTCACATCTGTAATCCTAGCACTTTGGGAAGCCAAGACAGGAGGATCACTTGAGGCTAGGAGTTCAAACCAGCCTGGACAACATAGTGAGACCCTGTCTCTACAAAAAATTTTTAAAGATTAGCCAGGTGTGGTGTTCACCTGTAATCCCAGTTACTAGGGAGGCTGAGGTGAGAGGATCACTTGAGCTCAAGAGGTCAAGGCTGCAGTGAACCATGATCACACAACTGCACTCCAGCCTGGGTGACAGAGTGAGACCCTGTCTCTAAAAAAAAAAAAAAAAAAAA"
"chr1","11004822","11005153","chr19","46066584","46066890","82","35061762","GGCTGGGCATGGTGGCTCATGCCTGTAATCCTAGCGCTTTGGGAGGCCAAGGTGGGAGGACTGTGTGAGGCCAAGAGTTCAAGACTAGCCTGGCAGCCTGGACAACACAGGGAGACCCCACCTCTATCCAAAAAAACCACAAAAAAGCCACATTAGCTGGGCGTAGTGGCATGCATCTGTCCTAGCTACTTGGGAGGCTGAAGCTGGAGGATCCTCCCTCTGGAGGCTGAGCCCAGGAGTTCTAGGGTGTAGTGAGCTATGATTACACCACTGTGTTCCACCAGCCTGGGCAACAGAGTGAGACCCTGTCTCAAAATAATAATTAAAAAAAA","GGCTGGGTGTGGTGACTCATGCCTGTAATCCCAACACTTTGGGAGACTGAGGTGGGAGGACTGTTTGAGTCTAGGAGTTCAAGACCAGCATGGGAAAGATAGTGAGATCCCATCTCTACCAAAAAAAAAAAAATTATTTTAATTAGCTGGGCACGGTGGTAAGCACCTGTAGTCTTAGGTACTTGGGAGGCTGAAGTTGGAGGATCCTTTGAGCTCAGGAGTTTGAGGCTGCAGTGAGCTATGATTGTGCCACTGCACTCCAGCCTGGGCAAGAGAGTGAGACTCTGTCTCAAAAAATATAAATAAA"
"chr1","11013912","11014070","chr1","10283447","10283604","14","730465","AGCACCTTTGGGAGGCTGAGGCGGGCAAATCCCTTGAGCTCAGGAGTTTGAGACCAGCCTGGGCAACATGGCAAGACCCCCTCTCTACGAAAGGTTAAAAAGCCAAGCATGGTGGCACGTGCCTGTTGTCCCAATTACTTGAGAGGCTGAGGTGGGAGG","AGCACCTTTGGGAGACTGAGGCAGGCAAATCCCTTGAGCCCAGGAGTTTGAGACCAGCCTGGGCAACACGGCAAGACCCCCTCTCTACAAGAGATTAAAAAGTCGAGCATGGTGGCACGTGCCTTTTGTCCCAATTATTGGGAGGCTGAGGGGGAAGG"
"chr1","11032560","11032852","chr1","10318942","10319239","22","713618","GGCTGGATGTAGTGACTCCTGCCTGTAATCCCAGGAGGCTGGGAGGCTGAGGCAGGTGGGTCGCCTGAGACCGGGAGTTCAAGACCAGCTTGGGCAACATAGCAAGACCTTGTCTCTAAAAAAAAATTTTTTTAAATTAGCCAGGCATGGTGGCATGCACCTTTAGTCCCAGCTACTCGGCAGGCTGAGATGGGACGATCGCTTGAGCCCAGGAGGTCTCAAGGTTGCAGTGAGCCATGTTCATGCCATTGAACTCCAGCCTGGGTGACAGAGTAAGATTTTGTCTCAAAAAA","GGCTGGGTGTAGTGACTCCTGCCTGTAATCCCAGGAGGCTGGGAGGCTGAGGCAGGTGGGTTGCCTGAGACCAGGAGTTCAAGACCAGCCTGGGCAACATAGCAAGACCTTGCCTCTAAAAAAATTTTTTTTTTTTTTAAATTAGCCAGGCACGGTGGCATGCACCTTTAGTCCTAGCTACTTGGCAGGCTGAGGTGGGAGGATCGCTTGAACCCAGGAGGTCTCAAGCTTGCAGAGAGCCATGTTCATGCCATTGAACTCCAGCCTGGATGACAGAGTAAGATTTTGTCTCCAAAAA"
"chr1","11040380","11040662","chr1","10328262","10328555","35","712118","GGCCAGGTGTGGTGGCTCACAGCTGTAATCCTAGCACTTTTGGAGGCCGAGGTGGGAGGATCGAGGAGTTCGAGGCAACATAGGGAGACTCTATCTCTACCAAAAATGTAAAAAGTAGCCAAGTATGATTGAACACACTTGTCCCAGCTACTCAGGAGGCTGATGGGGGAGGATCACCTGAGCCCTGGAGGCCGAGGGTGCAGTGAGCCATGATCGATGCCACTGCACTCCAGCCTGGGCCACAAAGTGAGACCCTGTCTCAAAAAAATAATAATAAAAAAAA","GGCCAGCTGTGGAGGCTCACAACTGTAATCCTAGCGCTTTTCGGAGGCCGAGGTGGGAGGATCCCTCGAGCCTAGGAGTTCGAGGCAACATAGGGAGACTCCATCTCTACCAAAAATTTAAAAAGTAGCCGAGCATGATGGAACACACTCGAAGTCCCAGCTACTCAGGAGGCTGAGGTGGGAGGATCACCTGAGCCCTGGAGGCCGAAGGTGCAGTGAGCCATGATCCATGCCACTGTACTCCAGCCTAGGCCACAGAGTGAGATCCTGTCTCAAAAAAAAAAAAAAGAAAAA"
"chr1","11049995","11050245","chr10","25956813","25957066","59","14906818","GCTGGGTGTGGTGGCTCATGCCTGAAATCCCAACACTGGCAGGACAAGACAGGAGGATTGCTTGAGGCCAGGAGTTCAAGACCAGCCTGGGCAACACAGCAAAAACCCATCTCTATAAAACATAAGAAAAATTACCCAGGTGTGGTGGCACGTGCCTGGGAGGTCAAGGCTGCAGTGAGCTAGGATCACACTACTGCACTCCAGAATGGGCAACAGAGTGAGACCCTGTCTCAAAAAAAGGAAAAAAAAGA","GGCCAGGTGCGGTGGCTCACGCTTGTAATCCCAGCACTTTGGGAGGCAGAGGTGGGAGGGTTGCTTGAGGCTAGGAGTTCAAGACCAGCCTGGGTAACATAGCAAAATCCCATCACTACAAAAAATTTTAAAAATCAGCTAGGTGTGGTGGCTTAAGCCTACGAGTTCAAGACTGCTGTGAGCTATGATTTTGCCACTGCACTCCAGCCTGGCTGGCAGAGTGAGATCCTGTCTCAATGAAATACAAAATAAAA"
"chr1","11053677","11054006","chr1","10342346","10342618","72","711331","GGCCAGGTGCAGTGGCTCATGCCTATAATTCCAGTGCTTTGGGCGGCCTAGGTGGGAGGACTGCTTTAGGCAGTCTGAGACCAGCCTGGGCAACATAGCAAGACCCCTATCTCTACAAAAAAAAAGAAACAAATGTAGCTGGGCATGGTGGTGCGTGATTGTAGTCCTAGCTACTTGGGAGGCTGAGGTGGGAGGATCACTTGAACCCAGGAGTACAAGGCTGCAATGAGCTATAATCGCACCACTGTACTCCAGCCTGGGCATCAGGGTAAGAGTAAGACCATGTCACTATTTTTCTTTTTAAAAGGAAATTAAAAAAAAAAAGGAAAA","GGCCAGGTGCAGTGGTCATGCCTATAATTCCAGTGCTTTGGGTGGCCAAGGTGGGAGGACTTCTTTAGGCAGTCTGAGACCAGCCTGGGCAACATAGCAAGACCTCTATCTCTACAGAAAAATGAAACAAAATGTAGCCGGGCATGGTGGTGCGTGCTTGTAGTCCTAGCTACTTGGGAGGCTGAGGTGGGAGGATCGTTTGAGCCCAGGAGTACAAGGCTGCTATGAGCTATAATCGCACCACTGTACTTCAGCCTGGGCATCAGGGTAAGA"
"chr1","11054024","11054254","chr11","75916398","75916624","55","64862374","AAGAATTCGAGTGATAGCCTGGGCAATATAGTGAGACCCCATCTCCACCAAAAACAATAACAAAAAATAGCTGGGAATGGTGGTGTGTGCCTGTGGTCTAGCTACTTGGGTGGTTGAGGAGGGAGGATCGTTTGAGCCCAAGAGTTTGAGGCTGCAGTGAGCTGCAACTGTGCCACTGCACTCCAGCCTGTGCAACAGAGGTAGACACTACTTCAAAAAAAAAAAAAAAGA","CAAGAATTCAAAATAAGCGTGGGCAACCCAGGGAGACCCCATCTCTACAAAAAAATAAAAAATTAGCCAGGCATGGTGATGCATGCCTGTGGGCCCAGCTACTTGGGAGGCTGAGGTGGGAGGACTGTTTTGAGTCTGAGAGCTCAAGGCTGCAGTGAGCTGTGATCATGCCACTGTACTCCAGCCTGGGTGACAGGGTGACCTTTCTCTCAAAAAGAAAAAAAAAA"
"chr1","11061724","11062014","chr3","165939533","165939833","58","154877809","GGTGGCTCACAACTGTAATTCCAGCACTTTGGGAGGCCGAGGTGGGAGGACTGCTTGAGCCCACGGGTTCAAGACCAGTCTGGGAAACACAGCAAGACCCATCTCTACAAAAATTTAAAAAACATAGGTGGGTATGGTGGTGTATGCCTGCGGTCCCAGCTGCTCAGGAGGCTAAGGTGGGAGCCTAGCAGATGGAGGCTACAGTGAGCCATGATTGCACCACTGCACTCCAGCCTGGGTGACAGAGCAAGACCCTGTCTCAAAACAACAACAACAACAAAAACAAAAGAA","GCTGGGAGGGGTGGATCATGCCTGTAATCTCAGTGCTTTGGGAGGCTGAGGTGGGAGGACTGCTTGAGGCCAGGAGTTCAAGACCAGCCTGGGCAACACAGTAAGAACCCATCTCTACAAACAATTAAAAAAATAAGCGAGGTATGGTGGTGTGTGCCTGTAGTCCCAGCTGTTTGGGAGGCTGAGGTGGGAGCCCAGGAGTTTGAGGCTGCGGGGAGCTATGATCACACCACTGCACTCCAGCCTGGGTGACAGAGTGAGACCCTGTCTCAAAAAAAAAAAAAAAAAGAAAAGAAAAAAA"
"chr1","11072351","11072656","chr1","10358392","10358708","30","713959","GGCTGAGCACGGTGGCACATGCTTGTAATCCCAGAACTCTGGAAAGTCGAGGCAGGAGGACTGCTTGAGGCCAGGAGTTTCAGGCAGCCTGGGCAACACAGAAAGACCCTGTGTTTACAAAAATAAAAACTAAAATTAAAAAACAAGCCAGGTACAGTGATGTGTGCCTGTAGTCCCAGCTACTAGGGAGGCTGAGGCAGGGGGATTGCTTGAGCCCCAGGGTTCAAGGCTACAGTGAGCTATGATTGCACTACGGCACCCAGCCTGGGTGACAGAGCAAAACTAAAAAAAAAAAAAAAAGAAAAA","GGCTGAGCACGGTGGCTCACGCCTGTAATCCCAGAACTTTGGAAGGTCAAGGCAGGAGGATTGCTTGAGGCCAGGAGTTTGAGGCCAGCCTGGGCAATGCAGAAAGACCCTGTGTTTACAAAAATAAAAACTAAAATTAAAAAACAAGTCAGGTACCAGGTACGGTGATGTGTGCCTGTAGTACCAGTTACTAGGGAGGCTGAGGTAGGGGGATTGCTTGAGCCCCAGGGGTCAAGGCTACAGTGAGCTAGGATTGCACTATGGCATCCAGCCTGGGTGACAGAGCAAAACTTAAAAAAACAAAAAAACAAAAAAAA"
"chr1","11080274","11080583","chr1","10363537","10363850","22","716737","GTCAGGCACAGTGGCTCATGCCTGTAATCCTAGTGACTAAGGAGGCTGAGGTGGGGGGGGGATTGTTTGAGGCCAGGATTGTTTGAGGAGTTCAAGACCAGCCTGGGCAACACAGCAAGACACTGTCTCTATAAAATAAAAAAAATTTAGCCAGACGTGGTGGTGCACACCTGCAGTCCCAGCTACTTGGGAGGCTGTGGTGGGAGGATCGCTTGAGCCCAGGAGTTCAAGGTTGCAGTGAGCTATGGTTGCACCACTGCACTCCAGCCTGGGTGACAGAGCAAGACTTCAGTATCCAAAAAAATAAAAA","GTCAGGTACGGTGGCTCATGCCTGTAATCCTAGTGACTAAGGAGGCTGAGGTGGGGAGATTGTTTGAGGCCAGGATAGTTTGAGGAGTTCAAGACCAGCCTGGGCAACACAGCAAGACACTGTCTCTATAAAATTAAAAAAAAAATTAGCCAAATGTGGTGGTACACACCTGCAGTCCCAGCTACTTGGGAGGCTCTGGTGGGAGGATCACTTGAGCCCAGGAGTTCGAGGTTGCAGTGAGCTATGGTTGCACCACTGCACTCCAGCCTGGGTGACAGAGCAAGACTTCAGTCTCCAAGAAAATATAAACAGAA"
"chr1","11107955","11108057","chr12","96966182","96966288","20","85858227","GGCTGGGCATGGTGGCTCATGTCTCTAATCCCAGCACTTTAGGAGGCCAAGGCAGGAGGATAGCTTAAGACCAGGCTGGGTGACACAGTGAGACTTTGTCTCT","GGCTGGGTGCAGTGGCTCACGCCTGTAATCCCAGCACTTTGGGAGGCCAAGACAGGAGGATTGCTTTGAGACCAGCCTGGGTAACACAGTGAGACCCTGTCTGTACA"
"chr1","11111612","11111902","chr5","78689579","78689868","64","67577967","GGCCAGGCATGGTGGCTCACATGTAATCCTGACACTTTGGAAGGCTACAGCAGGAGGATTGCTTGAGACCAGGAGTTCAAGACCATTCTGGACAAAAAAGTGAGACCCTGTCTCTACAAAAAATAAAAAATCAGCTGGGCATGGTGGCTCATGCCTGTCGTCCCAGCTCCTTGGGAGATGGAGGCAGAAGAATCATCTTAGCCCAGTTGGTTGAGGCTGCAGTGAGACAAGGTTGTGCCTCTACACTCTAGCCTGGGCAGCAGAGCAAGACCCTTTCTCTCAAAAAATAAA","CAGGCACTGTGGCTCATGCCTGTAATCCCAGCACTTTGGGAAGCCAAGGCAGGAGGATTACTTGAGCCCAGGAGTTTGAGACCAGCCTAGGCAACATAGTGAGACCCCTGTCTCTACAAAAAAAATTAAAAATTAGCTGGGCATTGTGGTGCATGCCTGTAGCCCCAGCTACTTGGGAGACTGAGGTGGGAGGATCACTTGAGCCCAAGAGGTTGAAGCTGCAGTAAGCCATGTCTGTGCCACTGCACTCCAGCCGGGGCAACACAGCAAGACCCTATCTCAAAAATAAA"
"chr1","11112360","11112545","chr12","82277360","82277547","46","71165000","TCTTAACAAAAAACTATAAAATTAGGGAGCCAGGCATGGTAACTCATGCCGGTAGTCCCAGAAACTCCAGAGGTTGAGGCCAGGGGGATGGCTTGAGCCCAGGAGTTCAAGGCTGCAGTGAGCTGTGATTGTGCCACTGCCCTCCAGCCTGGGTAATAGAGCAAGACTGTCTCTTTAGAAGAAAAA","GTCTTTACTAAAAACCAAAAACAATTAGCCAGGCATGGTGGCACGTGCCTATAGTCCCAGCTACTCAGGAGGCTAGGGTGGGAGGATCGCCTGAGCCCAGGAGTTTGAGGCTGCAGTGAGCTTGATTGCGCCACTGTACTCTAGCCTGGGTGATAGAGCAGGACCCTGTCTTTTAAAAAAAAAAAAAA"
"chr1","11121745","11122031","chr8","32542121","32542384","92","21420376","GGCACAGTGGCTCACACCTATAATCCCAGCATTTTGGAAGGCTGTGGAGGGAGGCTGGCTGGAGCACAGGAGTTTGAGACCAGCCTGGGCAACATTAAACTTGTAGGAGGAAATGCAGGCTCTATGCCTGTTCTTTTGTAGAGACCTCATTTCTACAAAAAACTAGCCAGTGTGGTGGCACGTGCCTATAGCTACTTGGGAAACTGAGGTGGGAGGATTGCTTAAGCCCAGGAGATCAAGGCTATACTCTAGCCTGGGTGACACAGCAAGACCATCTCAAAAAAAAA","GGGTGCAGTGGCTCCCAACTCTAATCCCAGCATTTTGGGAAGTTGAGGAGCGAGCATTGCTTCAGTCCAAGAGTTTGAGGCCAGCATGGGCAACATAGTGAGACGCCATCTCTACAAAAAATATTTTTTAAAATTAGCCCAGCATGGTGGTGCCTGCCTGTAGTTCCAGCTATTTGGTGGACTGAGGTGGGAGGATTGCTTGAACCAGAGAGGTCAAGGCTGCACCCCAGCCTGGGTGACAAAGCCAGACCCTGTGTCAAAAAA"
"chr1","11124168","11124458","chr1","10406195","10406485","16","717973","GGTGGTTCACACCTGTAATCCCAGCACTTTGGGAGGCCGTGGTGGGAAGATTGCTTGAGCCCAGGAATTTGAGACCAACCTGGGCAACATAGCAAGACCTCATCTCTACTAAAAATTAAAATTAAAATTAACTGGGCATGGTGGTGTGTGCCTGTAGTTTCAGCTACTGGGAGGCTGAGGTAGGAGGATCACTTGAGCAAAAGTGTTCAAGTCTGCAGTGAGCTATCATTGCACCACTGCACTTCAGCCTGGGTAACAGAGTGAGAGACCCTGTCTCTAAAGGAATAAAAA","GTGGTTCATACCTGTAATCCCAGCACTTTGGGAGGCCATGGTGGGAGGATTGCTTGAGCCCAGGAATTCGAGACCAACCTGGGCAACATAGCAAGACCTCATCTCTACTAAAAATTGAAATTAAAATTAACTGGATGTGGTGGTGTGTGCCTGTAGTTTCAGCTACTGGGAGGCTGAGGTAGGAGGATCACTTGAGGAAAAGTGTTCAAGTCTGCAGTGAGCTATCATTGTACCACTGTACTCCAGCCTGGGTAACACAGTGAGAGACCCTGTCTCTAAAGAAATAAACAA"
"chr1","11141815","11142031","chr1","10422980","10423217","42","718835","CCAAACTTGGCAACATAATGAGACCCTATCCCTACAAAAAATAATTTTAAAAAATGAGCCAGGCATGGTGGTGCATTTCTGTAGTTCCTTCTATTCAGGAGGCTGAGGTGGGAGGATTGCTTGAGTCCAGGAGTTCAAGACCACAGAGAGCTGTGATCACACCACTGTACTCCACTGAGAGACAGATTAAAGTCCTGCCTCTTAAAAAAAAAAAGAA","CCAACCTTTGCAACATGGTGAGACTCTATCTCTACAAAAAATAATTTTAATAATTTAAAAAGTTAGCCAGGCATGGCGGTGCATTTCTGTAGTTCCTTCTACTCAGGAGGCTGACGCGGGAGGATTGCTTGAGTCTAGGAGTTCAAGACCACAGTGAGCTATAATCACACCTCTGCACTCTACTGCGAGAGAGATTAAAGTCCTGCCTCTTAAAAAAAAAGAAAAAAAAAAAAAAAAA"
"chr1","11164332","11164629","chr1","10438474","10438775","29","725858","GGCTAGGCGCGGTGGCTCATGCCTGTAATCCCACCACCTTGGGAGGCCGAGACAGGATGATTGCTTGAGGACAGGAATTCAAGACCAGCCTGAGCAACATAGCAAGACTTCGAATCTACAAAAAATTTAAAAATTAGCTGGGTGAGGTGATCTGTGTCTGCAGTCCCAGCTATTTGGGAGACTAAGGCGGGAGGAACACTTGAGCCCACGAGTGTGAGGCTGCAGTGGGCTACAATCGCACCACTGCACTCCAGACTGGGTGACAGAGTGAGACTCTGTCTCCAAAAACAAAACAAAA","GGCTAGGCGCGGTGGCTCATGCCTGTAATCCCACCACCTTGGGAGGCTGAGACAGGATGATTGCTTGAGGACAGGAATTCAAGACCAGCCCGAGCAAGACTTCAAATCTACAGCAAGACTTCAAATCTACAAAAAATTTAAAAATTAGCTGGATGAGGTGATCTGTGCCTGCAGTCCTAACTATTTGGGAGACTAAGGCGGGAGGAACGCTTGAGCCCACGAGTGTGAGGCTGCAGTGGGCTACAATTGCACCACTGCACTCCAGACTGTGTGGAGACCCTGTCTCCAAAAACAAAACAAAA"
"chr1","11166973","11167262","chr1","10441109","10441399","21","725864","GGCTGGGTGCAGTGGCTCACTCCTATAATCCCAGCACTTTGGGAGGCCAAGACAGGAGGATTGCTTGAAGCCAGGAGTTCAAGACCAGCCTGGGTAACATAGCAAGACCTTGTCTCTGTAAAAAGTTTAATGGGGCATGATGGCATGCGCCTGTGGTCTCAGCTACTCAGGAGGCCAAGGCAGGAGGATCACTTGAGTCCAGGAGTTTGAGGCTGCAGTGAGCTATGATTGCACCACTGCACTCCAGCGTGGGCAACAGAACAAGACACTATCTCAAAACAAACAAAAAA","GGTCAGGTGCAGTGGCTCACTCCTGTAATCCCAGCACTTTGGGAGGCCAAGACAGGAGGATTGCTTGAAGCCAGAAGTTCAAGACCAGCCTGGGTAACATAGCAAGACCCTGTCTCTATAAAAAAATTGAGTGGGGCATGATGGCATGTGCCTGTGGTCTCAGCTACTCAGGAGGCCAGGGCAGGAGGATCCCTTGAGTCCAGGAATTTGAGGCTGCAGTGAGCTATGATCACACCACTGCACTCCAGTTTGGGCAACAGAATAAGACCCTATCTCAAAACAAACAAAAAA"
"chr1","11188882","11189169","chr1","10463664","10463954","34","725218","GGCTGGGCATTGTGGCTCCTGCCTATAATCTCAGCACTCTAGGACGCTGAGACAGGAGGATCACTTGAGGCCAAGAGTTCAAGACCAGCCTGGGCAACCTAGCGAGACTCTATCTCTACAAAAATAAAAAATTAGCCAAGCGTGGTGGCATGAAGCTGTAATCCTAGCTACTCAGGAGGCTAAGGCGGGGGGATTGCTTGAGTCCAGGAGTTTAGAGGCTGCAGAGAGCCACAATCGTGCCCCTGCATTCCAGCCTAGATGGCAGAGCAAGACTGCATCTCAAAAAAA","GCATAGTGGCTCCTGCCTGTAATCTCAGCACTCTGGGAGGCTGAGACAGGAGAATCACTTGAGGCCAAGAGTTCAAGACCTGCCTGGGCAACCTAGTGAGACTCTATCTCTACAAAAATAAAAAATTAGCCAAGCGAGGTGGCATGCACCTGTAATCCTAGCTACTCAGGAGGCTGAGATGGGAGGATTGGGGGGATTGCTTGAGCCCAGGAGTTTGGAGGCTGCAGAGAGCCACAGTCATGCCATTGCTTTCCAGCCTGGATGGCAGAGCAAGACTGCATCTCAAAAAAA"
"chr1","11189702","11189990","chr1","10464501","10464783","21","725201","GTGATGACTCATGCCTATAAATCACGGCACTTTTGGAGGCTGAGGCAGGATGACTGCTTGAGTCCAGGAGTTTGAGATCAGCCTGGGCAACATAGTGAGACCTCGTCTCTACAAAAAATAAAATTAGCTGGGCCTGGTGCGTGTCTGCAGTCCCAGCTACTCAGGAGGCTGACGTGGGAGGATCACTTGAGCCCAGGAGGTTGAGGCTGCAGTGAGCCGAGATTGTCCCACTGCACTCCAGCCCGGGCAGCAGAGACCCTGTTTCCAAAACAAAAACAAAAACAAAAAA","GTGATGACTCATGCCTATAAATCACAGCACTTTGGGAGGCTGAGGCAGGACGACTGCTCGAGTTCAGGAGTTTGAGATCAGCCTGGGCAACACAGTGAGATCTCGTCTCTACAAAAAATAAAATTAGCTGGGCCTGGTGCGTGTCTGCAGTCCCAGCTCCTCAGGAGGCTGACGTGGAGGATCACTTTGAGCCCAGGAGGTTGAGGCTGCAGTGAGCCGAGACTGTGCCACTGTACTCCAGCCCGGGCAGCAGAGACCCCGTTTCAAAAACAAAAACGAAAAA"
"chr1","11194341","11194713","chr1","95771715","95772086","98","84577374","GCTGGGCGTGGTGGCTCATGCCTGTAATCTCAGTAATTTGGCAGGCCAAAATGGAAGAATCACTTGAAGCAGGAGTTTGAGACCAGCCTGGGCAACATAGTAAAACACCATCTGTATAATAAAAATGAAAAATGAAAAAAATTAATTCCAGCCTGGGCAACAGAGTAAGACCCTGTCTCAAAAAAAAAGGAATTGAAAAAATTTTAAAAATTAGCTGAGCAGAGTGGCACCTGCCTGTAGTCCCAGCTACTCAGGAGACTGAGGCAGGAAGTTCACTTGAGCCCATGAGTTCCAGGGTGCAGTGAGCTATGATTGTGCCACTGCACTCCAGCCCAGGTGACAGAGCAAGATTCTCTTACAAAAAAAAAAAAGA","GGCTGGGTACAGTGGCTCATACCTGTAATCCAGACCTTTGGGAGGCCGAGGTGGGAGGATCCCTTGAGGCCAGGAGTTTGAGACCAGCCTGGGCAACGTGGTGAGACCCTGTCTCTACAAAAAAAAATTTGTTAAAAGATTAGCCAGGCTGGGCAACATGGCGAGACCATGTCTCTACAAAAGAATACAATAAAATAAAATAAAATATTAGCGAAGCATGGTGGCATGCACATGTAGTCACAGCTACTCAGAGGGCTGAGGTGGGAGGATCACTTGAGCCCAGGAGTTTAAGGCTGCAGTGAGCTATAATCATGCTACTGCACTCCAGCCTGGGTGAGAGAGAAGAAGAACCGCCTCAGAAAAGAAAAGAAA"
"chr1","11198301","11198582","chr1","10473400","10473682","15","724901","GCTAGGCACAGTGACTCACACCCGTAATTCCAGCAACTTGGGAGGCTGAGGCAAGAGGATTGCTTGAGATCAGGAGTTGGAGACCAGCTCCAGACATAGCAAGACCCTGTCTCCACAAAAAATTTAAAACTTAGCCAGGCGTAGGGACACGTGCCTGTAGTCCCAGCTACTCAGGAGGCTAAGGCAGAGGGATCGCTTGAGCCCAGGAGTTCCAGACTGCAGTGACCCCCATAATTGTGCCATTGCACTCCAGCCTGGGCAACAGAGCAAGACCTCATCTCA","GCTAGGCACAGTGACTCACACCCGTAATTCCAGCAACGTGGGATGCTGAGGCAAGAGGATTGCTTGAGATCAAGAGTTGGAGACCAGCTCCAGACGTAGCAAGATCCTGTCTCCACAAAAAAAAATTTAAAAATTAGCCAGGCATAGGGACATGTGCCTGTAGTCCCAGCTACTCAGGAGGCTAAGGCGGAGAGATCGCTTGAGCCCAGGAGTTCCAGACTGCAGTGACCCCCATAATTGTGCCATTGCACTCCAGCCTGGGCAACAGCAAGACCTCATCTCA"
"chr1","11203322","11203590","chr1","10479013","10479286","15","724309","CTCAGTGCTTTGGGAGGCCAAGGCGGGAGGACTGCTTGAGGCCAAGATTTCAAGAACAGCCTGGGCAACATGGCTAGATTCTGTCTCTACAAAAAAATACAAAAAATTAGCTGGGCACTTGCCTGTAGTTCTAGCTACTGGATGCTAAGGTGGGAGAAATGCTTGAGCCCAGAAGTTCAAGGCTGTAGTGAGCTATGCACGTGCCACTGCACTCTACAGAGTGCAGGGTGACAGGGTGAGACCCTGTCTCTTAAAAAAAAAAAAAAAAA","CTCAGTGCTTTGGGAGGCTGAGGTGGGAGGACTGCTTGAGGCCAAGATTTCAATAACAGCCTGGGCAACATGGCGAGATCCTGTCTCTACAAAAAAGTACAAAACATTAGCTGGGCACTTGCCTGTAGTTCTAGCTACAATGGATGCTAAGGTGGGAGAAATGCTTGAGCCCAGAAGTTCAAGGCTGTAGTGAGCTATGCACGTGTCACTGCACTCTTCAGAGTGCAGGGTGACAGGGTGAGACCCTGTCTCTTAAAAAAAAAAAAAAAAAAAA"
"chr1","11219157","11219438","chr1","10495018","10495306","29","724139","CTGGGCATGGCAGCTCACACTTGTAATCCTAGCACTTTGGGAGGCTGAGGCAGGAAGATTGCTTGAGCTCCAGAGCGAGAGCAACCTGGGCATGATGAGACTTTGTCTCTACTAAAAAAAAAAAAATAGCTGGGCATGGTGGCGTGTGCCTGTAGTCCCAGCTACTTAGGAGGCTAAGATGGGAAGATCACTCGATTCCAGGAGATTAAGGCTGCAGTGAACTGTTATCACACCACTGCATTCCAGTCTCCAGTGAGACCCTGTCTCAACAACAACAAAAAA","CTGGGCATGGCAGCTCACACCTGTAATCCCAGCACTTTGGGAGGCCGAGGCGGGAAGATCGCTTGAGCTGCAGAGTTCGAGAGCAGCCTGGGCATAATTAGACTTTGTCTCTACTTAAAAAAAAAAAAAAAATAGCTGAGCATGGTGGCGTGTGCCTGTAGTCTCAGCTACTCTGGAGGCTAAGATGGGAAGATCACTTGAATCCAAGAGATTAAGATTGCAGCGAACTGTTATCGCACCACCGCACTCCAGTCTCCAGTGAGACCCTGTCTCAACAACAACAAAAAAA"
"chr1","11231193","11231505","chr1","10506555","10506849","43","724638","GGCCAGGCACAGTGGCTCACGCCTGTAATCCCAACACTTTGGGAGGCCAAGGAGAGAGGAGTGTTTGAGGCCAGGAGTTCGAAACAGCCTGGGCAACACAGTGAGACCCTGTCTCTACAAAAATAAAAATTAGCCAGGTGTGGTGGTGCATGCCTGTAATCCCAGCTACTCGGGAGGCTGAGGCAGGAGGATCACTTGAGCCCAGATGGTTGAGGCTGCAGAAAGGTGTGATCGTGTGCAGCACTGCACTCAAGCCTGAGTGACAAAGAGCCTGTCTACAAAAAAAAAAAAAAAAAACCCAAAAACGTAAAAA","CAGTGGCTCACGCCTGTAATCCCAACACTTTGGGAGGCCAAGGAGGGAGGATTGTTTGAGGCCAGGAGTTCGAAACAGCCTGGGCAACACAGCAAGACCCTGTCTCTACAAAAAATAAAAATTAGCCAGGTGTGGTGGTGCACGCCTGTAATCCCAGTTACTCGGGAAGCTGAGGCAGGAGGATCGCTTGAGCCCAGACGGTTGAGGCTGCAGAGAGGTGTGATCATGTGCAGTGCTGCACTCAAGCCTGAGTGACAAAGCAAGACCCTGTCTCAGAAGAAAAAAAAAAAAGAAA"
"chr1","11233032","11233327","chr1","10508761","10509037","37","724271","GGCAAGGCGCCACAGCTCATGTCTGTAATCCCAAGCACTTTGGGAGGCCAAGGCAGGAGAATTGCTTGAGCCCAGGAGTTCAAGACCAGCCTGGGCAACACAGTGAGATCCCATCTCTACAAAAAATAAATTTAAAAAATTAGCCAGGAGTGGAGACTCATGCCTGTGGTCCTACCTACTTGGGAGGCTGAGGTGAGAGGATCGCTTGAGCTCAGTAGGTCATGGCTGCAGCGAGCTGAGATCGCATTACTGCACTTCAGCCTGGGTGACACAGCAAGACCCTGTCTCAAAAAAAA","GTCTGTAATCCCAAGCACTGTGGGAGGCCGAGGCGGGAGAATTGCTTGAGCCCAGGAGTTCAAGACCAGCCTGGGCAACACAGTGAGACCCCATCTCTACAAAAAATAAATTTAAAAAATCAGCCAGGTGTGGAGACTCACACTTGTGGGCCTACCTACTTGGGAGGCTGAGGTGAGAGGATCGCTTGAGCTCAGTAGGTCATGGCTGCAGTGAGCTGTGACCGCATCCCTGCACTTCAGCCTGGGAGACACAGCAAGACCCTGTCTCAAAAAAAAA"
"chr1","11262689","11262977","chr1","10541017","10541291","37","721672","GGCTGAGTGCAGTGGCTCATGTCTGTAATCCCAGCCCTTTGGGAGGCTGAAGCGAGAGAATCGCTTGAGGCCAGGAGTTAAACACCAGCCTGGGCAACATAGACCCCTGTCTGTATAAAATATTAAATAAAAAATATTAGCTGGGCATGGTGGTGCTTGCCTGTGGTCCCAGCTACTTTGGAGGCTGAGGTGGGAGAATTGCTTGAGCCCAGGGGTCAAGGCTGCAGTGAGTCCTGATCACACCACTGCACTCCAGCCTGGGCGACAGAGTGAGACCATGCCTCAGAAA","GCTCATGGCTGTATCCCAGCCCTTGGGGAGGCTGAAGTGAGAGGATCACTTGAGGCCAGGAGTTGAAGACCACCTTGGGCAACGTAGACCACTGTCTCTATAAAATATAAAATAAAAAATATTAGCTGGGCATGGTGGTGTTTGCCTATGGTCCCAGCTATTTTGGAGGCTGAGGTGGGAGTATCGCTTGGGCCCAGGAGGTCAAGGCTGCAGTGAGCCCTGATCACACCACTGCACTCCAGCCTGGGCGACAGAGTGAGACTGTGCCTCAGAAA"
"chr1","11275135","11275434","chr1","10554465","10554764","25","720670","GACTGGGCATGGTGGCTCATGCCTGTAATCACAGTAATTTGTGAGGCCAAGGTGAGAGGATTGCTTGAGCCCAGGAGTTTGAGACCAGCCTAAGTAACGTAGTAAGACCCCATCTCTACAAAAAAAATTTTAAAAAGTTAGCTGGGCGTGGTGGTGCATGCCTGTAGTCTCAGCTACTCAGGAGGCTGAGGTGGAAGGATCGCTTGAACCTAGCAAGTCGAGGCTGCAGTGAGCTATGATCACGCCACTGCACATCCGCCTGGGCGACAGAGCGAGACCCTGTCTCAAAAAAAAAAAAAA","GGGCATGGTGGCTCACGCCTGTAATCACAGCAATTTGTGAGGCCAAGGTGAGAGGATTGCTTGAGCCCAGGAGTTTGAGACCAGCCTAAGTAACATAGTAAGACCCCATCTCTACAAAAAAATTTTAAAAAGTTAGCTGGGCATGGTGGTGCATGCCTGTAGTCTCAGCTACTCAGGAGGTTGAAGTGGAAGGATCACTTGAGCCTGGCAGGTCAAGGCTGCAGTGAGCTATGATCATGCCACTGCACACCTGCCTGGGCGATAGAGCGAGACCCTGTCTCAAACAAACAAACAAAAAAA"
"chr1","11280822","11280934","chr3","20729870","20729987","17","9449048","GGCTGGGTGTGGTGGCTCACACCTGTAGTCCCAACACTTTGGGAGGCCAAGGTAGGACTGCTTGAGGCCAGGAGTTTGAGACCAGCCTGGCCAACATAATGAGACCCTGTCTC","GGCTAGGTGTGGTGGCTCATTCGTGTAGTCCCAACACTTTGGGAGGCTGAGGTGGGAGGATTGCTTGAGGCCAGGAGTTTGAGACCAGCCTGGTCCACATAGCAAGACCCTGTCTCTA"
"chr1","11297388","11297686","chr1","10574799","10575119","38","722589","GGCAGGATGGTTCATGCCTGTAATCCTAGCACTTAGGGAGGCTGAGTTGGGAGGATCACTTGAGGCCGGGAGTTCAAGACCAGCCTGAGCAACATAACAAGACCCTGTCTCTACTAAAAACATTAAAAATTAGCAGGATGTGGTGGCACATGCCTGTGGTCCCAGCTACTCAGGAGGCTGAGGTGGGAGGATTGCTTGTGCCCAGGAGGTCAAGGCTGCAGTGAGCCGTGACTAAGCCACTGCACTCCAGCCTGGGCAACAGAGCAAGACTCTGCCTCAAAACAAGACAACATAAAAAA","GGCAGGATGGTTCATGCCTGTAATCCAAGAACTTAGGGAGGCTGAGATGGGAGGATCACTTGAGGAGGATCACTTGAGGCCAGGAGTTCAAGACCAGCCTGGGCAACATAACAAGACCCTGTCTCTACTAAATACATTAAAAATTAACAGGGTATGGTGGCACGTGCCTGTGGTCCCAGCTACTTAGGAGGCTGAGGTGGGAAGATTGCTTGTGCCCAGGAGGTCAAGGCTGCAGTGAGCTGTAACTGAGCCACCGCACTCCAGCCTGGGCAACAGAGCAAGACTCTGCCTCAAAACAAGACAAAATAAAAAAACAGAGAA"
"chr1","11299247","11299563","chr1","10576660","10576977","31","722587","GGCTGGGCACAGTGGCCTTATGCCTGTAATCCCAGCACTTTGGGAGGTTGAGGTAGGAGGATCACTTGAGGTCAGTTCGAGACCAGCCTGGGTAACATAGTGAGACCCCCCCCATCTCTACCAAAGAAAAAACTAAAAATGAGCTAGGTGTGGTGGCGCCCGCCTATAGTCCCAGCTACTTGGGAGGCTGAGGTGGAAGGAATGCTTGAGCCCAAGAGTTCGAGGCTGCAGTGGGCTATGATCCCACCACTGCACTCCAGCCTGGGTGACAGAGTGAGACCCTATCTCAAAAAACAAACAAACAAAAAAAAGAACAA","GGCTGGGCACAACAGTGGCCTCATGCCTGTAATCCCAGCACTTTGGGAGGCTGAGGTAGAAGGATCACTTGAGGCCAGGTGGAGACCAGCCTGGGTAACATAGTGAGACCCCCATCTCTACCAAAGAAAAAACTAAAAATTAGCCAGGTGTGGTGGTGCCCGCCTAAAGTCTCAGCTACTTGGGAGGCTGAGGTGGGAGGATTGCTTGAGCCCAGGAGTTCGAGGCTGCAGTGGGCTCGAACTTTCACCACTGCACTCCAGCCTGGGTGACAGAGTGAGACCCTATCTAAAAAACAAACAAACAAACAAACAAACAAA"
"chr1","11318018","11318323","chr1","10592392","10592704","26","725626","GGCTGGACGTGGTGGCTCACGCCTGTGATCCCAACACTTTAGGAGGCTGAGTCAGGAGGACTGCTTGAGGCCAGGAGTTTCAAGACAAGCCTGGGCAAAACAGCAAGACCCTGTTTCTAAAAAAAAGAAAAATTATCTGGGCTTGGTAGTGCACTTGTGTAGTCCCAGCTACTTGGTAGGCTGAGGTGGGAGGATGATTTGAGACCAAGAGGTGGAGGCTGCAGCGAGCTGTGATCACGCCACTGCACTCCAGCCTGGGCAATAGAGCGAGACCCTGTCTCAAAACAATAAAAATAAAAGAACAAA","GGCTGGACGTGGTGGCTCACGCCTGTAATCCTAACACTTTAGGAGGCTGAGTCAGGAGGACTGCTTGAGGGCCAGGAGTTTTGAGACAAGCCTGAGCAAAACAGCAAGACTCTGTTTCTAAATAAAAGTAAAAAAAAAATTATCTGGGCTTGGTAGTGCACTTGCATAGTCCCAGCTACTTGGGAGGCTAAGGTGGGAGGATGATTTGAGACCAGGAGGTCAAGGCTGCAGCCAGCTATGATCATGCTGCTGCACTCCAGCCTGGGCAATAGAGCGAGACCCTGTCTCAAAACAATAAAAATAAAAGAACAAA"
"chr1","11322299","11322620","chr1","10595699","10595979","64","726600","GGCCAGGCGCAATGGCTCACGCCTGTAATCCTAGCGCTTCGGGAGGCCAAGGAGGATCACTTAAGGCCAGGAGTTTGAGACCAGCCTGGGAAACTTGGTGAAACGCCCCGTTTCTACAAAAAGTAGCCAGGTGCCTATAGCCCCAGCTACTCGGGAGGCTGAGGTGGAAGGATCACTTGAGCCCAGGAGTTCAAGGCCATAGTGAGCTATGATCATGCCACTGTACTCCAGCCTAGGCAGCAGAGTGATACCATATCTCAAAACAAAACAAAACAAAACAAAACAAAACAAAACAAAACAAAGCAAAAACCCAACAACAAAA","GGCCAGGCGCAATGGCTCACACCTGTAATCCTAGCACTTTGGGAGGCCAAGGAGGATCACTTGAGGCCAGGAGTTTGAGACCAGCCTGGGCAACATGGTGAAACCCCCTGTTCCTACAAAAAATAGCCAGGTGCCTATAGTCCCAGCTACTCAGGAGGCTGAGGTGGGAGCATTGCTTGAGCCCAGGAGTTCAAGACCATAGTGCGCTATGAGCTTGCCACTATACTCCAGCCTAGGCAGCAGAGTGATACTATGCCTCAAAACAAAACAAAACAAAAAAA"
"chr1","11328109","11328378","chr1","10600605","10600887","25","727504","GGTGCAGTGGCTCACGCCAGTGCTTTGGGAGTCCAAGGCAGGAGGATCGCTTGAGGCCATGAGTTTAAGACCAGGCTGGGTAACATAGTGAGATCCTGTCTCTACAAAAAATTAAAAACTTAGCTGGGCATGGTGGTGTGTGGCTGTAGTCCCAGCTACTTGGGAGGCTGAGACAGGGGGATTGCGTGAGCCCAGCAACTCAAGGTTGCAGTGAGCCGTGATTGCACCATTGCACCCCAGCCTGGGCAACTTAGAGTGAGACTCCATCTC","GGTGCAGTGGCTCATGCCAGTGCTTTGGGAGTCCAAGGCAGGAGGATCGCTTGAGGCCAGGAGTTCAAGACCAGCCTGGGTAACATAGTGAGACCCTGTCTCTACAAAAAATTAAAAACTTAACTGGGCATGGTGGTGTGTGCCTGTAGTCCCAGCTACTTGGGAGGCTGAGACAGGGGGATTGCATGAGCCCAGTAACTCAAGGTTGCAGTGAGCCACGATTGCACCATTGCACCCCAGCCTGGGCAACTTAGAGTGAGAATCCATCTCTTAAAAAAAAAAA"
"chr1","11359877","11360003","chr1","10637882","10638005","11","721995","GGCCAGGCACGGTGGCTCACCCCTCTGTAATTCCAGCACTTTGTGAGGCTACGATGGGAGGATCATTTGAGGGCAGAAGTTCAAGACCAGCCTGGGCAACCTAGCAAGATCCTGCCTCTACAAAAAA","CAGGCACAGTGGCTCACCCCTCTGTAATTCCAGCACTTTGTGAGGCCAAGACCGGAGGATCGTTTGAGGGCAGAATTTCAAGACCAGCCTGGGCAACCTAGCAATATCCTGCCTCTACAAAAAA"
"chr1","11364550","11364838","chr1","10642286","10642562","48","722264","GACTGGGCGCAGTGGCTCATGCCTGTAATCCTAACACTTTGGGAGGCGAAGTGAAAGGATTGCTTGAGCCCAGGAGTTTGAGACCAGCCTGGACAACATAGCAAGACCCTGTCTCTACAAAAAATAAAAAATTAGCCCAGCATGATGGCACACGCCTATAGTCCCTCAGGAGGCTGAGGTGGGAGGATTGCTTGAGCCCAGAAGGTCAAGGCTGCACTGAGCTGTGTTCACACCACTGCACTCCAGCCTGGGTAAAAAAGAGAGCCTGTCTCAATAATAATAATAATAA","GACTGGGTGCAGTGGCTTATGCCTGTAATCCTAACACTTTGGGAGGTGGAAGTGAAAGGATTGCTTGAGCCCAGGAGTTTGAGACCAGCCTGAGCAACATAGAAAGAACCTGTCTCTACAAAAAATAAAAAATTAGCCGGGCATGATGGCACACAAATATAGTCCCAGCGACTCAGGAGGCTGAAGTGGGAGGATTGCTTGAGTCTAGAAGGTCGAGGCTGCAATGAGCTGTGTTCACACCACCGCATGCCTGGGGGACAAAGAGAGCTTGTCTCAA"
"chr1","11375648","11375948","chr1","10653448","10653748","34","722200","GGCCGGGCACAGTGGCTGACTCCTATAATCCTAGCACTTTGGGAGGCTGAGGCAGGAGGATTGCTTGAGCCTGGGAGTTCAAGACCAGCCAGGGCAACATAGGGAGACCCCCCTATCACTACAAAAAATAATAATAATTAGCCAGACGTTGTGGTGCACACCTGTAGTCCCAGGTACTTGGGAGGCTGAGGTGAGAGGATCATTTGAGCCTGGGATGTTGAGGCTATAGTGAGCTGAGATTGCGCCAGTGCACTCCAGCCTTGGTGACAGAGCCAGACTCTGTTTCAAAAAAAAAAAAAAA","GGCTGGGCACAGTGGCTCACTCCTATAATCCTAGCAGTTTGGGAGGCTGGGGCAGGAGGATCGCTTGAGCCCAGGAGTTGGAGGCCAGCCAGGACAACATAGGGAGACCCGCTACCTCTACAAAAAAAGTAATAATTGGCCAGACTTTGTGGTGTACACCTGTAGTGCCAGGTGCTTGGGAGGCTGAGGTGAGAGGATCATTTGAGCTGGGGAGGTTGAGGCTCTAGTGAACTGAGATTGCACCACTGCACTCCAGCCTGGGTGACAGGGCCAGACTCTGTCTCAAAAAAAAAAAAAAAAA"
"chr1","11487822","11488102","chr1","10768802","10769075","16","719020","CACTTTGAGAGGCCAAGGTGGGAGGACCACTTGAGGCCAGGAGTTTGAGACCAGTGTGGGCAACATAGTGAAACGCTGTCTCAAAACAAAAACAAAAACAAAAAACTAGCTGGGTATGGTGGCACATGCCTGTAGACCTAGCTACTCAGGAGGCTGAGATGGGAGGATTACCTGAGCCCAGGAGTTTCAGGCTGCAGTGAGCTATGACCATGCCACTGCACTTCAGCCTTAATGACAGAGTGACACCTTGTCTCAAAAAGATAAAAATAAAAACATAAAAA","CACTTTGAGAGGCCAAGGTGGGAGGACCACTTGAGGCCAGGAGTTTGAGACCAGTCTGGGCAACATAGTCAAACGCTGTCTCAAAACAAAAACAAAAACAAAAAACTAGCTGGGCATGGTGGCACGTGCCTGCAGACCTAGTTACTCAGGAGGCTGATGGGAGGATTACCTGAGCCCAGGAGTTTCAGGCTGCAGTGAGCTATGATCATGCCACTTCAGACTTAATGACAGAGTGACACCTTGTCTCAAAAAGATAAAAATAAAAAAATAAAAA"
"chr1","11489166","11489462","chr1","10770139","10770410","37","719027","GCAGGGTACCGTAGTTCATGCCTATAATCCCAGCTACTTGGAAGGCTGAGGCAGGAGGATCCTTGAGGCCAGGAGGTTAAGACCAACCGGGGAAACAGCAAGACCCTCTCTGTAAAAACACACAAAAATTAGCCAGGCGTGGTGACACATGCCTGTAGTCCTTGCTACTTTGGAGGCTGAGGTTGGAGGATCCCTTGAGCTGAGGAGTTCAAGGCTGCAGTGAACTATGATTGTGCTACTGCACTGTAGCCTGGGTGGCAGAGCGAGACCCTGTCTCTTAAAAAAAAAAAAAAAGAA","GCAGGGTACCATAGTTCATGCCTATATTCCCAGCTACTTGGAAGGCTGAGGCAGGAGGATCCTTGAGGCCAGGAGTTTAAGACCAGCCGGGGAAACAGCAAGACCCTGTCTCTAAAAACACACAGTAGTAGCCTGTAGTCCTCGCTACTTTGGAGGCTGAGGTGGGAGGATCCCTTGAGCCGAGGAGTTCGAGGCTGCAGTGGACTATGATTGTGCTACTGCACTGTAGCCTGGGTGGCAGAGCGAGACCCTGTCTCTTAAAAAAAAAAGAA"
"chr1","11491735","11491846","chr1","10773311","10773410","17","718424","GGCCGAGCACAGTGGCTAACACCTGTAATCCCACTTTTGGAGGCCAAAGTGGGAGGATTGCTTGAGGCCAGGAGTTCAAGACCAGCCTGGGCAACATAACGAGACCCCCATC","GTGGCTAACACCTGTAATCCCACTTTGGGAGGCCAAAGTGGGAAGATTGCTTGAGGCCAGGGGTTCAAGACCAGCCTGGGCAACATAATGAGACCCGATC"
"chr1","11494156","11494355","chr1","10775709","10775896","19","718447","CCATCTCTACTAAAAAATAAAAAAATTGGCCAGGCATGGTGGCATGCATCTGTAGTCTAGCTACTCAGGAGGCTGAGGTGGAAGGATTGTTTGAGCCCAGGAGTTAGAGGCCATAGTGAGCTATGATCATGCCATTGCAGTCAAGCCTGGGTGACAAAGTGAGACCCTGGCTCAAAAAATAAATAAATAAATAAATAAAA","CCATCTCTACTAAAAAATAAAAAATTGGCCAGGCATGGTGGCATGCATCTGTAGTCTAGCTACTCAGGAGGCTGAGGTGGAAGGATTGTTTGAGAACAGGAGTTAGAGGCTATAGTGAGCTATGATCTTGCCATTGCACTCCAGCCTGGGTGACAAAGTGAGACCCTGACTCAAAAAAAATTAAAAAA"
"chr1","11505154","11505393","chr1","10788942","10789181","20","716212","AGCCTGGGCTACACAGAGAGACCCTGTCTCTACAAAAAATAAAAGATAAAATTAGCTGGCGTGGTGGTGTGTGCCTGTGGTCACAGCTACTCAGGAGGCTGAAGAGAGAGGATCGCTTGAGCCCAGGAGGTCGAGGCTGCAATGAGCTATGATCATGCCACTGCACTCCAGCCTGGGTGACGGAGCAAGCCCCTGTCCTCCCCCCACCCCCCAAAAAAAGAAAAAGAAAAGAAACACAAA","AGCCTGGGCAACACAGAGAGACCCCGTACCTACAAAAAATAAAAGACAAAACTAGCTCGTGTGGTGGTGTGTGCCCGTGGTCACAGCTACTCAGGAGGCTGACGAGAGAGGCTCGCTTGAGTCCAGGAGGTCGAGGCTGCAGTGAGCTATGATCATGCTACTGCGCTCCAGCCTGGGTGACGGTGCAAGCCCCTGTCCTCCCCCCAACCCTCCCAAAAAAAGAAAAAGAAAAGAAACAAA"
"chr1","11530355","11530655","chrX","147369436","147369734","56","135839081","GGCCAGGCATGGTGGCTCAAACCTGTAATCCCAGCACTTTGGGAGGTCGAGGTGGGAGAATTGTTTGAGCCCAGGAGATTGAGATCACCCTGGAAAATATAGGGAGACTCCATCTCCACACACAAAAAAATAAAATTAGCTGGGTGTGGTGGTGCACACCTGCAGTTCCAGCTACTCAGAAGGCTAACATGGGAGGGTTGCTTGAGCCTGGGAGGTTGAGGCTGTAGTGAGCTGTGATTGTGCCACTGTACTCCAGCCTGGGCAAGAGAGAAAGACCCTGTCTCAAAAAAAAAAAAAAAGA","GGCCAGGTGTGGTGGCTCACACCTGTAATCCCAGCACTTTGGGAGGCTGAAGTGGGAGGATTGCTTGAGACCAGGAGTTTGAGAACAGCCTGGGCAACATGGCAAGACTGTGTCTCTACAAAAAATACAACAATTAGCTGGGTGTGGTGGTGCATGTCTACAGTCCCAGCTACTCAGGAGGCTGAGATGGGAGGATCCCTTGAGCCTGGGAGGTCGAGGCTGCAGTGAGCTGTGATCATGTCACTGCACTCCAGCTTGGCTGACAGAGTAAGACCCTGCCTTAAAAAAAAAAAAAGGAA"
"chr1","11567498","11567771","chr1","10853244","10853544","37","714254","CAGTGGCTCATGCTTGTAATCCCAGTGACTCAGGAAGCTGAGGTGGGAGAATCACTTGAGGCCAGGAGTTCTAGACCAGCCTGGGCAACATAGCAAAACCCTGTTTAAAAAAAATTTAAAACTTAACTGGCATGGTGGTGTGCACCTGTAGTCCCAGCTACTCAAGAGGCTGAGGCAGGAGGATTGCTTGAGCCAGGGAGTTCAAGGCTGCAGTGAGCTGTGATCATGCCACTGCACTCCAGCCTGAAAGACAGAACAAGACTCTAACTCTAAA","CAGTGGCTCATGCTTGTAATCCCAGTGACTCAGGAAGCTGAGGTGGGAGAATCACTTGAAGCCAGGAGTTCTAGACCAGCCTGGGCAACGTAGCAAAACCCTGTTTAAAAAAAAAAAAAAAATTAAAACTTAACTGGCCTGGTGGTGTGCACCTGTAGTCTCAGCTACTCAAGAGGCTAAGGCAGGAGGATTGCTTGAGCCAGGGAGTTCAAGGCTGCGGTGAGCTGTGATCACGCCACTGCACTCCAGCCTGGAAGACAGAACAAGACTCCAACTCTAAATAAGTAAATAAGCAAATAAA"
"chr1","11574142","11574380","chr6","170454936","170455168","52","158880794","TAATCTCGGCACTTTGGGAGGTTGAGGCAGGAGCATAGCTTGAGCCCAGGAGTTTGAGACTAGCCCGGGCAACATAGCAAGACCCCATCTCTACAAAAATCTTAAAATTAGCCGGATGCAGTGGCGCACATCTGTAGTCCTAGCTACTTGGGAGGCTGAGGTGGGAGGATCACTTGAGCCTGGGAGGTTGGGGCTGCAGTGAGCTGTGATTGAGCCACTGTACTCCAGCCTGGGTGGCA","TATAATCTCAGCAGTTTGGGAGGCAGCGGCAGGTGGATTGCTTGAGCCCAGGAGTTCGAGACCAGTCTGGGCAACATAAGGAGACCCCATGTCTAAAAAAAATTAAAAAATTACCTGGACATGGTGGCATGCACCTGTGGTCCCAGCTACTTGGGAGGCTGGGGTGGGAGGATCATTTGAGCCTGGGAGGTTGAGGCTGCAGTGAGCTATGAATGTGCCATTGCACTCCAGCC"
"chr1","11623828","11624112","chr1","10904976","10905255","22","718852","GGCCAGGCACGGTGGCTCACGTCTACAATCCCAGCACTTTGGGAGGCCGAGGCAGGAGGATTGCTTGAGGTCAGGAGTTTGTGACCTGCCTGACCAACATGGCAAGACCCTATCTCTACAAAAAATAAAAATTAGTCTGGTGTGGTGGCACGTGCCTGCAATCCCAGCTACTCAGGAGGCTGAGGTGGAAGGATCGCTTGAGCCCAGAAAATTGAGGCTGCAGTGAGCCATGATCACACCACTGCACTCCAGCCTGGGTGACAGAGTGAGACCGTGTCTCTAAAA","GGCTGGGCACGGTGGCTCACGTCTGTAATCCCAGCACTTTGGGAGGCCGAGGCAGGAGGATTGCTTGAGGCCAGGAGTTTGAGACCTGCCTGACCAATATGGCAAGACCCCATCTCCACAAAAAATAAAAATTAGCCTGGTGTGGTGGCACATGCCTGCAATCCCAGCTACTCAGGAGGCTGAGGGGGAAGGATTGCTTGAGCCCAGAAAATTGAGGCTGCAGTGAGCCATGATCATACCACTGCACTCCAGCCTGTGTGATAGAGTGAGACCCTGTCTC"
"chr1","11638075","11638344","chr1","10919793","10920102","51","718282","GGCTGGGCACAGTGGCTCATGCCTGTAGTTCCAGCACTTTGGGAGGCTGAGGCAGAAGGATGACTTGAGGCCAGGAGTGCGAGACCAGCCTGGGCAACAAAGCAAAACTCCATCTCTACAAAAAACATTTTTTTTAATAGTGGTGGTGCACACCTGTACTCCCAGCTACTCAGGATGCTGAGGCAGGAGGATGACTTGAGCCTAAGAGTTTGAGTCTGCAGTGAGCTATGAATGCGCCAGCCTGGGTGACAGAGACCCTGTCCCTAAAAA","GGCTGGGCACAGTGGCTCATGCCTGTAGTTCCAGCACTTTGGGAGGCTGAGGCAGGAGGATGACTTGAAGCCAGGAGTGCAAGACCAGCCTGGGCAACAAAGCAAAACTCTTATCTCTACAAAAAAAAAAAGAAAAAACATTTTTTTAAATTAGTGGTGGTGCGCACCTGTACTCCCAGCTGCTCAGGAGGCTGAGGCAGGAGGATGGCTTGAGCCTAAGAATTTGAGTCTGCAGTGAGCTATGAATCCGCCAGCCTGGGTGACAGAGACCCTGTCCCTAAAAATATGTAAGTAAATTAAAACAAACAAA"
"chr1","11667306","11667482","chrX","97446542","97446722","27","85779236","TTAGCTGGGTGTGATGGTGCACACCTGTAGCCCCAGCTATTGGGGAGGCTGAGGTGGGAGGATTGCTTGAGCCCAGGAGGTTGAGGCTTCAGTGAGCTGTGATTGCGTCACTGCACTCCAGCCTAGATGACAGAGTGAGACCCTGTCTCCAAAAAATAAAATTAAAAAATAAAAAAA","TTAGCTGGGCATGGTGGTGCACATCTGTAGTCCTAGCTACTTGGGAGGCTGAGGTGGGAGGATTGCTTGAGCCCAGGAGTTTGAGGTTACAGTGAGCTGTGATTGCACCACTGTACTCTAGCCTGAGTGACAGAGTGAGACCCTGACTCTAACAACAAAAAAAAAAGTAAGAAAAAAAAAA"
"chr1","11667788","11667925","chr1","19633562","19633696","24","7965774","GGTCAGGCGCAGTGGCTCATGCCTGTAATCCTAGCATTTTGAGAGGGTGAGGCAGGAGGACCTCTTGAAGCCAGGAGTTGGAGACCAGCCTGGCAACATAGTGAGACCCCTTCTCTACAGAAAATTTTAAAAATTAGT","GGTTGGGTGCAGTGGCTCATGCCTATAATCCTAGCACTTTGGGAGGCTGAGGCAAGAGAATCTCTTGAAGCCAGGAGTTGGAGATCAGCCTGGACAACATAGTGAGACCTGTCTCTACTAAAAAAAAATTAGCGG"
"chr1","11697905","11698203","chr1","10978947","10979243","39","718958","GGGTACGGTGGCTCACACCCGTAATCCCAGCACTTTGGGAGGCTGAGGTGGGAGGATCGCTTGAGCCCAGTAGTTCCAGACCAGCCTAAGCAACATAGGGAGACCCTATCTCTACAAAAAATGTAAAAATTAGCCAGGCATTGTGGCATACACCTGTAGTCCCAACTACAGGAAGGAGGGGCTAACATGAGAGGATCCTTTGAGCCCAGGAGTTCCAGGCTGCAGTGAGCCTTGGTTGCACCACTGTAGTTCAGCCTGGGTAACAGAGTGAGACTCTGTCTCAAAAAATTAAAAATAAA","GGGTACAGTGGCTCACACCCGTAATCCCAGCACTTTGAGAAGGTGAGGTGGGAGGACCGCTTGAGCCCAGTAGTTCCAGACCAGCCTAAGCGACATAGGGAGACCCCATCTCTTACAAAAAAATGTAAAAATTAGCCATGCATTGTGCACAACCGTAGTCCCAACTACAGGAGGGGTACGTGGGAGGATCCCTTGAGCCCAGGAATTCCAGATTGCAGCGAGCCTTGATTGTGCCACTGTACTTCAGCCTCAGCAACAGAGTGAGACTCTGTCTCAAAAAAAATTTTAAAAATAAAA"
"chr1","11704637","11704860","chr1","10985724","10985945","19","718913","AGCCTAGGCAACATAGGGAGACCTCATCTCTGCAAAAAATAACAAAATTAGCCGGGCATGGTGGTGCACACCTGTAGTCCCAGCTATTCTCCAGGCTGAGGTGGGAGGATCGCTTGAGCCCAAGAGGTTGAGGCTGCAGTGAGCCATGATCGCACCACTGCACTCCAGCTTAGGCAATACAGCGAGACCTTGTCTCAAAAAAAGACAAAAAAAAACAAAAGAAA","AGCCTGGGCAACATAGGGAGACCTCGTCTCAGCAAAAAATAACAAAATTATCCGGGCACGGTGGTGCACACCTGTAGTCCCAGCTATTCTCCAGGTTGAGGTGGGAGGATTGCTTAAGCCCAAGAGGTCGAGGCTGCAGTGAGCCATGATCACGCCACTGCACTCCAGCTTGGGCAATAGAGCGAGACCCTGTCTCAAAAAACGACAAAAAACAAAAAGAGA"
"chr1","11707296","11707629","chrY","74753","75056","93","11632543","CAGGCATGGTGGCTCATGCCTGTAATCCCAGCACTTTTGGGAGACTGAGGCAGAGGATCACTGAAGCCAGGAGTTTGAGACCAGCCTGGGCAACATAGCGAGACCCCATCTCTACAAAAAATACAATAATTAACCAGGCTAACTACTGTATTTATAATACAATAATTATTATTGCATTAATAATACAAAACTTCGGAGGCCGAGGCAGGAGGATCATTTGAGCCCAGGAGTTTGAGGCTGCAATGAACCATGATTGTGCCACTAGACATAGTGTCATGACTGTGTGCAACCTAGACGTAAAGCCAGATTCTGTCTCAAAAACAAAACAAAACAA","GGCTGGGCATAATGGCTCATGCCTATAATCCCAGCACTTTGGGAGGCTGAGGCATGAGGATCACTTGAGGCCAGGAATTTGAGACCAGCCTGCACAACATAGCGAGAACTTATCTCTACAAAAAATATAAATAAATAAGCAATAACTGGGTATGACGATGCATGCTTATCATCCAAGCTACTTGGGAGGCTGAGGTGGGAGGATCACTTGAGCCAAGGAGTTCGAGGCTGCAGTGAGTCATGATCGTGTCACTGCACTCCAGCCTGCGCAACAGAGCAAGATCCCACCTCTAAAAGAAAAAAAA"
"chr1","11710851","11711022","chr1","10990625","10990790","15","720226","TTAGCTGGGCATGGTGGTGTGAGCCTGTAATACCAGCTACTTGGGAGGCTGAGATGGGAGGATCACTTGAGCCCAGGAGTTGGAGGCTGCAGTGAGCCAAGGTTGCACCACTGTACTCCAGTCTGGGTGACAGAGCACCTAGAGGGCCCTGTCTCAAAAAAAGAAAATAAAA","TTAGCTGGGCATAGTGGTGTGAGCCTGTAATACTAGCTACTTGGGTGGCTGAGGTGGGAGGATCACTTGAGCCCAGGAGTTGGAGGCTGCAGTGAGCCAAGGTTGCACCAGTGTACTCCAGTCTGGGTAACACAGCAGGACCTTGTCTCAAAAAAAGAAAATAAAA"
"chr1","11722094","11722404","chr6","105142168","105142470","64","93420074","GGCCAGGTCTGGTGGCTCACGCCTGTAATCCCAACACTTTAGGAGGTGGAGGGAGAAGACTGCTTGAGCCCAGGAGTTCGAGAACAACCTGGCCAACAAAGTAAGATCCTATCTCTACAAAAAATCAAAAAATTAGCCAGGCATGGTGGAGTACACCTATAGCCCCAGCTACTTGGGAGGCTGAGGTGGGAGAATCACTTGAGCCAGTGAGGTCAAGTGTACAGTGAGCCAAGATCATGCCACTGCACTACAGCCTGGGGGACGGAGCAAGATCCTGCCAGAAAGAGAAACGAAGGAAAGAAAGAAAGAAA","GCCAGGTGTGGTGGCTCATGCCTGTAATCCCAGCACTTTGGGAGGCTGAGGCAGGAGGATTGCTTGAGCCCAGGAGTTTGAGACCAGCCTAGCAACATAGCAAGTCCCAGTCTCTACAAAAAATAAAAGAAATTAGCCAGGCATAGTGGCACATGCCTGTGGGCCCAGCTACCTGGGAGGCTGACATGGGAGGATCTCTTCAGCCTGGGAGGTCAAGCCTGCAGTGAGCCATGATCATGTCACTGCACTCTAGCCTGGGCGACAGAGCAAGACCCTATCTTAAAAAGAGAGAAAGAGAGAAAA"
"chr1","11748601","11748871","chr1","11031087","11031361","18","717514","GCCAGGCACGGTGGCTCACACCTATAATCCCAACACTTTGGGAGGCCTTGGCCAGGAGTTAGACACCAACCTGGGCAACATAGCGAGACCCCATCTCTAGCAAAAAAATGTAAACATTTAGCCAGGCATGGGGGCATGCTTGTAGTCCCAGCTACTCTAGAGACTGAGGCAGGAGGATCACTTGAGGCCAGGAAATCAAGGCTGCAGTGAGCTATGATCATGCCACTGCACTCCAGCCTGGGCAACAGGGCAAGACCCTGTCTCAAAAAAA","GCCAGGCATGGTGGCTCACGCCTTTAATCCCAACACTCTGGGAGGCCTCGGCCAGGAGTTAGACAGCAGCCTGGGCAACATAGCGAGACCCCGTCTCTAGCAAAAAAATGTAAACATTTAGCCAGGCGTGGGGGCGTGCTTGTAGTCCCAGCCACTCTAGAGGCTGAGGCAGGAGGATCACTTGAGGCCAGGAAATCAAGACTGCAGTGAGCTATGATCATGCCACTGCACTCCAGCCTGGGCAACAGGGCAAGATCCTGTCTCAAAAAAAATAA"
"chr1","11753656","11753940","chr1","11036778","11037060","20","716878","GCCAGGCATGGTAGCTCACACCTGTAATCTCAGCACTTTGGGAGGTCAAGGTGGGCGAATTGCTTGAGTCCAGGAGTTCGAGGCCAGCCTGAGCAACATGGCAAAAAATTAAATCTCTACAAAAAATTTAAAAATTAGCCAGGTGTGGTGGTACGCACCTATAGTCCCAGCTACTTGGAGGTAGAGGTGAGAGGATCCCTTGAGCCTAGGAATTTGAGGCTACAGTGAGACATGATTGCACCACTGCACTCCAGCCTGGGTGACACAGTAAGACCCTGTCTCTAA","GCCAGTCATGGTAGCTCACACCTGTAATCTCAGCACTTTGGGAGGCCAAGGTGGGTGAATCGCTTGAGTCCAGGAGTTCGAGGCCAGCCTGGGCAACATGGCAAAAAATTAAATCTCTACAAAAAATTTAAAAATTAGCCAGGTGTGGTGGCACCTATAGTCCCAGCTACTTGGAAGCAGAGATGAGAAGATCCCTTGAGCCTAGGAATTTGAGGCTACAGTGAGTCATGATTGCACCACGGTACTCCAGCCTGGATGACAGAGTAAGACCCTGTCTCTAAAA"
"chr1","11766132","11766454","chr1","11049878","11050167","56","716254","CAGGTGTGGTGGCTCATGGCGTAATGGGCCTGCCCAATGCTTTGGGAGGCCAAGGCAGGTAGATCGCTTGAGCCCAGGAGTTTGAGACAAGCCCTGGCAACATAGTGAGATCCCATTTCTAACAAAAAAAAAAAAAAAAAAAAAATTAAAGCCGGGTGTGGTGGCACACGCCTGTAGTCTCAGCTACTGAGGTGGCTGAGGTGGGAGGATCGTTTGAGCCCTGGAGGTTGAGGCTGCAGTGAGCTGTGATCGCACCACTGCACTCTGGCCTGGGCGACAGAGTGAGACACTGTCTGAGAACAAAAAACGACTTGAAAAAAAAA","GGCACGGTGGCTCATGGCGCAATGGGCCTGCCCAGCGGTTGGGGAGGCCAAGGCAGGCAGATCGCTTGAGCCCAGGAGTTCGAGACAAGCCCTGGCAACACAGTGAGACCCCATTTCTACAAAAAAAATAAAATTAGCCGGGTGTGCTGGCACACGCCTGTAGTCTCAGCTACTCACGCGGCTGAGGTGGAAGGATCGTTTGAGCCCTGGAGGTTGAGGCTGCAGTGAGCTGTGATTGCACCATTGCATTCCGGCCTGGGCAACAGAGTGAGACACTGTCTGAAAAAAAA"
"chr1","11776839","11777161","chr1","11060755","11061075","15","716084","GGCTGGGTACAGTGGCTCATGCCTGTAATCTCAGCACTTTGGGAGGCCAAGGTGGGAGGATTGCTTGAGCCCAGAAGTTCCAGACAAACCTGGGCAAGATAGCAAGACCCCATCTCTAAAAAATAAATAATTAATTAAAAAAATTTTTTTAATTAGCCAGATGTGGTGGCTTGCATCTGTAGTCCAAGCTACTCAGGAGACTGAAGTGGGAGATCACTTGTGCCCGGGAGTTCAAGGCTGCAGTGAGCCATGATTGCACCACTGCACTCTAGCCTGGGTGACAGAGCAAGACCCTGTCTCTGAAACAAAACAAAACAAACAAA","GCTGGGTACAGTGGCTCATGCCTGTAATCTCAGCACTTTGGGAGGCCAAGGTGGGAGGATTGCTTGAGCCCAGAAGTTCCAGACAAACCTGGGCAAGATAGCAAGACCCCATCTCTAAAAAATAAATAATTAATTAAAATTTTTTTTAATTAGCCAGATGTGGTGGTATGCATCTGTAGTCCCAGCTACTCAGGAGACTGAAGTGGGAGGATCACTTGTGCCCAGGAGGTCGAGGCTGCAGTGAGCCATGACTGCACGACTGCACTCTAGCCTGGGTGACAGAGCGAGACCCTGTCTCTGAAACAAAACAAAACAAAAAAA"
"chr1","11811044","11811323","chr1","11098355","11098632","31","712689","GGTTGGGTGCTGTGGCTTGCGTCTATAATCCTAGCACTCCTAAAACAGGAGATCGTTTTAGGCCAGAAGTTCGAGACCAGCCTGGGCAATAAAGTGAGATCCTGTCTCTATAAAAATAAGCTGGATGTGGTGGCATGCACCTGTAGTCCCAGCTACTTGGGAGGCTGAGATGGGAGGATCACTTGAGCCCAGGAGTTTGAGGTTACAATAAGCTATGATCACACCACCGTACTCCAGCCTGGGTGACAGAGTGAGATCCTGTCTCTAAAAAGATAAAGAA","GGTTGGGTGCTGTGTCTTGCGCCTGTAATCCTAGCACTTTGGGAGGCCAAAACAGGAGATCGTTTTAGGCCAGAAGTTCAAGACCACCCTGGGCAACACAGTGAGATCTTGTCTCTGTAAAAATAAGCTGGATGTGGTGGCATGCACCTGTAGTCCCAGCTACTCGGGAGGCTGAGATGGGAGGATCGCTTGAGCCCAGGAGTTTGAGGTTACAGTAAGCTATGATCACACCACTGTACTCCAGCCTGGGTGACAGAGTGAGATCCTGTCTCTAAAAA"
"chr1","11814615","11814929","chr1","188530204","188530518","58","176715589","GGCTGGGCGCAGCGGCTCACGCATGTAATCCCAGCACTTTGGGAGGCCGAGGCCAGCAGATTGCTTGAGCCCAGGAGTTCAAAACCAGCCTGGGCAACACAGCAAAACCCCATTTCTATAAAAAAAATGTTAAAAATTAGCCAGGTGTGGTGGCACGCGCCTGTGATCCCAGCTACTCAGGAGGCTGAGGTGGGAGGATCGCTTGAGCCTGGGAGGCATAGGTTGCAGTGAGCTATAATCATGCCACCCTACTCCAGCCTAGGCGACAGAGTGAGATCCTGTCCCAAAAAAGAAAAACAATAATAATAAAATAAA","GGTTGGGCGCAGTGGCTCATGCCTGTAGTCCCAGCACTTTGGGAGGCCGAGGTTGGAGGATTGCTTGAGGCCAGGAGTTCAAGACCAGCCTGGGCAACATAGCAAGACCCCATCTCTACAAAAAAAAATGTTTTAAATTAGTGAGGTGTGGTGGCACACACCTGTAGTCCTAGCTACTCAGGAGGCTGAGGTGGGAGGAATGCTTGAGACAAGGAGTTTGAGGCTACAGTGAGCTATGATTGAGCCACTGTACTCCAGCCTGGGTGACAGAGCAAGACCCTGTCTCTAAAAAGGGAGGACAAAAAAGAAAAAAAA"
"chr1","11831788","11832099","chr14","86579568","86579890","73","74747780","GCCTGGTGCAGCAGCTTACACTTGTAATCCCAGCACTTTGGGAGGCTGAGGTGGGAGGATAAATTGAGTTCAGATGTTCGAGACCGGCCTAGGCAACAAAGAGAGACCTTGTCTCTACTAAAAATAAAAGAAAAAAAATTAGCTGGGTATGGTGGTGAACATCTGTAGTCCCAGCTACTCGGGAGGCTGAAATGGGAGGATCACTGAGCCGGGAAGTCAAGGCTGAAATTACCACTTCACTCCAGCCTGGGTGACAGAGCAAGACTCTGTTTCAAAATAAAATAAAATAAAATAAAATAAAATAAAATAAAA","GGGTGTAGTGGCTCATGCCTGTAATCCCAGCACTTTGGGAGGCTGAGGTGGGAGGATTGCTTGAACTCAGGAGTTTGAGACCAGCCTGGGCAACACAGAGAGACCCCATCTCTACAAAAAGTAAAAAAAAAAAAATTAGGTGGGCATGGTGGTGTGCACCTGTGGTCCCAGCTACTTGGGAAGCTGAGGTGGGAGAATCGCTTGAGATCGAGAAGTGGAGGTCGCAGTGAGCCAATATTGTGCCACTGCACTCCAGCCTGGGTGACAGAGTGAGATCCTGTCTCAAAAAACAAAAGAATAAAAAATTAAAATTAAAATTAAAA"
"chr1","11832129","11832435","chr3","85172582","85172876","59","73340453","GGCCAGGTGCAGTGGCTCACACCTGTAATCCCAGCACTTTGGGAGGCTAAGGTAGGAGGATTGCTTGAGGCCGTGAGTTCAAAATCAGCCTTGCAAACATAGTGAGACTCTCCATCTCTACAGAAAAAAAAAATTATTTTAATTAGCCAGACATGGCGGCATACTCCTGTAATCCCAGCTACTTGGGAGGCTGACGTGGGAGGATCGCTGGAGCCCAAGAGTTTGAGGTTATATTGAGCTATGATCATGCCACTGCACTCCAGCCTTGGTGACAGAGCAAGACTCTGTCTCTATTTAAAAAAAAAAA","GGCTGGGAGCAGTGGGTTACACCTGTAATCCCAGCACTTTGGTAGGCTAAGGCAGAATTGCTTGAAGCCAGGAGCTCAAGGCCAGCCTAGGCAACATAGTGAGACCCTGACTCTACTAAAAATAAAAAATTAGCCAGGTATGGTGGCACATGCCTGTAGTCCCAGCTACTTGGGAGGTTGAAATGGGAAGATCACTTGAGCCCAGTAGTTTGAGGTTGCACTGAGCATGATCATGCCACTGCACTCCAGCCTGGGTGACAGAGCAAGACCCTGTCTCTAATAAAATAATAAAAAA"
"chr1","11844984","11845306","chr3","64187258","64187590","87","52342274","GGTGTGGTGGTGCACACCTGTAATCCCAGCACTTTGGAAGGCCCAGGTGGGAGGATTGCTTGAACCCAGAAGTTGAAGGCCAGCCTGGGCAACATCATGAGACCCTGCCTCTACAAAAAAAAAAAAAAGAAAGAAAGAAATTAATTAAATAAAATAAAAAATAGCCGGGTATGGTGGTGTCACCTATAGTCCTAGCTACCTGGAAGGCTGAAACGGGAGGATCACCTGAGCCCAGGAGCCCAGGATCACCCCACTACACTCCAGCCTGGGCGACAGAGTGAGACCTTGTCTTCAACAATAACAACAATAACAACAACAACAAA","CTGGGTGTGGTGGTTCACACCTGTAATCCCAGTGCTTTGGGAGGCTAAGGCAGAAGGACTGCTTGAACCCAGAAGTTTGAGACCAGACTGGGCAACATAATGAGACCCTTGTCTCAAATAAAATAAAATTAAAATAAAAAATAAAATATAGAATAAAATAAAATAGCCACATGTGGTGGCATGCATCTGTATTACTAGCTACTTAGGAGGCTGAGGTAGGAGGATCACCTGAGCCCAGTTCAAGGCTGTAGTGAGTTATGATCATGCCACTGCACTCCAGCCTGGATGACAGGGAGAGGCCCTGTCTCAGAAAAAAAACAAAACAAAACAAAA"
"chr1","11849782","11850092","chr3","184970694","184971000","62","173120912","GGCCAGGTGAAGTAGCTCATGCCTGCTATCCTAGCACCTTGGGAGGCTGAGATGGGAGGATCCCTTGAGTCTGGGAGTTTGAGACCAGCCTGGGCAACACAGTGAGACCCCATCTCTAAAAAAAATTAAAAATCAGTGAGGTATGGTGGTGCATGCCTGTGGATTCAACTACTTGAGAGGCTGAGGCAGGAGGATCACCTGAGCCCAGGAAGTTGGAGGCTGCAATGAGCCATGATCACACCACTGCATTCCAAGCTGGGTGACAGAGTGAGACCCTGTCTAAAAAAATATCAAAAATAAAAATAAATAAA","CTGGGTGCAGTGGCTCAGGCCTGTAATCCCAGCACTTTGGGAGGCTGAGGTGGGAGGAATGCTTGAGGCCAGGAGTTTGAGACCAGGCTGGGCAACATAGCAAGACCCCGTCTCTCCAAAACAATGAAAAATTTAGTGGGGTGTGGTGGCTCATGCCTGTGGTCTCAGCTCCTTGGGAGGCTGAGGCAGGAGGATCCCCTGAGCCAAGGAGTTCAAGGCTGCAGTAGGTCATGATCATACCACTGCACTCCAGCCTGGGCAACAGAGTGAGACCCTGTCTCTAAAAACAAAATAAAAATACAAAGAA"
"chr1","11852865","11853156","chr2","201476670","201476965","72","189623805","GGCACAATGGCTCACACCTGTAATCCCAGCACTTTGGGAGGCTGGGGTGGGAGGATCATTTGAGGCCAGGAGTTTGAGATCAGCCTGAGCAATATAGAGACCCCATCTCTACCTGCCCCCAACCCCCCACCAAAAAAAACAAAACAGAAATTAGCTAGACGTGGTGGCACCTACCTGTAGTCCCAGATGCTAGGGAAGCTGAGGTGGGAGAATGGCATAAGCCCAGGGGTTTGAGGCTGCTGTGAGCCATGATCACGCCACTGCACTCCAGCCTGGGTGACAGAGGGAGACC","CAGGCCTGGTGGCTCATGCCTGTAATCCTAGCATTTTGGGAGGCTGAGGTGGGAGGATCACTGGAGCCCAGGAGTTTGAGACCAGCCTGGGCAACATAGCGAGACTCCATCTCTACAGAAAAGTAAAAAAAAAAAAAAAAAAAGAAAGAAAAAATTAGCTGGGTGTGGTGGTGTGTACCTGTGTTTCCAGCTACTCAGGAGACTGAGGTGGGAGGATCACTTGAGCCCAGGAGGTTGAGGTTGTGGTGAGCTATGATAGCGCCACTGCACTCCAGCCTGGGCCACAGAGCGAGACC"
"chr1","11858103","11858410","chr1","11144452","11144735","42","713651","GGCCGGGTGCAGTGGCTCATGCCTGTTATCCCAGCACATTGGGAGGCTGAGGCAGGAGGATCCCTTGAGCCCAGGAGGTCAAGACCAGCCTGGGCAACATAGGGAGACCCCATCTCTACAAAAAAAAAAAGAGAAAGTTAGCTGGGCTGTGGTGTTGCACGCCTGTAGTCCTGGCAACTCAGGAGGCTGAGGTGGGAGGATCACTTGAGCCCAGGAGTTTGAGGCTGCAGTGAGCTGTGATCATGCCACTGCCCTCCACCCTGGGTGACAGAGCAAAATGCTGTCTCTGGAATAAATAAATAAATAAA","GGCTGGGCGCAGTGGCTTATACCTGTTATCCCAGCACATTGGGAGGCTGAGGCAGGAGGATCCCTTGAGCCCAGGAGTTCAAGACCAGCCTGGGCAACATAGGGAGACCTCCATCTTTACAAAAAAATTAAAAAGTTATCTGGCTGTGGTGCTGCACGCCTGTAGTCCTGACTACTCAGGAGGCTGAGGTGGAAGGATCACTTGAGCCCAGGAGTTTGAGGCTGCAGTGAGCTGTGATCATGCCACTGCCCTCCAGCCTGGGTGACAGAACAAAATGCTATCTC"
"chr1","11879214","11879491","chr1","11184807","11185094","21","694407","GGGTGCAGTGGCTCACACCTGTAATCCAACACTTTGGGAGGCCGAGGCGGAAGGATCGCTTGAGCCCAGGAGTTTGAGGCCAGCCCGGGCAACATGGCGAGGCCCCATCTCTACAGAACATTTTTTAAAAATTAGCCGGGTGTGGTAGCATGCACTTGTGGTCCCAGCTACTCAGGAGGCTGAGGTGGGAGGATCACTTGAGCCCAAGAGCTCGAGGCTGCAGTGAGCCATGATTGTACCACTGCACTGCAGCCTGGGAGACCCTGTTTCAAAATAAA","GGGTGCAGTGGCTTACACCTATAATCCAACACTTTGGGAGGCCAAGGCGGGAGGATTGCTTGAGCCCAGGAGTTTGAGGCCAGCCCGGGCAACATGGCGAGGCCCCATCTCTACAGAACATTTTTTTTAAATTAGCTGGGTGTGGTAGCATGCACTTGTGGTCCCAGCTACTCAGGAGGCTGAGGTGGGAGGATGACTTGAGCCCAAGAGCTCGAGGCTGCAGTGAGCCATGATTGTACCACTGCACTCCAGCCTGGGAGACAAAGGGAGACCCTGTTTCAGAATAAA"
"chr1","11881633","11881945","chr1","11186581","11186895","18","695052","GACTGAGCACAGTGGCTCACACCTATAATCCCAGCACTTTGGGAGGCTGAGACAGGAGGATCTCTTGAGCCCAAGACTTCGAGACCAGCCTGAGTGATATAGTGAGATCTTGTCTCTACAGAAAATTTTAAAAGTTAGCTGAGCATGGTGGTGGCGTGCACCTGTGATTCCAGTTACTTGGGAGGCTAAGGTGGGAGGATCGCTTGAGCCCAGGAGGTGGAGGTTGCAGTGAGCCAAGATCATACCACTGTACTCCAGCCTATGTGACAGAGTAAGATCCTATATCAAAACAAAACAAAAACAAACAAAAAAA","GACCGAGCACAGTGGCTCACATCTATAATCCCAGCACTTCGGGAGGCCGAGACAGGAGGATCTCTTGAGCCCAAAACTTCCAGACCAGCCTGAGTGATATAGTGAGACCTTGTCTCTACAGAAAATTTTAAAAATTAGCTGAGCATGATGGTGGCGAGCACCTGTGATTCCAGTTACTTGGGAGGCTAAGGTGGGAGGATCACTTGAGTCCAGGAGGTGGAGGTTGCAGTGAGTCAAGATCACACCACTGTACTCCAGCCTTTGTGACAGAGTAAGATCCTATATCAAAACAAAACAAAACAAAAACAGAAAAAA"
"chr1","11889101","11889389","chr1","11195037","11195328","22","694064","GGCAGGGCCTGGTGGCTCATGCCTATAATCTCAACACTTTGGGAGGCTGAGGTGGGAGGATCCTTTGAGCCCAGTAGTTTGAGACCAGCCTGGGCAGGATAACGAGGACTTGTCTCTACAAAAAATTTAAAAATCAGCCAGGCGTGATAGTGCACGCTTGTAGTCCCAGCTACTTAGGAGGCTGAGGTGGGAGGATCACTTGAGCCCAGGAGTTTGAGACTGCAGTGAGCTGTGATTACACCATTGCACTCCATCCCAGGTGACAGAGTGAGACCCTGTCTAAAAATAA","GGCAGGGCCTGGTGGCTCATGCCTGTAATTTCAACACTTTGGGAGGCCAAGGTGGGAGGATCCTTTGAGCCCAGGAGTTTGAGACCAGCCTGGGCAGGAAAACGAGGACTTGTCTCTACAAAAAATTTAAACATTAGCCATGTGTGGTGGTGCACACTTGTAGTCTCAGCTACTCAGGAGGCTGAGGTGGGAGGATCACTTGAGCCCTGGAGTTTGAGGCTGCAGTGAGCTGTGATTACACCATTGCACTCCATCCCAGGTGACAGAGTGAGACCCCATGTAAAAATAATAA"
"chr1","11896524","11896839","chr1","11203437","11203745","34","693087","GGCCAGGTGCCATGACTCACGCCTGTAATCCCAACACTTTGGGAGGCTGAGGTGGGAGGATCCTTTGAGACCAGGAGTTCAAGACCAGCCTGGGCAACATAGACCCGTCCCTCCGCCCCCACCCACCTCCCGTCTCCACAAAAAAATTAGGAGGGCATGGTGGTGTGCGCCTGTAATCTCAGCTTCTCAGGAGGCTGAAGTGAGAGGATCATTTGAGCCCAAGAGGTTGAGGCTGCAGTGAGCCGTGATTGTACCACTGTACTTCTGCCTGAGTTACAGAGTAAGACTCTGTCTCAAAAAAAAGGAAAAGAAAAAA","GGCCGGGTGCCATGACTCACGCCTGTAATCCCAACACTTTGGGAGGCCGAAGTGGGAGGATCCTTTGAGACCAGGAGTTCAAGACCAGTCTGGGCAACATAGTAAGACCCGTTGCCCCACCCCCACCCACCTCCTGTCTCCACGAAAAACATTAGGAGGGCGTGGTGGCATGCGCCTGTAATCTCAGCTTCTCAGGAGGCTGAAGTGGGAGGATCACTTGAGCCTAAGAGGTTGAGGCTGCAGTGAGCCGTGATTGTACCACTGTACTTCTGCCTGAGTTCTGTCTCAAAAAAAAAGGAAAAGAAAAAA"
"chr1","11906371","11906612","chr1","11213679","11213920","23","692692","GGGTGGGGTGGCTCACATCTGTAATGTCAACACTTAGGGAGACCAAGGCAGGAGGCTTATTTGAGGCCCTGAGTTCAAGACCAAACTGGGCAACAAAGTGAGACCCTGTCTCTACAAAAAATTAAAAAATTAGCCAGACATGGTGGCACGCACCTCTAGGCCCAGCTACTCAGGAAGCTGAGGCAGGAGGATTGCTTGAGCCCAGGAGGTGAAGGCTGCAGTAAGCTATAGTCATGCTACTG","GGGCAGGGTGGCTCATGCCTGTAATGCCAGCACTTAGGGAGACCAAGGCAGAAGGCTTAATTGAGGCCCTGAGTTCAAGACCAACCTGGGCAACAAAGTGAAACCCTGTCTCTATGAAAAATTAAAAAATAAGCCAGGCGTGGTGGCACGCACCTGTAGTCCCAGCTACTCAGGAAGCTAAGGCAGGAGGATTGCTTAAGCCCAGGAGGTGAAGGCTGCAGTGAGCTATAATCATGCCACTG"
"chr1","11911487","11911803","chr1","11220123","11220435","42","691364","GGCCGGGTGTGGTGGCTCACGCCTGTAATCCCAGCACTTTGGGAGGCCAAGGTGCGCAGATTGGTTGAGGCTGGGAGTTCCAGACCAGCCTGAGTAACATGGCGAAACCTCATCTCCACTAAAAAATTTAGCTGGGCTTGGTGGGGTGCACCTGCAGTCCCTCCCAGCTACTTGGGAGGCTGAGGTGGGAGGATCACCTGAGTGCAGGAAGTCAAGGTTGCAGTGAGCCATGAGCCATGATTGTGCCTCTGCACTCCAGCCTGGGCAACGGGAGTGAGATTGGGTCTCAAAAAAAAAAAAAAACCAAAAAACAAAAA","GCTGGGTGTGGTGGCTCATGCCTGTAATCCCAGGACTTTGGGAGGCCGAGGTGGGCAGATCGGTTGAGGCCAGGAGTTCCAGACCAGCCTGAGCAACATGGCAAAACCTCGTCTCCACTAAAAAATTTAGCTGGGCATGGTGGTGTGCACCTGTAGTCCCTCCTAGCTACTCGGGAGGCTGAGGTGGGAGGATCACCTGAGTGCAGGAAGTTGAGGCTGCAGTGAGCCATGATTGTGCCTCTGCACTCCAGCCTGGGCAACAGGAGTGAAATTGGGTTCCCCTGCCCAAAACAAAAAACAAAAACAAGAAAGA"
"chr1","11920174","11920467","chr2","84913076","84913368","53","72992902","GTCGGGTGCGGTGGCTCCCTCCTGTCATTCCAGCACTTTGGGAGGCTGAGGCAGAAGGATCACTTGAGCCCAGGAGCTTGAGACCAGCTTGGGCAACATAGCAAAACTTCATCTCTATAAAAAATTTTAAAATTAGCCAGACATGGTGACGCAGGCCTATAGTCCCAGCTACTCAGGAGGCTGAGGTGGGAGGATCGCTTGAGTCCGGGAGGCTGAGGCTGCAGTGAGCTATGTTTCTGCCACTGCGCATCAGCCTGGGTGACAGTGAGACCCTGTCTCAAATAAATAAATAAA","GGCTGGGGGCAGTGGCTCACACCTGTAATCCCAAAATTTTGGGAGGCTGAGGTGGGAGGATCGCTTGAGCCCAGGAATTTGAGACTAACCTGGGCAACATAGTGAGACTGTCTCTACAAAAAATTTTAAAATTAGCCAGGTGTGGTGGCACATGCCTGTAGTCCCAGCTACTCGGGAGGCTGAGGTGGGAGGATTGCTTGAGCCCAGGAGGTCAAAGCTGCAGTGAGCCATGATCTTGCCACTGCACTCCAGCCTGGGTGACAGCGAGACCCTGTCTCAAAAAAAAAAAAAAA"
"chr1","11927047","11927355","chr1","11242481","11242790","25","684566","GGCCGAGAGCAGTGGCTCATGCCTGTAATCCCTGCACTTTGAGAGGCCAAAGTTGAAGGATTGCTTGAGGCCAGGAGTTCGAGAGCAGCCTGGGCAACATAGTGAGACCCTCTCTCTTCAAAAATAAAAAAAAATAGCCAAGTGTGGTGGCTTGAACCTGGGGTCCCAGCTACTGAAGAAGCTGAGGCAGGAGGACCTCTTGAGCCCGGGAAGTCGAGGTTGCATGAGCTATGATTGCACCACTGTGTTCCAGCCTGGGAAACAGAGCAAGACCTTGTCTCATAAAGCAAAACAAAAACAAAGAAAGAA","GGCTGGTGGCAGTGGCTCATGCCTGTAATCCCTACACTTTGAGAGGCCAAAGCTGAGGGATCGCTTGAGGCCAGGAGTTCGAGAACAGCTTGGGCAACATAGCGAGACCCTATCTCTTCAAAAATAAAAAAAAATAGCCAGGTGTGGTGGCTTGGACCTGGGGTCCCAGCTACTCAAGAGGCTGAGGCGGAAGGACCTCTTGATCCCAGGAAGTCGAGGTTGCAGTGAGCTATGGTTGCACCACAGTGCTCCAGCCTGGGAAACAGAGCGAGACCTTGTCTCATAAAGCAAAACAAAAACAAAGAAAGAA"
"chr1","11944638","11944914","chr1","11263446","11263721","17","681192","CCTGTAACCCGGCATTTTGGGAAGCCGAGGCAGGAGAAGATTGCTTGACTCCAGGAGTCCAGGAGTTCAGGAGACCAGCCTGGGTAACAAAGTGAAATGCTTCCCCATGTCTACAAAAGATAAATATTAGGCATGGCTGCAGCATCTGTGGTCAGCTACTTGGGAGGCTGAGTGAGGTGGGAGGATTACTTGAGCCCAGGAGTTCGAGGCTGCAGTGAGCGGTGATTGCACCACTGCACTCCAGCCTGAGTGACAGAGTGAGACTCTGGCTCAAAGA","CCTGTAACCCAGCATTTTGGGAAGCTGAGGCAGGAGATTGCTTGACTCCAGGAGTCCAGGAGTCCAGGAGACCAGCCTGGGTAACAAAGTGAAATGCTTACCCATGTCTACCAAAAATAAATATTAGGCATGGCTGCAGCATCTGTGCTCCCAGCTACTCAGGAGGCTGAGTGAGGTGGGAGGATTACTTGAGCCCAGGAGTTCGAGGCTGCAGTGAGCCGTGATTGCACCACTGCACTACAGCCTGAGTGACAGAGTGAGACTCTGGCTCAAAAA"
"chr1","11953298","11953626","chr12","65551151","65551448","74","53597853","GGCTAGGCATGGTGGCTCACGCCTTTAATCCCAGCACTTTAATCCCAACACTTTGGGAATCCAAAGTGAGAGGATCATTGGAGCCCAAGAGTTTGGGAGCAGCCTGGGCAACATAAGAAGACCCTGTCTCTACAAAAAATTTTAAAAAAATTAGTGGGGCGTGGTGGTGCATGCCTGTGGTCTCACGTACTCAGGAGGCTGAGGTGGGAGGATTGCTTGGGCCCAAGAGGTTGAGGCTGCAGTGAGCTGTGATTGTGCCACTGCACTCCAGCCCAGGTAACAGCGAGATCTTGTCTCAAAATAAAAAATAAATAAGTAAATAAACAAAA","GGCTGGGCATGTGGCTCATGCCTAAAATCTCAACACTTTGGGAGGCCGAGGTGGGAAGATTGCTTGAGCCCAGGAGTTCAAGACCAGCCTGGGCAACATAGGGAGACCCGTCTCTACAAAAAATTTAATAAATTTGCCAGGTGTGGTGGTGCATACCTGTGGTCCCAGCTAGGAGGCTGAGGTAGGAGGATCGCTTGGGCCCAGGAGGTTGAGGCTGCAGTGAGCTGTGATCGTGCCACTGCACTCCAGCCTGGAAGATAGACTGAGACCTTGTCTCCAAAAAAAAAAAAAAAAAAAA"
"chr1","11958379","11958541","chr1","11276422","11276579","16","681957","AAAAATAAGTCAGGCTTGATGGCATGCACCTGCAGTCCCAGCTGCTCAGGAGGCTCAGGTGGGAGGATCACCTGAGCCCAGGGAGGTCGAGGCTGTAATGAGCTTCCAGCCTGGGTGACAGAGAACCCTGTCTCAAAAATCAAATAAATAAATAAAATATAAA","AGTCAGGCTTGATGGCATGCACCTGCAGTCCCAGCTACTCAGGAGGTTCAGGTGGGAGGATCACCTGAGCCCAGGGAGGTCGAGGCTGTAACGAGCTTCCAGCCTGGGAGACAGAGAACCCTGTCTCAAAAATCGAATAAATAAAATATAAATTAAAA"
"chr1","11960520","11960856","chr1","11278318","11278620","53","682202","GGCGGGGTGCAGTGGTTCACACCTGTAATCTCAGCACTGGGAGGCTGAGGCAGGAGAATTGCTTGAGCCCAGGAGTTTGAGACCAGCCTGAGCAACATGGCAAGACCCCATCTCTACCAAAAATTTAAAAATTAGCTGGGCGTGGTGGCAGCTATAGTCTATATATAGGTGGTACCTATAGTCTAAGCTACTTGGGAGGCTGAGGTGGGAGGATCATTGAGCCCTGATGGTCGAGGCTGCAGTGAGCTGTATTCATGCCACACGCCACTGCACTCCAGCTTGGGCGAGAAAGCAAGATCCCATATACAAAAAAAACAAACAACAACAACAACAAAAA","GGCTGGGTGCAGTGGTTCACACCTGTAATCCCAGCACTGGGAGGCTGAGGCAGGAGAATTGCTTGAACCCAGAAGTTTGAGACGAGCCCAAGCAACATGGCAAGACCCCATCTCTACAAAAAATTTAAAAATTAGCTGGGCGTGGTTGCACGTACTTATAGTGTAAGCTACTTGGGAGGCTGAGGTGGGAGGATCATTGAACCCTGATGGTCGAGGCTTCAGTGAGCTCTATTCATGCCACACGCCACTGCACTCCAGCTTGGGTGACAAAGCAAGACCTTGTATCAAAAAAACCCAAAAAAA"
"chr1","11985870","11986075","chr2","192152416","192152638","56","180166546","CCAGCCTGGGCAACATGGCAAAACCCCGTCTCTACAAAAATGAGCCAGGCACGTACCTGTAGTCCCAGCTACTCGGGAGGCTGAGATGGGAGGATCACCTGAGTCCAAGAGGCTGAGGCTGTGGTGAGCTTTGATTGCACCACTGCACTCCAGCCTGACTGAGAGACCCTGTCTCAATAAATAAATTAATTTAAGAAAGAAAGAAA","CCAGCCTGAGCAACATGGCAAGACCCCGTCTACACTAAAAATAGAAAAATCAGCCGGGTGTGGTGATACGTACCTGTGGTCCCAGCTACTCAGGAGGCTGAGATGGGAGGGTCACCTGAGCCCACAGGCCAGAGGTTGCAGTGAGCTGAGATTGCACCACTGTACTCCAGCCTGGGCAACAGAGTGAGACCCTGTCTCAAACAAAACAAAACAAAACAAAAAA"
"chr1","12057716","12057996","chr1","11384052","11384336","19","673664","CAGGCATGGTAACTCATGCCTGTAATCCCAACACTTTAGGAGGCTGAAATGGGAGGATCACTTGAGGCCAGGAGTTTGAGACTAGCCTGGGCAACAAGGCAAGACCCCATCTACAACAATAGAAAATTAGCCAGGTGTGATGTCACATTGTACTCCTAGCTACTCAGAAAGCCTGAGGTGGGAGGATCACTTGAGCCCAGGAGTTAGAGGTTGCAGTGGGCTATGATCATGCCACTGCACTCCAGCCTGAGTGACAGAGCAAAACCCTGTCTCTGAAACAA","GTCAGGCATGGTGCCTCATGCCTGTAATCCCAACACTTTAGGAGGCCGAAGTGGGAGGATCACTTGAGGCCAGGAGTTGGAGACTAGTCTGGGCAACATGGCAAGATCCCATCTACAACAATAGAAAATTAGCTAGGTGTGATGTGCACACTTGTACTCCTAGCTACTCAGAAAGGCTGAGGTGGGAAGATCACTTGAGCCCAGAAGTTAGAGGTTGCAGTGGGCTATGATCGTGCCACTGCACTCCAGCCTGGGTGACAGAGCAAAACCCTGTCTCTAAAACAA"
"chr1","12066711","12067010","chr1","11397782","11398082","31","668929","GGCCGGCTTGGTGGCTGATGCCTGCAGTCTCAGCACTTAGGGAGGCCAGGCTGGGAGAATCACTTGAGGCCAGGAGTTTGAGACCAGCCTGGGCAACACAGTGAGATCCCCATCTCTACACAAAATAAAATACATTAGCTGGGTGTGGTGGCATGCGCCTGTAGTCCCAGCTACTCAGGAGGCTGAGGTGGGAGGATGGCTTGAGCCCAGGAAGTTGAGGTTACAGTGAGCTGTGATCATGCCACTGCACTCCAGCCTGGGCAACAGAGCAAGACCCTGTTTCAAAAAAAAAGATAAAAA","GGCCAGGCTTGGTGGCTCATGCCTGCAGTCTCAGCACTTCGGGAGGCCAGCCTGGGAGGATTGCTTGAGGTCAGGAGTTTGAGACCCGCCAGGCAACACAGCGATACCTCCATCTCTACAAAAAATAAAATAAATTAGCTGGGTGTGGTGGCATGTGCCTGTAGTCCCAGCTACTCAGGAGGCTGAGGTGGGAGGATTGCTTGAGCATAGGAGGTTGAGCCTGCAGTGATCTGTGATCGTGCCACTGCACTCCAGCCTGGGCAACACAGCAAGACCCTGTTTAAAAAAAAAGTGATAAAAA"
"chr1","12084121","12084302","chr1","11416905","11417083","14","667216","TACAAGAATCGGCCAGTCATGGTGGCTCACGCCAGTAATCTCAGCACTGTGGGAGGCTGAGGTGGGAGGATCGCCCGAGCCCAGGAGTTCAATGCTGCAGTGAGCCAAGATCATGCCACTGCACTCCAGCCCGGAACATAGAGTGAGACCCTGTCTCTAAAAATAATAATAATAATAAAAGA","TACAAGAATCAGCCAGTCATGGTGGCTCACGCTGGTAATCTCAGCACTGTGGGAGGCCGAGGTGGGAGGATCGCTTGAGCCCAGGAGTTCAAGGCTGCAGTGAGCCAAGATCATGCCACTGCACTCCAGCCTGGAACACACAGTAAGACCCTGTCTCTAAAAATAATAATAATAAAAGA"
"chr1","12130022","12130314","chr1","11463189","11463480","21","666833","GGCCGAGTGCAGTGGCTCACACCTATAATCCCAGCACCTTGGGAGGCCAGAGGCGGGAAGATCACTTGAGGGTGGGAAGAACACTTGAGCTCAGGAGTTCGAGACCAGCCTGGACAACATGGCGAAACCCCATCTCTATAAAGAAATCAGCCCAGCATGGTGGCCCGAGCCTGTAGTCCCAGCTACTCGGGAGGCTGAGGTGGGAGGATCGCTTGAGCGCAGGAGTTGGAGGCTGCAGTGAGCTATGGGTGAAAGAGTGAGACCTTGTCTCAAAAAAAATTAAAAAATAAGAA","GCCAGGTGCAGTGGCTTACACCTATAATCCCAGCACCTTGGGAGGCCACAGGTGGGAAGATCACTTGAGGGTGGGAAGAGCACTTGAGCTCAGGAGTTCGAGACCAGCCTGGGCAACATGGCGAAACTCCGTCTGTACAAAAAAATCAGCTCAGCCTGGTGGCCCGAGCCTGTAGTCCCAGCTACTCTGGAGGCTGAGGTGGGAGGATCGCTTGAGACCAGGAGTTGGAGGCTGCAGTGAGCTATGGGTGACAGAGTGAGACCTTGTCTCTAAAAAAACTAAAAAATAAGAA"
"chr1","12156769","12157074","chr1","11491196","11491490","33","665573","GGCCGGATGCAGTGGCTCAAGCCTGTAATCCCAGTGCTTTGGGAGGCCAAGGAGGCTGGAGGATTGCCTGAGGCTAAGAGTTTGAGGTCAGTCTGGGTAACACAGCGAGACTCCATCTCTATAAAAAAATTAAAAAATTATTTGGGTGGGATGGTGCCTATTGTCCCAGCTACTCAGGAGGCTGAGGTGGGAGGATCACATGAGCCCAGGAATTTGAGGCTGCATTGAGCTCTGATCGTGCCACTGCACTCCAGCCTGGGTGATGAGTGAGGTCCTATCTCAAAAACAAAACAAAACCAAACAAAA","GGCCGGATGCAGTGGCTCACGCCTGTAATCCCAGTGCTTCAGGAGGCCAAGGAGGCAGGAGGATTGCTTGAGGCTAAGAGTTCGAGATCAGCCTGGGTAACATAGTGAGACCCCATCTCTATAAACAAATTAAACAATTAGTTGGGTGGGATGGTGCCTGTTGTCCCAGCTACTCAGGAGGCTGAGGCGGGAGGATCACATGAGCCCTGGAATTTGAGGCTGCATTGAGCTATGATCATGCCACTGCACTCCAGCCTGGGCGATGAGTGAGGCCCTATCTCAAAACAAAACGAAA"
"chr1","12176998","12177285","chr1","11511878","11512168","31","665120","GGCCAGGCATGATGGCTCACGCCTGTAATCCCAGAACTTTGGGAAGCCGAGGTGGGTGGATCGCTTGAGTTCAGAAGTTCGAGACCATCCTGGGCAACATAGCAAGACTCCGTCTCTATGAAAATGAGCTGGGCATGGTGGCATGCGCCTGTGGTCCCAGCTACTCAGGAGGCTGAGGCGGGAAGATTGTGTGAGCCCAGGAAGTCGAGGCTGCAGTGAGCCATGACCTGTGCCACTGTACTCCAGCCTGGGTGACAGGGTGAGACCCTAAAAAAAAAAAAAAAAAAA","GGCCAGGCATGACAGCTCGTGCCTGTAATCCCAAAACTTTGGGAAGCCAAGGTGCGTGGATCGCTTGAGCTCAGGAGTTCGAGACTAGCCTGGGCAACATAGCGAGACCCCGTCTCTATGAAAATGAACTTGGCGTGGTGGCATGCACCTATGGTCCCAGCTACTCAGGAAGCTGAGGCGGGAAGATTGCGTGAGTCCAGAAATTCGAGGCTGCAGTGAGCCATGACCTGTGCCACTGCACTCCAGCCCGGGTGACAGAGTGAGACCCTGTCCGAAAAAAAAAAAAAAAAA"
"chr1","12180365","12180536","chr14","2894541","2894688","46","9285824","AGCCCGGCATGGTGGCTCAAGCCTGTAATCCCAGCACTGTGGGAGGCTGAGGTGGGAGAATTGCTTGAGCCCAGGAAGTCGAGGCTGCAGTGAACCGTGATTAAGTCGAGGCTGCAGTGAACTGTGATCGAGTCACTGTACTCCAGCCTGGGTGGCAGAGTGAGACCCTGTC","TCAGCTGGGCATGGTGGCTCACGCCTGTAATCCCAGCACTCTGGGAGGCTGAAGAGGGAGGATGGCTTGAGCCCCGGAGTTTCAAGTTGCAGTGAGCTATGATTGTGCCACTGCACTCCAGCCTGGGTGCAGAGTGAGACCCTGTCTC"
"chr1","12181977","12182102","chr9","82847515","82847637","16","70665538","GACTGGGTATGGTGGCTCACACCTGTAATCCCAGCACTTTGGGAGGCCCAAGGTGGGAGGATGGCTTGAGGCCAGGAGCTTAATACCACCCTGGGCAACATAGGGAGACCTCGTCTCTACCAAAAA","GGCTGGGCACAGTGGCTCACGCCTGTAATCCCAGCACTTTAGGAGGCCAAGGTGGGAGGATCGCTTGAGGTCAGGAGTACAAGACCAGCCTGGGCAACATAGGGAGACCCGTCTCTACAAAAA"
"chr1","12191186","12191469","chr2","54682020","54682302","66","42490834","GGCCTGGCACCGTGGCTCACACCAGTAATCCTAGCACTTTGGGAGGCCAAGGCAGTGGGGGGGATTTTTTGAGGCCAGGAATTCAAGACCAGCCTGTGCAACATAAGGAGACCCCAATCTCTACAAAAAATTATAAATGAAAAAATTAGCTGGGCACGGTGGCACATACCTGTACTCCCAACTACTGGGAGGAGGATTGCTTGAGCCCATGAGTTCAAGGTTACAGTGAGCAATGATCATGCCTGTGCACTCCAACCTGCGCAACAGAGACCCTGTCTCAAAAA","GGCCAGGCGTGGTGGCTCACGCCAGTAATCCCAGCACTTTGGGAGGCCGAGGCGGGTGGATGGCTTGAGGCCAGGAGTTCAAGACCAGCCCGGGCAACATAACGAGAAACTGTCTCTACAAAAAATGATTTAAAAAAAAAAATTAGCTGGATACGGTGGCATGCACCTGTGGTCCCACTGAGGTGGAGGATCACTTGAGCCTGGGAAGTCAAGGCTGCAGTGAGCTGTGATTGAGCCACTGCACTCTAGCCTGCGCAACAGAGGGAGACCCTGTTTCAAAAAA"
"chr1","12203969","12204286","chr6","67166681","67166993","57","54962712","GGCCAGGTGCGGCAGCTCACACCTGTAATCCCAGCACTTTGGGAGGCTGAGGCTGGGAAATCGCTTGAGCCGAGGAGTTCAAGACCAGCCTGGGCAATAGAGCAAGACCCCAACTCTACAATAAATTTTTAAAAATTAGCCAGGCATGGTAGCACACACCTGTAGTCCCAGCTACTGGGGAGGCTGAGGTAGGAGGATCGCTTGAGCCCAGGAGGTCAAGGCTGCAGTGAGCTATACTCACACAACTGCACTCCCAGCCTTGGTGACAGAGCTAGACCCTGTCTCTAAAAAAGAAAAAGGGAAAAAAAAAGAAGAAAA","GGCTGGGTACGGTGGCTCAAAGTCGTAATCCCAACGCTTTGGGAGACGGAGGCAAGAGGATCGCTTGAGGCCAGGAGTTCAAGACCAGCCTGGGCAATTCAGTGAAACCCCATCTCTACAAAAAATTTAAAAATTAGCCAGGTGTGGTGCACACACCTGTGGTCCTAGCTACTCAGGAGGCTGAGGCAGGAGGATGGCTTGAGCCCAGGAGTTCAAGGCTGCAGTGAGCCACGATCACACCACTGCACTCCAGCCTAGGCGACAGAGCAAGATTCTGTCTCTTAAAAAAAAAAAAAAAAAAAAAAAAAAAAAA"
"chr1","12206459","12206568","chr5","1889927","1890031","16","10316532","GACTGGACTTGGTGGCTTTCACCTGGAATCCCAGCACTTTGGGAGGCTGAGGCAGGAGGATGACTTGAGGCCAGGAGTTCAAGACCAGCCTGGGCAACATAGCTTGACTC","GACATGGTGGCTCACACCTGCAATCCCAGCACTTTGGAAGGCCGAGGTGGGAGGATCACTTGAGGCCAGGAGTTCAAGACCAGCCTGGGCAACATAGCAAGACCC"
"chr1","12248928","12249031","chr7","168511583","168511686","13","156262655","GGCTGGGCACAGTGGCTCATGCCTGTAATCCCAGCACTTTGGGAGGCCAAGGCAGGCCGATCACTTGAGGCCAGGAGTTTGAGACCAGCCTGGGCAACATGGTG","GGCTGGGCACTGTGGCTCACGCCTGTAATCCTAGCACCTTGGGAGGTCAAGGTGGGTGGATCAGTTGAGGCCAGGAGTTTGAGACCAGTCTGGGCAACAGAGTG"
"chr1","12253979","12254251","chr1","11587895","11588169","31","666084","GGTGCGGTGGGTCATGCCTGTAATCTAAGCTCTTTGGGAGACCAAGGCAGATGGATTGCTTAAAGCCAGGAGTTCGAGACCGCCCTTGGCAACATAGACACTGTCTCTATAGAAGAAAAAAGCCGTCTGTGTGTGGTGGTATGCAACTGTAGTTCTAGCTACTTGAGAGGCTGAGGTGGGAGGATCCCTTAATCCCAGGAGTTGGAGGCTGCAGTGAGCCATGACTGTGCTACTGCACTCTAGCCTGGGTGACGAAGGGGGGCCTTGTCTCAA","GGTGCGGTGGGTCACACCGTAATCTAAGCTCTTTGGGAGGCCAAGGCAGATGGATTGCTTGAAGCCAGGAGTTTGAGACCATCCTGGGCAACATAGGGAGACGCTGTCTCTACAGAAGAAGAAAACCATCTGGGTGTGGTGGTATGCAACTGTAGTTCTAGCTATTTGAGAGGCTGAGGTGGGAGGATTCTTTGATCCCAAGAGTTGGAGGCTGTAGTGAGCCATGATTGTGCTACTGCACTCCAGCCTGGATGACGGAGGGAGGCCTTGTCTCA"
"chr1","12275199","12275465","chr1","11609589","11609864","26","665610","GGCTAGGCGCAGTGGCTCAGGCCTGTAATCCCAGCACTTTAGGAAGCCAAGGCAGGAGGATTGCGTGAGGCCAGGAATTCCAGACTGGCCTGGGCAACATAGTGAGAGACCCTGTCTCTACAAAAAATTAAAAAACTAGCTGCGCATGGTGGTGCATGCCTGTAGTCCCAGCTACTCAAGGCGTTAAGGTGAGAGAATCACTTGAACCAGGAGATTGAGGCTGCAGTGAGCCATGATCACACCACTGCACTCCAGCCTAGGTGACAG","CTGGGCGCAGTGGCTCAGGCCTGGAATCCCAGCACTTATGGGAAGCCAAGGCAGGAGGATTGCTTGAGGCCAGGAATTCCAGACTGGCCTGGGCAACATAGTGAGAGACCCTGTCTCTACAAAAAATTAAAAAACTAGCTGCACATGGTGGTGCATGCCTGTAGTCCCAGCTACTGAAGAGGCTAAGGTGAGAGGATCACTTGAACCAGGAAGTTGAGGCTGCAGTGAGCCATGATCACACCACTGCACTCCAGCCTAGGCGACAGAGCTGAAACC"
"chr1","12285785","12286069","chr1","11621384","11621675","26","664401","GTGGCTCACACCAGTAATCCCAATACTTTGGGAGGCTAAGGCAGGGGGACTACTCGAGACCAGGAACTCAAGACCAGCCTGGGCAAAATAGCAAGACCCCATCTCTAAAAAGAAAAGGTAAAAATTAGTAAGGCATGATGGCACACACCTATAGTCCCTCCCAGCTACTCAGGAGGCTGAGGAGTGAAGATAGCTTGGGCCCAGGAGTTTGAGGCTGCAATAAGCTATGATCACACCACTGCTCTCCAACCTGGGTGACAGAGCAAGACCCTGTCTCAAAATAAA","GGGCACAGTGGTTCACACCTGTAATCCCAACACTTTGGGAGGCTAAGGTAGGGGGACTACTTGAGATCAGGAACTCAAGACCAGCCTGGGAAAAATAGCAAGACCCCGTCTCTACAAAAAAATATTAAAAATTAGTGAGGCATGGTGGCACACACCTGTAGTCCCTCCCAGCTACTCAGGAGGTTGAGGAGGGAAGATAGCTTGGGCCCAGGAGTTTGAGGCTGCAATGAGCTATGATCACACCACTGCTCTCCAACCTGGGTGACAGAGCAAGACCCTGTCTCAAAATAAA"
"chr1","12297314","12297616","chr1","11633519","11633804","38","663795","GGCCGTGCGCATTGGCTCATGCCTGTTATCCCAGTTCTTTGAGAAGCCAAGATGGGAAGCTCATTTGAGGCCAGAAGTTCCAGACCAGCCTAGGCAAAATTGTGAGACCTTGTCTCTACAAAAATAAACAATTAGCTGGGCATAGTGGTGTGCGCCTGTAGTCCCAGCTACTCAGGAGGCTGAGGTGGAAGGATTACTTGAGTGCAGGAGTTCAAAGTTACAGTGAGCTATGATTGTGCCAGTGTACTCCAGCCTTGGAGACAGAGCAAGACCCTGTCTCTAAGAAACCAACCAAACAAAAAA","GGCTGTGCACATTGGCTCATGCTTGTAATCCCAGGTCTTTGGGAAGCCAAGATGGGAGGCTCACTTGAGGCCAGAAGTTCCAGACCAGCCTGGGCAACATTGTGAGACCTTGTCTCTACAAAAATAAACAATTAGCTGGACATAGTGGCGTGCATCTGTAGTCCCAGCTACTCAGGAGGCTGAGGTGGAAGGATCACTTGAGCACAGGAGTTCAAGGTTACAGTGAGCTATGATCGTGCCAGTGTACTCCAGCCTTGGAGATGGAGCAAGACCCTGTCTCTAAAAA"
"chr1","12316959","12317124","chr9","15628977","15629142","34","3312018","TTAGCTAGAGGTGGCGGCAGTACATGCCTGTAGTCCCAGCTTCTCAGGAGGCTGAGGCGGGAAGATTACTTGAGTCTAGAAGTTCGAGGCTTCAGTGAGCTATGTTCACGCTACTGCCCACCAGCCTGAGCAACAAAGTAAGACCCTGTCTCTTAAAAAAAAAGAA","AAATGAGCCAGGCATGGCAGTACATGCCTGTAGTCCCAGCTACTCAAGAGGCTGAGGCAGGAGGATTGCTTGAGCCCAGAAGTTGGAGGCTGCAGTGAGCTATGATCATGCTACTGCACTCCAGTTTAGGCAACAGAGTGAGACCCTGTCTCCAAAAATAAATAAA"
"chr1","12346692","12346961","chr8","78511957","78512224","58","66165265","GGCACAGTGGCACACACCTGTAGTCCAAGCTACTTGCGAGGCTAAGGTGGGAAGACCGCTTGATCCCAGAAGTTCAAGACCAGCCTGGGGAACACAGCGAGACCCTATCTCCACAAAAAATGAAAAGTAATTAGCTAAGCATGGTGGCATGCACTTACGTTCCAGCTATTCGGGAGGCTGAGGTGGGAGGATCACCTGAGCCCAGGAGTTCCAGGCTATAATGAGCTATGATTTTGCCACTGCCCTCCAGCCTAGGTGAAAGAGAGTGAC","GGAGCAGTGGCTCATGCCTGTAATCACAGCACTTTGGGAGGCCAAGGTGGGAGGATCGCTGATGTCCAGGAGTTCAAGACCAGCCTGAGTAACATAGTGAGACTTCATCTCTAGAAAAAATAAAAAATTAGCTGGGTGTGGTGGCATGCACTTGGTAGTACCAGCTACTCAGGAGGCTGAGGTGGGAGGATCATCTGAGCTCGGAGGTTGAGACTGCAGTGAGCTGTGATCATGCCACTGCCCTCCAGCCTGGGTGACAGAGTGAGAC"
"chr1","12375132","12375359","chr11","132565033","132565283","68","120189901","GTAATCCCAGCACTTTGGGAGGCTGAGATGGGTGGATCACTTGAGGCCAGGAGTTGAGCAACAAAGTGAGACCCTGTCTCTCCAAAAAAAAAAAAAAAAAAAATACAGCTGGGCATGGTGGTATGTACCTGTAGGGGGAGGCTGAGGCAGGAGGATCACTTGAGCCCAGGAGGTCCAGGCTGCAGTGAGCCAAGATCCCGCCACTGTACTCCAGCCTGGGCAACAGAG","CTGTAATCCCAGCACTTTGGGAAGCCAAGACAGGAGGATCTTTTGAGGCCAGGAGTTCGAGACCAGCCTGGGTAACATAGTAAGACCTCATCTCTCCAAAAAAAAGAAAAAAAAATTGCCAGGCCTGGTGGCATACACCTGTATTCCCAGCTACTTGGGAAGCTGAGGCAGGAGGATCGATCACTTGAGCCCAGGAGGCTGAGGTTGCAGTGAGCCAGGACCACACCACTGCTCTCCAGCCTGGGCAGACA"
"chr1","12375391","12375672","chr1","11712544","11712829","23","662847","GGCTAGGAGTGGTGGCTCATGCCTGTAATCCCAGCACTCTGGGAAGCTGAGGTGGGAGGATCGCTTGAGGCCAGAAGTTCAAGACCAGCCTGGGTGAAGAAGTAAGACCTTGTCTCTACAAAAAGTTTAAAAATTAACTGGGCATGGTGGCGTGCGCCTGTAGTCTCAGCCATTCAGGAGGCTGGAGGAGGAGGATCACTTGGACTTTGAAGGTCAAGGCCACACTAAGCTGAGATCATGCCACTGTACTTAGCCTGGGTGACAGAGTAAGACCCTGCCTCA","GGCCAGGAGTGGTGGCTCATGCCTGTAATCCCAGCACTTTGGGAGGCTGAGGTGGGAGGATCGCTTGAGGCCAGCCAGGCGTTCAAGACCAGTCTGGGTGATGAAGTAAGACCTTGGCTCTGCAAAAAGCTTAAAAATTAACCGAGCATGGTGGCATGTGCCTGCAGTCTCAGCCATTCAGGAGGCTGGGGGAGAAGGATCGCTTGGACTTTGAAGGTCAAGGCCACACTAAGCTGAGATCATGCCACTGTACTTAGCCTAGGTGACAAAGTAAGACCCTGCCTCA"
"chr1","12407177","12407473","chr1","42013299","42013590","54","29606122","GGCTGGGCATGGTAGCTCATGCCTGTAATCCCAGCACTTTCAGAGGCCGAGGTGGGAGGATGACTTGAACCCAAGAGTTCAAGACCAATCTGGACAATATGGCAAGACTCCATCTCTATAAAAATTAGCTGGGCGTGGTGGCAGGCACCTGTAGTCTCAGTTACTCAGGAGGCTGAGGTGGGAGGATGGCTTAAGCCCAGGAGACGTAAAGGCTGCAGTGAGCTGTGATGATGCCACTGCACTCCAGCCTGGGTGACAAAGCCAGACCCTGTCTACAGAGAAAAGAAAAAAAAAAAA","GGCTGGGCACGGTGGTTCATGCCTGTAATTCCAACATTTTCGGAGGCTGAGGAGGGAAGATCGCTTGAGGCCAGGAGTTTGAGACCAGCCTGGACAACATGGTGAGACCCCATCTCTAAAAAGTTAGCTGGGTGTAGTGGTGCATGCCTATAATCCAAGCTACTAAGGAGGCTGAGGTGGGAGGATCACTTGAGCCAGGGAGGTCGAGGCTGCAGTGAGCTGTGACTGTGCCACTGCACTCCAGCCTGGGTGACAGAGTAAGACCCTGTCTAAAAGAAAAAAAAAAAAAAAA"
"chr1","12479851","12480170","chr1","11812967","11813260","49","666884","GACCGGGCACAGTGGTTCATGCCTATAATCCCAGCACTTTGGGAAGCTGAGGCAGGTGGATCAGTTGAGTCCAGGAGTTTGAGACCAGCCTGGGCAACACAGTAAGACCCAATCTCTACTCAAAATAAAAAAAATTAAGCCAGGCAAGGTGGCACACGCCTATAGCCCCAGCTCCATGGGAAGCAGAGGTGGGAGGATCACTTGAGCCCAGGAGTTCAAGGTTGCGGTGAGCCAAGACTGAGCCACTGCCTTCCAGCCTGGGCAACAGAGTGAGACCCTGTCTCAAAAGAAAAAAAAAGGTTACTCTGAAAAAAAGAAAA","GACTGGGCACAGTGGCTGATGCCTATAATCCCAGCACTTTGGGAAGTGAGGTGGATCACTTGAGTCCAGGAGTTTGAGACCAGCCTGGGCAACACAGTAAGACCCCATCTCTACTCAAAATAAAAAAAAATTAGCCGGGCAAGGTGGCACATGCCTATAGCCCCAGGTCCGTGGGAGGCTGAGGTGGGAGGATCGCTTAAGCCCAGGAGTTCAAGGTTGTAGTGAGCCAAGATTGAGTCACTGCACTCCAGCCTGGGCAACAGAGACTCTGTCTCAAAAACAAAACAAAAAAAA"
"chr1","12500934","12501044","chr1","11833592","11833702","11","667342","GCCAAGCACGGAGGCTTACACCTGTTATCCTAGCACTTTGGGAGGATTGCTTGAGACCAGGAGCTCAAGACCAGCCTGGGTAACATAGGGAGACCTTCTCTCTACAAATAA","GCCAAGCATGGTGGCTTATGCCTGTTATCCTAGTACTTTCGGAGTACTGCTTGAGACCAGGAGCTCAAGACCAGCCTGGGTAACATAGGGAGACCCTATCTCTATAAATAA"
"chr1","12504722","12505023","chr1","11837406","11837678","43","667316","CCAGGCATGGTGACTCACGCCTGTAAAACTAGCACTTTGAGAGACCAAAGTGGGAGGATTGCTTGAGGTCAGGAGTTCGAGACCAGCCTGGCCAACATAGTGAGATCCCACCTCTATCAAAAAATATAAAAATTAGCTGGATTAATGGGGCACACCTGTAGTCCCAGCCACTCAGGAGGCTGAGGCAGGAAGATCACTTGAGTCCAGGAGTTCAAGGCTGCACTGAGTCACTTGCACTCTAGCCTGGGCCACAGAGCAAGACCCTCTCTCAAAAAAACAAACCAAACCAACCAAACAAAAAA","CAGGCATAGTGACTCACGCCTGTAAAACTAGCACTTCGAGAGGCCAAAGTGGGAGGACTGCTTGAGGTCAGGAGTTCGAGACCAGCCTGGCCAACATAGTGAGATCCCATCTCTATCAAAAAATATAAAAATTAGCTGGATGTAATGGTGCACGCCTGTAGTCCCAGCCCAGGAGGCTGAGGCAGGAAGATCACTTGAGCCCAGGAGTTCAAGGCTGCACTGAGCCACTTGCACTCTAGCCTGGGCCATAGAGCAAGACCCTCTATCAAGAAA"
"chr1","12508326","12508633","chr1","11840936","11841216","54","667390","GGCCAAGCACAGTGGCTCCCACCTATAATACCAGCACTTTGGGAGGCCAAGGTGGGAGAATTACTCGAGCCCAAGAGTTCAAGAGAAGCCTGAGCAGCATAGCGAGATCTCATCTCTACAGATAAAATAATTGGCTAGGGATGGTGGCACTCACCAGTGGTTCCGGCTACTGGGGAGGCTGAGGTGGGAGGATCATTTGAGTCCAGGAGGTCGAGGCTGCAGTGAGCCATCCAGGATAATGCCACCACACTTCAGCCTGGGCGACAGAGATCCTGTACAAAAAAAAAAGAAAGAAAGAAAGAAAAAAA","GGCCAGGCACAGTGGCTCCCACCTCTAATACCAGCACTTTGGGAGGCCGAGGTAGGAGAATTACTCAAGCCCAAGAGTTCAAGAGCAGCCTGGGCAGCATAGCGAGATCTCATCTCTACAAATAATTAGCTAGGGATGGCGGCACTCACCAGTGGTCCCGGCTACTGGGAAGGCTGAGGTGGGAGGATCATTTGAGCCCAGGAAGTTGAGTGAGCCATCCATGATAATGCCACCATACTTCAGCCTGGGCGACAGTGTGAGACTCTGTCTCAAAATAAAAG"
"chr1","12509316","12509590","chr1","11842120","11842390","31","667196","CCTGGTGCAGTGGCTCATGCCTGTAATACCTGCACTTTGGGAGGCTGAGGCAGGAGGATCACTTGAGCCCAGGAGTTTAAGACAAGTCTGGTCAACATAGGGAGATAGGGAGGCCCTTTTTCTACCAAAAAATATTAAAATCAGCCGGTCATGGTGGCACATGCGGGCAGTTCCACCCGTGGTCCCACTGAGATGGGCAGATTGCACTAAGCCATGATCACACCACTGGACTCCAATCTGGGTGCCAGAGCGAGACCTTGTCTCAAAGAAAAAAA","CCTGGTGCGGTGGCTCATGCCTGTAATACCAGCACTTTGGGAGGCTGAGGCAGGAGGATCACTTGAGTCCAGCAGTTTAAGACCAATCTGGGCAACAGAGGGAGATAGGGAGGCCCTTTTTCTACCAAAAAATAAAAATAAAAATTAGCCAGGCGTGGTGGCACGTGTGGGCGGTTCCGCCCATGGTCCCACTGAGATGGGCAGATTGCACTAAGCCATGATCACACCACTGGACTCCAATCTGGGTGCCAGAGTGAGACCTTGTCTCAAA"
"chr1","12515282","12515516","chr1","11848351","11848596","33","666931","AGGAGTTCAAGACCAGCCTGGGCAACATAGTGGGACCTCGTCTCTAACAAAAAAAAAATAATAAAATTAAAGCAGGGACGTAAGGATGAGCATCTGTAGTCCCTGCTACTCAGGAGGCTGAGGTGGGAAGGTCGTTTGAGCCCGGGAGGTCAAGCCTGCAGTGAGCTATGATGGCACCACTGCACTCCAGCCTGGATGACAAGGCAAGACCCTGTCTCAAAAAAACAAAAAAAAA","AGGAGTTTGAGACCAGCCTGGGCAACATAGTGGGACCCTGTTTCTACAAAAAAATTAAAAATAATAAAATAAAATCAAAATTAGCAGGGCTTAGGGATGAGCATCTGTAGTCCCAGCGACTCAGGAGGCTGACGTGGGAAGATCGTTTGAGCCTGGGAGGTCAAGGTTGCAGTGAGCTATGATGGCACCACTGCACTCCAGCCTGGATGAGAGAGCAAGACCCTGTCTCAAACCAACAAAAAAAAA"
"chr1","12531420","12531698","chr1","11863788","11864065","21","667632","GGCCGGGTGCAGTGGCTCACACCTGTAATCCCAGCTTTCCTTTGGGAAGTCAAGGCAGAAGGGTTGCTTAAGCCAGGAATTCCAGACTAGCCTGGGCAACATAGCGAGACCCTATCTTTACAAAAAAATGATTAAGTGAGCCAGGCGTGGTGGCACATGCCTGTAATCTCAGCTACTCGAGAGGCTGAGGTGGGAGGATTGCTTGAGCCTGGGAGGTGGAGGCTGCAGTGGCCATGATCGGGCCACTGCACTCCAGCCTGGGCAACAGAGTGAGGACCT","GGCCGGGTGCAGTGGCTCACACCTGTACTCCCAGCTTTCCTTTGGGAAGCCAAGGCAGAAGGATTGCTTGAGCCAGGAATTCCAGACTAGCCTGGGCAACATAGCGAGATCCTATCTTTACGAAAAGTGAATAAGTGAGCCAGGCGTGGTGGCGCATGCCTGTAGTCTCAGCTACTCAGGAGGCTGAGATGGGAGAACTGCTTGAGCCTGGAAGGTGGAGGCTGCAGTGGCCATGATCGTGCCACTGTACTCCAGCCTGGGCAACAGAGTGAGATCCT"
"chr1","12546336","12546632","chr1","11879135","11879421","37","667201","GGCTGGGGGCAGTGGCTCATACCTGTAATCCCAGCACTTGAGAGGCCGAGGTGGGAGGATTGCTTGAACCCAGGAGTTCAAGACCAGCCTGGGCAACATAAGAATACCCCTACTCTACAAAATTTTTTTTTTTAATTAGCTAGGTATGGTAGCATGCACCTGTGGTCCCAGCCACTCCGGAGGCTGAGGTGGGAGGATCTCTCGAGCCCAGGAGTTTGAGGCTGCAGTGAGCTATGATCGCACTGCTGCGTTCTAGCCTGGGCAACAGAACAAGATCCTGCCTCAAAAAACACAAAA","GGCTGGGGGCAGTGGCTCGCACATGTAATTTCTAGCACTTGAGAGGCCGAGGTGGGAGGATGGCTCGAACCCAGGAGTTCAAGGCCAGCCTGGGCAACATAAGAACACCCCTACTCTACAAAATTTTTTTAAAAAAATTAGCCAGGTATGGTAGCATGCACCTGTGGTCCCAGCCACTCCGGAGGCTGAGGTGGGAGGATCTCTTGAGCCCAGAAGTTTGAGGCTGCTGTGAGATATGATGGCACTACTGTGCTCTAGCCTGAGAACAAGATCCTGCCTCAGAAAAA"
"chr1","12555035","12555151","chr1","11890164","11890280","7","664871","GGCTGGATATGTTGGCTCACGCCTATATTCCCAGCACTTTGGGAGGCCGAGGTGGGGGAATTACTTGAGGCCAGGAGTTCAAGATCAGCCTGGGCAACATAGCAAGACTCTGTCTCT","GGCTGGATATGGTGACTCACCCCTATATTCCCAGCACTTTGGGAGGCCGAGGTGGGGGAATCGCTTGAGGCCAGGAGTTCAAGATCAGCCTGGGCAACATGGCAAGACGCTGTCTCT"
"chr1","12558707","12558834","chr1","11894180","11894307","5","664527","GGCCAGGTGTGGTACCTCACTCCTGTAATCCCAGCACTTTGGGAGACTGAGGCAGGAGGATCACTTGAAGCCAGGAGTTCAAGACCAGCCTGGGCAACAATGTGATACCCCCGTCTCTACAAATAATA","GGCCAGGTGTGGTACCTCACTCCTGTAATCCCAGCACTTTGGGAGGCTGAGGCAGGAGGATCACTTGAAGCCAGGAGTTCAAGACCAACCTGGACAACAATGTGAGACCCCCATCTCTACAAATAATA"
"chr1","12612893","12613194","chr1","11954081","11954409","51","658812","GGCCGTGCACAGTGGTTCACACCTGTAATCCTAGCACTTTGGGAGGCCAAGGCAGGAGGATTGCTTGAATCCAGGAGTTTGAGATCAGCCTTGGCAACGTAGCAAGACCCCATCTGTACAAAATATCAAAAAATTAGCCAGGCGTGATGTGATGGTACACGCCTGTGGTCCGAGCTACATGGGAGGCTGAAGTGGGAGGATCACTTGAACCCAGGAGGTGGAGGCTGCAGTGAGCCGTGTTCACGCCACTGCACTCCTGCCTGGGTGACAGAGTGAGACCCTGTCTCAGAAAAAAAAAAAAA","GGCCGCACACAGTGGTTCACGCCTGTAATCCTAGCACTTTGGGAGGCCAAGGCAGGCGGACGGCTTGAATCCAGGAGTTTAAGATCAGCCTTGGCAACACAGCAAGACCCCATCTGTACAAAATATCAAAAAATTAGCCAGGCGTGATGTGATGGTGCATGCCTGTGGTCCCAGCTACGTGGGAGGCTGAGGTGGGAGGATCCCTTGAGCCCAGGAGGTGGAGGCTGCAGTGAGCCATGTTCATGCCACTGTACTCCAGCCTGGGTGACAGTGAGACCCTGTCTCAGAAAAAAAAAAAAACAAAACAAAAAAAAAAAAAAAAAAAAAAA"
"chr1","12707487","12707804","chr1","12044687","12044988","39","662800","CTGGGCACAGTGGCTCATGTGTGTAAACCCAGCATTTCGGGAGGCCAAGGCAGGAGAATTACTTGAGCCCCAGGAGCTCAAGACCAGCCTGGGCAACGTGGTGAAGCTCCATTTCTTAAAAAAATATATACACAAAAAATAGCCAGGCGTGGTAATGCACGCCTGTAGTCCCAGCTACTAAGGAGGCTGAGATGGGAGGATCCCTTGAGCCCAGGAGTTTGAGGCTACAAGGAGCTATGATCATGCCACTGCACTCCAGCCTGGGTGACAGAGAAAGACCCTGTCTCAAAAAAAGAAAGAAAGAAATTAAAACAGAAA","CTGGGCACAGTGGCTTATGTGTACAATCCCAGTATTTCGGGAGGCCAAGGCAGGAGAATTACTTGAGCCCCAGGAGCTCAAGACCAGCCTGGGCAACATGGAGAAACTAATTTCTTAAAAATATATATACATGAAAAATAGCCAGGCATGGTGATGCACACCTATAGGCCCAGCTACTAGGGAGGCTGAGATGGCAGGATCCGTTGAGCCCAGGAGTTTGAGGCTACAGGGAGCTGTGATCGTGCCACTGCACTCCAGCCTGGGTGACAGAGAAAGACCCTGTCTCAAAAAAAAGAAAGAAA"
"chr1","12718714","12718830","chr1","12055131","12055247","12","663583","GGCTGGGTGTGGTGACTCATGCCAGTAATCCCAGCACTTTGAGAGTCTGAGGCGGGAGGACTGCTTGAGGAAAGGAGTTCAAGACCAGCCTAGGCAACACAGCAAGAACTTATCTCT","GGTTGGGTGTGATGACTCATGCCTGTAATCCCAGCACTTTGAGAGGCTGAGGCGGGAGGACTACTTGAGGCAAGGAGTTCAAGACCAGCCTGGGCAACGTAGCAAGAGCCCATCTCT"
"chr1","12783355","12783636","chr1","12100727","12101017","45","682628","GTGGTGGCCCATACCTATACTCCCTGCATTTTGGGAGGCCAAGGCAGGAGAATAACTTGAGCTCAGGAGTTCCAGAGCAGCCCAGGCAAGATAGAGAGACCTTGTCTCTACTTAAAAAAGTATCCAGGCGTAGTGGCTCAACACCTGTAGTCCTAGCTACTCAGGAGTCTGAGGTGGTAGGATCGCTTGAATCCCGGAAATTGAGGCTGCAGTGAGCTATGATTGTGACACTGCACTGTAGCCTGGGTTACAGAGTGAGATCTTTAAAAAACAAACAAAAAA","GGCCAAGTGTGGAAGCCAACACTTATAATCCCTGCACTTTAGGAGGCCAAGGCAGGAGAATCACTTGAGCTCAGGAGTTCCGAATCAGCCTGGGCAAGACAGCAAGACCTTGTCTCTACTAAAAAAGTATCCAGGCGTGGTGACTCACATACCTGTAGTCTTAGCTACTCAGGAGGCTGAGGTGGGAGGATCGCTTGAACCCAGGAGATTGAGGCTGCAGTAAGCTATGATTGTGCCACTGCACTCTAGCCCGGGTGACAGAACAACATCTTTAAAAAACAAACAAAAAAA"
"chr1","12802086","12802335","chr3","126535617","126535868","55","113733531","GGCCAAGTGTGGTGACTCAAGACTAATCCCAGCACTTATGGAGCCCGAGTCAGGAGGATTGCTTGAGCCAGGAGTTAGAGACCAGCCTAGCCAACAGAGTGAGGCCCCATCTCTATAAAAATACAAAAATTTAGCCAGCTATGGTAGTGGGCATCTGTGATCTCAGCTGCTCAGGAAGCTGAGGTGGGAGGATTGCTTGAGCCCAGGAGGTTGAGGCTGCAGTGAGCTATGATCACACCACTGCGTTCCA","GCCAGGCGCAGTGGCTCATGCCTATAATCCTAGCACTTTGGGAGGCTGTGGCAGCAGGATTGCTTGAGGCCAGGAGTTTGAGACCAGCCTGGGCAACATAGTGAGACCCCATCTCTACAAAAGATTAAAAATTAGCTGCGTGTAGTAGCATATGCCTGTCAACCTAGTTACTCAGGAGGCTGAGGTGGGAGGATCCCTTGAGCCCAGGAGTTTGAGGCTGCAGTAAGTTATGATCACACCGCTGCATTCCAG"
"chr1","13530987","13531124","chr8","99775223","99775358","34","86244236","GGGAGCAGTGACTCATGCCTTTAACCCCAACACTTTGGGAGACCAAGGCGGGAGGATCATTTCAGCCCAGGGGTTTGAGACCAACCTGGACAACACAGCAAAAACCCATCTCTATAAAATATTCTTTATTGAACGGGG","CGGGCATGGTGACTCACGCCTATAATCCCAACACTTTGGGAGGACAAGGCAGGATGATCACTTGAGCCCAGGAGTTTGAGACCAGCCTGAGCAACATAGCAAGACCCCCTCTCTACAAAAAAATTTAGAAGTTACT"
"chr1","13531406","13531591","chr9","115231624","115231796","55","101700218","TCTACAAAATATACATATTTTTTAATTAGCCGGGCATGGTAGCATGCATCTGTCTTCCCAATTGTATGGGTTGCTGACATGGGAGAAACAATTGAGCCCAGAAGATTTTGGCTGCAGTGAGCCATGCTCACACCACTGCTGTACTCCAGCCTGGGCAACATTGTGAGACCCTATTAAAGAAAAAAA","CTACAAAAAGAATTTTTTAATTAACTGGGCATGGTGGCCTGCAGTGCTAGCTACTCAGGAGGCTGAGGCAGAAGGATCACTTGAGCCCGGAGTTCAAGGCTGCAGTGGGCTGTGATCACACCACTGCACTCCAGCCTGGGCAACAGAGCAAGCCCCTGTCACCAGAAAAAAAA"
"chr1","13532652","13532804","chr1","12146295","12146447","20","1386357","GGCCGGGAAGAGGATTACGCCTGTAATCCCAGTAGTTTGGGAGGCCAAAGTGGGTGGATTGTTTGAGTCTAGGAGTTCAAGACCAGCCTGGACAACATAGTGAAACCCACTGTCTTTACAAAAAGTCAAAAAATAAAAGATTAGCTGGGCATG","GGCTGGGCACAGGGTCATGCCTGTAATACCAGCACTTTGGGAGGCCAAGGGGGGTGGATTGTTTGAGTCTAGGAGTTCAAGACTAGCATGGAGAACATAGTGAAAGCCAATGTCTTTACAAAAAGTCATCAAATAATAGATTAGCTAGGCATG"
"chr1","13541060","13541348","chr1","12119256","12119537","40","1421804","GGCTGAGTGTGGCGACTCAAGACTAATCCCAGCACTTTTGGATGCCGAGGCAGGAGGATCGCTGGAGACCAGGAGTTCGAGACCAGCCTAGCCAACAGAGTGAGGCCCCATCCCTATAAAAATAAAAAAAAATTAGCCAGTTGTGATGGTGTCCATCTGTGGTCTCAGCTACTCAGGAGGCTGAGGTGGGAGGATTGCTTGAGCCCAGGAAGTTGAGGTTGCAGTGGATTATGATCACACCACTGCACTCCAGCCTGGGTGACAGAGGGAAATCCTGTCTCAGAAAAAA","GGCCGAATGTGGTGACTCAAGACTAATCCCAGCACTTTTGGAGGCCGAGGCGGGAGGATCACTGGAGCCAGGAGTTAGAGACCAGCCTAACCAACAGAGTGAGGCCCCATCTCTATAAAAACACAGAAATTTAGCCGGCTGTGGTTTTGTGCATCTGTGGTCTCAGCTACTTAGGAGGCTGAGGTGGGAGGATTGCTGGAGCCCAGGAGGCTGAGGATGCAGTGGACTACGATGCACCACTACACTGCAGCCCAGGTGACAGAGGGAGGTCCTGTCTCAGAA"
"chr1","13624429","13624522","chr10","27429977","27430071","18","13805548","GGCTGGGCCTGGTGGCTCACGCCTTTAATCTCAGAGCTTTGTGAAGCTGAGGTGGGAGGATTGTTTGAGGACAGCAGTTCCAGACCAGCCTGGG","GGCTGGGTCCCATGGCTCACACCTGTAATCCCAGGACTTTGGGAAGCTGAGGTGGGAGGATTGATGGAGCCCAGGAGTTCAAGAACAGCCTGGGC"
