"chr1","93323080","93323285","chr1","92548372","92548561","28","774708"
"chr1","11665170","11665481","chr1","10945986","10946293","24","719184"
"chr1","11927552","11927782","chr19","37244182","37244407","53","25316630"
"chr1","40501004","40501307","chr1","39161865","39162153","36","1339139"
"chr1","94896107","94896264","chr3","42449035","42449193","49","52447072"
"chr1","110362457","110362738","chr1","109776679","109776938","40","585778"
"chr1","123600874","123601156","chr1","115057188","115057483","34","8543686"
"chr1","129761208","129761511","chr11","108122224","108122524","57","21638984"
"chr1","129892308","129892606","chr1","125357713","125358008","18","4534595"
"chr1","182058817","182059111","chr5","86925549","86925828","65","95133268"
"chr1","224526078","224526368","chr1","219977188","219977496","31","4548890"
"chr1","792773","793045","chr3","13105019","13105290","58","12312246"
"chr1","894390","894513","chr13","46512186","46512305","24","45617796"
"chr1","969318","969602","chr1","157235","157525","20","812083"
"chr1","1008455","1008696","chr2","61275500","61275760","71","60267045"
"chr1","1011897","1012160","chr4","108000144","108000414","55","106988247"
"chr1","1012432","1012724","chr7","96863166","96863444","60","95850734"
"chr1","1021637","1021889","chr10","12192602","12192874","77","11170965"
"chr1","1023149","1023439","chr8","39165024","39165322","64","38141875"
"chr1","1150664","1150951","chr1","212801492","212801783","65","211650828"
"chr1","1152355","1152647","chr1","291224","291515","27","861131"
"chr1","1166941","1167176","chr1","304698","304916","36","862243"
"chr1","1187518","1187839","chr1","324460","324762","51","863058"
"chr1","1189316","1189391","chr2","56197408","56197483","19","55008092"
"chr1","1226797","1227076","chr1","361871","362138","33","864926"
"chr1","1256787","1257089","chr1","392917","393230","59","863870"
"chr1","1271959","1272102","chr7","2704009","2704157","41","1432050"
"chr1","1324561","1324817","chr15","46265389","46265656","69","44940828"
"chr1","1324970","1325249","chr2","124168334","124168607","59","122843364"
"chr1","1346407","1346534","chr16","76744880","76745008","33","75398473"
"chr1","1346827","1346987","chr3","126170332","126170491","31","124823505"
"chr1","1363968","1364121","chr8","96729325","96729462","51","95365357"
"chr1","1364170","1364452","chr19","33783509","33783789","39","32419339"
"chr1","1421571","1421866","chr1","587937","588219","40","833634"
"chr1","1452904","1453203","chr1","587937","588219","38","864967"
"chr1","1499262","1499327","chr1","54094474","54094540","16","52595212"
"chr1","1499609","1499681","chrX","15934857","15934923","16","14435248"
"chr1","1501716","1501981","chr1","637036","637326","48","864680"
"chr1","1561470","1561580","chr1","694691","694801","10","866779"
"chr1","1561883","1562068","chr1","695415","695607","20","866468"
"chr1","1566866","1567115","chr1","700378","700618","23","866488"
"chr1","1571287","1571358","chr14","52690112","52690177","19","51118825"
"chr1","1580026","1580157","chr6","84156665","84156798","38","82576639"
"chr1","1585664","1585949","chr1","142523424","142523705","59","140937760"
"chr1","1633827","1633970","chr1","783882","784024","12","849945"
"chr1","1634729","1634864","chr8","124405124","124405255","20","122770395"
"chr1","1635015","1635283","chr1","793738","793977","46","841277"
"chr1","1637982","1638256","chr1","796662","796935","13","841320"
"chr1","1665949","1666212","chr1","825075","825341","18","840874"
"chr1","1673138","1673269","chr3","55572998","55573128","28","53899860"
"chr1","1673547","1673733","chr13","26144064","26144247","42","24470517"
"chr1","1676953","1677254","chr2","104586853","104587152","61","102909900"
"chr1","1693289","1693558","chr1","123553726","123553990","73","121860437"
"chr1","1699227","1699380","chr8","14063264","14063418","44","12364037"
"chr1","1713280","1713379","chr1","875941","876044","12","837339"
"chr1","1713671","1713841","chr3","127201134","127201313","44","125487463"
"chr1","1717575","1717841","chr1","880370","880634","20","837205"
"chr1","1738590","1738710","chr10","62530419","62530538","27","60791829"
"chr1","1739743","1739880","chr3","43002189","43002326","18","41262446"
"chr1","1742159","1742471","chr3","123903117","123903425","60","122160958"
"chr1","1761189","1761479","chr4","87333067","87333363","67","85571878"
"chr1","1801467","1801769","chr1","966393","966701","32","835074"
"chr1","1857272","1857561","chr1","1019697","1019997","44","837575"
"chr1","1859242","1859590","chr7","52112257","52112567","95","50253015"
"chr1","1875221","1875344","chr3","36373230","36373353","22","34498009"
"chr1","1875374","1875515","chrX","8417026","8417160","26","6541652"
"chr1","1881346","1881645","chr1","1046226","1046513","33","835120"
"chr1","1901997","1902265","chr16","51470636","51470915","62","49568639"
"chr1","1909810","1910122","chr1","1078974","1079270","31","830836"
"chr1","1931190","1931318","chr1","1101640","1101769","6","829550"
"chr1","1949467","1949770","chr18","6870105","6870403","51","4920638"
"chr1","1967291","1967529","chr1","1144526","1144790","49","822765"
"chr1","2015073","2015230","chr1","1199057","1199214","13","816016"
"chr1","2053913","2054176","chrX","30235373","30235651","52","28181460"
"chr1","2057432","2057709","chr1","1247395","1247665","21","810037"
"chr1","2064320","2064426","chr7","98100798","98100893","23","96036478"
"chr1","2083193","2083351","chr10","62247249","62247407","28","60164056"
"chr1","2135738","2136047","chr13","74579338","74579644","69","72443600"
"chr1","2189918","2190222","chr4","13681799","13682071","90","11491881"
"chr1","2228335","2228649","chr1","1417943","1418259","34","810392"
"chr1","2289143","2289186","chr1","1479515","1479562","9","809628"
"chr1","2289768","2289812","chr1","1480145","1480189","2","809623"
"chr1","2482292","2482560","chr1","1687975","1688263","40","794317"
"chr1","2492163","2492461","chr1","1700019","1700313","27","792144"
"chr1","2517684","2517970","chr1","1724256","1724542","17","793428"
"chr1","2650897","2651163","chr2","42959841","42960124","58","40308944"
"chr1","3035794","3036077","chr1","2191858","2192143","14","843936"
"chr1","3094236","3094547","chr1","2249173","2249474","37","845063"
"chr1","3138832","3139097","chr1","2292857","2293125","26","845975"
"chr1","3201688","3201993","chr1","2357280","2357593","44","844408"
"chr1","3245435","3245692","chr3","38934767","38935033","56","35689332"
"chr1","3349363","3349656","chr1","2508332","2508618","32","841031"
"chr1","3456172","3456333","chr19","33343579","33343740","29","29887407"
"chr1","3471635","3471929","chr3","86677534","86677827","71","83205899"
"chr1","3560569","3560870","chr15","43687639","43687935","54","40127070"
"chr1","3603373","3603591","chr10","71004722","71004936","45","67401349"
"chr1","3657446","3657748","chr1","2836381","2836681","28","821065"
"chr1","3685972","3686268","chr1","2867891","2868191","29","818081"
"chr1","3742467","3742713","chr4","11862374","11862624","54","8119907"
"chr1","3777507","3777649","chr1","3136850","3137006","24","640657"
"chr1","3789670","3789965","chr7","125197753","125198061","65","121408083"
"chr1","3805359","3805647","chr1","3167887","3168174","22","637472"
"chr1","3950713","3950848","chr2","189451666","189451801","33","185500953"
"chr1","3951145","3951284","chr1","3309195","3309336","15","641950"
"chr1","4003797","4004100","chr1","3351568","3351861","38","652229"
"chr1","4200159","4200462","chr1","3528356","3528663","42","671803"
"chr1","4360694","4360983","chr1","3698501","3698790","31","662193"
"chr1","4408239","4408529","chr1","3745322","3745629","36","662917"
"chr1","4592487","4592778","chr1","3928185","3928473","27","664302"
"chr1","4614405","4614700","chr10","12389093","12389387","65","7774688"
"chr1","4744326","4744642","chr1","4070505","4070817","31","673821"
"chr1","4758631","4758932","chr2","95955285","95955580","58","91196654"
"chr1","4772658","4772954","chr1","4100499","4100800","21","672159"
"chr1","4802731","4803038","chr1","4131757","4132050","26","670974"
"chr1","4882619","4882892","chr1","4204217","4204491","16","678402"
"chr1","4887923","4888197","chr11","1767086","1767360","59","3120837"
"chr1","5030144","5030388","chr1","4345286","4345537","19","684858"
"chr1","5047834","5048123","chr1","4362229","4362517","26","685605"
"chr1","5778644","5778953","chr1","4884638","4884942","29","894006"
"chr1","5788723","5789021","chr1","4893735","4894039","30","894988"
"chr1","5851836","5852078","chr1","4955551","4955794","25","896285"
"chr1","5934783","5934958","chr1","5036188","5036389","33","898595"
"chr1","5935269","5935398","chr1","5036669","5036794","16","898600"
"chr1","5946874","5947161","chr1","5049800","5050075","29","897074"
"chr1","5983456","5983763","chr1","5086241","5086541","37","897215"
"chr1","5992315","5992502","chr1","5094992","5095186","19","897323"
"chr1","6037014","6037326","chr1","5139902","5140238","44","897112"
"chr1","6038099","6038413","chr1","5141024","5141339","40","897075"
"chr1","6042128","6042304","chr19","28356007","28356185","33","22313879"
"chr1","6042603","6042743","chr1","5145796","5145928","20","896807"
"chr1","6050436","6050739","chr11","107411569","107411871","57","101361133"
"chr1","6159033","6159156","chr1","5260890","5261020","16","898143"
"chr1","6215676","6215963","chr1","5321344","5321635","23","894332"
"chr1","6216689","6216981","chr1","5318510","5318798","19","898179"
"chr1","6224353","6224657","chr1","5333795","5334106","26","890558"
"chr1","6227266","6227534","chr20","20626690","20626960","56","14399424"
"chr1","6316368","6316568","chr4","167948312","167948510","46","161631944"
"chr1","6363650","6363831","chr1","5479559","5479740","7","884091"
"chr1","6403519","6403833","chr1","5526863","5527183","33","876656"
"chr1","6420273","6420565","chr1","5540990","5541257","41","879283"
"chr1","6428076","6428365","chr1","5551141","5551437","32","876935"
"chr1","6430909","6431191","chr1","5553962","5554236","23","876947"
"chr1","6473518","6473727","chr3","170242210","170242417","41","163768692"
"chr1","6497862","6498069","chr1","5626734","5626940","19","871128"
"chr1","6515400","6515683","chr1","5643507","5643791","15","871893"
"chr1","6531181","6531315","chr1","5658987","5659111","17","872194"
"chr1","6559736","6559880","chr6","144363682","144363828","26","137803946"
"chr1","6560171","6560343","chr10","22553987","22554163","39","15993816"
"chr1","6574299","6574607","chr3","123903117","123903425","64","117328818"
"chr1","6608789","6609090","chr4","151163740","151164021","75","144554951"
"chr1","6618954","6619159","chr1","5747454","5747661","10","871500"
"chr1","6642209","6642505","chr1","5769010","5769307","16","873199"
"chr1","6647119","6647419","chr3","127162429","127162726","62","120515310"
"chr1","6658254","6658382","chr1","5785082","5785210","10","873172"
"chr1","6665808","6666103","chr1","27049076","27049368","72","20383268"
"chr1","6684060","6684181","chr1","5811010","5811142","14","873050"
"chr1","6691545","6691811","chr1","5819632","5819900","21","871913"
"chr1","6692456","6692756","chr1","5820608","5820914","23","871848"
"chr1","6693835","6694109","chr1","5821990","5822264","14","871845"
"chr1","6713672","6713934","chrX","67448189","67448456","54","60734517"
"chr1","6720392","6720688","chr15","43687639","43687935","57","36967247"
"chr1","6731452","6731747","chr1","5858937","5859229","36","872515"
"chr1","6742187","6742461","chr3","39231940","39232206","64","32489753"
"chr1","6746987","6747154","chr1","5875681","5875836","22","871306"
"chr1","6747389","6747489","chr1","5876339","5876453","24","871050"
"chr1","6749336","6749636","chr1","5877948","5878245","29","871388"
"chr1","6760793","6761065","chr1","5887205","5887513","57","873588"
"chr1","6764578","6764872","chr1","5890161","5890453","18","874417"
"chr1","6765549","6765860","chr1","5891047","5891360","36","874502"
"chr1","6771614","6771950","chr1","5897687","5897998","55","873927"
"chr1","6776647","6776857","chr3","35639309","35639528","51","28862662"
"chr1","6784918","6785226","chr1","5910945","5911247","33","873973"
"chr1","6791218","6791525","chr1","5916869","5917175","20","874349"
"chr1","6791769","6792067","chr1","5917424","5917708","31","874345"
"chr1","6800087","6800371","chr1","191690399","191690678","53","184890312"
"chr1","6813103","6813410","chr1","5944697","5945009","25","868406"
"chr1","6820448","6820773","chr1","5952712","5953020","35","867736"
"chr1","6823226","6823522","chr1","211353988","211354282","65","204530762"
"chr1","6852167","6852459","chr1","5985420","5985722","39","866747"
"chr1","6856335","6856617","chr1","5989198","5989480","17","867137"
"chr1","6865779","6866064","chr1","6000471","6000747","30","865308"
"chr1","6897558","6897844","chr8","38149121","38149408","76","31251563"
"chr1","6907991","6908293","chr1","6043638","6043911","49","864353"
"chr1","6921975","6922280","chr3","105829916","105830219","67","98907941"
"chr1","6944114","6944374","chr1","124615453","124615689","65","117671339"
"chr1","6960208","6960508","chr1","6095512","6095811","21","864696"
"chr1","6963892","6964192","chr1","6099265","6099566","30","864627"
"chr1","6999104","6999409","chr1","6136275","6136590","23","862829"
"chr1","7134611","7134828","chr1","6273895","6274107","25","860716"
"chr1","7146812","7147008","chr1","6287865","6288061","15","858947"
"chr1","7152503","7152814","chr1","6293664","6293944","49","858839"
"chr1","7173688","7174000","chr1","6316566","6316866","39","857122"
"chr1","7181953","7182225","chr1","6325766","6326039","16","856187"
"chr1","7405844","7405957","chr1","6542885","6543001","6","862959"
"chr1","7545317","7545587","chr1","6668555","6668832","21","876762"
"chr1","7657479","7657785","chr9","128228335","128228636","58","120570856"
"chr1","7718548","7718708","chr8","43486431","43486585","32","35767883"
"chr1","7720517","7720809","chr1","6839781","6840078","37","880736"
"chr1","7726215","7726518","chr1","6845768","6846074","26","880447"
"chr1","7744663","7744975","chr1","6863286","6863588","34","881377"
"chr1","7789821","7790085","chr1","6908613","6908879","16","881208"
"chr1","7810819","7811126","chr1","6929678","6929980","28","881141"
"chr1","7817559","7817848","chr1","6936711","6936985","41","880848"
"chr1","7833772","7834072","chr1","6953882","6954183","19","879890"
"chr1","7845222","7845522","chr1","6964451","6964748","19","880771"
"chr1","7851081","7851373","chr1","6970645","6970940","34","880436"
"chr1","7866379","7866660","chr1","6987250","6987541","46","879129"
"chr1","7875751","7876048","chr1","63043764","63044066","54","55168013"
"chr1","7890058","7890331","chrX","52930864","52931128","51","45040806"
"chr1","7892129","7892445","chr1","7012604","7012905","37","879525"
"chr1","7897492","7897769","chr1","7018191","7018463","58","879301"
"chr1","7900908","7900984","chr16","44594351","44594426","15","36693443"
"chr1","7912901","7913021","chr1","7034260","7034380","9","878641"
"chr1","7917367","7917661","chr5","169543224","169543530","78","161625857"
"chr1","7932542","7932832","chr1","7052589","7052879","16","879953"
"chr1","7944886","7945104","chr19","2956619","2956834","46","4988267"
"chr1","7974520","7974823","chr1","7095020","7095322","26","879500"
"chr1","7975736","7976024","chr1","7096242","7096531","28","879494"
"chr1","7978252","7978551","chr1","7098529","7098833","35","879723"
"chr1","7980525","7980810","chr1","7101124","7101404","20","879401"
"chr1","7987820","7988104","chr1","7108464","7108752","15","879356"
"chr1","7993494","7993798","chr1","7114733","7115046","27","878761"
"chr1","8003194","8003241","chr1","7125876","7125923","1","877318"
"chr1","8042024","8042339","chr1","7162036","7162351","24","879988"
"chr1","8058481","8058760","chr1","7183552","7183862","41","874929"
"chr1","8062682","8062804","chr1","7187546","7187661","17","875136"
"chr1","8065520","8065802","chr11","128872693","128872966","61","120807173"
"chr1","8084776","8085077","chr1","17737031","17737327","58","9652255"
"chr1","8095982","8096296","chr4","104021076","104021374","68","95925094"
"chr1","8115466","8115756","chr1","7242270","7242556","13","873196"
"chr1","8130374","8130697","chr1","7257606","7257928","24","872768"
"chr1","8132608","8132905","chr1","7259482","7259755","50","873126"
"chr1","8144624","8144907","chr1","7270845","7271103","32","873779"
"chr1","8167950","8168121","chr1","7295173","7295334","27","872777"
"chr1","8168377","8168513","chr1","7295599","7295735","11","872778"
"chr1","8199450","8199728","chr1","7328835","7329076","51","870615"
"chr1","8210154","8210446","chr1","7338604","7338899","20","871550"
"chr1","8219515","8219819","chr1","7348808","7349096","32","870707"
"chr1","8221139","8221255","chr1","7350440","7350556","9","870699"
"chr1","8237616","8237913","chr1","7368800","7369093","31","868816"
"chr1","8290197","8290500","chr1","7447808","7448116","35","842389"
"chr1","8301241","8301418","chr1","7458483","7458657","12","842758"
"chr1","8331095","8331356","chr1","7488262","7488521","29","842833"
"chr1","8338777","8339006","chr1","7495568","7495795","25","843209"
"chr1","8395780","8396057","chr1","7553352","7553628","18","842428"
"chr1","8399715","8399814","chr11","118237427","118237525","20","109837712"
"chr1","8456636","8456863","chr1","7607940","7608150","28","848696"
"chr1","8474172","8474295","chr1","7626778","7626901","11","847394"
"chr1","8487644","8487783","chr1","142183123","142183260","24","133695479"
"chr1","8488085","8488269","chr15","8429087","8429254","40","58998"
"chr1","8491061","8491337","chr1","7645614","7645902","46","845447"
"chr1","8491451","8491681","chr13","33765890","33766118","54","25274439"
"chr1","8513334","8513442","chr1","7668725","7668832","5","844609"
"chr1","8535206","8535322","chr1","7692362","7692473","16","842844"
"chr1","8562183","8562476","chr1","7716827","7717123","26","845356"
"chr1","8587325","8587624","chr1","7745081","7745384","27","842244"
"chr1","8588990","8589277","chr1","7746613","7746935","54","842377"
"chr1","8596930","8597157","chr1","7753709","7753921","30","843221"
"chr1","8600916","8601059","chr4","36960164","36960294","31","28359248"
"chr1","8625981","8626264","chr1","7783865","7784149","41","842116"
"chr1","8638966","8639274","chr1","7796805","7797118","28","842161"
"chr1","8646739","8647016","chr3","123351694","123351976","61","114704955"
"chr1","8649514","8649640","chr1","7807389","7807519","16","842125"
"chr1","8655067","8655392","chr1","7812977","7813296","23","842090"
"chr1","8664853","8664987","chr1","7822741","7822870","12","842112"
"chr1","8665038","8665338","chr1","7822922","7823220","15","842116"
"chr1","8680794","8680917","chr5","8654908","8655033","28","25886"
"chr1","8681230","8681311","chr7","651487","651564","20","8029743"
"chr1","8768783","8769094","chr1","7919354","7919666","27","849429"
"chr1","8791495","8791617","chr11","71555756","71555880","20","62764261"
"chr1","8793068","8793171","chr16","70044060","70044158","25","61250992"
"chr1","8793709","8793784","chr1","31653913","31653986","15","22860204"
"chr1","8800486","8800781","chr1","7953099","7953379","44","847387"
"chr1","8818510","8818632","chr13","25546692","25546816","19","16728182"
"chr1","8832636","8832760","chr9","82847515","82847637","14","74014879"
"chr1","8844353","8844670","chr7","16836681","16836985","60","7992328"
"chr1","8849071","8849213","chr1","8013002","8013143","9","836069"
"chr1","8849525","8849660","chr1","8013451","8013564","29","836074"
"chr1","8851787","8851896","chr1","141319339","141319440","29","132467552"
"chr1","8858407","8858675","chr1","8022860","8023120","47","835547"
"chr1","8875658","8875932","chr1","8039004","8039298","53","836654"
"chr1","8881811","8882101","chr1","8045083","8045378","24","836728"
"chr1","8892717","8892971","chr1","8752314","8752565","66","140403"
"chr1","8898240","8898487","chr20","10685324","10685570","51","1787084"
"chr1","8911494","8911813","chr1","8084194","8084516","22","827300"
"chr1","8921773","8921940","chr1","8093677","8093848","17","828096"
"chr1","8922223","8922367","chr1","8094151","8094298","14","828072"
"chr1","8926757","8926875","chr1","8097834","8097959","16","828923"
"chr1","8949753","8950027","chr1","8123622","8123892","25","826131"
"chr1","8958788","8958911","chr1","200289163","200289285","17","191330375"
"chr1","8963231","8963529","chr1","8140002","8140309","32","823229"
"chr1","8978337","8978632","chr1","8154719","8154995","41","823618"
"chr1","8982760","8983029","chr15","14646159","14646430","54","5663399"
"chr1","8995675","8995947","chr1","8173167","8173436","21","822508"
"chr1","9007285","9007588","chr4","142473682","142473973","68","133466397"
"chr1","9025080","9025382","chr1","8203338","8203635","27","821742"
"chr1","9034120","9034247","chr2","44878801","44878925","25","35844681"
"chr1","9041663","9041796","chr10","30449663","30449796","24","21408000"
"chr1","9042112","9042293","chrX","97446542","97446722","35","88404430"
"chr1","9044527","9044761","chr3","74945806","74946044","62","65901279"
"chr1","9050383","9050700","chr1","8229384","8229686","28","820999"
"chr1","9051826","9052131","chr6","100949181","100949485","37","91897355"
"chr1","9053803","9053872","chr1","8232496","8232577","19","821307"
"chr1","9054176","9054317","chr1","8232891","8233021","16","821285"
"chr1","9056894","9057204","chr1","8235562","8235859","41","821332"
"chr1","9106242","9106533","chr1","8286836","8287111","30","819406"
"chr1","9122223","9122348","chr6","32660972","32661093","27","23538749"
"chr1","9135334","9135644","chr1","8315082","8315388","26","820252"
"chr1","9141518","9141761","chr1","8321138","8321382","22","820380"
"chr1","9141766","9141904","chr1","8321387","8321526","10","820379"
"chr1","9146828","9147100","chr1","8327872","8328124","43","818956"
"chr1","9157199","9157493","chr1","8336851","8337140","18","820348"
"chr1","9175588","9175800","chr1","8357064","8357294","28","818524"
"chr1","9179321","9179618","chr1","8361608","8361902","22","817713"
"chr1","9183468","9183595","chr1","8365831","8365960","7","817637"
"chr1","9199197","9199335","chr1","8382441","8382582","15","816756"
"chr1","9199639","9199836","chr1","8382897","8383078","34","816742"
"chr1","9210466","9210765","chr10","25367339","25367629","74","16156873"
"chr1","9259736","9260027","chr4","6937789","6938091","60","2321947"
"chr1","9275332","9275612","chr3","155129902","155130173","67","145854570"
"chr1","9294062","9294368","chr1","8472703","8473013","27","821359"
"chr1","9297615","9297801","chr1","8476238","8476418","21","821377"
"chr1","9302156","9302345","chr1","218511627","218511810","40","209209471"
"chr1","9304769","9305078","chr9","28922132","28922420","80","19617363"
"chr1","9429611","9429786","chr1","8604962","8605143","15","824649"
"chr1","9486528","9486553","chr16","41419029","41419053","5","31932501"
"chr1","9486882","9486973","chr2","148733834","148733921","16","139246952"
"chr1","9509836","9510113","chr1","18486288","18486580","61","8976452"
"chr1","9570448","9570572","chr1","8744078","8744207","12","826370"
"chr1","9576485","9576767","chr1","8750476","8750756","23","826009"
"chr1","9577945","9578194","chr1","8752314","8752565","13","825631"
"chr1","9599218","9599507","chr1","8774097","8774382","21","825121"
"chr1","9619310","9619580","chr1","8798660","8798961","49","820650"
"chr1","9642925","9643180","chr1","8824971","8825247","38","817954"
"chr1","9644600","9644911","chr1","8826972","8827290","37","817628"
"chr1","9654507","9654803","chr1","8836388","8836696","36","818119"
"chr1","9680074","9680358","chr1","8858356","8858647","45","821718"
"chr1","9681737","9681988","chr19","31804372","31804611","64","22122635"
"chr1","9684059","9684325","chr1","8862978","8863242","23","821081"
"chr1","9702215","9702519","chr1","8883079","8883384","25","819136"
"chr1","9709345","9709566","chr1","8890842","8891058","23","818503"
"chr1","9709583","9709894","chr1","8891075","8891385","15","818508"
"chr1","9750079","9750376","chr1","8932674","8932973","29","817405"
"chr1","9793817","9794120","chr1","8973858","8974139","41","819959"
"chr1","9795499","9795807","chr1","8975181","8975479","41","820318"
"chr1","9797454","9797749","chr1","8977428","8977732","34","820026"
"chr1","9801195","9801501","chr1","8981776","8982081","22","819419"
"chr1","9813563","9813855","chr2","57517560","57517862","55","47703997"
"chr1","9828043","9828194","chr11","105301908","105302057","30","95473865"
"chr1","9831682","9831973","chrX","15902142","15902434","53","6070460"
"chr1","9853954","9854131","chr13","86759325","86759498","37","76905371"
"chr1","9854401","9854532","chr13","93907128","93907264","29","84052727"
"chr1","9872088","9872345","chr1","9056448","9056712","29","815640"
"chr1","9872629","9872892","chr1","9056998","9057261","15","815631"
"chr1","9879358","9879646","chr1","9064295","9064588","21","815063"
"chr1","9890001","9890120","chr1","9076778","9076896","15","813223"
"chr1","9890444","9890481","chr1","9077221","9077259","6","813223"
"chr1","9890774","9890943","chr1","9077554","9077734","30","813220"
"chr1","9913144","9913329","chr1","135834735","135834928","50","125921591"
"chr1","9921013","9921312","chr1","9109304","9109611","32","811709"
"chr1","9930798","9930960","chr1","9116695","9116833","35","814103"
"chr1","9931273","9931350","chr1","9117452","9117526","8","813821"
"chr1","9934824","9934958","chr7","20208738","20208869","25","10273914"
"chr1","9953263","9953552","chrX","49513581","49513873","59","39560318"
"chr1","9958384","9958561","chr14","64804258","64804431","32","54845874"
"chr1","9958628","9958754","chr4","73819458","73819584","15","63860830"
"chr1","9969746","9970044","chr1","9175478","9175780","25","794268"
"chr1","9970746","9971025","chr1","9176472","9176770","30","794274"
"chr1","9976432","9976729","chr1","9183116","9183415","19","793316"
"chr1","10000167","10000412","chr1","9206214","9206460","16","793953"
"chr1","10012497","10012622","chr1","9222804","9222928","9","789693"
"chr1","10012921","10013082","chr1","9223228","9223392","17","789693"
"chr1","10022623","10022706","chr1","9235443","9235526","7","787180"
"chr1","10023462","10023742","chr1","9235975","9236256","19","787487"
"chr1","10027799","10027965","chr8","11306109","11306271","36","1278310"
"chr1","10028259","10028413","chr1","27684255","27684415","42","17655996"
"chr1","10036248","10036339","chr3","158873113","158873201","17","148836865"
"chr1","10047559","10047838","chr1","9254499","9254783","25","793060"
"chr1","10051747","10052046","chrX","101668164","101668460","44","91616417"
"chr1","10052735","10052812","chr13","9337444","9337520","21","715291"
"chr1","10053141","10053200","chr2","93331141","93331204","15","83278000"
"chr1","10070929","10071220","chr1","9278418","9278699","28","792511"
"chr1","10078470","10078735","chr1","9286269","9286533","15","792201"
"chr1","10090461","10090624","chr18","36720775","36720932","41","26630314"
"chr1","10090916","10091050","chr12","27091688","27091821","28","17000772"
"chr1","10132362","10132671","chr1","9336393","9336697","25","795969"
"chr1","10150912","10151194","chr1","9357279","9357571","37","793633"
"chr1","10153983","10154112","chr19","8153130","8153252","28","2000853"
"chr1","10154406","10154570","chr19","8026553","8026714","33","2127853"
"chr1","10160166","10160354","chr1","15335340","15335517","53","5175174"
"chr1","10175062","10175218","chr12","85591604","85591764","26","75416542"
"chr1","10211892","10212184","chr1","9434285","9434588","28","777607"
"chr1","10236792","10237090","chr1","9463211","9463510","24","773581"
"chr1","10237729","10237994","chr1","9464163","9464443","38","773566"
"chr1","10240536","10240830","chrX","2057493","2057787","50","8183043"
"chr1","10249080","10249360","chr16","21941769","21942047","63","11692689"
"chr1","10263935","10264231","chr1","9494490","9494795","25","769445"
"chr1","10266352","10266661","chr1","9496843","9497153","33","769509"
"chr1","10314512","10314802","chr19","25476896","25477182","61","15162384"
"chr1","10321199","10321508","chr11","121456453","121456756","66","111135254"
"chr1","10337930","10338246","chr1","9592227","9592514","54","745703"
"chr1","10342949","10343197","chr13","70892536","70892787","55","60549587"
"chr1","10343484","10343743","chr7","95863189","95863435","68","85519705"
"chr1","10348882","10349173","chr1","9604297","9604574","29","744585"
"chr1","10355902","10356171","chr6","179154659","179154925","55","168798757"
"chr1","10357751","10358031","chr1","9616845","9617129","20","740906"
"chr1","10358322","10358595","chrX","123773493","123773766","53","113415171"
"chr1","10373605","10373898","chr1","9632102","9632392","26","741503"
"chr1","10376165","10376291","chr1","9635436","9635564","7","740729"
"chr1","10393146","10393434","chr1","9653153","9653441","14","739993"
"chr1","10406674","10406968","chr1","9667825","9668136","57","738849"
"chr1","10408487","10408785","chr1","9669063","9669352","23","739424"
"chr1","10415325","10415634","chr1","9672263","9672571","16","743062"
"chr1","10442467","10442683","chr1","9700344","9700560","16","742123"
"chr1","10443234","10443338","chr1","9701072","9701171","8","742162"
"chr1","10445038","10445238","chr17","5229611","5229823","53","5215427"
"chr1","10464065","10464345","chr1","129543506","129543782","51","119079441"
"chr1","10475652","10475938","chr10","14283283","14283568","56","3807631"
"chr1","10482571","10482875","chr1","9743572","9743882","25","738999"
"chr1","10485051","10485332","chr1","9747194","9747438","55","737857"
"chr1","10486204","10486519","chr1","154261716","154262030","52","143775512"
"chr1","10504285","10504598","chr8","78850789","78851109","56","68346504"
"chr1","10508831","10509113","chr1","9770637","9770912","34","738194"
"chr1","10528087","10528344","chr1","9789874","9790151","38","738213"
"chr1","10530199","10530489","chr10","31869665","31869954","55","21339466"
"chr1","10549739","10549941","chr1","9812291","9812493","14","737448"
"chr1","10558761","10559028","chr1","9822420","9822684","33","736341"
"chr1","10587888","10588166","chr1","9852624","9852906","20","735264"
"chr1","10722969","10723276","chr1","9989186","9989491","37","733783"
"chr1","10732199","10732501","chr1","9998082","9998388","29","734117"
"chr1","10803895","10804195","chr1","10069591","10069890","27","734304"
"chr1","10825122","10825450","chr1","10090882","10091206","27","734240"
"chr1","10826925","10827127","chr7","53643903","53644105","47","42816978"
"chr1","10868709","10869000","chr1","10135340","10135635","21","733369"
"chr1","10905780","10906064","chr1","10172167","10172453","24","733613"
"chr1","10913227","10913351","chr1","10178461","10178583","9","734766"
"chr1","10913650","10913828","chr20","23185454","23185631","39","12271804"
"chr1","10915222","10915349","chr7","121189198","121189333","27","110273976"
"chr1","10926446","10926739","chr1","10191794","10192082","29","734652"
"chr1","10945924","10946153","chr1","213911110","213911337","40","202965186"
"chr1","10962646","10962945","chr1","10223429","10223722","23","739217"
"chr1","10965384","10965675","chr3","165868043","165868332","54","154902659"
"chr1","10966685","10966987","chr1","10227902","10228202","16","738783"
"chr1","10986276","10986559","chr1","10251940","10252243","34","734336"
"chr1","10986737","10987033","chr2","109967146","109967434","69","98980409"
"chr1","11004822","11005153","chr19","46066584","46066890","82","35061762"
"chr1","11013912","11014070","chr1","10283447","10283604","14","730465"
"chr1","11032560","11032852","chr1","10318942","10319239","22","713618"
"chr1","11040380","11040662","chr1","10328262","10328555","35","712118"
"chr1","11049995","11050245","chr10","25956813","25957066","59","14906818"
"chr1","11053677","11054006","chr1","10342346","10342618","72","711331"
"chr1","11054024","11054254","chr11","75916398","75916624","55","64862374"
"chr1","11061724","11062014","chr3","165939533","165939833","58","154877809"
"chr1","11072351","11072656","chr1","10358392","10358708","30","713959"
"chr1","11080274","11080583","chr1","10363537","10363850","22","716737"
"chr1","11107955","11108057","chr12","96966182","96966288","20","85858227"
"chr1","11111612","11111902","chr5","78689579","78689868","64","67577967"
"chr1","11112360","11112545","chr12","82277360","82277547","46","71165000"
"chr1","11121745","11122031","chr8","32542121","32542384","92","21420376"
"chr1","11124168","11124458","chr1","10406195","10406485","16","717973"
"chr1","11141815","11142031","chr1","10422980","10423217","42","718835"
"chr1","11164332","11164629","chr1","10438474","10438775","29","725858"
"chr1","11166973","11167262","chr1","10441109","10441399","21","725864"
"chr1","11188882","11189169","chr1","10463664","10463954","34","725218"
"chr1","11189702","11189990","chr1","10464501","10464783","21","725201"
"chr1","11194341","11194713","chr1","95771715","95772086","98","84577374"
"chr1","11198301","11198582","chr1","10473400","10473682","15","724901"
"chr1","11203322","11203590","chr1","10479013","10479286","15","724309"
"chr1","11219157","11219438","chr1","10495018","10495306","29","724139"
"chr1","11231193","11231505","chr1","10506555","10506849","43","724638"
"chr1","11233032","11233327","chr1","10508761","10509037","37","724271"
"chr1","11262689","11262977","chr1","10541017","10541291","37","721672"
"chr1","11275135","11275434","chr1","10554465","10554764","25","720670"
"chr1","11280822","11280934","chr3","20729870","20729987","17","9449048"
"chr1","11297388","11297686","chr1","10574799","10575119","38","722589"
"chr1","11299247","11299563","chr1","10576660","10576977","31","722587"
"chr1","11318018","11318323","chr1","10592392","10592704","26","725626"
"chr1","11322299","11322620","chr1","10595699","10595979","64","726600"
"chr1","11328109","11328378","chr1","10600605","10600887","25","727504"
"chr1","11359877","11360003","chr1","10637882","10638005","11","721995"
"chr1","11364550","11364838","chr1","10642286","10642562","48","722264"
"chr1","11375648","11375948","chr1","10653448","10653748","34","722200"
"chr1","11487822","11488102","chr1","10768802","10769075","16","719020"
"chr1","11489166","11489462","chr1","10770139","10770410","37","719027"
"chr1","11491735","11491846","chr1","10773311","10773410","17","718424"
"chr1","11494156","11494355","chr1","10775709","10775896","19","718447"
"chr1","11505154","11505393","chr1","10788942","10789181","20","716212"
"chr1","11530355","11530655","chrX","147369436","147369734","56","135839081"
"chr1","11567498","11567771","chr1","10853244","10853544","37","714254"
"chr1","11574142","11574380","chr6","170454936","170455168","52","158880794"
"chr1","11623828","11624112","chr1","10904976","10905255","22","718852"
"chr1","11638075","11638344","chr1","10919793","10920102","51","718282"
"chr1","11667306","11667482","chrX","97446542","97446722","27","85779236"
"chr1","11667788","11667925","chr1","19633562","19633696","24","7965774"
"chr1","11697905","11698203","chr1","10978947","10979243","39","718958"
"chr1","11704637","11704860","chr1","10985724","10985945","19","718913"
"chr1","11707296","11707629","chrY","74753","75056","93","11632543"
"chr1","11710851","11711022","chr1","10990625","10990790","15","720226"
"chr1","11722094","11722404","chr6","105142168","105142470","64","93420074"
"chr1","11748601","11748871","chr1","11031087","11031361","18","717514"
"chr1","11753656","11753940","chr1","11036778","11037060","20","716878"
"chr1","11766132","11766454","chr1","11049878","11050167","56","716254"
"chr1","11776839","11777161","chr1","11060755","11061075","15","716084"
"chr1","11811044","11811323","chr1","11098355","11098632","31","712689"
"chr1","11814615","11814929","chr1","188530204","188530518","58","176715589"
"chr1","11831788","11832099","chr14","86579568","86579890","73","74747780"
"chr1","11832129","11832435","chr3","85172582","85172876","59","73340453"
"chr1","11844984","11845306","chr3","64187258","64187590","87","52342274"
"chr1","11849782","11850092","chr3","184970694","184971000","62","173120912"
"chr1","11852865","11853156","chr2","201476670","201476965","72","189623805"
"chr1","11858103","11858410","chr1","11144452","11144735","42","713651"
"chr1","11879214","11879491","chr1","11184807","11185094","21","694407"
"chr1","11881633","11881945","chr1","11186581","11186895","18","695052"
"chr1","11889101","11889389","chr1","11195037","11195328","22","694064"
"chr1","11896524","11896839","chr1","11203437","11203745","34","693087"
"chr1","11906371","11906612","chr1","11213679","11213920","23","692692"
"chr1","11911487","11911803","chr1","11220123","11220435","42","691364"
"chr1","11920174","11920467","chr2","84913076","84913368","53","72992902"
"chr1","11927047","11927355","chr1","11242481","11242790","25","684566"
"chr1","11944638","11944914","chr1","11263446","11263721","17","681192"
"chr1","11953298","11953626","chr12","65551151","65551448","74","53597853"
"chr1","11958379","11958541","chr1","11276422","11276579","16","681957"
"chr1","11960520","11960856","chr1","11278318","11278620","53","682202"
"chr1","11985870","11986075","chr2","192152416","192152638","56","180166546"
"chr1","12057716","12057996","chr1","11384052","11384336","19","673664"
"chr1","12066711","12067010","chr1","11397782","11398082","31","668929"
"chr1","12084121","12084302","chr1","11416905","11417083","14","667216"
"chr1","12130022","12130314","chr1","11463189","11463480","21","666833"
"chr1","12156769","12157074","chr1","11491196","11491490","33","665573"
"chr1","12176998","12177285","chr1","11511878","11512168","31","665120"
"chr1","12180365","12180536","chr14","2894541","2894688","46","9285824"
"chr1","12181977","12182102","chr9","82847515","82847637","16","70665538"
"chr1","12191186","12191469","chr2","54682020","54682302","66","42490834"
"chr1","12203969","12204286","chr6","67166681","67166993","57","54962712"
"chr1","12206459","12206568","chr5","1889927","1890031","16","10316532"
"chr1","12248928","12249031","chr7","168511583","168511686","13","156262655"
"chr1","12253979","12254251","chr1","11587895","11588169","31","666084"
"chr1","12275199","12275465","chr1","11609589","11609864","26","665610"
"chr1","12285785","12286069","chr1","11621384","11621675","26","664401"
"chr1","12297314","12297616","chr1","11633519","11633804","38","663795"
"chr1","12316959","12317124","chr9","15628977","15629142","34","3312018"
"chr1","12346692","12346961","chr8","78511957","78512224","58","66165265"
"chr1","12375132","12375359","chr11","132565033","132565283","68","120189901"
"chr1","12375391","12375672","chr1","11712544","11712829","23","662847"
"chr1","12407177","12407473","chr1","42013299","42013590","54","29606122"
"chr1","12479851","12480170","chr1","11812967","11813260","49","666884"
"chr1","12500934","12501044","chr1","11833592","11833702","11","667342"
"chr1","12504722","12505023","chr1","11837406","11837678","43","667316"
"chr1","12508326","12508633","chr1","11840936","11841216","54","667390"
"chr1","12509316","12509590","chr1","11842120","11842390","31","667196"
"chr1","12515282","12515516","chr1","11848351","11848596","33","666931"
"chr1","12531420","12531698","chr1","11863788","11864065","21","667632"
"chr1","12546336","12546632","chr1","11879135","11879421","37","667201"
"chr1","12555035","12555151","chr1","11890164","11890280","7","664871"
"chr1","12558707","12558834","chr1","11894180","11894307","5","664527"
"chr1","12612893","12613194","chr1","11954081","11954409","51","658812"
"chr1","12707487","12707804","chr1","12044687","12044988","39","662800"
"chr1","12718714","12718830","chr1","12055131","12055247","12","663583"
"chr1","12783355","12783636","chr1","12100727","12101017","45","682628"
"chr1","12802086","12802335","chr3","126535617","126535868","55","113733531"
"chr1","13530987","13531124","chr8","99775223","99775358","34","86244236"
"chr1","13531406","13531591","chr9","115231624","115231796","55","101700218"
"chr1","13532652","13532804","chr1","12146295","12146447","20","1386357"
"chr1","13541060","13541348","chr1","12119256","12119537","40","1421804"
"chr1","13624429","13624522","chr10","27429977","27430071","18","13805548"
"chr1","13684253","13684363","chr1","12353123","12353232","11","1331130"
"chr1","13685207","13685522","chr1","12354383","12354690","29","1330824"
"chr1","13724038","13724164","chr1","129880370","129880494","18","116156332"
"chr1","13725281","13725553","chr1","12394695","12394967","23","1330586"
"chr1","13742385","13742642","chr1","12413004","12413263","22","1329381"
"chr1","13775004","13775312","chr1","12448996","12449301","32","1326008"
"chr1","13850304","13850517","chr1","12529357","12529582","34","1320947"
"chr1","13905747","13906051","chr1","12588231","12588518","50","1317516"
"chr1","13911863","13912165","chr1","12594312","12594603","29","1317551"
"chr1","13934926","13935210","chr1","12617303","12617602","31","1317623"
"chr1","14014473","14014653","chr1","12694951","12695129","15","1319522"
"chr1","14034526","14034785","chr1","12715762","12716026","22","1318764"
"chr1","14081125","14081250","chr6","94210591","94210714","17","80129466"
"chr1","14221548","14221876","chr1","53872477","53872791","73","39650929"
"chr1","14285006","14285298","chr1","12959133","12959426","25","1325873"
"chr1","14537388","14537681","chr16","40682328","40682600","66","26144940"
"chr1","14586366","14586665","chr1","13275317","13275619","23","1311049"
"chr1","14760021","14760314","chr1","13452925","13453232","35","1307096"
"chr1","14803882","14804143","chr1","13496008","13496266","25","1307874"
"chr1","14810332","14810642","chr3","39804175","39804480","59","24993843"
"chr1","14815650","14815878","chr1","13507577","13507809","24","1308073"
"chr1","14841897","14842202","chr1","13533919","13534219","22","1307978"
"chr1","14851688","14851978","chr1","13543699","13543988","18","1307989"
"chr1","14879398","14879696","chr1","13571562","13571858","43","1307836"
"chr1","14884933","14885228","chr1","13577092","13577365","50","1307841"
"chr1","14898656","14898922","chr10","61695759","61696020","60","46797103"
"chr1","14912627","14912906","chr1","13605985","13606264","15","1306642"
"chr1","14914898","14915215","chr7","16836681","16836985","60","1921783"
"chr1","14953168","14953463","chr1","13645034","13645327","26","1308134"
"chr1","14978890","14979135","chr14","65585017","65585263","60","50606127"
"chr1","14989041","14989340","chr1","13680903","13681197","32","1308138"
"chr1","15007766","15008057","chr1","13699851","13700142","21","1307915"
"chr1","15049075","15049213","chr1","13741470","13741606","11","1307605"
"chr1","15049525","15049682","chr1","13741920","13742077","5","1307605"
"chr1","15053426","15053594","chr1","13746336","13746531","29","1307090"
"chr1","15057551","15057835","chr1","13750195","13750488","35","1307356"
"chr1","15079500","15079796","chr1","13773553","13773852","18","1305947"
"chr1","15139284","15139447","chr1","13831178","13831336","12","1308106"
"chr1","15169185","15169489","chr5","101488244","101488549","62","86319059"
"chr1","15243272","15243579","chr13","71248269","71248571","52","56004997"
"chr1","15256705","15257004","chr1","13951570","13951862","44","1305135"
"chr1","15267814","15267899","chr10","66697427","66697509","14","51429613"
"chr1","15269915","15270032","chr20","65014620","65014741","21","49744705"
"chr1","15282083","15282302","chr19","2956619","2956834","46","12325464"
"chr1","15283395","15283686","chr1","13972945","13973239","33","1310450"
"chr1","15305452","15305748","chr6","147992052","147992350","65","132686600"
"chr1","15327725","15327841","chr11","113373159","113373274","19","98045434"
"chr1","15339424","15339672","chr1","14035826","14036100","47","1303598"
"chr1","15340163","15340324","chr20","11957484","11957638","31","3382679"
"chr1","15340364","15340488","chr9","82847515","82847637","18","67507151"
"chr1","15371914","15372224","chr1","6863286","6863588","58","8508628"
"chr1","15427566","15427845","chr1","36872845","36873125","54","21445279"
"chr1","15431129","15431452","chr1","14132537","14132855","42","1298592"
"chr1","15452578","15452703","chr1","14151656","14151776","15","1300922"
"chr1","15465511","15465812","chr1","14167915","14168193","45","1297596"
"chr1","15475747","15476040","chr1","14178750","14179040","27","1296997"
"chr1","15476041","15476175","chr1","14179041","14179172","11","1297000"
"chr1","15497639","15497800","chr19","51007704","51007865","41","35510065"
"chr1","15497827","15497927","chr1","221762579","221762671","19","206264752"
"chr1","15506329","15506597","chr12","87749598","87749866","61","72243269"
"chr1","15509490","15509759","chr1","14212807","14213076","17","1296683"
"chr1","15518247","15518534","chr1","14220581","14220867","13","1297666"
"chr1","15520197","15520333","chr1","14222547","14222679","13","1297650"
"chr1","15521872","15522160","chr15","48727951","48728234","64","33206079"
"chr1","15531943","15532237","chr15","29615590","29615889","51","14083647"
"chr1","15536943","15537236","chr1","14237948","14238242","27","1298995"
"chr1","15549475","15549776","chr1","14250456","14250748","26","1299019"
"chr1","15564890","15565010","chr1","14286018","14286138","11","1278872"
"chr1","15567377","15567681","chr1","14288460","14288772","29","1278917"
"chr1","15575020","15575359","chr1","14296482","14296833","38","1278538"
"chr1","15577293","15577612","chr1","14273593","14273911","30","1303700"
"chr1","15601394","15601670","chr1","14324687","14324980","42","1276707"
"chr1","15620510","15620799","chr1","14369431","14369729","32","1251079"
"chr1","15635383","15635596","chr10","10806243","10806459","40","4829140"
"chr1","15654428","15654705","chr1","14402148","14402423","14","1252280"
"chr1","15667993","15668251","chr1","14416661","14416922","29","1251332"
"chr1","15690276","15690593","chr1","14441406","14441713","26","1248870"
"chr1","15693851","15693948","chr1","14445005","14445104","12","1248846"
"chr1","15721375","15721674","chr1","14475118","14475421","21","1246257"
"chr1","15722170","15722479","chr1","14475918","14476225","15","1246252"
"chr1","15733173","15733494","chr1","14489253","14489585","35","1243920"
"chr1","15746427","15746800","chr1","14497458","14497836","37","1248969"
"chr1","15754089","15754336","chr20","21091235","21091502","71","5337146"
"chr1","15757540","15757816","chr1","14505283","14505595","56","1252257"
"chr1","15767015","15767320","chr1","14515744","14516043","22","1251271"
"chr1","15769070","15769342","chr1","14518164","14518436","32","1250906"
"chr1","15773548","15773767","chr1","14522823","14523039","17","1250725"
"chr1","15782889","15783012","chr1","14531940","14532061","10","1250949"
"chr1","15784406","15784681","chr6","76152155","76152450","70","60367749"
"chr1","15786002","15786285","chr1","14535386","14535679","30","1250616"
"chr1","15789606","15789722","chr1","14538845","14538959","14","1250761"
"chr1","15806713","15806866","chr12","21323547","21323703","26","5516834"
"chr1","15807158","15807286","chr2","95373365","95373485","28","79566207"
"chr1","15815520","15815799","chr1","14566230","14566500","35","1249290"
"chr1","15824600","15824907","chr1","14576477","14576765","37","1248123"
"chr1","15834201","15834490","chr11","130372252","130372523","78","114538051"
"chr1","15837222","15837341","chr7","96669674","96669791","17","80832452"
"chr1","15840111","15840397","chr11","124299635","124299918","56","108459524"
"chr1","15842588","15842704","chr1","14591781","14591907","12","1250807"
"chr1","15844771","15844836","chr1","14595423","14595488","4","1249348"
"chr1","15844878","15845200","chr3","130342599","130342889","93","114497721"
"chr1","15846711","15846907","chr1","14596917","14597117","34","1249794"
"chr1","15847170","15847315","chr1","14597381","14597529","21","1249789"
"chr1","15851504","15851788","chr1","14601541","14601825","15","1249963"
"chr1","15877938","15878142","chr1","14630816","14630996","44","1247122"
"chr1","15878384","15878507","chr7","56060833","56060961","31","40182449"
"chr1","15900175","15900334","chr3","13044305","13044455","36","2855870"
"chr1","15901047","15901326","chr19","37280679","37280983","49","21379632"
"chr1","15906817","15906933","chr1","14661421","14661537","9","1245396"
"chr1","15913563","15913874","chr10","49683640","49683946","66","33770077"
"chr1","15940698","15940759","chr3","44338700","44338762","17","28398002"
"chr1","15944752","15945019","chr1","14698379","14698673","49","1246373"
"chr1","15947591","15947767","chr1","14704155","14704351","30","1243436"
"chr1","15955287","15955501","chr7","126036652","126036868","51","110081365"
"chr1","15970459","15970570","chr1","14753781","14753895","15","1216678"
"chr1","15971913","15972186","chr1","14754978","14755245","30","1216935"
"chr1","15993578","15993673","chr19","30133564","30133663","24","14139986"
"chr1","15996710","15996935","chr16","23905346","23905542","72","7908636"
"chr1","16000131","16000251","chr1","14785855","14785977","8","1214276"
"chr1","16013543","16013819","chr16","52172870","52173148","67","36159327"
"chr1","16023368","16023520","chr12","21323547","21323703","28","5300179"
"chr1","16023820","16023955","chr3","45239314","45239453","26","29215494"
"chr1","16028910","16029121","chr16","54638113","54638322","41","38609203"
"chr1","16039200","16039466","chr1","14831877","14832180","49","1207323"
"chr1","16046012","16046281","chr1","14838438","14838706","25","1207574"
"chr1","16104560","16104864","chr1","14900495","14900798","20","1204065"
"chr1","16104897","16105097","chrX","67046575","67046774","48","50941678"
"chr1","16107907","16108026","chr3","49560525","49560646","33","33452618"
"chr1","16110386","16110680","chr1","27014433","27014724","51","10904047"
"chr1","16130405","16130517","chr1","14928296","14928413","10","1202109"
"chr1","16132008","16132287","chr3","123351694","123351976","53","107219686"
"chr1","16135778","16136061","chr1","14934349","14934607","60","1201429"
"chr1","16137622","16137921","chr1","14936145","14936442","25","1201477"
"chr1","16178332","16178618","chr1","14978050","14978326","30","1200282"
"chr1","16201761","16201898","chr7","68478894","68479032","21","52277133"
"chr1","16212736","16212975","chr1","15014064","15014302","21","1198672"
"chr1","16224731","16224951","chr1","15027269","15027495","20","1197462"
"chr1","16228895","16229018","chr1","15031893","15032018","8","1197002"
"chr1","16242240","16242494","chr1","15040018","15040290","59","1202222"
"chr1","16296612","16296785","chr1","15094812","15094998","29","1201800"
"chr1","16297060","16297200","chr1","15095273","15095427","21","1201787"
"chr1","16299278","16299580","chr1","15098132","15098440","33","1201146"
"chr1","16374696","16374981","chr2","184143766","184144059","57","167769070"
"chr1","16386812","16387120","chr1","15185857","15186158","37","1200955"
"chr1","16387197","16387503","chr1","15186245","15186543","29","1200952"
"chr1","16389163","16389466","chr19","43210585","43210888","64","26821422"
"chr1","16402642","16402916","chr1","15203793","15204065","22","1198849"
"chr1","16403917","16404227","chr1","15205045","15205361","24","1198872"
"chr1","16415858","16416013","chr1","15213254","15213409","7","1202604"
"chr1","16417371","16417670","chr1","15214724","15215047","54","1202647"
"chr1","16419923","16420209","chr1","15217279","15217568","13","1202644"
"chr1","16420552","16420833","chr1","15217936","15218219","37","1202616"
"chr1","16435053","16435371","chr1","15233501","15233811","28","1201552"
"chr1","16445983","16446287","chr1","15243884","15244179","28","1202099"
"chr1","16457822","16458098","chr1","15255783","15256048","29","1202039"
"chr1","16461162","16461419","chr1","15258888","15259147","32","1202274"
"chr1","16485224","16485346","chr2","165531071","165531193","24","149045847"
"chr1","16500054","16500351","chr10","70677425","70677712","84","54177371"
"chr1","16510295","16510594","chr1","15302169","15302448","63","1208126"
"chr1","16528561","16528835","chr1","15320779","15321054","18","1207782"
"chr1","16529877","16530040","chr14","32139013","32139178","35","15609136"
"chr1","16531842","16532130","chr1","15332940","15333224","21","1198902"
"chr1","16533758","16534059","chr2","172304675","172304978","64","155770917"
"chr1","16535066","16535363","chr1","15336551","15336846","13","1198515"
"chr1","16538492","16538775","chr1","15340026","15340309","15","1198466"
"chr1","16561908","16562226","chr1","15362227","15362545","26","1199681"
"chr1","16562508","16562786","chr6","17609699","17609979","56","1047191"
"chr1","16565767","16566094","chr3","159381312","159381634","70","142815545"
"chr1","16574447","16574722","chr1","15374292","15374571","23","1200155"
"chr1","16588626","16588736","chr1","15387207","15387321","10","1201419"
"chr1","16589037","16589248","chr8","105388423","105388621","54","88799386"
"chr1","16608347","16608464","chr1","15465575","15465692","6","1142772"
"chr1","16609268","16609469","chr13","42904008","42904210","40","26294740"
"chr1","16630863","16630979","chr1","121742832","121742947","10","105111969"
"chr1","16900790","16901049","chr1","124005930","124006229","53","107105140"
"chr1","16910996","16911112","chr1","121742832","121742947","10","104831836"
"chr1","16943569","16943692","chr15","46151444","46151568","15","29207875"
"chr1","16957824","16958111","chr1","15649572","15649858","26","1308252"
"chr1","16981825","16981961","chr1","139196083","139196205","35","122214258"
"chr1","17009622","17009929","chr1","15706631","15706909","53","1302991"
"chr1","17019560","17019756","chr1","174113725","174113923","47","157094165"
"chr1","17021099","17021253","chr1","15718494","15718651","21","1302605"
"chr1","17025193","17025406","chr1","15722620","15722826","19","1302573"
"chr1","17029700","17029894","chr1","15727203","15727404","29","1302497"
"chr1","17030183","17030309","chr1","15727687","15727811","12","1302496"
"chr1","17037003","17037133","chr10","27663251","27663372","20","10626248"
"chr1","17039475","17039807","chr1","15735055","15735377","35","1304420"
"chr1","17040644","17040929","chr1","15736210","15736489","21","1304434"
"chr1","17047842","17048118","chr1","15743727","15743977","41","1304115"
"chr1","17059583","17059838","chr19","37264509","37264744","75","20204926"
"chr1","17060121","17060248","chr16","56252080","56252218","39","39191959"
"chr1","17071932","17072065","chr1","15768713","15768844","10","1303219"
"chr1","17084225","17084519","chr1","15779911","15780207","18","1304314"
"chr1","17093919","17094191","chr3","37042470","37042744","55","19948551"
"chr1","17125391","17125694","chr1","15821910","15822210","26","1303481"
"chr1","17129794","17130090","chr1","15828156","15828470","40","1301638"
"chr1","17148538","17148772","chr1","15847152","15847376","32","1301386"
"chr1","17154512","17154795","chr1","15852698","15852981","14","1301814"
"chr1","17170669","17170956","chr1","15871355","15871643","18","1299314"
"chr1","17171695","17171801","chr4","15278126","15278223","22","1893569"
"chr1","17172102","17172407","chr1","15872438","15872737","35","1299664"
"chr1","17173112","17173382","chr1","15874193","15874461","23","1298919"
"chr1","17228392","17228672","chr11","120199798","120200085","54","102971406"
"chr1","17272164","17272448","chr1","15968143","15968427","19","1304021"
"chr1","17294998","17295296","chr1","15994776","15995076","17","1300222"
"chr1","17297445","17297712","chr1","15997036","15997322","36","1300409"
"chr1","17320470","17320763","chr1","16024355","16024647","17","1296115"
"chr1","17326967","17327096","chr1","16030873","16031006","13","1296094"
"chr1","17330830","17331127","chr1","16035376","16035679","27","1295454"
"chr1","17337274","17337560","chr1","16041608","16041896","38","1295666"
"chr1","17352979","17353302","chr9","30695765","30696081","64","13342786"
"chr1","17355309","17355538","chr1","109669557","109669786","50","92314248"
"chr1","17372523","17372747","chr1","16079674","16079894","25","1292849"
"chr1","17379323","17379520","chr1","16086372","16086566","24","1292951"
"chr1","17433072","17433339","chr11","69172884","69173158","59","51739812"
"chr1","17445674","17445977","chr1","16156006","16156306","19","1289668"
"chr1","17455025","17455144","chr1","16164081","16164218","23","1290944"
"chr1","17457379","17457549","chr1","16167026","16167194","6","1290353"
"chr1","17457843","17457902","chr1","16167485","16167544","4","1290358"
"chr1","17472353","17472646","chr1","16180954","16181253","21","1291399"
"chr1","17472843","17473119","chr1","16181450","16181732","29","1291393"
"chr1","17494855","17495155","chr1","16212970","16213271","29","1281885"
"chr1","17513818","17514040","chr3","41668700","41668919","46","24154882"
"chr1","17526320","17526451","chr13","56057132","56057269","23","38530812"
"chr1","17529038","17529337","chr1","16252294","16252583","41","1276744"
"chr1","17534150","17534268","chr16","17673911","17674030","16","139761"
"chr1","17537479","17537647","chr7","55505074","55505235","33","37967595"
"chr1","17537675","17537794","chr8","142934040","142934158","17","125396365"
"chr1","17542657","17542939","chr1","16266637","16266917","13","1276020"
"chr1","17578350","17578607","chr3","126102669","126102927","57","108524319"
"chr1","17583801","17583961","chr15","10324635","10324792","27","7259166"
"chr1","17583977","17584284","chr1","16309312","16309622","27","1274665"
"chr1","17591183","17591362","chr14","64804258","64804431","41","47213075"
"chr1","17591663","17591798","chr20","3524907","3525040","20","14066756"
"chr1","17606951","17607242","chr14","115049792","115050083","47","97442841"
"chr1","17650002","17650281","chr13","25090593","25090872","45","7440591"
"chr1","17717764","17718086","chr1","16441895","16442210","26","1275869"
"chr1","17729397","17729451","chr1","16453775","16453830","13","1275622"
"chr1","17729807","17730054","chr1","16454185","16454436","22","1275622"
"chr1","17738924","17739056","chr1","16463717","16463849","10","1275207"
"chr1","17780679","17780986","chr1","16507594","16507900","21","1273085"
"chr1","17815064","17815194","chr16","39379692","39379819","29","21564628"
"chr1","17878824","17879119","chr1","16605200","16605483","32","1273624"
"chr1","17897094","17897346","chr1","16623038","16623295","17","1274056"
"chr1","17922468","17922782","chr1","16648917","16649237","20","1273551"
"chr1","17948359","17948446","chr1","16674594","16674681","0","1273765"
"chr1","18082868","18083025","chr1","16828576","16828732","12","1254292"
"chr1","18098096","18098264","chr7","42048162","42048319","46","23950066"
"chr1","18149781","18150067","chr1","16894206","16894493","22","1255575"
"chr1","18157962","18158234","chr1","16902063","16902333","10","1255899"
"chr1","18214279","18214576","chr1","16958127","16958438","39","1256152"
"chr1","18368540","18368876","chr1","17113677","17114005","65","1254863"
"chr1","18410756","18411052","chr1","17157296","17157603","30","1253460"
"chr1","18418735","18419027","chr1","17165455","17165752","37","1253280"
"chr1","18425707","18425830","chr1","17172380","17172503","7","1253327"
"chr1","18437932","18438219","chr1","17185134","17185422","16","1252798"
"chr1","18452873","18453173","chr1","17200206","17200512","17","1252667"
"chr1","18475494","18475807","chr2","136839773","136840073","75","118364279"
"chr1","18508059","18508348","chr1","17258340","17258637","21","1249719"
"chr1","18537576","18537870","chr7","140588016","140588306","57","122050440"
"chr1","18553514","18553749","chr1","17308167","17308398","14","1245347"
"chr1","18584344","18584640","chr1","17339219","17339508","26","1245125"
"chr1","18585820","18586119","chr15","17838151","17838448","53","747669"
"chr1","18588095","18588382","chr1","188111652","188111943","61","169523557"
"chr1","18598487","18598769","chr1","17354034","17354313","21","1244453"
"chr1","18601339","18601647","chr2","99945161","99945467","62","81343822"
"chr1","18607682","18607972","chr1","17363018","17363316","28","1244664"
"chr1","18613464","18613755","chr1","17368813","17369106","29","1244651"
"chr1","18619166","18619293","chr5","150516607","150516733","18","131897441"
"chr1","18619567","18619782","chr17","3590562","3590778","46","15029005"
"chr1","18676958","18677245","chr1","17433476","17433771","34","1243482"
"chr1","18680236","18680533","chr1","17436787","17437070","37","1243449"
"chr1","18699466","18699749","chr1","17455879","17456183","45","1243587"
"chr1","18716661","18716940","chrX","144504663","144504944","54","125788002"
"chr1","18757365","18757544","chr1","218816649","218816824","42","200059284"
"chr1","18799400","18799696","chr3","124267629","124267922","59","105468229"
"chr1","18844120","18844392","chr1","17602159","17602431","13","1241961"
"chr1","18869500","18869797","chr1","17629495","17629789","26","1240005"
"chr1","18873430","18873751","chr1","17634884","17635193","49","1238546"
"chr1","18923395","18923703","chr1","17685124","17685432","21","1238271"
"chr1","18975970","18976263","chr1","17737031","17737327","24","1238939"
"chr1","18978328","18978610","chr1","17739386","17739672","29","1238942"
"chr1","18990869","18991173","chr1","17757381","17757681","20","1233488"
"chr1","18997352","18997562","chr10","73195715","73195925","39","54198363"
"chr1","19011692","19011934","chr1","17778281","17778527","14","1233411"
"chr1","19047290","19047516","chr1","17814446","17814676","16","1232844"
"chr1","19089372","19089651","chr11","132393554","132393839","62","113304182"
"chr1","19135840","19135978","chr1","17913858","17913996","7","1221982"
"chr1","19175891","19176085","chr1","17954359","17954556","20","1221532"
"chr1","19231512","19231641","chr1","18012396","18012519","10","1219116"
"chr1","19264956","19265147","chr19","1054935","1055142","53","18210021"
"chr1","19268105","19268222","chrX","40491044","40491160","25","21222939"
"chr1","19268254","19268413","chrX","17806427","17806582","39","1461827"
"chr1","19269173","19269378","chr20","35094996","35095206","45","15825823"
"chr1","19271911","19272203","chr5","184078871","184079160","62","164806960"
"chr1","19284352","19284651","chr2","108954834","108955131","65","89670482"
"chr1","19295189","19295403","chr1","220653461","220653668","52","201358272"
"chr1","19323495","19323629","chr6","77071847","77071983","19","57748352"
"chr1","19325922","19326119","chr6","152795201","152795407","49","133469279"
"chr1","19327529","19327823","chr1","18104094","18104406","39","1223435"
"chr1","19340993","19341126","chr1","18118277","18118410","7","1222716"
"chr1","19345174","19345294","chr3","2150481","2150601","14","17194693"
"chr1","19369263","19369552","chr1","18148172","18148468","30","1221091"
"chr1","19370601","19370731","chr15","26695740","26695863","20","7325139"
"chr1","19417765","19418044","chr1","18199957","18200238","13","1217808"
"chr1","19421039","19421288","chr1","18203225","18203487","32","1217814"
"chr1","19454078","19454390","chr1","18235834","18236135","37","1218244"
"chr1","19470842","19470997","chr10","72976219","72976371","40","53505377"
"chr1","19471025","19471117","chrX","95110180","95110264","25","75639155"
"chr1","19491980","19492296","chr1","18272240","18272538","38","1219740"
"chr1","19495003","19495285","chr1","18274875","18275158","46","1220128"
"chr1","19501042","19501336","chr1","18281096","18281384","47","1219946"
"chr1","19511325","19511398","chr1","18290856","18290929","5","1220469"
"chr1","19512031","19512258","chr1","18291565","18291791","14","1220466"
"chr1","19519618","19519868","chr1","18300971","18301221","13","1218647"
"chr1","19526609","19526931","chr1","18308134","18308453","24","1218475"
"chr1","19527332","19527635","chr1","18309016","18309316","25","1218316"
"chr1","19537176","19537498","chr1","18319114","18319415","41","1218062"
"chr1","19537969","19538276","chr7","45639425","45639731","53","26101456"
"chr1","19557196","19557439","chr9","56702789","56703029","63","37145593"
"chr1","19558023","19558179","chr1","18332227","18332382","14","1225796"
"chr1","19558476","19558602","chr1","18332686","18332812","11","1225790"
"chr1","19587022","19587325","chr1","18365905","18366216","40","1221117"
"chr1","19594108","19594409","chr1","18373246","18373529","39","1220862"
"chr1","19600011","19600319","chr8","122344226","122344533","53","102744215"
"chr1","19616846","19617017","chr2","150423472","150423642","38","130806626"
"chr1","19617044","19617181","chr19","18437726","18437858","24","1179318"
"chr1","19635835","19636151","chr1","18420676","18420991","28","1215159"
"chr1","19645227","19645492","chr1","18429844","18430103","27","1215383"
"chr1","19647737","19647984","chr8","92687825","92688073","47","73040088"
"chr1","19649724","19649926","chr9","82901461","82901660","59","63251737"
"chr1","19649953","19650068","chr3","42286128","42286243","21","22636175"
"chr1","19657278","19657561","chr1","18442592","18442861","33","1214686"
"chr1","19659980","19660176","chr1","18444981","18445179","26","1214999"
"chr1","19670432","19670722","chr1","18455863","18456131","41","1214569"
"chr1","19679243","19679488","chr1","18464212","18464442","30","1215031"
"chr1","19681810","19682079","chr1","18466845","18467114","15","1214965"
"chr1","19703779","19704068","chr1","18486288","18486580","39","1217491"
"chr1","19712812","19713090","chr1","18495312","18495588","24","1217500"
"chr1","19713091","19713293","chr1","18495593","18495796","17","1217498"
"chr1","19716744","19717027","chr1","18497590","18497870","33","1219154"
"chr1","19718521","19718651","chr11","121219101","121219227","22","101500580"
"chr1","19758873","19759124","chr1","18544430","18544683","19","1214443"
"chr1","19777577","19777868","chr1","18564048","18564342","27","1213529"
"chr1","19785692","19786004","chr1","18573124","18573436","22","1212568"
"chr1","19806729","19807025","chr7","68422646","68422935","63","48615917"
"chr1","19825917","19826197","chr1","18618001","18618279","24","1207916"
"chr1","19833737","19833829","chr3","158873113","158873201","19","139039376"
"chr1","19867820","19868129","chr1","18648918","18649231","23","1218902"
"chr1","19872789","19873089","chr1","18653955","18654250","18","1218834"
"chr1","19877782","19878065","chr4","158423696","158423977","53","138545914"
"chr1","19881763","19881886","chr1","18663072","18663194","6","1218691"
"chr1","19913803","19914081","chr1","18695491","18695782","35","1218312"
"chr1","19949627","19949918","chr1","18736259","18736552","27","1213368"
"chr1","19972414","19972548","chr1","18773305","18773439","6","1199109"
"chr1","20057084","20057377","chr1","18846087","18846377","23","1210997"
"chr1","20062509","20062639","chr1","18851582","18851713","8","1210927"
"chr1","20064621","20064897","chr1","18853705","18853987","26","1210916"
"chr1","20091761","20092008","chr1","18881818","18882078","32","1209943"
"chr1","20099377","20099669","chr1","18889461","18889747","22","1209916"
"chr1","20100389","20100700","chr1","18890481","18890776","40","1209908"
"chr1","20117772","20118036","chr1","18911986","18912266","50","1205786"
"chr1","20122201","20122367","chr1","163204360","163204527","36","143082159"
"chr1","20123880","20124148","chr1","18917829","18918095","21","1206051"
"chr1","20144316","20144614","chr1","18937773","18938061","50","1206543"
"chr1","20171764","20172079","chr1","18964905","18965231","34","1206859"
"chr1","20183407","20183541","chr8","40540535","40540669","24","20357128"
"chr1","20207164","20207382","chr10","16790120","16790329","50","3417044"
"chr1","20207987","20208101","chr1","19001537","19001651","8","1206450"
"chr1","20216146","20216436","chr1","19009772","19010062","31","1206374"
"chr1","20216532","20216815","chr1","19010159","19010435","23","1206373"
"chr1","20296440","20296740","chr1","19090231","19090506","45","1206209"
"chr1","20333434","20333742","chr1","19126784","19127094","36","1206650"
"chr1","20345812","20346142","chr1","19139121","19139403","65","1206691"
"chr1","20349603","20349735","chr1","19142889","19143021","11","1206714"
"chr1","20350034","20350183","chr1","19143330","19143488","21","1206704"
"chr1","20376476","20376775","chr1","19169866","19170165","19","1206610"
"chr1","20471162","20471477","chr1","19268987","19269284","38","1202175"
"chr1","20486098","20486390","chr1","19283810","19284112","42","1202288"
"chr1","20492647","20492951","chr1","19290350","19290666","25","1202297"
"chr1","20499174","20499455","chr17","30119772","30120053","57","9620598"
"chr1","20499741","20499752","chr2","139350862","139350874","2","118851121"
"chr1","20502206","20502515","chr1","19300939","19301248","24","1201267"
"chr1","20505947","20506235","chr1","19304975","19305263","26","1200972"
"chr1","20528733","20529035","chr1","19330754","19331060","18","1197979"
"chr1","20534460","20534733","chr1","19336059","19336334","38","1198401"
"chr1","20546481","20546597","chr1","19348371","19348487","9","1198110"
"chr1","20546895","20547069","chr1","19348791","19348977","29","1198104"
"chr1","20580048","20580324","chr1","19392047","19392327","26","1188001"
"chr1","20580706","20581013","chr1","19392702","19393013","27","1188004"
"chr1","20587289","20587599","chr1","19398923","19399212","39","1188366"
"chr1","20588047","20588354","chr1","19399668","19399967","26","1188379"
"chr1","20591248","20591551","chr7","41578296","41578589","55","20987048"
"chr1","20614689","20615022","chr1","19427247","19427589","35","1187442"
"chr1","20623693","20623988","chr3","157359608","157359908","66","136735915"
"chr1","20625572","20625842","chr1","19440321","19440605","34","1185251"
"chr1","20630162","20630424","chr1","19444520","19444782","14","1185642"
"chr1","20640266","20640598","chr3","132351538","132351859","72","111711272"
"chr1","20653685","20653976","chr3","48203268","48203560","55","27549583"
"chr1","20668428","20668705","chr1","19482308","19482613","53","1186120"
"chr1","20685350","20685519","chr10","14457055","14457230","30","6228295"
"chr1","20685812","20685845","chr11","120039940","120039969","9","99354128"
"chr1","20686149","20686269","chr17","39507177","39507300","17","18821028"
"chr1","20686759","20687074","chr20","24010200","24010492","70","3323441"
"chr1","20690913","20691216","chr1","19505988","19506290","16","1184925"
"chr1","20692539","20692841","chr1","19507619","19507924","26","1184920"
"chr1","20699446","20699746","chr1","19514699","19514999","26","1184747"
"chr1","20701031","20701318","chr1","19516923","19517222","23","1184108"
"chr1","20702626","20702919","chr1","19518491","19518784","19","1184135"
"chr1","20712643","20712887","chr13","43846014","43846273","64","23133371"
"chr1","20730154","20730426","chr5","139267239","139267525","68","118537085"
"chr1","20734124","20734423","chr1","19549868","19550164","27","1184256"
"chr1","20740299","20740580","chr5","51322379","51322663","53","30582080"
"chr1","20744945","20745250","chrX","64991673","64991978","69","44246728"
"chr1","20754226","20754521","chr1","19571541","19571840","32","1182685"
"chr1","20763688","20763865","chr1","19580709","19580875","31","1182979"
"chr1","20764175","20764291","chr1","19581166","19581294","20","1183009"
"chr1","20768811","20768928","chr1","19586147","19586264","7","1182664"
"chr1","20776758","20776885","chr1","19594220","19594347","10","1182538"
"chr1","20782705","20782981","chr1","19600514","19600786","29","1182191"
"chr1","20796292","20796567","chr1","19614555","19614829","13","1181737"
"chr1","20807277","20807563","chr1","19623973","19624282","37","1183304"
"chr1","20815932","20816234","chr9","105999659","105999970","64","85183727"
"chr1","20828107","20828399","chr1","19643680","19643985","29","1184427"
"chr1","20828694","20828988","chr1","19644281","19644585","28","1184413"
"chr1","20836033","20836322","chr15","29615590","29615889","59","8779557"
"chr1","20856251","20856385","chr1","19669794","19669922","11","1186457"
"chr1","20867880","20868185","chr1","19680991","19681295","37","1186889"
"chr1","20868535","20868805","chr1","19681637","19681907","22","1186898"
"chr1","20885102","20885394","chr1","137319296","137319583","69","116434194"
"chr1","20888362","20888649","chr1","19702539","19702833","25","1185823"
"chr1","20896500","20896799","chr1","19710630","19710931","20","1185870"
"chr1","20901967","20902259","chr1","19715428","19715728","35","1186539"
"chr1","20903458","20903753","chr1","19716927","19717223","39","1186531"
"chr1","20910379","20910667","chr20","24010200","24010492","61","3099821"
"chr1","20917691","20917967","chr3","123351694","123351976","58","102434003"
"chr1","20918533","20918830","chr1","19732350","19732636","31","1186183"
"chr1","20920001","20920236","chr3","178167687","178167924","45","157247686"
"chr1","20952937","20953232","chr14","104533645","104533935","66","83580708"
"chr1","20996240","20996520","chr1","19809968","19810262","35","1186272"
"chr1","21002404","21002701","chr1","19816491","19816786","20","1185913"
"chr1","21008688","21008794","chr1","19822769","19822870","11","1185919"
"chr1","21011133","21011434","chr1","19824911","19825208","24","1186222"
"chr1","21013384","21013682","chr1","19827473","19827757","44","1185911"
"chr1","21020936","21021058","chr1","19835445","19835567","6","1185491"
"chr1","21021296","21021615","chr1","19835807","19836090","55","1185489"
"chr1","21025247","21025550","chr8","38588275","38588563","80","17563028"
"chr1","21036295","21036587","chr1","19850771","19851068","17","1185524"
"chr1","21054776","21054943","chr13","71306528","71306706","51","50251752"
"chr1","21071726","21072035","chr1","19889886","19890180","37","1181840"
"chr1","21074977","21075141","chr1","19893166","19893324","17","1181811"
"chr1","21078305","21078520","chr1","19897424","19897650","20","1180881"
"chr1","21083412","21083662","chr10","37997666","37997915","55","16914254"
"chr1","21086709","21086975","chr1","19904033","19904287","30","1182676"
"chr1","21102815","21102925","chr2","34857283","34857395","23","13754468"
"chr1","21114265","21114556","chr1","128695684","128695966","77","107581419"
"chr1","21124093","21124399","chr1","19943298","19943604","24","1180795"
"chr1","21124487","21124793","chr1","19943712","19944004","53","1180775"
"chr1","21131189","21131479","chr1","19950609","19950909","53","1180580"
"chr1","21132731","21133038","chr1","19952127","19952437","25","1180604"
"chr1","21137064","21137364","chr1","19956567","19956869","25","1180497"
"chr1","21148142","21148352","chr14","52870570","52870773","45","31722428"
"chr1","21172251","21172540","chr13","91625412","91625701","59","70453161"
"chr1","21172558","21172741","chr1","20007443","20007615","24","1165115"
"chr1","21174379","21174538","chr9","26540592","26540755","41","5366213"
"chr1","21185028","21185331","chr1","20022643","20022928","30","1162385"
"chr1","21196439","21196670","chr15","10211767","10211989","53","10984672"
"chr1","21198333","21198410","chr1","7391604","7391678","13","13806729"
"chr1","21209161","21209458","chr2","184143766","184144059","49","162934605"
"chr1","21215488","21215637","chr9","82524514","82524665","39","61309026"
"chr1","21215933","21216061","chr3","162144405","162144534","29","140928472"
"chr1","21222137","21222434","chr1","20057115","20057399","42","1165022"
"chr1","21224329","21224626","chr1","20059269","20059564","20","1165060"
"chr1","21248107","21248368","chr1","20085330","20085598","23","1162777"
"chr1","21270788","21270987","chr10","17041385","17041582","31","4229403"
"chr1","21284770","21285072","chr7","52199292","52199594","60","30914522"
"chr1","21298509","21298857","chrX","48162977","48163283","115","26864468"
"chr1","21337212","21337358","chr1","20182739","20182886","21","1154473"
"chr1","21337669","21337700","chr1","20183202","20183232","2","1154467"
"chr1","21337995","21338140","chrX","41038889","41039039","41","19700894"
"chr1","21343327","21343467","chr1","20192471","20192606","12","1150856"
"chr1","21343798","21343939","chr1","20192943","20193091","14","1150855"
"chr1","21352081","21352269","chr1","20201438","20201628","14","1150643"
"chr1","21602328","21602505","chr1","91696625","91696802","13","70094297"
"chr1","21623184","21623476","chr1","123864081","123864371","24","102240897"
"chr1","21646335","21646470","chr17","25722560","25722695","22","4076225"
"chr1","21646772","21646928","chr14","9041730","9041892","32","12605042"
"chr1","21660742","21660995","chr2","3434127","3434384","71","18226615"
"chr1","21674512","21674817","chr1","20288032","20288350","37","1386480"
"chr1","21687863","21688123","chr1","20302030","20302292","21","1385833"
"chr1","21714785","21715077","chr7","120532126","120532421","59","98817341"
"chr1","21716036","21716177","chr6","145629603","145629744","32","123913567"
"chr1","21719840","21720092","chr1","20333781","20334042","36","1386059"
"chr1","21725033","21725336","chr2","160551205","160551504","57","138826172"
"chr1","21730096","21730341","chr14","106651296","106651534","48","84921200"
"chr1","21730343","21730483","chr2","101380040","101380184","31","79649697"
"chr1","21738871","21739169","chr1","20353204","20353495","31","1385667"
"chr1","21747965","21748218","chr10","48091879","48092129","67","26343914"
"chr1","21787978","21788254","chr19","33574257","33574528","58","11786279"
"chr1","21793070","21793414","chr1","211647137","211647448","94","189854067"
"chr1","21809619","21809925","chr1","20427628","20427941","37","1381991"
"chr1","21839119","21839379","chr1","20459075","20459318","29","1380044"
"chr1","21846295","21846609","chr1","20466219","20466538","27","1380076"
"chr1","21864252","21864508","chr14","78448740","78448996","63","56584488"
"chr1","21868042","21868349","chr1","20488967","20489268","21","1379075"
"chr1","21877218","21877510","chr1","20497392","20497675","22","1379826"
"chr1","21889076","21889387","chr1","20510170","20510490","36","1378906"
"chr1","21892848","21892998","chr19","17044024","17044168","32","4848824"
"chr1","21893309","21893353","chr12","112435949","112435996","10","90542640"
"chr1","21896336","21896618","chr1","20514753","20515037","12","1381583"
"chr1","21904892","21904932","chr1","20522703","20522743","1","1382189"
"chr1","21905366","21905671","chr1","20523151","20523461","25","1382215"
"chr1","21911272","21911395","chr1","20529289","20529409","18","1381983"
"chr1","21917137","21917345","chr1","20535020","20535191","47","1382117"
"chr1","21925296","21925483","chrX","49252322","49252508","49","27327026"
"chr1","21932363","21932635","chr5","186597229","186597499","68","164664866"
"chr1","21933609","21933706","chr1","20554722","20554833","21","1378887"
"chr1","22024212","22024473","chr11","576346","576611","59","21447866"
"chr1","22040411","22040715","chr1","20670902","20671205","16","1369509"
"chr1","22048706","22048969","chr1","20679496","20679759","16","1369210"
"chr1","22062839","22063086","chr2","96436489","96436735","50","74373650"
"chr1","22064607","22064875","chr1","20696345","20696615","20","1368262"
"chr1","22115776","22116089","chr1","20748646","20748959","20","1367130"
"chr1","22135245","22135529","chr1","20767068","20767351","14","1368177"
"chr1","22137603","22137798","chr5","182870756","182870952","44","160733153"
"chr1","22144312","22144586","chr1","20773687","20773967","26","1370625"
"chr1","22152862","22153182","chr7","165716105","165716404","62","143563243"
"chr1","22153198","22153498","chr1","53106748","53107031","64","30953550"
"chr1","22157924","22158220","chr1","20789424","20789741","34","1368500"
"chr1","22170009","22170303","chr1","20804027","20804335","45","1365982"
"chr1","22173126","22173393","chr8","71689849","71690123","57","49516723"
"chr1","22176788","22177080","chr11","113114919","113115214","56","90938131"
"chr1","22179902","22180110","chr1","20814489","20814702","20","1365413"
"chr1","22195686","22195924","chr7","126111761","126111972","67","103916075"
"chr1","22209299","22209573","chr1","20845394","20845668","13","1363905"
"chr1","22301893","22302190","chr1","20941138","20941435","15","1360755"
"chr1","22345629","22345909","chr1","20982389","20982671","22","1363240"
"chr1","22374330","22374634","chr1","21011949","21012233","51","1362381"
"chr1","22389277","22389392","chr1","21026778","21026893","10","1362499"
"chr1","22391878","22392178","chr1","21029408","21029709","42","1362470"
"chr1","22426694","22427012","chr1","21062875","21063179","28","1363819"
"chr1","22444457","22444576","chr1","21082654","21082773","11","1361803"
"chr1","22451300","22451450","chr3","44304041","44304188","27","21852741"
"chr1","22471104","22471408","chr1","21110962","21111269","22","1360142"
"chr1","22487720","22487843","chr2","107844001","107844127","18","85356281"
"chr1","22488347","22488644","chr1","21129274","21129580","29","1359073"
"chr1","22563275","22563500","chr4","34829421","34829653","45","12266146"
"chr1","22591637","22591778","chr1","21230253","21230392","10","1361384"
"chr1","22610489","22610580","chr6","66228061","66228151","14","43617572"
"chr1","22703811","22704092","chr1","21344346","21344621","29","1359465"
"chr1","22724657","22724781","chr1","21363565","21363686","13","1361092"
"chr1","22744538","22744848","chr1","21384148","21384435","47","1360390"
"chr1","22769804","22770097","chr1","194090838","194091133","51","171321034"
"chr1","22804111","22804408","chr1","43496894","43497193","58","20692783"
"chr1","22825917","22826259","chr1","21464829","21465206","66","1361088"
"chr1","22835174","22835488","chr1","21474061","21474377","24","1361113"
"chr1","22868560","22868885","chrX","127203368","127203678","67","104334808"
"chr1","22872474","22872632","chr12","21323547","21323703","28","1548927"
"chr1","22875958","22876224","chr7","19580653","19580903","69","3295305"
"chr1","22876354","22876649","chr12","38582080","38582375","52","15705726"
"chr1","22891435","22891731","chr14","122733616","122733911","57","99842181"
"chr1","22901920","22902226","chr11","109624796","109625101","56","86722876"
"chr1","22920980","22921264","chr1","21560196","21560484","21","1360784"
"chr1","22937239","22937411","chr1","21576038","21576212","17","1361201"
"chr1","22945217","22945515","chr1","21583905","21584204","23","1361312"
"chr1","22955832","22955948","chr3","42098713","42098828","13","19142881"
"chr1","23033274","23033573","chr1","211353988","211354282","51","188320714"
"chr1","23068159","23068463","chr17","7032433","7032735","61","16035726"
"chr1","23070384","23070692","chr14","69100958","69101269","78","46030574"
"chr1","23070736","23071015","chr9","64360705","64360983","64","41289969"
"chr1","23073353","23073537","chr13","75616065","75616265","53","52542712"
"chr1","23082145","23082440","chr1","21718398","21718698","25","1363747"
"chr1","23089482","23089783","chr1","21726218","21726508","32","1363264"
"chr1","23091518","23091752","chr20","33668679","33668914","50","10577161"
"chr1","23100306","23100437","chr1","21737332","21737464","8","1362974"
"chr1","23100742","23100881","chr1","21737772","21737917","25","1362970"
"chr1","23103911","23104175","chr1","21740968","21741240","22","1362943"
"chr1","23106840","23106863","chr8","22177824","22177847","5","929016"
"chr1","23107161","23107432","chr1","21744273","21744538","18","1362888"
"chr1","23113148","23113176","chr1","134248153","134248180","3","111135005"
"chr1","23113215","23113405","chr14","21649801","21649992","40","1463414"
"chr1","23147958","23148223","chr11","131209524","131209777","54","108061566"
"chr1","23157421","23157708","chr5","139756441","139756723","57","116599020"
"chr1","23172469","23172560","chr1","21802880","21802972","10","1369589"
"chr1","23187858","23188145","chr1","21818895","21819212","57","1368963"
"chr1","23192131","23192388","chr5","9176993","9177243","64","14015138"
"chr1","23192600","23192740","chr5","168973759","168973905","44","145781159"
"chr1","23231669","23231948","chr1","21862248","21862525","15","1369421"
"chr1","23236779","23236896","chr1","21867318","21867441","13","1369461"
"chr1","23236998","23237015","chr19","4261131","4261146","2","18975867"
"chr1","23237062","23237354","chrX","15902142","15902434","69","7334920"
"chr1","23242480","23242766","chr1","21873364","21873647","16","1369116"
"chr1","23244943","23245031","chr1","21875832","21875920","10","1369111"
"chr1","23293867","23294139","chr1","21881748","21882026","32","1412119"
"chr1","23299129","23299403","chr1","21886064","21886333","53","1413065"
"chr1","23300185","23300475","chr1","21887118","21887411","24","1413067"
"chr1","23313395","23313692","chr7","36331166","36331462","54","13017771"
"chr1","23318538","23318826","chr1","21908027","21908341","49","1410511"
"chr1","23320539","23320701","chr1","21910058","21910221","17","1410481"
"chr1","23320999","23321147","chr1","21910521","21910668","8","1410478"
"chr1","23332803","23333059","chr1","21923100","21923359","20","1409703"
"chr1","23350187","23350314","chr1","21941778","21941906","10","1408409"
"chr1","23350917","23351083","chr1","21942508","21942674","6","1408409"
"chr1","23354638","23354950","chr1","21946258","21946554","35","1408380"
"chr1","23359518","23359802","chr1","21951153","21951404","55","1408365"
"chr1","23374229","23374528","chr7","140100928","140101221","60","116726699"
"chr1","23380616","23380926","chr1","21972330","21972640","20","1408286"
"chr1","23403190","23403460","chr12","10391753","10392027","56","13011437"
"chr1","23406997","23407310","chr7","45450102","45450409","63","22043105"
"chr1","23414774","23414933","chr1","22009070","22009246","25","1405704"
"chr1","23415215","23415342","chr1","22009524","22009660","19","1405691"
"chr1","23417423","23417642","chr1","22012289","22012528","35","1405134"
"chr1","23420291","23420576","chr1","22015220","22015533","56","1405071"
"chr1","23426162","23426480","chr1","22021146","22021469","34","1405016"
"chr1","23442908","23443207","chr1","22037349","22037656","26","1405559"
"chr1","23450272","23450543","chr10","62116808","62117080","56","38666536"
"chr1","23454367","23454497","chr1","22054708","22054834","16","1399659"
"chr1","23460543","23460845","chr16","68450975","68451269","52","44990432"
"chr1","23526959","23527063","chr3","130244030","130244121","26","106717071"
"chr1","23543996","23544291","chr1","22151331","22151636","26","1392665"
"chr1","23545208","23545427","chr11","110297779","110297994","44","86752571"
"chr1","23555613","23555751","chr1","22162223","22162356","24","1393390"
"chr1","23556027","23556208","chr1","22162643","22162827","8","1393384"
"chr1","23576873","23577185","chr1","22188179","22188480","32","1388694"
"chr1","23578343","23578606","chr1","22189633","22189889","23","1388710"
"chr1","23623638","23623947","chr15","26509484","26509789","56","2885846"
"chr1","23636126","23636258","chr13","87095059","87095190","18","63458933"
"chr1","23639321","23639629","chr1","22250844","22251154","28","1388477"
"chr1","23641974","23642115","chr9","71653682","71653822","28","48011708"
"chr1","23642411","23642595","chr1","22253644","22253833","21","1388767"
"chr1","23667228","23667419","chr3","37880884","37881056","42","14213656"
"chr1","23667733","23667872","chr16","22194752","22194884","31","1472981"
"chr1","23668987","23669151","chr19","41838414","41838568","46","18169427"
"chr1","23679873","23680138","chr1","22290620","22290885","27","1389253"
"chr1","23688110","23688412","chr1","22303578","22303888","29","1384532"
"chr1","23692592","23692893","chr1","22308597","22308897","25","1383995"
"chr1","23697222","23697522","chr1","22313302","22313619","37","1383920"
"chr1","23722943","23723234","chr1","22338250","22338544","21","1384693"
"chr1","23746397","23746685","chr1","22363098","22363394","28","1383299"
"chr1","23746902","23747069","chr1","22363611","22363777","10","1383291"
"chr1","23758359","23758554","chr7","18986491","18986688","45","4771868"
"chr1","23768633","23768764","chr1","22386132","22386263","6","1382501"
"chr1","23774307","23774422","chr13","92229940","92230056","16","68455633"
"chr1","23781264","23781539","chr2","134217641","134217927","61","110436377"
"chr1","23784474","23784716","chr1","22410424","22410676","32","1374050"
"chr1","23808277","23808562","chr1","22426968","22427235","56","1381309"
"chr1","23838715","23838831","chr1","22457543","22457653","12","1381172"
"chr1","23856329","23856623","chr1","22477049","22477342","21","1379280"
"chr1","23865247","23865522","chr1","22485737","22486012","14","1379510"
"chr1","23879902","23880045","chr1","22499422","22499566","5","1380480"
"chr1","23882170","23882227","chr3","30146684","30146739","10","6264514"
"chr1","23884688","23884956","chr1","22503793","22504085","37","1380895"
"chr1","23928944","23929031","chr13","1772973","1773060","16","22155971"
"chr1","23929321","23929533","chr7","52471521","52471733","54","28542200"
"chr1","23938782","23939052","chr1","22556342","22556611","22","1382440"
"chr1","23942415","23942628","chr2","94580235","94580453","43","70637820"
"chr1","23989745","23989855","chr1","22608549","22608659","5","1381196"
"chr1","23991562","23991849","chr1","22610610","22610923","37","1380952"
"chr1","24002806","24002940","chr1","22624457","22624591","10","1378349"
"chr1","24004339","24004649","chr1","22626619","22626894","58","1377720"
"chr1","24006978","24007108","chr20","23393491","23393621","23","613487"
"chr1","24021513","24021810","chr1","46234312","46234606","55","22212799"
"chr1","24034211","24034550","chr1","109806160","109806457","84","85771949"
"chr1","24039041","24039352","chr1","22658934","22659242","22","1380107"
"chr1","24059764","24059873","chr14","15716939","15717051","26","8342825"
"chr1","24066276","24066393","chr7","131371999","131372116","16","107305723"
"chr1","24072461","24072591","chr4","73819458","73819584","23","49746997"
"chr1","24086467","24086755","chr1","22713480","22713776","26","1372987"
"chr1","24090909","24091225","chr1","53762820","53763135","59","29671911"
"chr1","24114014","24114318","chr1","44230646","44230948","64","20116632"
"chr1","24119419","24119720","chr1","22748221","22748528","37","1371198"
"chr1","24156747","24157011","chr16","26567861","26568129","72","2411114"
"chr1","24170744","24171014","chr8","117236364","117236630","72","93065620"
"chr1","24172718","24172955","chr1","22792288","22792516","34","1380430"
"chr1","24181875","24182070","chr2","187607888","187608063","55","163426013"
"chr1","24182373","24182502","chr6","80196250","80196384","22","56013877"
"chr1","24207278","24207564","chr1","22845605","22845892","43","1361673"
"chr1","24210741","24211013","chr1","22847917","22848216","48","1362824"
"chr1","24212357","24212645","chr3","50649607","50649887","53","26437250"
"chr1","24216038","24216333","chr9","108928751","108929050","54","84712713"
"chr1","24222019","24222300","chr1","22864131","22864409","21","1357888"
"chr1","24282249","24282535","chr18","47931505","47931784","57","23649256"
"chr1","24283762","24284051","chr1","22929342","22929637","25","1354420"
"chr1","24296920","24297210","chr1","22943107","22943409","35","1353813"
"chr1","24317071","24317367","chr3","136459037","136459335","50","112141966"
"chr1","24320651","24320860","chr1","22964347","22964552","30","1356304"
"chr1","24340809","24341075","chr1","22984042","22984309","29","1356767"
"chr1","24352500","24352652","chr1","22995824","22995974","10","1356676"
"chr1","24352962","24353103","chr1","22996283","22996435","19","1356679"
"chr1","24354659","24354871","chr1","22997988","22998216","39","1356671"
"chr1","24364302","24364589","chr3","74053446","74053735","70","49689144"
"chr1","24379522","24379771","chr1","23023357","23023605","20","1356165"
"chr1","24385455","24385629","chr1","23028691","23028869","18","1356764"
"chr1","24385913","24386054","chr1","23029155","23029296","9","1356758"
"chr1","24390378","24390522","chr1","23033622","23033771","19","1356756"
"chr1","24390816","24390975","chrX","17806427","17806582","28","6584389"
"chr1","24403096","24403399","chrX","96878513","96878823","55","72475417"
"chr1","24427027","24427336","chr5","101488244","101488549","59","77061217"
"chr1","24445555","24445862","chr1","23084029","23084340","23","1361526"
"chr1","24467884","24468165","chr5","139756441","139756723","51","115288557"
"chr1","24470783","24470956","chr20","22980440","22980608","32","1490343"
"chr1","24472062","24472381","chr15","346916","347236","66","24125146"
"chr1","24472893","24473174","chr1","23111649","23111931","23","1361244"
"chr1","24482962","24483257","chr1","23122019","23122305","25","1360943"
"chr1","24553094","24553276","chr19","2472679","2472851","39","22080415"
"chr1","24553563","24553700","chr12","46389903","46390042","25","21836340"
"chr1","24565693","24566000","chr1","23203776","23204102","41","1361917"
"chr1","24585316","24585602","chr1","23223583","23223878","35","1361733"
"chr1","24594279","24594559","chr1","23233573","23233874","34","1360706"
"chr1","24595405","24595522","chr1","23234693","23234815","15","1360712"
"chr1","24603169","24603277","chrX","47541698","47541808","21","22938529"
"chr1","24603303","24603501","chr11","23440449","23440645","40","1162854"
"chr1","24625755","24626053","chr1","23265629","23265885","65","1360126"
"chr1","24634510","24634822","chr1","23273967","23274297","52","1360543"
"chr1","24641234","24641381","chr1","23280703","23280853","12","1360531"
"chr1","24654371","24654672","chr1","23292056","23292364","31","1362315"
"chr1","24657210","24657518","chr1","23294871","23295170","35","1362339"
"chr1","24663391","24663745","chr1","23301134","23301474","42","1362257"
"chr1","24664866","24665112","chr1","23302612","23302873","31","1362254"
"chr1","24667349","24667651","chr1","23305813","23306115","14","1361536"
"chr1","24676621","24676919","chr1","23314433","23314732","19","1362188"
"chr1","24700425","24700549","chr1","23338581","23338704","8","1361844"
"chr1","24701301","24701535","chr6","32166318","32166542","52","7465017"
"chr1","24709024","24709295","chr1","23350589","23350846","37","1358435"
"chr1","24758945","24759077","chr1","205464254","205464380","20","180705309"
"chr1","24760048","24760361","chr1","23406649","23406957","35","1353399"
"chr1","24788049","24788360","chr1","23432416","23432733","21","1355633"
"chr1","24804380","24804693","chr1","23451852","23452164","21","1352528"
"chr1","24807134","24807437","chr13","44811753","44812050","51","20004619"
"chr1","24817482","24817594","chr1","23467639","23467751","4","1349843"
"chr1","24838943","24839070","chr1","23489427","23489544","19","1349516"
"chr1","24848924","24849177","chr1","23499604","23499860","12","1349320"
"chr1","24852287","24852550","chr4","128903519","128903790","55","104051232"
"chr1","24859054","24859174","chr3","36373230","36373353","22","11514176"
"chr1","24870358","24870573","chr15","8774329","8774521","71","16096029"
"chr1","24896393","24896674","chr1","23545860","23546142","14","1350533"
"chr1","24927334","24927471","chr1","23575468","23575605","13","1351866"
"chr1","24927743","24927916","chr1","23575870","23576056","26","1351873"
"chr1","24940152","24940448","chr1","23586472","23586746","38","1353680"
"chr1","24950946","24951247","chr20","22875232","22875535","58","2075714"
"chr1","24951859","24952138","chr1","23601069","23601364","35","1350790"
"chr1","24959692","24959995","chr1","23609446","23609754","23","1350246"
"chr1","24968443","24968567","chr1","23618337","23618460","8","1350106"
"chr1","24969778","24970058","chr1","23619640","23619920","24","1350138"
"chr1","24988310","24988617","chr1","23637176","23637459","51","1351134"
"chr1","25021361","25021479","chr1","23671450","23671562","18","1349911"
"chr1","25032065","25032360","chr20","33500619","33500904","64","8468554"
"chr1","25052276","25052581","chr1","23700131","23700423","33","1352145"
"chr1","25069174","25069448","chr1","23717134","23717405","22","1352040"
"chr1","25097331","25097630","chr1","23745870","23746167","20","1351461"
"chr1","25113413","25113555","chr2","93688594","93688737","34","68575181"
"chr1","25248197","25248522","chr1","23889603","23889916","33","1358594"
"chr1","25288217","25288300","chrX","53790985","53791067","11","28502768"
"chr1","25297758","25297981","chr1","23942951","23943176","15","1354807"
"chr1","25315075","25315399","chr1","23960430","23960749","19","1354645"
"chr1","25337704","25337892","chr20","30429126","30429316","44","5091422"
"chr1","25345496","25345793","chr1","23993658","23993954","42","1351838"
"chr1","25376113","25376423","chr1","24028753","24029044","35","1347360"
"chr1","25386605","25386922","chr1","24039003","24039318","22","1347602"
"chr1","25411449","25411779","chr1","24068238","24068539","47","1343211"
"chr1","25413275","25413542","chr4","43879415","43879692","84","18466140"
"chr1","25424582","25424876","chr5","165928913","165929218","70","140504331"
"chr1","25430960","25431258","chr1","24085319","24085615","35","1345641"
"chr1","25777734","25778022","chr1","24198301","24198586","14","1579433"
"chr1","25796949","25797266","chr1","24217325","24217642","23","1579624"
"chr1","25804530","25804750","chr2","94580235","94580453","39","68775705"
"chr1","25852145","25852446","chr1","24273728","24274021","46","1578417"
"chr1","25883096","25883374","chr1","24305455","24305733","22","1577641"
"chr1","25916607","25916920","chr4","54081952","54082263","58","28165345"
"chr1","25951683","25951979","chr1","211353988","211354282","65","185402305"
"chr1","25986861","25987048","chr16","44201467","44201664","21","18214606"
"chr1","25987870","25988148","chr16","44200040","44200319","13","18212170"
"chr1","25997142","25997442","chr1","24426901","24427197","33","1570241"
"chr1","26024211","26024524","chr1","24454213","24454524","17","1569998"
"chr1","26033120","26033419","chr1","24463343","24463632","24","1569777"
"chr1","26047140","26047354","chr8","92417384","92417591","50","66370244"
"chr1","26048788","26048893","chr12","120657147","120657252","23","94608359"
"chr1","26066480","26066770","chr1","24496473","24496762","27","1570007"
"chr1","26114535","26114810","chr1","24579907","24580191","36","1534628"
"chr1","26138095","26138410","chr1","24606958","24607271","18","1531137"
"chr1","26159156","26159445","chr1","24628573","24628866","20","1530583"
"chr1","26159537","26159825","chr1","24628960","24629237","24","1530577"
"chr1","26168921","26169206","chr1","24638214","24638511","22","1530707"
"chr1","26190598","26190892","chr1","24661268","24661567","36","1529330"
"chr1","26192933","26193232","chr11","48401419","48401716","65","22208486"
"chr1","26198921","26199205","chr1","24670184","24670471","14","1528737"
"chr1","26208390","26208657","chr1","24680989","24681256","21","1527401"
"chr1","26228470","26228778","chr8","65063149","65063452","68","38834679"
"chr1","26235921","26236188","chr1","24706825","24707090","20","1529096"
"chr1","26249337","26249452","chr1","24720358","24720472","6","1528979"
"chr1","26252648","26252830","chr19","42263572","42263752","50","16010924"
"chr1","26254584","26254868","chr1","24726600","24726925","71","1527984"
"chr1","26262147","26262451","chr1","24734564","24734856","24","1527583"
"chr1","26272060","26272126","chr17","54156683","54156743","12","27884623"
"chr1","26287430","26287724","chr1","24760058","24760364","41","1527372"
"chr1","26295444","26295743","chr1","24767792","24768087","23","1527652"
"chr1","26296935","26297249","chr12","89412367","89412671","59","63115432"
"chr1","26314584","26314700","chr1","24788848","24788964","5","1525736"
"chr1","26327754","26328049","chr1","24805226","24805523","16","1522528"
"chr1","26340775","26340949","chr1","24818702","24818866","24","1522073"
"chr1","26387596","26387773","chrX","47720394","47720573","45","21332798"
"chr1","26389878","26390150","chr1","24869513","24869795","25","1520365"
"chr1","26401445","26401725","chr1","24882402","24882672","46","1519043"
"chr1","26407183","26407457","chr16","70963621","70963889","62","44556438"
"chr1","26426415","26426716","chr1","24904732","24905034","22","1521683"
"chr1","26435527","26435634","chr10","27067355","27067468","22","631828"
"chr1","26435926","26436070","chr20","29152223","29152364","37","2716297"
"chr1","26436372","26436406","chr1","24916522","24916555","3","1519850"
"chr1","26445633","26445803","chr1","24926077","24926251","14","1519556"
"chr1","26457699","26458011","chr20","50502156","50502463","63","24044457"
"chr1","26459890","26460000","chr4","111036807","111036921","25","84576917"
"chr1","26481973","26482269","chr1","24962367","24962666","23","1519606"
"chr1","26495186","26495325","chr1","24976737","24976877","10","1518449"
"chr1","26515649","26515745","chr2","84382983","84383080","20","57867334"
"chr1","26519797","26519969","chr1","25002563","25002743","18","1517234"
"chr1","26523659","26523788","chr19","28288218","28288343","23","1764559"
"chr1","26534161","26534290","chr16","24839675","24839805","18","1694486"
"chr1","26538378","26538570","chr9","113813760","113813944","49","87275382"
"chr1","26540366","26540479","chr1","25023634","25023749","9","1516732"
"chr1","26541745","26542049","chr1","25025014","25025317","23","1516731"
"chr1","26542216","26542508","chr1","25025470","25025766","32","1516746"
"chr1","26557783","26558040","chr11","32824995","32825253","49","6267212"
"chr1","26573569","26573865","chr1","25052056","25052366","49","1521513"
"chr1","26594857","26594985","chr1","25078168","25078292","12","1516689"
"chr1","26595279","26595457","chr2","75488309","75488482","40","48893030"
"chr1","26616881","26617095","chr3","3881369","3881580","53","22735512"
"chr1","26621221","26621530","chr1","25102825","25103132","25","1518396"
"chr1","26652430","26652737","chr1","25136597","25136890","29","1515833"
"chr1","26652961","26653231","chr1","25137440","25137709","31","1515521"
"chr1","26663030","26663310","chr1","25148543","25148817","24","1514487"
"chr1","26676897","26677178","chr1","25162904","25163188","43","1513993"
"chr1","26692213","26692480","chr1","25179947","25180205","39","1512266"
"chr1","26697548","26697816","chr1","37126383","37126644","50","10428835"
"chr1","26713407","26713700","chr1","25201088","25201403","43","1512319"
"chr1","26714195","26714473","chr1","25201896","25202180","24","1512299"
"chr1","26714806","26715069","chr1","25202214","25202467","36","1512592"
"chr1","26722074","26722178","chr1","183892014","183892124","25","157169940"
"chr1","26736465","26736742","chr19","30007363","30007647","56","3270898"
"chr1","26761703","26761985","chr11","9925570","9925857","58","16836133"
"chr1","26766003","26766213","chr1","25259364","25259558","29","1506639"
"chr1","26766668","26766960","chr1","25260013","25260308","20","1506655"
"chr1","26772160","26772476","chr4","104021076","104021374","67","77248916"
"chr1","26773139","26773411","chr9","11806930","11807198","51","14966209"
"chr1","26778246","26778528","chr1","25275641","25275924","16","1502605"
"chr1","26809959","26810251","chr19","21253045","21253324","32","5556914"
"chr1","26816342","26816616","chr1","25313366","25313649","31","1502976"
"chr1","26816843","26817024","chr1","25314052","25314233","10","1502791"
"chr1","26823913","26824164","chr1","25322459","25322717","23","1501454"
"chr1","26829657","26829916","chr1","25327728","25327982","46","1501929"
"chr1","26835885","26836065","chr6","179660695","179660875","48","152824810"
"chr1","26836372","26836502","chr11","4197084","4197215","24","22639288"
"chr1","26840466","26840536","chr15","86273368","86273432","11","59432902"
"chr1","26840836","26840996","chr1","25342630","25342790","12","1498206"
"chr1","26853321","26853455","chr1","25357545","25357678","5","1495776"
"chr1","26853753","26853915","chr1","25357979","25358141","13","1495774"
"chr1","26866791","26866847","chr10","33357354","33357404","12","6490563"
"chr1","26867139","26867320","chr2","50498150","50498324","40","23631011"
"chr1","26895712","26896013","chr1","25400931","25401212","32","1494781"
"chr1","26904606","26904791","chr7","68248109","68248297","54","41343503"
"chr1","26930592","26930855","chrX","53490861","53491124","53","26560269"
"chr1","26976770","26976894","chr2","107844001","107844127","15","80867231"
"chr1","26984443","26984746","chr1","25494496","25494803","36","1489947"
"chr1","26993166","26993450","chr1","25504696","25504982","15","1488470"
"chr1","26995192","26995456","chr2","41466589","41466842","73","14471397"
"chr1","27001500","27001644","chr1","25512662","25512820","33","1488838"
"chr1","27001951","27002097","chr1","25513110","25513260","13","1488841"
"chr1","27069287","27069589","chr19","43364068","43364358","55","16294781"
"chr1","27114560","27114850","chr1","25629235","25629522","16","1485325"
"chr1","27124551","27124873","chr1","25639541","25639837","44","1485010"
"chr1","27134376","27134668","chr1","25648767","25649057","17","1485609"
"chr1","27138100","27138177","chr1","25652931","25653008","7","1485169"
"chr1","27138472","27138619","chr1","25653316","25653460","11","1485156"
"chr1","27154664","27154801","chr1","25668128","25668263","8","1486536"
"chr1","27157121","27157335","chr1","181591560","181591761","79","154434439"
"chr1","27157637","27157791","chr16","48023623","48023770","26","20865986"
"chr1","27158510","27158626","chr1","25672559","25672668","10","1485951"
"chr1","27187012","27187295","chr3","133784100","133784379","63","106597088"
"chr1","27189362","27189479","chr1","25703646","25703767","10","1485716"
"chr1","27199649","27199766","chr1","25717030","25717148","5","1482619"
"chr1","27227420","27227601","chr1","25745836","25746008","18","1481584"
"chr1","27228148","27228280","chr1","25746565","25746697","5","1481583"
"chr1","27234933","27235222","chr7","136572483","136572769","61","109337550"
"chr1","27238725","27239042","chr1","25758661","25758963","30","1480064"
"chr1","27249088","27249346","chr5","139263693","139263952","59","112014605"
"chr1","27260814","27261106","chr1","25776880","25777169","20","1483934"
"chr1","27273973","27274290","chr19","36217538","36217862","65","8943565"
"chr1","27279749","27280078","chr19","40228982","40229290","94","12949233"
"chr1","27298708","27298991","chr1","25819298","25819590","28","1479410"
"chr1","27317391","27317680","chr1","25841297","25841578","21","1476094"
"chr1","27325284","27325558","chr1","109826847","109827120","72","82501563"
"chr1","27332217","27332508","chr1","25856462","25856763","26","1475755"
"chr1","27335325","27335604","chr1","25859908","25860185","21","1475417"
"chr1","27338978","27339288","chr1","25864007","25864311","26","1474971"
"chr1","27378180","27378466","chr2","99648006","99648286","57","72269826"
"chr1","27381125","27381420","chr7","140100928","140101221","57","112719803"
"chr1","27384091","27384259","chr4","18548987","18549144","31","8835104"
"chr1","27388674","27388959","chr13","93973412","93973700","54","66584738"
"chr1","27400151","27400458","chr11","109624796","109625101","62","82224645"
"chr1","27431094","27431386","chr1","25965830","25966119","18","1465264"
"chr1","27433447","27433646","chr1","25968499","25968704","21","1464948"
"chr1","27438609","27438864","chr1","25974244","25974504","26","1464365"
"chr1","27477471","27477776","chr1","26012765","26013073","24","1464706"
"chr1","27485344","27485632","chr1","26019210","26019497","17","1466134"
"chr1","27498711","27498996","chr1","26048278","26048559","25","1450433"
"chr1","27522218","27522510","chr20","34546419","34546704","49","7024201"
"chr1","27529975","27530160","chr1","26077163","26077333","35","1452812"
"chr1","27530472","27530606","chr19","30127870","30128005","23","2597398"
"chr1","27535055","27535173","chr1","26081314","26081444","18","1453741"
"chr1","27536328","27536626","chr1","26082636","26082935","53","1453692"
"chr1","27539367","27539425","chr2","56287099","56287155","13","28747732"
"chr1","27550615","27550892","chr5","186597229","186597499","59","159046614"
"chr1","27567604","27567782","chr1","211765737","211765916","28","184198133"
"chr1","27572601","27572718","chr1","26124065","26124186","11","1448536"
"chr1","27573378","27573589","chr1","26124852","26125064","13","1448526"
"chr1","27580173","27580401","chr1","26135326","26135525","42","1444847"
"chr1","27581823","27581933","chr1","26136649","26136766","12","1445174"
"chr1","27587033","27587333","chr5","51350304","51350607","50","23763271"
"chr1","27611721","27612002","chr1","26169526","26169793","24","1442195"
"chr1","27644920","27645119","chr3","157785528","157785718","57","130140608"
"chr1","27653816","27654102","chr1","26211696","26211998","30","1442120"
"chr1","27661812","27662007","chr1","26219388","26219568","26","1442424"
"chr1","27686582","27686759","chr1","26241373","26241538","29","1445209"
"chr1","27687065","27687187","chr1","26241850","26241979","15","1445215"
"chr1","27721542","27721843","chr1","26277095","26277386","28","1444447"
"chr1","27741196","27741467","chr1","26297649","26297922","18","1443547"
"chr1","27743709","27743977","chr1","26300179","26300446","34","1443530"
"chr1","27751911","27752202","chr1","26308658","26308946","29","1443253"
"chr1","27765491","27765788","chr6","105874930","105875222","53","78109439"
"chr1","27774187","27774468","chr11","109198563","109198857","63","81424376"
"chr1","27781838","27782134","chr1","26343906","26344186","30","1437932"
"chr1","27785826","27785945","chr4","13998167","13998284","27","13787659"
"chr1","27804417","27804798","chr1","26373023","26373388","41","1431394"
"chr1","27845615","27845915","chr5","51350304","51350607","54","23504689"
"chr1","27859956","27860260","chr1","26430564","26430853","28","1429392"
"chr1","27865235","27865520","chr1","26436134","26436450","49","1429101"
"chr1","27885188","27885404","chr1","26456076","26456293","13","1429112"
"chr1","27887286","27887457","chr2","92025512","92025675","31","64138226"
"chr1","27926793","27927086","chr1","26498097","26498396","19","1428696"
"chr1","27933352","27933661","chr1","26504863","26505172","16","1428489"
"chr1","27940017","27940230","chr1","26512330","26512541","17","1427687"
"chr1","27942212","27942523","chr1","26514492","26514784","42","1427720"
"chr1","27955021","27955300","chr1","26527441","26527718","20","1427580"
"chr1","27980793","27981105","chr1","26552961","26553278","35","1427832"
"chr1","27988552","27988684","chr1","26561536","26561668","5","1427016"
"chr1","28011794","28012015","chr16","43473883","43474099","48","15462089"
"chr1","28012331","28012627","chr1","26586196","26586493","13","1426135"
"chr1","28015746","28015872","chr2","107844001","107844127","19","79828255"
"chr1","28015914","28016083","chr1","26590962","26591124","17","1424952"
"chr1","28019727","28020009","chr1","26593793","26594088","30","1425934"
"chr1","28025435","28025702","chr1","26599992","26600254","52","1425443"
"chr1","28050873","28051163","chr1","26627216","26627497","31","1423657"
"chr1","28055488","28055760","chr1","26631916","26632186","19","1423572"
"chr1","28059263","28059575","chr1","26636336","26636653","31","1422927"
"chr1","28063303","28063587","chr1","26640542","26640845","36","1422761"
"chr1","28075280","28075533","chr10","67076281","67076536","56","39001001"
"chr1","28079901","28080211","chr1","26658212","26658527","29","1421689"
"chr1","28085557","28085854","chr1","26663909","26664216","24","1421648"
"chr1","28087663","28087969","chr1","26666478","26666781","19","1421185"
"chr1","28097255","28097558","chr1","26676349","26676673","62","1420906"
"chr1","28097963","28098257","chr1","26677060","26677371","30","1420903"
"chr1","28099614","28099926","chr1","26678718","26679031","26","1420896"
"chr1","28114910","28115035","chr19","34814438","34814559","13","6699528"
"chr1","28122216","28122518","chr1","26701522","26701829","25","1420694"
"chr1","28142160","28142459","chr2","72923747","72924047","64","44781587"
"chr1","28166281","28166393","chr14","2788570","2788678","27","25377711"
"chr1","28174047","28174156","chr20","23302274","23302387","19","4871773"
"chr1","28178523","28178750","chr1","26763110","26763328","23","1415413"
"chr1","28202032","28202158","chr1","18100775","18100899","22","10101257"
"chr1","28208310","28208595","chr1","26791068","26791361","20","1417242"
"chr1","28212431","28212718","chr4","80545362","80545649","69","52332931"
"chr1","28215308","28215595","chr1","26798558","26798859","40","1416750"
"chr1","28233479","28233741","chr1","26806025","26806313","60","1427454"
"chr1","28242838","28243048","chr5","56540327","56540546","42","28297489"
"chr1","28244442","28244752","chr1","26812837","26813139","24","1431605"
"chr1","28250377","28250534","chr1","26819933","26820090","8","1430444"
"chr1","28250843","28250975","chr1","26820407","26820539","9","1430436"
"chr1","28272681","28272798","chr1","26843062","26843180","10","1429619"
"chr1","28274933","28275233","chr1","26845331","26845626","19","1429602"
"chr1","28281386","28281589","chr1","26851426","26851624","15","1429960"
"chr1","28281654","28281807","chr1","26851689","26851842","6","1429965"
"chr1","28282094","28282241","chr1","26852134","26852276","12","1429960"
"chr1","28283855","28284136","chr1","26854511","26854800","27","1429344"
"chr1","28284906","28285193","chr1","26855568","26855862","23","1429338"
"chr1","28287377","28287669","chr1","26857372","26857669","17","1430005"
"chr1","28294195","28294487","chr1","26864519","26864825","37","1429676"
"chr1","28300083","28300214","chr1","26870780","26870895","22","1429303"
"chr1","28325401","28325699","chr1","26897418","26897724","27","1427983"
"chr1","28327884","28328076","chr1","26899912","26900102","17","1427972"
"chr1","28340437","28340554","chr1","26913116","26913244","15","1427321"
"chr1","28351648","28351899","chr6","135747025","135747278","57","107395377"
"chr1","28384396","28384661","chr1","26956850","26957114","29","1427546"
"chr1","28393394","28393699","chr20","18747261","18747569","63","9646133"
"chr1","28417857","28418155","chr1","26994217","26994519","33","1423640"
"chr1","28434230","28434530","chr1","27014433","27014724","19","1419797"
"chr1","28434705","28434885","chr1","27014899","27015065","22","1419806"
"chr1","28451750","28451958","chr3","3881369","3881580","47","24570381"
"chr1","28458288","28458400","chr1","27042117","27042229","1","1416171"
"chr1","28470473","28470765","chr1","27055021","27055338","40","1415452"
"chr1","28479921","28480040","chr4","6988605","6988727","22","21491316"
"chr1","28493027","28493316","chr1","27079964","27080265","41","1413063"
"chr1","28502990","28503112","chr1","27091718","27091840","18","1411272"
"chr1","28503436","28503724","chr1","27092168","27092478","46","1411268"
"chr1","28508412","28508707","chr1","27097504","27097794","21","1410908"
"chr1","28513347","28513518","chr8","28214239","28214399","40","299108"
"chr1","28514505","28514703","chr1","27102883","27103082","17","1411622"
"chr1","28523484","28523638","chr3","45737519","45737668","38","17214035"
"chr1","28564167","28564276","chr1","27154159","27154268","5","1410008"
"chr1","28571890","28572200","chr1","27163166","27163456","30","1408724"
"chr1","28596504","28596652","chr9","106149260","106149407","7","77552756"
"chr1","28596668","28596952","chr9","106148952","106149244","26","77552284"
"chr1","28599608","28599894","chr1","27220750","27221049","33","1378858"
"chr1","28602184","28602407","chr3","170242210","170242417","46","141640026"
"chr1","28607238","28607391","chr1","27228873","27229025","9","1378365"
"chr1","28615310","28615606","chr6","35189860","35190164","59","6574550"
"chr1","28620160","28620284","chr12","14732091","14732215","17","13888069"
"chr1","28624362","28624520","chr3","124250296","124250455","31","95625934"
"chr1","28626872","28627152","chr1","27249155","27249448","32","1377717"
"chr1","28628691","28628804","chr1","27251044","27251157","5","1377647"
"chr1","28637335","28637629","chr1","27260765","27261062","21","1376570"
"chr1","28642317","28642422","chr1","27265525","27265630","6","1376792"
"chr1","28643634","28643841","chr18","9978498","9978715","51","18665136"
"chr1","28671494","28671795","chr1","27295380","27295667","33","1376114"
"chr1","28673934","28674235","chr1","27298460","27298778","38","1375474"
"chr1","28687279","28687407","chr7","31804546","31804669","19","3117267"
"chr1","28687708","28687887","chr3","157608781","157608963","43","128921073"
"chr1","28694411","28694615","chr1","27312860","27313056","18","1381551"
"chr1","28718142","28718334","chr17","20293490","20293680","40","8424652"
"chr1","28721484","28721790","chr1","27341687","27342029","52","1379797"
"chr1","28725553","28725849","chr2","160551205","160551504","60","131825652"
"chr1","28735161","28735403","chr1","27356400","27356645","21","1378761"
"chr1","28739918","28740224","chr1","27361883","27362190","21","1378035"
"chr1","28755298","28755598","chr1","27377755","27378039","38","1377543"
"chr1","28760912","28761206","chr1","27388051","27388318","45","1372861"
"chr1","28767316","28767589","chr1","27394787","27395058","30","1372529"
"chr1","28767990","28768073","chr1","79933567","79933651","15","51165577"
"chr1","28773648","28773936","chr1","27401761","27402057","17","1371887"
"chr1","28779251","28779496","chr1","27410152","27410372","40","1369099"
"chr1","28780878","28780973","chr1","27410985","27411080","2","1369893"
"chr1","28783847","28784132","chr1","27414466","27414709","55","1369381"
"chr1","28799414","28799516","chr9","15337716","15337814","20","13461698"
"chr1","28806376","28806670","chr1","27442924","27443214","26","1363452"
"chr1","28848729","28849029","chr1","27496037","27496348","29","1352692"
"chr1","28872283","28872444","chr1","27522894","27523058","9","1349389"
"chr1","28910059","28910228","chr3","126621167","126621327","37","97711108"
"chr1","28910871","28910992","chr3","116950025","116950140","28","88039154"
"chr1","28918238","28918367","chr1","27562495","27562612","18","1355743"
"chr1","28922292","28922399","chr16","5087928","5088033","30","23834364"
"chr1","28922705","28922834","chr19","28355572","28355703","34","567133"
"chr1","28923326","28923588","chr1","27567653","27567928","27","1355673"
"chr1","28930756","28930920","chr10","28678576","28678739","35","252180"
"chr1","28931221","28931360","chr8","71179092","71179225","24","42247871"
"chr1","28934574","28934865","chr1","27578875","27579177","30","1355699"
"chr1","28941993","28942109","chr1","27587328","27587447","13","1354665"
"chr1","28945871","28946171","chr1","27589902","27590205","18","1355969"
"chr1","28977269","28977477","chr13","30070965","30071173","42","1093696"
"chr1","28991471","28991744","chrX","65751654","65751935","53","36760183"
"chr1","29004699","29004984","chr5","153553663","153553942","58","124548964"
"chr1","29007664","29007704","chr1","27655700","27655742","6","1351964"
"chr1","29008003","29008208","chr1","27656038","27656224","31","1351965"
"chr1","29021949","29022242","chr1","27670914","27671187","40","1351035"
"chr1","29032629","29032907","chr1","27682458","27682735","19","1350171"
"chr1","29035332","29035455","chr1","27684977","27685105","20","1350355"
"chr1","29059582","29059830","chr7","97194661","97194914","72","68135079"
"chr1","29074249","29074498","chr1","27737315","27737580","53","1336934"
"chr1","29087661","29087823","chr1","27760360","27760522","14","1327301"
"chr1","29092370","29092628","chr1","27763123","27763374","23","1329247"
"chr1","29100353","29100638","chr1","27770235","27770520","14","1330118"
"chr1","29103143","29103389","chr1","27773055","27773287","29","1330088"
"chr1","29120728","29121004","chr1","27791723","27791997","37","1329005"
"chr1","29127677","29127981","chr1","27799681","27799984","35","1327996"
"chr1","29173631","29173797","chr1","27847595","27847750","30","1326036"
"chr1","29180934","29181050","chr8","320367","320492","25","28860567"
"chr1","29222607","29222767","chr1","27900910","27901055","21","1321697"
"chr1","29223061","29223208","chr1","27901351","27901499","8","1321710"
"chr1","29246758","29247043","chr12","62915320","62915606","57","33668562"
"chr1","29270391","29270680","chr1","27942724","27943024","30","1327667"
"chr1","29271171","29271480","chr1","27943515","27943824","17","1327656"
"chr1","29288263","29288539","chr1","27966962","27967235","17","1321301"
"chr1","29294641","29294968","chr1","140901826","140902127","73","111607185"
"chr1","29318414","29318694","chr1","28006446","28006723","26","1311968"
"chr1","29344953","29345127","chrX","5313319","5313490","41","24031634"
"chr1","29345153","29345271","chr4","37779512","37779629","19","8434359"
"chr1","29359259","29359568","chr1","28046458","28046762","20","1312801"
"chr1","29375796","29376083","chr1","28064116","28064406","20","1311680"
"chr1","29392734","29393011","chr1","28082947","28083228","19","1309787"
"chr1","29400892","29401040","chr1","28090279","28090412","21","1310613"
"chr1","29401347","29401479","chr1","28090706","28090839","9","1310641"
"chr1","29422461","29422735","chr6","17609699","17609979","58","11812762"
"chr1","29422746","29422857","chr4","68769437","68769549","20","39346691"
"chr1","29426902","29427186","chr1","28118284","28118556","45","1308618"
"chr1","29446272","29446564","chr1","28137900","28138176","40","1308372"
"chr1","29451651","29451948","chr1","28142900","28143185","40","1308751"
"chr1","29497242","29497556","chr1","28188431","28188740","21","1308811"
"chr1","29503892","29504198","chr1","28194913","28195238","32","1308979"
"chr1","29563436","29563749","chr1","28256993","28257306","19","1306443"
"chr1","29565521","29565845","chr5","41007202","41007507","70","11441681"
"chr1","29566753","29567051","chr1","28260327","28260628","33","1306426"
"chr1","29610009","29610297","chr1","28303243","28303529","16","1306766"
"chr1","29617472","29617792","chr1","28310673","28310987","32","1306799"
"chr1","29677926","29678238","chr7","116518734","116519041","62","86840808"
"chr1","29683110","29683401","chr1","28375953","28376246","14","1307157"
"chr1","29739292","29739599","chr1","28420425","28420731","33","1318867"
"chr1","30035415","30035709","chr1","28719234","28719528","27","1316181"
"chr1","30076265","30076574","chr1","28763547","28763860","15","1312718"
"chr1","30105732","30106003","chr1","28793283","28793556","23","1312449"
"chr1","30248456","30248758","chr1","28939409","28939707","24","1309047"
"chr1","30268976","30269261","chr1","28958959","28959244","24","1310017"
"chr1","30418725","30419036","chr1","29108566","29108878","24","1310159"
"chr1","30506240","30506546","chr1","29204241","29204553","27","1301999"
"chr1","30673545","30673839","chr1","29373630","29373924","26","1299915"
"chr1","30817353","30817645","chr1","29515733","29516025","26","1301620"
"chr1","30830222","30830537","chr8","96575803","96576115","65","65745581"
"chr1","30864714","30864825","chr1","29567222","29567333","6","1297492"
"chr1","30880331","30880617","chr2","99689040","99689328","47","68808709"
"chr1","30902554","30902839","chr1","12971480","12971776","28","17931074"
"chr1","30944823","30945071","chr1","9206214","9206460","59","21738609"
"chr1","30973683","30973976","chr1","29731654","29731947","14","1242029"
"chr1","30981941","30982136","chr1","29740181","29740408","41","1241760"
"chr1","31036920","31037230","chr1","29795336","29795640","38","1241584"
"chr1","31054805","31055117","chr1","29813809","29814127","31","1240996"
"chr1","31070425","31070695","chr15","13633275","13633547","59","17437150"
"chr1","31072558","31072694","chr19","40426551","40426683","18","9353993"
"chr1","31073798","31074080","chr1","29833075","29833379","32","1240723"
"chr1","31163191","31163508","chr1","29923093","29923396","33","1240098"
"chr1","31219087","31219377","chr4","5341609","5341902","56","25877478"
"chr1","31236817","31236943","chr1","29997556","29997682","4","1239261"
"chr1","31241460","31241757","chr1","30003518","30003819","27","1237942"
"chr1","31243628","31243919","chr1","30005744","30006029","21","1237884"
"chr1","31253435","31253753","chr4","8532076","8532392","62","22721359"
"chr1","31259706","31260005","chr1","30022312","30022607","18","1237394"
"chr1","31296636","31296868","chr1","30059255","30059488","23","1237381"
"chr1","31297301","31297582","chr1","146553304","146553584","62","115256003"
"chr1","31309093","31309363","chr1","30071537","30071803","25","1237556"
"chr1","31313035","31313156","chr8","71617230","71617348","23","40304195"
"chr1","31329331","31329537","chr1","30091693","30091913","24","1237638"
"chr1","31329955","31330210","chr1","140720922","140721163","69","109390967"
"chr1","31332988","31333259","chr1","30096696","30096967","19","1236292"
"chr1","31335751","31335883","chr1","30100075","30100191","24","1235676"
"chr1","31344868","31344987","chr2","202023671","202023792","19","170678803"
"chr1","31360244","31360507","chr1","30125563","30125831","23","1234681"
"chr1","31365862","31366157","chr12","19505062","19505360","62","11860800"
"chr1","31366722","31366935","chr8","5949092","5949295","54","25417630"
"chr1","31378227","31378340","chr11","55515815","55515935","35","24137588"
"chr1","31394523","31394707","chr1","30160303","30160469","42","1234220"
"chr1","31395021","31395170","chr1","30160781","30160919","17","1234240"
"chr1","31396286","31396580","chr1","30162347","30162652","42","1233939"
"chr1","31396650","31396767","chr1","30162714","30162831","7","1233936"
"chr1","31400186","31400235","chr1","30165524","30165574","2","1234662"
"chr1","31401651","31401774","chr10","54455965","54456093","49","23054314"
"chr1","31402069","31402206","chr16","57395645","57395778","27","25993576"
"chr1","31454033","31454304","chr2","109213127","109213413","74","77759094"
"chr1","31464219","31464540","chr16","67866589","67866902","66","36402370"
"chr1","31496555","31496633","chr4","104483943","104484024","14","72987388"
"chr1","31504197","31504493","chr2","84913076","84913368","50","53408879"
"chr1","31512540","31512837","chr1","30275337","30275638","23","1237203"
"chr1","31531005","31531262","chr1","30297064","30297346","44","1233941"
"chr1","31546657","31546966","chr1","30314405","30314710","33","1232252"
"chr1","31551534","31551844","chr1","30322297","30322593","54","1229237"
"chr1","31557136","31557423","chr1","30327959","30328241","19","1229177"
"chr1","31568314","31568591","chr1","30340012","30340301","30","1228302"
"chr1","31576647","31576793","chr1","30348600","30348746","4","1228047"
"chr1","31577087","31577246","chr1","30349043","30349206","11","1228044"
"chr1","31589708","31589996","chr1","30363368","30363663","21","1226340"
"chr1","31591662","31591946","chr1","30364502","30364728","74","1227160"
"chr1","31600338","31600632","chr1","30373759","30374057","25","1226579"
"chr1","31603272","31603570","chr11","6503766","6504057","64","25099506"
"chr1","31606909","31607068","chr1","30378479","30378634","11","1228430"
"chr1","31607377","31607506","chr1","30378928","30379065","23","1228449"
"chr1","31613349","31613573","chr3","67626410","67626636","56","36013061"
"chr1","31624390","31624501","chr1","30397507","30397618","6","1226883"
"chr1","31626063","31626214","chr1","30399137","30399290","10","1226926"
"chr1","31636423","31636538","chr1","30409832","30409949","10","1226591"
"chr1","31651910","31652184","chr1","30424902","30425189","33","1227008"
"chr1","31652931","31653185","chr1","30425925","30426179","13","1227006"
"chr1","31685410","31685699","chr1","30460127","30460415","20","1225283"
"chr1","31691506","31691683","chr19","43888070","43888235","39","12196564"
"chr1","31691716","31691825","chr2","23540306","23540416","27","8151410"
"chr1","31693805","31694146","chr1","30467542","30467875","38","1226263"
"chr1","31711623","31711927","chr1","30487882","30488193","23","1223741"
"chr1","31713119","31713410","chr13","49515244","49515533","48","17802125"
"chr1","31731678","31731967","chr1","30507868","30508160","21","1223810"
"chr1","31738088","31738267","chr18","48162913","48163097","38","16424825"
"chr1","31742273","31742563","chr13","39475662","39475956","55","7733389"
"chr1","31779697","31779812","chr6","126567985","126568100","12","94788288"
"chr1","31837620","31837919","chr13","14552089","14552371","60","17285531"
"chr1","31894933","31895211","chr1","30641242","30641534","43","1253691"
"chr1","31899016","31899326","chr1","30646211","30646521","23","1252805"
"chr1","31904814","31905122","chr1","30655457","30655757","36","1249357"
"chr1","31925122","31925413","chr1","30677092","30677381","23","1248030"
"chr1","31938427","31938651","chr1","30690288","30690514","20","1248139"
"chr1","32009290","32009583","chr1","30761063","30761352","20","1248227"
"chr1","32104344","32104642","chr1","30856425","30856707","40","1247919"
"chr1","32106333","32106635","chr1","30859044","30859353","27","1247289"
"chr1","32121056","32121334","chr1","30875824","30876103","30","1245232"
"chr1","32122421","32122712","chr1","30877239","30877528","12","1245182"
"chr1","32140701","32141017","chr1","30890818","30891139","21","1249883"
"chr1","32144291","32144439","chr1","30894376","30894530","17","1249915"
"chr1","32144753","32145000","chr3","11087078","11087309","80","21057675"
"chr1","32161676","32161978","chr11","63273330","63273621","60","31111654"
"chr1","32163469","32163736","chr1","30912719","30912989","25","1250750"
"chr1","32185690","32185969","chr1","30935542","30935821","18","1250148"
"chr1","32191295","32191539","chr1","30942392","30942638","18","1248903"
"chr1","32193112","32193384","chr9","32479266","32479543","63","286154"
"chr1","32195916","32196212","chr1","30946841","30947145","20","1249075"
"chr1","32203831","32203934","chr1","159937662","159937769","23","127733831"
"chr1","32223665","32223967","chr14","13086838","13087139","60","19136827"
"chr1","32241122","32241421","chr20","22512994","22513298","29","9728128"
"chr1","32254525","32254617","chr1","31004776","31004856","15","1249749"
"chr1","32260410","32260672","chr1","31011624","31011882","23","1248786"
"chr1","32267945","32268094","chr19","38121943","38122092","33","5853998"
"chr1","32268381","32268539","chr3","126621167","126621327","36","94352786"
"chr1","32282682","32282974","chr2","54830568","54830861","51","22547886"
"chr1","32283627","32283819","chr4","8454525","8454703","44","23829102"
"chr1","32285699","32285994","chr8","26252062","26252357","58","6033637"
"chr1","32287866","32288122","chr11","50418617","50418873","47","18130751"
"chr1","32294933","32295055","chr1","31046454","31046576","7","1248479"
"chr1","32311927","32312046","chr19","44575056","44575176","17","12263129"
"chr1","32319148","32319460","chr1","31070890","31071202","19","1248258"
"chr1","32324759","32324904","chr16","51075412","51075554","38","18750653"
"chr1","32324934","32325058","chr7","32465205","32465319","22","140271"
"chr1","32351574","32351846","chr4","13997820","13998103","62","18353754"
"chr1","32352105","32352357","chr1","31100692","31100962","29","1251413"
"chr1","32356609","32356846","chr1","31105111","31105340","23","1251498"
"chr1","32357725","32357999","chr1","31106207","31106459","44","1251518"
"chr1","32368082","32368389","chr4","2185273","2185588","55","30182809"
"chr1","32373083","32373212","chr1","31121727","31121852","17","1251356"
"chr1","32387831","32388102","chr6","137558389","137558660","64","105170558"
"chr1","32390832","32391131","chr11","63273330","63273621","58","30882498"
"chr1","32404961","32405273","chr1","31155123","31155436","33","1249838"
"chr1","32411288","32411575","chr1","31163250","31163529","22","1248038"
"chr1","32414495","32414781","chr3","41391456","41391747","60","8976961"
"chr1","32417588","32417885","chr1","31169806","31170106","28","1247782"
"chr1","32423229","32423342","chr1","31175608","31175721","5","1247621"
"chr1","32424908","32425032","chr4","14234468","14234592","20","18190440"
"chr1","32428366","32428601","chr4","123447665","123447894","45","91019299"
"chr1","32447404","32447520","chr1","31198604","31198720","8","1248800"
"chr1","32450037","32450339","chr1","31201199","31201493","31","1248838"
"chr1","32466572","32466852","chr1","31218796","31219084","26","1247776"
"chr1","32474867","32475156","chr5","185678151","185678451","55","153203284"
"chr1","32524003","32524292","chr7","140588016","140588306","52","108064013"
"chr1","32551256","32551328","chr1","31314086","31314158","9","1237170"
"chr1","32552646","32552955","chr1","31315450","31315745","35","1237196"
"chr1","32565352","32565644","chr1","31324945","31325217","33","1240407"
"chr1","32565978","32566224","chr1","163602015","163602259","60","131036037"
"chr1","32571564","32571857","chr1","31332132","31332443","36","1239432"
"chr1","32580416","32580644","chr8","30229995","30230233","75","2350421"
"chr1","32590900","32591216","chr1","31354198","31354520","25","1236702"
"chr1","32597541","32597675","chr1","31359612","31359744","6","1237929"
"chr1","32597977","32598121","chr1","31360045","31360189","10","1237932"
"chr1","32611193","32611486","chr15","43687639","43687935","50","11076446"
"chr1","32612533","32612842","chr1","31377171","31377424","70","1235362"
"chr1","32616787","32617069","chr1","31382196","31382454","54","1234591"
"chr1","32617464","32617744","chr1","31382849","31383138","32","1234615"
"chr1","32661389","32661584","chr1","31430625","31430805","21","1230764"
"chr1","32688640","32688934","chr16","39643297","39643568","83","6954657"
"chr1","32746043","32746279","chr3","126091436","126091662","48","93345393"
"chr1","32914034","32914329","chr1","31500989","31501286","21","1413045"
"chr1","32928178","32928477","chr1","31524898","31525196","28","1403280"
"chr1","32932725","32933027","chr1","31529615","31529912","41","1403110"
"chr1","32942905","32943199","chr1","31541221","31541515","22","1401684"
"chr1","32954720","32954877","chr1","31553808","31553964","13","1400912"
"chr1","32974869","32975077","chr16","47794491","47794660","73","14819622"
"chr1","32975341","32975503","chr1","31577443","31577609","21","1397898"
"chr1","32985483","32985692","chr3","178334159","178334364","47","145348676"
"chr1","32990893","32991092","chr1","31596423","31596614","22","1394470"
"chr1","32993377","32993684","chr1","31599233","31599538","24","1394144"
"chr1","33010542","33010665","chr10","87818140","87818263","23","54807598"
"chr1","33013220","33013366","chr1","31617012","31617162","17","1396208"
"chr1","33013669","33013832","chr1","31617475","31617634","12","1396194"
"chr1","33014780","33015051","chr1","31618500","31618769","18","1396280"
"chr1","33022777","33023057","chr1","31626619","31626912","29","1396158"
"chr1","33032338","33032638","chr1","31634662","31634949","36","1397676"
"chr1","33035997","33036198","chr4","146272024","146272210","53","113236027"
"chr1","33042368","33042687","chr1","31644117","31644438","38","1398251"
"chr1","33053845","33053966","chr4","167227092","167227214","15","134173247"
"chr1","33069031","33069348","chr1","31674880","31675172","42","1394151"
"chr1","33070960","33071268","chr1","31677454","31677766","25","1393506"
"chr1","33072941","33073040","chr1","31679435","31679534","8","1393506"
"chr1","33073713","33073883","chr1","31680214","31680384","6","1393499"
"chr1","33080225","33080509","chr1","31687401","31687692","26","1392824"
"chr1","33092547","33092676","chr2","85417647","85417776","25","52325100"
"chr1","33098580","33098874","chr1","31706474","31706769","16","1392106"
"chr1","33104371","33104656","chr1","31715336","31715602","41","1389035"
"chr1","33105644","33105789","chr1","31713643","31713800","35","1392001"
"chr1","33106055","33106167","chr6","166817294","166817391","34","133711239"
"chr1","33106724","33106762","chr8","127187233","127187278","12","94080509"
"chr1","33106779","33107051","chr13","28680679","28680936","75","4426100"
"chr1","33112447","33112558","chr1","31723524","31723639","8","1388923"
"chr1","33133989","33134248","chr3","41943668","41943932","64","8809679"
"chr1","33164559","33164676","chr5","153068406","153068522","16","119903847"
"chr1","33196829","33197120","chr14","60650624","60650917","62","27453795"
"chr1","33220865","33221130","chr20","37926585","37926844","24","4705720"
"chr1","33240989","33241288","chr1","31865094","31865390","28","1375895"
"chr1","33274449","33274756","chr1","31879844","31880125","43","1394605"
"chr1","33277215","33277321","chr3","154492120","154492234","21","121214905"
"chr1","33277721","33277847","chr4","106500045","106500170","17","73222324"
"chr1","33285138","33285425","chr1","31889436","31889725","21","1395702"
"chr1","33289245","33289526","chr10","71263369","71263653","64","37974124"
"chr1","33306659","33306942","chr1","31912998","31913248","50","1393661"
"chr1","33322271","33322438","chr1","31930620","31930784","16","1391651"
"chr1","33343504","33343706","chr1","31952577","31952787","17","1390927"
"chr1","33359830","33359989","chr18","36720775","36720932","31","3360945"
"chr1","33360289","33360424","chr1","31970087","31970221","18","1390202"
"chr1","33376290","33376592","chr1","31986866","31987167","18","1389424"
"chr1","33382646","33382921","chr18","11751780","11752066","57","21630866"
"chr1","33385193","33385452","chr1","31997881","31998146","22","1387312"
"chr1","33386026","33386340","chr15","24356454","24356770","68","9029572"
"chr1","33387094","33387317","chr1","32000102","32000319","18","1386992"
"chr1","33395534","33395841","chr1","32009258","32009568","25","1386276"
"chr1","33408220","33408512","chr1","32020935","32021233","20","1387285"
"chr1","33415235","33415537","chr1","32027667","32027968","24","1387568"
"chr1","33418745","33419028","chr1","32031173","32031460","19","1387572"
"chr1","33438083","33438251","chr1","207948084","207948245","38","174510001"
"chr1","33449163","33449336","chr1","32064747","32064921","15","1384416"
"chr1","33454005","33454287","chr1","32070796","32071096","38","1383209"
"chr1","33489825","33490130","chr1","32111818","32112123","25","1378007"
"chr1","33495017","33495137","chrX","131653259","131653375","25","98158242"
"chr1","33495163","33495304","chr1","153250707","153250848","32","119755544"
"chr1","33497910","33498092","chr1","32121234","32121418","15","1376676"
"chr1","33502001","33502280","chr1","32125103","32125382","17","1376898"
"chr1","33504972","33505250","chr1","32127789","32128054","28","1377183"
"chr1","33506484","33506763","chr1","32129278","32129554","18","1377206"
"chr1","33512643","33512867","chr6","14369938","14370161","63","19142705"
"chr1","33515419","33515519","chr1","9714136","9714233","17","23801283"
"chr1","33515747","33515798","chr13","49224727","49224777","15","15708980"
"chr1","33516299","33516431","chr1","67637888","67638021","37","34121589"
"chr1","33525421","33525559","chr1","32142886","32143010","23","1382535"
"chr1","33539662","33539966","chr1","32152399","32152693","28","1387263"
"chr1","33618666","33618945","chr1","32273350","32273630","15","1345316"
"chr1","33675631","33675927","chr1","32331402","32331718","49","1344229"
"chr1","33712302","33712408","chr1","32373011","32373117","5","1339291"
"chr1","33716160","33716445","chr1","32376585","32376860","27","1339575"
"chr1","33758504","33758737","chr1","32418807","32419031","21","1339697"
"chr1","33793869","33794147","chr1","32449555","32449830","32","1344314"
"chr1","33891750","33892044","chr3","124267629","124267922","55","90375879"
"chr1","33934199","33934501","chr14","8439133","8439435","57","25495066"
"chr1","33958275","33958435","chr9","15628977","15629142","30","18329298"
"chr1","33958466","33958584","chr13","92229940","92230056","17","58271474"
"chr1","33970404","33970495","chr6","28929552","28929647","14","5040852"
"chr1","33973994","33974124","chr1","53826402","53826528","21","19852408"
"chr1","34061696","34061913","chr1","32740645","32740871","22","1321051"
"chr1","34128590","34128893","chr1","32809420","32809713","34","1319170"
"chr1","34225425","34225679","chr1","32900774","32901035","26","1324651"
"chr1","34451847","34452122","chr1","33134677","33134957","22","1317170"
"chr1","34458264","34458551","chr1","33141495","33141786","19","1316769"
"chr1","34490057","34490350","chr1","33173874","33174167","16","1316183"
"chr1","34507863","34508153","chr1","33192246","33192540","22","1315617"
"chr1","34610370","34610683","chr1","33298849","33299154","22","1311521"
"chr1","34612157","34612449","chr10","77425876","77426160","58","42813719"
"chr1","34628326","34628441","chr1","7781351","7781462","29","26846975"
"chr1","34844986","34845278","chr1","53550509","53550803","62","18705523"
"chr1","34846894","34847149","chr1","33530565","33530821","19","1316329"
"chr1","35026760","35027063","chr1","46249146","46249441","59","11222386"
"chr1","35131961","35132253","chr1","33827837","33828129","24","1304124"
"chr1","35146179","35146452","chr1","33842801","33843089","29","1303378"
"chr1","35269201","35269492","chr1","33968046","33968341","20","1301155"
"chr1","35283265","35283550","chr1","33982063","33982343","27","1301202"
"chr1","35353323","35353612","chr8","129433118","129433406","59","94079795"
"chr1","35409386","35409682","chr1","34105502","34105795","23","1303884"
"chr1","35411311","35411601","chr1","34107430","34107715","26","1303881"
"chr1","35412248","35412379","chr1","34109219","34109349","7","1303029"
"chr1","35412507","35412697","chr1","34109475","34109636","37","1303032"
"chr1","35414749","35415015","chr1","34112065","34112319","51","1302684"
"chr1","35444520","35444772","chr1","34143612","34143864","9","1300908"
"chr1","35445915","35446212","chr16","71173493","71173795","59","35727578"
"chr1","35448569","35448876","chr1","34148323","34148636","23","1300246"
"chr1","35462073","35462399","chr1","34162117","34162443","27","1299956"
"chr1","35473440","35473711","chr1","34175384","34175658","16","1298056"
"chr1","35492507","35492731","chr16","42183034","42183244","47","6690527"
"chr1","35495506","35495830","chr1","34201149","34201448","57","1294357"
"chr1","35498184","35498485","chr1","34201149","34201448","25","1297035"
"chr1","35509468","35509763","chrX","101668164","101668460","63","66158696"
"chr1","35516055","35516216","chrUn_NW_014807731v1","66","224","32","35515989"
"chr1","35516698","35516825","chr1","117811669","117811797","20","82294971"
"chr1","35530716","35531019","chr3","71376033","71376336","70","35845317"
"chr1","35553177","35553442","chr1","34269473","34269770","41","1283704"
"chr1","35563511","35563819","chr3","40153351","40153656","72","4589840"
"chr1","35567768","35567968","chr1","34284364","34284569","14","1283404"
"chr1","35571240","35571515","chr2","150804887","150805167","61","115233647"
"chr1","35601326","35601477","chr1","26852134","26852276","32","8749192"
"chr1","35602106","35602276","chr11","48070993","48071155","37","12468887"
"chr1","35604642","35604923","chr1","34302849","34303139","32","1301793"
"chr1","35621432","35621716","chr1","34322115","34322426","50","1299317"
"chr1","35625897","35626110","chr1","34326398","34326611","15","1299499"
"chr1","35636906","35637163","chr8","51764476","51764748","77","16127570"
"chr1","35646418","35646505","chr12","43283820","43283911","12","7637402"
"chr1","35648224","35648526","chr1","34349558","34349859","23","1298666"
"chr1","35659329","35659623","chr1","34361553","34361857","28","1297776"
"chr1","35666442","35666727","chr1","34368419","34368694","28","1298023"
"chr1","35674164","35674482","chr1","34376088","34376393","28","1298076"
"chr1","35690004","35690309","chr3","130448018","130448321","59","94758014"
"chr1","35720657","35720964","chr1","34415735","34416021","60","1304922"
"chr1","35732456","35732757","chr11","7388058","7388361","70","28344398"
"chr1","35736279","35736568","chr1","34433212","34433509","24","1303067"
"chr1","35738554","35738643","chr1","34435169","34435258","2","1303385"
"chr1","35740260","35740590","chr1","34436861","34437174","61","1303399"
"chr1","35751676","35751896","chr1","68268209","68268420","50","32516533"
"chr1","35752680","35752979","chr1","34450425","34450724","19","1302255"
"chr1","35765755","35766040","chr1","34462834","34463117","22","1302921"
"chr1","35774767","35775062","chr1","34472320","34472637","42","1302447"
"chr1","35788562","35788838","chr1","15477611","15477890","64","20310951"
"chr1","35804247","35804536","chr12","83006376","83006658","53","47202129"
"chr1","35822037","35822331","chr16","61203222","61203518","57","25381185"
"chr1","35848534","35848830","chr1","34550666","34550959","20","1297868"
"chr1","35854634","35854921","chr1","34557033","34557316","16","1297601"
"chr1","35859235","35859493","chr1","34561321","34561580","12","1297914"
"chr1","35874082","35874382","chr1","34579373","34579669","23","1294709"
"chr1","35892783","35893003","chr1","34598073","34598294","14","1294710"
"chr1","35914976","35915269","chr1","34618483","34618778","24","1296493"
"chr1","35931512","35931820","chr1","34634336","34634657","41","1297176"
"chr1","35937762","35937892","chr1","34644055","34644177","20","1293707"
"chr1","35966024","35966272","chr1","34672535","34672766","41","1293489"
"chr1","35972201","35972402","chr1","34680591","34680792","9","1291610"
"chr1","35972531","35972760","chr1","34680918","34681155","20","1291613"
"chr1","35986447","35986751","chr1","34695379","34695669","34","1291068"
"chr1","35994196","35994479","chr1","34703640","34703918","50","1290556"
"chr1","35997780","35997923","chr1","34707662","34707806","8","1290118"
"chr1","35998232","35998358","chr1","34708118","34708259","26","1290114"
"chr1","36027640","36027848","chr1","34740596","34740808","21","1287044"
"chr1","36045236","36045547","chr1","34759064","34759369","26","1286172"
"chr1","36055540","36055831","chr15","30025154","30025442","65","6030386"
"chr1","36056745","36056922","chr1","34770672","34770848","7","1286073"
"chr1","36057220","36057349","chr1","34771162","34771278","17","1286058"
"chr1","36061766","36061953","chr1","34776367","34776557","14","1285399"
"chr1","36080529","36080832","chr1","34791620","34791926","34","1288909"
"chr1","36083163","36083465","chr1","34794264","34794549","34","1288899"
"chr1","36093294","36093368","chr1","34804552","34804627","4","1288742"
"chr1","36094967","36095229","chr6","159172285","159172552","64","123077318"
"chr1","36106777","36106918","chr1","34819057","34819198","11","1287720"
"chr1","36107185","36107336","chr1","34819475","34819628","15","1287710"
"chr1","36109792","36110094","chr1","34822265","34822571","17","1287527"
"chr1","36113818","36113964","chr3","131499503","131499643","46","95385685"
"chr1","36114572","36114704","chr2","136103432","136103559","24","99988860"
"chr1","36123493","36123766","chr5","173523897","173524188","63","137400404"
"chr1","36129001","36129320","chr1","34841273","34841547","58","1287728"
"chr1","36130304","36130428","chr1","34842862","34842986","10","1287442"
"chr1","36130728","36130899","chr1","34843291","34843460","9","1287437"
"chr1","36135756","36136063","chr1","34854571","34854905","52","1281185"
"chr1","36137787","36137918","chr8","94921603","94921731","26","58783816"
"chr1","36140642","36140790","chr1","34860867","34861013","17","1279775"
"chr1","36141103","36141238","chr10","35639350","35639476","28","501753"
"chr1","36148856","36149165","chrX","39560885","39561193","59","3412029"
"chr1","36149302","36149505","chr1","34871996","34872199","14","1277306"
"chr1","36153780","36153900","chr7","43655643","43655763","16","7501863"
"chr1","36153928","36154075","chr9","12501404","12501543","31","23652524"
"chr1","36160497","36160812","chr1","34883660","34883954","42","1276837"
"chr1","36181480","36181767","chr8","129433118","129433406","58","93251638"
"chr1","36189722","36189913","chr1","34916004","34916198","12","1273718"
"chr1","36203450","36203730","chr1","34931195","34931476","13","1272255"
"chr1","36211529","36211847","chr1","34939698","34940013","20","1271831"
"chr1","36224190","36224408","chr15","106725050","106725273","55","70500860"
"chr1","36240051","36240125","chr10","29590072","29590142","14","6649979"
"chr1","36260807","36260935","chr1","34999377","34999511","13","1261430"
"chr1","36265734","36266028","chr1","35005813","35006112","20","1259921"
"chr1","36269249","36269505","chr2","150688646","150688908","57","114419397"
"chr1","36278718","36279009","chr1","35018190","35018479","22","1260528"
"chr1","36290800","36291097","chr1","35032402","35032702","21","1258398"
"chr1","36301342","36301514","chrX","93152402","93152581","31","56851060"
"chr1","36312668","36312978","chr1","35056783","35057085","33","1255885"
"chr1","36318308","36318515","chr6","140123726","140123929","47","103805418"
"chr1","36321533","36321798","chr1","35067064","35067329","8","1254469"
"chr1","36347770","36348066","chr1","35093854","35094152","25","1253916"
"chr1","36369487","36369781","chr1","35115336","35115637","24","1254151"
"chr1","36398604","36398905","chr1","35143491","35143795","21","1255113"
"chr1","36424026","36424340","chr1","35169406","35169700","38","1254620"
"chr1","36436504","36436793","chr1","35182740","35183020","36","1253764"
"chr1","36452501","36452788","chr1","35197174","35197458","39","1255327"
"chr1","36453378","36453673","chr1","35198325","35198625","24","1255053"
"chr1","36470971","36471064","chr1","35214447","35214540","5","1256524"
"chr1","36484893","36485193","chr12","38307089","38307382","53","1822196"
"chr1","36491620","36491895","chrX","148298862","148299129","65","111807242"
"chr1","36492220","36492481","chr7","82023696","82023957","58","45531476"
"chr1","36495008","36495272","chr1","35239409","35239670","22","1255599"
"chr1","36504536","36504775","chr1","35249281","35249520","17","1255255"
"chr1","36542667","36542812","chr16","50398074","50398218","30","13855407"
"chr1","36548331","36548626","chr1","35294285","35294565","35","1254046"
"chr1","36556464","36556749","chr1","35303783","35304060","38","1252681"
"chr1","36570280","36570591","chr19","8237701","8238014","70","28332579"
"chr1","36605619","36605868","chr3","141318589","141318838","57","104712970"
"chr1","36627207","36627456","chr1","35382302","35382551","16","1244905"
"chr1","36647605","36647922","chr10","32154454","32154755","64","4493151"
"chr1","36650569","36650705","chr1","118248504","118248638","26","81597935"
"chr1","36651028","36651199","chr1","35411462","35411629","15","1239566"
"chr1","36678616","36678741","chr3","165142712","165142835","27","128464096"
"chr1","36686315","36686439","chr1","35450421","35450545","11","1235894"
"chr1","36691179","36691482","chr19","36550949","36551256","66","140230"
"chr1","36718904","36719010","chr3","84891528","84891628","34","48172624"
"chr1","36719305","36719440","chr19","2943705","2943836","27","33775600"
"chr1","36750061","36750348","chr1","35517588","35517875","15","1232473"
"chr1","36795146","36795442","chr20","10719806","10720100","50","26075340"
"chr1","36804276","36804537","chr1","35572808","35573075","18","1231468"
"chr1","36817258","36817556","chr1","35587957","35588255","11","1229301"
"chr1","36824593","36824897","chr1","35595269","35595576","24","1229324"
"chr1","36826176","36826474","chr1","35596855","35597144","29","1229321"
"chr1","36842547","36842768","chr5","78031728","78031958","49","41189181"
"chr1","36867751","36867995","chr20","59701490","59701754","67","22833739"
"chr1","36870595","36870887","chr1","35642926","35643211","23","1227669"
"chr1","36893944","36894013","chr8","38780103","38780168","9","1886159"
"chr1","36926194","36926490","chr1","35698446","35698739","19","1227748"
"chr1","36932667","36932754","chr1","35704086","35704173","3","1228581"
"chr1","36933056","36933269","chr1","35704466","35704681","19","1228590"
"chr1","36933627","36933919","chr1","35705017","35705334","44","1228610"
"chr1","36943579","36943867","chr1","123230197","123230488","27","86286618"
"chr1","37112060","37112353","chr8","55284665","55284980","47","18172605"
"chr1","37112383","37112394","chr17","88408224","88408235","1","51295841"
"chr1","37141876","37142100","chr14","64527974","64528205","51","27386098"
"chr1","37142462","37142570","chr7","30059294","30059393","24","7083168"
"chr1","37142612","37142787","chr3","126054559","126054732","36","88911947"
"chr1","37148954","37149176","chr8","55318648","55318869","21","18169694"
"chr1","37167394","37167682","chr1","22392281","22392567","59","14775113"
"chr1","37184092","37184390","chr1","35767506","35767804","16","1416586"
"chr1","37219429","37219725","chr1","35804172","35804473","25","1415257"
"chr1","37253136","37253417","chr1","35833812","35834100","22","1419324"
"chr1","37260937","37261217","chr1","35841474","35841754","21","1419463"
"chr1","37483881","37484186","chr1","36064650","36064944","28","1419231"
"chr1","37494096","37494386","chr1","36074861","36075135","36","1419235"
"chr1","37497216","37497481","chr10","16394525","16394792","52","21102691"
"chr1","37510374","37510505","chr1","117811669","117811797","26","80301295"
"chr1","37672717","37673002","chr1","36253436","36253729","27","1419281"
"chr1","37814401","37814696","chr1","36402192","36402499","29","1412209"
"chr1","37821695","37821976","chr9","63095691","63095976","52","25273996"
"chr1","37897084","37897353","chr1","36464865","36465139","19","1432219"
"chr1","37964101","37964220","chr2","202236106","202236220","26","164272005"
"chr1","37964251","37964408","chrUn_NW_014807731v1","66","224","32","37964185"
"chr1","37970883","37971063","chrX","52447863","52448045","34","14476980"
"chr1","38011666","38011966","chr1","36579664","36579966","20","1432002"
"chr1","38021455","38021667","chr20","35094996","35095206","38","2926459"
"chr1","38025782","38026021","chr8","38412179","38412409","50","386397"
"chr1","38062118","38062433","chr1","36633846","36634148","32","1428272"
"chr1","38063017","38063224","chr1","36634742","36634948","19","1428275"
"chr1","38069575","38069874","chr1","36641441","36641759","40","1428134"
"chr1","38069889","38070223","chr2","88897939","88898270","90","50828050"
"chr1","38109692","38109875","chr2","53384035","53384215","47","15274343"
"chr1","38121110","38121231","chr13","42331990","42332109","25","4210880"
"chr1","38121470","38121687","chr1","32000102","32000319","42","6121368"
"chr1","38121708","38121996","chr1","36693841","36694141","26","1427867"
"chr1","38122151","38122450","chr1","36694284","36694580","44","1427867"
"chr1","38127079","38127381","chr11","8098665","8098958","59","30028414"
"chr1","38127619","38127869","chr5","72315484","72315733","63","34187865"
"chr1","38131475","38131766","chr1","36703874","36704174","23","1427601"
"chr1","38148813","38148884","chr1","36715114","36715184","6","1433699"
"chr1","38152788","38153086","chr1","36719992","36720294","19","1432796"
"chr1","38155375","38155632","chr1","36721823","36722110","53","1433552"
"chr1","38177751","38178048","chr1","36748205","36748505","20","1429546"
"chr1","38208627","38208859","chr1","36780743","36780974","16","1427884"
"chr1","38229270","38229393","chr1","36800908","36801032","6","1428362"
"chr1","38262708","38262977","chr1","36834625","36834902","43","1428083"
"chr1","38269699","38269959","chr1","36841882","36842146","28","1427817"
"chr1","38276892","38277205","chr1","36850969","36851282","22","1425923"
"chr1","38292945","38293230","chr1","36870285","36870583","27","1422660"
"chr1","38295557","38295841","chr1","36872845","36873125","26","1422712"
"chr1","38302269","38302439","chr1","36879854","36880026","14","1422415"
"chr1","38307005","38307131","chr1","36884537","36884663","4","1422468"
"chr1","38309669","38309950","chr1","36886752","36887035","23","1422917"
"chr1","38310964","38311181","chr1","36889236","36889448","14","1421728"
"chr1","38317512","38317710","chr14","53454483","53454680","45","15136971"
"chr1","38355405","38355723","chr1","36934407","36934692","48","1420998"
"chr1","38359363","38359487","chr1","36938634","36938758","5","1420729"
"chr1","38372712","38372987","chr1","36952015","36952281","26","1420697"
"chr1","38378690","38378995","chr1","36958380","36958656","47","1420310"
"chr1","38391963","38392239","chr1","36971916","36972193","15","1420047"
"chr1","38395281","38395562","chr1","36974432","36974703","26","1420849"
"chr1","38396979","38397269","chr1","36976730","36977023","14","1420249"
"chr1","38406270","38406487","chr1","183854881","183855101","46","145448611"
"chr1","38407279","38407533","chr2","3434127","3434384","66","34973152"
"chr1","38420747","38420871","chr1","37001017","37001141","8","1419730"
"chr1","38421537","38421849","chr1","37001789","37002112","25","1419748"
"chr1","38448105","38448400","chr1","37029075","37029360","30","1419030"
"chr1","38449159","38449432","chr20","22445913","22446203","63","16003246"
"chr1","38464527","38464826","chr1","37047163","37047472","39","1417364"
"chr1","38468305","38468581","chr1","37051360","37051641","23","1416945"
"chr1","38470499","38470750","chr1","37053938","37054191","15","1416561"
"chr1","38483379","38483675","chr1","37067324","37067614","23","1416055"
"chr1","38492989","38493255","chr1","37076688","37076956","22","1416301"
"chr1","38503544","38503827","chr1","37088734","37089019","27","1414810"
"chr1","38511773","38512068","chr1","37097298","37097617","46","1414475"
"chr1","38519842","38520007","chr12","45567339","45567502","35","7047497"
"chr1","38545837","38546099","chr1","37126383","37126644","16","1419454"
"chr1","38563365","38563659","chr1","37143783","37144067","50","1419582"
"chr1","38565980","38566314","chr1","37147426","37147753","52","1418554"
"chr1","38569225","38569442","chr1","37150916","37151134","14","1418309"
"chr1","38574483","38574762","chr1","37156228","37156511","29","1418255"
"chr1","38580662","38580917","chr1","62247326","62247566","78","23666664"
"chr1","38591584","38591884","chr1","37172887","37173187","15","1418697"
"chr1","38601001","38601318","chrX","64991673","64991978","65","26390672"
"chr1","38604751","38605045","chr1","37186601","37186880","42","1418150"
"chr1","38645107","38645397","chr2","160551205","160551504","58","121906098"
"chr1","38653927","38654227","chr3","37361711","37362011","48","1292216"
"chr1","38656546","38656822","chr1","37241627","37241903","12","1414919"
"chr1","38677745","38678028","chr1","37264576","37264860","26","1413169"
"chr1","38711226","38711547","chr1","37299707","37300027","44","1411519"
"chr1","38741609","38741923","chr1","37330018","37330311","45","1411591"
"chr1","38803049","38803315","chr1","37390889","37391157","15","1412160"
"chr1","38990882","38991172","chr1","37573870","37574168","23","1417012"
"chr1","39201839","39202091","chr1","37775975","37776238","24","1425864"
"chr1","39461621","39461903","chr1","38033338","38033619","29","1428283"
"chr1","39467255","39467401","chr1","38038612","38038757","14","1428643"
"chr1","39467675","39467773","chr1","38039027","38039130","13","1428648"
"chr1","39467780","39467916","chr1","38039131","38039267","5","1428649"
"chr1","39469421","39469540","chr7","40819207","40819325","23","1349786"
"chr1","39484014","39484308","chr1","218247210","218247510","54","178763196"
"chr1","39488778","39488898","chr1","38060029","38060148","9","1428749"
"chr1","39489502","39489773","chr4","32732434","32732715","58","6757068"
"chr1","39514431","39514713","chr1","38088770","38089053","23","1425661"
"chr1","39540656","39540771","chr2","178082637","178082751","31","138541981"
"chr1","39545152","39545398","chr11","45367871","45368106","61","5822719"
"chr1","39555539","39555678","chr1","38133028","38133179","20","1422511"
"chr1","39555959","39556135","chr1","38133458","38133632","16","1422501"
"chr1","39559443","39559697","chr1","38137246","38137518","41","1422197"
"chr1","39567664","39567835","chr1","38146530","38146680","46","1421134"
"chr1","39568386","39568516","chr1","38147224","38147356","12","1421162"
"chr1","39584667","39584871","chr1","38159956","38160163","20","1424711"
"chr1","39597175","39597283","chr4","128388118","128388230","14","88790943"
"chr1","39602607","39602737","chr1","38177685","38177812","9","1424922"
"chr1","39603028","39603208","chr1","38178117","38178306","30","1424911"
"chr1","39605796","39606090","chr1","38181495","38181799","25","1424301"
"chr1","39613160","39613220","chr12","20509197","20509257","8","19103963"
"chr1","39752886","39753177","chr1","38411056","38411341","23","1341830"
"chr1","39755466","39755781","chr1","38413349","38413658","39","1342117"
"chr1","39772445","39772745","chr1","38430326","38430637","32","1342119"
"chr1","39775512","39775718","chr1","38433711","38433919","24","1341801"
"chr1","39776902","39777065","chr3","38697811","38697980","37","1079091"
"chr1","39777390","39777543","chr18","49376309","49376453","31","9598919"
"chr1","39784356","39784650","chr1","38443121","38443440","39","1341235"
"chr1","39800976","39801266","chr1","38460646","38460951","42","1340330"
"chr1","39802082","39802147","chr7","107117745","107117806","12","67315663"
"chr1","39809745","39810037","chr1","38468750","38469025","27","1340995"
"chr1","39812647","39812933","chr1","38471607","38471889","17","1341040"
"chr1","39816193","39816312","chr1","38474272","38474386","9","1341921"
"chr1","39818587","39818874","chr1","38476318","38476605","13","1342269"
"chr1","39847458","39847682","chr1","38506247","38506457","25","1341211"
"chr1","39848777","39849057","chr1","38507526","38507806","18","1341251"
"chr1","39855569","39855842","chr1","38513539","38513823","40","1342030"
"chr1","39855864","39855973","chr1","38513841","38513955","9","1342023"
"chr1","39856503","39856798","chr1","38514491","38514758","39","1342012"
"chr1","39931935","39932066","chr1","38589884","38590009","15","1342051"
"chr1","39933293","39933587","chr1","38591205","38591491","27","1342088"
"chr1","39961696","39961981","chr1","38620438","38620723","19","1341258"
"chr1","39972576","39972711","chr1","38631964","38632088","17","1340612"
"chr1","39987995","39988277","chr1","38648455","38648735","20","1339540"
"chr1","39991903","39992211","chr1","38652405","38652698","29","1339498"
"chr1","39992888","39993113","chr1","38653399","38653624","12","1339489"
"chr1","39997569","39997714","chr1","38658193","38658337","11","1339376"
"chr1","39998013","39998148","chr1","38658644","38658775","5","1339369"
"chr1","40015840","40016117","chr10","36294298","36294583","64","3721542"
"chr1","40042682","40042953","chr1","38704418","38704689","13","1338264"
"chr1","40056643","40056936","chr1","38717521","38717815","15","1339122"
"chr1","40060657","40060814","chr1","38721859","38722022","16","1338798"
"chr1","40061109","40061239","chr1","38722330","38722458","11","1338779"
"chr1","40081307","40081577","chr3","13737588","13737858","57","26343719"
"chr1","40091234","40091558","chr1","38754460","38754786","21","1336774"
"chr1","40114251","40114468","chr1","38777588","38777793","24","1336663"
"chr1","40114506","40114596","chr12","118743385","118743467","28","78628879"
"chr1","40114898","40115049","chr6","56108880","56109036","34","15993982"
"chr1","40140587","40140883","chr1","38801061","38801366","55","1339526"
"chr1","40144727","40144860","chr3","183393084","183393212","24","143248357"
"chr1","40145548","40145725","chr1","117748523","117748696","40","77602975"
"chr1","40146653","40146959","chr10","27728409","27728709","60","12418244"
"chr1","40146974","40147260","chr1","90159285","90159578","60","50012311"
"chr1","40163304","40163425","chr1","38824074","38824196","12","1339230"
"chr1","40165479","40165783","chr1","38826253","38826559","23","1339226"
"chr1","40183424","40183689","chr1","38844172","38844450","34","1339252"
"chr1","40191645","40191951","chr11","122164387","122164686","60","81972742"
"chr1","40198005","40198087","chr1","38859355","38859433","9","1338650"
"chr1","40198380","40198559","chr1","38859770","38859947","16","1338610"
"chr1","40205980","40206256","chr1","38867426","38867701","27","1338554"
"chr1","40210154","40210430","chr1","38871885","38872162","16","1338269"
"chr1","40211528","40211789","chr1","38873240","38873492","41","1338288"
"chr1","40229791","40230097","chr1","38893040","38893346","13","1336751"
"chr1","40231003","40231137","chr1","38894262","38894396","5","1336741"
"chr1","40258498","40258662","chr10","20801654","20801818","39","19456844"
"chr1","40258958","40259086","chr3","36373230","36373353","20","3885728"
"chr1","40325273","40325582","chr1","38988658","38988963","29","1336615"
"chr1","40330029","40330173","chr2","180631259","180631404","30","140301230"
"chr1","40330208","40330251","chr3","143631352","143631393","9","103301144"
"chr1","40342267","40342385","chr10","62530419","62530538","26","22188152"
"chr1","40342439","40342545","chr11","49341562","49341670","22","8999123"
"chr1","40368530","40368831","chr1","39033844","39034153","35","1334686"
"chr1","40400740","40401034","chr1","39065227","39065494","49","1335513"
"chr1","40420807","40421074","chr7","44079186","44079464","59","3658379"
"chr1","40433776","40434044","chr1","39084686","39084958","24","1349090"
"chr1","40447818","40448082","chr1","39098900","39099161","20","1348918"
"chr1","40449658","40449901","chr1","39100688","39100935","17","1348970"
"chr1","40478549","40478836","chr1","39130658","39130941","20","1347891"
"chr1","40505584","40505716","chr5","85928031","85928161","19","45422447"
"chr1","40506526","40506858","chr1","39168705","39169029","37","1337821"
"chr1","40531513","40531677","chr1","156057464","156057621","35","115525951"
"chr1","40531975","40532115","chr1","39191614","39191754","4","1340361"
"chr1","40553745","40553947","chr7","127365135","127365339","8","86811390"
"chr1","40556862","40556967","chr1","134967208","134967318","22","94410346"
"chr1","40560165","40560263","chr4","15278126","15278223","25","25282039"
"chr1","40562395","40562694","chr7","127355439","127355740","32","86793044"
"chr1","40565940","40566021","chr7","127351276","127351366","11","86785336"
"chr1","40566723","40566838","chr7","127350132","127350247","6","86783409"
"chr1","40573783","40573799","chr10","33356981","33356997","2","7216802"
"chr1","40573882","40574178","chr7","127342959","127343253","24","86769077"
"chr1","40584548","40584782","chr1","39267512","39267747","17","1317036"
"chr1","40586752","40587043","chr1","39269717","39270010","25","1317035"
"chr1","40619116","40619397","chr1","39304685","39304966","16","1314431"
"chr1","40625174","40625297","chr1","200289163","200289285","22","159663989"
"chr1","40631779","40631991","chr3","38839947","38840148","50","1791832"
"chr1","40635074","40635377","chr1","39317303","39317607","16","1317771"
"chr1","40655187","40655252","chr12","20509197","20509257","15","20145990"
"chr1","40656444","40656553","chr1","39339550","39339652","15","1316894"
"chr1","40656861","40656994","chr1","39339962","39340095","7","1316899"
"chr1","40663612","40663728","chr1","39347501","39347617","2","1316111"
"chr1","40666549","40666837","chr1","39350341","39350638","26","1316208"
"chr1","40673504","40673800","chr8","96744882","96745179","58","56071378"
"chr1","40674624","40674758","chr1","39359184","39359318","16","1315440"
"chr1","40694264","40694556","chr1","39378706","39378998","15","1315558"
"chr1","40709672","40709906","chr1","85436005","85436229","55","44726333"
"chr1","40715349","40715618","chr6","170482910","170483157","58","129767561"
"chr1","40722540","40722754","chr6","170476375","170476582","24","129753835"
"chr1","40740756","40741054","chr1","39540919","39541207","35","1199837"
"chr1","40747473","40747774","chr1","39428914","39429195","53","1318559"
"chr1","40771631","40771901","chr8","100010905","100011161","59","59239274"
"chr1","40816134","40816410","chr1","39511686","39511945","32","1304448"
"chr1","40820213","40820509","chr1","39515746","39516064","45","1304467"
"chr1","40832514","40832813","chr3","41391456","41391747","63","558942"
"chr1","40840141","40840426","chr2","84978129","84978409","85","44137988"
"chr1","40844021","40844315","chr1","39540919","39541207","41","1303102"
"chr1","40856986","40857102","chr2","180235060","180235176","32","139378074"
"chr1","40860960","40861239","chr1","39559965","39560259","23","1300995"
"chr1","40876427","40876702","chr16","26744282","26744558","67","14132145"
"chr1","40882093","40882255","chr6","112634956","112635113","40","71752863"
"chr1","40893287","40893412","chr1","39594972","39595097","12","1298315"
"chr1","40894501","40894796","chr1","39596193","39596487","26","1298308"
"chr1","40901179","40901485","chr5","107767102","107767409","62","66865923"
"chr1","40901893","40902112","chr1","39606835","39607056","14","1295058"
"chr1","40906529","40906821","chr1","39611025","39611325","20","1295504"
"chr1","40938391","40938574","chr6","130708495","130708670","41","89770104"
"chr1","40939841","40940140","chr1","153434092","153434385","63","112494251"
"chr1","40962903","40963184","chr1","39653863","39654156","29","1309040"
"chr1","40964134","40964421","chr1","39655096","39655388","20","1309038"
"chr1","40980282","40980386","chr1","39677735","39677839","8","1302547"
"chr1","41008563","41008679","chr4","28045501","28045618","17","12963062"
"chr1","41013579","41013888","chr1","39710375","39710679","22","1303204"
"chr1","41014975","41015280","chr1","39711759","39712049","29","1303216"
"chr1","41016970","41017276","chr1","39713750","39714042","38","1303220"
"chr1","41019727","41020013","chr1","39716506","39716798","23","1303221"
"chr1","41073096","41073386","chr9","21289531","21289824","63","19783565"
"chr1","41078310","41078606","chr1","39772762","39773051","21","1305548"
"chr1","41113453","41113662","chr20","35094996","35095206","40","6018457"
"chr1","41114156","41114203","chr16","1220736","1220783","9","39893420"
"chr1","41114496","41114671","chr4","18015620","18015790","36","23098876"
"chr1","41135750","41136028","chr5","140153210","140153489","59","99017460"
"chr1","41144085","41144380","chr1","39835631","39835938","30","1308454"
"chr1","41148200","41148484","chr1","39839753","39840050","34","1308447"
"chr1","41151426","41151698","chr1","39842206","39842471","33","1309220"
"chr1","41152288","41152422","chr1","39843055","39843174","20","1309233"
"chr1","41152714","41152913","chr1","39843466","39843665","17","1309248"
"chr1","41164953","41165122","chr14","7002991","7003156","34","34161962"
"chr1","41165148","41165267","chr11","62483836","62483953","21","21318688"
"chr1","41177490","41177740","chr1","39868421","39868670","16","1309069"
"chr1","41203031","41203343","chr1","39893410","39893690","50","1309621"
"chr1","41208224","41208370","chr7","83975810","83975960","34","42767586"
"chr1","41216512","41216776","chr3","43806739","43807017","52","2590227"
"chr1","41324996","41325306","chrX","21314664","21314955","70","20010332"
"chr1","41326946","41327129","chr1","40017517","40017709","19","1309429"
"chr1","41327432","41327451","chr16","75369185","75369205","7","34041753"
"chr1","41327736","41327868","chr1","40018292","40018429","14","1309444"
"chr1","41342352","41342502","chr2","151197197","151197342","42","109854845"
"chr1","41363347","41363615","chr1","40053921","40054159","46","1309426"
"chr1","41371917","41372205","chr1","40064869","40065145","29","1307048"
"chr1","41398910","41399213","chr1","40091973","40092272","26","1306937"
"chr1","41404810","41405074","chr1","40099248","40099502","34","1305562"
"chr1","41424597","41424894","chr1","195801657","195801957","58","154377060"
"chr1","41446049","41446352","chr1","40139935","40140253","35","1306114"
"chr1","41475829","41475922","chr1","40170325","40170418","7","1305504"
"chr1","41476302","41476552","chr1","40170875","40171158","49","1305427"
"chr1","41478835","41479126","chr1","40173479","40173789","44","1305356"
"chr1","41487350","41487471","chr1","40182967","40183093","9","1304383"
"chr1","41489846","41490170","chr1","40185467","40185791","27","1304379"
"chr1","41492169","41492270","chr3","174409807","174409908","16","132917638"
"chr1","41500007","41500311","chr1","40196379","40196676","33","1303628"
"chr1","41512908","41513034","chr13","43495318","43495443","18","1982410"
"chr1","41516481","41516793","chr19","43114948","43115250","62","1598467"
"chr1","41517350","41517628","chr8","88122835","88123119","78","46605485"
"chr1","41524722","41524873","chr1","128720611","128720750","32","87195889"
"chr1","41524874","41525141","chr1","40220769","40221036","14","1304105"
"chr1","41525142","41525314","chr3","40258918","40259084","59","1266224"
"chr1","41538720","41539017","chr5","3182679","3182974","57","38356041"
"chr1","41540864","41541172","chr1","40236823","40237130","20","1304041"
"chr1","41544959","41545261","chr1","40241316","40241610","30","1303643"
"chr1","41553909","41554229","chr1","40248944","40249263","29","1304965"
"chr1","41554239","41554542","chr11","117977014","117977316","60","76422775"
"chr1","41564499","41564680","chr4","35912608","35912794","55","5651891"
"chr1","41564930","41565220","chr1","1724256","1724542","61","39840674"
"chr1","41571481","41571598","chr1","40265591","40265708","6","1305890"
"chr1","41572846","41573142","chr1","40266975","40267259","29","1305871"
"chr1","41575687","41575816","chr1","40277872","40278005","16","1297815"
"chr1","41583324","41583587","chr1","40285432","40285700","26","1297892"
"chr1","41595237","41595521","chr1","40298348","40298634","27","1296889"
"chr1","41624954","41625247","chr1","40327618","40327898","31","1297336"
"chr1","41642922","41643226","chr1","40345777","40346061","37","1297145"
"chr1","41661659","41661876","chr3","126091436","126091662","45","84429777"
"chr1","41666621","41666903","chr1","40368938","40369240","33","1297683"
"chr1","41676190","41676483","chr1","40378828","40379168","58","1297362"
"chr1","41676756","41677011","chr1","40379437","40379691","14","1297319"
"chr1","41683187","41683474","chr1","40385630","40385925","28","1297557"
"chr1","41684095","41684404","chr1","40386545","40386853","20","1297550"
"chr1","41693009","41693298","chr1","40395040","40395336","28","1297969"
"chr1","41697925","41698186","chr1","40423590","40423800","64","1274335"
"chr1","41712307","41712472","chr15","8429087","8429254","26","33283220"
"chr1","41730339","41730576","chr1","40452779","40453017","19","1277560"
"chr1","41739480","41739769","chr1","40460034","40460324","24","1279446"
"chr1","41771771","41771989","chr16","67041001","67041222","50","25269230"
"chr1","41797244","41797540","chr1","40504904","40505196","29","1292340"
"chr1","41805593","41805881","chr1","40514082","40514362","26","1291511"
"chr1","41853606","41853900","chr1","40556817","40557103","28","1296789"
"chr1","41863642","41863941","chr1","40567613","40567895","38","1296029"
"chr1","41895963","41896086","chr1","40596416","40596539","3","1299547"
"chr1","41912406","41912714","chr1","40615346","40615625","53","1297060"
"chr1","41981254","41981562","chr1","40692670","40692973","18","1288584"
"chr1","41988820","41989121","chr1","40700172","40700469","26","1288648"
"chr1","42219633","42219943","chr1","40937571","40937869","40","1282062"
"chr1","42236267","42236580","chr6","139215226","139215535","66","96978959"
"chr1","42372295","42372457","chr3","137639136","137639304","44","95266841"
"chr1","42429862","42430168","chr1","41152861","41153169","29","1277001"
"chr1","42512834","42513116","chr1","41169847","41170136","24","1342987"
"chr1","42663411","42663692","chr3","123351694","123351976","62","80688283"
"chr1","42676222","42676513","chr1","41337629","41337936","47","1338593"
"chr1","42690018","42690261","chr1","41351942","41352187","17","1338076"
"chr1","42835773","42836090","chr1","41501109","41501396","52","1334664"
"chr1","42876278","42876500","chr1","41542051","41542279","22","1334227"
"chr1","42899726","42899979","chr17","6006985","6007239","67","36892741"
"chr1","42913921","42914206","chr1","41577084","41577369","20","1336837"
"chr1","42922206","42922419","chr1","41584652","41584855","20","1337554"
"chr1","42951362","42951649","chr1","41609011","41609306","32","1342351"
"chr1","42955130","42955400","chr1","41611332","41611610","28","1343798"
"chr1","42983237","42983524","chr1","41639818","41640105","27","1343419"
"chr1","42997666","42997956","chr1","41653597","41653902","36","1344069"
"chr1","43009418","43009712","chr1","41666129","41666421","27","1343289"
"chr1","43018727","43018997","chr10","19944741","19945017","63","23073986"
"chr1","43023263","43023386","chr1","41681636","41681765","9","1341627"
"chr1","43023879","43024126","chr11","75270851","75271089","54","32246972"
"chr1","43042145","43042433","chr1","41701151","41701442","27","1340994"
"chr1","43055238","43055523","chr1","41717001","41717286","15","1338237"
"chr1","43057496","43057792","chr3","36897369","36897664","56","6160127"
"chr1","43078000","43078296","chr1","41738314","41738614","20","1339686"
"chr1","43091604","43091904","chr1","41752226","41752528","24","1339378"
"chr1","43094203","43094523","chr10","13692197","13692486","82","29402006"
"chr1","43112627","43112924","chr1","41772584","41772905","47","1340043"
"chr1","43124021","43124250","chr1","41782567","41782812","29","1341454"
"chr1","43161042","43161328","chr1","41820765","41821057","25","1340277"
"chr1","43179072","43179377","chr1","41838832","41839128","22","1340240"
"chr1","43223220","43223336","chr1","41882609","41882725","3","1340611"
"chr1","43232550","43232701","chr6","145629603","145629744","28","102397053"
"chr1","43265344","43265642","chr1","41924174","41924473","19","1341170"
"chr1","43269504","43269791","chr11","125201626","125201907","50","81932122"
"chr1","43273269","43273566","chr1","41930916","41931215","17","1342353"
"chr1","43282688","43282968","chr1","41940315","41940593","21","1342373"
"chr1","43290332","43290603","chr1","41947933","41948229","36","1342399"
"chr1","43299947","43300123","chr3","86349198","86349372","31","43049251"
"chr1","43300443","43300578","chr19","3199820","3199949","22","40100623"
"chr1","43303110","43303402","chr1","41964927","41965213","39","1338183"
"chr1","43312581","43312661","chr1","41974469","41974549","2","1338112"
"chr1","43314580","43314856","chr1","123654708","123654992","57","80340128"
"chr1","43328477","43328744","chr1","41991200","41991466","12","1337277"
"chr1","43329399","43329702","chr1","41992123","41992408","36","1337276"
"chr1","43343356","43343596","chr1","42006202","42006445","22","1337154"
"chr1","43346737","43347028","chr1","42009544","42009849","46","1337193"
"chr1","43377587","43377695","chr1","42040249","42040352","8","1337338"
"chr1","43378283","43378543","chr16","70146711","70146978","63","26768428"
"chr1","43385326","43385634","chr1","42048483","42048773","30","1336843"
"chr1","43389495","43389629","chr1","42050398","42050531","12","1339097"
"chr1","43400889","43401167","chr1","42063591","42063894","48","1337298"
"chr1","43402335","43402555","chr20","17985571","17985797","53","25416764"
"chr1","43408353","43408461","chr1","42071228","42071335","5","1337125"
"chr1","43422194","43422467","chr10","47225637","47225907","24","3803443"
"chr1","43438376","43438684","chr3","36458013","36458312","56","6980363"
"chr1","43456259","43456505","chr1","42120686","42120931","35","1335573"
"chr1","43479403","43479680","chr1","42143576","42143839","28","1335827"
"chr1","43481319","43481611","chr1","42144983","42145309","51","1336336"
"chr1","43494083","43494355","chr1","42160435","42160707","19","1333648"
"chr1","43497302","43497613","chr2","166718405","166718719","54","123221103"
"chr1","43507218","43507516","chr1","42179771","42180067","22","1327447"
"chr1","43553133","43553221","chr1","42278426","42278514","2","1274707"
"chr1","43590739","43590943","chr2","93979931","93980136","54","50389192"
"chr1","43647392","43647462","chr6","21859843","21859907","13","21787549"
"chr1","43673732","43674044","chr1","42398955","42399254","32","1274777"
"chr1","43701393","43701669","chr1","42428428","42428704","17","1272965"
"chr1","43709126","43709416","chr1","42436016","42436309","32","1273110"
"chr1","43715660","43715950","chr1","42442864","42443157","24","1272796"
"chr1","43717124","43717310","chr10","84067401","84067582","38","40350277"
"chr1","43739890","43740163","chr3","65583807","65584076","57","21843917"
"chr1","43801619","43801902","chr1","42514194","42514477","12","1287425"
"chr1","43836561","43836722","chr13","97087144","97087305","29","53250583"
"chr1","43851597","43851872","chr1","42675854","42676125","19","1175743"
"chr1","43876254","43876555","chr3","48771390","48771693","56","4895136"
"chr1","43896830","43897144","chr1","42712584","42712883","44","1184246"
"chr1","43959781","43960053","chr1","42775229","42775507","32","1184552"
"chr1","43970556","43970850","chrX","16433916","16434209","63","27536640"
"chr1","43980283","43980396","chr1","42795934","42796051","13","1184349"
"chr1","43994925","43995144","chr1","42810871","42811087","22","1184054"
"chr1","44057247","44057536","chr3","42967128","42967429","58","1090119"
"chr1","44059709","44060030","chr1","42869117","42869447","34","1190592"
"chr1","44108220","44108478","chr11","122688070","122688327","61","78579850"
"chr1","44143807","44144082","chr1","42956440","42956723","21","1187367"
"chr1","44159946","44160204","chr1","42972781","42973074","52","1187165"
"chr1","44163825","44164125","chr5","183301573","183301881","57","139137748"
"chr1","44164433","44164728","chr1","42977041","42977348","37","1187392"
"chr1","44171646","44171874","chr1","42984816","42985032","31","1186830"
"chr1","44200644","44200776","chr1","182272624","182272756","24","138071980"
"chr1","44362662","44362850","chr1","43181928","43182116","12","1180734"
"chr1","44373744","44374056","chr1","43193394","43193694","32","1180350"
"chr1","44383835","44384079","chr7","67325519","67325754","60","22941684"
"chr1","44394650","44394959","chr1","43214523","43214825","24","1180127"
"chr1","44399951","44400254","chr1","43223792","43224092","21","1176159"
"chr1","44402133","44402400","chr1","43226294","43226582","34","1175839"
"chr1","44406602","44406879","chr11","118504184","118504438","69","74097582"
"chr1","44414655","44414962","chr1","43238776","43239063","34","1175879"
"chr1","44422188","44422275","chr1","43247460","43247547","3","1174728"
"chr1","44428152","44428390","chr1","43253739","43253968","24","1174413"
"chr1","44429289","44429573","chr1","43254876","43255158","22","1174413"
"chr1","44431692","44431976","chr1","43257269","43257547","31","1174423"
"chr1","44442938","44443241","chr11","128838743","128839043","58","84395805"
"chr1","44464318","44464589","chr1","43289114","43289421","55","1175204"
"chr1","44468531","44468838","chr20","21422886","21423193","59","23045645"
"chr1","44471625","44471929","chr1","43296729","43297033","17","1174896"
"chr1","44484116","44484407","chr1","43309444","43309732","22","1174672"
"chr1","44504555","44504891","chr13","47954888","47955196","81","3450333"
"chr1","44564949","44565153","chr1","43393797","43393998","15","1171152"
"chr1","44565622","44565898","chr2","185276781","185277055","53","140711159"
"chr1","44590130","44590416","chr1","43419854","43420129","41","1170276"
"chr1","44597163","44597453","chr1","43426883","43427179","26","1170280"
"chr1","44614166","44614474","chr1","43444057","43444358","38","1170109"
"chr1","44642557","44642853","chr1","43472908","43473203","22","1169649"
"chr1","44666390","44666686","chr1","43496894","43497193","13","1169496"
"chr1","44666687","44666904","chr3","124929633","124929851","48","80262946"
"chr1","44691657","44691947","chr1","43524156","43524450","19","1167501"
"chr1","44735334","44735641","chr1","43610242","43610563","36","1125092"
"chr1","44745240","44745356","chr8","23150065","23150187","17","21595175"
"chr1","44745382","44745551","chr7","116514363","116514534","37","71768981"
"chr1","44749538","44749854","chr1","43625325","43625621","48","1124213"
"chr1","44752109","44752419","chr1","43627871","43628180","33","1124238"
"chr1","44758244","44758562","chr1","43633948","43634264","19","1124296"
"chr1","44759972","44760282","chr1","43635668","43635982","21","1124304"
"chr1","44771165","44771318","chrX","54000161","54000318","29","9228996"
"chr1","44772298","44772569","chr1","43656224","43656515","44","1116074"
"chr1","44777283","44777428","chr14","63769585","63769730","36","18992302"
"chr1","44784746","44785060","chr1","43670547","43670824","60","1114199"
"chr1","44795500","44795657","chr1","43681663","43681817","11","1113837"
"chr1","44807276","44807339","chr5","77735695","77735758","21","32928419"
"chr1","44814975","44815280","chr1","43701893","43702199","22","1113082"
"chr1","44823097","44823401","chr1","43709948","43710256","27","1113149"
"chr1","44833912","44834188","chr1","129289607","129289882","56","84455695"
"chr1","44855674","44855973","chr1","43741122","43741411","25","1114552"
"chr1","44857454","44857772","chr1","43742587","43742904","18","1114867"
"chr1","44858690","44858895","chr1","43743808","43744011","21","1114882"
"chr1","44858931","44859256","chr1","43744047","43744360","36","1114884"
"chr1","44870183","44870300","chrX","8701186","8701303","13","36168997"
"chr1","44871931","44872221","chr19","3353989","3354279","56","41517942"
"chr1","44874819","44875132","chr1","43760534","43760833","42","1114285"
"chr1","44878478","44878761","chr1","43763594","43763878","19","1114884"
"chr1","44879818","44880067","chr20","42020413","42020667","61","2859405"
"chr1","44880680","44880995","chr1","154261716","154262030","60","109381036"
"chr1","44951274","44951567","chr1","43838722","43839013","17","1112552"
"chr1","44971396","44971692","chr16","23732036","23732328","61","21239360"
"chr1","45013789","45014095","chr13","71802390","71802694","53","26788601"
"chr1","45028640","45028875","chr1","43916743","43916979","14","1111897"
"chr1","45042639","45042768","chr1","43930957","43931080","14","1111682"
"chr1","45057447","45057749","chrX","18310076","18310371","57","26747371"
"chr1","45106234","45106462","chr1","43992340","43992572","13","1113894"
"chr1","45120618","45120884","chr1","44007394","44007659","26","1113224"
"chr1","45129155","45129456","chr1","44015947","44016257","28","1113208"
"chr1","45142594","45142897","chr1","44032374","44032677","14","1110220"
"chr1","45165513","45165817","chr1","44053866","44054177","23","1111647"
"chr1","45173385","45173599","chr1","44061696","44061932","39","1111689"
"chr1","45218125","45218432","chr1","44108287","44108597","23","1109838"
"chr1","45224697","45224983","chr1","44115711","44115996","19","1108986"
"chr1","45247482","45247714","chr1","44141381","44141612","56","1106101"
"chr1","45268963","45269246","chr9","115879784","115880060","61","70610821"
"chr1","45277228","45277508","chr1","44171967","44172258","34","1105261"
"chr1","45282438","45282579","chr1","44177093","44177224","22","1105345"
"chr1","45344102","45344398","chr1","44239563","44239860","14","1104539"
"chr1","45350001","45350188","chr1","44247634","44247819","11","1102367"
"chr1","45351352","45351670","chr5","78697170","78697484","52","33345818"
"chr1","45352578","45352702","chr1","44250431","44250555","6","1102147"
"chr1","45361444","45361766","chr1","21474061","21474377","62","23887383"
"chr1","45362168","45362478","chr1","44260914","44261223","15","1101254"
"chr1","45399128","45399266","chr1","44358638","44358774","31","1040490"
"chr1","45412467","45412741","chr1","44307348","44307627","22","1105119"
"chr1","45418166","45418327","chr5","58651995","58652158","32","13233829"
"chr1","45449929","45450163","chr10","14751103","14751359","68","30698826"
"chr1","45450369","45450497","chr1","44348259","44348386","11","1102110"
"chr1","45460457","45460728","chr7","127802025","127802307","48","82341568"
"chr1","45460757","45460769","chr19","37258940","37258951","1","8201817"
"chr1","45494608","45494772","chr1","44389709","44389879","25","1104899"
"chr1","45505553","45505647","chr1","44402371","44402465","2","1103182"
"chr1","45505959","45505993","chr3","148232389","148232419","8","102726430"
"chr1","45506027","45506203","chr11","116427440","116427614","34","70921413"
"chr1","45515352","45515638","chr1","44411796","44412097","27","1103556"
"chr1","45523141","45523431","chr20","51397826","51398122","58","5874685"
"chr1","45526452","45526732","chr16","67007202","67007465","63","21480750"
"chr1","45533034","45533156","chr2","49678204","49678326","18","4145170"
"chr1","45537575","45537765","chr1","44433526","44433738","36","1104049"
"chr1","45539665","45539919","chr1","44435616","44435852","34","1104049"
"chr1","45559193","45559512","chrX","12409846","12410146","75","33149347"
"chr1","45571414","45571569","chr1","44473806","44473964","12","1097608"
"chr1","45571863","45571997","chr1","44474255","44474388","9","1097608"
"chr1","45573212","45573519","chr1","44475640","44475978","53","1097572"
"chr1","45612648","45612947","chr1","44516138","44516440","24","1096510"
"chr1","45613736","45614064","chr3","126815172","126815489","81","81201436"
"chr1","45615667","45615974","chr1","44518576","44518887","32","1097091"
"chr1","45619354","45619661","chr1","44522190","44522491","23","1097164"
"chr1","45629979","45630239","chr2","41466589","41466842","56","4163390"
"chr1","45630296","45630498","chr1","44533096","44533298","12","1097200"
"chr1","45631302","45631597","chr1","44534590","44534883","24","1096712"
"chr1","45643538","45643703","chr15","8154672","8154830","35","37488866"
"chr1","45643969","45644262","chr1","44551513","44551813","24","1092456"
"chr1","45656087","45656359","chr1","44563326","44563595","24","1092761"
"chr1","45664740","45664775","chrX","15971031","15971069","9","29693709"
"chr1","45669631","45669874","chr1","44577276","44577552","52","1092355"
"chr1","45696428","45696558","chr1","44603314","44603444","4","1093114"
"chr1","45699313","45699606","chr1","44607261","44607551","13","1092052"
"chr1","45703979","45704285","chr1","44611590","44611902","22","1092389"
"chr1","45707003","45707142","chr13","24158829","24158994","61","21548174"
"chr1","45707397","45707529","chr1","44614813","44614938","13","1092584"
"chr1","45711305","45711610","chr1","44618741","44619040","20","1092564"
"chr1","45721100","45721395","chr1","44628071","44628346","34","1093029"
"chr1","45722954","45723071","chr3","67301864","67301983","21","21578910"
"chr1","45729545","45729844","chr1","44637131","44637420","30","1092414"
"chr1","45734192","45734507","chr16","31792687","31793003","54","13941505"
"chr1","45755601","45755768","chr9","84911154","84911321","41","39155553"
"chr1","45756373","45756531","chr3","124792097","124792246","40","79035724"
"chr1","45756567","45756754","chrX","40502959","40503136","44","5253608"
"chr1","45757293","45757629","chr7","62956753","62957062","82","17199460"
"chr1","45760999","45761289","chr1","44672427","44672730","38","1088572"
"chr1","45769655","45769940","chr1","44681069","44681338","32","1088586"
"chr1","45774837","45775148","chr1","44683727","44684045","30","1091110"
"chr1","45793832","45794108","chr1","44702268","44702538","41","1091564"
"chr1","45794637","45794876","chr1","44703053","44703293","12","1091584"
"chr1","45803427","45803686","chr1","44709816","44710092","26","1093611"
"chr1","45810510","45810793","chr1","44717252","44717539","15","1093258"
"chr1","45815229","45815529","chr1","44722001","44722309","24","1093228"
"chr1","45816137","45816447","chr1","44722910","44723205","31","1093227"
"chr1","45835118","45835390","chr1","44759404","44759688","31","1075714"
"chr1","45868989","45869185","chr1","44785802","44786000","20","1083187"
"chr1","45871642","45871920","chr18","38502733","38503003","60","7368909"
"chr1","45900591","45900896","chr1","90159285","90159578","57","44258694"
"chr1","45908089","45908214","chr1","44813508","44813633","9","1094581"
"chr1","45912550","45912699","chr1","44817809","44817958","10","1094741"
"chr1","45938224","45938352","chr1","44844190","44844317","12","1094034"
"chr1","45939729","45940050","chr10","73824003","73824316","68","27884274"
"chr1","45943362","45943662","chr1","44849823","44850130","40","1093539"
"chr1","45958146","45958396","chr1","44866328","44866579","13","1091818"
"chr1","45990444","45990574","chr1","44909721","44909851","6","1080723"
"chr1","46018832","46018967","chr16","1727569","1727702","37","44291263"
"chr1","46019557","46019716","chr5","56463004","56463162","32","10443447"
"chr1","46023106","46023229","chr1","44943615","44943737","6","1079491"
"chr1","46038355","46038653","chr1","44959643","44959952","20","1078712"
"chr1","46040586","46040880","chr8","65091296","65091594","57","19050710"
"chr1","46043268","46043576","chr1","44963266","44963562","27","1080002"
"chr1","46045840","46046134","chr1","44965810","44966100","34","1080030"
"chr1","46050607","46050898","chr14","115049792","115050083","60","68999185"
"chr1","46052051","46052388","chr1","44972296","44972592","47","1079755"
"chr1","46052598","46052858","chr1","44972986","44973244","20","1079612"
"chr1","46059205","46059501","chr1","44980298","44980587","28","1078907"
"chr1","46063181","46063516","chr12","59156271","59156597","71","13093090"
"chr1","46067521","46067831","chr1","33298849","33299154","63","12768672"
"chr1","46068249","46068508","chr14","20491909","20492152","63","25576340"
"chr1","46073900","46074157","chr1","44993208","44993467","28","1080692"
"chr1","46086559","46086856","chr1","45006357","45006661","28","1080202"
"chr1","46094023","46094092","chr11","47193890","47193953","28","1099867"
"chr1","46094095","46094180","chr9","123682701","123682783","15","77588606"
"chr1","46095946","46096142","chr1","45016651","45016840","30","1079295"
"chr1","46096613","46096941","chr2","88897939","88898270","74","42801326"
"chr1","46102502","46102555","chr8","29453241","29453295","11","16649261"
"chr1","46106574","46106871","chr1","45030178","45030486","24","1076396"
"chr1","46107287","46107554","chr1","45030900","45031170","44","1076387"
"chr1","46113889","46114179","chr1","45037567","45037857","22","1076322"
"chr1","46134337","46134453","chr1","207476913","207477027","15","161342576"
"chr1","46142172","46142468","chr19","40069166","40069463","53","6073006"
"chr1","46153756","46154059","chr2","46260060","46260367","64","106304"
"chr1","46162570","46162847","chr1","45089164","45089431","20","1073406"
"chr1","46165882","46165999","chr11","102229016","102229130","16","56063134"
"chr1","46170819","46170925","chr5","111121792","111121898","9","64950973"
"chr1","46194209","46194235","chr9","63164489","63164513","5","16970280"
"chr1","46194535","46194683","chr3","3805522","3805672","35","42389013"
"chr1","46200380","46200709","chr14","63858277","63858583","72","17657897"
"chr1","46203236","46203352","chr1","45120664","45120780","5","1082572"
"chr1","46213240","46213570","chr1","45131616","45131943","24","1081624"
"chr1","46220171","46220446","chr1","129289607","129289882","66","83069436"
"chr1","46248062","46248171","chr9","87727843","87727952","29","41479781"
"chr1","46248754","46249051","chr1","45170053","45170349","32","1078701"
"chr1","46250945","46251253","chr3","55301789","55302082","68","9050844"
"chr1","46251424","46251645","chr4","54542586","54542798","53","8291162"
"chr1","46253175","46253344","chr1","45173339","45173508","12","1079836"
"chr1","46254575","46254848","chr1","45176586","45176851","22","1077989"
"chr1","46298693","46298838","chr1","45224305","45224459","18","1074388"
"chr1","46299150","46299302","chr1","45224770","45224919","17","1074380"
"chr1","46310475","46310621","chr1","45238588","45238738","12","1071887"
"chr1","46313317","46313578","chr1","45241145","45241444","51","1072172"
"chr1","46314181","46314495","chr1","45242666","45242971","40","1071515"
"chr1","46315083","46315381","chr1","45243566","45243829","57","1071517"
"chr1","46316881","46317009","chr1","45245393","45245516","9","1071488"
"chr1","46319656","46319951","chr1","45248205","45248502","20","1071451"
"chr1","46326067","46326276","chr1","45254046","45254260","31","1072021"
"chr1","46326469","46326750","chr1","45254447","45254724","19","1072022"
"chr1","46336852","46337148","chr1","45264478","45264795","43","1072374"
"chr1","46352247","46352546","chr3","130117447","130117749","24","83765200"
"chr1","46373687","46373969","chr1","110217765","110218050","58","63844078"
"chr1","46380163","46380336","chr1","45304215","45304388","6","1075948"
"chr1","46385234","46385531","chr1","45309823","45310114","29","1075411"
"chr1","46389302","46389599","chr15","43687639","43687935","54","2701663"
"chr1","46393718","46393915","chr16","23362029","23362222","44","23031689"
"chr1","46394209","46394237","chr4","87953529","87953558","6","41559320"
"chr1","46394532","46394659","chr13","43376362","43376486","20","3018170"
"chr1","46401613","46401907","chr1","45320300","45320604","35","1081313"
"chr1","46407121","46407418","chr11","48401419","48401716","68","1994298"
"chr1","46431102","46431426","chr1","45361560","45361909","52","1069542"
"chr1","46431929","46432212","chr1","45362385","45362673","38","1069544"
"chr1","46444584","46444900","chr1","45368690","45369004","22","1075894"
"chr1","46447021","46447312","chr1","45370758","45371050","14","1076263"
"chr1","46515399","46515520","chr1","45474297","45474404","16","1041102"
"chr1","46562839","46563008","chr7","151548321","151548487","38","104985482"
"chr1","46587182","46587407","chr1","45544948","45545172","16","1042234"
"chr1","46589970","46590076","chr1","45547799","45547908","18","1042171"
"chr1","46590381","46590576","chr1","45548210","45548403","14","1042171"
"chr1","46595686","46596011","chr19","40228982","40229290","97","6366704"
"chr1","46636316","46636616","chr1","45588225","45588530","28","1048091"
"chr1","46640481","46640776","chr1","45591945","45592240","23","1048536"
"chr1","46644469","46644741","chr19","7651153","7651428","60","38993316"
"chr1","46645265","46645580","chr1","45596884","45597191","31","1048381"
"chr1","46648282","46648572","chr1","45599892","45600201","31","1048390"
"chr1","46648980","46649261","chr1","45600540","45600845","33","1048440"
"chr1","46651451","46651741","chr1","45603315","45603605","11","1048136"
"chr1","46665759","46666027","chr9","27896865","27897139","63","18768894"
"chr1","46687992","46688093","chr7","137527092","137527195","19","90839100"
"chr1","46704095","46704401","chr1","45654721","45655023","22","1049374"
"chr1","46732186","46732459","chr5","40762070","40762343","60","5970116"
"chr1","46746203","46746319","chr11","113226186","113226302","17","66479983"
"chr1","46757523","46757654","chr1","19142889","19143021","27","27614634"
"chr1","46758961","46759255","chr1","45712127","45712415","25","1046834"
"chr1","46773251","46773540","chr1","45727180","45727470","29","1046071"
"chr1","46776178","46776467","chr9","95160793","95161079","54","48384615"
"chr1","46777723","46778024","chr1","45732283","45732592","32","1045440"
"chr1","46781868","46781998","chr8","143280328","143280473","37","96498460"
"chr1","46782036","46782049","chr10","65115672","65115684","3","18333636"
"chr1","46787663","46787788","chr6","178258279","178258401","32","131470616"
"chr1","46799867","46800140","chr1","45754430","45754712","23","1045437"
"chr1","46804471","46804815","chr1","45757789","45758127","26","1046682"
"chr1","46812311","46812435","chr13","25546692","25546816","19","21265619"
"chr1","46815130","46815416","chr1","45769012","45769300","20","1046118"
"chr1","46817978","46818266","chr2","83884719","83885008","58","37066741"
"chr1","46821940","46822095","chr3","126745685","126745842","31","79923745"
"chr1","46822124","46822245","chr19","52862045","52862167","16","6039921"
"chr1","46825739","46825973","chr1","45778838","45779071","17","1046901"
"chr1","46843686","46843973","chr11","131260074","131260355","57","84416388"
"chr1","46868858","46868987","chr1","45822331","45822460","12","1046527"
"chr1","46874126","46874302","chr2","22393735","22393905","43","24480391"
"chr1","46878543","46878830","chr1","45831980","45832277","24","1046563"
"chr1","46893699","46894007","chr1","45847139","45847447","11","1046560"
"chr1","46901685","46901990","chr1","45855118","45855416","23","1046567"
"chr1","46912473","46912768","chr1","45866110","45866397","25","1046363"
"chr1","46926587","46926873","chr1","45880575","45880862","14","1046012"
"chr1","46933980","46934245","chr1","45888174","45888441","16","1045806"
"chr1","46949205","46949413","chr1","45905093","45905309","22","1044112"
"chr1","46949740","46949887","chr11","110460757","110460916","37","63511017"
"chr1","46950128","46950250","chr11","116401771","116401893","23","69451643"
"chr1","46958088","46958374","chr7","41643486","41643768","64","5314602"
"chr1","46965361","46965518","chr7","84537557","84537711","25","37572196"
"chr1","46965811","46965865","chr2","56287099","56287155","12","9321288"
"chr1","46975141","46975299","chr1","45937550","45937710","20","1037591"
"chr1","46975598","46975716","chr1","45936824","45936938","12","1038774"
"chr1","47010428","47010543","chr15","29268875","29268992","16","17741553"
"chr1","47027758","47027881","chr1","45983366","45983490","8","1044392"
"chr1","47103334","47103451","chr1","46048870","46048978","14","1054464"
"chr1","47107732","47108016","chr1","46052718","46052996","44","1055014"
"chr1","47161255","47161559","chr1","46106688","46107002","33","1054567"
"chr1","47212086","47212361","chr10","19944741","19945017","60","27267345"
"chr1","47225234","47225486","chr15","27087852","27088111","58","20137382"
"chr1","47239087","47239207","chr1","46183167","46183288","9","1055920"
"chr1","47288583","47288878","chr1","46234312","46234606","21","1054271"
"chr1","47294721","47294892","chr1","46240791","46240976","22","1053930"
"chr1","47302872","47303167","chr1","46249146","46249441","33","1053726"
"chr1","47305904","47306079","chr1","46252202","46252377","11","1053702"
"chr1","47336059","47336172","chr1","46280812","46280925","3","1055247"
"chr1","47496605","47496904","chr14","111704523","111704824","69","64207918"
"chr1","47515172","47515282","chr8","93512794","93512909","22","45997622"
"chr1","47525611","47525907","chr14","12540994","12541290","58","34984617"
"chr1","47534502","47534790","chr1","46478112","46478393","27","1056390"
"chr1","47651184","47651424","chr3","126091436","126091662","58","78440252"
"chr1","47730769","47731077","chr1","46473572","46473857","40","1257197"
"chr1","47910420","47910708","chr1","46478112","46478393","29","1432308"
"chr1","47917774","47918052","chr3","48105482","48105749","54","187708"
"chr1","47927205","47927315","chr8","93512794","93512909","22","45585589"
"chr1","48039963","48040251","chr1","46718698","46719013","36","1321265"
"chr1","48077954","48078143","chr1","46757713","46757903","12","1320241"
"chr1","48081013","48081324","chr1","46760881","46761179","28","1320132"
"chr1","48083022","48083325","chr9","128228335","128228636","63","80145313"
"chr1","48085879","48086175","chr1","46765804","46766098","26","1320075"
"chr1","48088941","48089169","chr1","46768862","46769083","16","1320079"
"chr1","48109976","48110093","chr6","167222159","167222276","22","119112183"
"chr1","48114869","48115161","chr1","46794327","46794623","16","1320542"
"chr1","48127123","48127253","chr1","46807257","46807387","4","1319866"
"chr1","48138452","48138729","chr1","46817885","46818162","12","1320567"
"chr1","48141766","48142066","chr1","46821517","46821827","24","1320249"
"chr1","48166686","48166864","chr19","5653378","5653561","42","42513308"
"chr1","48169504","48169773","chr1","46848476","46848741","22","1321028"
"chr1","48176889","48177105","chr7","66622288","66622506","45","18445399"
"chr1","48193089","48193368","chr5","50912501","50912755","79","2719412"
"chr1","48226336","48226468","chr1","46920608","46920738","11","1305728"
"chr1","48258668","48258925","chr1","46953655","46953903","33","1305013"
"chr1","48267740","48268009","chr1","46964539","46964808","16","1303201"
"chr1","48275004","48275133","chr1","46971792","46971922","12","1303212"
"chr1","48292480","48292783","chr1","46989228","46989526","16","1303252"
"chr1","48330853","48331157","chr1","47029597","47029891","37","1301256"
"chr1","48592614","48592921","chr1","47287966","47288274","42","1304648"
"chr1","48618417","48618715","chr1","47313751","47314062","26","1304666"
"chr1","48632544","48632835","chr7","165716105","165716404","52","117083561"
"chr1","48664228","48664510","chr1","47359605","47359915","47","1304623"
"chr1","48680202","48680502","chr1","47375943","47376231","56","1304259"
"chr1","48681038","48681336","chr1","47376767","47377038","40","1304271"
"chr1","48684395","48684697","chr1","47380142","47380423","47","1304253"
"chr1","48697132","48697417","chrX","125989015","125989296","58","77291883"
"chr1","48697455","48697485","chr2","140141471","140141500","7","91444016"
"chr1","48708119","48708402","chr1","47403780","47404065","24","1304339"
"chr1","48723005","48723323","chr1","47419013","47419303","43","1303992"
"chr1","48812960","48813247","chr11","121290594","121290887","53","72477634"
"chr1","48815752","48816075","chr1","47507415","47507727","37","1308337"
"chr1","48837123","48837421","chr1","47528681","47528955","48","1308442"
"chr1","48862455","48862755","chr1","47552964","47553265","23","1309491"
"chr1","48886829","48887090","chr1","47578401","47578661","13","1308428"
"chr1","48919136","48919443","chr3","123585503","123585819","71","74666367"
"chr1","48961166","48961471","chr2","71005973","71006275","68","22044807"
"chr1","49100329","49100460","chr1","47878148","47878287","14","1222181"
"chr1","49197561","49197838","chr1","47974710","47974987","5","1222851"
"chr1","49220060","49220349","chr1","47998935","47999211","39","1221125"
"chr1","49252690","49252976","chr1","48029445","48029747","41","1223245"
"chr1","49373716","49373872","chr6","122098582","122098725","28","72724866"
"chr1","49374175","49374348","chr19","4906316","4906490","45","44467859"
"chr1","49393100","49393392","chr1","48170196","48170490","22","1222904"
"chr1","49403962","49404243","chr1","48181280","48181567","44","1222682"
"chr1","49664801","49664884","chrX","53790985","53791067","13","4126184"
"chr1","49718795","49719043","chr1","48502208","48502463","43","1216587"
"chr1","49818636","49818860","chr1","48606590","48606823","28","1212046"
"chr1","49976428","49976733","chr3","21279895","21280200","67","28696533"
"chr1","49985875","49986176","chr8","22878685","22878980","62","27107190"
"chr1","49989178","49989424","chrX","148305511","148305763","56","98316333"
"chr1","50071937","50072200","chr1","48844924","48845197","27","1227013"
"chr1","50553302","50553597","chr1","49291747","49292042","19","1261555"
"chr1","50569563","50569860","chr7","54626438","54626727","67","4056875"
"chr1","50633975","50634260","chr1","49375636","49375923","27","1258339"
"chr1","50675621","50675631","chr7","17256783","17256794","3","33418838"
"chr1","50676056","50676179","chr16","52438319","52438442","28","1762263"
"chr1","50701753","50702029","chr2","56900301","56900575","62","6198548"
"chr1","50709364","50709658","chr1","49474940","49475220","32","1234424"
"chr1","50726188","50726484","chr1","49492526","49492826","27","1233662"
"chr1","50800387","50800678","chr1","49566635","49566928","25","1233752"
"chr1","50830102","50830358","chr1","49596675","49596931","17","1233427"
"chr1","50832398","50832475","chr1","49598975","49599040","14","1233423"
"chr1","50911861","50911978","chr1","49677612","49677735","14","1234249"
"chr1","50918126","50918416","chr5","63356316","63356602","70","12438190"
"chr1","50998250","50998491","chr15","84541808","84542053","56","33543558"
"chr1","51013000","51013304","chr1","49777596","49777909","37","1235404"
"chr1","51157677","51157991","chr1","49972712","49973017","33","1184965"
"chr1","51184626","51184922","chr1","49999295","49999561","45","1185331"
"chr1","51249732","51250047","chr1","50062935","50063249","13","1186797"
"chr1","51250253","51250572","chr1","50063454","50063772","25","1186799"
"chr1","51254365","51254635","chr19","53249067","53249335","69","1994702"
"chr1","51256238","51256507","chr1","50066866","50067138","24","1189372"
"chr1","51273245","51273370","chr3","10002180","10002302","23","41271065"
"chr1","51279675","51279985","chr1","50091895","50092190","36","1187780"
"chr1","51310111","51310277","chr5","3061274","3061440","40","48248837"
"chr1","51335039","51335088","chr1","50147778","50147827","2","1187261"
"chr1","51356136","51356418","chr1","50167866","50168144","20","1188270"
"chr1","51413229","51413516","chr1","50226503","50226796","19","1186726"
"chr1","51418799","51419006","chr18","37535102","37535314","50","13883697"
"chr1","51428973","51429211","chr1","50241135","50241377","21","1187838"
"chr1","51464072","51464194","chr1","50277099","50277221","8","1186973"
"chr1","51488163","51488475","chr3","123585503","123585819","66","72097340"
"chr1","51522862","51523156","chr14","58287610","58287895","66","6764748"
"chr1","51534607","51534909","chr1","50339092","50339391","21","1195515"
"chr1","51581883","51582083","chr19","6885090","6885273","46","44696793"
"chr1","51619592","51619888","chr1","50428355","50428636","27","1191237"
"chr1","51669635","51669934","chr1","50483292","50483600","39","1186343"
"chr1","51684342","51684461","chr1","50497573","50497693","6","1186769"
"chr1","51693736","51694010","chr20","20626690","20626960","71","31067046"
"chr1","51697736","51697876","chr5","51283123","51283265","27","414613"
"chr1","51698187","51698358","chr14","12936569","12936737","39","38761618"
"chr1","51765349","51765677","chr3","5056389","5056699","72","46708960"
"chr1","51769975","51770269","chr1","50583351","50583654","24","1186624"
"chr1","51786394","51786699","chr1","50594476","50594782","36","1191918"
"chr1","51788481","51788747","chr1","50596764","50597072","57","1191717"
"chr1","51792462","51792771","chr1","50600803","50601121","32","1191659"
"chr1","51798039","51798133","chr1","16674594","16674681","17","35123445"
"chr1","51799179","51799303","chr20","33372431","33372555","17","18426748"
"chr1","51822380","51822558","chr1","50631653","50631831","8","1190727"
"chr1","51830396","51830689","chr1","50639630","50639928","25","1190766"
"chr1","51845556","51845840","chr1","50661126","50661419","33","1184430"
"chr1","51848845","51849055","chr1","62187766","62187962","52","10338921"
"chr1","51853772","51853952","chr6","68146972","68147145","32","16293200"
"chr1","51854233","51854370","chr1","50670833","50670970","4","1183400"
"chr1","51887589","51887741","chr16","58531539","58531690","20","6643950"
"chr1","51895383","51895666","chr2","134217641","134217927","51","82322258"
"chr1","51898003","51898124","chr6","94210591","94210714","16","42312588"
"chr1","51900060","51900155","chr17","8213924","8214024","16","43686136"
"chr1","51919392","51919680","chr1","50739156","50739446","23","1180236"
"chr1","51922359","51922654","chr7","140588016","140588306","53","88665657"
"chr1","51923399","51923654","chr1","50742672","50742937","31","1180727"
"chr1","51933537","51933838","chr1","50752694","50753000","29","1180843"
"chr1","51942528","51942788","chr1","50759431","50759699","25","1183097"
"chr1","51946720","51946985","chr1","50763928","50764196","23","1182792"
"chr1","51950511","51950629","chr1","50765183","50765309","15","1185328"
"chr1","51957333","51957453","chr1","50772760","50772881","7","1184573"
"chr1","51957463","51957750","chr10","12389093","12389387","53","39568370"
"chr1","51961421","51961710","chr1","50776838","50777144","41","1184583"
"chr1","51974806","51975084","chr1","50793522","50793768","42","1181284"
"chr1","51983354","51983520","chr9","89539724","89539868","50","37556370"
"chr1","51989033","51989233","chr5","139499798","139500000","34","87510765"
"chr1","51990965","51991342","chr1","50810632","50810991","40","1180333"
"chr1","51996793","51997081","chr1","50815539","50815842","36","1181254"
"chr1","52005149","52005273","chr19","42684924","42685033","43","9320225"
"chr1","52005508","52005580","chr14","111619018","111619076","23","59613510"
"chr1","52010253","52010475","chr1","50829382","50829606","17","1180871"
"chr1","52019541","52019837","chr1","50838597","50838853","53","1180944"
"chr1","52035114","52035417","chr1","50854258","50854573","66","1180856"
"chr1","52079867","52080018","chr1","50899736","50899887","10","1180131"
"chr1","52091047","52091345","chr1","50911423","50911721","15","1179624"
"chr1","52137638","52137931","chr1","50946149","50946432","27","1191489"
"chr1","52139656","52139955","chr1","50948490","50948799","23","1191166"
"chr1","52145926","52146009","chr7","63076991","63077076","18","10931065"
"chr1","52171636","52171889","chr20","26516169","26516422","61","25655467"
"chr1","52186335","52186645","chr1","182642228","182642528","67","130455893"
"chr1","52210230","52210517","chr1","51027180","51027483","32","1183050"
"chr1","52224107","52224403","chr1","51041646","51041936","31","1182461"
"chr1","52257244","52257455","chr1","51076418","51076637","34","1180826"
"chr1","52269329","52269615","chr1","51089091","51089372","26","1180238"
"chr1","52277747","52278067","chr1","51096211","51096533","23","1181536"
"chr1","52279025","52279289","chr1","51097489","51097766","36","1181536"
"chr1","52286491","52286740","chr1","51106035","51106284","24","1180456"
"chr1","52295071","52295226","chr1","24769307","24769455","37","27525764"
"chr1","52312666","52312966","chr1","51137511","51137810","15","1175155"
"chr1","52317769","52318076","chr1","51142613","51142925","23","1175156"
"chr1","52329651","52329921","chr1","51154474","51154769","41","1175177"
"chr1","52331663","52331869","chr9","98473358","98473561","55","46141695"
"chr1","52357079","52357371","chr7","58370727","58371021","75","6013648"
"chr1","52361993","52362303","chr1","51180513","51180823","19","1181480"
"chr1","52374684","52374980","chr9","120532529","120532826","62","68157845"
"chr1","52384279","52384414","chr1","51204956","51205090","7","1179323"
"chr1","52386074","52386172","chr13","43091006","43091110","23","9295068"
"chr1","52404222","52404516","chr1","51225449","51225744","36","1178773"
"chr1","52405355","52405665","chr16","66697046","66697357","54","14291691"
"chr1","52425466","52425768","chrX","15911622","15911925","64","36513844"
"chr1","52431565","52431857","chr1","188627840","188628135","62","136196275"
"chr1","52435913","52436206","chr1","51254064","51254353","19","1181849"
"chr1","52439689","52439982","chr1","51257417","51257682","53","1182272"
"chr1","52444585","52444893","chr1","51262408","51262717","29","1182177"
"chr1","52468297","52468410","chr1","51283539","51283651","10","1184758"
"chr1","52469795","52469949","chr5","183794102","183794248","35","131324307"
"chr1","52477398","52477725","chr1","51292636","51292956","27","1184762"
"chr1","52488678","52488999","chr3","154971572","154971876","68","102482894"
"chr1","52495540","52495834","chr1","51310639","51310930","35","1184901"
"chr1","52501030","52501307","chr19","10635743","10636019","60","41865287"
"chr1","52510814","52511117","chr1","51331869","51332182","32","1178945"
"chr1","52524306","52524603","chr1","51345851","51346158","33","1178455"
"chr1","52529578","52529889","chr1","51351426","51351742","33","1178152"
"chr1","52542264","52542542","chr1","51363959","51364237","21","1178305"
"chr1","52543904","52544214","chr1","51365711","51366008","32","1178193"
"chr1","52546099","52546401","chr1","51367931","51368230","16","1178168"
"chr1","52546989","52547233","chr1","51368815","51369058","15","1178174"
"chr1","52553152","52553434","chr1","51374708","51374990","9","1178444"
"chr1","52570521","52570635","chr14","9262393","9262510","18","43308128"
"chr1","52574392","52574604","chr1","51398140","51398350","16","1176252"
"chr1","52578845","52579118","chr1","51402942","51403215","25","1175903"
"chr1","52579277","52579578","chr1","51403396","51403670","44","1175881"
"chr1","52605259","52605550","chr16","31822404","31822697","64","20782855"
"chr1","52609533","52609825","chr1","51440302","51440602","31","1169231"
"chr1","52614068","52614231","chr1","51445471","51445634","10","1168597"
"chr1","52616024","52616324","chr1","51447438","51447741","20","1168586"
"chr1","52631711","52632003","chr1","51464169","51464461","13","1167542"
"chr1","52664695","52664959","chr14","57634401","57634675","54","4969706"
"chr1","52670546","52670634","chr1","51503152","51503240","5","1167394"
"chr1","52686418","52686692","chr1","51519668","51519955","31","1166750"
"chr1","52698378","52698659","chr1","51531930","51532208","22","1166448"
"chr1","52723018","52723240","chr16","24748324","24748543","39","27974694"
"chr1","52726992","52727287","chr1","51561241","51561536","16","1165751"
"chr1","52748737","52749026","chr1","20257747","20258018","64","32490990"
"chr1","52757550","52757743","chr1","51597742","51597936","19","1159808"
"chr1","52759605","52759885","chr1","51600100","51600382","15","1159505"
"chr1","52903050","52903361","chr1","51633226","51633518","38","1269824"
"chr1","52931451","52931731","chr1","51660992","51661268","23","1270459"
"chr1","52932628","52932930","chr4","151163740","151164021","70","98231112"
"chr1","52938749","52939055","chr1","51668720","51669026","18","1270029"
"chr1","52950643","52950901","chr3","19982301","19982542","66","32968342"
"chr1","52958179","52958493","chr1","51685931","51686245","25","1272248"
"chr1","52960623","52960749","chr9","107933148","107933272","17","54972525"
"chr1","52982489","52982799","chr1","51708294","51708601","27","1274195"
"chr1","52989320","52989399","chr7","151554870","151554945","12","98565550"
"chr1","53025623","53025916","chr1","51751785","51752071","36","1273838"
"chr1","53041068","53041325","chr1","51759497","51759755","17","1281571"
"chr1","53085404","53085674","chr4","18525744","18526014","61","34559660"
"chr1","53086214","53086494","chr11","27873752","27874033","63","25212462"
"chr1","53107952","53108246","chr1","51824863","51825155","33","1283089"
"chr1","53112017","53112306","chr1","51828700","51828995","28","1283317"
"chr1","53144325","53144577","chr1","51864347","51864599","19","1279978"
"chr1","53170669","53170956","chr1","51889961","51890256","30","1280708"
"chr1","53181924","53182062","chr3","126122510","126122645","29","72940586"
"chr1","53182376","53182574","chr14","16204089","16204253","64","36978287"
"chr1","53182608","53182623","chr6","149852315","149852330","3","96669707"
"chr1","53363010","53363302","chr1","52084319","52084615","28","1278691"
"chr1","53398354","53398580","chr1","52117894","52118123","10","1280460"
"chr1","53414073","53414369","chr1","52134458","52134767","27","1279615"
"chr1","53416255","53416569","chr1","52136546","52136870","34","1279709"
"chr1","53426702","53426828","chr1","52147634","52147762","6","1279068"
"chr1","53427122","53427313","chr1","52148038","52148224","19","1279084"
"chr1","53428741","53428810","chrX","15934857","15934923","18","37493884"
"chr1","53429679","53429972","chr1","52150971","52151263","19","1278708"
"chr1","53443302","53443604","chr1","52166007","52166310","22","1277295"
"chr1","53444735","53445050","chr20","8590111","8590405","67","44854624"
"chr1","53445465","53445753","chr1","52168185","52168478","19","1277280"
"chr1","53457293","53457593","chr1","52182984","52183264","39","1274309"
"chr1","53466742","53467022","chr1","52192914","52193194","17","1273828"
"chr1","53474705","53474935","chr7","3453618","3453851","54","50021087"
"chr1","53495902","53496117","chr3","165295251","165295467","57","111799349"
"chr1","53510230","53510346","chr1","211570558","211570675","17","158060328"
"chr1","53514102","53514383","chr1","52239960","52240256","40","1274142"
"chr1","53521678","53521886","chr10","29785506","29785712","61","23736172"
"chr1","53527309","53527567","chr1","52254039","52254298","18","1273270"
"chr1","53542033","53542314","chr1","191690399","191690678","57","138148366"
"chr1","53556356","53556656","chr4","103730788","103731088","46","50174432"
"chr1","53559088","53559381","chr1","52289377","52289665","21","1269711"
"chr1","53587485","53587784","chr1","52323492","52323790","23","1263993"
"chr1","53591676","53591983","chr1","52327719","52328030","33","1263957"
"chr1","53595625","53595913","chr10","69629356","69629644","55","16033731"
"chr1","53597751","53598070","chr1","52334384","52334662","63","1263367"
"chr1","53600816","53601094","chr1","52337195","52337474","25","1263621"
"chr1","53610989","53611185","chr1","52345630","52345860","42","1265359"
"chr1","53623996","53624270","chr1","52358891","52359157","33","1265105"
"chr1","53636966","53637171","chr9","13842966","13843169","28","39794000"
"chr1","53648910","53649098","chr4","36343878","36344054","47","17305032"
"chr1","53663614","53663906","chr1","52404594","52404898","36","1259020"
"chr1","53664099","53664389","chr1","52405089","52405384","25","1259010"
"chr1","53665911","53666195","chr1","52406745","52407041","30","1259166"
"chr1","53674948","53675072","chr1","52416412","52416536","10","1258536"
"chr1","53677895","53678009","chr1","52420017","52420134","7","1257878"
"chr1","53681180","53681299","chr1","52423090","52423229","26","1258090"
"chr1","53691797","53691913","chr1","52434936","52435052","9","1256861"
"chr1","53693584","53693809","chr20","27667647","27667870","55","26025937"
"chr1","53709217","53709291","chr1","52460361","52460433","6","1248856"
"chr1","53731397","53731554","chr1","52480122","52480273","15","1251275"
"chr1","53731853","53731931","chr7","651487","651564","19","53080366"
"chr1","53732237","53732343","chr20","51382743","51382843","24","2349494"
"chr1","53743483","53743764","chr1","52494107","52494359","47","1249376"
"chr1","53757738","53757971","chr1","52510504","52510728","63","1247234"
"chr1","53758811","53758977","chr1","52511576","52511742","7","1247235"
"chr1","53772377","53772500","chr2","44878801","44878925","18","8893576"
"chr1","53793800","53793930","chr1","52563974","52564104","8","1229826"
"chr1","53794919","53795205","chr1","52565119","52565421","35","1229800"
"chr1","53809438","53809732","chr1","52586719","52587013","15","1222719"
"chr1","53822381","53822471","chr1","52600968","52601058","5","1221413"
"chr1","53852004","53852312","chr1","52628838","52629149","16","1223166"
"chr1","53870790","53871011","chrX","9102166","9102385","45","44768624"
"chr1","53885598","53885793","chr2","180858970","180859159","44","126973372"
"chr1","53886100","53886144","chr12","17593852","17593890","9","36292248"
"chr1","53911729","53912023","chr1","52681243","52681524","34","1230486"
"chr1","53938329","53938619","chr1","52708081","52708383","29","1230248"
"chr1","53999397","53999618","chr1","52769375","52769608","23","1230022"
"chr1","54025244","54025540","chr1","52796524","52796820","19","1228720"
"chr1","54026655","54026944","chr4","110888143","110888432","54","56861488"
"chr1","54030909","54031092","chr1","52799247","52799433","15","1231662"
"chr1","54035276","54035576","chr1","52805320","52805621","32","1229956"
"chr1","54044649","54044913","chr1","52813480","52813739","38","1231169"
"chr1","54081962","54082253","chr1","52850822","52851114","23","1231140"
"chr1","54124690","54124999","chr1","52895156","52895496","45","1229534"
"chr1","54131539","54131846","chr1","52901994","52902296","27","1229545"
"chr1","54139618","54139913","chr1","52910045","52910337","17","1229573"
"chr1","54183915","54184191","chr7","28923349","28923634","61","25260566"
"chr1","54225921","54226175","chr10","67002711","67002975","63","12776790"
"chr1","54237780","54238101","chr20","28618222","28618522","69","25619558"
"chr1","54307360","54307461","chr1","53070533","53070638","8","1236827"
"chr1","54316322","54316613","chr20","58214912","58215201","53","3898590"
"chr1","54350927","54351039","chr1","53115117","53115229","2","1235810"
"chr1","54393238","54393529","chr1","53158081","53158380","25","1235157"
"chr1","54441716","54442021","chr1","53206108","53206431","38","1235608"
"chr1","54460694","54460852","chr1","53225263","53225421","4","1235431"
"chr1","54466817","54467073","chr1","53231333","53231588","13","1235484"
"chr1","54483380","54483689","chr15","100257607","100257913","65","45774227"
"chr1","54524261","54524555","chr1","53289911","53290210","26","1234350"
"chr1","54563737","54563863","chr2","165531071","165531193","17","110967334"
"chr1","54575984","54576288","chr3","44659196","44659505","51","9916788"
"chr1","54585776","54585821","chr12","83930050","83930094","12","29344274"
"chr1","54596802","54597109","chr1","53364545","53364818","43","1232257"
"chr1","54614606","54614921","chr1","53382495","53382804","14","1232111"
"chr1","54616140","54616453","chr1","53384144","53384418","50","1231996"
"chr1","54621381","54621695","chr1","53389401","53389718","36","1231980"
"chr1","54646520","54646835","chr1","53414500","53414813","17","1232020"
"chr1","54648955","54649244","chr1","53417241","53417547","30","1231714"
"chr1","54652769","54653077","chr1","53421011","53421294","50","1231758"
"chr1","54658445","54658730","chr1","53425972","53426257","20","1232473"
"chr1","54659834","54660052","chr1","53427372","53427572","24","1232462"
"chr1","54664758","54665050","chr1","53433239","53433522","23","1231519"
"chr1","54665755","54666048","chr1","53434218","53434515","15","1231537"
"chr1","54680161","54680323","chr1","53482939","53483101","6","1197222"
"chr1","54719861","54720171","chr18","6870105","6870403","73","47849756"
"chr1","54738471","54738699","chr20","41332824","41333057","43","13405647"
"chr1","54743460","54743756","chr1","53546310","53546606","20","1197150"
"chr1","54746047","54746312","chr1","53549223","53549487","20","1196824"
"chr1","54747333","54747624","chr1","53550509","53550803","25","1196824"
"chr1","54766132","54766442","chr4","31451325","31451636","60","23314807"
"chr1","54768235","54768450","chr1","53572389","53572594","25","1195846"
"chr1","54788390","54788696","chr1","53594007","53594310","22","1194383"
"chr1","54790589","54790697","chr1","53596209","53596315","8","1194380"
"chr1","54795035","54795340","chr1","53602046","53602337","35","1192989"
"chr1","54809152","54809358","chr3","66577928","66578124","44","11768776"
"chr1","54809409","54809456","chr1","53615762","53615809","1","1193647"
"chr1","54809746","54809843","chr1","53616092","53616189","3","1193654"
"chr1","54841637","54841930","chr1","53649079","53649368","24","1192558"
"chr1","54841943","54842225","chr14","58287610","58287895","58","3445667"
"chr1","54844744","54845030","chr1","53652652","53652938","18","1192092"
"chr1","54850862","54851149","chr1","53658742","53659049","35","1192120"
"chr1","54873617","54873915","chr1","53679782","53680069","27","1193835"
"chr1","54897506","54897565","chr11","50179036","50179093","13","4718470"
"chr1","54897816","54897946","chr1","53704936","53705059","14","1192880"
"chr1","54900200","54900512","chr1","53707213","53707518","24","1192987"
"chr1","54914699","54915009","chr1","53723152","53723471","28","1191547"
"chr1","54932496","54932776","chr1","53741786","53742083","38","1190710"
"chr1","54948295","54948600","chr2","204421942","204422246","62","149473647"
"chr1","54952786","54953086","chr1","53762820","53763135","30","1189966"
"chr1","54962188","54962484","chr1","53772539","53772837","18","1189649"
"chr1","55018457","55018583","chr1","53826402","53826528","5","1192055"
"chr1","55064710","55064842","chr16","22194752","22194884","19","32869958"
"chr1","55066364","55066672","chr1","53872477","53872791","18","1193887"
"chr1","55068102","55068371","chr5","186597229","186597499","56","131529127"
"chr1","55101752","55102086","chr1","53912129","53912432","47","1189623"
"chr1","55138372","55138667","chr1","53949090","53949377","24","1189282"
"chr1","55152279","55152538","chr1","53962557","53962817","13","1189722"
"chr1","55183354","55183644","chr4","110888143","110888432","56","55704789"
"chr1","55201086","55201371","chr1","54014356","54014627","37","1186730"
"chr1","55214031","55214295","chr1","198157534","198157791","52","142943503"
"chr1","55227832","55228131","chr1","54042340","54042642","23","1185492"
"chr1","55247809","55248070","chr1","54062858","54063129","25","1184951"
"chr1","55256884","55257190","chr7","140588016","140588306","56","85331132"
"chr1","55260806","55260937","chr19","17205012","17205144","23","38055794"
"chr1","55287436","55287554","chr1","54105068","54105185","9","1182368"
"chr1","55304706","55304837","chr1","54125507","54125638","7","1179199"
"chr1","55307359","55307649","chr1","54128214","54128499","39","1179145"
"chr1","55318393","55318523","chr1","54133245","54133375","0","1185148"
"chr1","55347585","55347722","chr1","153250707","153250848","28","97903122"
"chr1","55347959","55348106","chr3","48621254","48621397","34","6726705"
"chr1","55348196","55348464","chr1","54165636","54165919","26","1182560"
"chr1","55357535","55357665","chr7","16781339","16781468","19","38576196"
"chr1","55388335","55388631","chr1","54205293","54205591","20","1183042"
"chr1","55394036","55394308","chr1","54212297","54212564","17","1181739"
"chr1","55418073","55418366","chr1","54234552","54234860","30","1183521"
"chr1","55424795","55425003","chr19","38929530","38929737","51","16495265"
"chr1","55451363","55451697","chr1","54266859","54267197","38","1184504"
"chr1","55455173","55455487","chrX","18616220","18616528","78","36838953"
"chr1","55491524","55491814","chr1","142286262","142286555","62","86794738"
"chr1","55499932","55499999","chr15","12931710","12931775","9","42568222"
"chr1","55501167","55501393","chr12","20476764","20476984","56","35024403"
"chr1","55512721","55513014","chr1","54321928","54322219","25","1190793"
"chr1","55517430","55517745","chr1","54326457","54326761","31","1190973"
"chr1","55520305","55520436","chr1","54331321","54331452","7","1188984"
"chr1","55527407","55527709","chr1","54336688","54336990","32","1190719"
"chr1","55541634","55541853","chr2","44350896","44351113","37","11190738"
"chr1","55555371","55555648","chr1","54363025","54363302","18","1192346"
"chr1","55573701","55573972","chr1","54380587","54380858","15","1193114"
"chr1","55577715","55577848","chr9","22648313","22648444","16","32929402"
"chr1","55585466","55585756","chr1","54392351","54392655","34","1193115"
"chr1","55592330","55592492","chr1","54400473","54400635","6","1191857"
"chr1","55593135","55593264","chr7","45689838","45689967","19","9903297"
"chr1","55611610","55611724","chr1","54421104","54421217","10","1190506"
"chr1","55618572","55618853","chr1","54428305","54428588","41","1190267"
"chr1","55648406","55648719","chr1","54457347","54457664","19","1191059"
"chr1","55654806","55655104","chr1","54463809","54464120","51","1190997"
"chr1","55684174","55684456","chr4","15016055","15016341","63","40668119"
"chr1","55697874","55698162","chr2","84913076","84913368","52","29215202"
"chr1","55704866","55705164","chr1","54511276","54511574","20","1193590"
"chr1","55709749","55710045","chr1","54516490","54516797","37","1193259"
"chr1","55713851","55714080","chr1","54520577","54520798","17","1193274"
"chr1","55734663","55734809","chr10","33407535","33407677","25","22327128"
"chr1","55735105","55735282","chr10","84269871","84270049","35","28534766"
"chr1","55742549","55742626","chr1","54548397","54548480","12","1194152"
"chr1","55754218","55754536","chr1","54559663","54560004","57","1194555"
"chr1","55774953","55775244","chr1","54569636","54569936","35","1205317"
"chr1","55863120","55863386","chr1","54649229","54649480","29","1213891"
"chr1","55874156","55874393","chr1","54660713","54660938","26","1213443"
"chr1","55936892","55937156","chrX","112023236","112023510","58","56086344"
"chr1","55947226","55947530","chr1","54727296","54727620","51","1219930"
"chr1","55999561","55999860","chr20","21314597","21314896","59","34684964"
"chr1","56006002","56006118","chr10","73131386","73131503","16","17125384"
"chr1","56091653","56091929","chr1","54873046","54873329","30","1218607"
"chr1","56108669","56108991","chr1","54891760","54892079","37","1216909"
"chr1","56117039","56117323","chr1","54900246","54900524","23","1216793"
"chr1","56141613","56141884","chr1","54928828","54929120","44","1212785"
"chr1","56153081","56153168","chr7","96741731","96741820","19","40588650"
"chr1","56155906","56156179","chr1","54942664","54942922","41","1213242"
"chr1","56164171","56164461","chr1","54951263","54951554","19","1212908"
"chr1","56218336","56218622","chr1","55008684","55008972","18","1209652"
"chr1","56391236","56391445","chr1","55194582","55194791","23","1196654"
"chr1","56481651","56481977","chr1","55275625","55275955","31","1206026"
"chr1","56524072","56524358","chr1","55320443","55320728","28","1203629"
"chr1","56613492","56613785","chr7","140588016","140588306","58","83974524"
"chr1","56794042","56794338","chrX","30673371","30673666","60","26120671"
"chr1","56881667","56881789","chr1","55555346","55555469","5","1326321"
"chr1","56933408","56933704","chr1","55618224","55618524","22","1315184"
"chr1","57027295","57027584","chr1","55717450","55717733","24","1309845"
"chr1","57128905","57129196","chr1","55809492","55809765","35","1319413"
"chr1","57240569","57240701","chr1","55930664","55930796","8","1309905"
"chr1","57259585","57259868","chr1","55946873","55947146","27","1312712"
"chr1","57282485","57282782","chr1","55967943","55968231","30","1314542"
"chr1","57327843","57327962","chr2","165531071","165531193","24","108203228"
"chr1","57331787","57332067","chr1","56018223","56018530","39","1313564"
"chr1","57411631","57411936","chr1","56100082","56100376","26","1311549"
"chr1","57415021","57415302","chr1","56103749","56104030","20","1311272"
"chr1","57424976","57425230","chr1","56113704","56113990","52","1311272"
"chr1","57614007","57614302","chr1","56294678","56294985","33","1319329"
"chr1","57629972","57630224","chr1","56310413","56310665","22","1319559"
"chr1","57657524","57657818","chr1","56340389","56340684","21","1317135"
"chr1","57934790","57935098","chr1","56613053","56613357","28","1321737"
"chr1","57969465","57969746","chr1","56648576","56648862","31","1320889"
"chr1","58010736","58011046","chr1","56688953","56689273","37","1321783"
"chr1","58047682","58047962","chr3","36540292","36540572","53","21507390"
"chr1","58165086","58165377","chr1","56839848","56840155","34","1325238"
"chr1","58424068","58424350","chr2","44788884","44789158","72","13635184"
"chr1","58444499","58444791","chr1","57120460","57120754","21","1324039"
"chr1","58538749","58539063","chr1","57211990","57212300","32","1326759"
"chr1","58567587","58567880","chr7","53545449","53545742","56","5022138"
"chr1","58612958","58613245","chr1","57280856","57281124","30","1332102"
"chr1","58639683","58639987","chr1","57308170","57308481","28","1331513"
"chr1","58691325","58691634","chr1","57363443","57363750","21","1327882"
"chr1","58722981","58723110","chr3","41303396","41303525","22","17419585"
"chr1","58756681","58756971","chr1","57427865","57428163","28","1328816"
"chr1","58763554","58763816","chr1","57435096","57435374","31","1328458"
"chr1","58832404","58832720","chr1","57505097","57505402","35","1327307"
"chr1","58884252","58884572","chr1","140354452","140354787","94","81470200"
"chr1","58893781","58894002","chr1","32000102","32000319","50","26893679"
"chr1","58937088","58937379","chr1","57612184","57612472","10","1324904"
"chr1","58954390","58954702","chr3","10339726","10340032","74","48614664"
"chr1","58964027","58964346","chr1","57639348","57639666","18","1324679"
"chr1","59076768","59077063","chr1","57756363","57756645","47","1320405"
"chr1","59163860","59164192","chr1","57842658","57842995","28","1321202"
"chr1","59170754","59171064","chr1","57849664","57849983","27","1321090"
"chr1","59212546","59212795","chr1","57898032","57898293","34","1314514"
"chr1","59333079","59333378","chr1","58029824","58030128","39","1303255"
"chr1","59397469","59397571","chr1","58094536","58094637","5","1302933"
"chr1","59467015","59467199","chr1","58156409","58156603","21","1310606"
"chr1","59577164","59577489","chr1","58274330","58274656","17","1302834"
"chr1","59614490","59614773","chr1","58310806","58311089","22","1303684"
"chr1","59646240","59646509","chr1","58342943","58343231","42","1303297"
"chr1","59652681","59652897","chr1","58348505","58348709","21","1304176"
"chr1","59714692","59714770","chr11","28073258","28073337","14","31641434"
"chr1","59714771","59714893","chr1","58410258","58410390","20","1304513"
"chr1","59714898","59714916","chr16","46281024","46281036","7","13433874"
"chr1","59715341","59715517","chr19","2428385","2428563","37","57286956"
"chr1","59803597","59803773","chr1","58496587","58496763","7","1307010"
"chr1","59803804","59803923","chr1","58496790","58496909","7","1307014"
"chr1","59876634","59876955","chr1","58572413","58572734","25","1304221"
"chr1","59904403","59904529","chr11","64012516","64012648","26","4108113"
"chr1","59917441","59917725","chr1","58612316","58612607","24","1305125"
"chr1","59990099","59990405","chr1","58687459","58687762","17","1302640"
"chr1","59994263","59994552","chr1","58691885","58692172","18","1302378"
"chr1","60013392","60013706","chr1","58711001","58711323","65","1302391"
"chr1","60200949","60201249","chr1","58905426","58905745","56","1295523"
"chr1","60209951","60210199","chr1","58914931","58915179","16","1295020"
"chr1","60419234","60419528","chr1","59112910","59113203","34","1306324"
"chr1","60459272","60459553","chr1","59155882","59156163","39","1303390"
"chr1","60550813","60551055","chr1","59241101","59241365","37","1309712"
"chr1","60611923","60612237","chr1","27401761","27402057","69","33210162"
"chr1","60697079","60697357","chr1","59387441","59387720","30","1309638"
"chr1","60770453","60770742","chr1","59461297","59461597","32","1309156"
"chr1","60821370","60821542","chr1","59515029","59515214","24","1306341"
"chr1","60879441","60879723","chr1","59579148","59579431","21","1300293"
"chr1","60955262","60955576","chr1","59659465","59659762","41","1295797"
"chr1","61008096","61008365","chr1","59707092","59707362","30","1301004"
"chr1","61023277","61023570","chr1","59722847","59723136","32","1300430"
"chr1","61094132","61094375","chr1","59794357","59794613","37","1299775"
"chr1","61269773","61270061","chr20","27216656","27216943","75","34053117"
"chr1","61599959","61600260","chr15","49822998","49823297","59","11776961"
"chr1","61707226","61707422","chr3","165944386","165944567","50","104237160"
"chr1","61707791","61707904","chr19","15110306","15110412","29","46597485"
"chr1","61830160","61830290","chr1","60441961","60442079","20","1388199"
"chr1","61862684","61863011","chr12","114200366","114200702","69","52337682"
"chr1","61933454","61933691","chr1","60540165","60540416","20","1393289"
"chr1","61987527","61987808","chr1","60593792","60594075","23","1393735"
"chr1","62105393","62105691","chr1","60717487","60717787","30","1387906"
"chr1","62136422","62136631","chr1","60748125","60748334","7","1388297"
"chr1","62172492","62172775","chr1","60784920","60785207","23","1387572"
"chr1","62186204","62186419","chr14","66911348","66911552","46","4725144"
"chr1","62206815","62207084","chr1","60819643","60819915","18","1387172"
"chr1","62220246","62220577","chr1","60833090","60833410","39","1387156"
"chr1","62328279","62328555","chr1","60941465","60941754","35","1386814"
"chr1","62329305","62329594","chr17","80429135","80429431","57","18099830"
"chr1","62419554","62419882","chr1","61028468","61028791","29","1391086"
"chr1","62420345","62420655","chr1","61029240","61029552","27","1391105"
"chr1","62425572","62425871","chr1","61034479","61034782","33","1391093"
"chr1","62449203","62449353","chr1","61058457","61058604","17","1390746"
"chr1","62449653","62449798","chr1","61058901","61059046","14","1390752"
"chr1","62458772","62459065","chr1","61068376","61068669","19","1390396"
"chr1","62460968","62461270","chr19","45495569","45495860","62","16965399"
"chr1","62467996","62468305","chrX","11916219","11916524","57","50551777"
"chr1","62490658","62490943","chr1","61100786","61101111","59","1389872"
"chr1","62543534","62543814","chr1","77920214","77920499","57","15376680"
"chr1","62604595","62604729","chr9","115052851","115052979","19","52448256"
"chr1","62620105","62620393","chr1","61233675","61233965","14","1386430"
"chr1","62683278","62683344","chr1","61298568","61298634","10","1384710"
"chr1","62731747","62732087","chr1","61349625","61349945","52","1382122"
"chr1","62754676","62754945","chr1","61373107","61373376","20","1381569"
"chr1","62773673","62773803","chr1","61392734","61392864","7","1380939"
"chr1","62776963","62777234","chr1","61396871","61397140","12","1380092"
"chr1","62777761","62778060","chr1","61397875","61398174","31","1379886"
"chr1","62805580","62805842","chr1","61421544","61421847","55","1384036"
"chr1","62806929","62807230","chr1","61422633","61422926","37","1384296"
"chr1","62808381","62808668","chr1","20767068","20767351","72","42041313"
"chr1","62811620","62811890","chr1","38379932","38380206","72","24431688"
"chr1","62815143","62815265","chr1","61431181","61431304","13","1383962"
"chr1","62818528","62818798","chr1","61434912","61435182","14","1383616"
"chr1","62823940","62824049","chr1","140328428","140328538","33","77504488"
"chr1","62824078","62824196","chr14","8294861","8294977","17","54529217"
"chr1","62830564","62830859","chr1","61447250","61447547","21","1383314"
"chr1","62833229","62833536","chr1","61449925","61450218","34","1383304"
"chr1","62834442","62834737","chr1","61451361","61451620","54","1383081"
"chr1","62836634","62836923","chr1","61453544","61453843","36","1383090"
"chr1","62842742","62842859","chr1","61459310","61459424","16","1383432"
"chr1","62846940","62847118","chr1","61463050","61463220","23","1383890"
"chr1","62847423","62847558","chr1","61463521","61463659","11","1383902"
"chr1","62867583","62867870","chr1","61484307","61484596","39","1383276"
"chr1","62876178","62876459","chr1","61498276","61498559","22","1377902"
"chr1","62884451","62884565","chr1","61506874","61506991","11","1377577"
"chr1","62893271","62893570","chr1","61515028","61515332","29","1378243"
"chr1","62897182","62897366","chr19","14237560","14237740","37","48659622"
"chr1","62912102","62912376","chr1","61533500","61533753","50","1378602"
"chr1","62959243","62959546","chr1","61578298","61578613","20","1380945"
"chr1","62981957","62982242","chr1","61600675","61600971","33","1381282"
"chr1","62987851","62988161","chr1","61606124","61606408","47","1381727"
"chr1","63028086","63028365","chr19","2507487","2507757","54","60520599"
"chr1","63039183","63039442","chr1","61650473","61650732","16","1388710"
"chr1","63043914","63044230","chr1","61655530","61655808","61","1388384"
"chr1","63052865","63053113","chr1","61665678","61665929","15","1387187"
"chr1","63074629","63074923","chr1","61687880","61688174","24","1386749"
"chr1","63084472","63084743","chr1","61696515","61696787","14","1387957"
"chr1","63098845","63099148","chr1","61711106","61711404","21","1387739"
"chr1","63113027","63113302","chr1","61724967","61725258","35","1388060"
"chr1","63133235","63133527","chr1","61746369","61746674","50","1386866"
"chr1","63148140","63148436","chr4","159090526","159090826","43","95942386"
"chr1","63156366","63156631","chr1","61768871","61769143","30","1387495"
"chr1","63164565","63164844","chr1","61783449","61783727","21","1381116"
"chr1","63172375","63172680","chr1","61790940","61791241","27","1381435"
"chr1","63185731","63185852","chr1","61804140","61804260","6","1381591"
"chr1","63215361","63215654","chr1","61834265","61834552","19","1381096"
"chr1","63235325","63235530","chr1","61853472","61853679","17","1381853"
"chr1","63237507","63237662","chr10","8082273","8082427","37","55155234"
"chr1","63244298","63244585","chr1","61862501","61862801","35","1381797"
"chr1","63257605","63257616","chr19","32160553","32160563","1","31097052"
"chr1","63257921","63258160","chr1","61875692","61875886","57","1382229"
"chr1","63267722","63267834","chr19","52862045","52862167","22","10405677"
"chr1","63268399","63268554","chr1","61884430","61884604","30","1383969"
"chr1","63269049","63269203","chr3","13044305","13044455","35","50224744"
"chr1","63269781","63269838","chr1","93575739","93575800","10","30305958"
"chr1","63269839","63269891","chr7","52416361","52416411","15","10853478"
"chr1","63336467","63336554","chr12","10551229","10551316","19","52785238"
"chr1","63380421","63380707","chr1","62007935","62008228","23","1372486"
"chr1","63405207","63405384","chr11","67501548","67501730","34","4096341"
"chr1","63405677","63405821","chr11","123324581","123324717","29","59918904"
"chr1","63414173","63414479","chr11","26758432","26758731","55","36655741"
"chr1","63428589","63428704","chr11","24015103","24015221","19","39413486"
"chr1","63437107","63437393","chr1","62066162","62066449","21","1370945"
"chr1","63461589","63461755","chr1","3136850","3137006","36","60324739"
"chr1","63463069","63463373","chr1","62091508","62091799","45","1371561"
"chr1","63475990","63476257","chr10","33233697","33233985","66","30242293"
"chr1","63485185","63485406","chr5","92576982","92577206","47","29091797"
"chr1","63486729","63486945","chr1","62114881","62115097","17","1371848"
"chr1","63495173","63495492","chr1","62123021","62123338","17","1372152"
"chr1","63499085","63499148","chr8","17300112","17300170","17","46198973"
"chr1","63501601","63501873","chr1","62130082","62130373","33","1371519"
"chr1","63545115","63545402","chr1","62174962","62175249","17","1370153"
"chr1","63547313","63547623","chr1","62177130","62177436","19","1370183"
"chr1","63558217","63558414","chr1","62187766","62187962","10","1370451"
"chr1","63558606","63558894","chr1","62188111","62188395","16","1370495"
"chr1","63563836","63564167","chr1","62193235","62193499","84","1370601"
"chr1","63565693","63565929","chr1","62195013","62195243","29","1370680"
"chr1","63566052","63566349","chr1","62195366","62195671","27","1370686"
"chr1","63571744","63572001","chr1","130906396","130906655","63","67334652"
"chr1","63573350","63573650","chr2","203900738","203901034","61","140327388"
"chr1","63577198","63577494","chr1","62204197","62204477","37","1373001"
"chr1","63586381","63586683","chr12","56478765","56479047","79","7107616"
"chr1","63606295","63606579","chr1","62238706","62238992","22","1367589"
"chr1","63614101","63614402","chrX","8992375","8992673","58","54621726"
"chr1","63615815","63616097","chr1","62249009","62249294","22","1366806"
"chr1","63627288","63627508","chr1","62260780","62260998","16","1366508"
"chr1","63647189","63647352","chr2","54876172","54876343","46","8771017"
"chr1","63652856","63653119","chr1","62279535","62279817","32","1373321"
"chr1","63668687","63668984","chr1","62295717","62296021","29","1372970"
"chr1","63708853","63708964","chr2","43752839","43752949","17","19956014"
"chr1","63722932","63723037","chr16","935954","936064","25","62786978"
"chr1","63748059","63748328","chr7","139613893","139614162","56","75865834"
"chr1","63803905","63804195","chr3","13411522","13411814","56","50392383"
"chr1","63848815","63849121","chr1","62460359","62460664","22","1388456"
"chr1","63865649","63865943","chr1","62477521","62477814","27","1388128"
"chr1","63881121","63881410","chrX","65751654","65751935","57","1870533"
"chr1","63911323","63911602","chr1","62523895","62524174","30","1387428"
"chr1","63925696","63925986","chr1","62538929","62539220","22","1386767"
"chr1","63949299","63949445","chr1","62562591","62562737","4","1386708"
"chr1","63992214","63992485","chr1","62606788","62607069","30","1385426"
"chr1","63992915","63993210","chr1","62607497","62607792","17","1385418"
"chr1","64092516","64092812","chr1","62709359","62709655","25","1383157"
"chr1","64106368","64106710","chr1","62723000","62723332","40","1383368"
"chr1","64161314","64161622","chr1","62778671","62778966","39","1382643"
"chr1","64282595","64282886","chr3","22548724","22549012","25","41733871"
"chr1","64332880","64333182","chr1","62955181","62955483","34","1377699"
"chr1","64340662","64340881","chr1","62964035","62964254","22","1376627"
"chr1","64380092","64380388","chr1","63004936","63005221","25","1375156"
"chr1","64382525","64382825","chr1","63007079","63007383","26","1375446"
"chr1","64409073","64409367","chr1","63033045","63033339","18","1376028"
"chr1","64475708","64475980","chr1","197740813","197741090","56","133265105"
"chr1","64492659","64492947","chr1","63107844","63108134","19","1384815"
"chr1","64511931","64512222","chr17","80429135","80429431","57","15917204"
"chr1","64531720","64531986","chr2","61559433","61559703","73","2972287"
"chr1","64533258","64533457","chr1","63147972","63148174","10","1385286"
"chr1","64533645","64533947","chr5","183301573","183301881","64","118767928"
"chr1","64538596","64538879","chr3","155461604","155461892","56","90923008"
"chr1","64538921","64539175","chr3","36424130","36424381","58","28114791"
"chr1","64558536","64558815","chr1","63167834","63168127","27","1390702"
"chr1","64577299","64577591","chr3","37470994","37471285","63","27106305"
"chr1","64621120","64621418","chr1","63226855","63227140","41","1394265"
"chr1","64640907","64641178","chr1","14264801","14265072","65","50376106"
"chr1","64649664","64649954","chr1","63253303","63253594","22","1396361"
"chr1","64720245","64720545","chr1","63325500","63325799","22","1394745"
"chr1","64752280","64752512","chr1","63357799","63358032","19","1394481"
"chr1","64785994","64786280","chr15","30689974","30690262","68","34096020"
"chr1","64816419","64816726","chr1","63422987","63423296","26","1393432"
"chr1","64826590","64826882","chr1","63432865","63433149","22","1393725"
"chr1","64870085","64870385","chr1","63476357","63476658","26","1393728"
"chr1","64887915","64888215","chr2","134217641","134217927","64","69329726"
"chr1","64976593","64976918","chr1","24477067","24477380","76","40499526"
"chr1","65095508","65095777","chr2","68173712","68173989","56","3078204"
"chr1","65146112","65146400","chr2","84913076","84913368","52","19766964"
"chr1","65164974","65165280","chr4","103730788","103731088","58","38565814"
"chr1","65260403","65260650","chr1","63792392","63792645","19","1468011"
"chr1","65276742","65277031","chr3","155242835","155243121","56","89966093"
"chr1","65351586","65351879","chr1","63898343","63898632","24","1453243"
"chr1","65354657","65354962","chr1","63901451","63901764","32","1453206"
"chr1","65375947","65376106","chr3","124202196","124202354","32","58826249"
"chr1","65376423","65376518","chr3","50263754","50263847","19","15112669"
"chr1","65381865","65382187","chr1","63928111","63928423","36","1453754"
"chr1","65390578","65390877","chr1","63936860","63937168","25","1453718"
"chr1","65458128","65458425","chr1","64001847","64002145","28","1456281"
"chr1","65476523","65476812","chr1","64020861","64021156","21","1455662"
"chr1","65478855","65479163","chr1","131594158","131594456","66","66115303"
"chr1","65502447","65502734","chr1","64040788","64041088","27","1461659"
"chr1","65516782","65517069","chr1","64054194","64054477","27","1462588"
"chr1","65518478","65518768","chr1","64055949","64056261","68","1462529"
"chr1","65524937","65525136","chr1","64062195","64062403","24","1462742"
"chr1","65580896","65581031","chr1","64117641","64117763","24","1463255"
"chr1","65581318","65581514","chr1","64118048","64118232","25","1463270"
"chr1","65588665","65588894","chr1","64126463","64126695","27","1462202"
"chr1","65615263","65615536","chr9","84536946","84537213","63","18921683"
"chr1","65682820","65682951","chr1","205327020","205327148","22","139644200"
"chr1","65682978","65683128","chr7","151364365","151364517","32","85681387"
"chr1","65692010","65692327","chr1","64228202","64228523","26","1463808"
"chr1","65693575","65693750","chr1","64229772","64229947","6","1463803"
"chr1","65702754","65703053","chr1","64237257","64237569","37","1465497"
"chr1","65768439","65768726","chr1","30761063","30761352","50","35007376"
"chr1","65775664","65775977","chrX","16069191","16069490","74","49706473"
"chr1","65837694","65837845","chr10","77502118","77502274","46","11664424"
"chr1","65841737","65842057","chr1","64379513","64379812","42","1462224"
"chr1","65844865","65845171","chr1","64382633","64382939","17","1462232"
"chr1","65858284","65858534","chr1","64396337","64396587","15","1461947"
"chr1","65859746","65860034","chr9","98661850","98662144","64","32802104"
"chr1","65865851","65866152","chr1","64404818","64405126","32","1461033"
"chr1","65890727","65890958","chr1","64435090","64435326","25","1455637"
"chr1","65902216","65902437","chr1","23942951","23943176","42","41959265"
"chr1","65924567","65924842","chr1","64469143","64469437","39","1455424"
"chr1","65979581","65979855","chr1","64522903","64523179","20","1456678"
"chr1","66098597","66098892","chr1","64639850","64640146","21","1458747"
"chr1","66117030","66117343","chr1","64660705","64660979","57","1456325"
"chr1","66134027","66134333","chr1","64679309","64679610","15","1454718"
"chr1","66146783","66147089","chr1","64695095","64695391","40","1451688"
"chr1","66148803","66149096","chr12","21580706","21580995","76","44568097"
"chr1","66161610","66161902","chr1","64708760","64709048","42","1452850"
"chr1","66167572","66167881","chr3","43321649","43321949","54","22845923"
"chr1","66173225","66173455","chr16","72431500","72431726","52","6258275"
"chr1","66173928","66174224","chrX","101668164","101668460","51","35494236"
"chr1","66175575","66175696","chr17","15089597","15089719","15","51085978"
"chr1","66185692","66185997","chr1","64735897","64736203","28","1449795"
"chr1","66213853","66214134","chr1","64766882","64767163","40","1446971"
"chr1","66214184","66214476","chr1","64767253","64767527","43","1446931"
"chr1","66219178","66219485","chr1","64771929","64772208","54","1447249"
"chr1","66226298","66226593","chr1","64780111","64780409","15","1446187"
"chr1","66230792","66231041","chr4","115359598","115359845","63","49128806"
"chr1","66233836","66234112","chr16","20692707","20692988","65","45541129"
"chr1","66235932","66236105","chr1","64791783","64791962","12","1444149"
"chr1","66236399","66236572","chr1","64792256","64792405","45","1444143"
"chr1","66241856","66242182","chr1","64797802","64798105","63","1444054"
"chr1","66250005","66250300","chr1","64806366","64806661","14","1443639"
"chr1","66265707","66265983","chr3","48105482","48105749","51","18160225"
"chr1","66266079","66266366","chr1","64831362","64831624","45","1434717"
"chr1","66269994","66270304","chr1","64835577","64835877","23","1434417"
"chr1","66286725","66286837","chr9","52551721","52551839","26","13735004"
"chr1","66292843","66293144","chr1","10295692","10295997","28","55997151"
"chr1","66294723","66295032","chrX","41541015","41541312","65","24753708"
"chr1","66295944","66296229","chr1","10298840","10299142","37","55997104"
"chr1","66297305","66297591","chr1","10300214","10300493","18","55997091"
"chr1","66301866","66302154","chr1","10304843","10305129","20","55997023"
"chr1","66303800","66303925","chr1","10306869","10306990","14","55996931"
"chr1","66304227","66304533","chr1","10307319","10307627","29","55996908"
"chr1","66317198","66317499","chr1","64934827","64935128","18","1382371"
"chr1","66337629","66337923","chr7","18514581","18514866","63","47823048"
"chr1","66346181","66346275","chr1","64962926","64963020","8","1383255"
"chr1","66351711","66352034","chr1","64968617","64968943","26","1383094"
"chr1","66364315","66364591","chr1","64982098","64982383","26","1382217"
"chr1","66372028","66372186","chr1","64990576","64990704","34","1381452"
"chr1","66372221","66372337","chr1","64990739","64990855","6","1381482"
"chr1","66397729","66398025","chr1","65015478","65015777","22","1382251"
"chr1","66407995","66408116","chr1","53704936","53705059","16","12703059"
"chr1","66421458","66421755","chr1","65038432","65038729","22","1383026"
"chr1","66456066","66456368","chr1","65073080","65073381","26","1382986"
"chr1","66458468","66458789","chr1","65076245","65076567","42","1382223"
"chr1","66562914","66563201","chr1","65177086","65177391","35","1385828"
"chr1","66573410","66573685","chr1","65187677","65187954","20","1385733"
"chr1","66654170","66654329","chr19","13344328","13344484","39","53309842"
"chr1","66654638","66654768","chr1","164351347","164351475","24","97696709"
"chr1","66669875","66670147","chr1","65282099","65282371","16","1387776"
"chr1","66827964","66828280","chr1","65427031","65427349","28","1400933"
"chr1","66839008","66839296","chr1","65438937","65439246","39","1400071"
"chr1","66839716","66839862","chr1","65439667","65439813","8","1400049"
"chr1","66989924","66990019","chr17","19984851","19984943","23","47005073"
"chr1","67138285","67138389","chr19","45367529","45367633","21","21770756"
"chr1","67138764","67138796","chr3","46942577","46942607","7","20196187"
"chr1","67305983","67306287","chr1","65949826","65950118","35","1356157"
"chr1","67419901","67420174","chr1","66051077","66051382","46","1368824"
"chr1","67421252","67421477","chr1","66052448","66052658","19","1368804"
"chr1","67449766","67450064","chr7","144503285","144503589","60","77053519"
"chr1","67523507","67523821","chr1","66156563","66156878","23","1366944"
"chr1","67581886","67582003","chr1","66222834","66222951","7","1359052"
"chr1","67791660","67791951","chr11","6437506","6437802","53","61354154"
"chr1","67794398","67794712","chr1","66428412","66428726","26","1365986"
"chr1","67808616","67808900","chr1","66442780","66443080","39","1365836"
"chr1","67855219","67855509","chr1","66489798","66490089","24","1365421"
"chr1","67887923","67888195","chr1","66527158","66527441","35","1360765"
"chr1","67933695","67933964","chr1","66565687","66565978","39","1368008"
"chr1","67949871","67950002","chr1","66580563","66580689","13","1369308"
"chr1","67951134","67951438","chr1","66581837","66582139","24","1369297"
"chr1","67964325","67964457","chr1","66592520","66592650","20","1371805"
"chr1","67964771","67964957","chr1","66592971","66593146","21","1371800"
"chr1","68006971","68007253","chr4","128903519","128903790","63","60896548"
"chr1","68035863","68035937","chr1","66663122","66663196","2","1372741"
"chr1","68069180","68069488","chr1","66694641","66694939","40","1374539"
"chr1","68080350","68080618","chr1","66705659","66705940","37","1374691"
"chr1","68083339","68083610","chr1","66708992","66709265","25","1374347"
"chr1","68124618","68124900","chr1","66750853","66751153","33","1373765"
"chr1","68131542","68131829","chr1","66757880","66758156","34","1373662"
"chr1","68134300","68134596","chr1","66760539","66760866","48","1373761"
"chr1","68159018","68159308","chr1","66787633","66787925","24","1371385"
"chr1","68177744","68178089","chr6","67437506","67437829","83","740238"
"chr1","68189494","68189780","chr1","66818348","66818633","28","1371146"
"chr1","68212971","68213147","chr3","49992810","49992973","44","18220161"
"chr1","68213174","68213296","chr11","114029774","114029891","24","45816600"
"chr1","68256524","68256826","chr5","86428601","86428887","74","18172077"
"chr1","68259492","68259570","chr1","66906470","66906548","3","1353022"
"chr1","68263404","68263681","chr1","188619656","188619927","55","120356252"
"chr1","68267051","68267181","chr9","63516362","63516495","29","4750689"
"chr1","68268824","68269090","chr1","66916137","66916399","31","1352687"
"chr1","68323342","68323641","chr1","66962236","66962536","19","1361106"
"chr1","68337552","68337854","chr1","66977351","66977686","54","1360201"
"chr1","68355064","68355352","chr1","66994366","66994658","24","1360698"
"chr1","68382299","68382590","chr1","67019962","67020252","14","1362337"
"chr1","68396543","68396860","chr1","67034308","67034619","31","1362235"
"chr1","68423182","68423474","chr1","67060884","67061188","32","1362298"
"chr1","68433767","68433881","chr8","142934040","142934158","16","74500273"
"chr1","68466225","68466530","chr1","67243290","67243600","29","1222935"
"chr1","68514481","68514750","chr1","67195223","67195495","34","1319258"
"chr1","68557105","68557272","chr1","67151291","67151455","10","1405814"
"chr1","68687407","68687695","chr1","67258570","67258866","16","1428837"
"chr1","68733027","68733339","chr1","67306558","67306838","49","1426469"
"chr1","68748974","68749143","chr15","68278160","68278316","38","470814"
"chr1","68749602","68749857","chr1","67322734","67322991","18","1426868"
"chr1","68756639","68756915","chr1","67329451","67329712","31","1427188"
"chr1","68764822","68765142","chr1","67337682","67337974","53","1427140"
"chr1","68772571","68772840","chr1","67345461","67345737","22","1427110"
"chr1","68783485","68783778","chr1","67356371","67356656","27","1427114"
"chr1","68785097","68785362","chr14","75414251","75414521","73","6629154"
"chr1","68804346","68804514","chr1","67377827","67377995","8","1426519"
"chr1","68837639","68837759","chr8","94798198","94798319","18","25960559"
"chr1","68845673","68845780","chr18","14524158","14524259","39","54321515"
"chr1","68864452","68864567","chr1","67441995","67442110","9","1422457"
"chr1","68876720","68877019","chr1","67453778","67454076","22","1422942"
"chr1","68983621","68983938","chr1","67560159","67560464","31","1423462"
"chr1","69011467","69011775","chr16","71054388","71054696","54","2042921"
"chr1","69048611","69048833","chr1","67625904","67626125","15","1422707"
"chr1","69059505","69059662","chr1","67637405","67637562","11","1422100"
"chr1","69059957","69060094","chr1","67637888","67638021","11","1422069"
"chr1","69077646","69077935","chr1","67655424","67655711","26","1422222"
"chr1","69119419","69119501","chr1","67701609","67701692","8","1417810"
"chr1","69247724","69248013","chr17","20024832","20025121","62","49222892"
"chr1","69320291","69320592","chr1","67903923","67904224","21","1416368"
"chr1","69444453","69444768","chr1","68028128","68028438","25","1416325"
"chr1","69459174","69459500","chr1","68042632","68042945","40","1416542"
"chr1","69479403","69479564","chr8","129349349","129349514","33","59869946"
"chr1","69481251","69481570","chr1","68063935","68064224","54","1417316"
"chr1","69511417","69511544","chr1","68093964","68094094","18","1417453"
"chr1","69511874","69512035","chr1","68094413","68094591","30","1417461"
"chr1","69512350","69512363","chr8","9819296","9819310","1","59693054"
"chr1","69552837","69552929","chr1","68132883","68132977","6","1419954"
"chr1","69565725","69565842","chr1","68146105","68146220","8","1419620"
"chr1","69575645","69575755","chr4","35164599","35164708","20","34411046"
"chr1","69576116","69576154","chr3","44339435","44339460","15","25236681"
"chr1","69576456","69576634","chr1","35417022","35417192","43","34159434"
"chr1","69654703","69655002","chr1","68235357","68235652","21","1419346"
"chr1","69661086","69661369","chr1","68241723","68242015","25","1419363"
"chr1","69674319","69674626","chr1","68255027","68255299","56","1419292"
"chr1","69839163","69839401","chr1","68432275","68432502","38","1406888"
"chr1","69859751","69859932","chr11","177147","177326","47","69682604"
"chr1","70043556","70043865","chr1","68622478","68622785","34","1421078"
"chr1","70089249","70089569","chr1","68664138","68664452","23","1425111"
"chr1","70095333","70095632","chr1","68667507","68667808","29","1427826"
"chr1","70104870","70105190","chr1","68676169","68676485","46","1428701"
"chr1","70107759","70107979","chr3","157271791","157272008","47","87164032"
"chr1","70205055","70205260","chr1","68774179","68774386","14","1430876"
"chr1","70226480","70226764","chr1","68796117","68796402","12","1430363"
"chr1","70401003","70401288","chr1","11144452","11144735","63","59256551"
"chr1","70411024","70411307","chr1","68974710","68975020","45","1436314"
"chr1","70527991","70528290","chr1","69091436","69091758","38","1436555"
"chr1","70584876","70585153","chr1","69143213","69143489","15","1441663"
"chr1","70655266","70655569","chr1","69216867","69217169","21","1438399"
"chr1","70726876","70727037","chr1","69252319","69252484","18","1474557"
"chr1","70733875","70734012","chr1","85928276","85928412","23","15194401"
"chr1","70801614","70801881","chr1","69328896","69329169","27","1472718"
"chr1","70989069","70989385","chr1","69532419","69532736","31","1456650"
"chr1","70995502","70995632","chr16","43488947","43489078","33","27506555"
"chr1","71069749","71070027","chr1","69615072","69615354","19","1454677"
"chr1","71078960","71079246","chr1","69624401","69624687","17","1454559"
"chr1","71106390","71106699","chr1","69648191","69648500","25","1458199"
"chr1","71287240","71287455","chr1","69826194","69826386","33","1461046"
"chr1","71307603","71307859","chr4","128899381","128899647","71","57591778"
"chr1","71309383","71309687","chr1","69847904","69848205","33","1461479"
"chr1","71331649","71331953","chr1","69868759","69869065","17","1462890"
"chr1","71335916","71336211","chr1","69873019","69873294","51","1462897"
"chr1","71357909","71358200","chr12","84883590","84883883","46","13525681"
"chr1","71387458","71387771","chr1","69924802","69925113","27","1462656"
"chr1","71408409","71408701","chr1","69946660","69946953","19","1461749"
"chr1","71409279","71409523","chr1","69947558","69947799","12","1461721"
"chr1","71417967","71418269","chr1","69956426","69956723","41","1461541"
"chr1","71419558","71419843","chr3","123351694","123351976","54","51932136"
"chr1","71421577","71421867","chr1","69962111","69962392","36","1459466"
"chr1","71423889","71424168","chr1","69963812","69964086","39","1460077"
"chr1","71428715","71429000","chr1","69968624","69968901","25","1460091"
"chr1","71433758","71434043","chr1","69973736","69974026","26","1460022"
"chr1","71459767","71460072","chr10","10625974","10626278","58","60833793"
"chr1","71462993","71463216","chr4","32951467","32951682","47","38511526"
"chr1","71501353","71501654","chr1","116556867","116557170","57","45055514"
"chr1","71510338","71510660","chr4","15096791","15097094","67","56413547"
"chr1","71514415","71514627","chr1","70051518","70051727","14","1462897"
"chr1","71527850","71527975","chr19","50326892","50327017","17","21200958"
"chr1","71553017","71553311","chr13","24481774","24482062","59","47071243"
"chr1","71558822","71559107","chr1","70093634","70093946","42","1465188"
"chr1","71576617","71576884","chr1","70113465","70113749","36","1463152"
"chr1","71611652","71611946","chr1","70212036","70212329","30","1399616"
"chr1","71613695","71613981","chr1","70213751","70214042","21","1399944"
"chr1","71617344","71617638","chr1","70217512","70217814","28","1399832"
"chr1","71633534","71633820","chr1","70233325","70233612","23","1400209"
"chr1","71641705","71641997","chr1","70240677","70240962","56","1401028"
"chr1","71663989","71664188","chr9","22982404","22982594","43","48681585"
"chr1","71744689","71744963","chr1","70354952","70355243","36","1389737"
"chr1","71763392","71763698","chr1","70375605","70375890","46","1387787"
"chr1","71869070","71869331","chr1","70521951","70522229","30","1347119"
"chr1","71894713","71894808","chr1","70547587","70547682","6","1347126"
"chr1","71905402","71905519","chr3","178929122","178929237","18","107023720"
"chr1","71908303","71908613","chr1","70561686","70562003","24","1346617"
"chr1","71922744","71923074","chr9","54746154","54746466","76","17176590"
"chr1","71969452","71969730","chr1","70629838","70630116","29","1339614"
"chr1","72190997","72191266","chr1","70852480","70852756","20","1338517"
"chr1","72208502","72208797","chr1","70872607","70872906","30","1335895"
"chr1","72222439","72222676","chr1","70886814","70887054","19","1335625"
"chr1","72264693","72264823","chr1","155846166","155846296","23","83581473"
"chr1","72274088","72274371","chr1","70944548","70944821","30","1329540"
"chr1","72323034","72323329","chr1","70987723","70988025","31","1335311"
"chr1","72377763","72378059","chr1","71040963","71041241","39","1336800"
"chr1","72384535","72384822","chr1","71047600","71047887","25","1336935"
"chr1","72451464","72451756","chr1","71108365","71108661","27","1343099"
"chr1","72629085","72629359","chr1","71302150","71302423","28","1326935"
"chr1","72663302","72663425","chr1","71335448","71335565","13","1327854"
"chr1","73054366","73054660","chr1","71733804","71734097","32","1320562"
"chr1","73058726","73059033","chr1","71738117","71738427","35","1320609"
"chr1","73126202","73126451","chr1","71804588","71804843","36","1321614"
"chr1","73129994","73130288","chr1","211353988","211354282","66","138223994"
"chr1","73147611","73147865","chr12","2733940","2734165","69","70413671"
"chr1","73186101","73186219","chr1","71867047","71867166","12","1319054"
"chr1","73249741","73249998","chr1","71929747","71930005","23","1319994"
"chr1","73288243","73288507","chr1","155141171","155141450","66","81852928"
"chr1","73357809","73358101","chr1","72041396","72041701","32","1316413"
"chr1","73477549","73477855","chr1","72162677","72162966","42","1314872"
"chr1","73565017","73565321","chr1","72256313","72256615","27","1308704"
"chr1","73609575","73609772","chr1","166776461","166776633","62","93166886"
"chr1","73609815","73609938","chr1","142193838","142193958","21","68584023"
"chr1","73703949","73704147","chr16","74866256","74866452","41","1162307"
"chr1","73736280","73736564","chr1","72444491","72444773","28","1291789"
"chr1","73822758","73823070","chr10","15068395","15068698","75","58754363"
"chr1","73874942","73875247","chr1","72588558","72588861","27","1286384"
"chr1","73911467","73911759","chr1","72630855","72631149","37","1280612"
"chr1","73977310","73977619","chr18","1158360","1158673","79","72818950"
"chr1","74325453","74325631","chr1","73038989","73039181","38","1286464"
"chr1","74385876","74386181","chr1","73092391","73092710","41","1293485"
"chr1","74615322","74615601","chr19","52174303","52174578","64","22441019"
"chr1","74690029","74690251","chr3","93515202","93515421","54","18825173"
"chr1","74886710","74886866","chr1","73626492","73626648","11","1260218"
"chr1","74895161","74895325","chr20","4062761","4062927","37","70832400"
"chr1","74895623","74895758","chr1","155846166","155846296","26","80950543"
"chr1","74945000","74945282","chr3","167477786","167478063","69","92532786"
"chr1","75020475","75020612","chr13","56057132","56057269","29","18963343"
"chr1","75023545","75023831","chr1","73758051","73758346","29","1265494"
"chr1","75058534","75058728","chr1","73795824","73796010","18","1262710"
"chr1","75072255","75072539","chr1","73809268","73809551","21","1262987"
"chr1","75076121","75076417","chr1","73813135","73813402","43","1262986"
"chr1","75078782","75079080","chr1","73815895","73816195","21","1262887"
"chr1","75151368","75151635","chr1","73887170","73887480","59","1264198"
"chr1","75295696","75295995","chr19","31374338","31374621","71","43921358"
"chr1","75344027","75344148","chr1","74088715","74088826","19","1255312"
"chr1","75374890","75375160","chr1","74116410","74116681","24","1258480"
"chr1","75568778","75569058","chr1","74313430","74313703","32","1255348"
"chr1","75821079","75821346","chr1","74613373","74613645","20","1207706"
"chr1","75827950","75828199","chr1","74620239","74620491","22","1207711"
"chr1","76043149","76043364","chr1","36889236","36889448","49","39153913"
"chr1","76059264","76059492","chr1","74860013","74860242","14","1199251"
"chr1","76145008","76145282","chr1","74921793","74922074","30","1223215"
"chr1","76145602","76145881","chr1","74922394","74922670","25","1223208"
"chr1","76301282","76301573","chr1","75092654","75092945","26","1208628"
"chr1","76345901","76346180","chr1","75130836","75131115","14","1215065"
"chr1","76406409","76406715","chr3","85489556","85489854","59","9083147"
"chr1","76437519","76437824","chr1","75220056","75220360","14","1217463"
"chr1","76504513","76504782","chr1","75283121","75283392","27","1221392"
"chr1","76513448","76513710","chr1","75291002","75291298","61","1222446"
"chr1","76555586","76555716","chr1","75337715","75337845","6","1217871"
"chr1","76564309","76564603","chr1","75350870","75351184","35","1213439"
"chr1","76580751","76581037","chr1","75361235","75361519","21","1219516"
"chr1","76702692","76702971","chr1","75479106","75479357","44","1223586"
"chr1","76767759","76767905","chr1","75545234","75545382","11","1222525"
"chr1","76815523","76815813","chr1","75591911","75592225","51","1223612"
"chr1","76838726","76838954","chr1","75610703","75610936","25","1228023"
"chr1","76897735","76898052","chr3","175789427","175789740","61","98891692"
"chr1","76925903","76926019","chr1","75720591","75720706","10","1205312"
"chr1","76926798","76927088","chr1","75721475","75721789","54","1205323"
"chr1","76939298","76939548","chr1","75731036","75731291","23","1208262"
"chr1","76948282","76948405","chr6","169525376","169525499","16","92577094"
"chr1","76960463","76960730","chr1","75753828","75754110","30","1206635"
"chr1","76963527","76963784","chr1","75756886","75757146","17","1206641"
"chr1","76963785","76963933","chr12","62178385","62178532","30","14785400"
"chr1","76971789","76971847","chr7","164531158","164531221","13","87559369"
"chr1","76972862","76972936","chr7","151554870","151554945","15","74582008"
"chr1","76982681","76982969","chr1","75774305","75774584","30","1208376"
"chr1","76985542","76985845","chr1","75777475","75777777","24","1208067"
"chr1","76993595","76993885","chr1","75785748","75786045","39","1207847"
"chr1","76995447","76995740","chr1","75787603","75787902","30","1207844"
"chr1","76998659","76998946","chr1","75790829","75791118","19","1207830"
"chr1","77011240","77011529","chr1","75802491","75802777","26","1208749"
"chr1","77063926","77064208","chr20","28224004","28224291","62","48839922"
"chr1","77068091","77068406","chr1","75857567","75857878","38","1210524"
"chr1","77072182","77072405","chr1","75861654","75861859","37","1210528"
"chr1","77136624","77136809","chr1","164081832","164082010","53","86945208"
"chr1","77356512","77356808","chr1","76067736","76068021","28","1288776"
"chr1","77359197","77359323","chr1","76070414","76070528","23","1288783"
"chr1","77440542","77440828","chr1","76154453","76154731","33","1286089"
"chr1","77499181","77499475","chr1","76211787","76212081","18","1287394"
"chr1","77685127","77685408","chr1","76424802","76425090","30","1260325"
"chr1","77697987","77698288","chr1","76438502","76438804","19","1259485"
"chr1","78088841","78089137","chr1","76835557","76835829","38","1253284"
"chr1","78275218","78275524","chr6","120264734","120265027","78","41989516"
"chr1","78298640","78298921","chr1","77053515","77053819","46","1245125"
"chr1","78381687","78381971","chr4","71006054","71006340","70","7375633"
"chr1","78449146","78449280","chr1","77200487","77200621","9","1248659"
"chr1","78449586","78449718","chr1","77200934","77201067","6","1248652"
"chr1","78470235","78470539","chr1","77222127","77222428","23","1248108"
"chr1","78510648","78510939","chr1","77254068","77254357","21","1256580"
"chr1","78546474","78546755","chr1","77282582","77282871","42","1263892"
"chr1","78560339","78560617","chr1","77296495","77296775","19","1263844"
"chr1","78569170","78569287","chr11","70573457","70573574","15","7995713"
"chr1","78597474","78597717","chr1","77337432","77337677","12","1260042"
"chr1","78604628","78604870","chr10","25956813","25957066","65","52647815"
"chr1","78629767","78630063","chr1","77371529","77371830","35","1258238"
"chr1","78653764","78654060","chr1","77395918","77396214","19","1257846"
"chr1","78684226","78684522","chr1","77430985","77431270","30","1253241"
"chr1","78694740","78694984","chr1","77441102","77441343","21","1253638"
"chr1","78709331","78709446","chr1","77454530","77454645","10","1254801"
"chr1","78728035","78728245","chr1","77473856","77474066","11","1254179"
"chr1","78778665","78778970","chr14","38359947","38360256","62","40418718"
"chr1","78819324","78819647","chr1","77577959","77578276","29","1241365"
"chr1","78839748","78840039","chr1","77597413","77597710","17","1242335"
"chr1","78856659","78856955","chr1","77614240","77614545","25","1242419"
"chr1","78892786","78893083","chr1","77650138","77650436","25","1242648"
"chr1","78893319","78893644","chr1","77650671","77651005","35","1242648"
"chr1","78895236","78895517","chr1","77652901","77653182","13","1242335"
"chr1","78907786","78908065","chr1","77665736","77666043","48","1242050"
"chr1","78925089","78925348","chr1","77683035","77683278","35","1242054"
"chr1","78951797","78952079","chr1","77710328","77710605","24","1241469"
"chr1","78954810","78955103","chr1","77713378","77713668","28","1241432"
"chr1","78982763","78983043","chr1","77744196","77744495","49","1238567"
"chr1","78991863","78992163","chr1","77753531","77753833","13","1238332"
"chr1","78998492","78998707","chr1","77759483","77759712","30","1239009"
"chr1","79003693","79003953","chr18","6148992","6149254","77","72854701"
"chr1","79016683","79016991","chr1","77777808","77778102","33","1238875"
"chr1","79019352","79019637","chr1","77780388","77780691","39","1238964"
"chr1","79021079","79021203","chr10","30386760","30386884","24","48634319"
"chr1","79029474","79029769","chr1","77790974","77791278","17","1238500"
"chr1","79032013","79032312","chr1","77794131","77794430","23","1237882"
"chr1","79047651","79047948","chr1","77811002","77811300","25","1236649"
"chr1","79056572","79056861","chr7","56241135","56241409","62","22815437"
"chr1","79058507","79058636","chr1","77824125","77824255","7","1234382"
"chr1","79068243","79068549","chr1","10811316","10811617","63","68256927"
"chr1","79082734","79082865","chr1","77840619","77840749","7","1242115"
"chr1","79088889","79089181","chr1","77847368","77847648","33","1241521"
"chr1","79095366","79095670","chr11","46309026","46309328","62","32786340"
"chr1","79107044","79107341","chr3","43983145","43983438","65","35123899"
"chr1","79111476","79111784","chr1","77861979","77862285","26","1249497"
"chr1","79115958","79116217","chr1","77866439","77866698","18","1249519"
"chr1","79116432","79116610","chr1","77866917","77867107","20","1249515"
"chr1","79125655","79125940","chr1","77876714","77877006","26","1248941"
"chr1","79127864","79128147","chr1","77878888","77879171","20","1248976"
"chr1","79130527","79130847","chr1","77881575","77881881","30","1248952"
"chr1","79133181","79133222","chr13","19012667","19012707","13","60120514"
"chr1","79140722","79141022","chr2","84913076","84913368","58","5772354"
"chr1","79145165","79145458","chr1","77896718","77897020","22","1248447"
"chr1","79150450","79150735","chr16","24250880","24251168","18","54899570"
"chr1","79158831","79158978","chr1","77911239","77911385","7","1247592"
"chr1","79168627","79168926","chr1","77920214","77920499","31","1248413"
"chr1","79174730","79174918","chr1","77926415","77926606","18","1248315"
"chr1","79175211","79175399","chr1","77926899","77927080","17","1248312"
"chr1","79181754","79182040","chr1","77934665","77934955","25","1247089"
"chr1","79192116","79192409","chr1","77944739","77945036","27","1247377"
"chr1","79205549","79205848","chr1","77955748","77956052","24","1249801"
"chr1","79206869","79206984","chr4","128388118","128388230","15","49181249"
"chr1","79220419","79220577","chr2","68681845","68682003","47","10538574"
"chr1","79220719","79220903","chr16","23362029","23362222","31","55858690"
"chr1","79220904","79221203","chr1","77972773","77973073","22","1248131"
"chr1","79221204","79221344","chr9","115376441","115376580","27","36155237"
"chr1","79227877","79228096","chr1","77978519","77978738","8","1249358"
"chr1","79233102","79233221","chr1","77983258","77983380","7","1249844"
"chr1","79233521","79233652","chr1","77983992","77984128","14","1249529"
"chr1","79260441","79260710","chr20","12631025","12631300","74","66629416"
"chr1","79288580","79288864","chr1","78041007","78041283","36","1247573"
"chr1","79295071","79295371","chr1","78047097","78047411","34","1247974"
"chr1","79319624","79319926","chr1","78072915","78073209","26","1246709"
"chr1","79329242","79329533","chr1","78082623","78082894","43","1246619"
"chr1","79329625","79329756","chr1","78083015","78083136","17","1246610"
"chr1","79333023","79333135","chr8","143302539","143302650","17","63969516"
"chr1","79336850","79337070","chr1","78090231","78090452","20","1246619"
"chr1","79348669","79348941","chr1","78102142","78102446","51","1246527"
"chr1","79353912","79354196","chr1","78105016","78105297","26","1248896"
"chr1","79374107","79374369","chr1","78125428","78125674","34","1248679"
"chr1","79388202","79388394","chr1","78139346","78139546","27","1248856"
"chr1","79406617","79406875","chr1","78158157","78158415","20","1248460"
"chr1","79412693","79412804","chr1","78163828","78163939","7","1248865"
"chr1","79413111","79413240","chr1","78164254","78164383","6","1248857"
"chr1","79424349","79424649","chr1","78181088","78181388","27","1243261"
"chr1","79427027","79427315","chr1","78183749","78184050","40","1243278"
"chr1","79464168","79464367","chr1","78229649","78229835","26","1234519"
"chr1","79468159","79468456","chr16","52940276","52940575","50","26527883"
"chr1","79566077","79566426","chr1","78310445","78310772","56","1255632"
"chr1","79713006","79713315","chr1","78448112","78448407","32","1264894"
"chr1","79849407","79849697","chr1","78587370","78587649","29","1262037"
"chr1","80288853","80289128","chr1","79024287","79024575","26","1264566"
"chr1","80332717","80332999","chr1","79076491","79076768","28","1256226"
"chr1","80387870","80388141","chr1","79128699","79128970","15","1259171"
"chr1","80435305","80435448","chr5","156902194","156902333","28","76466889"
"chr1","80435490","80435610","chr11","46598443","46598564","18","33837047"
"chr1","80442619","80442789","chrX","105215528","105215687","41","24772909"
"chr1","80443061","80443161","chr9","60206806","60206906","22","20236255"
"chr1","80445148","80445441","chr1","79186235","79186508","39","1258913"
"chr1","80482938","80483061","chr1","79225840","79225964","10","1257098"
"chr1","80546882","80547154","chr1","79291077","79291357","25","1255805"
"chr1","80547463","80547484","chr9","63305347","63305371","4","17242116"
"chr1","80668437","80668723","chr1","79411916","79412197","28","1256521"
"chr1","80784533","80784772","chr1","79527069","79527320","30","1257464"
"chr1","80830965","80831261","chr1","79574756","79575054","34","1256209"
"chr1","80832224","80832474","chr1","79576013","79576263","14","1256211"
"chr1","80916307","80916607","chr1","79651658","79651960","17","1264649"
"chr1","81065877","81066147","chr1","79790218","79790489","17","1275659"
"chr1","81130887","81131146","chr1","79860002","79860259","21","1270885"
"chr1","81203867","81203951","chr1","79933567","79933651","7","1270300"
"chr1","81302131","81302303","chr1","80024279","80024447","12","1277852"
"chr1","81322307","81322437","chr9","1080439","1080570","27","80241868"
"chr1","81342542","81342754","chr1","80069445","80069656","16","1273097"
"chr1","81380358","81380655","chr1","80106042","80106336","24","1274316"
"chr1","81449262","81449546","chr1","80171176","80171445","41","1278086"
"chr1","81496189","81496468","chr8","117632241","117632525","69","36136052"
"chr1","81542213","81542513","chr1","80251166","80251463","43","1291047"
"chr1","81585294","81585372","chr11","3132112","3132193","16","78453182"
"chr1","81585419","81585598","chr7","66448545","66448719","40","15136874"
"chr1","81621603","81621870","chr1","80338063","80338331","57","1283540"
"chr1","81697876","81698166","chr12","100654132","100654418","50","18956256"
"chr1","81756846","81757122","chr1","80470667","80470939","18","1286179"
"chr1","81775022","81775316","chr1","80494888","80495180","39","1280134"
"chr1","81808526","81808849","chr1","80528371","80528702","32","1280155"
"chr1","81828497","81828733","chr1","80553711","80553962","36","1274786"
"chr1","81963380","81963496","chr1","80691437","80691553","11","1271943"
"chr1","82332463","82332683","chr1","81139268","81139499","25","1193195"
"chr1","82411640","82411907","chr1","81217480","81217738","57","1194160"
"chr1","82434855","82434972","chr1","81240732","81240849","6","1194123"
"chr1","82565757","82566070","chr16","23949857","23950175","82","58615900"
"chr1","82605534","82605845","chr1","81420212","81420528","41","1185322"
"chr1","82655217","82655531","chr1","81468982","81469293","46","1186235"
"chr1","82710254","82710564","chr1","81525016","81525341","39","1185238"
"chr1","82713420","82713580","chr1","81528178","81528334","10","1185242"
"chr1","82773889","82774147","chr1","81587820","81588079","15","1186069"
"chr1","82788162","82788482","chr1","81602259","81602578","28","1185903"
"chr1","82895887","82896179","chr1","81709804","81710104","26","1186083"
"chr1","82956135","82956253","chr1","81770639","81770767","15","1185496"
"chr1","82965158","82965370","chr1","58348505","58348709","44","24616653"
"chr1","83031351","83031638","chr9","58105447","58105736","64","24925904"
"chr1","83119251","83119543","chr1","81934885","81935131","61","1184366"
"chr1","83141809","83142097","chr1","81956868","81957162","42","1184941"
"chr1","83148178","83148481","chr1","81963470","81963772","20","1184708"
"chr1","83148953","83149243","chr8","86768229","86768522","74","3619276"
"chr1","83149538","83149568","chr1","81964847","81964878","3","1184691"
"chr1","83179122","83179435","chr1","81994343","81994653","27","1184779"
"chr1","83179983","83180284","chr1","81994343","81994653","28","1185640"
"chr1","83185174","83185297","chr1","81999475","81999596","12","1185699"
"chr1","83247862","83247988","chr1","82062704","82062837","11","1185158"
"chr1","83297643","83297946","chr1","82114746","82115031","45","1182897"
"chr1","83471816","83472113","chr1","82281475","82281768","31","1190341"
"chr1","83519120","83519402","chr1","82330921","82331201","42","1188199"
"chr1","83547625","83547945","chr1","82359173","82359468","44","1188452"
"chr1","83605758","83605879","chr1","82416185","82416305","8","1189573"
"chr1","83642998","83643304","chr1","82454417","82454718","29","1188581"
"chr1","83674441","83674736","chr15","34234250","34234544","61","49440191"
"chr1","83727580","83727868","chr1","82534457","82534732","37","1193123"
"chr1","83769027","83769304","chr1","82577320","82577594","19","1191707"
"chr1","83845851","83845966","chr1","82656458","82656578","15","1189393"
"chr1","84060995","84061297","chr2","75634080","75634375","62","8426915"
"chr1","84109965","84110149","chr9","45658033","45658214","53","38451932"
"chr1","84136140","84136264","chr1","82957242","82957366","5","1178898"
"chr1","84311938","84312206","chr1","83193531","83193799","16","1118407"
"chr1","84323346","84323648","chr1","83204768","83205075","28","1118578"
"chr1","84361934","84362232","chr1","83242342","83242651","34","1119592"
"chr1","85069837","85070118","chr1","83863791","83864059","42","1206046"
"chr1","85082079","85082387","chr1","83873638","83873942","30","1208441"
"chr1","85230526","85230826","chr5","14864191","14864482","63","70366335"
"chr1","85231787","85232067","chr4","110252102","110252381","52","25020315"
"chr1","85317298","85317477","chr1","84118526","84118701","12","1198772"
"chr1","85344094","85344399","chr1","84142841","84143164","53","1201253"
"chr1","85407454","85407634","chr1","84221274","84221451","16","1186180"
"chr1","85418199","85418490","chr9","99101491","99101790","51","13683292"
"chr1","85430261","85430530","chr13","65860732","65860999","61","19569529"
"chr1","85432000","85432253","chr1","84245388","84245641","25","1186612"
"chr1","85434182","85434303","chr1","84247852","84247968","11","1186330"
"chr1","85439817","85440133","chrX","123095610","123095922","59","37655793"
"chr1","85471658","85471939","chr14","78383925","78384200","62","7087733"
"chr1","85565412","85565698","chr1","84402811","84403103","24","1162601"
"chr1","85805429","85805714","chr1","191690399","191690678","51","105884970"
"chr1","85826639","85826810","chr1","84651531","84651698","12","1175108"
"chr1","85870851","85871147","chr2","43723133","43723421","79","42147718"
"chr1","85966974","85967270","chr1","26277095","26277386","49","59689879"
"chr1","85984987","85985288","chr1","84808935","84809237","21","1176052"
"chr1","85986757","85987001","chr20","41332824","41333057","55","44653933"
"chr1","85989992","85990120","chr19","10460976","10461099","26","75529016"
"chr1","86008470","86008729","chr4","122350197","122350458","72","36341727"
"chr1","86011555","86011832","chr1","84835602","84835875","27","1175953"
"chr1","86059935","86060219","chr5","55900992","55901275","63","30158943"
"chr1","86144122","86144404","chr1","84972637","84972903","35","1171485"
"chr1","86155134","86155428","chr1","84984325","84984616","26","1170809"
"chr1","86171768","86172070","chr1","85001677","85001986","26","1170091"
"chr1","86206949","86207199","chr1","85036769","85037013","27","1170180"
"chr1","86247558","86247861","chr2","178119588","178119898","61","91872030"
"chr1","86294361","86294649","chrX","108208239","108208529","53","21913878"
"chr1","86312160","86312463","chr1","85143722","85144025","23","1168438"
"chr1","86373569","86373869","chr1","85205500","85205799","11","1168069"
"chr1","86384476","86384775","chr1","85213848","85214147","16","1170628"
"chr1","86393574","86393692","chr1","85222940","85223058","7","1170634"
"chr1","86434953","86435257","chrX","47748077","47748386","50","38686876"
"chr1","86438747","86438929","chrX","63599804","63599994","38","22838943"
"chr1","86451552","86451818","chr1","85280419","85280698","36","1171133"
"chr1","86464622","86464913","chr1","85294739","85295051","40","1169883"
"chr1","86495377","86495677","chr1","85327510","85327811","23","1167867"
"chr1","86549169","86549329","chr1","85381837","85381993","14","1167332"
"chr1","86584179","86584454","chr1","85416732","85417005","14","1167447"
"chr1","86603576","86603874","chr1","85433039","85433340","25","1170537"
"chr1","86606228","86606436","chr1","85436005","85436229","23","1170223"
"chr1","86622099","86622226","chr1","85451543","85451666","16","1170556"
"chr1","86623165","86623451","chr1","85452613","85452897","15","1170552"
"chr1","86626722","86627024","chr10","60781198","60781496","69","25845524"
"chr1","86630183","86630308","chr1","85459366","85459490","7","1170817"
"chr1","86642499","86642795","chr1","85472372","85472671","30","1170127"
"chr1","86643446","86643740","chr1","85473320","85473585","49","1170126"
"chr1","86647904","86648169","chr1","85477791","85478059","16","1170113"
"chr1","86653054","86653322","chr13","64728001","64728269","62","21925053"
"chr1","86655106","86655127","chr16","69311970","69311988","9","17343136"
"chr1","86655867","86656000","chr5","2780258","2780384","33","83875609"
"chr1","86664208","86664231","chr16","41419029","41419053","5","45245179"
"chr1","86684129","86684405","chr1","85513507","85513775","17","1170622"
"chr1","86686142","86686428","chr1","85515530","85515803","29","1170612"
"chr1","86702361","86702611","chr1","139171311","139171559","55","52468950"
"chr1","86714003","86714308","chr1","85542953","85543257","21","1171050"
"chr1","86785024","86785212","chr9","11352038","11352217","45","75432986"
"chr1","86815693","86815990","chr9","28346880","28347170","61","58468813"
"chr1","86826419","86826710","chr1","162529282","162529568","57","75702863"
"chr1","87007292","87007360","chr1","85834401","85834469","1","1172891"
"chr1","87069416","87069687","chr1","85888982","85889262","30","1180434"
"chr1","87095582","87095897","chr1","85915295","85915616","36","1180287"
"chr1","87109531","87109648","chr14","54311438","54311555","16","32798093"
"chr1","87174782","87174919","chr5","6942875","6943008","31","80231907"
"chr1","87174945","87175105","chr3","63876628","63876793","31","23298317"
"chr1","87187475","87187732","chr1","85998680","85998941","25","1188795"
"chr1","87193833","87194141","chr1","86005047","86005345","29","1188786"
"chr1","87201522","87201853","chr1","86012715","86013056","23","1188807"
"chr1","87319793","87319999","chr1","86122210","86122416","16","1197583"
"chr1","87322724","87323038","chr1","86125028","86125326","30","1197696"
"chr1","87367528","87367804","chr1","86169068","86169360","37","1198460"
"chr1","87398305","87398607","chr11","63392648","63392957","59","24005657"
"chr1","87407261","87407529","chr1","86216026","86216301","27","1191235"
"chr1","87410648","87410933","chr1","86219436","86219720","29","1191212"
"chr1","87427498","87427619","chr1","86235506","86235625","12","1191992"
"chr1","87505037","87505350","chr1","86317450","86317752","34","1187587"
"chr1","87673099","87673405","chr1","86473039","86473347","16","1200060"
"chr1","87700552","87700853","chr1","86500459","86500763","24","1200093"
"chr1","87757764","87757888","chr6","174912492","174912608","36","87154728"
"chr1","88054090","88054220","chr1","86847373","86847497","14","1206717"
"chr1","88115545","88115834","chr1","86913045","86913336","12","1202500"
"chr1","88136688","88137019","chr7","62956753","62957062","71","25179935"
"chr1","88155323","88155634","chr1","86952563","86952878","28","1202760"
"chr1","88185566","88185753","chr3","129669679","129669864","41","41484113"
"chr1","88226474","88226750","chr1","87010585","87010858","24","1215889"
"chr1","88236812","88237109","chr1","87023566","87023859","22","1213246"
"chr1","88265369","88265648","chr1","87051692","87051997","42","1213677"
"chr1","88265675","88265696","chr12","46086476","46086496","3","42179199"
"chr1","88308943","88309250","chr1","87095944","87096253","15","1212999"
"chr1","88309570","88309861","chr1","87096570","87096859","27","1213000"
"chr1","88324376","88324679","chrX","21349822","21350117","62","66974554"
"chr1","88336866","88337139","chr9","123745173","123745449","58","35408307"
"chr1","88345215","88345504","chr1","87132183","87132470","19","1213032"
"chr1","88347251","88347541","chr1","87134033","87134327","26","1213218"
"chr1","88389622","88389911","chr1","87176390","87176683","21","1213232"
"chr1","88399038","88399323","chr1","87186118","87186404","23","1212920"
"chr1","88409264","88409477","chr10","26689716","26689920","55","61719548"
"chr1","88435135","88435427","chr1","87220578","87220866","9","1214557"
"chr1","88517511","88517820","chr1","87306521","87306827","22","1210990"
"chr1","88536764","88537072","chr1","87326401","87326676","56","1210363"
"chr1","88676331","88676543","chr13","37987524","37987732","45","50688807"
"chr1","88693719","88694007","chr1","87485067","87485350","29","1208652"
"chr1","88728550","88728675","chr1","87519945","87520072","17","1208605"
"chr1","88783405","88783712","chr1","87567354","87567664","33","1216051"
"chr1","89229073","89229378","chr1","87922410","87922709","26","1306663"
"chr1","89309743","89310063","chr1","88002036","88002310","70","1307707"
"chr1","89616841","89617139","chr1","88338342","88338644","20","1278499"
"chr1","89636462","89636768","chr1","88358086","88358390","27","1278376"
"chr1","89795805","89795953","chr1","88515841","88515993","13","1279964"
"chr1","89875969","89876264","chr1","88598093","88598384","18","1277876"
"chr1","89888528","89888815","chr1","88619173","88619460","16","1269355"
"chr1","89980405","89980694","chr1","88718770","88719056","33","1261635"
"chr1","90070843","90071147","chr1","88810818","88811128","20","1260025"
"chr1","90121371","90121545","chr1","88862952","88863130","16","1258419"
"chr1","90154870","90155174","chr1","146278080","146278377","58","56123210"
"chr1","90157363","90157536","chr1","88899384","88899548","16","1257979"
"chr1","90186440","90186724","chrX","103046997","103047266","67","12860557"
"chr1","90197739","90198032","chr1","88945945","88946236","20","1251794"
"chr1","90199010","90199316","chr1","88947219","88947530","19","1251791"
"chr1","90212502","90212796","chr1","88961114","88961413","17","1251388"
"chr1","90221168","90221258","chr1","88970113","88970187","19","1251055"
"chr1","90238975","90239169","chr1","88988374","88988562","20","1250601"
"chr1","90276415","90276685","chrX","67493410","67493689","65","22783005"
"chr1","90279232","90279518","chr1","89028067","89028347","13","1251165"
"chr1","90304094","90304397","chr1","89053794","89054107","27","1250300"
"chr1","90340980","90341284","chr1","89089795","89090101","33","1251185"
"chr1","90350599","90350850","chr5","4873263","4873530","65","85477336"
"chr1","90356921","90357204","chr1","89105274","89105586","48","1251647"
"chr1","90399933","90400215","chr1","89150279","89150571","22","1249654"
"chr1","90408941","90409151","chr1","89159439","89159655","16","1249502"
"chr1","90422083","90422361","chr1","89171888","89172154","48","1250195"
"chr1","90427069","90427280","chr13","39371697","39371907","42","51055372"
"chr1","90445481","90445641","chr1","89201534","89201694","18","1243947"
"chr1","90445943","90446083","chr1","89202003","89202146","8","1243940"
"chr1","90466622","90466952","chr1","89223959","89224277","40","1242663"
"chr1","90555120","90555393","chr1","89339331","89339605","17","1215789"
"chr1","90604069","90604356","chr3","50329605","50329905","66","40274464"
"chr1","90804869","90804959","chr1","89477385","89477475","2","1327484"
"chr1","90906883","90907188","chr16","38454878","38455193","61","52452005"
"chr1","90977880","90978137","chr1","89734834","89735093","33","1243046"
"chr1","90996383","90996464","chr1","89754302","89754376","8","1242081"
"chr1","91045305","91045481","chr1","89801333","89801498","17","1243972"
"chr1","91121542","91121853","chr1","89885889","89886186","38","1235653"
"chr1","91193885","91194170","chr1","89958171","89958463","23","1235714"
"chr1","91202123","91202429","chr1","89966414","89966727","21","1235709"
"chr1","91202609","91202898","chr1","89966922","89967220","45","1235687"
"chr1","91213410","91213709","chr19","8321984","8322279","65","82891426"
"chr1","91225936","91226072","chr8","71179092","71179225","23","20046844"
"chr1","91347983","91348277","chr1","90117807","90118104","21","1230176"
"chr1","91359601","91359801","chr1","90130395","90130594","20","1229206"
"chr1","91361324","91361623","chr16","166962","167251","62","91194362"
"chr1","91364237","91364561","chr1","90135353","90135666","26","1228884"
"chr1","91378093","91378364","chr3","38934767","38935033","59","52443326"
"chr1","91387247","91387525","chr1","90159285","90159578","28","1227962"
"chr1","91410776","91411052","chr3","39159304","39159586","59","52251472"
"chr1","91440808","91441103","chr1","90215716","90216011","32","1225092"
"chr1","91494822","91495120","chr1","90257924","90258226","35","1236898"
"chr1","91781027","91781197","chr3","39035232","39035395","36","52745795"
"chr1","91894086","91894205","chr1","90673281","90673398","10","1220805"
"chr1","91894252","91894423","chr1","90673430","90673593","15","1220822"
"chr1","91980977","91981042","chr3","78091570","78091637","15","13889407"
"chr1","92018680","92018958","chr1","90806145","90806430","21","1212535"
"chr1","92068590","92068839","chr1","90869549","90869798","16","1199041"
"chr1","92092250","92092518","chr5","188337391","188337669","76","96245141"
"chr1","92145991","92146165","chr1","90948111","90948292","20","1197880"
"chr1","92151353","92151577","chr1","90953485","90953703","26","1197868"
"chr1","92154391","92154680","chr17","92270496","92270781","48","116105"
"chr1","92167625","92167830","chr1","90970102","90970306","11","1197523"
"chr1","92184581","92184897","chr9","12539664","12539969","64","79644917"
"chr1","92273479","92273779","chr1","91074469","91074769","25","1199010"
"chr1","92299792","92299919","chr1","91100006","91100136","11","1199786"
"chr1","92305357","92305660","chr1","91105555","91105865","20","1199802"
"chr1","92318720","92319012","chr1","91118950","91119263","41","1199770"
"chr1","92401889","92402156","chr2","97951471","97951743","65","5549582"
"chr1","92530508","92530795","chr1","91319739","91320055","45","1210769"
"chr1","92541753","92541881","chr1","91331705","91331834","7","1210048"
"chr1","92547993","92548288","chr1","91337647","91337927","26","1210346"
"chr1","92600870","92601152","chr1","91391589","91391872","16","1209281"
"chr1","92603516","92603746","chr1","91394221","91394448","19","1209295"
"chr1","92642946","92643238","chr1","91413763","91414037","42","1229183"
"chr1","92672457","92672719","chr1","91893386","91893651","21","779071"
"chr1","92704035","92704345","chr1","91569220","91569531","30","1134815"
"chr1","92712712","92713001","chr1","91576024","91576307","32","1136688"
"chr1","92745255","92745535","chr15","67461605","67461878","66","25283650"
"chr1","92805614","92805839","chr1","92028959","92029184","12","776655"
"chr1","92806350","92806688","chr1","92029677","92030012","32","776673"
"chr1","92832373","92832661","chr1","92055604","92055887","33","776769"
"chr1","92905603","92905901","chr1","92132379","92132681","35","773224"
"chr1","92907494","92907770","chr12","20012360","20012632","69","72895134"
"chr1","92911417","92911701","chr1","92137825","92138109","19","773592"
"chr1","92937351","92937597","chr14","116444280","116444531","73","23506929"
"chr1","92944163","92944464","chr1","92171743","92172039","22","772420"
"chr1","92962027","92962307","chr7","96759809","96760089","55","3797782"
"chr1","93015880","93016122","chr1","92243204","92243450","23","772676"
"chr1","93016920","93017251","chr1","92244271","92244580","47","772649"
"chr1","93017257","93017559","chr1","92244592","92244895","31","772665"
"chr1","93020408","93020706","chr1","92247752","92248049","29","772656"
"chr1","93030822","93031125","chr1","92259339","92259645","37","771483"
"chr1","93035104","93035279","chr1","92264157","92264333","6","770947"
"chr1","93087240","93087445","chr1","92309636","92309829","20","777604"
"chr1","93123214","93123507","chr1","92345848","92346145","21","777366"
"chr1","93133495","93133771","chr1","92356712","92356987","20","776783"
"chr1","93210967","93211256","chr1","92434695","92434999","30","776272"
"chr1","93222645","93222949","chr1","92447744","92448053","23","774901"
"chr1","93260517","93260774","chr3","180242810","180243067","50","86982293"
"chr1","93270334","93270673","chr1","92496748","92497102","32","773586"
"chr1","93272597","93272882","chr3","73762744","73763023","68","19509853"
"chr1","93296672","93296803","chr4","73819458","73819584","19","19477214"
"chr1","93300418","93300676","chr1","92524164","92524422","20","776254"
"chr1","93302825","93303082","chr1","92526552","92526821","24","776273"
"chr1","93303472","93303755","chr1","92527219","92527506","30","776253"
"chr1","93304626","93304846","chr1","92528364","92528587","15","776262"
"chr1","93312162","93312455","chr1","92536372","92536647","36","775790"
"chr1","93326622","93326925","chr1","92551834","92552137","17","774788"
"chr1","93327883","93328164","chr1","92552948","92553230","23","774935"
"chr1","93331232","93331247","chr5","2325838","2325854","3","91005394"
"chr1","93331546","93331726","chr7","2419428","2419612","51","90912118"
"chr1","93332049","93332185","chr1","144486514","144486647","19","51154465"
"chr1","93334847","93335063","chr1","92560838","92561056","27","774009"
"chr1","93344058","93344345","chr1","92569998","92570289","33","774060"
"chr1","93356521","93356827","chr18","16329347","16329651","72","77027174"
"chr1","93358629","93358917","chr1","90159285","90159578","66","3199344"
"chr1","93370002","93370300","chr1","92599549","92599848","15","770453"
"chr1","93370364","93370672","chr1","92599923","92600209","43","770441"
"chr1","93381165","93381281","chr8","72245817","72245934","14","21135348"
"chr1","93420698","93421019","chr1","92648779","92649102","18","771919"
"chr1","93424638","93424785","chr12","91266657","91266801","37","2157981"
"chr1","93428438","93428560","chr1","92654022","92654144","6","774416"
"chr1","93433571","93433850","chr1","92659434","92659723","24","774137"
"chr1","93445558","93445881","chr1","92671567","92671894","29","773991"
"chr1","93449302","93449600","chr2","183338715","183338995","72","89889413"
"chr1","93460723","93461047","chrX","20242286","20242595","79","73218437"
"chr1","93465280","93465395","chr1","92690108","92690223","4","775172"
"chr1","93480481","93480649","chr1","92705534","92705699","13","774947"
"chr1","93499816","93499997","chr13","87211970","87212142","49","6287846"
"chr1","93504974","93505279","chr1","92730130","92730440","24","774844"
"chr1","93510097","93510317","chr1","92734684","92734910","17","775413"
"chr1","93515360","93515638","chr1","92740093","92740376","17","775267"
"chr1","93532725","93532999","chr11","122776089","122776360","63","29243364"
"chr1","93547910","93548181","chr4","128903519","128903790","54","35355609"
"chr1","93567649","93567817","chr1","92786956","92787122","22","780693"
"chr1","93610524","93610826","chr1","92830877","92831177","22","779647"
"chr1","93647285","93647586","chr1","92867608","92867899","19","779677"
"chr1","93691345","93691633","chr9","58105447","58105736","54","35585898"
"chr1","93709358","93709563","chr1","34326398","34326611","51","59382960"
"chr1","93736822","93736959","chr1","92962365","92962502","6","774457"
"chr1","93737266","93737358","chr1","92962816","92962908","4","774450"
"chr1","93751878","93752160","chr1","92977796","92978086","27","774082"
"chr1","93760815","93761117","chr7","111736578","111736881","58","17975763"
"chr1","93768393","93768550","chr12","21323547","21323703","20","72444846"
"chr1","93771518","93771836","chr1","92998033","92998355","27","773485"
"chr1","93774873","93775155","chr1","93001680","93001963","21","773193"
"chr1","93799262","93799562","chr3","41480459","41480757","49","52318803"
"chr1","93802494","93802794","chr1","93027533","93027808","40","774961"
"chr1","93814867","93815185","chr7","45450102","45450409","68","48364765"
"chr1","93838998","93839273","chr1","93066583","93066846","36","772415"
"chr1","93849123","93849417","chr1","93076825","93077110","28","772298"
"chr1","93865048","93865348","chr15","28230517","28230819","59","65634531"
"chr1","93866448","93866562","chr8","101782819","101782936","26","7916371"
"chr1","93889086","93889200","chr1","93115613","93115727","2","773473"
"chr1","93892675","93892795","chr1","93119533","93119665","17","773142"
"chr1","93899354","93899647","chr1","93126163","93126473","48","773191"
"chr1","93906899","93907022","chr2","165531071","165531193","19","71624172"
"chr1","93911829","93911955","chr16","39379692","39379819","19","54532137"
"chr1","93923026","93923313","chr8","122685373","122685657","60","28762347"
"chr1","93923325","93923445","chr6","75136695","75136820","22","18786630"
"chr1","93945182","93945292","chr1","93173075","93173185","5","772107"
"chr1","93984963","93985209","chr9","34504265","34504507","66","59480698"
"chr1","93997484","93997760","chr20","28723910","28724188","52","65273574"
"chr1","94013142","94013438","chr1","93226651","93226962","33","786491"
"chr1","94043404","94043678","chr1","93257795","93258067","18","785609"
"chr1","94049615","94049904","chr1","93266579","93266869","15","783036"
"chr1","94089667","94089950","chr1","93315389","93315675","10","774278"
"chr1","94092842","94093161","chr1","93318578","93318907","42","774264"
"chr1","94114164","94114453","chr1","93340786","93341061","35","773378"
"chr1","94129940","94130225","chr1","93352503","93352787","15","777437"
"chr1","94132591","94132890","chr1","93355168","93355469","24","777423"
"chr1","94146273","94146552","chr1","93370688","93370971","34","775585"
"chr1","94164143","94164299","chr1","93391990","93392151","11","772153"
"chr1","94174069","94174377","chr1","93402407","93402722","30","771662"
"chr1","94189777","94190066","chr1","93420571","93420852","26","769206"
"chr1","94204023","94204152","chr1","117811669","117811797","17","23607646"
"chr1","94206935","94207229","chr11","104474930","104475220","78","10267995"
"chr1","94219092","94219378","chr1","93452484","93452781","31","766608"
"chr1","94226274","94226564","chr1","93459646","93459941","29","766628"
"chr1","94226572","94226687","chr17","20445335","20445450","23","73781237"
"chr1","94226985","94227165","chr3","41266668","41266852","41","52960317"
"chr1","94228369","94228671","chr17","80429135","80429431","57","13799234"
"chr1","94233463","94233698","chr1","93467550","93467800","26","765913"
"chr1","94247009","94247299","chr1","93481596","93481890","22","765413"
"chr1","94248606","94248781","chr1","93483497","93483661","29","765109"
"chr1","94249095","94249235","chr1","93483953","93484094","6","765142"
"chr1","94249244","94249541","chr1","93484103","93484405","32","765141"
"chr1","94254719","94255012","chr1","93490447","93490744","27","764272"
"chr1","94258996","94259283","chr1","93494718","93495011","18","764278"
"chr1","94262736","94262868","chr1","93498453","93498588","6","764283"
"chr1","94264367","94264654","chr1","93500077","93500373","30","764290"
"chr1","94268478","94268758","chr1","93504538","93504819","13","763940"
"chr1","94297715","94297979","chr1","93529095","93529356","24","768620"
"chr1","94306661","94306951","chr15","45142437","45142723","56","49164224"
"chr1","94326347","94326647","chr1","93558024","93558340","33","768323"
"chr1","94334924","94335227","chr1","93567596","93567899","16","767328"
"chr1","94338634","94338918","chr1","93571438","93571746","34","767196"
"chr1","94368398","94368720","chr1","93600758","93601062","52","767640"
"chr1","94389799","94390094","chr1","93624961","93625247","30","764838"
"chr1","94391384","94391691","chr1","93626529","93626816","46","764855"
"chr1","94393992","94394270","chr1","93629114","93629392","11","764878"
"chr1","94395129","94395377","chr8","16758019","16758271","69","77637110"
"chr1","94403171","94403448","chr1","93638348","93638648","42","764823"
"chr1","94407188","94407473","chr1","93642341","93642634","34","764847"
"chr1","94415646","94415945","chr1","93650869","93651156","31","764777"
"chr1","94423364","94423654","chr1","93657663","93657955","22","765701"
"chr1","94424529","94424652","chr6","64065434","64065559","16","30359095"
"chr1","94434304","94434608","chr1","93676746","93677051","14","757558"
"chr1","94438253","94438315","chr1","93680698","93680762","5","757555"
"chr1","94464805","94464960","chr1","93706532","93706689","8","758273"
"chr1","94465260","94465405","chr19","35574608","35574755","33","58890652"
"chr1","94477501","94477791","chr1","93719944","93720234","15","757557"
"chr1","94479771","94479959","chr11","62687672","62687867","55","31792099"
"chr1","94484899","94485204","chr1","93727407","93727713","39","757492"
"chr1","94492216","94492460","chr1","93734373","93734621","31","757843"
"chr1","94497574","94497851","chr1","93739842","93740134","35","757732"
"chr1","94504059","94504353","chr1","93746226","93746533","28","757833"
"chr1","94518532","94518780","chr1","93760531","93760798","33","758001"
"chr1","94518974","94519270","chr1","93760968","93761269","23","758006"
"chr1","94536931","94537229","chr1","93778870","93779167","28","758061"
"chr1","94537983","94538258","chr1","93779883","93780158","18","758100"
"chr1","94544015","94544322","chr1","93785904","93786209","25","758111"
"chr1","94558044","94558208","chr2","187591444","187591610","49","93033400"
"chr1","94559862","94560127","chr1","93801962","93802230","18","757900"
"chr1","94565238","94565440","chr1","93807582","93807787","20","757656"
"chr1","94578739","94579031","chr1","93820100","93820384","21","758639"
"chr1","94594620","94594915","chr1","93836363","93836662","26","758257"
"chr1","94600828","94601118","chr3","41391456","41391747","59","53209372"
"chr1","94602166","94602454","chr1","93843848","93844136","20","758318"
"chr1","94611872","94612154","chr1","93854068","93854349","29","757804"
"chr1","94617542","94617849","chr16","51884206","51884517","64","42733336"
"chr1","94624055","94624231","chr12","87917476","87917649","39","6706579"
"chr1","94651482","94651707","chr4","87659306","87659521","40","6992176"
"chr1","94653395","94653651","chr20","28231522","28231772","66","66421873"
"chr1","94675818","94676058","chr14","22784146","22784375","53","71891672"
"chr1","94682965","94683264","chr6","140128245","140128544","57","45445280"
"chr1","94686406","94686689","chr1","93943915","93944191","31","742491"
"chr1","94700023","94700287","chr8","22179128","22179386","47","72520895"
"chr1","94704167","94704450","chr1","93974391","93974665","21","729776"
"chr1","94730198","94730380","chr8","38827921","38828100","32","55902277"
"chr1","94734291","94734609","chr1","94005293","94005599","33","728998"
"chr1","94738086","94738322","chr1","94009097","94009338","15","728989"
"chr1","94753056","94753355","chr1","94024387","94024701","45","728669"
"chr1","94783020","94783220","chr1","94054767","94054977","24","728253"
"chr1","94783263","94783475","chr1","94055009","94055207","29","728254"
"chr1","94794135","94794236","chr1","94061554","94061655","7","732581"
"chr1","94800478","94800776","chr1","94067460","94067769","29","733018"
"chr1","94824800","94825091","chr1","94095609","94095901","21","729191"
"chr1","94836193","94836488","chr1","94107049","94107352","27","729144"
"chr1","94839819","94840119","chr1","94111033","94111333","23","728786"
"chr1","94841607","94841866","chr1","94112822","94113095","33","728785"
"chr1","94844602","94844718","chr1","94115826","94115942","4","728776"
"chr1","94855127","94855377","chrX","7354555","7354813","49","87500572"
"chr1","94868302","94868604","chr17","80429135","80429431","48","14439167"
"chr1","94869603","94869861","chr1","94141298","94141567","23","728305"
"chr1","94884693","94884992","chr1","94156764","94157033","43","727929"
"chr1","94892395","94892634","chr1","94164711","94164950","13","727684"
"chr1","94896550","94896681","chr1","94168818","94168949","8","727732"
"chr1","94918867","94919115","chr1","94191259","94191507","10","727608"
"chr1","95034085","95034374","chr1","94307059","94307353","24","727026"
"chr1","95035947","95036245","chr1","94308911","94309212","28","727036"
"chr1","95102025","95102318","chr1","94374650","94374935","24","727375"
"chr1","95124766","95125095","chr1","94398072","94398411","36","726694"
"chr1","95136548","95136837","chr1","94411938","94412228","14","724610"
"chr1","95144505","95144637","chr9","115052851","115052979","19","19908346"
"chr1","95194141","95194300","chr1","94470439","94470575","27","723702"
"chr1","95194604","95194787","chr1","94470870","94471067","20","723734"
"chr1","95196486","95196603","chr1","94472762","94472879","10","723724"
"chr1","95240285","95240569","chr1","94515904","94516190","19","724381"
"chr1","95264427","95264707","chr10","13786018","13786298","50","81478409"
"chr1","95264757","95264887","chr1","94533990","94534120","7","730767"
"chr1","95267069","95267293","chr1","94536306","94536519","18","730763"
"chr1","95269357","95269662","chr10","43495806","43496105","60","51773551"
"chr1","95277179","95277479","chr1","94546171","94546474","9","731008"
"chr1","95284200","95284521","chr1","94553780","94554094","22","730420"
"chr1","95291834","95291951","chr1","94561283","94561400","7","730551"
"chr1","95291954","95292220","chr1","94561403","94561657","37","730551"
"chr1","95311651","95311954","chr1","94580284","94580588","16","731367"
"chr1","95316972","95317275","chrX","63300446","63300760","67","32016526"
"chr1","95336910","95337218","chr1","94596766","94597083","37","740144"
"chr1","95347934","95348064","chr10","84802957","84803087","21","10544977"
"chr1","95426454","95426748","chr1","94681297","94681592","25","745157"
"chr1","95505997","95506278","chr1","94760604","94760885","13","745393"
"chr1","95534116","95534365","chr17","78010791","78011045","64","17523325"
"chr1","95600477","95600774","chr1","94849436","94849731","12","751041"
"chr1","95603374","95603548","chr13","92761101","92761272","39","2842273"
"chr1","95610181","95610494","chr1","94858862","94859162","30","751319"
"chr1","95641015","95641326","chr1","94891239","94891544","31","749776"
"chr1","95674764","95675072","chr1","94925129","94925445","52","749635"
"chr1","95708093","95708377","chr1","94958542","94958839","34","749551"
"chr1","95711104","95711401","chr1","94961527","94961818","28","749577"
"chr1","95723123","95723410","chr16","1095250","1095541","62","94627873"
"chr1","95817345","95817461","chr1","95071629","95071745","10","745716"
"chr1","95860583","95860791","chr1","95122244","95122461","27","738339"
"chr1","95887348","95887620","chr3","39159304","39159586","63","56728044"
"chr1","95889489","95889712","chr1","95149464","95149685","17","740025"
"chr1","95894548","95894849","chr1","95154641","95154936","22","739907"
"chr1","95948338","95948420","chr2","50663560","50663642","13","45284778"
"chr1","95978595","95978848","chr1","95237434","95237687","20","741161"
"chr1","95997395","95997676","chr10","48075974","48076262","66","47921421"
"chr1","96036629","96036782","chr4","2017308","2017461","33","94019321"
"chr1","96036819","96036848","chr5","92425838","92425863","5","3610981"
"chr1","96045512","96045797","chr1","95309325","95309608","9","736187"
"chr1","96088970","96089256","chr1","95362467","95362768","36","726503"
"chr1","96139120","96139439","chr1","95413044","95413325","55","726076"
"chr1","96186049","96186299","chr1","95463381","95463633","24","722668"
"chr1","96198728","96198857","chr1","95476094","95476209","17","722634"
"chr1","96221895","96222171","chr1","95499589","95499868","15","722306"
"chr1","96293520","96293795","chr1","35294285","35294565","56","60999235"
"chr1","96294815","96294913","chr1","95571817","95571914","8","722998"
"chr1","96317167","96317289","chr1","95607972","95608094","9","709195"
"chr1","96330923","96331048","chr7","92846413","92846536","14","3484510"
"chr1","96348369","96348647","chr2","54176449","54176727","63","42171920"
"chr1","96353649","96353941","chr9","23116704","23116994","54","73236945"
"chr1","96365659","96365776","chr12","59194353","59194471","17","37171306"
"chr1","96391849","96392170","chr1","95685862","95686177","26","705987"
"chr1","96427000","96427297","chr1","95722263","95722575","37","704737"
"chr1","96458116","96458226","chr14","122143875","122143993","19","25685759"
"chr1","96464359","96464642","chr1","95761935","95762239","35","702424"
"chr1","96474215","96474384","chr15","8429087","8429254","33","88045128"
"chr1","96474426","96474603","chr4","58130431","58130605","41","38343995"
"chr1","96476291","96476599","chr1","195896967","195897270","53","99420676"
"chr1","96489729","96489839","chr1","95785957","95786068","10","703772"
"chr1","96496617","96496859","chr8","16758019","16758271","49","79738598"
"chr1","96499224","96499501","chr8","27744032","27744312","60","68755192"
"chr1","96499531","96499560","chr11","56678296","56678322","4","39821235"
"chr1","96501097","96501220","chr3","82959008","82959131","19","13542089"
"chr1","96525816","96526108","chr1","95821850","95822143","26","703966"
"chr1","96526909","96527206","chr1","95822843","95823146","39","704066"
"chr1","96554694","96554985","chr1","210820717","210821008","57","114266023"
"chr1","96562317","96562609","chrX","134411063","134411349","74","37848746"
"chr1","96609026","96609330","chr1","95903592","95903886","23","705434"
"chr1","96613022","96613146","chr1","95907609","95907733","6","705413"
"chr1","96687934","96688212","chr1","95981775","95982053","16","706159"
"chr1","96821701","96821973","chr1","96117495","96117763","16","704206"
"chr1","96855232","96855356","chr1","96150949","96151075","9","704283"
"chr1","97018500","97018621","chr1","96303439","96303562","7","715061"
"chr1","97315303","97315587","chr1","96615253","96615546","25","700050"
"chr1","97538522","97538805","chr1","96837368","96837645","31","701154"
"chr1","97603756","97603958","chr1","96965774","96965977","12","637982"
"chr1","97725537","97725880","chr20","37549716","37550048","84","60175821"
"chr1","97739076","97739200","chr1","97102118","97102242","11","636958"
"chr1","97759189","97759507","chr1","97123909","97124232","33","635280"
"chr1","97794472","97794761","chr1","97154422","97154707","27","640050"
"chr1","97850834","97851144","chr12","38307089","38307382","77","59543745"
"chr1","97932582","97932892","chr1","97285703","97286013","23","646879"
"chr1","97938020","97938130","chr3","39423093","39423206","19","58514927"
"chr1","97938417","97938627","chr20","53017139","53017355","50","44921278"
"chr1","97984414","97984679","chr10","29777070","29777306","73","68207344"
"chr1","97984987","97985062","chr20","16548493","16548567","15","81436494"
"chr1","98043796","98044073","chr1","97401324","97401629","46","642472"
"chr1","98081994","98082324","chr1","97439495","97439817","34","642499"
"chr1","98182464","98182756","chr1","97544687","97544979","14","637777"
"chr1","98258795","98259079","chr1","97617201","97617479","20","641594"
"chr1","98341883","98342110","chr5","14844666","14844890","55","83497217"
"chr1","98576352","98576538","chr3","37880884","37881056","39","60695468"
"chr1","98576569","98576679","chr13","31634723","31634833","24","66941846"
"chr1","98716635","98716930","chr1","98088430","98088709","42","628205"
"chr1","98759828","98760128","chr1","98131806","98132088","42","628022"
"chr1","98825482","98825742","chr1","98193387","98193648","16","632095"
"chr1","98851264","98851576","chr1","186284920","186285229","56","87433656"
"chr1","98925947","98926237","chr1","98291990","98292298","40","633957"
"chr1","98958357","98958668","chr1","98324316","98324624","29","634041"
"chr1","98997242","98997528","chr1","98365145","98365428","18","632097"
"chr1","99045509","99045801","chr1","98407220","98407507","27","638289"
"chr1","99130942","99131225","chr1","98538913","98539189","50","592029"
"chr1","99239129","99239339","chr1","98656576","98656786","14","582553"
"chr1","99379727","99379941","chr1","98807937","98808149","16","571790"
"chr1","99623071","99623337","chr1","99048687","99048939","30","574384"
"chr1","99675398","99675663","chr1","99104061","99104339","51","571337"
"chr1","99776611","99776925","chr1","99203813","99204109","68","572798"
"chr1","99790126","99790438","chr1","99217632","99217945","28","572494"
"chr1","99874551","99874854","chr1","99306676","99306974","33","567875"
"chr1","99903702","99903990","chr1","99338938","99339210","33","564764"
"chr1","99921803","99922106","chr1","99356586","99356894","27","565217"
"chr1","99961827","99962131","chr1","99394754","99395061","41","567073"
"chr1","100000862","100000941","chr1","99487800","99487879","3","513062"
"chr1","100031822","100032160","chr1","99518423","99518748","66","513399"
"chr1","100038587","100038672","chr1","99525190","99525285","19","513397"
"chr1","100161719","100162019","chr1","99654569","99654837","56","507150"
"chr1","100204386","100204666","chr1","99686285","99686563","23","518101"
"chr1","100290342","100290630","chr1","99765393","99765674","37","524949"
"chr1","100316060","100316178","chr3","99592664","99592782","36","723396"
"chr1","100328416","100328734","chr1","99806824","99807142","33","521592"
"chr1","100340374","100340677","chr1","99818361","99818661","25","522013"
"chr1","100398859","100399025","chr1","99877743","99877907","12","521116"
"chr1","100580373","100580642","chr9","22873625","22873899","65","77706748"
"chr1","100630175","100630480","chr1","100114575","100114889","61","515600"
"chr1","100699267","100699548","chr1","100177129","100177418","34","522138"
"chr1","100731963","100732238","chr1","100203970","100204247","22","527993"
"chr1","100915986","100916290","chr1","100370013","100370310","30","545973"
"chr1","100977879","100977994","chr1","100439548","100439664","5","538331"
"chr1","101081421","101081737","chr1","100570305","100570633","48","511116"
"chr1","101102554","101102852","chr1","100591551","100591854","42","511003"
"chr1","101106284","101106428","chr3","9755296","9755438","26","91350988"
"chr1","101106735","101106912","chr15","8429087","8429254","36","92677648"
"chr1","101108700","101109001","chr1","100597385","100597709","41","511315"
"chr1","101129896","101130199","chr1","100619074","100619379","17","510822"
"chr1","101130901","101131161","chr1","100620012","100620293","43","510889"
"chr1","101159234","101159509","chr1","100648805","100649093","32","510429"
"chr1","101159809","101160122","chr1","100649392","100649693","30","510417"
"chr1","101229291","101229586","chr1","100712833","100713118","27","516458"
"chr1","101244660","101244963","chr1","100727091","100727395","27","517569"
"chr1","101262002","101262306","chr2","200415452","200415748","58","99153450"
"chr1","101269731","101270022","chr1","100754169","100754455","25","515562"
"chr1","101281034","101281328","chr1","100764842","100765143","22","516192"
"chr1","101299533","101299664","chr1","100783558","100783689","6","515975"
"chr1","101302714","101303000","chr1","100786766","100787045","17","515948"
"chr1","101306365","101306473","chr12","110350854","110350960","18","9044489"
"chr1","101314529","101314820","chr2","48727638","48727936","60","52586891"
"chr1","101317239","101317450","chr1","100809680","100809897","19","507559"
"chr1","101318053","101318275","chr1","100810480","100810707","24","507573"
"chr1","101324932","101325232","chr1","100817853","100818148","20","507079"
"chr1","101330880","101331187","chr1","100824926","100825220","33","505954"
"chr1","101336213","101336506","chr7","78606719","78607017","61","22729494"
"chr1","101342450","101342758","chr1","100837868","100838170","29","504582"
"chr1","101349100","101349209","chr1","100844331","100844438","6","504769"
"chr1","101350372","101350685","chr1","100845607","100845900","27","504765"
"chr1","101352856","101353165","chr9","106351847","106352148","59","4998991"
"chr1","101372816","101373115","chr1","100867420","100867742","41","505396"
"chr1","101377281","101377584","chr1","100871912","100872209","28","505369"
"chr1","101387974","101388255","chr1","129543506","129543782","58","28155532"
"chr1","101388852","101389152","chr9","54493586","54493890","61","46895266"
"chr1","101410254","101410526","chr1","100906661","100906942","31","503593"
"chr1","101438000","101438280","chr1","100936467","100936748","16","501533"
"chr1","101441089","101441206","chr1","100939108","100939225","5","501981"
"chr1","101510450","101510747","chr1","101008449","101008746","18","502001"
"chr1","101514614","101514877","chr1","101012596","101012859","24","502018"
"chr1","101518843","101519108","chr1","101016831","101017111","31","502012"
"chr1","101529920","101530206","chr1","101027622","101027908","19","502298"
"chr1","101555289","101555591","chr1","101055710","101056019","25","499579"
"chr1","101555839","101556125","chr1","101056268","101056554","14","499571"
"chr1","101566396","101566567","chr1","101065933","101066097","21","500463"
"chr1","101566868","101567009","chr1","101066392","101066533","12","500476"
"chr1","101579745","101580047","chr2","22459989","22460279","72","79119756"
"chr1","101582112","101582388","chr10","33033248","33033526","52","68548864"
"chr1","101588543","101588667","chr1","101084538","101084660","8","504005"
"chr1","101591137","101591424","chr1","101087452","101087756","46","503685"
"chr1","101591921","101592227","chr1","101088260","101088566","20","503661"
"chr1","101595511","101595800","chr1","101091827","101092143","41","503684"
"chr1","101598332","101598624","chr1","101094660","101094976","40","503672"
"chr1","101604381","101604498","chr1","101100795","101100912","6","503586"
"chr1","101610504","101610714","chr1","101107387","101107567","48","503117"
"chr1","101623024","101623141","chr1","101119489","101119613","15","503535"
"chr1","101627100","101627388","chr3","43983145","43983438","65","57643955"
"chr1","101628876","101628993","chr1","101125340","101125461","8","503536"
"chr1","101629919","101630044","chr1","101126387","101126513","12","503532"
"chr1","101650483","101650611","chr1","101147057","101147189","9","503426"
"chr1","101651489","101651778","chr1","101148068","101148364","16","503421"
"chr1","101660331","101660612","chr1","101156235","101156514","21","504096"
"chr1","101661045","101661344","chr4","20517123","20517422","59","81143922"
"chr1","101675920","101676211","chr1","101174327","101174604","30","501593"
"chr1","101679571","101679725","chr20","28719488","28719651","33","72960083"
"chr1","101680286","101680354","chr13","87307846","87307909","17","14372440"
"chr1","101683813","101684084","chr2","84155954","84156223","46","17527859"
"chr1","101686950","101687194","chr1","101185375","101185625","15","501575"
"chr1","101693849","101693939","chr1","99487800","99487879","24","2206049"
"chr1","101697637","101697931","chr6","129061647","129061938","52","27364010"
"chr1","101704555","101704855","chr1","101203428","101203730","25","501127"
"chr1","101706503","101706744","chr1","101205466","101205707","15","501037"
"chr1","101711043","101711364","chr1","101209879","101210228","55","501164"
"chr1","101718069","101718364","chr13","10589847","10590141","65","91128222"
"chr1","101753723","101754042","chr1","101250409","101250732","37","503314"
"chr1","101760109","101760353","chr1","101256189","101256424","27","503920"
"chr1","101765750","101765766","chr15","25969222","25969236","3","75796528"
"chr1","101765800","101766082","chr1","101261587","101261892","52","504213"
"chr1","101803511","101803812","chr1","101298972","101299264","30","504539"
"chr1","101879236","101879357","chr11","113337897","113338020","20","11458661"
"chr1","101879815","101879938","chr16","44506953","44507074","16","57372862"
"chr1","101905737","101906022","chr1","101402187","101402470","30","503550"
"chr1","101918564","101918847","chr1","77920214","77920499","57","23998350"
"chr1","102085204","102085446","chr5","167365567","167365806","65","65280363"
"chr1","102096339","102096456","chr1","101591035","101591151","9","505304"
"chr1","102227505","102227787","chr1","101722891","101723173","24","504614"
"chr1","102292965","102293262","chrX","39602549","39602842","59","62690416"
"chr1","102313320","102313594","chr11","109186448","109186735","59","6873128"
"chr1","102335305","102335551","chr1","101833093","101833340","15","502212"
"chr1","102412121","102412393","chr1","101909265","101909581","62","502856"
"chr1","102423637","102423743","chr1","101920158","101920264","9","503479"
"chr1","102424412","102424568","chr1","101920934","101921105","31","503478"
"chr1","102511463","102511745","chr1","36952015","36952281","65","65559448"
"chr1","102556788","102557077","chr1","102055609","102055881","39","501179"
"chr1","102558188","102558446","chr14","68590922","68591186","54","33967266"
"chr1","102563077","102563371","chr1","102062068","102062376","37","501009"
"chr1","102567373","102567491","chr1","102066476","102066593","6","500897"
"chr1","102578898","102579189","chr1","102078250","102078547","28","500648"
"chr1","102615681","102615969","chr1","102115373","102115660","17","500308"
"chr1","102618578","102618863","chr1","102118288","102118582","38","500290"
"chr1","102622722","102622985","chr1","102122434","102122711","38","500288"
"chr1","102633414","102633718","chr9","106607385","106607691","71","3973971"
"chr1","102633800","102634118","chr1","102132893","102133213","48","500907"
"chr1","102638894","102639085","chr2","97859544","97859728","42","4779350"
"chr1","102639382","102639513","chr3","183393084","183393212","22","80753702"
"chr1","102639540","102639834","chr1","102138672","102138967","11","500868"
"chr1","102649337","102649621","chr1","102145510","102145797","24","503827"
"chr1","102656846","102657099","chr3","36424130","36424381","57","66232716"
"chr1","102658718","102658849","chr7","121189198","121189333","21","18530480"
"chr1","102661996","102662128","chr1","102158767","102158902","9","503229"
"chr1","102662472","102662627","chr1","102159213","102159358","23","503259"
"chr1","102669103","102669395","chr1","102166367","102166676","45","502736"
"chr1","102671765","102672048","chr19","3353989","3354279","54","99317776"
"chr1","102682625","102682903","chr1","102179968","102180260","29","502657"
"chr1","102717814","102718120","chr1","102218986","102219291","21","498828"
"chr1","102864294","102864591","chr15","43687639","43687935","63","59176655"
"chr1","102882130","102882378","chr1","102409504","102409746","32","472626"
"chr1","102884206","102884514","chr1","102411879","102412183","23","472327"
"chr1","103387309","103387609","chr1","102931200","102931500","20","456109"
"chr1","103437439","103437554","chr1","102979197","102979308","6","458242"
"chr1","103469758","103470033","chr1","103009505","103009781","24","460253"
"chr1","103471378","103471654","chr1","103011140","103011450","50","460238"
"chr1","103480962","103481085","chr1","103028759","103028870","18","452203"
"chr1","103531730","103531987","chr1","103071028","103071315","49","460702"
"chr1","103618754","103619052","chr1","111340126","111340424","67","7721372"
"chr1","103644230","103644518","chr17","90323795","90324088","59","13320435"
"chr1","103746697","103746964","chr1","103258539","103258821","29","488158"
"chr1","103957727","103958021","chr1","103438935","103439224","28","518792"
"chr1","104055003","104055257","chr4","28717400","28717648","62","75337603"
"chr1","104099364","104099654","chr1","103584004","103584291","22","515360"
"chr1","104142096","104142301","chr1","103627370","103627575","17","514726"
"chr1","104278911","104279191","chr1","103761203","103761501","36","517708"
"chr1","104313035","104313327","chr1","103787673","103787982","42","525362"
"chr1","104367457","104367744","chr1","103840864","103841146","36","526593"
"chr1","104396718","104396937","chr19","7923760","7923971","50","96472958"
"chr1","104495400","104495664","chr1","103965005","103965271","25","530395"
"chr1","104541865","104542198","chr1","104008635","104008938","51","533230"
"chr1","104717693","104718008","chr1","104199286","104199592","35","518407"
"chr1","104745575","104745889","chr8","93028507","93028814","71","11717068"
"chr1","104748889","104749168","chr10","14573811","14574097","67","90175078"
"chr1","104821807","104822118","chr1","104287448","104287758","34","534359"
"chr1","105356773","105356933","chr2","55700768","55700930","35","49656005"
"chr1","105375481","105375682","chr2","96973714","96973910","55","8401767"
"chr1","105421478","105421750","chr1","104414171","104414454","38","1007307"
"chr1","105500931","105501210","chr1","104414171","104414454","28","1086760"
"chr1","105596082","105596227","chr16","29485453","29485596","36","76110629"
"chr1","105857034","105857337","chr1","188627840","188628135","62","82770806"
"chr1","105866027","105866311","chr1","104917785","104918073","26","948242"
"chr1","105916987","105917327","chr1","104968374","104968718","64","948613"
"chr1","106132563","106132871","chrX","15948249","15948557","61","90184314"
"chr1","106185226","106185518","chr1","105236053","105236361","45","949173"
"chr1","106204441","106204757","chr1","105247913","105248222","36","956528"
"chr1","106234305","106234575","chr1","105283527","105283805","31","950778"
"chr1","106422185","106422437","chr1","105464388","105464640","25","957797"
"chr1","106452340","106452622","chr16","54488636","54488919","58","51963704"
"chr1","106461045","106461278","chr1","105514076","105514309","18","946969"
"chr1","106570375","106570677","chr4","107003258","107003567","64","432883"
"chr1","106645648","106645933","chr3","131531467","131531753","67","24885819"
"chr1","106757841","106758107","chr5","37261936","37262205","64","69495905"
"chr1","106770133","106770414","chr1","105820083","105820364","25","950050"
"chr1","106778694","106778993","chr1","105875432","105875729","34","903262"
"chr1","107027598","107027923","chr2","163093184","163093508","73","56065586"
"chr1","107120668","107120796","chr1","136113020","136113157","43","28992352"
"chr1","107127317","107127598","chr9","122890269","122890544","83","15762952"
"chr1","107188019","107188166","chr1","106357247","106357391","10","830772"
"chr1","107314599","107314811","chr1","106478606","106478821","25","835993"
"chr1","107913251","107913558","chr1","107104061","107104369","31","809190"
"chr1","108144657","108144967","chr1","107340334","107340646","24","804323"
"chr1","108280108","108280413","chr1","107486146","107486454","50","793962"
"chr1","108319632","108319917","chr1","107529601","107529879","30","790031"
"chr1","108624745","108625017","chr1","107856068","107856361","45","768677"
"chr1","108706089","108706376","chr1","107930828","107931117","23","775261"
"chr1","108712979","108713195","chr19","11585537","11585747","45","97127442"
"chr1","108721536","108721826","chr1","44077655","44077953","52","64643881"
"chr1","108775451","108775614","chr8","29653012","29653169","38","79122439"
"chr1","108981200","108981318","chr1","108219499","108219617","5","761701"
"chr1","108987431","108987742","chr1","108225728","108226019","42","761703"
"chr1","109019022","109019337","chr1","108252337","108252652","25","766685"
"chr1","109284657","109284934","chr1","108518852","108519127","48","765805"
"chr1","109408601","109408893","chr1","108641288","108641588","20","767313"
"chr1","109414835","109415003","chr3","63876628","63876793","35","45538207"
"chr1","109537139","109537430","chr1","108771551","108771825","43","765588"
"chr1","109586278","109586549","chr1","108819575","108819851","19","766703"
"chr1","109602017","109602319","chr1","91833480","91833776","23","17768537"
"chr1","109640551","109640836","chr1","108874330","108874617","24","766221"
"chr1","109682784","109683077","chr7","42974617","42974909","56","66708167"
"chr1","109683786","109684085","chr1","108921193","108921477","41","762593"
"chr1","109686886","109687091","chr1","108924359","108924555","36","762527"
"chr1","109778821","109779133","chr1","200804124","200804434","60","91025303"
"chr1","110031786","110032093","chr1","109450871","109451185","31","580915"
"chr1","110079100","110079399","chr1","109503765","109504063","18","575335"
"chr1","110096357","110096475","chr1","109519048","109519166","6","577309"
"chr1","110113978","110114272","chr1","194090838","194091133","60","83976860"
"chr1","110115573","110115869","chr1","109538083","109538381","17","577490"
"chr1","110122662","110122915","chr3","156182074","156182342","60","46059412"
"chr1","110139393","110139686","chr1","109560851","109561159","34","578542"
"chr1","110147385","110147708","chr1","109568823","109569131","35","578562"
"chr1","110158447","110158759","chr1","109579560","109579867","22","578887"
"chr1","110175731","110176011","chr1","109596967","109597235","34","578764"
"chr1","110176216","110176429","chr1","109597440","109597656","17","578776"
"chr1","110192261","110192551","chr1","109612205","109612471","42","580056"
"chr1","110199530","110199799","chr1","109622522","109622791","17","577008"
"chr1","110206462","110206745","chr1","109630005","109630303","31","576457"
"chr1","110208045","110208164","chrX","49324840","49324956","23","60883205"
"chr1","110209943","110210041","chr3","39605341","39605445","18","70604602"
"chr1","110211278","110211470","chr9","86855636","86855825","50","23355642"
"chr1","110230003","110230290","chr2","84913076","84913368","65","25316927"
"chr1","110237706","110237971","chr1","109659373","109659648","38","578333"
"chr1","110246321","110246610","chr1","109667969","109668240","28","578352"
"chr1","110247907","110248136","chr1","109669557","109669786","18","578350"
"chr1","110251313","110251638","chr1","109672957","109673252","58","578356"
"chr1","110279892","110280170","chr1","109700857","109701146","38","579035"
"chr1","110285752","110286075","chr1","109706418","109706737","30","579334"
"chr1","110362141","110362428","chr1","109776379","109776650","35","585762"
"chr1","110363582","110363892","chr1","109777790","109778123","46","585792"
"chr1","110382600","110382882","chr1","109796518","109796797","30","586082"
"chr1","110392038","110392335","chr1","109806160","109806457","19","585878"
"chr1","110399570","110399855","chr1","109813257","109813546","22","586313"
"chr1","110412012","110412287","chr1","109826847","109827120","19","585165"
"chr1","110414429","110414717","chr1","109829297","109829579","27","585132"
"chr1","110416112","110416401","chr1","109831335","109831614","28","584777"
"chr1","110430571","110430857","chr7","140588016","140588306","57","30157445"
"chr1","110464297","110464588","chr1","109880158","109880453","23","584139"
"chr1","110472749","110472876","chr1","109888864","109888999","16","583885"
"chr1","110477498","110477788","chr1","109897737","109898019","26","579761"
"chr1","110486277","110486565","chr1","109908242","109908527","17","578035"
"chr1","110492600","110492899","chr1","109914544","109914821","40","578056"
"chr1","110515772","110516029","chr3","36424130","36424381","57","74091642"
"chr1","110524561","110524867","chr10","29909394","29909699","57","80615167"
"chr1","110538389","110538669","chr19","16469674","16469960","60","94068715"
"chr1","110549361","110549478","chr1","109971249","109971366","8","578112"
"chr1","110556147","110556455","chr1","109978145","109978451","22","578002"
"chr1","110561597","110561719","chr1","53704936","53705059","20","56856661"
"chr1","110565804","110566107","chr1","109987853","109988163","38","577951"
"chr1","110577447","110577645","chr1","109999814","109999999","29","577633"
"chr1","110579775","110580065","chr11","69167974","69168257","66","41411801"
"chr1","110586261","110586537","chr1","110007940","110008210","30","578321"
"chr1","110591504","110591712","chr1","110012892","110013080","46","578612"
"chr1","110591997","110592020","chr16","72124145","72124164","4","38467852"
"chr1","110592274","110592318","chr5","127510355","127510395","10","16918081"
"chr1","110597739","110597964","chr1","110017484","110017703","34","580255"
"chr1","110599514","110599764","chr1","135908287","135908521","60","25308773"
"chr1","110600786","110601085","chr5","78689579","78689868","59","31911207"
"chr1","110634184","110634478","chr1","110089690","110090001","51","544494"
"chr1","110639056","110639204","chr1","110043955","110044106","14","595101"
"chr1","110639496","110639671","chr1","110094036","110094186","37","545460"
"chr1","110648342","110648619","chr7","143963143","143963421","66","33314801"
"chr1","110651924","110652225","chr9","5743881","5744173","52","104908043"
"chr1","110662958","110663252","chr1","110117628","110117923","28","545330"
"chr1","110664805","110664988","chr1","110119679","110119860","12","545126"
"chr1","110668112","110668381","chr1","110123352","110123658","53","544760"
"chr1","110687279","110687480","chr10","73899940","73900146","44","36787339"
"chr1","110692606","110692905","chr1","110149444","110149733","30","543162"
"chr1","110696578","110696866","chr1","110153696","110153974","31","542882"
"chr1","110704034","110704333","chr9","5743881","5744173","61","104960153"
"chr1","110721999","110722290","chr1","194090838","194091133","57","83368839"
"chr1","110742869","110743145","chr1","110194418","110194687","24","548451"
"chr1","110758914","110759199","chr1","110217765","110218050","15","541149"
"chr1","110763950","110764251","chr1","110222949","110223251","15","541001"
"chr1","110767549","110767858","chr3","43574851","43575152","82","67192698"
"chr1","110787016","110787291","chr1","110246086","110246366","39","540930"
"chr1","110798643","110798937","chr1","110257669","110257968","20","540974"
"chr1","110867304","110867420","chr1","148386664","148386780","17","37519360"
"chr1","110872920","110873187","chr6","178966828","178967109","70","68093908"
"chr1","111011955","111012155","chr1","110408427","110408627","9","603528"
"chr1","111015153","111015422","chr1","110411576","110411853","27","603577"
"chr1","111023855","111024123","chr1","110420719","110420990","22","603136"
"chr1","111026423","111026713","chr1","110423273","110423575","34","603150"
"chr1","111056102","111056405","chr1","110453626","110453911","31","602476"
"chr1","111057438","111057724","chr1","110454942","110455242","28","602496"
"chr1","111076089","111076388","chr5","1994999","1995283","72","109081090"
"chr1","111077818","111078099","chr1","110484157","110484409","37","593661"
"chr1","111157983","111158096","chr1","110564110","110564224","6","593873"
"chr1","111174197","111174491","chr1","110581633","110581951","38","592564"
"chr1","111187460","111187768","chr1","110595727","110596036","20","591733"
"chr1","111214591","111214879","chr7","140588016","140588306","55","29373425"
"chr1","111246627","111246914","chr1","110655003","110655290","17","591624"
"chr1","111267277","111267563","chr1","110676903","110677191","25","590374"
"chr1","111273173","111273287","chr3","124943079","124943201","42","13669906"
"chr1","111280609","111280764","chr10","77502118","77502274","44","33778491"
"chr1","112132918","112133217","chr3","52345064","52345346","52","59787854"
"chr1","112165967","112166251","chr1","122778660","122778951","29","10612693"
"chr1","112375624","112375831","chr16","54638113","54638322","40","57737511"
"chr1","112540815","112540846","chr8","29452845","29452878","4","83087970"
"chr1","112687858","112688167","chr4","31751916","31752223","62","80935942"
"chr1","112739980","112740283","chr1","122192558","122192866","22","9452578"
"chr1","112750361","112750665","chr1","122169005","122169316","27","9418644"
"chr1","112766900","112767155","chr1","122152633","122152891","19","9385733"
"chr1","112814077","112814371","chr1","122107186","122107485","22","9293109"
"chr1","112816662","112816972","chr1","122104598","122104888","32","9287936"
"chr1","112941463","112941665","chr1","121986394","121986596","20","9044931"
"chr1","112943254","112943539","chr7","140588016","140588306","51","27644762"
"chr1","112956679","112956970","chr8","38704895","38705190","66","74251784"
"chr1","112957466","112957588","chr1","121960973","121961096","9","9003507"
"chr1","112976012","112976296","chr1","121942386","121942676","26","8966374"
"chr1","113019220","113019504","chr1","126584700","126584995","56","13565480"
"chr1","113065519","113065667","chr1","121565557","121565704","12","8500038"
"chr1","113565488","113565778","chr1","123697395","123697690","24","10131907"
"chr1","113597117","113597380","chr1","123669736","123669999","17","10072619"
"chr1","113613741","113614031","chr1","123654708","123654992","27","10040967"
"chr1","113626118","113626257","chr1","123640486","123640625","7","10014368"
"chr1","113626582","113626777","chr1","123639995","123640157","51","10013413"
"chr1","113638036","113638320","chr1","123628561","123628846","19","9990525"
"chr1","113668115","113668307","chr1","123597282","123597474","10","9929167"
"chr1","113674720","113674907","chr1","123591202","123591390","13","9916482"
"chr1","113678642","113678892","chr1","123585793","123586044","20","9907151"
"chr1","113684814","113685024","chr1","123579325","123579536","12","9894511"
"chr1","113685246","113685533","chr1","123578804","123579113","44","9893558"
"chr1","113709394","113709657","chr1","123553726","123553990","19","9844332"
"chr1","113723699","113723980","chr1","123538356","123538620","49","9814657"
"chr1","113726487","113726680","chr1","123535668","123535856","23","9809181"
"chr1","113726825","113727112","chr1","123535224","123535526","31","9808399"
"chr1","113732437","113732556","chr1","123529105","123529230","9","9796668"
"chr1","113744541","113744751","chr17","39211081","39211286","42","74533460"
"chr1","113752601","113752821","chr1","123506894","123507113","32","9754293"
"chr1","113762262","113762542","chr1","123497152","123497451","34","9734890"
"chr1","113798255","113798562","chr1","123459800","123460111","29","9661545"
"chr1","113801347","113801471","chr1","123456615","123456738","5","9655268"
"chr1","113816193","113816440","chr1","123441734","123441987","27","9625541"
"chr1","113817386","113817687","chr1","123440775","123441073","22","9623389"
"chr1","113821030","113821317","chr12","84883590","84883883","53","28937440"
"chr1","113837302","113837517","chr1","123422368","123422581","22","9585066"
"chr1","113842375","113842674","chr1","123417309","123417600","28","9574934"
"chr1","113856168","113856465","chr1","123404772","123405065","16","9548604"
"chr1","113864872","113865168","chr1","123395075","123395367","20","9530203"
"chr1","113865730","113866026","chr1","123394228","123394511","32","9528498"
"chr1","113882248","113882548","chr1","123381244","123381534","45","9498996"
"chr1","113890231","113890532","chr10","71286329","71286631","69","42603902"
"chr1","113898184","113898364","chr10","85079615","85079798","49","28818569"
"chr1","113911020","113911077","chr14","14239910","14239972","19","99671110"
"chr1","113918275","113918568","chr1","121643407","121643710","26","7725132"
"chr1","113931613","113931728","chr3","10367416","10367533","19","103564197"
"chr1","117564039","117564332","chr1","121162022","121162280","58","3597983"
"chr1","117573543","117573847","chr1","121152482","121152785","17","3578939"
"chr1","117676692","117676984","chr1","121817985","121818291","38","4141293"
"chr1","117860812","117861103","chr1","120872433","120872721","24","3011621"
"chr1","117867738","117868035","chr1","120867125","120867433","47","2999387"
"chr1","117880759","117881064","chr1","120845350","120845632","42","2964591"
"chr1","117904649","117904923","chrX","125166820","125167096","66","7262171"
"chr1","118195616","118195930","chr6","134870801","134871115","71","16675185"
"chr1","118226465","118226705","chr19","8254164","8254401","47","109972301"
"chr1","118263082","118263190","chr1","120454211","120454323","8","2191129"
"chr1","118274193","118274504","chr1","120442357","120442681","31","2168164"
"chr1","118359994","118360283","chr1","120356752","120357043","30","1996758"
"chr1","118377353","118377646","chr1","120340581","120340873","30","1963228"
"chr1","118384974","118385248","chr1","120333551","120333840","42","1948577"
"chr1","118452098","118452412","chr19","28376403","28376710","62","90075695"
"chr1","118458784","118458958","chr9","64071975","64072156","39","54386809"
"chr1","118488531","118488826","chr1","120230041","120230336","15","1741510"
"chr1","118738642","118738938","chr1","119991790","119992080","24","1253148"
"chr1","118784705","118784935","chr1","119938049","119938251","36","1153344"
"chr1","118861797","118862079","chr1","119866379","119866665","24","1004582"
"chr1","118917935","118918222","chr1","119816277","119816552","40","898342"
"chr1","119272293","119272594","chr1","119431219","119431525","26","158926"
"chr1","119307917","119308156","chr1","119395154","119395388","52","87237"
"chr1","119313754","119313931","chr20","14949715","14949895","41","104364039"
"chr1","119419357","119419651","chr1","119281579","119281871","23","137778"
"chr1","119440586","119440712","chr2","203172934","203173060","18","83732348"
"chr1","119461927","119462225","chr1","119241610","119241905","25","220317"
"chr1","119474088","119474385","chr3","42705012","42705309","52","76769076"
"chr1","119484295","119484575","chr1","119216125","119216429","40","268170"
"chr1","119491189","119491472","chr1","119211601","119211859","45","279588"
"chr1","119494663","119494962","chr1","119208134","119208433","13","286529"
"chr1","119564062","119564143","chr1","119136032","119136115","6","428030"
"chr1","119579619","119579904","chr1","119120018","119120319","34","459601"
"chr1","119632880","119633182","chr1","119007590","119007894","21","625290"
"chr1","119639909","119640201","chr1","119000292","119000583","21","639617"
"chr1","119663862","119663989","chr1","118975892","118976007","22","687970"
"chr1","119664064","119664367","chr1","118975514","118975823","34","688550"
"chr1","119754265","119754560","chr1","118876062","118876349","26","878203"
"chr1","119780088","119780304","chr1","118848741","118848957","20","931347"
"chr1","119822317","119822621","chr1","118815999","118816309","34","1006318"
"chr1","119851392","119851676","chr10","71263369","71263653","59","48588023"
"chr1","119906080","119906375","chr3","165868043","165868332","57","45961963"
"chr1","119923987","119924161","chr1","118714448","118714617","15","1209539"
"chr1","119924487","119924620","chr1","118714007","118714134","12","1210480"
"chr1","119978396","119978678","chr1","118658554","118658832","24","1319842"
"chr1","120129055","120129250","chr1","39307023","39307224","49","80822032"
"chr1","120141694","120141944","chr1","118454203","118454457","32","1687491"
"chr1","120171336","120171647","chr3","155814442","155814753","65","35643106"
"chr1","120178478","120178590","chr1","118420155","118420269","9","1758323"
"chr1","120178914","120179077","chr19","40337846","40337998","28","79841068"
"chr1","120318456","120318733","chr1","118277513","118277816","48","2040943"
"chr1","120322640","120322792","chr1","118272896","118273046","18","2049744"
"chr1","120323078","120323226","chr1","118272460","118272606","15","2050618"
"chr1","120327736","120327852","chr14","10488926","10489044","21","109838810"
"chr1","120333350","120333474","chr4","87279538","87279662","17","33053812"
"chr1","120335716","120336025","chr1","118259112","118259415","32","2076604"
"chr1","120336142","120336444","chr1","118258335","118258645","57","2077807"
"chr1","120345443","120345576","chr1","118248504","118248638","7","2096939"
"chr1","120369685","120369973","chr1","118223651","118223939","24","2146034"
"chr1","120374775","120375070","chr1","118218563","118218847","27","2156212"
"chr1","120413744","120414040","chr1","118179094","118179393","23","2234650"
"chr1","120426199","120426503","chr1","118166297","118166608","23","2259902"
"chr1","120456720","120456873","chr3","124202196","124202354","30","3745476"
"chr1","120457842","120458177","chr1","118131027","118131354","31","2326815"
"chr1","120471321","120471616","chr2","72592847","72593136","57","47878474"
"chr1","120498353","120498644","chr1","118090826","118091117","12","2407527"
"chr1","120551145","120551459","chr1","118044816","118045125","47","2506329"
"chr1","120583672","120583984","chr1","118011925","118012244","35","2571747"
"chr1","120600222","120600493","chr1","117994995","117995265","24","2605227"
"chr1","120609737","120609794","chr15","6999941","7000000","12","113609796"
"chr1","120614485","120614787","chr1","117980527","117980818","25","2633958"
"chr1","120621169","120621471","chr1","117973710","117973974","53","2647459"
"chr1","120634305","120634630","chr1","117960765","117961065","49","2673540"
"chr1","120643061","120643260","chr1","117952175","117952364","22","2690886"
"chr1","120660037","120660257","chr13","30070965","30071173","42","90589072"
"chr1","120660258","120660403","chr11","92420671","92420799","49","28239587"
"chr1","120660357","120660435","chr1","99487800","99487879","15","21172557"
"chr1","120714572","120714877","chr1","117877161","117877469","27","2837411"
"chr1","120736927","120737216","chr1","117854579","117854870","22","2882348"
"chr1","120752218","120752533","chr1","117839733","117840049","22","2912485"
"chr1","120756990","120757270","chr1","117834982","117835282","45","2922008"
"chr1","120781133","120781263","chr1","117811669","117811797","9","2969464"
"chr1","120828214","120828476","chr1","117762535","117762801","24","3065679"
"chr1","120832020","120832328","chr1","117758696","117759013","46","3073324"
"chr1","120839037","120839347","chr1","117751321","117751652","57","3087716"
"chr1","120841981","120842152","chr1","117748523","117748696","15","3093458"
"chr1","121075384","121075699","chr1","117614257","117614541","45","3461127"
"chr1","121079271","121079509","chr1","117610123","117610365","17","3469148"
"chr1","121088114","121088324","chr1","117600978","117601183","15","3487136"
"chr1","121159686","121159998","chr1","117529018","117529333","28","3630668"
"chr1","121263956","121264172","chr1","117426155","117426373","19","3837801"
"chr1","121268119","121268304","chr10","86197266","86197449","50","35070853"
"chr1","121274106","121274387","chr19","6690247","6690520","59","114583859"
"chr1","121296356","121296665","chr1","117393164","117393459","42","3903192"
"chr1","121302378","121302488","chr1","117387342","117387449","8","3915036"
"chr1","121302982","121303284","chr1","117386542","117386825","37","3916440"
"chr1","121323816","121323934","chr11","70573457","70573574","21","50750359"
"chr1","121351524","121351772","chr1","117338380","117338629","24","4013144"
"chr1","121352766","121353055","chr12","59222204","59222491","51","62130562"
"chr1","121420333","121420589","chr1","117270835","117271093","17","4149498"
"chr1","121446847","121447145","chr1","117243720","117244036","71","4203127"
"chr1","121478258","121478543","chr1","117214048","117214335","29","4264210"
"chr1","121520175","121520467","chr9","11771085","11771376","50","109749090"
"chr1","121531597","121531859","chr1","117164033","117164299","21","4367564"
"chr1","121575774","121576063","chr1","117119591","117119868","33","4456183"
"chr1","121642817","121643111","chrX","19017046","19017338","54","102625771"
"chr1","121655463","121655734","chr1","117041201","117041514","53","4614262"
"chr1","121665958","121666245","chr1","117030669","117030950","18","4635289"
"chr1","121667694","121667822","chr2","90813351","90813480","20","30854343"
"chr1","121760042","121760184","chr3","125794719","125794861","30","4034677"
"chr1","121760210","121760323","chr4","128388118","128388230","18","6627908"
"chr1","121869922","121870179","chr1","116824512","116824775","27","5045410"
"chr1","121870223","121870249","chr14","82043455","82043480","1","39826768"
"chr1","121888893","121889063","chr1","116805570","116805735","16","5083323"
"chr1","121909401","121909689","chr11","8601268","8601559","60","113308133"
"chr1","121983642","121983940","chr1","116709671","116709988","31","5273971"
"chr1","122010442","122010559","chr14","8294861","8294977","15","113715581"
"chr1","122038563","122038853","chr1","116655668","116655972","32","5382895"
"chr1","122053744","122054026","chr1","116634194","116634481","28","5419550"
"chr1","122072946","122073237","chr1","116616682","116616972","30","5456264"
"chr1","122101902","122102085","chr1","116594812","116595002","24","5507090"
"chr1","122141876","122142179","chr1","116556867","116557170","24","5585009"
"chr1","122210418","122210708","chr1","116489236","116489526","17","5721182"
"chr1","122280891","122281196","chr1","195801657","195801957","60","73520766"
"chr1","122375923","122376121","chr1","116264828","116265026","13","6111095"
"chr1","122433270","122433542","chr1","116199527","116199795","30","6233743"
"chr1","122625338","122625612","chr1","116005882","116006183","45","6619456"
"chr1","122627748","122627865","chr1","116003620","116003737","9","6624128"
"chr1","122727831","122728084","chr1","115925545","115925830","51","6802286"
"chr1","122741219","122741544","chr1","115912493","115912800","26","6828726"
"chr1","122752451","122752802","chr1","115900975","115901321","33","6851476"
"chr1","122797847","122798135","chr1","115858135","115858447","41","6939712"
"chr1","122802195","122802478","chr1","115851200","115851480","32","6950995"
"chr1","122803283","122803590","chr1","115849764","115850070","27","6953519"
"chr1","122808333","122808552","chr1","115846286","115846505","10","6962047"
"chr1","122815449","122815738","chr1","115838863","115839148","24","6976586"
"chr1","122854032","122854315","chr4","156314409","156314679","66","33460377"
"chr1","122894410","122894697","chr3","41480459","41480757","67","81413951"
"chr1","122906780","122907054","chr1","115747889","115748187","42","7158891"
"chr1","122916078","122916356","chr1","115738786","115739068","19","7177292"
"chr1","122936116","122936415","chr1","115718131","115718430","29","7217985"
"chr1","122944576","122944870","chr1","115709564","115709838","43","7235012"
"chr1","122951100","122951406","chr1","115702569","115702875","18","7248531"
"chr1","122954620","122954782","chr1","115698810","115698976","13","7255810"
"chr1","122978684","122978851","chr3","126621167","126621327","37","3642483"
"chr1","122978880","122978998","chr15","49911926","49912045","15","73066954"
"chr1","122985744","122985863","chr1","115665494","115665615","9","7320250"
"chr1","123003207","123003502","chr1","115647773","115648058","28","7355434"
"chr1","123004179","123004476","chr1","115646796","115647087","24","7357383"
"chr1","123013229","123013513","chr1","115636362","115636647","13","7376867"
"chr1","123015744","123016034","chr1","115633862","115634156","17","7381882"
"chr1","123022071","123022190","chr1","115627994","115628113","9","7394077"
"chr1","123024248","123024523","chr10","82963910","82964181","62","40060338"
"chr1","123026351","123026626","chr1","115622848","115623140","37","7403503"
"chr1","123033029","123033195","chr3","24413650","24413815","38","98619379"
"chr1","123037572","123037878","chr1","115611037","115611356","30","7426535"
"chr1","123045902","123046024","chr1","115604451","115604579","15","7441451"
"chr1","123053506","123053791","chr1","115597187","115597486","36","7456319"
"chr1","123079216","123079508","chr1","115569595","115569878","26","7509621"
"chr1","123084724","123085046","chr1","115563062","115563386","24","7521662"
"chr1","123090520","123090827","chr1","115555953","115556248","31","7534567"
"chr1","123091468","123091588","chr1","115555177","115555298","2","7536291"
"chr1","123113027","123113150","chr1","115533371","115533493","8","7579656"
"chr1","123116830","123117140","chr1","115529424","115529712","43","7587406"
"chr1","123117558","123117767","chr1","115528754","115528987","35","7588804"
"chr1","123117821","123118124","chr1","115528428","115528706","39","7589393"
"chr1","123122988","123123258","chr11","123534948","123535208","54","411960"
"chr1","123131474","123131778","chr1","115514359","115514653","24","7617115"
"chr1","123131872","123132153","chr1","115514000","115514259","64","7617872"
"chr1","123135771","123136037","chrX","67448189","67448456","61","55687582"
"chr1","123148610","123148876","chr1","115494059","115494334","37","7654551"
"chr1","123162851","123163149","chr1","115481852","115482150","20","7680999"
"chr1","123167199","123167483","chr1","115477326","115477609","23","7689873"
"chr1","123172442","123172728","chr1","115472083","115472355","41","7700359"
"chr1","123174163","123174283","chr1","115470594","115470718","13","7703569"
"chr1","123193991","123194235","chr6","87946522","87946754","66","35247469"
"chr1","123218361","123218642","chr11","123534948","123535208","72","316587"
"chr1","123228350","123228676","chr11","117366311","117366614","92","5862039"
"chr1","123263770","123263895","chr10","82790381","82790500","28","40473389"
"chr1","123304582","123304775","chr19","15032352","15032540","53","108272230"
"chr1","123375017","123375187","chr3","37880884","37881056","27","85494133"
"chr1","123403273","123403575","chr1","115251923","115252216","25","8151350"
"chr1","123476643","123476950","chr1","115183758","115184069","46","8292885"
"chr1","123528220","123528238","chr3","44466709","44466727","4","79061511"
"chr1","123528271","123528566","chr1","115131096","115131411","36","8397175"
"chr1","123581114","123581363","chr1","115077240","115077442","59","8503874"
"chr1","123595388","123595522","chr2","19918369","19918492","36","103677019"
"chr1","123595548","123595697","chr1","38146530","38146680","48","85449018"
"chr1","123609386","123609511","chr1","115048500","115048615","20","8560886"
"chr1","123610993","123611317","chr1","115046680","115047022","40","8564313"
"chr1","123652816","123653129","chr1","115001306","115001618","28","8651510"
"chr1","123659008","123659294","chr1","114995604","114995889","17","8663404"
"chr1","123663401","123663713","chr1","114990836","114991171","48","8672565"
"chr1","123684271","123684562","chr1","114967950","114968239","36","8716321"
"chr1","123684626","123684744","chr1","183892014","183892124","25","60207388"
"chr1","123688153","123688187","chr11","108344667","108344705","7","15343486"
"chr1","123704213","123704499","chr1","114945546","114945847","31","8758667"
"chr1","123712982","123713262","chr1","114935862","114936144","22","8777120"
"chr1","123723265","123723551","chr1","114923049","114923334","18","8800216"
"chr1","123735207","123735530","chr1","114910233","114910541","34","8824974"
"chr1","123760136","123760422","chr7","137856198","137856481","49","14096062"
"chr1","123762727","123763019","chr1","114876107","114876401","18","8886620"
"chr1","123767998","123768282","chr1","114870528","114870805","21","8897470"
"chr1","123770075","123770381","chr1","114868434","114868746","18","8901641"
"chr1","123778243","123778538","chr6","71739431","71739729","57","52038812"
"chr1","123786923","123787206","chr1","114849924","114850199","24","8936999"
"chr1","123788066","123788147","chr1","114848965","114849046","7","8939101"
"chr1","123788223","123788454","chr2","51041029","51041254","47","72747194"
"chr1","123791086","123791343","chr1","114845783","114846035","35","8945303"
"chr1","123800531","123800842","chr1","114835928","114836239","19","8964603"
"chr1","123815854","123815910","chr7","120364444","120364496","15","3451410"
"chr1","123827869","123828147","chr1","114808893","114809178","17","9018976"
"chr1","123850078","123850370","chr1","114785934","114786234","19","9064144"
"chr1","123850529","123850740","chr1","114785570","114785783","16","9064959"
"chr1","123854215","123854513","chr1","114781810","114782075","51","9072405"
"chr1","123856214","123856512","chr16","51030316","51030617","61","72825898"
"chr1","123861408","123861680","chr1","114775474","114775735","28","9085934"
"chr1","123871380","123871648","chr1","114765864","114766156","44","9105516"
"chr1","123872711","123873025","chr1","114764183","114764491","34","9108528"
"chr1","123887608","123887916","chr1","114748763","114749065","23","9138845"
"chr1","123893006","123893309","chr1","114742834","114743167","47","9150172"
"chr1","123894700","123894977","chr1","114741175","114741451","15","9153525"
"chr1","123901290","123901460","chr1","114734661","114734830","13","9166629"
"chr1","124697603","124697884","chr1","114006527","114006806","27","10691076"
"chr1","124719638","124719748","chr1","113979482","113979592","6","10740156"
"chr1","124738743","124739027","chr1","113957540","113957821","28","10781203"
"chr1","124760586","124760856","chr1","113931489","113931759","13","10829097"
"chr1","124802829","124802992","chr2","22647384","22647543","38","102155445"
"chr1","124803216","124803346","chr1","140031629","140031754","24","15228413"
"chr1","124811534","124811827","chr15","43687639","43687935","55","81123895"
"chr1","124868762","124869135","chr1","113820355","113820690","51","11048407"
"chr1","124894644","124894933","chr11","6437506","6437802","58","118457138"
"chr1","124945434","124945732","chr1","113750365","113750657","26","11195069"
"chr1","124950589","124950811","chr1","113743208","113743447","34","11207381"
"chr1","124969894","124970213","chr1","113721686","113722005","31","11248208"
"chr1","124978308","124978597","chr1","113714023","113714323","24","11264285"
"chr1","125007741","125008023","chr1","113684051","113684363","45","11323690"
"chr1","125015994","125016189","chr9","23514812","23515006","36","101501182"
"chr1","125032302","125032587","chr1","113659850","113660141","19","11372452"
"chr1","125037802","125038012","chr1","113655837","113656046","15","11381965"
"chr1","125080327","125080600","chr1","113612922","113613225","49","11467405"
"chr1","125083653","125083767","chr1","113609436","113609550","7","11474217"
"chr1","125084008","125084315","chr1","113608891","113609191","28","11475117"
"chr1","125084903","125085201","chr1","113608034","113608333","27","11476869"
"chr1","125086044","125086377","chr3","43652365","43652670","74","81433679"
"chr1","125089742","125090019","chr1","113603221","113603519","33","11486521"
"chr1","125096862","125097047","chr9","59337601","59337779","39","65759261"
"chr1","125098943","125099172","chr19","33928910","33929130","49","91170033"
"chr1","125101771","125102054","chr1","113590907","113591194","27","11510864"
"chr1","125124448","125124564","chr3","10367416","10367533","15","114757032"
"chr1","125149532","125149657","chr1","113545211","113545329","12","11604321"
"chr1","125154293","125154575","chr1","113534393","113534668","46","11619900"
"chr1","125161329","125161615","chr1","113526768","113527069","51","11634561"
"chr1","125174697","125175004","chr1","113513050","113513353","23","11661647"
"chr1","125176847","125177153","chr1","113510584","113510887","25","11666263"
"chr1","125196594","125196887","chr1","113490467","113490766","17","11706127"
"chr1","125203728","125204028","chr9","92162902","92163202","57","33040826"
"chr1","125214649","125214931","chr1","113461437","113461721","25","11753212"
"chr1","125215284","125215503","chr19","39028175","39028394","42","86187109"
"chr1","125238398","125238528","chr1","113438347","113438479","5","11800051"
"chr1","125265705","125265793","chr1","113410727","113410811","9","11854978"
"chr1","125272439","125272739","chr5","86867827","86868121","57","38404612"
"chr1","125274715","125275027","chr1","113401229","113401539","25","11873486"
"chr1","125276822","125277111","chr1","113398876","113399160","29","11877946"
"chr1","125309376","125309658","chr1","113365714","113365979","32","11943662"
"chr1","125322046","125322346","chr11","117366311","117366614","56","7955735"
"chr1","125345447","125345740","chr1","113328677","113328967","28","12016770"
"chr1","125655346","125655634","chr1","113002719","113003015","25","12652627"
"chr1","125817016","125817230","chr1","112839300","112839499","35","12977716"
"chr1","125892336","125892539","chr1","112764610","112764823","25","13127726"
"chr1","125930874","125930999","chr2","203169966","203170091","30","77239092"
"chr1","125940204","125940506","chr6","107165254","107165549","55","18774950"
"chr1","125987258","125987549","chr1","112669920","112670211","28","13317338"
"chr1","125998172","125998479","chr1","112658906","112659219","31","13339266"
"chr1","126125569","126125849","chr1","112532150","112532430","25","13593419"
"chr1","126136391","126136666","chr1","112518139","112518441","37","13618252"
"chr1","126153487","126153604","chr1","112501233","112501350","2","13652254"
"chr1","126178478","126178594","chr1","112478303","112478419","6","13700175"
"chr1","126200382","126200531","chr1","38658193","38658337","35","87542189"
"chr1","126204342","126204623","chr1","112446403","112446681","23","13757939"
"chr1","126213439","126213597","chr2","140183141","140183302","37","13969702"
"chr1","126225542","126225837","chr1","112424334","112424636","30","13801208"
"chr1","126233580","126233877","chr1","112416374","112416673","14","13817206"
"chr1","126251975","126252263","chr1","112397911","112398207","25","13854064"
"chr1","126272067","126272276","chr1","112377723","112377914","28","13894344"
"chr1","126482429","126482723","chr1","112222083","112222361","37","14260346"
"chr1","126533487","126533769","chr1","112170287","112170568","17","14363200"
"chr1","126586885","126587152","chr1","112116664","112116930","14","14470221"
"chr1","126754918","126755193","chr5","51322379","51322663","67","75432539"
"chr1","126793283","126793576","chr1","111922945","111923235","26","14870338"
"chr1","126881736","126882010","chr4","157020938","157021220","50","30139202"
"chr1","127072092","127072218","chr20","23393491","23393621","18","103678601"
"chr1","127077433","127077696","chr1","111643376","111643639","27","15434057"
"chr1","127084004","127084292","chr1","111636595","111636896","26","15447409"
"chr1","127155004","127155265","chr14","86888514","86888774","72","40266490"
"chr1","127232591","127232691","chr13","97979048","97979149","17","29253543"
"chr1","127265630","127265757","chr7","7312470","7312594","16","119953160"
"chr1","127276189","127276321","chr1","126373296","126373427","18","902893"
"chr1","127284313","127284546","chr1","111431278","111431501","23","15853035"
"chr1","127284732","127285017","chr1","111430814","111431102","23","15853918"
"chr1","127319180","127319476","chr1","111398578","111398886","29","15920602"
"chr1","127333506","127333805","chr1","111384404","111384696","39","15949102"
"chr1","127376837","127377128","chr1","111340126","111340424","21","16036711"
"chr1","127388669","127388985","chr8","42885230","42885538","60","84503439"
"chr1","127454633","127454912","chr1","111261918","111262214","30","16192715"
"chr1","127576938","127577243","chr1","111139910","111140218","33","16437028"
"chr1","127589224","127589276","chr3","127057405","127057452","19","531819"
"chr1","127601020","127601311","chr9","24663590","24663883","58","102937430"
"chr1","127666953","127667240","chr1","111051585","111051885","32","16615368"
"chr1","127669715","127670002","chr1","111048822","111049097","31","16620893"
"chr1","127696859","127697145","chr1","111018686","111018969","38","16678173"
"chr1","127720516","127720805","chr1","110994436","110994742","39","16726080"
"chr1","127745891","127746181","chr1","110968741","110969035","28","16777150"
"chr1","127826095","127826301","chr1","110889516","110889720","20","16936579"
"chr1","127849225","127849529","chr1","110864680","110864963","36","16984545"
"chr1","127896265","127896536","chr1","110819995","110820280","37","17076270"
"chr1","127898547","127898863","chr1","110817695","110817979","45","17080852"
"chr1","127918654","127918961","chr1","110797263","110797564","34","17121391"
"chr1","127922543","127922821","chr1","155141171","155141450","54","27218628"
"chr1","127962018","127962314","chr1","110759758","110760052","19","17202260"
"chr1","128392230","128392468","chr16","21456395","21456661","49","106935835"
"chr1","128457190","128457456","chr1","124048750","124049018","30","4408440"
"chr1","128550468","128550759","chr1","123864081","123864371","31","4686387"
"chr1","128595769","128595882","chr1","123278763","123278876","12","5317006"
"chr1","128634577","128634872","chr15","43687639","43687935","51","84946938"
"chr1","128643101","128643221","chr1","124000508","124000628","7","4642593"
"chr1","128643250","128643574","chr1","121749940","121750267","26","6893310"
"chr1","128652690","128652917","chrX","24513675","24513909","69","104139015"
"chr1","128659544","128659835","chr19","25552445","25552727","88","103107099"
"chr1","128689679","128689969","chr1","15566075","15566366","31","113123604"
"chr1","128728778","128728966","chr15","13927684","13927861","46","114801094"
"chr1","128793994","128794183","chr1","45304215","45304388","36","83489779"
"chr1","128821312","128821578","chr1","124158012","124158302","39","4663300"
"chr1","128840423","128840714","chr1","124230960","124231247","23","4609463"
"chr1","128876260","128876552","chr1","124230960","124231247","23","4645300"
"chr1","128984401","128984697","chr1","124338056","124338367","47","4646345"
"chr1","129018850","129019132","chr1","124374537","124374824","29","4644313"
"chr1","129031306","129031609","chr1","124387567","124387870","31","4643739"
"chr1","129047114","129047371","chr1","124405632","124405885","20","4641482"
"chr1","129059620","129059886","chr1","124418779","124419027","44","4640841"
"chr1","129063048","129063351","chr1","124422234","124422508","59","4640814"
"chr1","129125341","129125595","chr1","124488514","124488793","38","4636827"
"chr1","129127571","129127897","chr1","124491457","124491773","27","4636114"
"chr1","129129280","129129591","chr1","182642228","182642528","70","53512948"
"chr1","129137211","129137506","chr1","124500623","124500918","26","4636588"
"chr1","129150490","129150789","chr1","124515328","124515625","26","4635162"
"chr1","129164607","129164738","chr9","28403718","28403866","36","100760889"
"chr1","129164929","129165115","chr15","30219377","30219549","54","98945552"
"chr1","129243853","129244093","chr1","124615453","124615689","11","4628400"
"chr1","129276097","129276461","chr1","124649584","124649956","45","4626513"
"chr1","129291789","129291908","chr1","124665746","124665868","11","4626043"
"chr1","129299841","129299887","chr3","48113227","48113278","15","81186614"
"chr1","129334469","129334770","chr1","124708481","124708791","50","4625988"
"chr1","129346757","129347044","chr1","124721885","124722168","40","4624872"
"chr1","129357646","129357773","chr5","158405688","158405812","22","29048042"
"chr1","129357807","129357960","chr1","77911239","77911385","37","51446568"
"chr1","129376046","129376332","chr1","124750720","124751012","28","4625326"
"chr1","129377890","129378192","chr1","124752305","124752601","27","4625585"
"chr1","129387139","129387423","chr1","124762156","124762460","38","4624983"
"chr1","129393637","129393911","chr1","124771695","124771986","34","4621942"
"chr1","129396783","129397043","chr1","124775364","124775663","55","4621419"
"chr1","129405250","129405432","chr1","124786625","124786823","28","4618625"
"chr1","129416064","129416352","chr1","124797427","124797733","32","4618637"
"chr1","129439274","129439536","chr8","72810099","72810372","58","56629175"
"chr1","129449836","129450144","chr1","124831735","124832044","15","4618101"
"chr1","129461553","129461671","chr1","124846603","124846720","7","4614950"
"chr1","129473663","129473955","chr3","124003157","124003450","57","5470506"
"chr1","129476071","129476354","chr2","100485244","100485539","56","28990827"
"chr1","129480221","129480357","chr1","165262677","165262806","39","35782456"
"chr1","129518364","129518621","chr1","124902230","124902496","37","4616134"
"chr1","129519519","129519854","chr1","124903108","124903442","27","4616411"
"chr1","129544044","129544338","chr1","124931717","124932014","16","4612327"
"chr1","129563637","129563851","chr1","124951199","124951404","25","4612438"
"chr1","129573721","129573999","chr9","57585582","57585863","59","71988139"
"chr1","129576778","129577041","chr1","124964839","124965101","17","4611939"
"chr1","129582624","129582899","chr1","124971773","124972049","23","4610851"
"chr1","129598580","129598864","chr19","42145426","42145711","16","87453154"
"chr1","129599991","129600275","chr2","84913076","84913368","57","44686915"
"chr1","129603934","129604162","chr10","36385452","36385678","47","93218482"
"chr1","129612691","129612978","chr15","51078359","51078651","57","78534332"
"chr1","129614103","129614397","chr1","125069944","125070230","31","4544159"
"chr1","129620828","129620949","chr11","94727951","94728073","22","34892877"
"chr1","129620971","129621271","chr1","16375971","16376284","67","113245000"
"chr1","129645441","129645557","chr15","29268875","29268992","14","100376566"
"chr1","129648466","129648588","chr1","125104349","125104473","9","4544117"
"chr1","129649089","129649275","chr1","125104979","125105165","9","4544110"
"chr1","129670243","129670537","chr1","125125995","125126298","22","4544248"
"chr1","129680430","129680747","chr2","84913076","84913368","69","44767354"
"chr1","129680748","129681013","chr10","14405934","14406203","66","115274814"
"chr1","129683444","129683737","chr11","98281117","98281424","56","31402327"
"chr1","129685325","129685612","chr1","125143316","125143621","45","4542009"
"chr1","129692420","129692718","chr1","125149861","125150162","28","4542559"
"chr1","129696182","129696468","chr1","125152036","125152323","21","4544146"
"chr1","129710645","129710937","chr1","125166868","125167163","30","4543777"
"chr1","129721795","129721912","chr1","125176900","125177016","2","4544895"
"chr1","129727659","129727946","chr1","125182857","125183155","31","4544802"
"chr1","129731520","129731806","chr4","2519086","2519378","61","127212434"
"chr1","129732244","129732346","chr11","116317863","116317962","16","13414381"
"chr1","129732378","129732570","chr9","98963937","98964118","48","30768441"
"chr1","129733271","129733597","chr1","125188156","125188462","46","4545115"
"chr1","129742235","129742454","chr1","45544948","45545172","53","84197287"
"chr1","129744762","129745048","chr1","125200274","125200574","30","4544488"
"chr1","129748224","129748511","chr1","125204193","125204480","18","4544031"
"chr1","129752254","129752567","chr1","125208451","125208769","21","4543803"
"chr1","129753262","129753559","chr1","125209454","125209769","32","4543808"
"chr1","129760893","129761050","chr3","44674966","44675110","46","85085927"
"chr1","129761088","129761205","chr7","113641019","113641138","24","16120069"
"chr1","129762950","129763236","chr1","125222048","125222339","21","4540902"
"chr1","129768318","129768615","chr1","125227668","125227960","20","4540650"
"chr1","129785337","129785608","chr1","125245764","125246037","14","4539573"
"chr1","129790133","129790426","chr10","34111011","34111315","60","95679122"
"chr1","129795344","129795624","chr1","125256444","125256721","14","4538900"
"chr1","129802200","129802490","chr7","137856198","137856481","50","8053998"
"chr1","129812595","129812726","chr12","63001603","63001735","34","66810992"
"chr1","129853341","129853516","chr1","125316217","125316410","30","4537124"
"chr1","129857951","129858251","chr1","125320490","125320808","47","4537461"
"chr1","129859759","129859854","chr7","51585793","51585890","27","78273966"
"chr1","129866123","129866407","chr1","125327933","125328220","36","4538190"
"chr1","129867787","129868007","chr10","26115228","26115437","62","103752559"
"chr1","129871534","129871830","chr1","125335167","125335463","20","4536367"
"chr1","129872492","129872784","chr1","125335796","125336092","18","4536696"
"chr1","129873281","129873568","chr1","125336563","125336861","27","4536718"
"chr1","129925807","129926089","chr1","125389725","125390007","15","4536082"
"chr1","129929620","129929857","chr20","33668679","33668914","43","96260941"
"chr1","129931519","129931796","chr1","125398303","125398582","19","4533216"
"chr1","129939629","129939754","chr2","44878801","44878925","20","85060828"
"chr1","129952296","129952476","chr5","149376651","149376826","37","19424355"
"chr1","129987643","129987944","chr1","125459470","125459770","34","4528173"
"chr1","129998605","129998898","chr1","125470166","125470457","19","4528439"
"chr1","130007862","130008153","chr1","125479663","125479975","29","4528199"
"chr1","130017023","130017329","chr1","125490636","125490940","23","4526387"
"chr1","130024650","130024974","chr7","116518734","116519041","79","13505916"
"chr1","130037537","130037801","chr1","125513984","125514272","39","4523553"
"chr1","130039029","130039074","chr15","102387129","102387176","5","27651900"
"chr1","130039077","130039408","chr1","125515895","125516217","29","4523182"
"chr1","130046355","130046625","chr1","125525246","125525516","26","4521109"
"chr1","130070153","130070431","chr1","125548461","125548749","24","4521692"
"chr1","130080533","130080787","chr1","125560748","125561008","14","4519785"
"chr1","130094634","130094915","chr1","125574656","125574935","19","4519978"
"chr1","130102290","130102545","chr1","186907121","186907386","54","56804831"
"chr1","130105658","130105967","chr8","140099003","140099305","72","9993345"
"chr1","130106473","130106644","chr1","125593326","125593505","20","4513147"
"chr1","130106950","130106998","chr1","125593809","125593856","5","4513141"
"chr1","130107308","130107548","chr1","125594163","125594404","12","4513145"
"chr1","130114887","130115179","chr1","125606139","125606436","17","4508748"
"chr1","130150731","130150975","chr19","16300081","16300302","67","113850650"
"chr1","130208898","130209184","chr18","3132014","3132308","66","127076884"
"chr1","130222665","130222926","chr1","125721403","125721666","17","4501262"
"chr1","130229871","130229962","chr10","80530560","80530643","22","49699311"
"chr1","130250116","130250238","chr1","125751771","125751894","4","4498345"
"chr1","130258477","130258777","chr1","125757661","125757957","40","4500816"
"chr1","130267240","130267558","chr1","125766744","125767049","23","4500496"
"chr1","130278967","130279150","chr1","125770897","125771071","21","4508070"
"chr1","130280807","130280974","chr1","125773083","125773250","12","4507724"
"chr1","130287793","130288033","chr1","125781217","125781456","15","4506576"
"chr1","130288550","130288840","chr1","125781977","125782261","23","4506573"
"chr1","130305888","130306062","chr7","57569326","57569496","42","72736562"
"chr1","130321717","130322009","chr1","125817690","125817982","22","4504027"
"chr1","130331633","130331701","chr8","142300404","142300476","13","11968771"
"chr1","130337114","130337238","chr1","125834329","125834458","13","4502785"
"chr1","130354716","130354871","chr6","158348507","158348652","49","27993791"
"chr1","130354919","130355095","chr9","86235261","86235437","35","44119658"
"chr1","130381502","130381744","chr1","125879776","125880027","28","4501726"
"chr1","130383608","130383850","chr1","125882220","125882501","57","4501388"
"chr1","130397524","130397830","chr1","125896087","125896380","52","4501437"
"chr1","130407052","130407211","chr1","205249292","205249451","31","74842240"
"chr1","130417798","130418122","chr1","125918580","125918888","44","4499218"
"chr1","130424705","130424916","chr1","125926681","125926892","17","4498024"
"chr1","130449541","130449793","chr16","39245643","39245870","73","91203898"
"chr1","130456540","130456619","chr16","69975390","69975475","20","60481150"
"chr1","130465416","130465534","chr1","125967227","125967344","4","4498189"
"chr1","130465815","130465978","chr1","125967631","125967796","13","4498184"
"chr1","130472593","130472901","chr1","125975752","125976060","19","4496841"
"chr1","130476878","130477180","chr1","125980040","125980335","24","4496838"
"chr1","130491589","130491809","chr19","10207297","10207517","38","120284292"
"chr1","130492321","130492612","chr1","125996817","125997108","29","4495504"
"chr1","130495701","130495993","chr6","10614451","10614747","53","119881250"
"chr1","130498363","130498490","chr1","126003458","126003594","14","4494905"
"chr1","130500001","130500129","chr7","133813449","133813579","24","3313448"
"chr1","130545643","130545902","chr20","14544642","14544902","48","116001001"
"chr1","130552428","130552716","chr14","67873068","67873356","53","62679360"
"chr1","130558806","130559061","chr1","126068360","126068604","29","4490446"
"chr1","130580312","130580615","chr1","44171967","44172258","62","86408345"
"chr1","130582948","130583252","chr1","126092820","126093119","21","4490128"
"chr1","130602560","130602865","chr1","126114246","126114544","35","4488314"
"chr1","130604666","130604946","chr1","126116313","126116593","11","4488353"
"chr1","130610708","130611040","chr6","11502520","11502823","79","119108188"
"chr1","130618460","130618728","chr1","126130766","126131028","14","4487694"
"chr1","130648680","130648961","chr1","126161352","126161621","29","4487328"
"chr1","130649089","130649245","chr1","126161760","126161915","9","4487329"
"chr1","130649552","130649690","chr1","126162220","126162357","9","4487332"
"chr1","130664612","130664895","chr1","126177412","126177687","22","4487200"
"chr1","130674301","130674591","chr1","126186962","126187249","37","4487339"
"chr1","130677321","130677616","chr1","126190055","126190350","13","4487266"
"chr1","130728688","130728955","chr1","126245786","126246058","28","4482902"
"chr1","130750144","130750467","chr17","92743097","92743398","83","38007047"
"chr1","130790092","130790393","chr1","126310706","126311028","38","4479386"
"chr1","130826278","130826565","chr1","126346353","126346642","24","4479925"
"chr1","130845882","130846183","chr1","126371259","126371564","20","4474623"
"chr1","130847918","130848041","chr2","44878801","44878925","14","85969117"
"chr1","130865999","130866259","chr4","109244008","109244264","49","21621991"
"chr1","130870389","130870698","chr1","126396371","126396655","36","4474018"
"chr1","130879246","130879531","chr8","77999575","77999858","50","52879671"
"chr1","130975749","130976026","chr1","126507937","126508228","26","4467812"
"chr1","130978972","130979023","chr5","51367312","51367357","14","79611660"
"chr1","131045029","131045326","chr1","126613635","126613930","23","4431394"
"chr1","131053882","131054169","chr3","13353235","13353524","59","117700647"
"chr1","131058855","131058990","chr1","126627429","126627564","10","4431426"
"chr1","131230011","131230212","chr1","126803949","126804157","21","4426062"
"chr1","131310656","131310905","chr1","126896263","126896500","42","4414393"
"chr1","131339659","131339928","chr1","126928751","126929025","21","4410908"
"chr1","131358394","131358540","chr1","126946987","126947135","12","4411407"
"chr1","131420265","131420379","chr1","127003631","127003740","15","4416634"
"chr1","131441247","131441554","chr1","127021233","127021517","33","4420014"
"chr1","131725409","131725726","chr1","127282404","127282706","44","4443005"
"chr1","131758739","131758989","chr8","38190322","38190555","64","93568417"
"chr1","131939374","131939658","chrX","65751654","65751935","57","66187720"
"chr1","132091963","132092258","chr10","47303639","47303937","53","84788324"
"chr1","132274031","132274336","chr1","127887702","127888020","34","4386329"
"chr1","132368966","132369275","chr1","127984425","127984717","28","4384541"
"chr1","132417252","132417550","chr1","128027412","128027704","35","4389840"
"chr1","132422489","132422655","chr4","160825138","160825301","36","28402649"
"chr1","132461065","132461370","chr7","161512254","161512553","61","29051189"
"chr1","132471300","132471558","chr2","104672036","104672284","55","27799264"
"chr1","132481807","132482015","chr14","66911348","66911552","33","65570459"
"chr1","132482492","132482781","chr1","139221820","139222119","60","6739328"
"chr1","132484658","132484792","chr1","128086244","128086378","6","4398414"
"chr1","132498009","132498317","chr1","128100158","128100471","25","4397851"
"chr1","132503517","132503814","chr1","128105522","128105847","52","4397995"
"chr1","132516048","132516323","chr1","128117479","128117745","27","4398569"
"chr1","132530458","132530732","chr1","128131823","128132105","24","4398635"
"chr1","132560700","132561039","chr6","73465980","73466309","85","59094720"
"chr1","132564140","132564218","chr14","64982678","64982756","13","67581462"
"chr1","132608818","132608953","chr6","77071847","77071983","23","55536971"
"chr1","132609250","132609400","chrX","17806427","17806582","31","114802823"
"chr1","132620063","132620326","chr1","128230461","128230746","42","4389602"
"chr1","132620377","132620521","chr10","70661531","70661689","39","61958846"
"chr1","132641203","132641489","chr1","128245858","128246147","32","4395345"
"chr1","132641527","132641652","chr9","82847515","82847637","16","49794012"
"chr1","132697083","132697377","chr1","128299535","128299842","38","4397548"
"chr1","132711230","132711509","chr2","82809358","82809637","59","49901872"
"chr1","132721200","132721503","chr1","128326984","128327283","29","4394216"
"chr1","132721966","132722261","chr1","128327749","128328041","15","4394217"
"chr1","132724028","132724290","chr1","128330174","128330435","24","4393854"
"chr1","132726647","132726845","chr4","98123180","98123366","52","34603467"
"chr1","132731523","132731793","chr1","128338445","128338716","23","4393078"
"chr1","132737344","132737473","chr3","124750878","124751007","15","7986466"
"chr1","132775992","132776292","chr1","128388095","128388390","20","4387897"
"chr1","132805307","132805551","chr1","128417924","128418169","15","4387383"
"chr1","132807477","132807756","chr1","128420071","128420356","21","4387406"
"chr1","132808198","132808322","chr1","142993218","142993341","23","10185020"
"chr1","132815177","132815453","chr9","87135713","87135987","64","45679464"
"chr1","132819252","132819525","chr1","128433491","128433797","47","4385761"
"chr1","132820558","132820650","chr1","128435129","128435233","22","4385429"
"chr1","132820944","132821086","chr1","128435532","128435683","20","4385412"
"chr1","132829251","132829303","chr1","128443918","128443971","5","4385333"
"chr1","132829632","132829779","chr11","105301908","105302057","35","27527724"
"chr1","132844703","132844943","chr1","128459722","128460004","56","4384981"
"chr1","132845313","132845407","chr7","97206538","97206633","14","35638775"
"chr1","132859468","132859801","chr3","166750589","166750916","84","33891121"
"chr1","132861658","132861946","chr1","128471351","128471644","22","4390307"
"chr1","132862742","132862999","chr1","128472438","128472695","18","4390304"
"chr1","132864712","132864927","chr1","128474945","128475171","28","4389767"
"chr1","132873246","132873295","chr1","128482017","128482067","2","4391229"
"chr1","132880977","132881265","chr1","128490738","128491020","22","4390239"
"chr1","132887464","132887753","chr1","128498217","128498515","23","4389247"
"chr1","132893743","132894012","chr9","15329101","15329372","61","117564642"
"chr1","132956769","132956881","chr5","153377537","153377648","19","20420768"
"chr1","132980077","132980196","chr1","128609666","128609785","5","4370411"
"chr1","132986801","132987090","chr2","160551205","160551504","54","27564404"
"chr1","132991080","132991255","chr1","128605110","128605282","29","4385970"
"chr1","133003749","133004063","chr2","71005973","71006275","64","61997776"
"chr1","133008532","133008819","chr1","128628917","128629194","38","4379615"
"chr1","133013531","133013697","chr1","128644143","128644306","16","4369388"
"chr1","133029482","133029777","chr7","121007440","121007737","59","12022042"
"chr1","133030232","133030423","chr2","189440024","189440204","53","56409792"
"chr1","133031400","133031543","chr1","128667514","128667655","11","4363886"
"chr1","133031845","133032015","chr1","128667946","128668124","22","4363899"
"chr1","133035113","133035386","chr9","17067851","17068122","53","115967262"
"chr1","133045385","133045576","chr1","128683288","128683477","15","4362097"
"chr1","133050336","133050637","chrX","2196237","2196512","88","130854099"
"chr1","133051328","133051611","chr19","2489601","2489882","57","130561727"
"chr1","133054333","133054625","chr1","118159509","118159803","56","14894824"
"chr1","133058617","133058912","chr1","128692418","128692725","25","4366199"
"chr1","133084503","133084769","chr1","128718862","128719147","34","4365641"
"chr1","133089456","133089762","chr1","128724668","128724973","15","4364788"
"chr1","133099081","133099374","chr1","128731709","128732008","22","4367372"
"chr1","133101452","133101744","chr1","128735197","128735508","24","4366255"
"chr1","133104107","133104378","chr1","128737851","128738130","46","4366256"
"chr1","133104383","133104678","chr1","128738134","128738426","23","4366249"
"chr1","133107814","133107950","chr1","128740316","128740456","9","4367498"
"chr1","133108248","133108425","chr1","128740752","128740930","9","4367496"
"chr1","133112993","133113063","chr4","114846628","114846697","16","18266365"
"chr1","133116618","133116721","chr1","128749893","128749996","3","4366725"
"chr1","133117503","133117727","chr1","128750800","128751012","19","4366703"
"chr1","133122826","133123046","chr1","16316885","16317107","45","116805941"
"chr1","133134419","133134703","chr1","128770477","128770760","26","4363942"
"chr1","133153932","133154097","chr1","128794606","128794777","18","4359326"
"chr1","133158062","133158347","chr3","123351694","123351976","55","9806368"
"chr1","133194692","133194928","chr1","128837800","128838031","20","4356892"
"chr1","133201892","133202210","chr1","128848478","128848796","25","4353414"
"chr1","133204357","133204520","chr14","122793407","122793569","30","10410950"
"chr1","133204766","133204901","chr1","128853258","128853378","23","4351508"
"chr1","133220881","133221005","chr1","128870903","128871024","8","4349978"
"chr1","133225244","133225535","chr1","128876376","128876673","24","4348868"
"chr1","133226862","133227161","chr1","128878004","128878315","33","4348858"
"chr1","133246147","133246231","chr15","86623730","86623813","12","46622417"
"chr1","133246536","133246693","chr1","128899192","128899349","8","4347344"
"chr1","133246729","133247003","chr1","128899686","128899961","22","4347043"
"chr1","133249404","133249696","chr1","128901720","128902013","19","4347684"
"chr1","133271051","133271187","chr3","35046151","35046286","25","98224900"
"chr1","133301784","133302095","chr20","22404303","22404610","65","110897481"
"chr1","133309359","133309658","chr1","128968985","128969261","39","4340374"
"chr1","133310659","133310956","chr1","128970276","128970571","32","4340383"
"chr1","133333582","133333718","chr1","128994162","128994298","11","4339420"
"chr1","133334009","133334178","chr1","128994587","128994761","13","4339422"
"chr1","133339364","133339597","chr1","129000721","129000966","26","4338643"
"chr1","133343316","133343573","chr6","132267130","132267394","67","1076186"
"chr1","133359675","133359817","chr1","129022052","129022189","13","4337623"
"chr1","133360087","133360215","chr1","129022465","129022592","15","4337622"
"chr1","133369181","133369416","chr1","129032723","129032932","39","4336458"
"chr1","133373151","133373459","chr1","129036628","129036937","26","4336523"
"chr1","133377754","133378020","chr1","129041226","129041501","20","4336528"
"chr1","133385250","133385563","chr4","36484206","36484512","60","96901044"
"chr1","133394363","133394659","chr1","129056883","129057207","51","4337480"
"chr1","133394663","133394939","chr1","129057213","129057493","22","4337450"
"chr1","133409458","133409725","chr1","129074214","129074493","21","4335244"
"chr1","133438183","133438533","chr14","109518638","109518962","89","23919545"
"chr1","133439817","133439940","chr1","129102549","129102673","7","4337268"
"chr1","133440237","133440408","chr1","129102972","129103144","9","4337265"
"chr1","133462089","133462204","chr9","61837632","61837748","17","71624457"
"chr1","133489957","133490087","chr15","78075730","78075859","24","55414227"
"chr1","133500840","133501079","chr1","129171223","129171461","17","4329617"
"chr1","133502602","133502879","chr1","129173112","129173401","25","4329490"
"chr1","133509545","133509841","chr1","129179919","129180200","31","4329626"
"chr1","133557983","133558091","chr5","1889927","1890031","19","131668056"
"chr1","133599965","133600182","chr1","129272853","129273071","10","4327112"
"chr1","133609907","133610225","chr1","129283289","129283607","26","4326618"
"chr1","133615670","133615958","chr1","129289607","129289882","22","4326063"
"chr1","133627230","133627355","chr1","129301608","129301734","9","4325622"
"chr1","133636728","133636969","chr19","34736371","34736605","59","98900357"
"chr1","133638428","133638485","chr20","35316726","35316790","13","98321702"
"chr1","133707296","133707499","chr1","129437436","129437638","11","4269860"
"chr1","133713807","133714104","chr1","129444277","129444544","59","4269530"
"chr1","133801424","133801530","chr7","67847204","67847302","21","65954220"
"chr1","133810172","133810476","chr9","108928751","108929050","71","24881421"
"chr1","133810948","133811253","chr1","129543117","129543434","33","4267831"
"chr1","133830431","133830715","chr14","10882289","10882575","51","122948142"
"chr1","133878990","133879289","chr1","129611058","129611350","24","4267932"
"chr1","133879702","133879996","chr1","157235","157525","58","133722467"
"chr1","133888893","133889193","chr1","129622188","129622488","24","4266705"
"chr1","133890906","133891228","chr1","129624537","129624861","19","4266369"
"chr1","133892112","133892338","chr1","45544948","45545172","47","88347164"
"chr1","133893491","133893791","chr1","129627463","129627707","65","4266028"
"chr1","133897667","133897983","chr1","129634172","129634486","22","4263495"
"chr1","133925082","133925375","chr1","129660990","129661284","16","4264092"
"chr1","133935711","133935800","chr15","68180125","68180216","18","65755586"
"chr1","133945231","133945516","chr1","129680719","129681004","15","4264512"
"chr1","133979656","133979982","chr1","129715695","129716021","21","4263961"
"chr1","133989820","133990131","chr1","129725590","129725894","39","4264230"
"chr1","134017060","134017359","chr1","129753736","129754030","16","4263324"
"chr1","134023208","134023382","chr1","131444832","131445004","34","2578376"
"chr1","134023717","134023848","chr9","115052851","115052979","18","18970866"
"chr1","134025606","134025918","chr1","129762225","129762515","39","4263381"
"chr1","134047733","134047996","chr4","149626761","149627029","58","15579028"
"chr1","134053958","134054244","chr1","129793257","129793555","32","4260701"
"chr1","134056604","134056870","chr1","129795961","129796252","44","4260643"
"chr1","134102793","134102916","chr7","125926632","125926754","18","8176161"
"chr1","134115470","134115589","chr1","129858647","129858766","4","4256823"
"chr1","134116218","134116512","chr1","129859396","129859683","15","4256822"
"chr1","134136383","134136507","chr1","129880370","129880494","7","4256013"
"chr1","134173391","134173512","chr13","25546692","25546816","20","108626699"
"chr1","134174301","134174538","chr6","147224714","147224958","54","13050413"
"chr1","134174650","134174945","chr2","97689754","97690052","66","36484896"
"chr1","134211284","134211595","chr19","11467713","11468008","77","122743571"
"chr1","134252502","134252717","chr2","94580235","94580453","35","39672267"
"chr1","134267127","134267421","chr11","109624796","109625101","65","24642331"
"chr1","134281610","134281912","chr1","130022258","130022550","55","4259352"
"chr1","134300037","134300149","chr4","7114618","7114732","17","127185419"
"chr1","134306696","134306991","chr1","130051236","130051522","39","4255460"
"chr1","134308740","134308812","chr1","130053285","130053358","6","4255455"
"chr1","134315813","134316116","chr1","130060413","130060712","20","4255400"
"chr1","134320824","134321135","chr2","84913076","84913368","68","49407748"
"chr1","134323414","134323649","chr1","130067726","130067958","23","4255688"
"chr1","134342439","134342727","chr2","9789588","9789874","63","124552851"
"chr1","134350505","134350805","chr1","218247210","218247510","65","83896705"
"chr1","134352331","134352485","chr19","29318338","29318493","32","105033993"
"chr1","134354355","134354651","chr15","43687639","43687935","59","90666716"
"chr1","134357564","134357677","chr4","116585293","116585408","17","17772271"
"chr1","134358042","134358216","chr1","130095646","130095820","15","4262396"
"chr1","134358493","134358563","chr4","109565285","109565356","15","24793208"
"chr1","134378694","134378870","chr20","24073514","24073680","41","110305180"
"chr1","134379169","134379303","chr3","40637514","40637640","27","93741655"
"chr1","134386384","134386658","chr1","130123970","130124248","22","4262414"
"chr1","134386991","134387304","chr1","130124582","130124896","17","4262409"
"chr1","134392132","134392197","chr1","130130491","130130554","6","4261641"
"chr1","134411110","134411383","chr1","130149405","130149684","28","4261705"
"chr1","134435188","134435485","chr1","130173818","130174121","56","4261370"
"chr1","134443747","134444062","chr15","84456989","84457301","63","49986758"
"chr1","134454705","134454964","chr1","130196780","130197074","50","4257925"
"chr1","134465289","134465542","chr20","9019686","9019952","72","125445603"
"chr1","134474740","134475039","chr1","130218807","130219114","26","4255933"
"chr1","134486726","134487031","chr19","14661252","14661554","53","119825474"
"chr1","134487441","134487747","chr4","159090526","159090826","59","24603085"
"chr1","134490613","134490917","chr1","130231604","130231882","49","4259009"
"chr1","134491047","134491157","chr1","130232346","130232456","10","4258701"
"chr1","134496064","134496280","chr1","130241275","130241494","23","4254789"
"chr1","134502905","134503177","chr1","130251072","130251348","27","4251833"
"chr1","134511998","134512256","chr5","24821419","24821662","59","109690579"
"chr1","134516432","134516464","chr2","94525820","94525851","10","39990612"
"chr1","134516702","134516843","chr19","17044024","17044168","27","117472678"
"chr1","134528630","134528933","chr10","32184869","32185181","71","102343761"
"chr1","134529013","134529303","chr1","130279092","130279385","28","4249921"
"chr1","134529852","134530135","chr1","130280235","130280525","56","4249617"
"chr1","134541725","134542006","chr8","7979558","7979842","56","126562167"
"chr1","134551108","134551374","chr6","69305372","69305652","79","65245736"
"chr1","134552956","134553255","chr3","63863668","63863953","86","70689288"
"chr1","134599150","134599303","chrX","130729746","130729896","36","3869404"
"chr1","134600383","134600580","chr12","45631942","45632119","61","88968441"
"chr1","134600879","134601043","chr11","46598598","46598762","44","88002281"
"chr1","134602251","134602538","chr13","101287343","101287627","68","33314908"
"chr1","134603909","134604208","chr1","130348152","130348451","32","4255757"
"chr1","134604617","134604902","chr7","40295738","40296016","57","94308879"
"chr1","134609690","134609843","chr20","26377453","26377601","37","108232237"
"chr1","134610159","134610293","chr1","128086244","128086378","15","6523915"
"chr1","134614438","134614738","chr7","152336231","152336532","68","17721793"
"chr1","134625325","134625490","chr1","130267139","130267300","16","4358186"
"chr1","134634205","134634513","chr1","130276497","130276805","18","4357708"
"chr1","134636797","134637090","chr1","130279092","130279385","18","4357705"
"chr1","134882380","134882659","chr1","130290313","130290608","33","4592067"
"chr1","134896022","134896314","chr1","130305423","130305716","11","4590599"
"chr1","134896909","134897224","chr10","10625974","10626278","72","124270935"
"chr1","134900795","134901052","chr3","30387045","30387298","71","104513750"
"chr1","134906720","134906922","chr3","170352684","170352881","47","35445964"
"chr1","134907823","134908084","chr1","130313884","130314161","41","4593939"
"chr1","134911907","134912221","chr1","130318058","130318358","30","4593849"
"chr1","134919898","134920022","chr1","130325438","130325568","13","4594460"
"chr1","134926581","134926659","chr1","130333072","130333150","4","4593509"
"chr1","134926664","134926931","chr12","100069617","100069887","66","34857047"
"chr1","134928831","134929137","chr1","130336270","130336571","35","4592561"
"chr1","134937341","134937616","chr1","130346358","130346631","31","4590983"
"chr1","134937618","134937943","chr1","130346633","130346925","51","4590985"
"chr1","134938884","134939185","chr1","130348152","130348451","29","4590732"
"chr1","134939882","134940173","chr1","130349146","130349432","41","4590736"
"chr1","134943969","134944271","chr2","84913076","84913368","54","50030893"
"chr1","134959961","134960251","chr1","130368628","130368923","30","4591333"
"chr1","134964986","134965192","chr11","110176270","110176479","42","24788716"
"chr1","134969264","134969289","chr16","7649231","7649254","4","127320033"
"chr1","134969589","134969698","chr10","74922772","74922885","17","60046817"
"chr1","134971784","134972086","chr4","156601678","156601973","70","21629894"
"chr1","134972188","134972482","chr1","130375715","130376021","29","4596473"
"chr1","134974505","134974810","chr10","71675051","71675353","72","63299454"
"chr1","134974812","134975096","chr15","41433336","41433607","69","93541476"
"chr1","134977204","134977469","chr1","130378890","130379165","25","4598314"
"chr1","134987765","134988033","chr1","77866439","77866698","66","57121326"
"chr1","134995376","134995669","chr2","69678536","69678808","67","65316840"
"chr1","134997752","134998047","chr1","130401086","130401380","20","4596666"
"chr1","134998663","134999048","chr1","123464268","123464611","137","11534395"
"chr1","135022774","135023094","chr1","130423847","130424176","43","4598927"
"chr1","135029766","135030061","chr1","130431539","130431822","36","4598227"
"chr1","135044985","135045278","chr9","23116704","23116994","53","111928281"
"chr1","135055063","135055175","chr1","130463532","130463644","3","4591531"
"chr1","135058004","135058308","chr1","130466239","130466542","24","4591765"
"chr1","135058375","135058655","chr1","130466592","130466872","16","4591783"
"chr1","135067828","135068057","chr1","130477400","130477631","22","4590428"
"chr1","135068070","135068294","chr1","130477641","130477865","11","4590429"
"chr1","135085243","135085492","chr1","130494981","130495243","25","4590262"
"chr1","135095445","135095633","chr1","130507210","130507397","7","4588235"
"chr1","135098893","135099077","chrX","66216938","66217110","58","68881955"
"chr1","135101019","135101266","chr1","130513561","130513829","34","4587458"
"chr1","135130073","135130157","chr15","9397815","9397898","14","125732258"
"chr1","135138541","135138845","chr1","130552611","130552928","33","4585930"
"chr1","135194358","135194637","chr1","130617198","130617477","14","4577160"
"chr1","135195599","135195915","chr2","184405013","184405317","61","49209414"
"chr1","135228875","135228999","chr1","130654414","130654530","17","4574461"
"chr1","135258451","135258756","chr1","130690161","130690471","25","4568290"
"chr1","135281420","135281705","chr1","37126383","37126644","79","98155037"
"chr1","135282852","135283107","chr1","130717598","130717853","14","4565254"
"chr1","135288936","135289264","chr1","130723497","130723811","31","4565439"
"chr1","135291600","135291876","chr1","130726452","130726730","16","4565148"
"chr1","135304601","135304715","chr1","130739038","130739152","8","4565563"
"chr1","135314369","135314470","chr9","35056367","35056470","18","100258002"
"chr1","135337953","135338251","chr1","130774390","130774684","24","4563563"
"chr1","135348969","135349284","chr3","106646590","106646873","79","28702379"
"chr1","135352859","135353145","chr1","130788354","130788626","33","4564505"
"chr1","135379060","135379181","chr13","95288408","95288530","17","40090652"
"chr1","135379483","135379682","chr3","48070686","48070883","40","87308797"
"chr1","135393651","135393819","chr1","130828507","130828674","16","4565144"
"chr1","135394430","135394579","chr1","130828973","130829128","22","4565457"
"chr1","135408162","135408281","chr8","91980421","91980539","19","43427741"
"chr1","135428474","135428787","chr8","37312363","37312671","58","98116111"
"chr1","135448520","135448805","chr1","130890212","130890514","42","4558308"
"chr1","135451225","135451518","chr16","70224075","70224369","71","65227150"
"chr1","135473927","135474169","chr1","130918536","130918777","14","4555391"
"chr1","135485412","135485722","chr1","130931808","130932115","28","4553604"
"chr1","135493501","135493780","chr1","130939472","130939762","28","4554029"
"chr1","135495002","135495275","chr1","130941310","130941591","37","4553692"
"chr1","135521971","135522083","chr2","169096495","169096603","18","33574524"
"chr1","135526014","135526289","chr1","130970947","130971220","14","4555067"
"chr1","135542264","135542553","chr1","130989441","130989736","24","4552823"
"chr1","135546423","135546716","chr1","22392281","22392567","68","113154142"
"chr1","135547351","135547496","chr1","130993953","130994098","7","4553398"
"chr1","135624485","135624768","chr1","131073228","131073519","30","4551257"
"chr1","135645135","135645414","chr1","131094619","131094886","25","4550516"
"chr1","135678118","135678257","chr7","139993971","139994107","24","4315853"
"chr1","135678553","135678716","chr8","58449589","58449720","55","77228964"
"chr1","135688003","135688268","chr20","26516169","26516422","73","109171834"
"chr1","135722984","135723260","chr3","37042470","37042744","43","98680514"
"chr1","135744696","135745005","chr5","51350304","51350607","54","84394392"
"chr1","135755267","135755560","chr1","131214689","131214986","21","4540578"
"chr1","135773263","135773421","chr6","11605687","11605838","43","124167576"
"chr1","135785555","135785735","chr9","33505595","33505770","52","102279960"
"chr1","135799650","135799931","chr1","131259734","131259984","48","4539916"
"chr1","135830502","135830735","chr19","3207654","3207880","48","132622848"
"chr1","135876300","135876608","chr1","131340309","131340622","21","4535991"
"chr1","135926053","135926257","chr5","56540327","56540546","57","79385726"
"chr1","135963619","135963834","chr17","5229611","5229823","41","130734008"
"chr1","135971177","135971328","chr12","113689982","113690138","44","22281195"
"chr1","135987846","135988082","chr1","131462203","131462437","19","4525643"
"chr1","135992567","135992740","chr1","131466628","131466797","22","4525939"
"chr1","135993052","135993185","chr1","131467106","131467247","19","4525946"
"chr1","136036720","136036846","chr1","117811669","117811797","20","18225051"
"chr1","136061236","136061533","chr1","131540785","131541089","33","4520451"
"chr1","136116079","136116376","chr1","131594158","131594456","24","4521921"
"chr1","136118889","136119184","chr1","131596912","131597209","23","4521977"
"chr1","136138785","136138910","chr1","131616517","131616642","11","4522268"
"chr1","136139742","136140049","chr1","131617470","131617764","32","4522272"
"chr1","136146707","136147005","chr1","131624100","131624407","30","4522607"
"chr1","136170545","136170679","chr15","50987081","50987211","24","85183464"
"chr1","136174806","136175081","chr1","131653761","131654044","26","4521045"
"chr1","136215917","136216185","chr1","131694412","131694676","29","4521505"
"chr1","136221299","136221588","chr2","84913076","84913368","54","51308223"
"chr1","136249501","136249625","chr2","44878801","44878925","19","91370700"
"chr1","136257543","136257742","chr1","131733261","131733446","26","4524282"
"chr1","136374533","136374748","chr7","129682688","129682879","57","6691845"
"chr1","136506561","136506835","chr1","132009504","132009778","18","4497057"
"chr1","136530246","136530568","chr1","132145911","132146205","45","4384335"
"chr1","136559930","136560063","chr1","132104988","132105120","8","4454942"
"chr1","136623092","136623398","chr20","28618222","28618522","63","108004870"
"chr1","136645590","136645897","chr1","132145911","132146205","60","4499679"
"chr1","136821123","136821430","chr1","101094660","101094976","70","35726463"
"chr1","136886924","136887216","chr1","129543506","129543782","62","7343418"
"chr1","136946550","136946608","chr3","43700406","43700464","12","93246144"
"chr1","136946610","136946817","chr1","132441732","132441972","44","4504878"
"chr1","136964025","136964205","chr1","132458702","132458843","57","4505323"
"chr1","136964499","136964670","chr1","132459130","132459301","10","4505369"
"chr1","136965521","136965814","chr1","132460170","132460473","33","4505351"
"chr1","137073213","137073514","chr1","132560962","132561272","31","4512251"
"chr1","137116519","137116802","chr1","132601755","132602037","13","4514764"
"chr1","137243799","137244007","chr1","132731547","132731755","11","4512252"
"chr1","137272508","137272805","chr1","132760375","132760665","46","4512133"
"chr1","137333575","137333666","chr15","45918511","45918595","15","91415064"
"chr1","137333844","137334073","chr2","173850228","173850461","59","36516384"
"chr1","137405183","137405485","chr14","15765089","15765384","68","121640094"
"chr1","137564529","137564790","chr1","133107547","133107804","15","4456982"
"chr1","137693398","137693722","chr1","133254912","133255238","54","4438486"
"chr1","137798735","137799048","chr1","133369078","133369391","24","4429657"
"chr1","137967025","137967329","chr1","133536948","133537255","26","4430077"
"chr1","138190812","138191081","chr1","133748061","133748337","25","4442751"
"chr1","138217143","138217429","chr1","133775903","133776201","33","4441240"
"chr1","138232723","138233010","chr1","133791698","133791985","19","4441025"
"chr1","138514305","138514591","chr1","134069400","134069683","19","4444905"
"chr1","138529554","138529845","chr1","134083687","134083971","27","4445867"
"chr1","139145767","139145956","chr1","134600587","134600776","7","4545180"
"chr1","139150282","139150562","chr3","100842732","100843015","56","38307550"
"chr1","139211709","139212043","chr1","134667514","134667809","63","4544195"
"chr1","139228659","139228915","chr1","134685034","134685290","17","4543625"
"chr1","139230898","139231207","chr1","134687313","134687626","54","4543585"
"chr1","139279040","139279268","chr1","134735942","134736197","40","4543098"
"chr1","139281586","139281738","chr7","151036143","151036301","28","11754557"
"chr1","139289610","139289883","chr19","6103272","6103552","57","133186338"
"chr1","139301474","139301760","chr1","221758088","221758372","64","82456614"
"chr1","139301770","139302028","chr1","134761212","134761480","21","4540558"
"chr1","139304705","139304905","chr14","119508193","119508396","51","19796512"
"chr1","139319630","139319912","chr1","134779570","134779863","29","4540060"
"chr1","139431533","139431776","chr1","134891320","134891565","21","4540213"
"chr1","139431809","139432070","chr1","134891602","134891866","19","4540207"
"chr1","139459809","139460089","chr1","134918957","134919234","24","4540852"
"chr1","139503035","139503354","chr1","134962552","134962893","38","4540483"
"chr1","139507356","139507476","chr1","134967208","134967318","16","4540148"
"chr1","139507790","139507972","chr1","134967614","134967795","13","4540176"
"chr1","139512662","139512966","chr1","134971441","134971733","31","4541221"
"chr1","139521824","139522103","chr1","134980540","134980819","26","4541284"
"chr1","139528325","139528547","chr14","9346324","9346537","46","130182001"
"chr1","139599131","139599431","chr1","135054904","135055218","52","4544227"
"chr1","139715902","139716166","chr1","139026058","139026333","67","689844"
"chr1","139721802","139721975","chr1","135175763","135175936","14","4546039"
"chr1","139722274","139722320","chr16","47992313","47992358","7","91729961"
"chr1","139740603","139740909","chr1","135194660","135194968","16","4545943"
"chr1","139934392","139934702","chr1","135437295","135437621","40","4497097"
"chr1","139960284","139960401","chrX","40453814","40453932","17","99506470"
"chr1","139960427","139960593","chr20","10442766","10442936","33","129517661"
"chr1","140008917","140009199","chr2","122657386","122657672","67","17351531"
"chr1","140021814","140022081","chr13","43611572","43611828","48","96410242"
"chr1","140088993","140089230","chr1","135561243","135561491","20","4527750"
"chr1","140168402","140168597","chr1","135640878","135641079","23","4527524"
"chr1","140174523","140174821","chr1","135652989","135653280","31","4521534"
"chr1","140210104","140210411","chr15","15103527","15103833","77","125106577"
"chr1","140226753","140227050","chr1","135652989","135653280","34","4573764"
"chr1","140284766","140284881","chr1","135700619","135700737","15","4584147"
"chr1","140290068","140290364","chr3","42107648","42107937","61","98182420"
"chr1","140301243","140301459","chr1","220653461","220653668","53","80352218"
"chr1","140331401","140331526","chr4","123816659","123816775","41","16514742"
"chr1","140331747","140331889","chr3","108437811","108437952","26","31893936"
"chr1","140349864","140350052","chr10","12383797","12383992","49","127966067"
"chr1","140359527","140359817","chr3","40783093","40783379","56","99576434"
"chr1","140381288","140381582","chr1","135785522","135785813","17","4595766"
"chr1","140389885","140390145","chr3","48372961","48373220","54","92016924"
"chr1","140422590","140422666","chr3","78091570","78091637","20","62331020"
"chr1","140426707","140426822","chr1","135830720","135830835","8","4595987"
"chr1","140430824","140431039","chr1","135834735","135834928","33","4596089"
"chr1","140432245","140432426","chr10","77298190","77298362","47","63134055"
"chr1","140436811","140436900","chr1","135840707","135840797","5","4596104"
"chr1","140441616","140441911","chr1","135845843","135846146","43","4595773"
"chr1","140450492","140450786","chr1","135854731","135855023","33","4595761"
"chr1","140462035","140462303","chr1","135866339","135866614","18","4595696"
"chr1","140467080","140467266","chr3","42501498","42501683","43","97965582"
"chr1","140468349","140468464","chr20","11334614","11334727","19","129133735"
"chr1","140505926","140506237","chr1","135907253","135907564","26","4598673"
"chr1","140506645","140506875","chr1","135908287","135908521","13","4598358"
"chr1","140511255","140511549","chr1","135912720","135913020","30","4598535"
"chr1","140512753","140513051","chr1","135915185","135915482","24","4597568"
"chr1","140528133","140528436","chr1","135930511","135930814","9","4597622"
"chr1","140536222","140536446","chr20","41332824","41333057","50","99203398"
"chr1","140545643","140545753","chr1","135948837","135948947","9","4596806"
"chr1","140558847","140558970","chr7","17210704","17210823","20","123348143"
"chr1","140561238","140561449","chr5","3572498","3572706","63","136988740"
"chr1","140562004","140562087","chr4","111745324","111745405","16","28816680"
"chr1","140589138","140589423","chr1","135993768","135994048","30","4595370"
"chr1","140600076","140600377","chr1","136004935","136005231","23","4595141"
"chr1","140609036","140609382","chr4","35606171","35606500","92","105002865"
"chr1","140632235","140632539","chr1","136041859","136042161","32","4590376"
"chr1","140645539","140645819","chr1","136053595","136053894","33","4591944"
"chr1","140659774","140660062","chr12","113031131","113031415","70","27628643"
"chr1","140686965","140687268","chr1","136093675","136093984","25","4593290"
"chr1","140691076","140691351","chr1","136097451","136097733","33","4593625"
"chr1","140702801","140702912","chr1","136104544","136104654","9","4598257"
"chr1","140711962","140712097","chr1","136113020","136113157","12","4598942"
"chr1","140892386","140892508","chr1","136399719","136399839","8","4492667"
"chr1","140897357","140897619","chr1","136405051","136405325","30","4492306"
"chr1","140899439","140899571","chr1","136407469","136407603","8","4491970"
"chr1","141021943","141022251","chr1","136544675","136544977","30","4477268"
"chr1","141028222","141028518","chr1","136549718","136550007","23","4478504"
"chr1","141060544","141060851","chr2","84913076","84913368","48","56147468"
"chr1","141131297","141131591","chr1","136693674","136693966","28","4437623"
"chr1","141197315","141197605","chr1","136759623","136759941","45","4437692"
"chr1","141222772","141223087","chr1","136785174","136785499","23","4437598"
"chr1","141355129","141355383","chr1","136925795","136926045","19","4429334"
"chr1","141459659","141459776","chr1","137036469","137036585","12","4423190"
"chr1","141463373","141463648","chr1","137040217","137040506","32","4423156"
"chr1","141479235","141479531","chr1","137055447","137055748","32","4423788"
"chr1","141483637","141483902","chr19","16268441","16268703","61","125215196"
"chr1","141514944","141515240","chr1","137091082","137091378","14","4423862"
"chr1","141671207","141671314","chr2","93071221","93071331","21","48599986"
"chr1","141676929","141677236","chr1","137246700","137246999","29","4430229"
"chr1","141683472","141683673","chr1","137253576","137253774","30","4429896"
"chr1","141695095","141695213","chr11","70573457","70573574","15","71121638"
"chr1","141703781","141704105","chr1","137270381","137270704","23","4433400"
"chr1","141709833","141710124","chr19","34708068","34708366","64","107001765"
"chr1","141719198","141719484","chr1","137286653","137286933","58","4432545"
"chr1","141747175","141747348","chr15","13927684","13927861","51","127819491"
"chr1","141749808","141749925","chr1","137316785","137316901","9","4433023"
"chr1","141761010","141761205","chr1","137329837","137330033","8","4431173"
"chr1","141802173","141802288","chr1","92690108","92690223","19","49112065"
"chr1","141819054","141819216","chr1","137396375","137396543","22","4422679"
"chr1","141819482","141819622","chr1","137396806","137396947","9","4422676"
"chr1","141836326","141836611","chr1","137414295","137414618","53","4422031"
"chr1","142022838","142023124","chr3","72383698","72383983","52","69639140"
"chr1","142319558","142319641","chr1","204554665","204554748","5","62235107"
"chr1","142349532","142349816","chr1","204527995","204528279","12","62178463"
"chr1","142373086","142373339","chr20","15106502","15106735","66","127266584"
"chr1","142414042","142414371","chr1","204464451","204464778","31","62050409"
"chr1","142421654","142421910","chr1","204458927","204459183","21","62037273"
"chr1","142433099","142433216","chr1","204447476","204447593","10","62014377"
"chr1","142457847","142458118","chr1","204422571","204422848","19","61964724"
"chr1","142486810","142487123","chr14","65440978","65441292","62","77045832"
"chr1","142498962","142499272","chr1","204385431","204385744","24","61886469"
"chr1","142531801","142531923","chr2","202023671","202023792","14","59491870"
"chr1","142550987","142551261","chr1","204333031","204333314","29","61782044"
"chr1","142563170","142563447","chr1","204320890","204321175","24","61757720"
"chr1","142607523","142607837","chr1","204274946","204275266","26","61667423"
"chr1","142686040","142686352","chr1","204192802","204193084","45","61506762"
"chr1","142795893","142796179","chr1","204081546","204081839","23","61285653"
"chr1","142799355","142799445","chr11","8958514","8958608","16","133840841"
"chr1","142867828","142868053","chr1","204017426","204017651","8","61149598"
"chr1","142948648","142948946","chr3","127446837","127447136","58","15501811"
"chr1","143153521","143153784","chr1","203757464","203757730","19","60603943"
"chr1","143203122","143203408","chr1","203703855","203704149","21","60500733"
"chr1","143365389","143365650","chr8","78511957","78512224","64","64853432"
"chr1","143399290","143399578","chr15","97487237","97487526","64","45912053"
"chr1","143662335","143662541","chr10","73195715","73195925","47","70466620"
"chr1","143692846","143693150","chr1","203190220","203190518","30","59497374"
"chr1","143731077","143731394","chr1","203149585","203149907","30","59418508"
"chr1","143738657","143738780","chr1","203144479","203144601","10","59405822"
"chr1","143742140","143742444","chr1","203140669","203140978","51","59398529"
"chr1","143757384","143757650","chr1","203126058","203126346","44","59368674"
"chr1","143838683","143838974","chr1","203041641","203041932","15","59202958"
"chr1","143858316","143858610","chr1","203021641","203021938","45","59163325"
"chr1","143899403","143899609","chr1","202980429","202980627","24","59081026"
"chr1","143902271","143902572","chr1","202977624","202977908","59","59075353"
"chr1","143946506","143946795","chr4","87333067","87333363","56","56613439"
"chr1","143956773","143957041","chr1","202922173","202922442","16","58965400"
"chr1","144101076","144101193","chr1","202777184","202777300","12","58676108"
"chr1","144123202","144123497","chr1","202756242","202756538","14","58633040"
"chr1","144124570","144124856","chr1","202754552","202754836","22","58629982"
"chr1","144127282","144127506","chr1","202751892","202752109","24","58624610"
"chr1","144175485","144175624","chr1","142227617","142227753","39","1947868"
"chr1","144175653","144175773","chr14","57623342","57623465","18","86552311"
"chr1","144179280","144179394","chr11","78863129","78863241","15","65316151"
"chr1","144255183","144255508","chr1","202631718","202632038","27","58376535"
"chr1","144255736","144256038","chr1","202631194","202631486","36","58375458"
"chr1","144454122","144454397","chr1","202436504","202436810","45","57982382"
"chr1","144568187","144568318","chr1","202322677","202322808","8","57754490"
"chr1","144721487","144721743","chr1","202169190","202169460","29","57447703"
"chr1","144730731","144730853","chr1","202160039","202160161","6","57429308"
"chr1","144743124","144743400","chr1","202147527","202147789","35","57404403"
"chr1","144745116","144745397","chr1","202145521","202145799","12","57400405"
"chr1","144795806","144796096","chr1","202093807","202094109","29","57298001"
"chr1","144812994","144813299","chr11","117366311","117366614","55","27446683"
"chr1","144830072","144830321","chr1","202060297","202060550","19","57230225"
"chr1","144830662","144830933","chr1","202059680","202059966","37","57229018"
"chr1","144868903","144869138","chr1","202013347","202013583","37","57144444"
"chr1","144880531","144880801","chr1","202001170","202001449","22","57120639"
"chr1","144920190","144920282","chr1","54548397","54548480","30","90371793"
"chr1","144920573","144920734","chr8","58555586","58555743","33","86364987"
"chr1","144921516","144921802","chr9","28116760","28117047","55","116804756"
"chr1","144924187","144924482","chr3","124286205","124286493","66","20637982"
"chr1","144924702","144925009","chr1","201898185","201898489","26","56973483"
"chr1","144963368","144963659","chr1","201858088","201858385","36","56894720"
"chr1","144976023","144976279","chr1","201843921","201844195","39","56867898"
"chr1","144994349","144994669","chr1","201825261","201825596","53","56830912"
"chr1","145014217","145014521","chr1","201809429","201809740","36","56795212"
"chr1","145017430","145017553","chr1","201807953","201808084","16","56790523"
"chr1","145020648","145020933","chr1","201804253","201804543","26","56783605"
"chr1","145031248","145031527","chr1","201793126","201793414","26","56761878"
"chr1","145046212","145046483","chr3","64700297","64700569","58","80345915"
"chr1","145051596","145051861","chr1","201773236","201773500","22","56721640"
"chr1","145055924","145056039","chr1","201769078","201769200","14","56713154"
"chr1","145064011","145064233","chr1","201761845","201762066","27","56697834"
"chr1","145068109","145068505","chr7","133540661","133541031","116","11527448"
"chr1","145069474","145069597","chr1","201756496","201756615","8","56687022"
"chr1","145084774","145085089","chr1","201740825","201741112","41","56656051"
"chr1","145089765","145089993","chr3","39780463","39780719","69","105309302"
"chr1","145122180","145122298","chr1","201701051","201701168","7","56578871"
"chr1","145122592","145122755","chr19","5858474","5858626","34","139264118"
"chr1","145126665","145126949","chr1","201696341","201696650","44","56569676"
"chr1","145135040","145135247","chr1","201688374","201688562","31","56553334"
"chr1","145137541","145137812","chr1","201686220","201686491","16","56548679"
"chr1","145269493","145269782","chr1","201542693","201542986","29","56273200"
"chr1","145280448","145280500","chr1","1479515","1479562","12","143800933"
"chr1","145295869","145296171","chr1","201516680","201516977","19","56220811"
"chr1","145395293","145395592","chr1","201421921","201422205","41","56026628"
"chr1","145422758","145422968","chr1","201395169","201395382","18","55972411"
"chr1","145472757","145473034","chr16","25649696","25649962","60","119823061"
"chr1","145508225","145508490","chr3","167477786","167478063","65","21969561"
"chr1","145590876","145591187","chr1","201246415","201246728","27","55655539"
"chr1","145645683","145645969","chr1","7348808","7349096","60","138296875"
"chr1","145713879","145714171","chr1","201127023","201127335","39","55413144"
"chr1","145730478","145730801","chr20","57547766","57548078","72","88182712"
"chr1","145800248","145800555","chr5","81767624","81767928","59","64032624"
"chr1","145818477","145818767","chr1","201036470","201036762","19","55217993"
"chr1","145890800","145891111","chr3","127055604","127055907","72","18835196"
"chr1","146081413","146081683","chr1","200853962","200854256","41","54772549"
"chr1","146092618","146092912","chr1","200843402","200843688","42","54750784"
"chr1","146120459","146120767","chr1","200815035","200815357","36","54694576"
"chr1","146131302","146131593","chr1","200804124","200804434","32","54672822"
"chr1","146203969","146204152","chr1","200732157","200732341","14","54528188"
"chr1","146209552","146209685","chr1","200726314","200726447","10","54516762"
"chr1","146229600","146229880","chr1","200705905","200706193","21","54476305"
"chr1","146239869","146239918","chr14","18125282","18125330","10","128114587"
"chr1","146247762","146247992","chr1","200688804","200689040","28","54441042"
"chr1","146269816","146270101","chr1","200620309","200620594","23","54350493"
"chr1","146305401","146305514","chr1","200583686","200583798","10","54278285"
"chr1","146305814","146305990","chr1","200583219","200583395","10","54277405"
"chr1","146331230","146331520","chr1","200553775","200554059","19","54222545"
"chr1","146351064","146351287","chr8","22929396","22929609","50","123421668"
"chr1","146431374","146431668","chr1","200455814","200456108","26","54024440"
"chr1","146435116","146435371","chr1","200451810","200452063","18","54016694"
"chr1","146436092","146436387","chr1","200450803","200451095","18","54014711"
"chr1","146452804","146453076","chr1","200433827","200434104","23","53981023"
"chr1","146463566","146463740","chr15","8429087","8429254","30","138034479"
"chr1","146464042","146464183","chr12","106687311","106687455","27","39776731"
"chr1","146476163","146476383","chr1","200409533","200409761","25","53933370"
"chr1","146495919","146496010","chr10","653845","653939","21","145842074"
"chr1","146509210","146509507","chr1","200376854","200377150","25","53867644"
"chr1","146526982","146527249","chr1","200359012","200359286","30","53832030"
"chr1","146532834","146533117","chr1","195814241","195814525","57","49281407"
"chr1","146533831","146533954","chr16","40275484","40275607","24","106258347"
"chr1","146533984","146534162","chr3","156205113","156205291","37","9671129"
"chr1","146597063","146597342","chr1","200299951","200300250","50","53702888"
"chr1","146609349","146609472","chr1","200289163","200289285","5","53679814"
"chr1","146609792","146610084","chr17","4930631","4930921","52","141679161"
"chr1","146611710","146611929","chr1","200286684","200286902","17","53674974"
"chr1","146623519","146623826","chr3","43652365","43652670","61","102971154"
"chr1","146668127","146668419","chr1","200229135","200229421","25","53561008"
"chr1","146694381","146694638","chr9","63247751","63248014","59","83446630"
"chr1","146695354","146695666","chr1","200201207","200201520","21","53505853"
"chr1","146705282","146705585","chr1","200190256","200190560","23","53484974"
"chr1","146725022","146725321","chr1","200170191","200170498","42","53445169"
"chr1","146749143","146749447","chr1","200144785","200145080","27","53395642"
"chr1","146773889","146774212","chr1","200120186","200120509","22","53346297"
"chr1","146830725","146831045","chr1","200066136","200066426","50","53235411"
"chr1","146838322","146838574","chr1","200058063","200058313","25","53219741"
"chr1","146873683","146873854","chr4","118310602","118310776","27","28563081"
"chr1","146876233","146876534","chr1","200019994","200020301","25","53143761"
"chr1","146906118","146906408","chr1","199990700","199990997","31","53084582"
"chr1","146912172","146912471","chr1","199984512","199984811","29","53072340"
"chr1","147013699","147014021","chr1","199884091","199884416","24","52870392"
"chr1","147053819","147054126","chr2","71005973","71006275","56","76047846"
"chr1","147055380","147055644","chr1","199842755","199843020","17","52787375"
"chr1","147056060","147056333","chr1","199842051","199842310","23","52785991"
"chr1","147171244","147171528","chr1","199735407","199735690","20","52564163"
"chr1","147185852","147186061","chr7","153615694","153615896","42","6429842"
"chr1","147249221","147249495","chr1","199653078","199653355","20","52403857"
"chr1","147264211","147264513","chr1","199638113","199638419","41","52373902"
"chr1","147273981","147274256","chr1","199628455","199628753","44","52354474"
"chr1","147313717","147314027","chr1","199588769","199589080","28","52275052"
"chr1","147355561","147355660","chr1","199548411","199548512","10","52192850"
"chr1","147357585","147357704","chr10","87818140","87818263","19","59539445"
"chr1","147387876","147388191","chr3","42779752","42780074","65","104608124"
"chr1","147390768","147391052","chr1","199514743","199515028","24","52123975"
"chr1","147425647","147425932","chr1","199478435","199478721","22","52052788"
"chr1","147430244","147430360","chr1","199474314","199474430","3","52044070"
"chr1","147437116","147437278","chr1","199467012","199467181","20","52029896"
"chr1","147450084","147450422","chr19","14891853","14892179","88","132558231"
"chr1","147474640","147474930","chr1","199429492","199429780","19","51954852"
"chr1","147502264","147502460","chr1","199401689","199401890","13","51899425"
"chr1","147511225","147511505","chr19","18126960","18127251","60","129384265"
"chr1","147525367","147525677","chr5","97369021","97369320","77","50156346"
"chr1","147543479","147543594","chr1","199362631","199362747","9","51819152"
"chr1","147575856","147576150","chr1","199334026","199334314","30","51758170"
"chr1","147588844","147589129","chr17","58499702","58500000","67","89089142"
"chr1","147603492","147603808","chr20","4956378","4956680","66","142647114"
"chr1","147634417","147634541","chr1","199276236","199276360","5","51641819"
"chr1","147698894","147699180","chr1","199201093","199201381","15","51502199"
"chr1","147936534","147936839","chr1","198917355","198917670","37","50980821"
"chr1","147948496","147948641","chr1","21910521","21910668","30","126037975"
"chr1","147948945","147949125","chr10","14457055","14457230","40","133491890"
"chr1","147974427","147974725","chr2","84913076","84913368","53","63061351"
"chr1","148013655","148013947","chr1","198833113","198833399","38","50819458"
"chr1","148024345","148024656","chr1","198822033","198822322","53","50797688"
"chr1","148173659","148173783","chr1","198685978","198686105","8","50512319"
"chr1","148183186","148183311","chr1","24151534","24151661","18","124031652"
"chr1","148183512","148183812","chr12","77013832","77014126","60","71169680"
"chr1","148228939","148229051","chr7","69459758","69459874","22","78769181"
"chr1","148229088","148229273","chrX","93152402","93152581","36","55076686"
"chr1","148263564","148263574","chr2","159752579","159752589","2","11489015"
"chr1","148263680","148263902","chr1","198587685","198587895","35","50324005"
"chr1","148272971","148273273","chr1","198578252","198578549","30","50305281"
"chr1","148334359","148334560","chr1","198516648","198516841","21","50182289"
"chr1","148345361","148345669","chr9","71858593","71858902","73","76486768"
"chr1","148360480","148360628","chr1","198492770","198492919","10","50132290"
"chr1","148392567","148392810","chr5","139496793","139497029","60","8895774"
"chr1","148403180","148403305","chr1","198395351","198395472","14","49992171"
"chr1","148405381","148405523","chr13","44780092","44780235","31","103625289"
"chr1","148405566","148405660","chr7","153424016","153424112","16","5018450"
"chr1","148413993","148414283","chr1","198384384","198384686","31","49970391"
"chr1","148422751","148423089","chr1","198375721","198376046","36","49952970"
"chr1","148431920","148432087","chr4","18647200","18647379","49","129784720"
"chr1","148432125","148432246","chr2","165531071","165531193","19","17098946"
"chr1","148438329","148438451","chr1","198368105","198368227","4","49929776"
"chr1","148463229","148463544","chr1","198343428","198343728","32","49880199"
"chr1","148475096","148475220","chr4","171202515","171202637","22","22727419"
"chr1","148512255","148512374","chr1","198308575","198308687","10","49796320"
"chr1","148667278","148667534","chr1","198157534","198157791","19","49490256"
"chr1","148676129","148676243","chr1","198149089","198149206","9","49472960"
"chr1","148676276","148676439","chr1","198148879","198149055","26","49472603"
"chr1","148729797","148729920","chr1","198099415","198099536","5","49369618"
"chr1","148781959","148782295","chr1","198047020","198047337","43","49265061"
"chr1","148831240","148831508","chr3","72679630","72679908","66","76151610"
"chr1","148836662","148836956","chr1","197991917","197992227","39","49155255"
"chr1","148886224","148886506","chr1","197945856","197946141","27","49059632"
"chr1","148978435","148978695","chr1","197849402","197849659","21","48870967"
"chr1","148980148","148980436","chr3","165341563","165341858","65","16361415"
"chr1","149002582","149002614","chr1","81964847","81964878","6","67037735"
"chr1","149004037","149004352","chr1","197819229","197819542","21","48815192"
"chr1","149015040","149015301","chr6","100115987","100116249","53","48899053"
"chr1","149031987","149032288","chr1","197791306","197791606","51","48759319"
"chr1","149036060","149036349","chr1","197786831","197787130","30","48750771"
"chr1","149080712","149080987","chr1","197740813","197741090","22","48660101"
"chr1","149108023","149108305","chr10","31415804","31416091","70","117692219"
"chr1","149122823","149123090","chr1","197701217","197701484","22","48578394"
"chr1","149162852","149163131","chr11","36080971","36081243","59","113081881"
"chr1","149164500","149164631","chr1","197659178","197659302","15","48494678"
"chr1","149196840","149197146","chr1","197626879","197627193","26","48430039"
"chr1","149350230","149350534","chr1","197485592","197485915","42","48135362"
"chr1","149449640","149449915","chr1","197397704","197397984","27","47948064"
"chr1","149461716","149462006","chr2","45901601","45901884","62","103560115"
"chr1","149564596","149564898","chr1","197274986","197275257","50","47710390"
"chr1","149763702","149764007","chr1","197079700","197080013","22","47315998"
"chr1","149812018","149812302","chr5","40762070","40762343","78","109049948"
"chr1","149838196","149838498","chr1","197007041","197007341","16","47168845"
"chr1","149911241","149911547","chr1","196933443","196933748","30","47022202"
"chr1","149984572","149984879","chr1","196860130","196860417","51","46875558"
"chr1","150008809","150009120","chr13","48259766","48260071","56","101749043"
"chr1","150027328","150027608","chr1","196817508","196817781","51","46790180"
"chr1","150031763","150032025","chr20","53473173","53473435","55","96558590"
"chr1","150048242","150048521","chr1","196796483","196796762","11","46748241"
"chr1","150079746","150079908","chr3","39899844","39900000","38","110179902"
"chr1","150165946","150166251","chr1","196680925","196681233","23","46514979"
"chr1","150187872","150188184","chr1","196658418","196658730","17","46470546"
"chr1","150192126","150192412","chr1","196654122","196654425","36","46461996"
"chr1","150407596","150407831","chr1","196428498","196428733","17","46020902"
"chr1","150411183","150411440","chr1","196425214","196425471","18","46014031"
"chr1","150438170","150438475","chr7","154190281","154190580","60","3752111"
"chr1","150440606","150440727","chr1","206092979","206093101","21","55652373"
"chr1","150480078","150480379","chr13","106703780","106704068","66","43776298"
"chr1","150510711","150511010","chr1","196305095","196305375","41","45794384"
"chr1","150542796","150543084","chr1","196272267","196272553","17","45729471"
"chr1","150563065","150563366","chr1","196253726","196254023","25","45690661"
"chr1","150587429","150587561","chr1","117811669","117811797","22","32775760"
"chr1","150590745","150590996","chr1","196234657","196234908","12","45643912"
"chr1","150624541","150624659","chr5","49688071","49688193","25","100936470"
"chr1","150624673","150624948","chr1","196156855","196157133","21","45532182"
"chr1","150626094","150626305","chr18","12486861","12487071","44","138139233"
"chr1","150629539","150629733","chr1","34916004","34916198","46","115713535"
"chr1","150638274","150638535","chr1","196141338","196141598","17","45503064"
"chr1","150648729","150648839","chr15","35525468","35525582","11","115123261"
"chr1","150649352","150649662","chr10","32184869","32185181","60","118464483"
"chr1","150650172","150650477","chr1","196129076","196129380","21","45478904"
"chr1","150662822","150663099","chr10","51000695","51000982","55","99662127"
"chr1","150666959","150667069","chr1","196113273","196113383","5","45446314"
"chr1","150667411","150667653","chr1","196112684","196112929","34","45445273"
"chr1","150672639","150672949","chr1","196107772","196108082","15","45435133"
"chr1","150677782","150677810","chr11","96308726","96308752","3","54369056"
"chr1","150677841","150677988","chr20","52092383","52092531","28","98585458"
"chr1","150678295","150678345","chr3","7315688","7315741","9","143362607"
"chr1","150692680","150692907","chr1","196088015","196088249","16","45395335"
"chr1","150706095","150706382","chr1","196075346","196075651","39","45369251"
"chr1","150707063","150707365","chr1","196074365","196074668","14","45367302"
"chr1","150708644","150708870","chr1","196072861","196073085","27","45364217"
"chr1","150770723","150771024","chr5","127878545","127878826","83","22892178"
"chr1","150786347","150786581","chr1","195997431","195997648","30","45211084"
"chr1","150787920","150788177","chr1","195995824","195996083","23","45207904"
"chr1","150797607","150797811","chr1","195986283","195986458","41","45188676"
"chr1","150819312","150819433","chr9","121352885","121353007","18","29466427"
"chr1","150822926","150823206","chr1","195966885","195967183","29","45143959"
"chr1","150835077","150835387","chr15","7988541","7988851","52","142846536"
"chr1","150839273","150839557","chr2","108888321","108888615","68","41950952"
"chr1","150840582","150840703","chr1","195946976","195947097","13","45106394"
"chr1","150845714","150845879","chr1","195941816","195941998","23","45096102"
"chr1","150848539","150848843","chr1","195938859","195939162","17","45090320"
"chr1","150873721","150874030","chr1","195916163","195916472","31","45042442"
"chr1","150874713","150874997","chr1","195915205","195915506","38","45040492"
"chr1","150902435","150902731","chr1","195893044","195893343","28","44990609"
"chr1","150916163","150916452","chr1","195878409","195878714","50","44962246"
"chr1","150918338","150918633","chr1","195876233","195876511","36","44957895"
"chr1","150927922","150928040","chr1","195867789","195867907","6","44939867"
"chr1","150929540","150929852","chr1","195864606","195864924","29","44935066"
"chr1","150934826","150935143","chr1","195858917","195859222","32","44924091"
"chr1","150982697","150983023","chr10","14790910","14791231","75","136191787"
"chr1","150984483","150984796","chr1","195819887","195820188","30","44835404"
"chr1","150994516","150994745","chr1","195809922","195810147","14","44815406"
"chr1","150999344","150999620","chr2","124168334","124168607","57","26831010"
"chr1","151002684","151002980","chr1","195801657","195801957","15","44798973"
"chr1","151014140","151014292","chr1","195789974","195790126","8","44775834"
"chr1","151018652","151018956","chr1","195784965","195785284","34","44766313"
"chr1","151061068","151061379","chr1","195742107","195742423","33","44681039"
"chr1","151096905","151097206","chr1","195707740","195708041","28","44610835"
"chr1","151098812","151098895","chr1","195706053","195706136","2","44607241"
"chr1","151101384","151101683","chr8","65063149","65063452","52","86038235"
"chr1","151110814","151111087","chr1","195639759","195640054","38","44528945"
"chr1","151114058","151114345","chr1","195636227","195636504","34","44522169"
"chr1","151138822","151138881","chr1","142514483","142514539","8","8624339"
"chr1","151172993","151173291","chr1","195581223","195581522","19","44408230"
"chr1","151182585","151182892","chr1","195571454","195571768","47","44388869"
"chr1","151190893","151191184","chr1","195563557","195563865","38","44372664"
"chr1","151229240","151229524","chr9","98039115","98039408","62","53190125"
"chr1","151278817","151279097","chr1","195482061","195482344","32","44203244"
"chr1","151381277","151381361","chr12","10992430","10992513","21","140388847"
"chr1","151426744","151427070","chr1","195335384","195335707","29","43908640"
"chr1","151509413","151509717","chr1","195254632","195254936","12","43745219"
"chr1","151583763","151583999","chr1","195183809","195184044","22","43600046"
"chr1","151677399","151677522","chr1","195090400","195090524","8","43413001"
"chr1","151689064","151689288","chr1","195078586","195078792","45","43389522"
"chr1","151690880","151691124","chr1","195076966","195077228","40","43386086"
"chr1","151693033","151693315","chr19","35299256","35299528","63","116393777"
"chr1","151709383","151709498","chr1","195053037","195053152","6","43343654"
"chr1","151728159","151728456","chr5","86867827","86868121","55","64860332"
"chr1","151823703","151823848","chr10","28115462","28115607","28","123708241"
"chr1","151824146","151824357","chr1","195078586","195078792","47","43254440"
"chr1","151867436","151867722","chr3","42244052","42244335","56","109623384"
"chr1","152003547","152003710","chr2","61281692","61281857","43","90721855"
"chr1","152155447","152155736","chr1","194596575","194596852","26","42441128"
"chr1","152222322","152222633","chr1","44230646","44230948","61","107991676"
"chr1","152396451","152396746","chr1","194365095","194365411","47","41968644"
"chr1","152425625","152425904","chr1","43238776","43239063","56","109186849"
"chr1","152504379","152504689","chr7","4300419","4300706","69","148203960"
"chr1","152556431","152556723","chr1","92247752","92248049","59","60308679"
"chr1","152690068","152690366","chr1","194090838","194091133","21","41400770"
"chr1","152751219","152751545","chr1","194032220","194032550","17","41281001"
"chr1","152812465","152812762","chr1","193978387","193978685","23","41165922"
"chr1","152812949","152813238","chr1","193977903","193978199","23","41164954"
"chr1","152847281","152847583","chr1","193940035","193940331","25","41092754"
"chr1","152870887","152871036","chr1","193915083","193915235","10","41044196"
"chr1","152871322","152871457","chr1","193914657","193914792","5","41043335"
"chr1","152889856","152890138","chr1","193894948","193895250","36","41005092"
"chr1","152925708","152926009","chr11","47120184","47120480","63","105805524"
"chr1","152932546","152932835","chr1","193858656","193858947","21","40926110"
"chr1","152944955","152945239","chr1","193845643","193845942","31","40900688"
"chr1","152991200","152991491","chr1","193808443","193808738","20","40817243"
"chr1","152994687","152994972","chr1","193804702","193804987","25","40810015"
"chr1","153012945","153013078","chr1","205834186","205834316","34","52821241"
"chr1","153043033","153043197","chr11","8977096","8977265","30","144065937"
"chr1","153054967","153055261","chr19","8730061","8730347","62","144324906"
"chr1","153067333","153067629","chr1","193720502","193720813","27","40653169"
"chr1","153074967","153075254","chr1","193713099","193713387","14","40638132"
"chr1","153082852","153083141","chr1","193706141","193706438","29","40623289"
"chr1","153141365","153141643","chr1","193644325","193644601","26","40502960"
"chr1","153145657","153145820","chr1","193640108","193640281","17","40494451"
"chr1","153168759","153169046","chr1","193615470","193615758","23","40446711"
"chr1","153171293","153171595","chr1","193612863","193613161","20","40441570"
"chr1","153178486","153178775","chr15","14815247","14815533","65","138363239"
"chr1","153200446","153200713","chr1","193582904","193583137","53","40382458"
"chr1","153218832","153219125","chr1","193561671","193561974","25","40342839"
"chr1","153227642","153227937","chr1","193554987","193555265","32","40327345"
"chr1","153235891","153236016","chrX","30309797","30309925","21","122926094"
"chr1","153238127","153238363","chr1","193544054","193544288","20","40305927"
"chr1","153250016","153250302","chr1","94156764","94157033","84","59093252"
"chr1","153258902","153259201","chr1","193523161","193523445","34","40264259"
"chr1","153261082","153261380","chr1","193520588","193520858","56","40259506"
"chr1","153262671","153262770","chr1","198406849","198406949","33","45144178"
"chr1","153263078","153263212","chr1","193518805","193518939","6","40255727"
"chr1","153264041","153264157","chr1","193517908","193518030","12","40253867"
"chr1","153270811","153271052","chr1","193510968","193511223","57","40240157"
"chr1","153282352","153282625","chr1","24418526","24418808","66","128863826"
"chr1","153283748","153284032","chr7","138266796","138267091","66","15016952"
"chr1","153322200","153322507","chr1","193459166","193459474","14","40136966"
"chr1","153327910","153328210","chr15","43687639","43687935","53","109640271"
"chr1","153335307","153335599","chr1","193445861","193446149","30","40110554"
"chr1","153362600","153362803","chr1","193418509","193418712","7","40055909"
"chr1","153373343","153373577","chr3","120419412","120419644","43","32953931"
"chr1","153381116","153381392","chr1","193398549","193398858","54","40017433"
"chr1","153419805","153419934","chrX","49402166","49402294","25","104017639"
"chr1","153470145","153470452","chr1","193297692","193297972","44","39827547"
"chr1","153470630","153470940","chr1","193297192","193297514","30","39826562"
"chr1","153494924","153495237","chr1","193270791","193271103","20","39775867"
"chr1","153500862","153501143","chr14","35840140","35840420","59","117660722"
"chr1","153502558","153502864","chr19","6968230","6968535","59","146534328"
"chr1","153503865","153504127","chr9","58809616","58809897","59","94694249"
"chr1","153542158","153542464","chr1","193233460","193233773","30","39691302"
"chr1","153606182","153606481","chr1","193175812","193176120","19","39569630"
"chr1","153723593","153723908","chr11","109624796","109625101","69","44098797"
"chr1","153726813","153727162","chr1","193059042","193059406","37","39332229"
"chr1","153760830","153761129","chr19","1122675","1122971","62","152638155"
"chr1","153926312","153926612","chr1","192889261","192889550","38","38962949"
"chr1","153935595","153935889","chr1","192882388","192882681","19","38946793"
"chr1","153966873","153967172","chr1","192859497","192859790","25","38892624"
"chr1","153972601","153972923","chr1","192853852","192854146","39","38881251"
"chr1","153982970","153983168","chr1","192788582","192788784","21","38805612"
"chr1","153991911","153992145","chr20","27667647","27667870","61","126324264"
"chr1","154012705","154013011","chr4","158963515","158963811","67","4950810"
"chr1","154022909","154023201","chr1","192746284","192746581","28","38723375"
"chr1","154024401","154024552","chr1","192744948","192745103","10","38720547"
"chr1","154024863","154025045","chr1","192744467","192744650","18","38719604"
"chr1","154035183","154035319","chr1","192733916","192734048","12","38698733"
"chr1","154035621","154035807","chr1","192733445","192733622","27","38697824"
"chr1","154090593","154090877","chr1","192674783","192675071","17","38584190"
"chr1","154099499","154099830","chr16","41128419","41128750","113","112971080"
"chr1","154101595","154101904","chr1","192662251","192662547","42","38560656"
"chr1","154122131","154122440","chr1","192643385","192643702","25","38521254"
"chr1","154128788","154129005","chr1","192636435","192636641","29","38507647"
"chr1","154129562","154129862","chr1","192635565","192635866","19","38506003"
"chr1","154139436","154139722","chr1","192626138","192626418","23","38486702"
"chr1","154161638","154161933","chr7","140588016","140588306","52","13573622"
"chr1","154165216","154165350","chr1","192592592","192592721","17","38427376"
"chr1","154176568","154176741","chr1","161689226","161689400","34","7512658"
"chr1","154177046","154177193","chr3","5152152","5152298","26","149024894"
"chr1","154188797","154189039","chr1","192569730","192569978","29","38380933"
"chr1","154359041","154359267","chr1","192397096","192397312","27","38038055"
"chr1","154359479","154359597","chr1","192396768","192396878","26","38037289"
"chr1","154359695","154359814","chr1","192396596","192396728","22","38036901"
"chr1","154390815","154391093","chr1","192367321","192367623","44","37976506"
"chr1","154531721","154532011","chr1","192236127","192236405","28","37704406"
"chr1","154570228","154570393","chr1","192196679","192196844","8","37626451"
"chr1","154663011","154663330","chr1","192110762","192111056","40","37447751"
"chr1","154681456","154681622","chr1","192092504","192092658","18","37411048"
"chr1","154719601","154719883","chr6","17609699","17609979","52","137109902"
"chr1","154822316","154822609","chr1","191949331","191949612","30","37127015"
"chr1","154853610","154853887","chr1","191918374","191918658","29","37064764"
"chr1","154877426","154877710","chr1","191894798","191895082","21","37017372"
"chr1","154947379","154947680","chr1","191816971","191817292","50","36869592"
"chr1","154978359","154978656","chr1","191786010","191786305","17","36807651"
"chr1","154980180","154980473","chr8","103496997","103497290","67","51483183"
"chr1","155029297","155029608","chr1","191730760","191731073","19","36701463"
"chr1","155058476","155058761","chr1","191702128","191702414","18","36643652"
"chr1","155066154","155066414","chr1","191694176","191694436","18","36628022"
"chr1","155069943","155070221","chr1","191690399","191690678","12","36620456"
"chr1","155140322","155140583","chr2","136481485","136481749","58","18658837"
"chr1","155163640","155163934","chr1","191593830","191594121","39","36430190"
"chr1","155190878","155191153","chr1","191564163","191564439","19","36373285"
"chr1","155249910","155250094","chr1","191518008","191518188","24","36268098"
"chr1","155267556","155267842","chr5","78689579","78689868","59","76577977"
"chr1","155289749","155290016","chr1","191480826","191481094","19","36191077"
"chr1","155337297","155337606","chr12","84857242","84857542","80","70480055"
"chr1","155360039","155360351","chr1","191411631","191411947","32","36051592"
"chr1","155379639","155379946","chr1","191390493","191390806","25","36010854"
"chr1","155384994","155385288","chr1","191385114","191385405","36","36000120"
"chr1","155390388","155390668","chr1","191379108","191379388","16","35988720"
"chr1","155394728","155395021","chr1","191374625","191374920","16","35979897"
"chr1","155415408","155415629","chr1","191354075","191354296","20","35938667"
"chr1","155441045","155441357","chr1","191328390","191328697","27","35887345"
"chr1","155446493","155446807","chr1","191323018","191323338","30","35876525"
"chr1","155456416","155456717","chr6","135606116","135606419","63","19850300"
"chr1","155457458","155457589","chr7","68824427","68824555","17","86633031"
"chr1","155481421","155481723","chr7","92955493","92955791","57","62525928"
"chr1","155486641","155486943","chr1","191280461","191280766","20","35793820"
"chr1","155584713","155584966","chr1","191184179","191184428","13","35599466"
"chr1","155585007","155585036","chr1","191184112","191184142","3","35599105"
"chr1","155648477","155648729","chr4","159403614","159403872","64","3755137"
"chr1","155660031","155660333","chr7","92486080","92486376","59","63173951"
"chr1","155674945","155675241","chr1","191118070","191118373","27","35443125"
"chr1","155796833","155797108","chr1","190995055","190995329","18","35198222"
"chr1","155843492","155843773","chr1","190945734","190946037","36","35102242"
"chr1","155930504","155930696","chr1","190860910","190861096","27","34930406"
"chr1","156018663","156018971","chr1","190766501","190766824","46","34747838"
"chr1","156026997","156027302","chr1","190757453","190757766","28","34730456"
"chr1","156143533","156143584","chr1","190640889","190640940","2","34497356"
"chr1","156283317","156283614","chr1","190498891","190499201","39","34215574"
"chr1","156296686","156296978","chr1","190485542","190485813","47","34188856"
"chr1","156608196","156608314","chr11","122944965","122945076","28","33663231"
"chr1","156703254","156703564","chr1","190080762","190081071","25","33377508"
"chr1","156823105","156823395","chr13","47263576","47263856","62","109559529"
"chr1","156937238","156937548","chr1","189846811","189847105","54","32909573"
"chr1","157084502","157084775","chr1","189706253","189706526","8","32621751"
"chr1","157172253","157172562","chr1","189577660","189577974","22","32405407"
"chr1","157188269","157188565","chr1","189561431","189561723","29","32373162"
"chr1","157219995","157220312","chr1","189530628","189530945","23","32310633"
"chr1","157249696","157249790","chr1","189500959","189501059","14","32251263"
"chr1","157257613","157257916","chr1","189450777","189451085","23","32193164"
"chr1","157273651","157273938","chr3","127624824","127625104","63","29648827"
"chr1","157274806","157275096","chr1","189434480","189434769","27","32159674"
"chr1","157275290","157275579","chr1","189433981","189434290","36","32158691"
"chr1","157290308","157290616","chr1","189418344","189418642","26","32128036"
"chr1","157320009","157320123","chr16","50167663","50167777","19","107152346"
"chr1","157337745","157338032","chr1","189369279","189369578","31","32031534"
"chr1","157360663","157360946","chr1","189346243","189346545","40","31985580"
"chr1","157383284","157383557","chr1","189324664","189324948","34","31941380"
"chr1","157393443","157393762","chr1","189308971","189309293","24","31915528"
"chr1","157420638","157420950","chr1","189275759","189276038","58","31855121"
"chr1","157516886","157517054","chrX","113320960","113321125","26","44195926"
"chr1","157523094","157523406","chr1","189186944","189187252","24","31663850"
"chr1","157543319","157543617","chr1","189167062","189167351","27","31623743"
"chr1","157552119","157552312","chr1","189160630","189160823","7","31608511"
"chr1","157595100","157595412","chr1","189115864","189116155","40","31520764"
"chr1","157616431","157616754","chr3","123585503","123585819","70","34030928"
"chr1","157681568","157681872","chr1","189028774","189029053","36","31347206"
"chr1","157712525","157712635","chr2","43752839","43752949","14","113959686"
"chr1","157730456","157730634","chr1","188980724","188980901","7","31250268"
"chr1","157743807","157743924","chr1","188967426","188967543","6","31223619"
"chr1","157780248","157780345","chr4","87524216","87524313","14","70256032"
"chr1","157825988","157826306","chr4","15858894","15859211","60","141967094"
"chr1","157827804","157828060","chr1","188873437","188873698","24","31045633"
"chr1","157870401","157870449","chr3","17904833","17904869","17","139965568"
"chr1","157903714","157903966","chr1","188795337","188795612","52","30891623"
"chr1","157963078","157963266","chr1","188691722","188691907","27","30728644"
"chr1","157981065","157981375","chr1","188676682","188677009","33","30695617"
"chr1","158004124","158004384","chr1","188647459","188647713","20","30643335"
"chr1","158017757","158018068","chr1","188633248","188633548","37","30615491"
"chr1","158028995","158029297","chr1","188627840","188628135","24","30598845"
"chr1","158037227","158037513","chr1","188619656","188619927","34","30582429"
"chr1","158127770","158128081","chr1","188530204","188530518","24","30402434"
"chr1","158161800","158162083","chr1","188498681","188498964","10","30336881"
"chr1","158167888","158168003","chr1","188493066","188493186","11","30325178"
"chr1","158174766","158175062","chr1","188492003","188492299","24","30317237"
"chr1","158176654","158176948","chr1","188490261","188490555","18","30313607"
"chr1","158218987","158219284","chr1","188440873","188441147","51","30221886"
"chr1","158252185","158252484","chr1","188408037","188408329","29","30155852"
"chr1","158291389","158291506","chr1","188368750","188368867","6","30077361"
"chr1","158295452","158295561","chr7","105998581","105998695","22","52296871"
"chr1","158320814","158321105","chr1","188339862","188340172","35","30019048"
"chr1","158340554","158340818","chr1","188319169","188319460","52","29978615"
"chr1","158342268","158342516","chr20","23601790","23602040","57","134740478"
"chr1","158347871","158347987","chr1","188314116","188314233","6","29966245"
"chr1","158371659","158371960","chr1","188289402","188289710","23","29917743"
"chr1","158383418","158383720","chr1","188278575","188278877","23","29895157"
"chr1","158385290","158385573","chr19","16025887","16026159","65","142359403"
"chr1","158411658","158411944","chr7","71549523","71549809","55","86862135"
"chr1","158419352","158419639","chr1","188244531","188244815","24","29825179"
"chr1","158441106","158441277","chr9","81154280","81154445","34","77286826"
"chr1","158443040","158443339","chr1","188228877","188229173","30","29785837"
"chr1","158482053","158482337","chr1","188188022","188188297","26","29705969"
"chr1","158485516","158485652","chr3","183393084","183393212","26","24907568"
"chr1","158488828","158489118","chr5","8246617","8246904","60","150242211"
"chr1","158492782","158493096","chr1","188177466","188177783","36","29684684"
"chr1","158504306","158504423","chrX","8701186","8701303","13","149803120"
"chr1","158554928","158555222","chr1","188111652","188111943","21","29556724"
"chr1","158556885","158557074","chr6","172252298","172252482","39","13695413"
"chr1","158580469","158580724","chr11","123534948","123535208","70","35045521"
"chr1","158620432","158620681","chr1","187964559","187964809","23","29344127"
"chr1","158624511","158624568","chr3","40170472","40170533","13","118454039"
"chr1","158657212","158657518","chr1","187933924","187934225","36","29276712"
"chr1","158677573","158677836","chr9","11830359","11830635","57","146847214"
"chr1","158690453","158690734","chr1","187903591","187903876","25","29213138"
"chr1","158702144","158702453","chr1","187888727","187889035","27","29186583"
"chr1","158734494","158734799","chr1","187855044","187855349","30","29120550"
"chr1","158742406","158742679","chr1","187847683","187847988","45","29105277"
"chr1","158753597","158753907","chr1","187835883","187836180","34","29082286"
"chr1","158789014","158789291","chr1","187800578","187800870","38","29011564"
"chr1","158793011","158793314","chr1","187796563","187796868","30","29003552"
"chr1","158794370","158794451","chr1","187795416","187795494","10","29001046"
"chr1","158797672","158797954","chrX","104727024","104727301","61","54070648"
"chr1","158863787","158864084","chr1","187716450","187716750","23","28852663"
"chr1","158901472","158901707","chr1","187678973","187679214","19","28777501"
"chr1","158930399","158930694","chr1","187650720","187650989","48","28720321"
"chr1","158984721","158984979","chr13","74419012","74419271","59","84565709"
"chr1","159005549","159005852","chr1","187582205","187582494","27","28576656"
"chr1","159019886","159020155","chr1","187566415","187566684","9","28546529"
"chr1","159021815","159022120","chr1","187564452","187564762","22","28542637"
"chr1","159022191","159022479","chr1","187564086","187564369","31","28541895"
"chr1","159035476","159035641","chr19","13103586","13103743","30","145931890"
"chr1","159038513","159038820","chr1","187544433","187544734","21","28505920"
"chr1","159049513","159049698","chr15","6759334","6759497","54","152290179"
"chr1","159060136","159060203","chr5","183821091","183821159","13","24760955"
"chr1","159107084","159107365","chr1","187476369","187476651","18","28369285"
"chr1","159132485","159132777","chr1","187450501","187450794","26","28318016"
"chr1","159135905","159136214","chr1","187447569","187447879","18","28311664"
"chr1","159142927","159143207","chr3","167477786","167478063","50","8334859"
"chr1","159171823","159172140","chr1","187409209","187409526","25","28237386"
"chr1","159179225","159179539","chr1","187401553","187401861","18","28222328"
"chr1","159188594","159188899","chr1","187392466","187392779","29","28203872"
"chr1","159201669","159201780","chr1","187379275","187379394","15","28177606"
"chr1","159209981","159210268","chr1","187371242","187371523","23","28161261"
"chr1","159221513","159221814","chr1","187359910","187360217","31","28138397"
"chr1","159226649","159226905","chr16","54088325","54088579","54","105138324"
"chr1","159243510","159243700","chr20","53399339","53399533","38","105844171"
"chr1","159245796","159245975","chr1","187334824","187335000","14","28089028"
"chr1","159251758","159252081","chr1","187329027","187329358","34","28077269"
"chr1","159259102","159259389","chr1","187321745","187322031","11","28062643"
"chr1","159282875","159283178","chr1","187297625","187297914","36","28014750"
"chr1","159293670","159293949","chr1","187287311","187287608","51","27993641"
"chr1","159300606","159300904","chr1","187280734","187281032","21","27980128"
"chr1","159304352","159304657","chr2","107411533","107411833","50","51892819"
"chr1","159307794","159308095","chr13","71248269","71248571","53","88059525"
"chr1","159323129","159323446","chr16","4516034","4516344","62","154807095"
"chr1","159366855","159367119","chr7","21590878","21591154","63","137775977"
"chr1","159370344","159370583","chr1","187209281","187209524","15","27838937"
"chr1","159371223","159371523","chr9","99101491","99101790","51","60269732"
"chr1","159373025","159373330","chr8","65063149","65063452","60","94309876"
"chr1","159401610","159401838","chr16","19119556","19119785","47","140282054"
"chr1","159421233","159421489","chr1","187158151","187158418","34","27736918"
"chr1","159444669","159444950","chr1","187134791","187135095","44","27690122"
"chr1","159446926","159447229","chr1","187132202","187132504","24","27685276"
"chr1","159450007","159450279","chr1","187128774","187129049","16","27678767"
"chr1","159454544","159454820","chr1","187124277","187124579","48","27669733"
"chr1","159471583","159471842","chr1","187111290","187111541","26","27639707"
"chr1","159489522","159489838","chr1","187090811","187091128","32","27601289"
"chr1","159547935","159548067","chr17","54442955","54443088","19","105104980"
"chr1","159571821","159572099","chr1","187014558","187014856","46","27442737"
"chr1","159634337","159634627","chr1","186949066","186949360","15","27314729"
"chr1","159637792","159638093","chr3","127162429","127162726","57","32475363"
"chr1","159647518","159647816","chr1","186241137","186241432","59","26593619"
"chr1","159673011","159673276","chr1","186907121","186907386","10","27234110"
"chr1","159687597","159687838","chr1","186890032","186890277","15","27202435"
"chr1","159689753","159689934","chr14","112778274","112778452","36","46911479"
"chr1","159703859","159704169","chr1","186875835","186876121","42","27171976"
"chr1","159716630","159716928","chr1","186863067","186863370","27","27146437"
"chr1","159736220","159736526","chr1","186842522","186842830","29","27106302"
"chr1","159750149","159750460","chr1","186830497","186830809","22","27080348"
"chr1","159762872","159763129","chr1","186817619","186817877","29","27054747"
"chr1","159777514","159777812","chr1","186802370","186802670","32","27024856"
"chr1","159788784","159789077","chr1","186789563","186789852","26","27000779"
"chr1","159902773","159903078","chr1","186658158","186658462","23","26755385"
"chr1","159932127","159932433","chr1","186631074","186631382","26","26698947"
"chr1","159973174","159973468","chr1","186584595","186584874","47","26611421"
"chr1","159981401","159981511","chr1","186576054","186576167","6","26594653"
"chr1","160003645","160003921","chr1","186549554","186549830","11","26545909"
"chr1","160017144","160017444","chr1","186534217","186534521","20","26517073"
"chr1","160027481","160027789","chr1","186527708","186528014","23","26500227"
"chr1","160050531","160050648","chr14","18099810","18099935","26","141950721"
"chr1","160140195","160140331","chr1","186415108","186415238","11","26274913"
"chr1","160187661","160187920","chr1","186366977","186367239","13","26179316"
"chr1","160193859","160194140","chr1","186361040","186361328","25","26167181"
"chr1","160235062","160235165","chr3","111301920","111302026","14","48933142"
"chr1","160241077","160241345","chr16","65904163","65904425","61","94336914"
"chr1","160241349","160241515","chr1","186312315","186312483","9","26070966"
"chr1","160258088","160258282","chr3","34573368","34573553","42","125684720"
"chr1","160258587","160258712","chr9","15155936","15156054","21","145102651"
"chr1","160265882","160266144","chr7","36206348","36206613","44","124059534"
"chr1","160269962","160270157","chr1","186280961","186281151","23","26010999"
"chr1","160280390","160280616","chr1","186270447","186270674","10","25990057"
"chr1","160306204","160306496","chr1","186241137","186241432","20","25934933"
"chr1","160337794","160338078","chr16","26744282","26744558","60","133593512"
"chr1","160351309","160351598","chr1","186194418","186194706","25","25843109"
"chr1","160351748","160351858","chr1","186194158","186194268","6","25842410"
"chr1","160510276","160510583","chr1","186043795","186044100","26","25533519"
"chr1","160516477","160516607","chr12","83212688","83212821","33","77303789"
"chr1","160516637","160516761","chr4","32621742","32621865","21","127894895"
"chr1","160519661","160519952","chr1","186034582","186034877","23","25514921"
"chr1","160563291","160563399","chr1","185991032","185991146","9","25427741"
"chr1","160591715","160592016","chr18","37002046","37002351","56","123589669"
"chr1","160614577","160614888","chr1","185937857","185938155","31","25323280"
"chr1","160712961","160713261","chr1","185835539","185835836","30","25122578"
"chr1","160816483","160816758","chr19","33574257","33574528","53","127242226"
"chr1","160894043","160894125","chr1","185659042","185659122","11","24764999"
"chr1","161184347","161184489","chr1","185365038","185365181","7","24180691"
"chr1","161198245","161198504","chr1","185351824","185352064","34","24153579"
"chr1","161198564","161198606","chr13","19012667","19012707","6","142185897"
"chr1","161291852","161291966","chr1","185250553","185250667","4","23958701"
"chr1","161322681","161322983","chr1","185220103","185220413","48","23897422"
"chr1","161346828","161347125","chr1","185195848","185196143","22","23849020"
"chr1","161378002","161378052","chr8","101541587","101541634","10","59836415"
"chr1","161397625","161397939","chr1","185131265","185131579","22","23733640"
"chr1","161400423","161400726","chr1","185129159","185129467","37","23728736"
"chr1","161417839","161417992","chr19","35574608","35574755","30","125843231"
"chr1","161418284","161418428","chr1","24769307","24769455","33","136648977"
"chr1","161435335","161435655","chr1","185094162","185094468","37","23658827"
"chr1","161439598","161439688","chr1","185090107","185090203","12","23650509"
"chr1","161449054","161449328","chr1","185080050","185080324","44","23630996"
"chr1","161459785","161460086","chr14","19971480","19971782","54","141488305"
"chr1","161461567","161461652","chr1","185070993","185071078","5","23609426"
"chr1","161463658","161463920","chr2","89038413","89038675","50","72425245"
"chr1","161474158","161474284","chr14","108538894","108539022","23","52935264"
"chr1","161474943","161475065","chr12","14732091","14732215","14","146742852"
"chr1","161479959","161480183","chr1","185052536","185052762","19","23572577"
"chr1","161510250","161510500","chr6","78756571","78756823","54","82753679"
"chr1","161515528","161515815","chr11","124811494","124811778","48","36704034"
"chr1","161515845","161515871","chr14","84348130","84348155","6","77167715"
"chr1","161517860","161518156","chr1","185013699","185014009","28","23495839"
"chr1","161520362","161520527","chr11","461319","461484","41","161059043"
"chr1","161520572","161520676","chrX","6264173","6264280","16","155256399"
"chr1","161524124","161524386","chr1","185007530","185007787","28","23483406"
"chr1","161531522","161531810","chr1","185000422","185000704","31","23468900"
"chr1","161561187","161561478","chr1","184970233","184970533","40","23409046"
"chr1","161599172","161599414","chr1","184932793","184933063","42","23333621"
"chr1","161602317","161602605","chr1","184929563","184929891","54","23327246"
"chr1","161604825","161604997","chr1","184927230","184927397","15","23322405"
"chr1","161634331","161634598","chr1","184896248","184896545","46","23261917"
"chr1","161667201","161667303","chr14","93720364","93720471","22","67946837"
"chr1","161763357","161763678","chr3","127055604","127055907","74","34707753"
"chr1","161808276","161808558","chr1","184729423","184729713","26","22921147"
"chr1","161834029","161834148","chr1","184703386","184703504","11","22869357"
"chr1","161911858","161912123","chr1","184625287","184625552","17","22713429"
"chr1","161983257","161983557","chr1","184553022","184553320","21","22569765"
"chr1","162002574","162002689","chr1","184535369","184535484","1","22532795"
"chr1","162032195","162032479","chr1","184505019","184505303","18","22472824"
"chr1","162072762","162073044","chr19","6103272","6103552","56","155969490"
"chr1","162098438","162098672","chr7","118689659","118689899","53","43408779"
"chr1","162106205","162106524","chr1","184436832","184437126","44","22330627"
"chr1","162624633","162624848","chrX","48222572","48222783","54","114402061"
"chr1","162679441","162679648","chr1","184368039","184368245","14","21688598"
"chr1","162712426","162712708","chr1","184337843","184338131","23","21625417"
"chr1","162812575","162812872","chr1","184237447","184237749","27","21424872"
"chr1","162862143","162862386","chr1","184141254","184141499","11","21279111"
"chr1","162880783","162881082","chr1","184122162","184122456","26","21241379"
"chr1","162931365","162931667","chr3","47401694","47401987","74","115529671"
"chr1","162938855","162939164","chr1","184062915","184063221","39","21124060"
"chr1","162945680","162946015","chr4","36484206","36484512","75","126461474"
"chr1","162986062","162986338","chr7","155166712","155166990","50","7819350"
"chr1","163025368","163025523","chr12","21323547","21323703","26","141701821"
"chr1","163025551","163025653","chr20","26105974","26106078","21","136919577"
"chr1","163029795","163030074","chr1","183976948","183977243","37","20947153"
"chr1","163067347","163067649","chr4","130857794","130858089","80","32209553"
"chr1","163092019","163092319","chr1","183912485","183912783","17","20820466"
"chr1","163093511","163093729","chrX","9102166","9102385","41","153991345"
"chr1","163107461","163107768","chr1","183896767","183897077","23","20789306"
"chr1","163112107","163112228","chr1","183892014","183892124","19","20779907"
"chr1","163123596","163123732","chr6","38241059","38241193","29","124882537"
"chr1","163142009","163142230","chr1","183854881","183855101","12","20712872"
"chr1","163146778","163146941","chr1","183849921","183850089","18","20703143"
"chr1","163147247","163147378","chr1","183849491","183849622","10","20702244"
"chr1","163151883","163152169","chr11","131260074","131260355","58","31891809"
"chr1","163169525","163169654","chr9","97270771","97270897","23","65898754"
"chr1","163180662","163180971","chr1","183815722","183816017","31","20635060"
"chr1","163196318","163196618","chr1","183800013","183800298","29","20603695"
"chr1","163210861","163211077","chr14","105129753","105129968","54","58081108"
"chr1","163212168","163212515","chr1","183783938","183784310","49","20571770"
"chr1","163260746","163260968","chr16","16569679","16569899","54","146691067"
"chr1","163275392","163275691","chr1","183713823","183714122","20","20438431"
"chr1","163282205","163282494","chr1","183707667","183707965","35","20425462"
"chr1","163287176","163287471","chr1","183702610","183702911","24","20415434"
"chr1","163329049","163329175","chr1","183666672","183666793","13","20337623"
"chr1","163355553","163355682","chr1","183643439","183643555","22","20287886"
"chr1","163362939","163363246","chr6","35189860","35190164","59","128173079"
"chr1","163430141","163430446","chr1","183569426","183569722","24","20139285"
"chr1","163447544","163447854","chr1","222228814","222229113","65","58781270"
"chr1","163454024","163454336","chr1","183544570","183544878","43","20090546"
"chr1","163455556","163455849","chr1","183543082","183543368","27","20087526"
"chr1","163472192","163472464","chr1","183524575","183524847","18","20052383"
"chr1","163472514","163472813","chr16","70224075","70224369","65","93248439"
"chr1","163495973","163496277","chr1","183500795","183501099","18","20004822"
"chr1","163506092","163506392","chr1","183490586","183490890","31","19984494"
"chr1","163520998","163521301","chr1","183475490","183475794","22","19954492"
"chr1","163535394","163535572","chr10","5065371","5065545","44","158470023"
"chr1","163593930","163594174","chr1","183350656","183350899","26","19756726"
"chr1","163663523","163663822","chr1","188627840","188628135","61","24964317"
"chr1","163694015","163694300","chr1","183249937","183250222","21","19555922"
"chr1","163807436","163807676","chr7","60945397","60945617","63","102862039"
"chr1","163824959","163825252","chr1","183126357","183126655","22","19301398"
"chr1","163825334","163825601","chr1","183125801","183126065","23","19300467"
"chr1","163825798","163826107","chr1","183125292","183125603","28","19299494"
"chr1","163862737","163862861","chr2","107844001","107844127","20","56018736"
"chr1","163865803","163866080","chr1","183085773","183086077","51","19219970"
"chr1","163870657","163870930","chr5","58565912","58566184","61","105304745"
"chr1","163878015","163878327","chr1","183074001","183074310","22","19195986"
"chr1","163884208","163884468","chr1","183067910","183068148","32","19183702"
"chr1","163897334","163897594","chr1","183054731","183054991","13","19157397"
"chr1","163926151","163926441","chr1","183031356","183031650","57","19105205"
"chr1","164059220","164059407","chr1","182889564","182889753","11","18830344"
"chr1","164059690","164059808","chr1","123211390","123211527","46","40848300"
"chr1","164062559","164062792","chr9","62480277","62480505","44","101582282"
"chr1","164087281","164087525","chr1","182859973","182860242","42","18772692"
"chr1","164091855","164092161","chr1","182855375","182855669","42","18763520"
"chr1","164136246","164136427","chr15","8027098","8027275","40","156109148"
"chr1","164136453","164136567","chr20","42862414","42862525","18","121274039"
"chr1","164149933","164150049","chr1","182795739","182795855","5","18645806"
"chr1","164164510","164164818","chr1","182773416","182773716","32","18608906"
"chr1","164198859","164199161","chr1","182737045","182737346","17","18538186"
"chr1","164217296","164217589","chr1","182718557","182718830","41","18501261"
"chr1","164227897","164228174","chr1","182707663","182707942","21","18479766"
"chr1","164236531","164236763","chr13","63515806","63516039","59","100720725"
"chr1","164289949","164290249","chr1","182642228","182642528","17","18352279"
"chr1","164412422","164412729","chr1","182521118","182521419","29","18108696"
"chr1","164456260","164456561","chr1","182478106","182478398","24","18021846"
"chr1","164512649","164512939","chr1","182423569","182423875","28","17910920"
"chr1","164517246","164517555","chr1","182418943","182419245","26","17901697"
"chr1","164565594","164565920","chr1","182318661","182318993","21","17753067"
"chr1","164583405","164583718","chr1","139519535","139519829","71","25063870"
"chr1","164611919","164612059","chr1","182272624","182272756","15","17660705"
"chr1","164612335","164612518","chr1","182272182","182272354","25","17659847"
"chr1","164612688","164612948","chr1","182271732","182271991","33","17659044"
"chr1","164629531","164629835","chr1","182255008","182255307","21","17625477"
"chr1","164633434","164633715","chr1","182251179","182251464","24","17617745"
"chr1","164689851","164689935","chr1","34345271","34345352","18","130344580"
"chr1","164702012","164702111","chr2","203815368","203815468","17","39113356"
"chr1","164707560","164707851","chr7","59690782","59691054","67","105016778"
"chr1","164729473","164729803","chr1","182161716","182162033","38","17432243"
"chr1","164732502","164732821","chr1","182158699","182159026","30","17426197"
"chr1","164733178","164733454","chr1","182158042","182158340","36","17424864"
"chr1","164774753","164775040","chr1","182119133","182119413","28","17344380"
"chr1","164788189","164788387","chr7","129571844","129572031","55","35216345"
"chr1","164788644","164788873","chr12","38199679","38199910","49","126588965"
"chr1","164790382","164790676","chr1","182102839","182103145","31","17312457"
"chr1","164810189","164810313","chr1","182082795","182082919","5","17272606"
"chr1","164826215","164826526","chr1","182065968","182066263","31","17239753"
"chr1","164846564","164846680","chr1","182045555","182045673","10","17198991"
"chr1","164852939","164853236","chr1","182038999","182039300","27","17186060"
"chr1","164865900","164866194","chr12","96791588","96791876","64","68074312"
"chr1","164892468","164892743","chr1","182002871","182003152","25","17110403"
"chr1","164900011","164900276","chr1","181994937","181995206","27","17094926"
"chr1","164903609","164903730","chr1","181991226","181991347","10","17087617"
"chr1","164905367","164905655","chr1","181988672","181988959","21","17083305"
"chr1","164907878","164908172","chr1","181986175","181986469","14","17078297"
"chr1","164922003","164922119","chr16","17771892","17772008","20","147150111"
"chr1","164922682","164922970","chr1","181971660","181971949","20","17048978"
"chr1","164952716","164952826","chr5","150981321","150981431","31","13971395"
"chr1","165021738","165022027","chr1","181880309","181880605","36","16858571"
"chr1","165026422","165026735","chr1","181876069","181876374","33","16849647"
"chr1","165075114","165075235","chr2","107347460","107347580","21","57727654"
"chr1","165109407","165109709","chr1","181800027","181800336","29","16690620"
"chr1","165230018","165230134","chr13","72532198","72532313","16","92697820"
"chr1","165230836","165231090","chr1","181671010","181671272","29","16440174"
"chr1","165308353","165308555","chr1","181591560","181591761","11","16283207"
"chr1","165309548","165309797","chr1","181590307","181590556","12","16280759"
"chr1","165371195","165371499","chr1","181527137","181527451","44","16155942"
"chr1","165371591","165371877","chr1","181526754","181527044","23","16155163"
"chr1","165486931","165486997","chr11","116622219","116622276","15","48864712"
"chr1","165487286","165487448","chr12","10462851","10463007","34","155024435"
"chr1","165490299","165490527","chr1","181425075","181425300","34","15934776"
"chr1","165526078","165526382","chr1","181388002","181388300","35","15861924"
"chr1","165558277","165558570","chr1","181356409","181356703","27","15798132"
"chr1","165878495","165878630","chr1","181034500","181034636","6","15156005"
"chr1","165910610","165910899","chr1","181007165","181007445","26","15096555"
"chr1","165919670","165919999","chr1","180997771","180998093","33","15078101"
"chr1","165998868","165999171","chr1","180926305","180926606","13","14927437"
"chr1","166019950","166020246","chr9","57278506","57278805","54","108741444"
"chr1","166036529","166036822","chr5","8246617","8246904","64","157789912"
"chr1","166061301","166061606","chr1","180862378","180862690","41","14801077"
"chr1","166081293","166081505","chr1","180843022","180843257","36","14761729"
"chr1","166081515","166081750","chr1","180842817","180843017","58","14761302"
"chr1","166098090","166098374","chr1","180825916","180826241","61","14727826"
"chr1","166128949","166129241","chr1","180795304","180795604","45","14666355"
"chr1","166257939","166258210","chr1","180658284","180658562","25","14400345"
"chr1","166290915","166291002","chrX","8436776","8436866","15","157854139"
"chr1","166329882","166330172","chr1","180581876","180582187","40","14251994"
"chr1","166337599","166337720","chr10","87818140","87818263","21","78519459"
"chr1","166496179","166496423","chr1","180408985","180409241","31","13912806"
"chr1","166633109","166633380","chr9","8094577","8094848","64","158538532"
"chr1","166760311","166760554","chr1","180140585","180140829","15","13380274"
"chr1","166847582","166847874","chr3","5500407","5500697","68","161347175"
"chr1","166872229","166872502","chr1","180035216","180035494","27","13162987"
"chr1","166913910","166914217","chr1","179988667","179988975","37","13074757"
"chr1","166919988","166920114","chr1","179983346","179983472","7","13063358"
"chr1","167000174","167000461","chr8","28623574","28623869","56","138376600"
"chr1","167118199","167118511","chr1","179779487","179779797","24","12661288"
"chr1","167154533","167154806","chr1","179742226","179742499","15","12587693"
"chr1","167206667","167206948","chr1","179689618","179689900","28","12482951"
"chr1","167245415","167245707","chr1","179663224","179663515","18","12417809"
"chr1","167272058","167272291","chr1","179630667","179630902","17","12358609"
"chr1","167316641","167316846","chr1","179586691","179586897","26","12270050"
"chr1","167479873","167480170","chr1","179432239","179432558","58","11952366"
"chr1","167546969","167547151","chr19","28356007","28356185","37","139190962"
"chr1","167547457","167547596","chr16","1119774","1119913","29","166427683"
"chr1","167601936","167602224","chr16","1095250","1095541","59","166506686"
"chr1","167946257","167946530","chr1","178963757","178964067","57","11017500"
"chr1","168084319","168084634","chr1","178827719","178828017","37","10743400"
"chr1","168406102","168406373","chr1","178448348","178448608","25","10042246"
"chr1","168410025","168410136","chr1","178444266","178444382","15","10034241"
"chr1","168440339","168440641","chr1","178413342","178413645","26","9973003"
"chr1","168447001","168447283","chr1","178406286","178406567","18","9959285"
"chr1","168517274","168517428","chr7","135658421","135658571","36","32858853"
"chr1","168517739","168517962","chr11","117411895","117412112","59","51105844"
"chr1","168551688","168551915","chr1","178315584","178315779","49","9763896"
"chr1","168736732","168736922","chr20","22428620","22428807","48","146308112"
"chr1","168773385","168773702","chr1","178093635","178093926","59","9320250"
"chr1","168854702","168855014","chr1","178009470","178009779","63","9154768"
"chr1","169215942","169216209","chr1","177813748","177813989","48","8597806"
"chr1","169218066","169218379","chr1","177811660","177811967","38","8593594"
"chr1","169244826","169245128","chr1","177784478","177784786","34","8539652"
"chr1","169371309","169371600","chr1","177656706","177656999","22","8285397"
"chr1","169387960","169388136","chr20","22547846","22548019","37","146840114"
"chr1","169458434","169458710","chr1","177478300","177478575","46","8019866"
"chr1","169606372","169606676","chr7","96854315","96854612","72","72752057"
"chr1","169626970","169627259","chr1","177301779","177302107","61","7674809"
"chr1","169783336","169783512","chr3","63876628","63876793","44","105906708"
"chr1","169783563","169783680","chr13","10014686","10014805","23","159768877"
"chr1","169850265","169850538","chr1","177077228","177077502","31","7226963"
"chr1","169947415","169947693","chr1","176975904","176976188","32","7028489"
"chr1","169985385","169985652","chr1","176931682","176931960","30","6946297"
"chr1","170028257","170028378","chr1","176885417","176885529","22","6857160"
"chr1","170045605","170045724","chrX","21055458","21055581","18","148990147"
"chr1","170196092","170196375","chr15","84414347","84414628","76","85781745"
"chr1","170309898","170310195","chr1","176601814","176602108","29","6291916"
"chr1","170349735","170350012","chr7","42268119","42268393","67","128081616"
"chr1","170394904","170395210","chr1","176511416","176511699","53","6116512"
"chr1","170534176","170534337","chr15","83613278","83613438","37","86920898"
"chr1","170684798","170684907","chr1","12353123","12353232","22","158331675"
"chr1","170690846","170691005","chr3","47015232","47015392","43","123675614"
"chr1","170910288","170910587","chr3","148208225","148208513","67","22702063"
"chr1","170968466","170968757","chr1","175805222","175805511","21","4836756"
"chr1","171031413","171031716","chr1","175744753","175745054","29","4713340"
"chr1","171036023","171036318","chrX","126706885","126707183","68","44329138"
"chr1","171038531","171038854","chr1","175737582","175737892","47","4699051"
"chr1","171130554","171130811","chr1","175640504","175640746","33","4509950"
"chr1","171192701","171192966","chr1","175578695","175578960","33","4385994"
"chr1","171246222","171246396","chr9","60473538","60473710","40","110772684"
"chr1","171352869","171353171","chr1","175420814","175421112","25","4067945"
"chr1","171385483","171385740","chr1","175386299","175386591","52","4000816"
"chr1","171436936","171437180","chr1","175331905","175332150","16","3894969"
"chr1","171535262","171535548","chr1","175238851","175239132","38","3703589"
"chr1","171700983","171701105","chr1","175060764","175060882","15","3359781"
"chr1","171701137","171701296","chr1","175060566","175060730","16","3359429"
"chr1","171823468","171823779","chr1","174938339","174938653","57","3114871"
"chr1","171830454","171830682","chr1","174931485","174931723","32","3101031"
"chr1","171882543","171882858","chr1","174837374","174837677","39","2954831"
"chr1","171897705","171898032","chr11","61787526","61787845","75","110110179"
"chr1","172041631","172041715","chr1","174677168","174677252","2","2635537"
"chr1","172046575","172046862","chr1","174671949","174672257","40","2625374"
"chr1","172068573","172068820","chr1","174654369","174654617","14","2585796"
"chr1","172082814","172083126","chr1","174641209","174641512","34","2558395"
"chr1","172096543","172096699","chr6","149350561","149350711","36","22745982"
"chr1","172259058","172259143","chr15","9397815","9397898","12","162861243"
"chr1","172308593","172308715","chr1","174360212","174360339","14","2051619"
"chr1","172363665","172363795","chr1","174304048","174304178","8","1940383"
"chr1","172401940","172402248","chr1","174268927","174269237","29","1866987"
"chr1","172499046","172499313","chr1","174170164","174170440","26","1671118"
"chr1","172527136","172527430","chr1","174138324","174138615","22","1611188"
"chr1","172552768","172552966","chr1","174113725","174113923","11","1560957"
"chr1","172555900","172556197","chr1","174110480","174110760","34","1554580"
"chr1","172562950","172563278","chr1","174103744","174104069","32","1540794"
"chr1","172627482","172627800","chr1","174035330","174035629","42","1407848"
"chr1","172717299","172717421","chr2","169133199","169133321","18","3584100"
"chr1","172794281","172794564","chr1","173857258","173857547","30","1062977"
"chr1","172798443","172798739","chr11","78321185","78321482","54","94477258"
"chr1","172863913","172864204","chr1","173783754","173784035","28","919841"
"chr1","172871119","172871399","chr1","173776385","173776665","24","905266"
"chr1","172873762","172873802","chr10","74775074","74775112","7","98098688"
"chr1","172878806","172879109","chr1","173768711","173769016","26","889905"
"chr1","172919103","172919381","chr16","21353392","21353685","71","151565711"
"chr1","173176914","173176925","chr6","148162172","148162184","1","25014742"
"chr1","173177118","173177342","chr7","33789485","33789705","54","139387633"
"chr1","173346150","173346346","chr1","173292200","173292385","24","53950"
"chr1","173478181","173478291","chrX","46726226","46726337","19","126751955"
"chr1","173478342","173478590","chr3","48312219","48312482","78","125166123"
"chr1","173536019","173536322","chr1","173102759","173103062","22","433260"
"chr1","173592447","173592620","chr1","173051121","173051315","44","541326"
"chr1","173675811","173676017","chr1","172970314","172970520","14","705497"
"chr1","173742385","173742660","chr1","172905057","172905361","41","837328"
"chr1","174038996","174039298","chr1","39655096","39655388","66","134383900"
"chr1","174270138","174270453","chr20","20742237","20742544","63","153527901"
"chr1","174272613","174272916","chr20","10719806","10720100","62","163552807"
"chr1","174277960","174278076","chr16","61292718","61292835","21","112985242"
"chr1","174326852","174327143","chr1","93494718","93495011","59","80832134"
"chr1","174360806","174360990","chr1","25431197","25431377","47","148929609"
"chr1","174361294","174361347","chr16","1220736","1220783","13","173140558"
"chr1","174430947","174431229","chr2","102368592","102368879","74","72062355"
"chr1","174488844","174488963","chr1","172456964","172457084","6","2031880"
"chr1","174509774","174510076","chr1","172428323","172428628","29","2081451"
"chr1","174563320","174563656","chr1","172374600","172374947","51","2188720"
"chr1","174795265","174795490","chrX","64511739","64511958","63","110283526"
"chr1","174799621","174799912","chr1","172134334","172134632","43","2665287"
"chr1","174893813","174894029","chr1","172048675","172048891","17","2845138"
"chr1","174911919","174912211","chr1","172024411","172024715","36","2887508"
"chr1","174960062","174960372","chr6","130163851","130164162","60","44796211"
"chr1","174967102","174967389","chr1","171961856","171962138","38","3005246"
"chr1","175109482","175109760","chr20","20219234","20219493","66","154890248"
"chr1","175270845","175271151","chr1","188627840","188628135","74","13356995"
"chr1","175338992","175339259","chr1","171592083","171592351","20","3746909"
"chr1","175357472","175357732","chr1","171573989","171574244","37","3783483"
"chr1","175454866","175455123","chr1","171478958","171479216","22","3975908"
"chr1","175555301","175555587","chr1","171375995","171376287","22","4179306"
"chr1","175614730","175615034","chr1","171322473","171322778","23","4292257"
"chr1","175931027","175931197","chr1","170790887","170791049","46","5140140"
"chr1","175931224","175931335","chr1","170790745","170790861","11","5140479"
"chr1","176509120","176509408","chr1","170106884","170107166","28","6402236"
"chr1","176911519","176911635","chr1","169846854","169846974","10","7064665"
"chr1","176927266","176927567","chr1","169839720","169840001","56","7087546"
"chr1","177012901","177013199","chr1","169748591","169748902","40","7264310"
"chr1","177018800","177018962","chr1","169742798","169742973","22","7276002"
"chr1","177019267","177019394","chr1","169742368","169742495","4","7276899"
"chr1","177177150","177177455","chr1","169575782","169576072","37","7601368"
"chr1","177543207","177543512","chr1","169166275","169166575","17","8376932"
"chr1","177564427","177564692","chr1","169143370","169143623","29","8421057"
"chr1","177587749","177588018","chr16","52172870","52173148","61","125414879"
"chr1","177621648","177621929","chr1","169074661","169074952","32","8546987"
"chr1","177637741","177638011","chr1","169057315","169057590","20","8580426"
"chr1","177651190","177651496","chr1","169043284","169043594","25","8607906"
"chr1","177663918","177664151","chr1","169029635","169029851","29","8634283"
"chr1","177666976","177667107","chr1","27434443","27434574","23","150232533"
"chr1","177720820","177720958","chr1","168979527","168979662","9","8741293"
"chr1","177722138","177722256","chr1","168978225","168978343","8","8743913"
"chr1","177746231","177746535","chr1","168958512","168958816","21","8787719"
"chr1","177752651","177752711","chr1","168951992","168952052","0","8800659"
"chr1","177752838","177753132","chr1","168951576","168951884","34","8801262"
"chr1","177869057","177869369","chr8","86768229","86768522","67","91100828"
"chr1","177876429","177876645","chr18","37535102","37535314","50","140341327"
"chr1","177895172","177895434","chr1","168787304","168787562","30","9107868"
"chr1","177901418","177901711","chr1","168781285","168781583","27","9120133"
"chr1","177977049","177977277","chr1","213911110","213911337","45","35934061"
"chr1","178069959","178070285","chr1","168626890","168627212","27","9443069"
"chr1","178079878","178080171","chr1","168616609","168616899","20","9463269"
"chr1","178081465","178081770","chr1","168615015","168615323","36","9466450"
"chr1","178091389","178091561","chr1","168605286","168605447","25","9486103"
"chr1","178091587","178091663","chr1","99546579","99546654","21","78545008"
"chr1","178110780","178111092","chr1","168586946","168587258","19","9523834"
"chr1","178259962","178260259","chr3","124209366","124209656","64","54050596"
"chr1","178402210","178402468","chr1","168302417","168302692","37","10099793"
"chr1","178479741","178480027","chr1","168218617","168218917","27","10261124"
"chr1","178503464","178503764","chr1","168191455","168191762","23","10312009"
"chr1","178510716","178511007","chr1","168184258","168184553","35","10326458"
"chr1","178751609","178751905","chr1","167937213","167937508","41","10814396"
"chr1","178812028","178812310","chr8","99980382","99980665","68","78831646"
"chr1","178967756","178968042","chr1","167721492","167721771","37","11246264"
"chr1","179151975","179152250","chr1","167519155","167519424","43","11632820"
"chr1","179167379","179167594","chr1","167502868","167503070","30","11664511"
"chr1","179218107","179218326","chr8","38190322","38190555","65","141027785"
"chr1","179248388","179248663","chr1","167413337","167413631","46","11835051"
"chr1","179315537","179315822","chr1","167349962","167350231","39","11965575"
"chr1","179401239","179401517","chr1","167268562","167268845","38","12132677"
"chr1","179498963","179499224","chrX","8413995","8414244","65","171084968"
"chr1","179687925","179688008","chr1","166980327","166980409","6","12707598"
"chr1","179748846","179748977","chr19","14696877","14697012","27","165051969"
"chr1","179759976","179760094","chr15","56835439","56835556","19","122924537"
"chr1","179760640","179760920","chrX","112025204","112025482","64","67735436"
"chr1","179764815","179765083","chr1","166903746","166904011","23","12861069"
"chr1","179769251","179769537","chr1","166899261","166899547","15","12869990"
"chr1","179777181","179777475","chr1","166890993","166891283","24","12886188"
"chr1","179799520","179799805","chr19","26081887","26082157","77","153717633"
"chr1","179802250","179802521","chr1","166872459","166872734","24","12929791"
"chr1","179805010","179805170","chr13","97087144","97087305","30","82717866"
"chr1","179805197","179805315","chrX","46651788","46651905","17","133153409"
"chr1","179808833","179809133","chr1","166857743","166858050","27","12951090"
"chr1","179814488","179814739","chr8","92687825","92688073","57","87126663"
"chr1","179837360","179837508","chr19","7326316","7326461","28","172511044"
"chr1","179837787","179837980","chr1","166832267","166832464","14","13005520"
"chr1","179850137","179850466","chr1","166812380","166812703","35","13037757"
"chr1","179855898","179856157","chr1","166806528","166806793","62","13049370"
"chr1","179858125","179858253","chrX","65259533","65259659","24","114598592"
"chr1","179866658","179866920","chr6","136981423","136981690","58","42885235"
"chr1","179867146","179867449","chr1","166796710","166797010","22","13070436"
"chr1","179874288","179874454","chr9","96278811","96278969","41","83595477"
"chr1","179883847","179884146","chr2","71005973","71006275","57","108877874"
"chr1","179889552","179889823","chr1","166778368","166778641","38","13111184"
"chr1","179890411","179890703","chr1","166777407","166777667","53","13113004"
"chr1","179891480","179891789","chr19","29108741","29109042","61","150782739"
"chr1","179897446","179897743","chr1","166770335","166770628","31","13127111"
"chr1","179899708","179899864","chr1","166769200","166769349","17","13130508"
"chr1","179900156","179900284","chr1","166768782","166768910","11","13131374"
"chr1","179905816","179906004","chr1","166762627","166762822","29","13143189"
"chr1","179906291","179906368","chr13","29152359","29152438","17","150753932"
"chr1","179913226","179913349","chr1","166753759","166753883","8","13159467"
"chr1","179916389","179916691","chr1","166750021","166750318","27","13166368"
"chr1","179923546","179923844","chr1","166741386","166741693","45","13182160"
"chr1","179930494","179930620","chr19","42797741","42797867","9","137132753"
"chr1","179961869","179962114","chr18","36684994","36685233","51","143276875"
"chr1","180012316","180012534","chr1","166654079","166654297","19","13358237"
"chr1","180014751","180015011","chr1","166651566","166651824","18","13363185"
"chr1","180030992","180031264","chr1","166634911","166635214","41","13396081"
"chr1","180032171","180032481","chr1","166633687","166633986","26","13398484"
"chr1","180065095","180065372","chr1","166599889","166600169","17","13465206"
"chr1","180074402","180074650","chr1","166591363","166591614","17","13483039"
"chr1","180116601","180116909","chr1","166556855","166557160","18","13559746"
"chr1","180138197","180138464","chr19","2507487","2507757","58","177630710"
"chr1","180138471","180138604","chr1","166535133","166535262","14","13603338"
"chr1","180143111","180143411","chr1","166530288","166530590","30","13612823"
"chr1","180167112","180167394","chr1","166506591","166506877","23","13660521"
"chr1","180177143","180177440","chr1","166496714","166497012","23","13680429"
"chr1","180191945","180192061","chr1","166481934","166482054","13","13710011"
"chr1","180192304","180192398","chr1","166480572","166480666","8","13711732"
"chr1","180205265","180205433","chr1","166467606","166467757","31","13737659"
"chr1","180216553","180216663","chr9","100211242","100211350","21","80005311"
"chr1","180226630","180226910","chr1","166445556","166445849","31","13781074"
"chr1","180239979","180240267","chr1","166433677","166433974","27","13806302"
"chr1","180241125","180241433","chr1","166432526","166432837","28","13808599"
"chr1","180254954","180255074","chr19","8153130","8153252","25","172101824"
"chr1","180255368","180255527","chr15","8417757","8417922","31","171837611"
"chr1","180264319","180264578","chr1","166415713","166415987","36","13848606"
"chr1","180268579","180268881","chr2","160551205","160551504","52","19717374"
"chr1","180277767","180278046","chr1","166402178","166402464","24","13875589"
"chr1","180287249","180287411","chr1","166391964","166392111","20","13895285"
"chr1","180294139","180294424","chr1","166383308","166383611","33","13910831"
"chr1","180322367","180322672","chr1","166354737","166355044","30","13967630"
"chr1","180331802","180332111","chr1","166346816","166347119","35","13984986"
"chr1","180336817","180337124","chr1","166341122","166341431","27","13995695"
"chr1","180339292","180339572","chr4","15192582","15192862","56","165146710"
"chr1","180340710","180341018","chr7","45639425","45639731","51","134701285"
"chr1","180373738","180373865","chr1","166302306","166302432","17","14071432"
"chr1","180396088","180396417","chr1","166279852","166280165","34","14116236"
"chr1","180405234","180405525","chr1","166270704","166270986","24","14134530"
"chr1","180408616","180408902","chr1","166267323","166267607","16","14141293"
"chr1","180420383","180420693","chr1","166254834","166255120","37","14165549"
"chr1","180429004","180429082","chr7","651487","651564","16","179777517"
"chr1","180429137","180429249","chr4","128388118","128388230","19","52041019"
"chr1","180447162","180447468","chr1","166228651","166228957","25","14218511"
"chr1","180472404","180472739","chr1","166201363","166201677","41","14271041"
"chr1","180487512","180487636","chr1","166185629","166185753","9","14301883"
"chr1","180490462","180490756","chr1","166182481","166182792","27","14307981"
"chr1","180512447","180512742","chr1","166159811","166160100","31","14352636"
"chr1","180538621","180538931","chr1","166127719","166128012","49","14410902"
"chr1","180542095","180542318","chr1","166122140","166122364","20","14419955"
"chr1","180548381","180548460","chr16","44224787","44224868","14","136323594"
"chr1","180551361","180551664","chr1","166112167","166112457","35","14439194"
"chr1","180557667","180557840","chrX","48663996","48664170","34","131893671"
"chr1","180584261","180584381","chr1","193536391","193536507","17","12952130"
"chr1","180587907","180588217","chr1","166074505","166074835","31","14513402"
"chr1","180609405","180609708","chr1","166053098","166053397","23","14556307"
"chr1","180620193","180620409","chr1","166042323","166042537","19","14577870"
"chr1","180622526","180622836","chr3","124639711","124640018","61","55982815"
"chr1","180628578","180628703","chr1","166033825","166033950","6","14594753"
"chr1","180651493","180651763","chr10","19679906","19680183","65","160971587"
"chr1","180686665","180686949","chr7","35839947","35840247","68","144846718"
"chr1","180724627","180724907","chr1","165934985","165935277","30","14789642"
"chr1","180770925","180771241","chr1","165892807","165893125","34","14878118"
"chr1","180788189","180788498","chr1","165875445","165875753","27","14912744"
"chr1","180807870","180808177","chr1","165855936","165856211","45","14951934"
"chr1","180827725","180828010","chr5","78689579","78689868","59","102138146"
"chr1","180837741","180838046","chr1","165826263","165826563","26","15011478"
"chr1","180839135","180839247","chr1","165824841","165824954","10","15014294"
"chr1","180853616","180853931","chr1","165809766","165810076","31","15043850"
"chr1","180861215","180861329","chr3","42286128","42286243","18","138575087"
"chr1","180861359","180861530","chr1","35417022","35417192","31","145444337"
"chr1","180881289","180881600","chr1","165781332","165781641","25","15099957"
"chr1","180882867","180883162","chr1","165779767","165780056","27","15103100"
"chr1","180938179","180938345","chr1","165724487","165724649","23","15213692"
"chr1","180938380","180938496","chr1","165724326","165724443","8","15214054"
"chr1","181047950","181048254","chr1","165612796","165613106","21","15435154"
"chr1","181071066","181071336","chr1","165589821","165590086","17","15481245"
"chr1","181120076","181120244","chr17","29269902","29270063","33","151850174"
"chr1","181121852","181122146","chr1","20982389","20982671","65","160139463"
"chr1","181202581","181202815","chr9","57819522","57819731","64","123383059"
"chr1","181204617","181204911","chr1","165462513","165462809","24","15742104"
"chr1","181374134","181374423","chr1","165292898","165293187","14","16081236"
"chr1","181394576","181394850","chr1","165272090","165272362","12","16122486"
"chr1","181428447","181428729","chr5","165714831","165715111","55","15713616"
"chr1","181448997","181449288","chr7","54626438","54626727","56","126822559"
"chr1","181460827","181461143","chr1","165197036","165197384","66","16263791"
"chr1","181462657","181462970","chr3","39608631","39608933","63","141854026"
"chr1","181472741","181472960","chr1","165185605","165185825","10","16287136"
"chr1","181487218","181487514","chr1","165171247","165171540","27","16315971"
"chr1","181502963","181503258","chr3","127162429","127162726","52","54340534"
"chr1","181511074","181511382","chr1","165147276","165147573","44","16363798"
"chr1","181516311","181516606","chr1","165141889","165142185","30","16374422"
"chr1","181558357","181558672","chr1","165100906","165101221","17","16457451"
"chr1","181609143","181609439","chr1","165051091","165051402","34","16558052"
"chr1","181624541","181624825","chr1","22392281","22392567","44","159232260"
"chr1","181632993","181633305","chr1","165027710","165028001","42","16605283"
"chr1","181654221","181654420","chr13","54729337","54729522","52","126924884"
"chr1","181659082","181659223","chr1","165001931","165002072","12","16657151"
"chr1","181660768","181661082","chr1","165000009","165000328","38","16660759"
"chr1","181671978","181672094","chr1","164989377","164989493","10","16682601"
"chr1","181674525","181674807","chr1","164986672","164986955","16","16687853"
"chr1","181676117","181676186","chr1","164985178","164985247","2","16690939"
"chr1","181697009","181697277","chr1","164963083","164963348","25","16733926"
"chr1","181698608","181698919","chr1","164961421","164961725","28","16737187"
"chr1","181716653","181716934","chr1","10904976","10905255","57","170811677"
"chr1","181718159","181718451","chr12","113687505","113687774","78","68030654"
"chr1","181732482","181732769","chr1","164928027","164928327","33","16804455"
"chr1","181735013","181735216","chr9","28839934","28840135","43","152895079"
"chr1","181774499","181774793","chr3","177488181","177488477","53","4286318"
"chr1","181823062","181823376","chr1","164829898","164830209","36","16993164"
"chr1","181825215","181825539","chr1","164828367","164828685","27","16996848"
"chr1","181847002","181847294","chr1","164805775","164806078","58","17041227"
"chr1","181849538","181849652","chr2","108728140","108728248","27","73121398"
"chr1","181849687","181849769","chr20","27224402","27224478","21","154625285"
"chr1","181862953","181863196","chr1","213725125","213725374","71","31862172"
"chr1","181870783","181871057","chr1","164781888","164782166","28","17088895"
"chr1","181884733","181884861","chr1","164770689","164770821","11","17114044"
"chr1","181890030","181890314","chr1","164764759","164765048","30","17125271"
"chr1","181893377","181893664","chr5","14864191","14864482","61","167029186"
"chr1","181932295","181932435","chr6","122098582","122098725","25","59833713"
"chr1","181932735","181932864","chr1","24663557","24663673","47","157269178"
"chr1","181933163","181933202","chr16","57155458","57155492","6","124777705"
"chr1","181938728","181939008","chr14","47806807","47807099","68","134131921"
"chr1","181981018","181981300","chr1","164660840","164661125","19","17320178"
"chr1","181995661","181995959","chr1","164645724","164646032","34","17349937"
"chr1","182102465","182102717","chr1","164536137","164536394","19","17566328"
"chr1","182114441","182114663","chr1","164524460","164524682","13","17589981"
"chr1","182222090","182222374","chr1","164418738","164419037","44","17803352"
"chr1","182234386","182234512","chr1","164405141","164405267","4","17829245"
"chr1","182240314","182240600","chr13","28143104","28143385","67","154097210"
"chr1","182248399","182248680","chr9","94248962","94249237","57","87999437"
"chr1","182250610","182250905","chr1","164388810","164389103","27","17861800"
"chr1","182263473","182263748","chr1","164375902","164376177","22","17887571"
"chr1","182285518","182285764","chr1","164353662","164353910","20","17931856"
"chr1","182288165","182288293","chr1","164351347","164351475","4","17936818"
"chr1","182295134","182295415","chr1","164343978","164344260","27","17951156"
"chr1","182330829","182331134","chr1","164307784","164308089","26","18023045"
"chr1","182335118","182335242","chr1","164303660","164303784","7","18031458"
"chr1","182348241","182348521","chr1","164291999","164292289","29","18056242"
"chr1","182363902","182364225","chr1","164277238","164277559","21","18086664"
"chr1","182442021","182442289","chr11","7508963","7509219","63","174933058"
"chr1","182456747","182457042","chr1","164184994","164185299","29","18271753"
"chr1","182467876","182468165","chr11","113114919","113115214","61","69352957"
"chr1","182501920","182502209","chr1","164139582","164139890","41","18362338"
"chr1","182516328","182516660","chr1","164128691","164128998","38","18387637"
"chr1","182524299","182524477","chr1","164081832","164082010","10","18442467"
"chr1","182578399","182578693","chr1","164027955","164028256","26","18550444"
"chr1","182636865","182637166","chr1","163966861","163967161","20","18670004"
"chr1","182654915","182655173","chr1","163945472","163945726","16","18709443"
"chr1","182659590","182659783","chrX","15957200","15957396","47","166702390"
"chr1","182667787","182668065","chr1","163933472","163933745","35","18734315"
"chr1","182669950","182670216","chr1","163931146","163931422","25","18738804"
"chr1","182676273","182676334","chr1","163926327","163926385","7","18749946"
"chr1","182676668","182676898","chr1","163925801","163926023","29","18750867"
"chr1","182679369","182679670","chr1","163922147","163922431","61","18757222"
"chr1","182680382","182680665","chr7","140100928","140101221","61","42579454"
"chr1","182683252","182683339","chr6","6630668","6630754","23","176052584"
"chr1","182692015","182692224","chr1","163908132","163908326","24","18783883"
"chr1","182692235","182692513","chr1","163907835","163908107","24","18784400"
"chr1","182693839","182694138","chr1","163906217","163906516","23","18787622"
"chr1","182711854","182711977","chr1","163887816","163887941","6","18824038"
"chr1","182713723","182713987","chr1","163885809","163886110","54","18827914"
"chr1","182721470","182721768","chr1","163879711","163880010","16","18841759"
"chr1","182747197","182747474","chr1","163853502","163853796","35","18893695"
"chr1","182768948","182769252","chr1","163828629","163828921","34","18940319"
"chr1","182770334","182770534","chr1","163827355","163827545","26","18942979"
"chr1","182772234","182772472","chr1","163825079","163825292","33","18947155"
"chr1","182776080","182776147","chr1","163822393","163822455","9","18953687"
"chr1","182776451","182776617","chr1","163821935","163822088","22","18954516"
"chr1","182790499","182790791","chr1","163808086","163808388","17","18982413"
"chr1","182792027","182792160","chr1","163806622","163806737","19","18985405"
"chr1","182794550","182794846","chr1","163803919","163804218","50","18990631"
"chr1","182802377","182802643","chr7","165009808","165010075","65","17792569"
"chr1","182811454","182811687","chr1","163785663","163785899","21","19025791"
"chr1","182811932","182812211","chr1","163784818","163785097","23","19027114"
"chr1","182813669","182813973","chr11","48401419","48401716","63","134412250"
"chr1","182825953","182826252","chr1","163770517","163770821","27","19055436"
"chr1","182857248","182857468","chr1","163737960","163738176","10","19119288"
"chr1","182893912","182894205","chr1","163653554","163653840","23","19240358"
"chr1","182897852","182897969","chr1","163650110","163650227","7","19247742"
"chr1","182899133","182899251","chr1","196288436","196288552","28","13389303"
"chr1","182927333","182927573","chr3","126794297","126794543","53","56133036"
"chr1","182937548","182937826","chr1","163602015","163602259","55","19335533"
"chr1","182966762","182967066","chr1","163571866","163572181","25","19394896"
"chr1","182967498","182967711","chrX","46812289","46812502","53","136155209"
"chr1","183008557","183008863","chr1","163526357","163526663","21","19482200"
"chr1","183056889","183057185","chr1","163477300","163477579","33","19579589"
"chr1","183117685","183117982","chr1","163416411","163416694","35","19701274"
"chr1","183208863","183209155","chr1","163316833","163317102","49","19892030"
"chr1","183229838","183230137","chr1","163297410","163297714","30","19932428"
"chr1","183286726","183286887","chr4","161962632","161962792","29","21324094"
"chr1","183286929","183287045","chr2","43907778","43907894","22","139379151"
"chr1","183303590","183303802","chr1","163222692","163222900","29","20080898"
"chr1","183320447","183320612","chr1","163204360","163204527","25","20116087"
"chr1","183369927","183370219","chr1","163155677","163155961","34","20214250"
"chr1","183416726","183417041","chr8","98849115","98849422","61","84567611"
"chr1","183430264","183430542","chr1","163095392","163095678","29","20334872"
"chr1","183446287","183446454","chr1","163079421","163079566","35","20366866"
"chr1","183477181","183477349","chr1","163046148","163046312","10","20431033"
"chr1","183479480","183479777","chr1","100650647","100650943","59","82828833"
"chr1","183493543","183493816","chr1","163028590","163028867","24","20464953"
"chr1","183508611","183508894","chr1","163014083","163014367","17","20494528"
"chr1","183508935","183509230","chr1","163013756","163014048","23","20495179"
"chr1","183533244","183533411","chr1","162988569","162988756","27","20544675"
"chr1","183533438","183533628","chr1","162988354","162988564","39","20545084"
"chr1","183540035","183540346","chr1","162981935","162982247","20","20558100"
"chr1","183545127","183545429","chr1","162976842","162977150","24","20568285"
"chr1","183545442","183545728","chr1","162976549","162976831","20","20568893"
"chr1","183557283","183557577","chr1","162963937","162964231","19","20593346"
"chr1","183561533","183561824","chr1","162959384","162959680","24","20602149"
"chr1","183594646","183594952","chr1","162925293","162925598","27","20669353"
"chr1","183615846","183616141","chr1","162907513","162907810","31","20708333"
"chr1","183616783","183616978","chr1","162906704","162906896","14","20710079"
"chr1","183644781","183645062","chr1","162880132","162880416","24","20764649"
"chr1","183646750","183646925","chr1","162877550","162877731","21","20769200"
"chr1","183652259","183652464","chr4","32585514","32585697","50","151066745"
"chr1","183652769","183652803","chr12","103293262","103293297","4","80359507"
"chr1","183700742","183700961","chr1","162819008","162819237","29","20881734"
"chr1","183710191","183710499","chr1","162810498","162810803","22","20899693"
"chr1","183730774","183731075","chr1","162788406","162788722","29","20942368"
"chr1","183756997","183757115","chr1","162763775","162763894","15","20993222"
"chr1","183758281","183758391","chr11","98850219","98850329","29","84908062"
"chr1","183803859","183804170","chr3","36904507","36904821","74","146899352"
"chr1","183810196","183810474","chr1","162713479","162713758","12","21096717"
"chr1","183825335","183825452","chr3","44148660","44148773","19","139676675"
"chr1","183830841","183831151","chr1","162692161","162692468","19","21138680"
"chr1","183842987","183843271","chr1","162679896","162680188","26","21163091"
"chr1","183851886","183852150","chr1","162670266","162670537","30","21181620"
"chr1","183864465","183864578","chr1","162654716","162654831","10","21209749"
"chr1","183869629","183869927","chr1","17258340","17258637","61","166611289"
"chr1","183881445","183881737","chr1","162638653","162638937","37","21242792"
"chr1","183881976","183882157","chr11","51724204","51724379","29","132157772"
"chr1","183882451","183882568","chr1","162637524","162637643","8","21244927"
"chr1","183884550","183884624","chr1","31653913","31653986","18","152230637"
"chr1","183884921","183885128","chr2","113929509","113929717","48","69955412"
"chr1","183913669","183913946","chr1","162605334","162605634","46","21308335"
"chr1","183938722","183939031","chr4","149426544","149426840","64","34512178"
"chr1","183944137","183944423","chr1","162576488","162576772","37","21367649"
"chr1","183959343","183959648","chr14","12540994","12541290","57","171418349"
"chr1","183983064","183983328","chr1","162537269","162537529","44","21445795"
"chr1","183988856","183989169","chr17","18786184","18786492","63","165202672"
"chr1","183990854","183991144","chr1","162529282","162529568","16","21461572"
"chr1","184001137","184001454","chr1","162518934","162519253","40","21482203"
"chr1","184002698","184002838","chr1","39339962","39340095","34","144662736"
"chr1","184010095","184010372","chr1","162509380","162509648","35","21500715"
"chr1","184011678","184011789","chr1","112478303","112478419","19","71533375"
"chr1","184026518","184026808","chr1","162493521","162493801","24","21532997"
"chr1","184058957","184059238","chr1","162462611","162462907","38","21596346"
"chr1","184070814","184071114","chr1","162450665","162450962","31","21620149"
"chr1","184075664","184075745","chr16","44594351","44594426","20","139481313"
"chr1","184076370","184076654","chr14","34757061","34757335","61","149319309"
"chr1","184101101","184101412","chr8","39362412","39362707","62","144738689"
"chr1","184120104","184120407","chr1","162399191","162399495","23","21720913"
"chr1","184122292","184122601","chr1","162397035","162397341","26","21725257"
"chr1","184144337","184144657","chr1","162375694","162376006","32","21768643"
"chr1","184164698","184164984","chr1","162355562","162355864","53","21809136"
"chr1","184203521","184203581","chr2","79990292","79990345","15","104213229"
"chr1","184203712","184203809","chr1","162317062","162317162","10","21886650"
"chr1","184263067","184263227","chr1","162258205","162258364","19","22004862"
"chr1","184263529","184263662","chr1","162257765","162257896","7","22005764"
"chr1","184278959","184279235","chr6","9643866","9644144","54","174635093"
"chr1","184288460","184288750","chr1","162200037","162200335","36","22088423"
"chr1","184289410","184289522","chr1","162197092","162197204","0","22092318"
"chr1","184290225","184290523","chr5","40205940","40206241","60","144084285"
"chr1","184292679","184292988","chr1","162194207","162194495","42","22098472"
"chr1","184307056","184307334","chr1","162180249","162180547","40","22126807"
"chr1","184308825","184309136","chr13","64763833","64764129","69","119544992"
"chr1","184378935","184379256","chr1","162108003","162108312","29","22270932"
"chr1","184381187","184381455","chr1","162105984","162106239","32","22275203"
"chr1","184391601","184391851","chr1","162096021","162096272","17","22295580"
"chr1","184399291","184399385","chr1","162088451","162088532","18","22310840"
"chr1","184401799","184401900","chr1","162082884","162082988","6","22318915"
"chr1","184407642","184407924","chr1","162077638","162077936","34","22330004"
"chr1","184410710","184410988","chr1","162071782","162072074","52","22338928"
"chr1","184412147","184412433","chr1","162070350","162070652","31","22341797"
"chr1","184415456","184415734","chr1","162066707","162066985","13","22348749"
"chr1","184423357","184423667","chr1","162058358","162058677","33","22364999"
"chr1","184430799","184431112","chr1","162050932","162051245","18","22379867"
"chr1","184439800","184440079","chr1","162041638","162041917","11","22398162"
"chr1","184467251","184467564","chr1","162011852","162012153","37","22455399"
"chr1","184469986","184470281","chr1","162009144","162009448","18","22460842"
"chr1","184483568","184483888","chr1","161995208","161995521","32","22488360"
"chr1","184484661","184484811","chr9","71383588","71383740","30","113101073"
"chr1","184521470","184521776","chr8","25633304","25633606","66","158888166"
"chr1","184528585","184528888","chr1","161949884","161950199","31","22578701"
"chr1","184542822","184543129","chr1","161920379","161920680","55","22622443"
"chr1","184543134","184543291","chr1","138345950","138346105","31","46197184"
"chr1","184544526","184544834","chr1","161933718","161934026","13","22610808"
"chr1","184557966","184558263","chr1","161920379","161920680","19","22637587"
"chr1","184611525","184611834","chr1","161869223","161869522","35","22742302"
"chr1","184614111","184614410","chr1","161866641","161866946","20","22747470"
"chr1","184696368","184696619","chr1","161783231","161783500","39","22913137"
"chr1","184706780","184706980","chr16","1507278","1507481","38","183199502"
"chr1","184711267","184711467","chr9","57786664","57786859","53","126924603"
"chr1","184737191","184737477","chr14","66461558","66461851","57","118275633"
"chr1","184774270","184774400","chr6","140693641","140693765","36","44080629"
"chr1","184776873","184777179","chr1","161699707","161700017","32","23077166"
"chr1","184786848","184787083","chr13","24158829","24158994","91","160628019"
"chr1","184787347","184787492","chr1","161688771","161688916","14","23098576"
"chr1","184791352","184791623","chr13","48573766","48574049","66","136217586"
"chr1","184794412","184794584","chr19","5981666","5981828","43","178812746"
"chr1","184799745","184800106","chr1","161676091","161676451","29","23123654"
"chr1","184801719","184802037","chr1","161674184","161674498","34","23127535"
"chr1","184802046","184802332","chr1","161673880","161674164","40","23128166"
"chr1","184806222","184806507","chr1","161669706","161669988","20","23136516"
"chr1","184896069","184896310","chr1","161573182","161573420","20","23322887"
"chr1","184914420","184914725","chr1","161555176","161555486","23","23359244"
"chr1","185001377","185001657","chr1","161467803","161468085","17","23533574"
"chr1","185026187","185026294","chr1","161446131","161446238","6","23580056"
"chr1","185045903","185046112","chr1","161431433","161431649","25","23614470"
"chr1","185054095","185054397","chr1","161423996","161424292","22","23630099"
"chr1","185077473","185077577","chr4","16076523","16076630","32","169000950"
"chr1","185127036","185127336","chr1","161348168","161348468","25","23778868"
"chr1","185148537","185148857","chr1","161326896","161327217","21","23821641"
"chr1","185178458","185178689","chr1","161297806","161298083","60","23880652"
"chr1","185242708","185242996","chr1","161231316","161231607","40","24011392"
"chr1","185256506","185256821","chr1","161217706","161218027","35","24038800"
"chr1","185259234","185259519","chr1","161214191","161214483","42","24045043"
"chr1","185262079","185262370","chr1","161211340","161211642","31","24050739"
"chr1","185263037","185263326","chr1","161210396","161210672","30","24052641"
"chr1","185270833","185271119","chr5","172668687","172668969","69","12602146"
"chr1","185276370","185276617","chr1","64716831","64717063","66","120559539"
"chr1","185277281","185277575","chr1","161195045","161195321","31","24082236"
"chr1","185287414","185287508","chr3","40511111","40511199","20","144776303"
"chr1","185294509","185294794","chr16","45622944","45623242","52","139671565"
"chr1","185328198","185328358","chr1","161149820","161149980","16","24178378"
"chr1","185328399","185328501","chr1","161149660","161149761","8","24178739"
"chr1","185372642","185372919","chr1","161103519","161103808","31","24269123"
"chr1","185373893","185374152","chr1","161102288","161102544","28","24271605"
"chr1","185377254","185377530","chr1","161098636","161098918","34","24278618"
"chr1","185388951","185389117","chr18","9795354","9795521","33","175593597"
"chr1","185389416","185389598","chr9","98173536","98173682","57","87215880"
"chr1","185435480","185435765","chr1","161039173","161039465","37","24396307"
"chr1","185441739","185442042","chr16","67430450","67430749","63","118011289"
"chr1","185468591","185468885","chr1","161005232","161005527","23","24463359"
"chr1","185491893","185492189","chr3","43572948","43573229","64","141918945"
"chr1","185512591","185512891","chr20","54333740","54334033","58","131178851"
"chr1","185561228","185561364","chr1","160913219","160913355","5","24648009"
"chr1","185561676","185561863","chr1","160912081","160912252","25","24649595"
"chr1","185582611","185582926","chr1","160891351","160891638","42","24691260"
"chr1","185586700","185586939","chr1","160886968","160887208","25","24699732"
"chr1","185603366","185603671","chr1","160869965","160870242","39","24733401"
"chr1","185626884","185627168","chr1","160845657","160845924","28","24781227"
"chr1","185628945","185629245","chr1","160843553","160843858","20","24785392"
"chr1","185633350","185633639","chr1","160839221","160839525","49","24794129"
"chr1","185654064","185654358","chr1","160817968","160818263","17","24836096"
"chr1","185700305","185700612","chr11","65291765","65292070","53","120408540"
"chr1","185729058","185729343","chr1","160745981","160746267","11","24983077"
"chr1","185744231","185744364","chr1","44177093","44177224","24","141567138"
"chr1","185745413","185745715","chr17","9722411","9722714","60","176023002"
"chr1","185746141","185746213","chr1","160729904","160729975","3","25016237"
"chr1","185817411","185817706","chr1","160679637","160679928","27","25137774"
"chr1","185872321","185872615","chrX","41541015","41541312","66","144331306"
"chr1","185879138","185879240","chr3","13711275","13711376","15","172167863"
"chr1","185891007","185891298","chr13","39475662","39475956","58","146415345"
"chr1","185961500","185961821","chr1","160566957","160567270","37","25394543"
"chr1","185983800","185983916","chr1","160545759","160545875","5","25438041"
"chr1","185984664","185984742","chr1","160503764","160503848","13","25480900"
"chr1","185985766","185986058","chr1","160502449","160502742","22","25483317"
"chr1","186045111","186045388","chr19","2507487","2507757","54","183537624"
"chr1","186068434","186068742","chr1","160423617","160423923","20","25644817"
"chr1","186071243","186071573","chr1","160420782","160421068","62","25650461"
"chr1","186072788","186073074","chr12","120383494","120383777","54","65689294"
"chr1","186074226","186074401","chr13","87094576","87094741","32","98979650"
"chr1","186087763","186088053","chr1","160402716","160403009","18","25685047"
"chr1","186088681","186088749","chr4","133170908","133170975","18","52917773"
"chr1","186100811","186101033","chr1","160389426","160389648","14","25711385"
"chr1","186162585","186162891","chr1","160328973","160329299","47","25833612"
"chr1","186166582","186166901","chr1","160324960","160325277","40","25841622"
"chr1","186167662","186167960","chr1","160323872","160324177","28","25843790"
"chr1","186184090","186184218","chr10","63478601","63478730","18","122705489"
"chr1","186192956","186193254","chr1","160299156","160299463","22","25893800"
"chr1","186196751","186197040","chr1","160296938","160297207","35","25899813"
"chr1","186227491","186227766","chr1","160266299","160266575","17","25961192"
"chr1","186228870","186229159","chr1","160264884","160265201","50","25963986"
"chr1","186235714","186235973","chr1","160258172","160258409","40","25977542"
"chr1","186253739","186254020","chr11","124122142","124122422","56","62131597"
"chr1","186259710","186260008","chr1","160234291","160234588","20","26025419"
"chr1","186318022","186318280","chr1","160176786","160177050","24","26141236"
"chr1","186332448","186332742","chr1","160162292","160162591","16","26170156"
"chr1","186365642","186365781","chr1","160129566","160129712","18","26236076"
"chr1","186365819","186365946","chr1","160129406","160129525","14","26236413"
"chr1","186370521","186370831","chr1","160124448","160124758","18","26246073"
"chr1","186407277","186407464","chr3","47065508","47065682","46","139341769"
"chr1","186407510","186407607","chr19","3024654","3024753","16","183382856"
"chr1","186424808","186425111","chr14","65160980","65161276","56","121263828"
"chr1","186427203","186427460","chr13","20032006","20032252","70","166395197"
"chr1","186431331","186431446","chr1","160066615","160066733","11","26364716"
"chr1","186459821","186460110","chr1","160038503","160038791","15","26421318"
"chr1","186479892","186480181","chr5","78689579","78689868","56","107790313"
"chr1","186489325","186489442","chr1","160008324","160008447","11","26481001"
"chr1","186543378","186543536","chr1","159953758","159953925","18","26589620"
"chr1","186550453","186550787","chr1","159946145","159946452","51","26604308"
"chr1","186577549","186577841","chr1","159918724","159919016","13","26658825"
"chr1","186596768","186597104","chr9","97368435","97368764","77","89228333"
"chr1","186710657","186710953","chr1","159776812","159777115","33","26933845"
"chr1","186719374","186719671","chr3","124267629","124267922","60","62451745"
"chr1","186738838","186739043","chr1","159748710","159748915","17","26990128"
"chr1","186756105","186756389","chr20","4066886","4067172","61","182689219"
"chr1","186803077","186803342","chr1","159685186","159685453","20","27117891"
"chr1","186833175","186833477","chr1","159654393","159654673","38","27178782"
"chr1","186836516","186836641","chr1","159651174","159651299","11","27185342"
"chr1","186941874","186942033","chrX","13233270","13233431","33","173708604"
"chr1","186942170","186942291","chrX","8317252","8317371","20","178624918"
"chr1","186963187","186963254","chr1","43633249","43633312","17","143329938"
"chr1","186964294","186964577","chr1","159523748","159524026","15","27440546"
"chr1","186988251","186988545","chr2","48622768","48623061","49","138365483"
"chr1","187014477","187014755","chr1","159473635","159473914","17","27540842"
"chr1","187220169","187220479","chr1","159268499","159268811","21","27951670"
"chr1","187255696","187255973","chr1","159231962","159232245","19","28023734"
"chr1","187283235","187283344","chr6","56503130","56503239","17","130780105"
"chr1","187325331","187325603","chr1","159160686","159160965","18","28164645"
"chr1","187354436","187354725","chr1","159128569","159128890","51","28225867"
"chr1","187354753","187354787","chr7","141733292","141733322","8","45621461"
"chr1","187392032","187392315","chr1","159090699","159090983","18","28301333"
"chr1","187970023","187970148","chr1","158991945","158992071","5","28978078"
"chr1","187997410","187997708","chr1","158967191","158967492","20","29030219"
"chr1","188074612","188074896","chr1","158884164","158884447","18","29190448"
"chr1","188102302","188102586","chr1","158852259","158852542","15","29250043"
"chr1","188141483","188141701","chrX","114288908","114289128","56","73852575"
"chr1","188184191","188184488","chr7","132429645","132429936","60","55754546"
"chr1","188233784","188234081","chr3","44804504","44804797","60","143429280"
"chr1","188243996","188244285","chr1","158724446","158724735","19","29519550"
"chr1","188261205","188261509","chr1","158706896","158707184","31","29554309"
"chr1","188263371","188263671","chr1","158704725","158705018","23","29558646"
"chr1","188264540","188264836","chr1","158703951","158704243","21","29560589"
"chr1","188312006","188312133","chr1","158656886","158657014","9","29655120"
"chr1","188370024","188370280","chr1","158599241","158599476","26","29770783"
"chr1","188384958","188385258","chr1","158583852","158584137","36","29801106"
"chr1","188461830","188462115","chr1","158506652","158506936","22","29955178"
"chr1","188485790","188486066","chr19","6103272","6103552","61","182382518"
"chr1","188499239","188499542","chr1","158469330","158469632","19","30029909"
"chr1","188557180","188557452","chr1","158410884","158411176","37","30146296"
"chr1","188993221","188993372","chr19","39962858","39963005","42","149030363"
"chr1","188995062","188995309","chr1","157938849","157939106","28","31056213"
"chr1","189236128","189236455","chr18","11772161","11772473","70","177463967"
"chr1","189350458","189350747","chr1","157594902","157595207","36","31755556"
"chr1","189360670","189360990","chr1","157584282","157584601","19","31776388"
"chr1","189432236","189432522","chr1","157513304","157513580","35","31918932"
"chr1","189472047","189472344","chr1","157472890","157473178","35","31999157"
"chr1","189494395","189494696","chr1","157450630","157450916","42","32043765"
"chr1","189503205","189503455","chr1","157441894","157442151","19","32061311"
"chr1","189503792","189504087","chr1","157441278","157441573","18","32062514"
"chr1","189510803","189511097","chr1","157434262","157434555","25","32076541"
"chr1","189553329","189553614","chr1","157390763","157391052","25","32162566"
"chr1","189583674","189583975","chr1","157361083","157361376","21","32222591"
"chr1","189625809","189625965","chr1","157319516","157319673","15","32306293"
"chr1","189626005","189626121","chr1","157319357","157319473","6","32306648"
"chr1","189639289","189639473","chr1","125104979","125105165","42","64534310"
"chr1","189660087","189660392","chr1","157280645","157280934","32","32379442"
"chr1","189691317","189691625","chr1","157251192","157251503","31","32440125"
"chr1","189758024","189758145","chr1","157185951","157186072","10","32572073"
"chr1","189758171","189758330","chr1","157185760","157185922","19","32572411"
"chr1","189840942","189841013","chr10","14221515","14221578","11","175619427"
"chr1","189887941","189888205","chrX","97553453","97553732","62","92334488"
"chr1","189910651","189910965","chr1","157033258","157033577","27","32877393"
"chr1","189973831","189974124","chr1","156967915","156968214","48","33005916"
"chr1","190108143","190108428","chr1","156788301","156788585","25","33319842"
"chr1","190142539","190142851","chr1","156752740","156753051","14","33389799"
"chr1","190232818","190233119","chr1","156721825","156722106","53","33510993"
"chr1","190247853","190248056","chr1","156706591","156706809","25","33541262"
"chr1","190348454","190348737","chr1","156602710","156602986","26","33745744"
"chr1","190348891","190349189","chr1","44516138","44516440","55","145832753"
"chr1","190414731","190415047","chr1","156541353","156541664","31","33873378"
"chr1","190488930","190489169","chr1","156467453","156467717","34","34021477"
"chr1","190516505","190516645","chr1","156440654","156440788","17","34075851"
"chr1","190516946","190517080","chr1","156440218","156440351","12","34076728"
"chr1","190528348","190528621","chr1","156428729","156429006","19","34099619"
"chr1","190535753","190536043","chr1","156421268","156421557","16","34114485"
"chr1","190562055","190562355","chr1","156400628","156400930","40","34161427"
"chr1","190568079","190568359","chr3","123351694","123351976","49","67216385"
"chr1","190591064","190591352","chr3","40643531","40643820","50","149947533"
"chr1","190608154","190608465","chr1","156349042","156349329","46","34259112"
"chr1","190626532","190626817","chr8","68025108","68025400","61","122601424"
"chr1","190633844","190634118","chr1","156322524","156322801","31","34311320"
"chr1","190646055","190646257","chr1","156309313","156309517","19","34336742"
"chr1","190652227","190652515","chr1","156301729","156302019","22","34350498"
"chr1","190702610","190702896","chr1","156250668","156250954","19","34451942"
"chr1","190710681","190710920","chr1","156242331","156242574","24","34468350"
"chr1","190715631","190715898","chr1","89734834","89735093","50","100980797"
"chr1","190743563","190743750","chr1","156209269","156209457","14","34534294"
"chr1","190762456","190762755","chr11","108539027","108539321","61","82223429"
"chr1","190762830","190763133","chr1","156189644","156189956","21","34573186"
"chr1","190774868","190775000","chr1","156177310","156177433","14","34597558"
"chr1","190782498","190782800","chr1","156166668","156166952","46","34615830"
"chr1","190792514","190792789","chr1","67226741","67227023","59","123565773"
"chr1","190799358","190799611","chr8","11379571","11379821","67","179419787"
"chr1","190835307","190835591","chr1","156113090","156113379","14","34722217"
"chr1","190875083","190875353","chr1","156075095","156075364","23","34799988"
"chr1","190893152","190893310","chr1","156057464","156057621","7","34835688"
"chr1","190893479","190893617","chr1","156057153","156057294","8","34836326"
"chr1","190912075","190912367","chr1","156037485","156037777","13","34874590"
"chr1","190936365","190936655","chr1","156012453","156012743","36","34923912"
"chr1","190964643","190964829","chr2","159752903","159753095","45","31211740"
"chr1","190966526","190966822","chr1","155980128","155980430","21","34986398"
"chr1","190996598","190996876","chr1","155950012","155950287","14","35046586"
"chr1","191010139","191010427","chr1","155936306","155936593","23","35073833"
"chr1","191028693","191028956","chr1","155919275","155919561","46","35109418"
"chr1","191046962","191047257","chr1","155900401","155900695","14","35146561"
"chr1","191062468","191062795","chr8","78850789","78851109","73","112211679"
"chr1","191125194","191125319","chr1","155822074","155822204","13","35303120"
"chr1","191199725","191199952","chr1","155745677","155745894","25","35454048"
"chr1","191245232","191245345","chr1","155687902","155688018","13","35557330"
"chr1","191282975","191283222","chr1","155652305","155652552","13","35630670"
"chr1","191293895","191294214","chr6","2857881","2858210","57","188436014"
"chr1","191456592","191456886","chr1","155492863","155493161","31","35963729"
"chr1","191458316","191458610","chr1","155491153","155491471","44","35967163"
"chr1","191486228","191486541","chr1","155466661","155466980","35","36019567"
"chr1","191543709","191544002","chr1","155411249","155411544","16","36132460"
"chr1","191566021","191566325","chr1","44230646","44230948","58","147335375"
"chr1","191613297","191613464","chr1","155339168","155339334","14","36274129"
"chr1","191613778","191613898","chr1","155338747","155338865","9","36275031"
"chr1","191628070","191628359","chr11","109186448","109186735","52","82441622"
"chr1","191644574","191644868","chr1","155310067","155310358","17","36334507"
"chr1","191660737","191661028","chr1","155302841","155303132","17","36357896"
"chr1","191672062","191672328","chr1","155289222","155289501","24","36382840"
"chr1","191676997","191677060","chr13","10730050","10730111","11","180946947"
"chr1","191721234","191721501","chr1","42143576","42143839","66","149577658"
"chr1","191730760","191731005","chr1","155226223","155226475","33","36504537"
"chr1","191776102","191776403","chr1","155177836","155178139","25","36598266"
"chr1","191786143","191786416","chr1","155168236","155168514","49","36617907"
"chr1","191811388","191811661","chr1","155141171","155141450","21","36670217"
"chr1","191844923","191844994","chr4","109565285","109565356","11","82279638"
"chr1","191857258","191857550","chr1","155097857","155098149","19","36759401"
"chr1","191866846","191867142","chr1","155090018","155090312","21","36776828"
"chr1","191876964","191877237","chr1","155079719","155079990","20","36797245"
"chr1","191880368","191880669","chr1","182642228","182642528","59","9238140"
"chr1","191899083","191899300","chr1","155062079","155062315","28","36837004"
"chr1","191965196","191965499","chr1","154993241","154993575","53","36971955"
"chr1","191966455","191966738","chr1","154992041","154992350","42","36974414"
"chr1","191975273","191975569","chr1","154982519","154982815","15","36992754"
"chr1","191983884","191984003","chr9","53099322","53099443","19","138884562"
"chr1","191984408","191984709","chr3","39159304","39159586","69","152825104"
"chr1","191984846","191985142","chr1","154972087","154972368","32","37012759"
"chr1","192042684","192042903","chr14","105129753","105129968","39","86912931"
"chr1","192046021","192046140","chr1","154907271","154907388","17","37138750"
"chr1","192047655","192047938","chr1","154905473","154905778","45","37142182"
"chr1","192064875","192065100","chr3","65252765","65252984","57","126812110"
"chr1","192088644","192088873","chr19","672684","672923","59","191415960"
"chr1","192126214","192126516","chr1","154833590","154833896","29","37292624"
"chr1","192211677","192211985","chr1","154744422","154744759","37","37467255"
"chr1","192251287","192251596","chr1","154701897","154702175","51","37549390"
"chr1","192256179","192256479","chr1","154697309","154697604","31","37558870"
"chr1","192271200","192271464","chr1","154682099","154682392","46","37589101"
"chr1","192281801","192282116","chr1","154671649","154671957","38","37610152"
"chr1","192298857","192299125","chr1","154654117","154654393","25","37644740"
"chr1","192322903","192323202","chr1","154633145","154633446","28","37689758"
"chr1","192401270","192401397","chr6","64103366","64103490","32","128297904"
"chr1","192401695","192401764","chr1","43633249","43633312","16","148768446"
"chr1","192412049","192412353","chr1","154542836","154543117","47","37869213"
"chr1","192415447","192415758","chr1","154539409","154539732","39","37876038"
"chr1","192424098","192424321","chr1","154530539","154530762","19","37893559"
"chr1","192428195","192428477","chr1","154528553","154528835","27","37899642"
"chr1","192429008","192429231","chr1","154527844","154528062","25","37901164"
"chr1","192480735","192481008","chr1","154475076","154475348","17","38005659"
"chr1","192558894","192559194","chr1","154391210","154391507","25","38167684"
"chr1","192583298","192583579","chr1","154367081","154367363","20","38216217"
"chr1","192588389","192588691","chr1","154362043","154362354","37","38226346"
"chr1","192594795","192595087","chrX","108129050","108129338","51","84465745"
"chr1","192654017","192654296","chr16","56479316","56479590","57","136174701"
"chr1","192680869","192681094","chr12","38199679","38199910","53","154481190"
"chr1","192687957","192688267","chr1","154261716","154262030","30","38426241"
"chr1","192723109","192723402","chr1","154225315","154225606","21","38497794"
"chr1","192743355","192743475","chr1","154205283","154205418","29","38538072"
"chr1","192743771","192743915","chr1","154204838","154204982","6","38538933"
"chr1","192756777","192757100","chr1","154191343","154191652","31","38565434"
"chr1","192757728","192757993","chr1","154190429","154190710","24","38567299"
"chr1","192835213","192835321","chr3","42928549","42928657","24","149906664"
"chr1","192854513","192854822","chr19","29595568","29595878","64","163258945"
"chr1","192863777","192864081","chr1","142316197","142316495","61","50547580"
"chr1","192876789","192876999","chrX","127636612","127636822","20","65240177"
"chr1","192901953","192902080","chr1","154047413","154047531","16","38854540"
"chr1","192921364","192921481","chr1","154027961","154028076","6","38893403"
"chr1","192923222","192923534","chr1","154025945","154026260","28","38897277"
"chr1","192943919","192944183","chr1","154005494","154005765","25","38938425"
"chr1","192947147","192947445","chr1","154002282","154002585","26","38944865"
"chr1","192979257","192979468","chr13","104678880","104679093","46","88300377"
"chr1","193078217","193078567","chr1","153873426","153873738","57","39204791"
"chr1","193096875","193097171","chr1","153860946","153861244","21","39235929"
"chr1","193117551","193117841","chr1","153838194","153838496","40","39279357"
"chr1","193133340","193133561","chr8","78728288","78728498","46","114405052"
"chr1","193145753","193146059","chr1","153808670","153808949","39","39337083"
"chr1","193180095","193180336","chr1","153773206","153773428","30","39406889"
"chr1","193205818","193205914","chr17","74692815","74692912","16","118513003"
"chr1","193228992","193229278","chr1","153734701","153735005","34","39494291"
"chr1","193252933","193253058","chr1","153709788","153709913","11","39543145"
"chr1","193255001","193255287","chr1","153707243","153707530","10","39547758"
"chr1","193258198","193258504","chr1","153703714","153704012","24","39554484"
"chr1","193297125","193297404","chr1","153660681","153660940","61","39636444"
"chr1","193362292","193362592","chr11","109624796","109625101","59","83737496"
"chr1","193493011","193493134","chr2","203169966","203170091","22","9676955"
"chr1","193493166","193493336","chr10","59585158","59585323","36","133908008"
"chr1","193530188","193530496","chr1","153434092","153434385","34","40096096"
"chr1","193564289","193564561","chr1","153400373","153400650","21","40163916"
"chr1","193579205","193579483","chr1","153385403","153385682","17","40193802"
"chr1","193603552","193603815","chr1","20257747","20258018","64","173345805"
"chr1","193650579","193650872","chr16","28920827","28921119","63","164729752"
"chr1","193659813","193659989","chr13","3753490","3753664","47","189906323"
"chr1","193717752","193717893","chr1","153250707","153250848","4","40467045"
"chr1","193816848","193817144","chr1","153155376","153155661","27","40661472"
"chr1","193824968","193825255","chr1","153147534","153147822","21","40677434"
"chr1","193858683","193858963","chr1","153113168","153113447","20","40745515"
"chr1","193863299","193863605","chr1","153109665","153109972","23","40753634"
"chr1","193864171","193864475","chr1","153108797","153109095","34","40755374"
"chr1","193887351","193887668","chr1","153084717","153085029","26","40802634"
"chr1","194036285","194036417","chr17","18119247","18119377","26","175917038"
"chr1","194059200","194059505","chr1","152930603","152930904","30","41128597"
"chr1","194145697","194145821","chr1","152798323","152798448","13","41347374"
"chr1","194147156","194147451","chr6","77260247","77260553","74","116886909"
"chr1","194177802","194178083","chr1","152761644","152761921","31","41416158"
"chr1","194479404","194479705","chr1","152458038","152458343","36","42021366"
"chr1","194506661","194506843","chr1","152430562","152430751","28","42076099"
"chr1","194528904","194529188","chr1","152408386","152408673","12","42120518"
"chr1","194616036","194616375","chr7","112338777","112339094","85","82277259"
"chr1","194630647","194630956","chr1","152307318","152307616","31","42323329"
"chr1","194642682","194642815","chr1","152295547","152295678","8","42347135"
"chr1","194710390","194710662","chr1","152225939","152226231","39","42484451"
"chr1","194722940","194723244","chr1","152204970","152205278","20","42517970"
"chr1","194740257","194740578","chr5","51350304","51350607","67","143389953"
"chr1","194783391","194783677","chr1","152148453","152148741","20","42634938"
"chr1","194806113","194806415","chr1","152125899","152126173","54","42680214"
"chr1","194822039","194822320","chr1","94156764","94157033","64","100665275"
"chr1","194836469","194836784","chr1","152093966","152094273","31","42742503"
"chr1","194846791","194846983","chr1","67589625","67589802","47","127257166"
"chr1","194857096","194857210","chr13","94073133","94073250","22","100783963"
"chr1","194857250","194857424","chr2","92036336","92036508","33","102820914"
"chr1","194872802","194873077","chr1","152056159","152056456","44","42816643"
"chr1","194874049","194874354","chr1","152054850","152055195","58","42819199"
"chr1","194884124","194884364","chr6","147224714","147224958","44","47659410"
"chr1","194892875","194893126","chrY","248624","248872","56","194644251"
"chr1","194901691","194901969","chr1","152026902","152027175","23","42874789"
"chr1","194921345","194921621","chr1","152008970","152009244","22","42912375"
"chr1","194928109","194928397","chr2","104445382","104445669","63","90482727"
"chr1","194928717","194929011","chr1","152001304","152001612","42","42927413"
"chr1","194933357","194933660","chr1","151996686","151996994","34","42936671"
"chr1","194942351","194942639","chr1","151987538","151987838","34","42954813"
"chr1","194946936","194947227","chr1","151982959","151983249","21","42963977"
"chr1","194951580","194951875","chr1","151978226","151978525","23","42973354"
"chr1","194958653","194958960","chr1","151971210","151971508","36","42987443"
"chr1","194959053","194959247","chr15","100264535","100264732","38","94694518"
"chr1","195009724","195010026","chr1","151918546","151918830","39","43091178"
"chr1","195016143","195016403","chr1","151912246","151912490","32","43103897"
"chr1","195076254","195076532","chr1","151854086","151854370","29","43222168"
"chr1","195103327","195103615","chr1","151828205","151828490","18","43275122"
"chr1","195131388","195131642","chr1","151800223","151800479","20","43331165"
"chr1","195134967","195135236","chr16","28482793","28483062","74","166652174"
"chr1","195206273","195206430","chr20","57080575","57080731","38","138125698"
"chr1","195206716","195206864","chr19","14661557","14661699","37","180545159"
"chr1","195266061","195266354","chr1","151660245","151660563","54","43605816"
"chr1","195280018","195280299","chr1","151646190","151646471","12","43633828"
"chr1","195436441","195436734","chr1","151482493","151482789","21","43953948"
"chr1","195457342","195457646","chr1","151452992","151453301","23","44004350"
"chr1","195476283","195476481","chr1","151433826","151434029","13","44042457"
"chr1","195610942","195611190","chr1","151306248","151306510","39","44304694"
"chr1","195703341","195703467","chr7","133813449","133813579","25","61889892"
"chr1","196001577","196001692","chr1","150887115","150887230","6","45114462"
"chr1","196014294","196014609","chr1","150874148","150874463","28","45140146"
"chr1","196069292","196069591","chr1","150818355","150818662","37","45250937"
"chr1","196118560","196118926","chrX","47229042","47229392","106","148889518"
"chr1","196147348","196147639","chr1","150741496","150741797","26","45405852"
"chr1","196155157","196155454","chr1","150733689","150733963","39","45421468"
"chr1","196271579","196271883","chr1","150609761","150610044","41","45661818"
"chr1","196343085","196343392","chr1","141854701","141855000","65","54488384"
"chr1","196361322","196361521","chr1","123535668","123535856","49","72825654"
"chr1","196505726","196506030","chr1","150382933","150383227","34","46122793"
"chr1","196539080","196539401","chr1","150349020","150349338","34","46190060"
"chr1","196746211","196746525","chr1","150148622","150148929","37","46597589"
"chr1","196767170","196767424","chr1","21560196","21560484","79","175206974"
"chr1","196797754","196797944","chr7","114050953","114051125","45","82746801"
"chr1","196811008","196811327","chr1","150080242","150080566","35","46730766"
"chr1","196851233","196851352","chr9","23213350","23213467","24","173637883"
"chr1","196851381","196851544","chr19","8026553","8026714","32","188824828"
"chr1","196906075","196906370","chr19","35633077","35633377","58","161272998"
"chr1","197019630","197019886","chr13","24177288","24177547","65","172842342"
"chr1","197075763","197076062","chr1","149820203","149820479","52","47255560"
"chr1","197102333","197102608","chr1","149793240","149793527","29","47309093"
"chr1","197123095","197123210","chr1","149772967","149773083","11","47350128"
"chr1","197174847","197175206","chr1","149721930","149722260","53","47452917"
"chr1","197204596","197204908","chr1","149692448","149692742","52","47512148"
"chr1","197230931","197231048","chr1","212741019","212741130","27","15510088"
"chr1","197251052","197251333","chr1","149645492","149645759","36","47605560"
"chr1","197319450","197319747","chr1","149575088","149575395","35","47744362"
"chr1","197331199","197331478","chr1","149563351","149563630","27","47767848"
"chr1","197361770","197362072","chr1","149533436","149533732","32","47828334"
"chr1","197390426","197390711","chrX","65717613","65717893","55","131672813"
"chr1","197482879","197483172","chr1","43902169","43902461","59","153580710"
"chr1","197534538","197534846","chr1","149358590","149358903","23","48175948"
"chr1","197544871","197545181","chr1","149348634","149348948","16","48196237"
"chr1","197548428","197548729","chr1","149345063","149345377","32","48203365"
"chr1","197549832","197550119","chr3","46647583","46647874","52","150902249"
"chr1","197561390","197561668","chr1","149332089","149332365","35","48229301"
"chr1","197847838","197848138","chr1","149043570","149043854","45","48804268"
"chr1","197852328","197852606","chr1","149039131","149039410","21","48813197"
"chr1","197912390","197912695","chr1","148978235","148978553","29","48934155"
"chr1","197987539","197987658","chr9","122912010","122912131","17","75075529"
"chr1","198006829","198007138","chr1","148882470","148882781","28","49124359"
"chr1","198025408","198025720","chr1","148865217","148865520","39","49160191"
"chr1","198172925","198173209","chr1","182642228","182642528","60","15530697"
"chr1","198233404","198233699","chr1","148653812","148654113","28","49579592"
"chr1","198278190","198278455","chr1","148607704","148607969","15","49670486"
"chr1","198285195","198285422","chr1","186270447","186270674","44","12014748"
"chr1","198319067","198319334","chr1","148565590","148565857","21","49753477"
"chr1","198471783","198472040","chr8","28287757","28288013","57","170184026"
"chr1","198484680","198484988","chr1","148400827","148401135","23","50083853"
"chr1","198499353","198499469","chr1","148386664","148386780","3","50112689"
"chr1","198500691","198500884","chr1","148384927","148385116","17","50115764"
"chr1","198544930","198545220","chr1","148340688","148340972","28","50204242"
"chr1","198552637","198552938","chr14","7684125","7684438","83","190868512"
"chr1","198621430","198621689","chr1","148259707","148260004","53","50361723"
"chr1","198651273","198651407","chr19","37004756","37004888","20","161646517"
"chr1","198675277","198675411","chr6","171645003","171645132","16","27030274"
"chr1","198680362","198680654","chr1","148196525","148196819","30","50483837"
"chr1","198704396","198704692","chr1","148173714","148173996","36","50530682"
"chr1","198767040","198767337","chr17","9722411","9722714","61","189044629"
"chr1","198769647","198769940","chr1","148110784","148111078","25","50658863"
"chr1","198790595","198790876","chr1","148090202","148090488","19","50700393"
"chr1","198792106","198792285","chr1","148088603","148088782","18","50703503"
"chr1","198812377","198812666","chr1","148068966","148069259","22","50743411"
"chr1","198818808","198819121","chr1","148062463","148062765","28","50756345"
"chr1","199253109","199253432","chrX","65053049","65053349","71","134200060"
"chr1","199415954","199416044","chr1","147424707","147424797","4","51991247"
"chr1","199542052","199542348","chr1","147298741","147299039","22","52243311"
"chr1","199615541","199615838","chr1","147223744","147224040","30","52391797"
"chr1","199832126","199832419","chr1","147011780","147012070","23","52820346"
"chr1","199849477","199849786","chr1","146995161","146995435","51","52854316"
"chr1","199850950","199851078","chr20","54697731","54697854","21","145153219"
"chr1","199934244","199934504","chr6","176033710","176033969","60","23900534"
"chr1","199946068","199946382","chr1","146895244","146895557","23","53050824"
"chr1","200237695","200237914","chr1","146817027","146817265","33","53420668"
"chr1","200257135","200257476","chr1","146798058","146798374","42","53459077"
"chr1","200309192","200309497","chr1","146741433","146741738","22","53567759"
"chr1","200312173","200312466","chr1","146738344","146738642","34","53573829"
"chr1","200316455","200316751","chr1","146733366","146733672","30","53583089"
"chr1","200321277","200321401","chr1","146728642","146728772","18","53592635"
"chr1","200365276","200365601","chr16","50584120","50584441","69","149781156"
"chr1","200406812","200407119","chr3","50329605","50329905","64","150077207"
"chr1","200422432","200422744","chr1","146580843","146581152","27","53841589"
"chr1","200447681","200447986","chr1","146553304","146553584","43","53894377"
"chr1","200450526","200450815","chr1","146550511","146550804","18","53900015"
"chr1","200456677","200456958","chr1","146544404","146544685","20","53912273"
"chr1","200492008","200492307","chr11","110011587","110011884","55","90480421"
"chr1","200512657","200512916","chr1","146475422","146475688","28","54037235"
"chr1","200524451","200524757","chr1","146464255","146464559","27","54060196"
"chr1","200530030","200530117","chr3","45470739","45470828","18","155059291"
"chr1","200554811","200555100","chr1","146433825","146434131","40","54120986"
"chr1","200558269","200558517","chr16","58496454","58496688","53","142061815"
"chr1","200559003","200559160","chr12","101537347","101537508","38","99021656"
"chr1","200569043","200569327","chr1","146421864","146422156","32","54147179"
"chr1","200594049","200594352","chr1","146398093","146398396","16","54195956"
"chr1","200618262","200618535","chr1","146373310","146373583","15","54244952"
"chr1","200626077","200626389","chr1","146365442","146365728","59","54260635"
"chr1","200661177","200661446","chr1","146321092","146321368","49","54340085"
"chr1","200665608","200665740","chr11","120988217","120988348","19","79677391"
"chr1","200681187","200681410","chrX","8697309","8697538","42","191983878"
"chr1","200687151","200687358","chr1","146296012","146296208","27","54391139"
"chr1","200687677","200687963","chr1","146294183","146294467","17","54393494"
"chr1","200702125","200702409","chr1","146283479","146283780","43","54418646"
"chr1","200730860","200731147","chr1","146235901","146236203","34","54494959"
"chr1","200743604","200743911","chr1","146223121","146223431","21","54520483"
"chr1","200748294","200748587","chr1","146217698","146217998","32","54530596"
"chr1","200771739","200771930","chr1","146194806","146194995","16","54576933"
"chr1","200790576","200790861","chr1","146176391","146176704","42","54614185"
"chr1","200848014","200848218","chr1","146118006","146118197","35","54730008"
"chr1","200871937","200872235","chr1","146092606","146092900","25","54779331"
"chr1","200905703","200905992","chr7","140588016","140588306","53","60317687"
"chr1","200908527","200908773","chr12","60880223","60880470","45","140028304"
"chr1","200957349","200957583","chr1","146016526","146016760","23","54940823"
"chr1","200978869","200979166","chrX","41541015","41541312","52","159437854"
"chr1","201039665","201039973","chr1","145923864","145924164","35","55115801"
"chr1","201040638","201040953","chr1","145922886","145923179","38","55117752"
"chr1","201046832","201047130","chr1","145916433","145916737","31","55130399"
"chr1","201235462","201235764","chr1","145717224","145717515","28","55518238"
"chr1","201260762","201261085","chr1","145691475","145691780","37","55569287"
"chr1","201291269","201291572","chr20","28651476","28651780","54","172639793"
"chr1","201331776","201332056","chr1","145619253","145619532","15","55712523"
"chr1","201385348","201385641","chr1","62477521","62477814","62","138907827"
"chr1","201386417","201386723","chrX","16320386","16320684","57","185066031"
"chr1","201435238","201435558","chr19","11528525","11528831","68","189906713"
"chr1","201447924","201448210","chr1","145488559","145488849","50","55959365"
"chr1","201470631","201470934","chr1","145465694","145466000","24","56004937"
"chr1","201625547","201625817","chr4","115024319","115024581","63","86601228"
"chr1","201662551","201662670","chr2","168401179","168401296","15","33261372"
"chr1","201730249","201730374","chr4","106500045","106500170","21","95230204"
"chr1","201788083","201788383","chr7","19471164","19471448","66","182316919"
"chr1","201805493","201805733","chr1","145107629","145107869","16","56697864"
"chr1","201895866","201896163","chr1","145006262","145006570","39","56889604"
"chr1","201976304","201976592","chr1","144921751","144922038","23","57054553"
"chr1","202032864","202033172","chr1","144853635","144853949","28","57179229"
"chr1","202107774","202107969","chr1","144775029","144775226","11","57332745"
"chr1","202279874","202280128","chr1","144642317","144642571","16","57637557"
"chr1","202439837","202439968","chr1","144486514","144486647","7","57953323"
"chr1","202495742","202496005","chr1","144428603","144428865","21","58067139"
"chr1","202576587","202576902","chr1","144356315","144356631","38","58220272"
"chr1","202595805","202596100","chr4","43182123","43182418","62","159413682"
"chr1","202629379","202629640","chr1","144291826","144292083","24","58337553"
"chr1","202650926","202651038","chr1","144281048","144281165","10","58369878"
"chr1","202651077","202651211","chr1","144280881","144281009","16","58370196"
"chr1","202666425","202666551","chr1","144265240","144265370","16","58401185"
"chr1","202672824","202673111","chr1","144258638","144258937","45","58414186"
"chr1","202785194","202785495","chr1","144141526","144141850","48","58643668"
"chr1","202825300","202825584","chr19","35299256","35299528","65","167526044"
"chr1","202835190","202835494","chr1","144083857","144084159","19","58751333"
"chr1","202922046","202922350","chr1","143997035","143997344","23","58925011"
"chr1","202949597","202949731","chr15","109869590","109869722","31","93080007"
"chr1","202968508","202968810","chr1","143951377","143951677","26","59017131"
"chr1","202975535","202975827","chr1","143938249","143938541","19","59037286"
"chr1","202977595","202977898","chr1","143936177","143936474","25","59041418"
"chr1","203107481","203107769","chr1","143794565","143794852","16","59312916"
"chr1","203112032","203112350","chr1","143789879","143790192","32","59322153"
"chr1","203216178","203216450","chr1","143749571","143749860","33","59466607"
"chr1","203224106","203224392","chr1","143740913","143741191","21","59483193"
"chr1","203228469","203228596","chr1","143736944","143737071","6","59491525"
"chr1","203262127","203262421","chr1","143702098","143702380","42","59560029"
"chr1","203318109","203318414","chr1","143639034","143639327","35","59679075"
"chr1","203410011","203410134","chr3","36373230","36373353","19","167036781"
"chr1","203465758","203466025","chr1","114741175","114741451","59","88724583"
"chr1","203549158","203549455","chr1","143395974","143396274","35","60153184"
"chr1","203566556","203566849","chr1","143382307","143382594","19","60184249"
"chr1","203593678","203593778","chr15","108465059","108465154","24","95128619"
"chr1","203596919","203597258","chr1","143348709","143349051","21","60248210"
"chr1","203599050","203599182","chr5","39904708","39904838","22","163694342"
"chr1","203623418","203623718","chr1","143314336","143314625","39","60309082"
"chr1","203651365","203651554","chr2","92392609","92392805","49","111258756"
"chr1","203665304","203665592","chr1","143275457","143275747","22","60389847"
"chr1","203748427","203748722","chr1","143194325","143194620","20","60554102"
"chr1","203751516","203751808","chr20","41706573","41706866","57","162044943"
"chr1","203778709","203778993","chr1","143160973","143161240","35","60617736"
"chr1","203781095","203781307","chr8","22439702","22439922","45","181341393"
"chr1","203825274","203825574","chr1","143113703","143114009","22","60711571"
"chr1","203826395","203826688","chr1","143112601","143112892","31","60713794"
"chr1","203839181","203839389","chr2","71125427","71125623","48","132713754"
"chr1","203848877","203849111","chr1","143089779","143090025","33","60759098"
"chr1","203874367","203874672","chr5","1931483","1931784","59","201942884"
"chr1","203947801","203947924","chr1","142993218","142993341","8","60954583"
"chr1","203993361","203993599","chr1","142944473","142944711","16","61048888"
"chr1","204082373","204082660","chr1","142859155","142859435","24","61223218"
"chr1","204118382","204118499","chr1","142825299","142825416","11","61293083"
"chr1","204118885","204119043","chr4","161962632","161962792","25","42156253"
"chr1","204143674","204144045","chr1","142804909","142805294","31","61338765"
"chr1","204156116","204156412","chr16","44072419","44072715","56","160083697"
"chr1","204190259","204190589","chr1","142756412","142756738","25","61433847"
"chr1","204205103","204205396","chr17","80429135","80429431","62","123775968"
"chr1","204208084","204208206","chr1","142741577","142741699","8","61466507"
"chr1","204221964","204222264","chr1","142727953","142728253","19","61494011"
"chr1","204265842","204266143","chr1","142637793","142638090","30","61628049"
"chr1","204267874","204268163","chr1","142635723","142635992","44","61632151"
"chr1","204298879","204299170","chr19","7088829","7089120","57","197210050"
"chr1","204322186","204322484","chr10","36370152","36370458","54","167952034"
"chr1","204329424","204329737","chr1","100649392","100649693","68","103680032"
"chr1","204332804","204333079","chr1","142574185","142574451","27","61758619"
"chr1","204370996","204371300","chr1","142536481","142536750","58","61834515"
"chr1","204383961","204384242","chr1","142523424","142523705","29","61860537"
"chr1","204392962","204393255","chr1","142514634","142514921","20","61878328"
"chr1","204393351","204393405","chr1","142514483","142514539","8","61878868"
"chr1","204396937","204397250","chr1","142510638","142510954","24","61886299"
"chr1","204408124","204408345","chrX","114288908","114289128","48","90119216"
"chr1","204421782","204421911","chr1","142487918","142488046","7","61933864"
"chr1","204422216","204422396","chr1","142487441","142487607","35","61934775"
"chr1","204433451","204433573","chr1","142475578","142475703","11","61957873"
"chr1","204456698","204456997","chr19","3500436","3500734","68","200956262"
"chr1","204485072","204485356","chr1","142422865","142423155","19","62062207"
"chr1","204486984","204487176","chr1","142421050","142421251","29","62065934"
"chr1","204487474","204487611","chr1","142420619","142420755","11","62066855"
"chr1","204508028","204508325","chr1","142396212","142396497","27","62111816"
"chr1","204561806","204561930","chr1","142344611","142344744","19","62217195"
"chr1","204567862","204568125","chr3","75139327","75139597","61","129428535"
"chr1","204570529","204570612","chr1","142335499","142335582","9","62235030"
"chr1","204578958","204579241","chr1","142326683","142326970","19","62252275"
"chr1","204588943","204589223","chr1","142316197","142316495","37","62272746"
"chr1","204626575","204626733","chr17","3933207","3933362","36","200693368"
"chr1","204646643","204646846","chr1","142257902","142258110","16","62388741"
"chr1","204657029","204657164","chrX","8417026","8417160","24","196240003"
"chr1","204664171","204664440","chr1","142246146","142246419","45","62418025"
"chr1","204670194","204670305","chr3","166844751","166844866","19","37825443"
"chr1","204670627","204670772","chr5","188672788","188672950","48","15997839"
"chr1","204674247","204674406","chr10","33604518","33604671","46","171069729"
"chr1","204674625","204674751","chr12","61371182","61371299","28","143303443"
"chr1","204682876","204682996","chr1","142227617","142227753","31","62455259"
"chr1","204684453","204684591","chr1","142226053","142226190","12","62458400"
"chr1","204693591","204693800","chr1","142215141","142215371","37","62478450"
"chr1","204694093","204694233","chr1","142214708","142214845","10","62479385"
"chr1","204712308","204712432","chr1","142197276","142197398","12","62515032"
"chr1","204724494","204724671","chr1","142183614","142183801","21","62540880"
"chr1","204724967","204725096","chr1","205464254","205464380","15","739287"
"chr1","204737690","204737868","chr1","142171987","142172159","14","62565703"
"chr1","204738178","204738309","chr1","142171563","142171700","14","62566615"
"chr1","204738674","204738994","chr1","142170878","142171195","42","62567796"
"chr1","204745504","204745626","chr13","80587853","80587974","17","124157651"
"chr1","204746028","204746322","chr16","11545677","11545975","58","193200351"
"chr1","204748173","204748434","chr1","142159134","142159394","19","62589039"
"chr1","204755051","204755333","chr1","142152294","142152586","24","62602757"
"chr1","204756173","204756293","chr1","142151320","142151440","6","62604853"
"chr1","204768490","204768560","chr1","142137186","142137265","13","62631304"
"chr1","204770064","204770350","chr1","142135627","142135885","45","62634437"
"chr1","204777522","204777642","chr1","205464254","205464380","21","686732"
"chr1","204778983","204779277","chr6","176458169","176458462","58","28320814"
"chr1","204786646","204786896","chr6","150935570","150935823","47","53851076"
"chr1","204791733","204792012","chr1","142113410","142113693","22","62678323"
"chr1","204796617","204796820","chr1","142108643","142108858","22","62687974"
"chr1","204798023","204798321","chr1","142107168","142107461","36","62690855"
"chr1","204800360","204800657","chr1","142104829","142105130","25","62695531"
"chr1","204803719","204803984","chr1","142102089","142102367","28","62701630"
"chr1","204803998","204804289","chr1","142101793","142102084","24","62702205"
"chr1","204816922","204817198","chr15","25968954","25969221","67","178847968"
"chr1","204821014","204821129","chr1","142083823","142083932","14","62737191"
"chr1","204821151","204821369","chr14","105129753","105129968","50","99691398"
"chr1","204838551","204838668","chr12","56838573","56838695","22","147999978"
"chr1","204855059","204855344","chr1","142040409","142040715","37","62814650"
"chr1","204873782","204873915","chr1","142021789","142021920","14","62851993"
"chr1","204891263","204891580","chr1","142004075","142004379","45","62887188"
"chr1","204893982","204894275","chr1","142001682","142001978","26","62892300"
"chr1","204918166","204918447","chr1","141976676","141976949","27","62941490"
"chr1","204944792","204945104","chr1","141947831","141948139","16","62996961"
"chr1","204945807","204946087","chr1","141946844","141947152","39","62998963"
"chr1","204960457","204960721","chr1","141932191","141932456","18","63028266"
"chr1","204966870","204967001","chr10","85334179","85334311","19","119632691"
"chr1","204970750","204970867","chr1","141921392","141921509","6","63049358"
"chr1","204974725","204974857","chr8","71179092","71179225","15","133795633"
"chr1","204974928","204975245","chr1","141916970","141917301","35","63057958"
"chr1","204986502","204986791","chr1","141904341","141904626","24","63082161"
"chr1","204989461","204989763","chr19","43210585","43210888","56","161778876"
"chr1","204993352","204993653","chr1","141897659","141897928","49","63095693"
"chr1","205003015","205003316","chr1","141883086","141883392","15","63119929"
"chr1","205003367","205003652","chr1","141882424","141882708","27","63120943"
"chr1","205008217","205008419","chr1","141877604","141877814","23","63130613"
"chr1","205014833","205015149","chr1","141872108","141872432","39","63142725"
"chr1","205033156","205033455","chr1","141854701","141855000","17","63178455"
"chr1","205044563","205044857","chr1","141843640","141843933","11","63200923"
"chr1","205063711","205064014","chr3","44516079","44516380","52","160547632"
"chr1","205071110","205071378","chr1","141807060","141807331","25","63264050"
"chr1","205089032","205089327","chr1","141788674","141788969","18","63300358"
"chr1","205090422","205090691","chr1","141787325","141787591","13","63303097"
"chr1","205111862","205112150","chr3","48105482","48105749","70","157006380"
"chr1","205118385","205118677","chr1","136549718","136550007","61","68568667"
"chr1","205163256","205163552","chr1","141708058","141708354","20","63455198"
"chr1","205168038","205168331","chr1","141703232","141703540","40","63464806"
"chr1","205211759","205212072","chr1","141653454","141653758","34","63558305"
"chr1","205217209","205217500","chr4","159090526","159090826","55","46126683"
"chr1","205253655","205253772","chr1","141610966","141611083","4","63642689"
"chr1","205264373","205264506","chr13","46512186","46512305","33","158752187"
"chr1","205375661","205375908","chr2","104672036","104672284","53","100703625"
"chr1","205379354","205379439","chr10","74256822","74256908","20","131122532"
"chr1","205389193","205389472","chr8","9939694","9939983","55","195449499"
"chr1","205453868","205454173","chr1","141366938","141367244","13","64086930"
"chr1","205463881","205464155","chr1","141357069","141357325","34","64106812"
"chr1","205500723","205500973","chr8","39029036","39029280","51","166471687"
"chr1","205530396","205530520","chrX","63161459","63161584","36","142368937"
"chr1","205556313","205556426","chr1","141272842","141272955","7","64283471"
"chr1","205708448","205708748","chr1","141091881","141092200","36","64616567"
"chr1","205751581","205751877","chr1","141031827","141032118","46","64719754"
"chr1","205757430","205757627","chr1","141026087","141026300","27","64731343"
"chr1","205766437","205766713","chr1","141016920","141017202","33","64749517"
"chr1","205770277","205770577","chr1","141013138","141013441","25","64757139"
"chr1","205803326","205803627","chr1","140976019","140976298","46","64827307"
"chr1","205817812","205818023","chr1","140959185","140959388","22","64858627"
"chr1","205830607","205830722","chr1","140940833","140940948","14","64889774"
"chr1","205868984","205869285","chr1","140901826","140902127","17","64967158"
"chr1","205960540","205960774","chr19","3350946","3351183","53","202609594"
"chr1","205972424","205972726","chr1","140798171","140798485","37","65174253"
"chr1","206010243","206010541","chr1","140760518","140760820","22","65249725"
"chr1","206036625","206036742","chr1","140734744","140734861","7","65301881"
"chr1","206044134","206044355","chr1","140727126","140727353","22","65317008"
"chr1","206063760","206064013","chr1","140702813","140703068","14","65360947"
"chr1","206097822","206097940","chr1","140669497","140669602","14","65428325"
"chr1","206099160","206099283","chr1","140667856","140667979","9","65431304"
"chr1","206103943","206104054","chr2","98262271","98262382","23","107841672"
"chr1","206106387","206106688","chr1","140660327","140660628","21","65446060"
"chr1","206110214","206110277","chr1","140656817","140656882","8","65453397"
"chr1","206134774","206135080","chr1","140632562","140632857","34","65502212"
"chr1","206147324","206147604","chr1","140619322","140619603","16","65528002"
"chr1","206149666","206149882","chr19","35895571","35895778","41","170254095"
"chr1","206150190","206150509","chr1","140616569","140616885","20","65533621"
"chr1","206156362","206156486","chr1","18100775","18100899","22","188055587"
"chr1","206187141","206187436","chr1","62195366","62195671","64","143991775"
"chr1","206192863","206192983","chr1","140571870","140571990","2","65620993"
"chr1","206193121","206193408","chr1","140571439","140571732","23","65621682"
"chr1","206197282","206197485","chr1","140567408","140567608","11","65629874"
"chr1","206202481","206202785","chr4","71517233","71517531","62","134685248"
"chr1","206204661","206204943","chr1","140559924","140560203","30","65644737"
"chr1","206216375","206216666","chr1","140548636","140548894","51","65667739"
"chr1","206221860","206222050","chr1","140542859","140543052","20","65679001"
"chr1","206222717","206223014","chr1","140541933","140542221","25","65680784"
"chr1","206228065","206228233","chr12","87917476","87917649","42","118310589"
"chr1","206228535","206228665","chr7","59908625","59908753","21","146319910"
"chr1","206228673","206228961","chr1","140535944","140536232","17","65692729"
"chr1","206242743","206242997","chr1","140521876","140522130","11","65720867"
"chr1","206249245","206249529","chr1","140514139","140514431","40","65735106"
"chr1","206264539","206264610","chr3","29922154","29922221","18","176342385"
"chr1","206272160","206272435","chr1","140497106","140497402","44","65775054"
"chr1","206295368","206295546","chr2","53384035","53384215","40","152911333"
"chr1","206297430","206297584","chr7","84537557","84537711","23","121759873"
"chr1","206297883","206298038","chr10","79933108","79933257","29","126364775"
"chr1","206324746","206325041","chr1","140440213","140440507","30","65884533"
"chr1","206369672","206369879","chr1","140394522","140394727","9","65975150"
"chr1","206389558","206389674","chr1","140374515","140374631","9","66015043"
"chr1","206392791","206393022","chr14","18138796","18139028","55","188253995"
"chr1","206404084","206404203","chr1","140359338","140359457","7","66044746"
"chr1","206408703","206409015","chr1","140354452","140354787","41","66054251"
"chr1","206430627","206430930","chr1","140335689","140335995","21","66094938"
"chr1","206437852","206437944","chr1","140328849","140328942","4","66109003"
"chr1","206438233","206438344","chr1","140328428","140328538","9","66109805"
"chr1","206463816","206464131","chr1","140300139","140300448","33","66163677"
"chr1","206471180","206471462","chr1","140293031","140293309","22","66178149"
"chr1","206492999","206493322","chr1","140271694","140272024","40","66221305"
"chr1","206502489","206502777","chr1","140262311","140262611","24","66240178"
"chr1","206506965","206507093","chr9","115052851","115052979","17","91454114"
"chr1","206533959","206534232","chr1","140225951","140226216","22","66308008"
"chr1","206550176","206550299","chr1","140201164","140201287","5","66349012"
"chr1","206554014","206554306","chr19","38813333","38813628","58","167740681"
"chr1","206556446","206556739","chr1","140196139","140196434","33","66360307"
"chr1","206563435","206563728","chr1","136053595","136053894","70","70509840"
"chr1","206569929","206570175","chr1","140183024","140183278","48","66386905"
"chr1","206606911","206607096","chr7","53098951","53099122","53","153507960"
"chr1","206614172","206614471","chr1","140138425","140138725","21","66475747"
"chr1","206645140","206645434","chr1","140099529","140099815","21","66545611"
"chr1","206650350","206650665","chr1","155230532","155230840","61","51419818"
"chr1","206653501","206653626","chr1","140090943","140091056","21","66562558"
"chr1","206665525","206665808","chr1","140074688","140074997","55","66590837"
"chr1","206672486","206672652","chr1","140067726","140067892","5","66604760"
"chr1","206681831","206682107","chr11","112582920","112583198","43","94098911"
"chr1","206693789","206693948","chr1","53225263","53225421","27","153468526"
"chr1","206699433","206699578","chr1","140027585","140027742","26","66671848"
"chr1","206737024","206737169","chr8","21621594","21621739","29","185115430"
"chr1","206740155","206740346","chr1","139987659","139987858","17","66752496"
"chr1","206746522","206746770","chr1","139980715","139980969","24","66765807"
"chr1","206755821","206756116","chr1","139971389","139971689","25","66784432"
"chr1","206759231","206759540","chr1","139967979","139968290","19","66791252"
"chr1","206774336","206774576","chr1","139951382","139951630","28","66822954"
"chr1","206775131","206775177","chr1","139950771","139950815","6","66824360"
"chr1","206780778","206781095","chr1","139944087","139944417","57","66836691"
"chr1","206787153","206787429","chr1","139936001","139936243","48","66851152"
"chr1","206789560","206789831","chr14","13361263","13361536","57","193428297"
"chr1","206791978","206792221","chr1","139930623","139930867","14","66861355"
"chr1","206801696","206801846","chr1","139921291","139921439","16","66880405"
"chr1","206802141","206802287","chr1","139920836","139920996","26","66881305"
"chr1","206807423","206807714","chr1","139915589","139915878","29","66891834"
"chr1","206812501","206812581","chr1","139910836","139910913","3","66901665"
"chr1","206834680","206834967","chr1","139888444","139888739","26","66946236"
"chr1","206843159","206843376","chr7","2321119","2321341","67","204522040"
"chr1","206849162","206849456","chr1","139873982","139874247","52","66975180"
"chr1","206860588","206860868","chr1","139862618","139862900","34","66997970"
"chr1","206861266","206861384","chr1","139862049","139862167","5","66999217"
"chr1","206869461","206869752","chr1","139844018","139844303","32","67025443"
"chr1","206876127","206876253","chr1","139837492","139837620","9","67038635"
"chr1","206876557","206876740","chr11","119943327","119943515","45","86933230"
"chr1","206883593","206883899","chr1","139831152","139831452","35","67052441"
"chr1","206887361","206887646","chr1","139828330","139828575","61","67059031"
"chr1","206892946","206893238","chr1","139824064","139824369","33","67068882"
"chr1","206900515","206900785","chr1","139819859","139820112","35","67080656"
"chr1","206904522","206904825","chr1","139815783","139816085","29","67088739"
"chr1","206928360","206928666","chrX","66041823","66042135","59","140886537"
"chr1","206960835","206961119","chr1","139756493","139756771","23","67204342"
"chr1","206962921","206963216","chr1","139754647","139754941","30","67208274"
"chr1","206970616","206970902","chr1","139747140","139747427","29","67223476"
"chr1","207031998","207032291","chr1","139684939","139685226","24","67347059"
"chr1","207070282","207070576","chr1","139644882","139645198","44","67425400"
"chr1","207082730","207083022","chr12","2320024","2320318","52","204762706"
"chr1","207125571","207125869","chr1","139587672","139587961","23","67537899"
"chr1","207170727","207171008","chr1","137694607","137694891","34","69476120"
"chr1","207178751","207179052","chr2","97391256","97391543","67","109787495"
"chr1","207199607","207199868","chr1","137723875","137724141","24","69475732"
"chr1","207203582","207203879","chr1","137728351","137728628","34","69475231"
"chr1","207223308","207223598","chr1","137742479","137742746","34","69480829"
"chr1","207228419","207228725","chr1","137758754","137759070","39","69469665"
"chr1","207235453","207235763","chr1","137765707","137766001","48","69469746"
"chr1","207254475","207254758","chr1","191690399","191690678","49","15564076"
"chr1","207265798","207265962","chr1","137794917","137795082","13","69470881"
"chr1","207277629","207277919","chr1","137806976","137807269","28","69470653"
"chr1","207291308","207291596","chr1","137821604","137821888","23","69469704"
"chr1","207330431","207330734","chr1","137863629","137863934","24","69466802"
"chr1","207346779","207347010","chr1","137880879","137881112","18","69465900"
"chr1","207354017","207354293","chr1","137888144","137888427","22","69465873"
"chr1","207359710","207360009","chr15","17816055","17816351","56","189543655"
"chr1","207365641","207365909","chr1","137895644","137895908","17","69469997"
"chr1","207383548","207383845","chr7","36331166","36331462","65","171052382"
"chr1","207403009","207403317","chr1","137928539","137928846","14","69474470"
"chr1","207463357","207463533","chr1","137989011","137989192","19","69474346"
"chr1","207463832","207463943","chr1","137989497","137989609","8","69474335"
"chr1","207475216","207475477","chr1","138000860","138001121","19","69474356"
"chr1","207476226","207476521","chr1","138001861","138002167","42","69474365"
"chr1","207505697","207506011","chr1","138036760","138037076","33","69468937"
"chr1","207554623","207554919","chr3","5453846","5454145","53","202100777"
"chr1","207578598","207578870","chr6","139168605","139168879","57","68409993"
"chr1","207590317","207590649","chr8","10013431","10013758","93","197576886"
"chr1","207604770","207605048","chrX","103046997","103047266","61","104557773"
"chr1","207613072","207613274","chr1","138163645","138163848","27","69449427"
"chr1","207615029","207615230","chr1","138163645","138163848","28","69451384"
"chr1","207647792","207648077","chr1","138192195","138192524","56","69455597"
"chr1","207650768","207651054","chr1","138195489","138195780","17","69455279"
"chr1","207652245","207652565","chr1","138197284","138197604","24","69454961"
"chr1","207671197","207671478","chr1","138214061","138214352","28","69457136"
"chr1","207687345","207687604","chr1","138233515","138233801","43","69453830"
"chr1","207704625","207704779","chr1","138257269","138257422","12","69447356"
"chr1","207706750","207707019","chr7","54672653","54672917","65","153034097"
"chr1","207738784","207739032","chr1","138290021","138290269","21","69448763"
"chr1","207759848","207760074","chr1","138315366","138315605","34","69444482"
"chr1","207780673","207780827","chr1","138336891","138337036","15","69443782"
"chr1","207789412","207789571","chr1","138345950","138346105","11","69443462"
"chr1","207792954","207793232","chr1","138349507","138349786","28","69443447"
"chr1","207821609","207821901","chr1","138377730","138378019","23","69443879"
"chr1","207837729","207838013","chr1","138393951","138394243","26","69443778"
"chr1","207870838","207871141","chr15","43687639","43687935","50","164183199"
"chr1","207880971","207881226","chr1","138439317","138439573","19","69441654"
"chr1","207884614","207884763","chr3","47558463","47558615","31","160326151"
"chr1","207900222","207900507","chr1","94126485","94126774","66","113773737"
"chr1","207903312","207903474","chr1","138465942","138466126","33","69437370"
"chr1","207906631","207906943","chr1","138471686","138472005","33","69434945"
"chr1","207908096","207908382","chr1","138473164","138473452","23","69434932"
"chr1","207966502","207966738","chr1","224135881","224136124","27","16169379"
"chr1","208007989","208008188","chr1","138532717","138532927","20","69475272"
"chr1","208013147","208013251","chr3","33528457","33528560","8","174484690"
"chr1","208024969","208025212","chr4","151523012","151523272","77","56501957"
"chr1","208028568","208028765","chr1","138565379","138565573","8","69463189"
"chr1","208061251","208061375","chr1","138625598","138625722","5","69435653"
"chr1","208080289","208080504","chr1","138646876","138647082","22","69433413"
"chr1","208107465","208107634","chr3","37304497","37304679","54","170802968"
"chr1","208180631","208180749","chr20","5126828","5126940","28","203053803"
"chr1","208218972","208219271","chr1","138858768","138859074","18","69360204"
"chr1","208227019","208227302","chr15","8920430","8920718","53","199306589"
"chr1","208232926","208233212","chr1","138872834","138873119","14","69360092"
"chr1","208236021","208236277","chr8","45549754","45550002","54","162686267"
"chr1","208243391","208243700","chr1","138883544","138883854","12","69359847"
"chr1","208258323","208258579","chr1","138895759","138896020","24","69362564"
"chr1","208274877","208274999","chr2","165531071","165531193","15","42743806"
"chr1","208291433","208291671","chr1","138935840","138936078","19","69355593"
"chr1","208308650","208308885","chr1","138953263","138953498","20","69355387"
"chr1","208331727","208331994","chr1","166591363","166591614","63","41740364"
"chr1","208600320","208600622","chr1","138989980","138990279","16","69610340"
"chr1","208613740","208614029","chr1","139003951","139004209","43","69609789"
"chr1","208632439","208632720","chr1","139022340","139022607","36","69610099"
"chr1","208636211","208636469","chr1","139026058","139026333","28","69610153"
"chr1","208663409","208663683","chr1","139053954","139054229","31","69609455"
"chr1","208663706","208663935","chr1","139054232","139054479","30","69609474"
"chr1","208687642","208687931","chr1","139075768","139076055","20","69611874"
"chr1","208693574","208693784","chr1","139081637","139081848","26","69611937"
"chr1","208705071","208705357","chr1","139092926","139093170","55","69612145"
"chr1","208720484","208720800","chr3","40497938","40498240","60","168222546"
"chr1","208743670","208743916","chr1","139131070","139131322","23","69612600"
"chr1","208752968","208753231","chr1","139141357","139141618","22","69611611"
"chr1","208767069","208767173","chr1","139154686","139154785","11","69612383"
"chr1","208783319","208783581","chr1","139171311","139171559","35","69612008"
"chr1","208790911","208791220","chr1","8981776","8982081","53","199809135"
"chr1","208803420","208803734","chr1","139189539","139189849","22","69613881"
"chr1","208805320","208805448","chr1","139191405","139191533","10","69613915"
"chr1","208809856","208809978","chr1","139196083","139196205","6","69613773"
"chr1","208831909","208832168","chr1","139219023","139219279","17","69612886"
"chr1","208834733","208835039","chr1","139221820","139222119","15","69612913"
"chr1","208843410","208843712","chr1","139230351","139230663","26","69613059"
"chr1","208862633","208862973","chr1","139248813","139249155","25","69613820"
"chr1","208877172","208877480","chr1","139263639","139263950","24","69613533"
"chr1","208880801","208881099","chr1","139267270","139267565","31","69613531"
"chr1","208904309","208904597","chr1","139290473","139290768","27","69613836"
"chr1","208909531","208909799","chr1","139295726","139295994","20","69613805"
"chr1","208925889","208926135","chr1","139312167","139312414","16","69613722"
"chr1","208941707","208941982","chr17","20096857","20097146","76","188844850"
"chr1","208976757","208977045","chr1","139359136","139359417","37","69617621"
"chr1","208995161","208995325","chr9","26520390","26520553","34","182474771"
"chr1","209003077","209003404","chr1","139391453","139391749","47","69611624"
"chr1","209008817","209009128","chr1","139398129","139398426","32","69610688"
"chr1","209011544","209011780","chr15","6993920","6994157","58","202017624"
"chr1","209023177","209023380","chr1","139412676","139412879","15","69610501"
"chr1","209024716","209024935","chr1","139414207","139414427","12","69610509"
"chr1","209034893","209035176","chr1","139424687","139424970","13","69610206"
"chr1","209040442","209040604","chr1","139430369","139430546","34","69610073"
"chr1","209045456","209045762","chr20","28618222","28618522","61","180427234"
"chr1","209060094","209060400","chr1","139445354","139445647","43","69614740"
"chr1","209081111","209081327","chr1","139466352","139466581","23","69614759"
"chr1","209084407","209084669","chr1","139469694","139469965","23","69614713"
"chr1","209085891","209086179","chr1","139470914","139471204","24","69614977"
"chr1","209086458","209086547","chr5","109387299","109387388","13","99699159"
"chr1","209096226","209096529","chr8","45074900","45075192","64","164021326"
"chr1","209101089","209101354","chr1","139506121","139506370","30","69594968"
"chr1","209102895","209103204","chr7","150795674","150795979","53","58307221"
"chr1","209119382","209119659","chr1","79186235","79186508","55","129933147"
"chr1","209229348","209229629","chr7","165685923","165686204","67","43543425"
"chr1","209251476","209251604","chr15","28507662","28507784","24","180743814"
"chr1","209277445","209277761","chr1","204889214","204889538","40","4388231"
"chr1","209291568","209291734","chr1","204897582","204897748","7","4393986"
"chr1","209294018","209294312","chr1","204899975","204900270","21","4394043"
"chr1","209298155","209298284","chr1","109570884","109571013","21","99727271"
"chr1","209316734","209317032","chr1","204922932","204923244","29","4393802"
"chr1","209331245","209331431","chr1","204937456","204937646","17","4393789"
"chr1","209343060","209343343","chr7","137856198","137856481","55","71486862"
"chr1","209358453","209358711","chr19","33660165","33660430","70","175698288"
"chr1","209377224","209377411","chr1","204982549","204982736","9","4394675"
"chr1","209394818","209394934","chr1","205001696","205001812","10","4393122"
"chr1","209413672","209413862","chr1","205020519","205020709","14","4393153"
"chr1","209425947","209426210","chr5","9176993","9177243","58","200248954"
"chr1","209442152","209442403","chr1","205044189","205044442","29","4397963"
"chr1","209448821","209449116","chr1","60679452","60679746","62","148769369"
"chr1","209463333","209463394","chr1","205060931","205060992","1","4402402"
"chr1","209467193","209467512","chr3","38481751","38482054","78","170985442"
"chr1","209501745","209502060","chr1","205097692","205097986","56","4404053"
"chr1","209547313","209547615","chr1","205137672","205137977","22","4409641"
"chr1","209559377","209559682","chr1","205149606","205149916","25","4409771"
"chr1","209595409","209595687","chr1","205190033","205190310","17","4405376"
"chr1","209599224","209599494","chr6","113621718","113621998","60","95977506"
"chr1","209609061","209609353","chr1","205204096","205204382","36","4404965"
"chr1","209647909","209648181","chr1","205240196","205240449","40","4407713"
"chr1","209655341","209655470","chr12","109753740","109753868","17","99901601"
"chr1","209659308","209659597","chr4","128415397","128415686","59","81243911"
"chr1","209660911","209661226","chr1","205253347","205253655","29","4407564"
"chr1","209676555","209676855","chr1","205268914","205269207","37","4407641"
"chr1","209685299","209685590","chr1","205277659","205277962","33","4407640"
"chr1","209688263","209688526","chr1","205280884","205281147","9","4407379"
"chr1","209728503","209728793","chr1","205322314","205322628","43","4406189"
"chr1","209733196","209733323","chr1","205327020","205327148","8","4406176"
"chr1","209736405","209736631","chr18","47295999","47296229","52","162440406"
"chr1","209750087","209750369","chr6","105487924","105488201","60","104262163"
"chr1","209759984","209760107","chr1","205347334","205347458","7","4412650"
"chr1","209769844","209770141","chr1","205357191","205357476","23","4412653"
"chr1","209779600","209779673","chr8","38780103","38780168","16","170999497"
"chr1","209800494","209800824","chr1","205383309","205383634","28","4417185"
"chr1","209827877","209828031","chr3","104971579","104971733","32","104856298"
"chr1","209828069","209828185","chr3","64873136","64873250","13","144954933"
"chr1","209835418","209835724","chr1","205416149","205416448","46","4419269"
"chr1","209847699","209847902","chr1","205428156","205428352","18","4419543"
"chr1","209862652","209862934","chr1","205443372","205443653","30","4419280"
"chr1","209884174","209884310","chr1","205464254","205464380","13","4419920"
"chr1","209885439","209885729","chr4","5221001","5221300","66","204664438"
"chr1","209906079","209906390","chr10","19530640","19530952","54","190375439"
"chr1","209926910","209927197","chr1","205513592","205513880","23","4413318"
"chr1","209943427","209943712","chr1","205531419","205531713","29","4412008"
"chr1","209964519","209964816","chr1","223575480","223575782","63","13610961"
"chr1","209969941","209970253","chr1","205556636","205556926","44","4413305"
"chr1","209977393","209977692","chr1","205564982","205565285","35","4412411"
"chr1","209979189","209979500","chr1","205566812","205567091","61","4412377"
"chr1","209981056","209981331","chr1","205568665","205568939","33","4412391"
"chr1","209982727","209982851","chr1","205570019","205570141","11","4412708"
"chr1","210000588","210000736","chr6","11605687","11605838","34","198394901"
"chr1","210006871","210007182","chr1","205588596","205588907","23","4418275"
"chr1","210019605","210019912","chr1","205601546","205601845","29","4418059"
"chr1","210021930","210022165","chr1","205604594","205604828","12","4417336"
"chr1","210033294","210033587","chr1","205616666","205616952","29","4416628"
"chr1","210039028","210039314","chr1","205623800","205624092","20","4415228"
"chr1","210039580","210039839","chr1","205624355","205624620","27","4415225"
"chr1","210042089","210042378","chr1","205627154","205627451","25","4414935"
"chr1","210048952","210049233","chr1","205634547","205634832","42","4414405"
"chr1","210050783","210051087","chr4","2738164","2738467","64","207312619"
"chr1","210064620","210064800","chr1","205650677","205650854","14","4413943"
"chr1","210069098","210069408","chr1","205655159","205655441","44","4413939"
"chr1","210074802","210075111","chr1","205660847","205661163","34","4413955"
"chr1","210086991","210087182","chr1","205672755","205672966","32","4414236"
"chr1","210087183","210087302","chr1","205672968","205673086","9","4414215"
"chr1","210098230","210098511","chr1","205684884","205685158","35","4413346"
"chr1","210117457","210117779","chr1","205705155","205705470","36","4412302"
"chr1","210122405","210122716","chr1","205710307","205710626","30","4412098"
"chr1","210123798","210124109","chr1","205711726","205712026","31","4412072"
"chr1","210137543","210137845","chr1","43902169","43902461","56","166235374"
"chr1","210150970","210151168","chr1","205736523","205736728","28","4414447"
"chr1","210151468","210151778","chr1","205736971","205737337","74","4414497"
"chr1","210155973","210156260","chr1","205741350","205741658","43","4414623"
"chr1","210184076","210184375","chr1","205769780","205770096","33","4414296"
"chr1","210202879","210203185","chr1","205789597","205789910","40","4413282"
"chr1","210216479","210216766","chr1","205804063","205804349","12","4412416"
"chr1","210229270","210229513","chr1","205817164","205817407","17","4412106"
"chr1","210237247","210237562","chr1","205825443","205825756","23","4411804"
"chr1","210238185","210238434","chr1","205826407","205826659","18","4411778"
"chr1","210245910","210246189","chr4","11454724","11454998","60","198791186"
"chr1","210293949","210294164","chr1","205875153","205875372","19","4418796"
"chr1","210302743","210303011","chr1","205884200","205884485","38","4418543"
"chr1","210313068","210313323","chr1","205893720","205893975","28","4419348"
"chr1","210335735","210336065","chr1","205916835","205917167","44","4418900"
"chr1","210357138","210357246","chr1","205938507","205938605","13","4418631"
"chr1","210357451","210357685","chr1","205938808","205939043","14","4418643"
"chr1","210386102","210386403","chr1","205968419","205968719","30","4417683"
"chr1","210386921","210386980","chr8","31558921","31558979","11","178828000"
"chr1","210423761","210424035","chr1","206002667","206002955","41","4421094"
"chr1","210432520","210432790","chr1","206011329","206011606","28","4421191"
"chr1","210440951","210441229","chr1","206018104","206018399","44","4422847"
"chr1","210472960","210473243","chr1","206052817","206053099","20","4420143"
"chr1","210509971","210510162","chr1","64648819","64648991","50","145861152"
"chr1","210512617","210512739","chr1","206092979","206093101","9","4419638"
"chr1","210524484","210524776","chr1","206105965","206106259","28","4418519"
"chr1","210546801","210546911","chr1","61385196","61385305","19","149161605"
"chr1","210562529","210562820","chr1","206146638","206146935","33","4415891"
"chr1","210562827","210563115","chr1","206146942","206147226","24","4415885"
"chr1","210572845","210573142","chr1","206156941","206157243","36","4415904"
"chr1","210581428","210581740","chr1","206165597","206165911","34","4415831"
"chr1","210616834","210617136","chr1","206196208","206196489","54","4420626"
"chr1","210671408","210671690","chr1","206251258","206251539","20","4420150"
"chr1","210706606","210706898","chr1","206287422","206287722","29","4419184"
"chr1","210712980","210713260","chr1","206293894","206294170","17","4419086"
"chr1","210719032","210719342","chr1","206300894","206301201","31","4418138"
"chr1","210781510","210781817","chr1","206363269","206363579","38","4418241"
"chr1","210785263","210785548","chr13","45053818","45054106","67","165731445"
"chr1","210789194","210789472","chr1","206371122","206371399","24","4418072"
"chr1","210812619","210812917","chr1","206396313","206396609","20","4416306"
"chr1","210824646","210824907","chr1","206408801","206409057","18","4415845"
"chr1","210847317","210847616","chr1","206431087","206431370","37","4416230"
"chr1","210850532","210850818","chr1","206434275","206434552","26","4416257"
"chr1","210855836","210856155","chr1","206439210","206439517","45","4416626"
"chr1","210865162","210865421","chr1","206448420","206448680","21","4416742"
"chr1","210867582","210867862","chr1","206451224","206451493","32","4416358"
"chr1","210869075","210869372","chr1","206452729","206453018","33","4416346"
"chr1","210871968","210872088","chr2","123407876","123407999","21","87464092"
"chr1","210889952","210890078","chr9","28925694","28925823","23","181964258"
"chr1","210890378","210890517","chr1","206474599","206474737","14","4415779"
"chr1","210891242","210891364","chr8","89265463","89265585","17","121625779"
"chr1","210896860","210897130","chr10","12192602","12192874","58","198704258"
"chr1","210901989","210902297","chr1","206486409","206486697","41","4415580"
"chr1","210906658","210906967","chr4","37761866","37762179","54","173144792"
"chr1","210949240","210949522","chr1","206570970","206571249","19","4378270"
"chr1","210961695","210961972","chr3","40783093","40783379","56","170178602"
"chr1","210985937","210986246","chr1","206606946","206607243","29","4378991"
"chr1","210989911","210990210","chr1","206610811","206611118","26","4379100"
"chr1","210993423","210993714","chr1","206614351","206614644","27","4379072"
"chr1","211027551","211027840","chr1","206649092","206649376","29","4378459"
"chr1","211057701","211058009","chr1","206678241","206678557","25","4379460"
"chr1","211080257","211080340","chr1","206701467","206701548","7","4378790"
"chr1","211081676","211081974","chr1","206702884","206703184","30","4378792"
"chr1","211112554","211112640","chr1","119288424","119288508","18","91824130"
"chr1","211115487","211115758","chr14","47823142","47823409","56","163292345"
"chr1","211119371","211119665","chr1","206740041","206740321","26","4379330"
"chr1","211128285","211128369","chr1","206748754","206748844","8","4379531"
"chr1","211173359","211173484","chr10","77419179","77419302","20","133754180"
"chr1","211205201","211205495","chr1","206833956","206834251","50","4371245"
"chr1","211252137","211252418","chr3","172796361","172796642","70","38455776"
"chr1","211294425","211294704","chr19","15106393","15106668","63","196188032"
"chr1","211309206","211309330","chr1","206952618","206952740","10","4356588"
"chr1","211316102","211316350","chr1","206959235","206959494","30","4356867"
"chr1","211318939","211319099","chr1","206962105","206962269","14","4356834"
"chr1","211331468","211331758","chr1","206973732","206974020","23","4357736"
"chr1","211364680","211364983","chr1","207006507","207006810","24","4358173"
"chr1","211406611","211406818","chr2","50930351","50930551","52","160476260"
"chr1","211450001","211450276","chr1","207091202","207091478","17","4358799"
"chr1","211466332","211466496","chr8","23470408","23470566","35","187995924"
"chr1","211471971","211472256","chr1","207114918","207115206","24","4357053"
"chr1","211473064","211473343","chr1","207115931","207116239","50","4357133"
"chr1","211483757","211484047","chr1","207126685","207126992","37","4357072"
"chr1","211488940","211489203","chr1","207131898","207132165","17","4357042"
"chr1","211524057","211524352","chr20","7590857","7591157","59","203933200"
"chr1","211606171","211606465","chr10","12521353","12521656","48","199084818"
"chr1","211658982","211659285","chr1","207297140","207297436","27","4361842"
"chr1","211663785","211664094","chr1","207301954","207302268","26","4361831"
"chr1","211667384","211667691","chr1","207305629","207305915","40","4361755"
"chr1","211687668","211687797","chr9","83876330","83876457","25","127811338"
"chr1","211692370","211692540","chr1","207330735","207330905","9","4361635"
"chr1","211706078","211706357","chr1","207345049","207345328","10","4361029"
"chr1","211712017","211712283","chr1","207347649","207347911","18","4364368"
"chr1","211730748","211731056","chr1","207375844","207376155","22","4354904"
"chr1","211734822","211734962","chr3","1883664","1883804","22","209851158"
"chr1","211741490","211741811","chr1","207386679","207387000","32","4354811"
"chr1","211745357","211745659","chr1","207392025","207392323","17","4353332"
"chr1","211746806","211746923","chr1","207393467","207393584","4","4353339"
"chr1","211747685","211748003","chr1","207394336","207394659","38","4353349"
"chr1","211756867","211757157","chr1","207403472","207403761","18","4353395"
"chr1","211769838","211770096","chr1","161102288","161102544","60","50667550"
"chr1","211796979","211797290","chr1","207445616","207445918","31","4351363"
"chr1","211813586","211813881","chr1","207461965","207462261","9","4351621"
"chr1","211828201","211828348","chr19","24837689","24837839","34","186990512"
"chr1","211828352","211828546","chr1","207477191","207477400","21","4351161"
"chr1","211860596","211860897","chr1","207510052","207510338","26","4350544"
"chr1","211886792","211886962","chr1","207532471","207532653","22","4354321"
"chr1","211887199","211887340","chr1","207532872","207533013","10","4354327"
"chr1","211922136","211922423","chr1","207570346","207570656","60","4351790"
"chr1","211925043","211925347","chr3","43652365","43652670","56","168272678"
"chr1","211950292","211950488","chr1","207599086","207599289","17","4351206"
"chr1","211956693","211956966","chr19","13276563","13276844","55","198680130"
"chr1","211961585","211961853","chr4","103721266","103721546","69","108240319"
"chr1","211990434","211990471","chrX","144545810","144545847","6","67444624"
"chr1","211990756","211991019","chr1","207638890","207639149","26","4351866"
"chr1","211994314","211994605","chr1","207642439","207642738","30","4351875"
"chr1","212015613","212015868","chr1","207662939","207663194","14","4352674"
"chr1","212042044","212042234","chr9","11445686","11445863","50","200596358"
"chr1","212071513","212071786","chr1","207722022","207722294","16","4349491"
"chr1","212089809","212089934","chr1","207740899","207741022","12","4348910"
"chr1","212108549","212108844","chr1","207761026","207761317","28","4347523"
"chr1","212127860","212128168","chr1","207781143","207781422","44","4346717"
"chr1","212154764","212155067","chr1","207809982","207810283","39","4344782"
"chr1","212162809","212163114","chr1","207818583","207818892","23","4344226"
"chr1","212182513","212182806","chr10","70271181","70271471","63","141911332"
"chr1","212186245","212186505","chr1","207841651","207841916","29","4344594"
"chr1","212204870","212205160","chr1","207861433","207861721","18","4343437"
"chr1","212216602","212216897","chr1","195801657","195801957","58","16414945"
"chr1","212273558","212273861","chr1","207930120","207930425","19","4343438"
"chr1","212295038","212295310","chr1","207955718","207955987","22","4339320"
"chr1","212296495","212296810","chr1","207957176","207957485","28","4339319"
"chr1","212335709","212335827","chr3","64873136","64873250","11","147462573"
"chr1","212335861","212336022","chr3","82067092","82067250","39","130268769"
"chr1","212338645","212338921","chr1","208000881","208001147","32","4337764"
"chr1","212343579","212343867","chr1","208005842","208006131","24","4337737"
"chr1","212353477","212353752","chr1","208013159","208013437","19","4340318"
"chr1","212388186","212388475","chr1","208047089","208047377","21","4341097"
"chr1","212418041","212418363","chr1","208072294","208072618","19","4345747"
"chr1","212437352","212437477","chr1","208091437","208091552","17","4345915"
"chr1","212444618","212444996","chr1","208098682","208098981","104","4345936"
"chr1","212507222","212507519","chr8","33501347","33501642","65","179005875"
"chr1","212527318","212527655","chr14","70948092","70948414","77","141579226"
"chr1","212625180","212625503","chr1","208271064","208271371","33","4354116"
"chr1","212637774","212638112","chr1","208283656","208283940","71","4354118"
"chr1","212664217","212664503","chr1","208310438","208310732","21","4353779"
"chr1","212664513","212664838","chr13","9406810","9407104","99","203257703"
"chr1","212750078","212750395","chr1","208390732","208391033","34","4359346"
"chr1","212916328","212916454","chr1","208555299","208555426","7","4361029"
"chr1","212932210","212932513","chr1","208571713","208572017","36","4360497"
"chr1","213085595","213085924","chr10","30337711","30338027","79","182747884"
"chr1","213095547","213095731","chr1","208732213","208732395","17","4363334"
"chr1","213111362","213111653","chr1","208747415","208747696","33","4363947"
"chr1","213166708","213167016","chr1","122104598","122104888","71","91062110"
"chr1","213255159","213255290","chr1","208890818","208890948","8","4364341"
"chr1","213258489","213258514","chr6","147651027","147651052","4","65607462"
"chr1","213258579","213258860","chr1","208894190","208894501","48","4364389"
"chr1","213288395","213288704","chr1","208925903","208926211","23","4362492"
"chr1","213305748","213306044","chr1","208943526","208943847","42","4362222"
"chr1","213332608","213332732","chr9","125654601","125654725","15","87678007"
"chr1","213344795","213344917","chr1","219404678","219404802","18","6059883"
"chr1","213406956","213407263","chr1","209101113","209101412","32","4305843"
"chr1","213408645","213408929","chr1","209102794","209103066","42","4305851"
"chr1","213450083","213450381","chr1","209141805","209142107","17","4308278"
"chr1","213516670","213516969","chr1","209208235","209208524","29","4308435"
"chr1","213602054","213602344","chr1","209297130","209297439","42","4304924"
"chr1","213637616","213637935","chr1","209331571","209331884","32","4306045"
"chr1","213696834","213697155","chr1","209389713","209390034","9","4307121"
"chr1","213816042","213816359","chr1","209507093","209507408","28","4308949"
"chr1","213825015","213825171","chr3","13044305","13044455","37","200780710"
"chr1","213848016","213848321","chr1","209540552","209540871","37","4307464"
"chr1","213998781","213999085","chr1","209720463","209720798","48","4278318"
"chr1","214003432","214003718","chr9","63095691","63095976","48","150907741"
"chr1","214008166","214008479","chr1","209729994","209730278","59","4278172"
"chr1","214045147","214045431","chr1","209774879","209775170","35","4270268"
"chr1","214055068","214055305","chr1","209784646","209784884","10","4270422"
"chr1","214059174","214059468","chr7","137856198","137856481","64","76202976"
"chr1","214090416","214090720","chr19","11528525","11528831","58","202561891"
"chr1","214117158","214117437","chr1","209870524","209870807","17","4246634"
"chr1","214141988","214142285","chr1","26812837","26813139","74","187329151"
"chr1","214160755","214160879","chr1","209901593","209901718","7","4259162"
"chr1","214183558","214183862","chr1","209927669","209927962","32","4255889"
"chr1","214221154","214221465","chr1","209959919","209960243","36","4261235"
"chr1","214243181","214243362","chr16","38738002","38738175","53","175505179"
"chr1","214281161","214281344","chr1","210014480","210014666","21","4266681"
"chr1","214307200","214307495","chr13","62483292","62483589","66","151823908"
"chr1","214318843","214319022","chr1","138345950","138346105","47","75972893"
"chr1","214344037","214344324","chr9","28116760","28117047","48","186227277"
"chr1","214385984","214386114","chr1","210107463","210107593","8","4278521"
"chr1","214411295","214411584","chr1","210131170","210131452","25","4280125"
"chr1","214421748","214422041","chr5","51322379","51322663","59","163099369"
"chr1","214482754","214483024","chr1","210205198","210205466","22","4277556"
"chr1","214499810","214499976","chr6","59171972","59172142","42","155327838"
"chr1","214505626","214505924","chr1","210229153","210229456","27","4276473"
"chr1","214623532","214623841","chr1","210339255","210339566","27","4284277"
"chr1","214638390","214638694","chr1","210353596","210353899","19","4284794"
"chr1","214688274","214688508","chr20","33668679","33668914","40","181019595"
"chr1","214690378","214690688","chr10","52020965","52021268","56","162669413"
"chr1","214702265","214702554","chr1","210416272","210416573","28","4285993"
"chr1","214716986","214717109","chr1","210431149","210431272","6","4285837"
"chr1","214762596","214762916","chr1","210476964","210477275","36","4285632"
"chr1","214773230","214773546","chr1","210487756","210488062","33","4285474"
"chr1","214803398","214803521","chr1","210517235","210517361","16","4286163"
"chr1","214828644","214828960","chr1","210541533","210541841","39","4287111"
"chr1","214849372","214849699","chr1","136053595","136053894","78","78795777"
"chr1","214882079","214882392","chr6","35189860","35190164","58","179692219"
"chr1","214888321","214888628","chr1","210603148","210603440","48","4285173"
"chr1","214907393","214907685","chr1","210614117","210614412","25","4293276"
"chr1","214908132","214908213","chr20","67038038","67038119","13","147870094"
"chr1","214935258","214935414","chr1","210644849","210645005","6","4290409"
"chr1","214937803","214938112","chr2","107411533","107411833","57","107526270"
"chr1","214963851","214964173","chr9","114784219","114784526","61","100179632"
"chr1","214973714","214973915","chr1","210683071","210683279","28","4290643"
"chr1","214985032","214985152","chr1","170790745","170790861","18","44194287"
"chr1","215008618","215008828","chr16","31100169","31100379","38","183908449"
"chr1","215034751","215035038","chr1","210742092","210742394","31","4292659"
"chr1","215035082","215035105","chr2","142079372","142079390","6","72955710"
"chr1","215047098","215047389","chr15","14032398","14032694","55","201014700"
"chr1","215090337","215090630","chr3","81122007","81122304","63","133968330"
"chr1","215106541","215106827","chr1","210815178","210815463","19","4291363"
"chr1","215111897","215112177","chr1","210820717","210821008","32","4291180"
"chr1","215179982","215180373","chr7","68230244","68230618","114","146949738"
"chr1","215191616","215191919","chr1","210902094","210902394","46","4289522"
"chr1","215261895","215262200","chr1","210981685","210981970","41","4280210"
"chr1","215270644","215270944","chr1","210990255","210990553","14","4280389"
"chr1","215291202","215291494","chr1","211011563","211011848","36","4279639"
"chr1","215298107","215298388","chr1","211018499","211018790","23","4279608"
"chr1","215309446","215309763","chr1","211030032","211030336","35","4279414"
"chr1","215337176","215337480","chr1","211057066","211057369","20","4280110"
"chr1","215390847","215391107","chr1","211110808","211111095","43","4280039"
"chr1","215410011","215410177","chr1","211130462","211130633","21","4279549"
"chr1","215410463","215410662","chr1","211130920","211131114","26","4279543"
"chr1","215416490","215416778","chr1","211136968","211137248","31","4279522"
"chr1","215423609","215423893","chr1","211144006","211144281","25","4279603"
"chr1","215440216","215440508","chr1","211160839","211161138","27","4279377"
"chr1","215447137","215447420","chr1","211167603","211167892","27","4279534"
"chr1","215469258","215469561","chr1","211189860","211190141","46","4279398"
"chr1","215494087","215494217","chr20","5026807","5026940","21","210467280"
"chr1","215495150","215495440","chr1","211215809","211216098","14","4279341"
"chr1","215496586","215496902","chr1","211217242","211217582","61","4279344"
"chr1","215562315","215562625","chr1","211283285","211283592","33","4279030"
"chr1","215606039","215606158","chr1","211325936","211326055","4","4280103"
"chr1","215610270","215610522","chr1","211330158","211330388","38","4280112"
"chr1","215612405","215612694","chr1","211332302","211332601","36","4280103"
"chr1","215614915","215614999","chr14","97824441","97824527","16","117790474"
"chr1","215615087","215615325","chr1","211335305","211335542","14","4279782"
"chr1","215624050","215624211","chr1","211345682","211345845","11","4278368"
"chr1","215625260","215625389","chr1","211346570","211346699","6","4278690"
"chr1","215627417","215627598","chr7","159041780","159041958","32","56585637"
"chr1","215628992","215629337","chr3","34684963","34685313","80","180944029"
"chr1","215648106","215648399","chrX","24534965","24535255","53","191113141"
"chr1","215649458","215649753","chr1","211370869","211371167","25","4278589"
"chr1","215652340","215652636","chr1","211373887","211374185","20","4278453"
"chr1","215659143","215659431","chr1","211381031","211381311","22","4278112"
"chr1","215666377","215666682","chr1","211389616","211389930","31","4276761"
"chr1","215671043","215671233","chr1","211394435","211394606","41","4276608"
"chr1","215671447","215671569","chr1","211394811","211394955","27","4276636"
"chr1","215678064","215678365","chr9","93979962","93980254","53","121698102"
"chr1","215681786","215682072","chr1","211404675","211404961","24","4277111"
"chr1","215697324","215697478","chr10","27406902","27407056","30","188290422"
"chr1","215697777","215697913","chr1","109888864","109888999","29","105808913"
"chr1","215700543","215700834","chr1","211421669","211421961","18","4278874"
"chr1","215709118","215709280","chr1","211428086","211428244","10","4281032"
"chr1","215710272","215710580","chr19","7399265","7399565","70","208311007"
"chr1","215718981","215719198","chr5","56540327","56540546","43","159178654"
"chr1","215724168","215724463","chr16","29486820","29487118","74","186237348"
"chr1","215772271","215772555","chr1","211492572","211492848","24","4279699"
"chr1","215801164","215801460","chr1","211522430","211522727","23","4278734"
"chr1","215833357","215833599","chr1","211556573","211556819","29","4276784"
"chr1","215847396","215847513","chr1","211570558","211570675","7","4276838"
"chr1","215847553","215847854","chr1","211570737","211571046","22","4276816"
"chr1","215852085","215852371","chr1","211215809","211216098","56","4636276"
"chr1","215865554","215865867","chr1","211589799","211590114","14","4275755"
"chr1","215867788","215868086","chr10","72047518","72047811","59","143820270"
"chr1","215869276","215869588","chr1","211593390","211593706","35","4275886"
"chr1","215871466","215871675","chr1","211596067","211596291","30","4275399"
"chr1","215896686","215896799","chr1","211622701","211622814","6","4273985"
"chr1","215909635","215909779","chr1","211637888","211638032","14","4271747"
"chr1","215914345","215914640","chr7","138266796","138267091","60","77647549"
"chr1","215921578","215921796","chr20","28451788","28451985","57","187469790"
"chr1","215934775","215934958","chr1","25431197","25431377","35","190503578"
"chr1","215938573","215938690","chr16","38853946","38854064","17","177084627"
"chr1","215944041","215944354","chr1","211664181","211664480","28","4279860"
"chr1","215958194","215958316","chr6","305258","305375","20","215652936"
"chr1","215958356","215958526","chr3","20603210","20603376","29","195355146"
"chr1","215961317","215961596","chr2","68173712","68173989","56","147787605"
"chr1","215980736","215981012","chr1","9725418","9725680","59","206255318"
"chr1","215992761","215993026","chr1","211707792","211708067","57","4284969"
"chr1","216004343","216004459","chr1","211717768","211717884","7","4286575"
"chr1","216026744","216027016","chr1","211740173","211740448","13","4286571"
"chr1","216028637","216028708","chr1","211742067","211742138","3","4286570"
"chr1","216037875","216038144","chr1","211751780","211752052","26","4286095"
"chr1","216047880","216048008","chr1","128086244","128086378","26","87961636"
"chr1","216048317","216048488","chr1","211765737","211765916","19","4282580"
"chr1","216052791","216053084","chr1","211771475","211771768","20","4281316"
"chr1","216054141","216054429","chr1","211772824","211773102","43","4281317"
"chr1","216059374","216059637","chr1","211778044","211778331","47","4281330"
"chr1","216082092","216082214","chr4","114923254","114923379","16","101158838"
"chr1","216091117","216091400","chr1","211810006","211810291","30","4281111"
"chr1","216100154","216100325","chr1","211822118","211822288","16","4278036"
"chr1","216100625","216100769","chr1","211822580","211822725","10","4278045"
"chr1","216107461","216107765","chr6","77260247","77260553","53","138847214"
"chr1","216137880","216138180","chr1","211857533","211857808","40","4280347"
"chr1","216140166","216140411","chr1","124676766","124677019","63","91463400"
"chr1","216156056","216156273","chr11","112699213","112699425","45","103456843"
"chr1","216167123","216167436","chr3","43652365","43652670","61","172514758"
"chr1","216168730","216169039","chr1","10811316","10811617","64","205357414"
"chr1","216171021","216171284","chr1","211888133","211888396","10","4282888"
"chr1","216179369","216179487","chr1","211896980","211897098","7","4282389"
"chr1","216181543","216181852","chr1","211899159","211899479","33","4282384"
"chr1","216199640","216199944","chr1","211913759","211914080","44","4285881"
"chr1","216204271","216204564","chr1","211918851","211919138","29","4285420"
"chr1","216212515","216212815","chr1","211926573","211926879","30","4285942"
"chr1","216250972","216251285","chr1","211970106","211970412","37","4280866"
"chr1","216255025","216255311","chr1","211974534","211974814","23","4280491"
"chr1","216275723","216276005","chr6","17609699","17609979","50","198666024"
"chr1","216347894","216348216","chr17","12716359","12716683","73","203631535"
"chr1","216350086","216350392","chr1","212063336","212063645","28","4286750"
"chr1","216369821","216370117","chr9","140065","140369","53","216229756"
"chr1","216445029","216445242","chr1","212159882","212160095","13","4285147"
"chr1","216453381","216453643","chr1","212168453","212168717","14","4284928"
"chr1","216457068","216457197","chr1","212172535","212172666","9","4284533"
"chr1","216466453","216466811","chr12","96791588","96791876","121","119674865"
"chr1","216503712","216504017","chr1","212218811","212219104","35","4284901"
"chr1","216507315","216507607","chr1","212222094","212222397","24","4285221"
"chr1","216508955","216509245","chr1","212223727","212224017","23","4285228"
"chr1","216516976","216517270","chr1","212231998","212232288","33","4284978"
"chr1","216523508","216523716","chr1","212238203","212238410","18","4285305"
"chr1","216544322","216544631","chr1","188627840","188628135","59","27916482"
"chr1","216554737","216555016","chr1","212262984","212263263","17","4291753"
"chr1","216575903","216576153","chr10","38870500","38870737","66","177705403"
"chr1","216579187","216579479","chr1","212289886","212290179","20","4289301"
"chr1","216607374","216607444","chr6","56473083","56473150","18","160134291"
"chr1","216641515","216641802","chr1","212356244","212356523","29","4285271"
"chr1","216647464","216647593","chr1","212362460","212362589","6","4285004"
"chr1","216649345","216649458","chr1","212364638","212364753","9","4284707"
"chr1","216653288","216653594","chr1","212368956","212369241","44","4284332"
"chr1","216664323","216664647","chr1","212379901","212380231","28","4284422"
"chr1","216664853","216665142","chr7","113150637","113150924","54","103514216"
"chr1","216676382","216676653","chr1","212391931","212392216","27","4284451"
"chr1","216683738","216683860","chr1","212399294","212399404","17","4284444"
"chr1","216693156","216693421","chr1","212406855","212407120","17","4286301"
"chr1","216741148","216741446","chr1","212494641","212494938","41","4246507"
"chr1","216750588","216750862","chr1","212504655","212504904","42","4245933"
"chr1","216787828","216788130","chr1","212543010","212543313","25","4244818"
"chr1","216814282","216814582","chr1","212569416","212569722","27","4244866"
"chr1","216848691","216848802","chr20","20666911","20667028","21","196181780"
"chr1","216865426","216865722","chr1","212622569","212622854","36","4242857"
"chr1","216872088","216872210","chr16","66009606","66009730","17","150862482"
"chr1","216875998","216876131","chr1","212633475","212633610","14","4242523"
"chr1","216881013","216881302","chr1","195814241","195814525","54","21066772"
"chr1","216885614","216885738","chr12","19203606","19203730","19","197682008"
"chr1","216891603","216891900","chrX","46453645","46453933","53","170437958"
"chr1","216900760","216900879","chr1","212647851","212647973","10","4252909"
"chr1","216907114","216907422","chr1","212650124","212650441","32","4256990"
"chr1","216914643","216914959","chr1","212657312","212657635","31","4257331"
"chr1","216921083","216921225","chr16","1119774","1119913","26","215801309"
"chr1","216921521","216921692","chr20","55352670","55352845","35","161568851"
"chr1","216928683","216928992","chr3","127296612","127296915","66","89632071"
"chr1","216931674","216931798","chr12","110254109","110254230","21","106677565"
"chr1","216932066","216932177","chr1","212741019","212741130","3","4191047"
"chr1","216934078","216934209","chr1","212743079","212743214","11","4190999"
"chr1","216942813","216943006","chr15","14075802","14076002","60","202867011"
"chr1","216952227","216952529","chr11","109624796","109625101","61","107327431"
"chr1","216952911","216953191","chr1","94545357","94545647","67","122407554"
"chr1","216953208","216953304","chr1","212759707","212759801","7","4193501"
"chr1","216958311","216958453","chr1","212765172","212765330","26","4193139"
"chr1","216963064","216963362","chr1","212769952","212770261","24","4193112"
"chr1","216968211","216968482","chr1","212777073","212777337","22","4191138"
"chr1","216983973","216984264","chr1","212794353","212794646","22","4189620"
"chr1","216988983","216989250","chr1","212799696","212800005","63","4189287"
"chr1","216990751","216991061","chr1","212801492","212801783","38","4189259"
"chr1","216991410","216991666","chr1","212802132","212802390","20","4189278"
"chr1","217019918","217020230","chr14","6219237","6219551","61","210800681"
"chr1","217033193","217033493","chr1","212846655","212846936","52","4186538"
"chr1","217048638","217048948","chr1","212862514","212862846","51","4186124"
"chr1","217054251","217054447","chr1","212868228","212868432","20","4186023"
"chr1","217056902","217057211","chr15","108938913","108939226","55","108117989"
"chr1","217057271","217057571","chr1","212871257","212871546","32","4186014"
"chr1","217058779","217059047","chr1","212871996","212872271","28","4186783"
"chr1","217060658","217060929","chr1","212874202","212874465","22","4186456"
"chr1","217062460","217062760","chr10","71641362","71641658","57","145421098"
"chr1","217074383","217074661","chr1","212885245","212885522","18","4189138"
"chr1","217079522","217079817","chr1","212890378","212890672","17","4189144"
"chr1","217082721","217082926","chr1","212893574","212893779","12","4189147"
"chr1","217098188","217098482","chr1","212905550","212905851","35","4192638"
"chr1","217124173","217124472","chr1","212931733","212932033","28","4192440"
"chr1","217127334","217127623","chr1","212934860","212935149","21","4192474"
"chr1","217129530","217129790","chr1","212936990","212937240","32","4192540"
"chr1","217155004","217155252","chr1","212965431","212965678","13","4189573"
"chr1","217161779","217162093","chr1","212971774","212972082","38","4190005"
"chr1","217177004","217177290","chr5","139756441","139756723","52","77420563"
"chr1","217185894","217186180","chr1","212995852","212996123","37","4190042"
"chr1","217190488","217190710","chr3","38924006","38924243","60","178266482"
"chr1","217197785","217198071","chr1","213011475","213011766","23","4186310"
"chr1","217205489","217205794","chr1","213019449","213019754","22","4186040"
"chr1","217214948","217215177","chr1","213028777","213028999","22","4186171"
"chr1","217215902","217216031","chr1","213029733","213029854","11","4186169"
"chr1","217224843","217225137","chr1","213038713","213039017","40","4186130"
"chr1","217232112","217232422","chr19","49277356","49277667","60","167954756"
"chr1","217236467","217236760","chr17","21640813","21641108","76","195595654"
"chr1","217249208","217249475","chr1","213063516","213063783","18","4185692"
"chr1","217255279","217255553","chr1","213069276","213069546","29","4186003"
"chr1","217300044","217300340","chr1","213113015","213113323","34","4187029"
"chr1","217305407","217305701","chr1","213119415","213119724","54","4185992"
"chr1","217309779","217310073","chr1","213123771","213124075","22","4186008"
"chr1","217339266","217339378","chr8","139890471","139890585","25","77448795"
"chr1","217345614","217345907","chr1","213161543","213161848","33","4184071"
"chr1","217362902","217363226","chr1","213181033","213181330","43","4181869"
"chr1","217383685","217383989","chr1","213203647","213203944","21","4180038"
"chr1","217393654","217393923","chr1","213213665","213213940","30","4179989"
"chr1","217432682","217432807","chr1","213247129","213247254","5","4185553"
"chr1","217484017","217484301","chr1","213298661","213298945","22","4185356"
"chr1","217485249","217485548","chr15","43687639","43687935","57","173797610"
"chr1","217505516","217505755","chr1","213316318","213316528","47","4189198"
"chr1","217512034","217512343","chr1","213322803","213323115","28","4189231"
"chr1","217521580","217521712","chr16","43383689","43383808","44","174137891"
"chr1","217521905","217522049","chr1","213331063","213331207","22","4190842"
"chr1","217533380","217533457","chr1","213344017","213344094","6","4189363"
"chr1","217540025","217540300","chr1","213352191","213352466","25","4187834"
"chr1","217545674","217545947","chr1","213357052","213357328","30","4188622"
"chr1","217557465","217557769","chr1","213367502","213367809","13","4189963"
"chr1","217559118","217559323","chr1","213369189","213369393","12","4189929"
"chr1","217562325","217562440","chr1","213372359","213372483","15","4189966"
"chr1","217562477","217562590","chr1","213372541","213372655","15","4189936"
"chr1","217575868","217576160","chr10","13786018","13786298","63","203789850"
"chr1","217595097","217595388","chr1","213405855","213406149","41","4189242"
"chr1","217617989","217618250","chr1","213427974","213428227","26","4190015"
"chr1","217627049","217627104","chr1","213435364","213435419","3","4191685"
"chr1","217628885","217628918","chr14","109545748","109545781","7","108083137"
"chr1","217650127","217650411","chr1","213458830","213459114","15","4191297"
"chr1","217674084","217674390","chr1","213484029","213484339","19","4190055"
"chr1","217680559","217680854","chr1","213490464","213490762","29","4190095"
"chr1","217714573","217714850","chr1","213524059","213524364","40","4190514"
"chr1","217726968","217727243","chr1","213536962","213537252","46","4190006"
"chr1","217735996","217736191","chr3","126944977","126945174","40","90791019"
"chr1","217757882","217758179","chr1","213568260","213568558","24","4189622"
"chr1","217772761","217773056","chr1","213583637","213583930","20","4189124"
"chr1","217793286","217793524","chr1","213604738","213604969","42","4188548"
"chr1","217842996","217843315","chr1","213660603","213660915","27","4182393"
"chr1","217846797","217847083","chr1","213664371","213664651","27","4182426"
"chr1","217889958","217890242","chr1","182642228","182642528","64","35247730"
"chr1","217894829","217895122","chr13","43162958","43163252","64","174731871"
"chr1","217908581","217908828","chr1","213725125","213725374","13","4183456"
"chr1","217951022","217951303","chr19","7519215","7519493","67","210431807"
"chr1","218006996","218007122","chr1","213816989","213817113","10","4190007"
"chr1","218009454","218009598","chr4","44439345","44439491","40","173570109"
"chr1","218013750","218013880","chr1","109570884","109571013","23","108442866"
"chr1","218042858","218043115","chr1","213853414","213853669","19","4189444"
"chr1","218046419","218046710","chr2","202831860","202832153","61","15214559"
"chr1","218052151","218052456","chr1","213862644","213862958","33","4189507"
"chr1","218063020","218063303","chr1","213873875","213874159","23","4189145"
"chr1","218099460","218099687","chr1","213911110","213911337","14","4188350"
"chr1","218117463","218117747","chr1","213928525","213928829","57","4188938"
"chr1","218120979","218121262","chr1","213931154","213931436","25","4189825"
"chr1","218134714","218134900","chr9","59337601","59337779","38","158797113"
"chr1","218164965","218165265","chr1","213979559","213979832","53","4185406"
"chr1","218208098","218208403","chr1","214022006","214022296","28","4186092"
"chr1","218238488","218238795","chr1","214055210","214055519","33","4183278"
"chr1","218301565","218301821","chr2","116189075","116189326","65","102112490"
"chr1","218309429","218309722","chr1","214136231","214136543","46","4173198"
"chr1","218407034","218407336","chr1","214231235","214231526","27","4175799"
"chr1","218473410","218473698","chr1","214296602","214296890","16","4176808"
"chr1","218483872","218483935","chr1","214307578","214307641","5","4176294"
"chr1","218508260","218508423","chr10","10727707","10727869","37","207780553"
"chr1","218508557","218508654","chr11","33540421","33540508","24","184968136"
"chr1","218558108","218558330","chr3","2190810","2191022","53","216367298"
"chr1","218601749","218601899","chr6","87757586","87757731","27","130844163"
"chr1","218602049","218602170","chr3","157449830","157449952","20","61152219"
"chr1","218606745","218607037","chr1","214451222","214451517","27","4155523"
"chr1","218643108","218643390","chr1","214493266","214493570","47","4149842"
"chr1","218673338","218673600","chr1","214526034","214526296","6","4147304"
"chr1","218677005","218677309","chr1","214529730","214530037","28","4147275"
"chr1","218683100","218683195","chr1","214535514","214535609","5","4147586"
"chr1","218750278","218750384","chr1","214599235","214599341","11","4151043"
"chr1","218822931","218823204","chr1","214661367","214661648","28","4161564"
"chr1","218848002","218848222","chr1","214688092","214688321","26","4159910"
"chr1","218879937","218880239","chr1","214717352","214717655","17","4162585"
"chr1","219011910","219012034","chr13","95288408","95288530","17","123723502"
"chr1","219012462","219012572","chr9","28896766","28896880","23","190115696"
"chr1","219037489","219037767","chr1","214859842","214860126","22","4177647"
"chr1","219108399","219108687","chr1","214937523","214937815","21","4170876"
"chr1","219144558","219144854","chr1","214977000","214977296","19","4167558"
"chr1","219206497","219206798","chr13","71248269","71248571","65","147958228"
"chr1","219302994","219303123","chr9","22648313","22648444","34","196654681"
"chr1","219307792","219308082","chr1","215209891","215210188","27","4097901"
"chr1","219365991","219366210","chr1","215261375","215261594","16","4104616"
"chr1","219682221","219682517","chr20","26591847","26592138","55","193090374"
"chr1","219687956","219688258","chr1","215563496","215563794","32","4124460"
"chr1","219785849","219786066","chr1","215664385","215664604","32","4121464"
"chr1","219876984","219877219","chr1","215753832","215754059","22","4123152"
"chr1","219898764","219899073","chr1","215773758","215774070","19","4125006"
"chr1","219930855","219931139","chr1","215807526","215807810","20","4123329"
"chr1","219933001","219933193","chr5","170126727","170126918","42","49806274"
"chr1","219936387","219936643","chr1","215813308","215813566","21","4123079"
"chr1","219991052","219991343","chr1","215871293","215871604","53","4119759"
"chr1","220006807","220006928","chr1","215887922","215888044","11","4118885"
"chr1","220025449","220025713","chr1","215907094","215907352","27","4118355"
"chr1","220066946","220067255","chr7","55925566","55925867","67","164141380"
"chr1","220116002","220116116","chr12","82551636","82551752","21","137564366"
"chr1","220116156","220116344","chr13","37621224","37621407","45","182494932"
"chr1","220151134","220151427","chr1","216034022","216034319","23","4117112"
"chr1","220191178","220191498","chr1","216067947","216068257","38","4123231"
"chr1","220202470","220202760","chr16","68450975","68451269","63","151751495"
"chr1","220236756","220237067","chr1","216113978","216114281","25","4122778"
"chr1","220243528","220243757","chr1","216120906","216121105","43","4122622"
"chr1","220275640","220275752","chr4","28709664","28709775","19","191565976"
"chr1","220295427","220295709","chr11","110798084","110798373","55","109497343"
"chr1","220319491","220319764","chr10","33033248","33033526","63","187286243"
"chr1","220329463","220329757","chr1","216207443","216207764","54","4122020"
"chr1","220341150","220341460","chr1","216219039","216219350","22","4122111"
"chr1","220411925","220412217","chr1","216293474","216293777","45","4118451"
"chr1","220579317","220579610","chrX","53651616","53651899","65","166927701"
"chr1","220580062","220580346","chr1","216464663","216464936","39","4115399"
"chr1","220587872","220588123","chr1","216472778","216473037","25","4115094"
"chr1","220588904","220589018","chr1","216473818","216473932","9","4115086"
"chr1","220589063","220589194","chr6","158299413","158299550","39","62289650"
"chr1","220609631","220609907","chr1","216497359","216497616","24","4112272"
"chr1","220630745","220630966","chr1","216521677","216521891","18","4109068"
"chr1","220653579","220653838","chr1","216544176","216544425","22","4109403"
"chr1","220658455","220658743","chr20","42287996","42288283","52","178370459"
"chr1","220676491","220676755","chr1","216567260","216567523","22","4109231"
"chr1","220682323","220682629","chr19","15410307","15410607","58","205272016"
"chr1","220683975","220684231","chr6","78756571","78756823","58","141927404"
"chr1","220685933","220686222","chr1","216576889","216577178","28","4109044"
"chr1","220695609","220695928","chr4","41453101","41453398","76","179242508"
"chr1","220696905","220697203","chr1","216586635","216586913","39","4110270"
"chr1","220700034","220700318","chr12","58307556","58307837","62","162392478"
"chr1","220706089","220706398","chr1","216595946","216596251","35","4110143"
"chr1","220707255","220707454","chr7","134195596","134195804","40","86511659"
"chr1","220710172","220710462","chr8","39165024","39165322","66","181545148"
"chr1","220737788","220738073","chr7","40020972","40021243","54","180716816"
"chr1","220820420","220820711","chr1","216712058","216712348","19","4108362"
"chr1","220842781","220842926","chr4","6913972","6914121","28","213928809"
"chr1","220962197","220962487","chr1","216863533","216863834","39","4098664"
"chr1","221027179","221027452","chr1","216930251","216930514","30","4096928"
"chr1","221048027","221048280","chr6","64723105","64723363","56","156324922"
"chr1","221057430","221057718","chr1","216961395","216961682","27","4096035"
"chr1","221085601","221085891","chr1","216986793","216987081","22","4098808"
"chr1","221161016","221161327","chr4","16646920","16647209","71","204514096"
"chr1","221164787","221165075","chr1","217064299","217064586","24","4100488"
"chr1","221173613","221173906","chr16","24836456","24836742","63","196337157"
"chr1","221177982","221178276","chr1","217078768","217079061","27","4099214"
"chr1","221221622","221221751","chr11","121219101","121219227","22","100002521"
"chr1","221248103","221248418","chr1","217150180","217150519","44","4097923"
"chr1","221259530","221259828","chr7","152260696","152260990","69","68998834"
"chr1","221262689","221262988","chr1","217163416","217163724","25","4099273"
"chr1","221265625","221265940","chr1","217166318","217166634","23","4099307"
"chr1","221276154","221276290","chr15","92614353","92614489","19","128661801"
"chr1","221276593","221276772","chr19","6987858","6988025","52","214288735"
"chr1","221327882","221328013","chr1","217217456","217217587","8","4110426"
"chr1","221333508","221333643","chr1","217223102","217223224","19","4110406"
"chr1","221371303","221371568","chr1","217261032","217261318","37","4110271"
"chr1","221407551","221407841","chr3","124286205","124286493","63","97121346"
"chr1","221439834","221439882","chr7","136461277","136461320","12","84978557"
"chr1","221483083","221483385","chr1","217365346","217365635","33","4117737"
"chr1","221523407","221523709","chr1","217410068","217410371","17","4113339"
"chr1","221533018","221533159","chr7","43947697","43947840","34","177585321"
"chr1","221533201","221533321","chr2","188170656","188170771","22","33362545"
"chr1","221562216","221562454","chr2","45945040","45945260","57","175617176"
"chr1","221573966","221574234","chr3","38806774","38807029","68","182767192"
"chr1","221579700","221579996","chr1","217464319","217464608","36","4115381"
"chr1","221599587","221599885","chr7","140100928","140101221","70","81498659"
"chr1","221607352","221607556","chr1","217492465","217492667","18","4114887"
"chr1","221626169","221626483","chr3","43062072","43062367","71","178564097"
"chr1","221654823","221655120","chr2","46426506","46426801","55","175228317"
"chr1","221658589","221658894","chr1","217544820","217545135","34","4113769"
"chr1","221722732","221723046","chr1","217597054","217597360","24","4125678"
"chr1","221726438","221726728","chr1","217600439","217600735","23","4125999"
"chr1","221733704","221733919","chr3","170242210","170242417","42","51491494"
"chr1","221753890","221754200","chr1","217622859","217623170","25","4131031"
"chr1","221771682","221771977","chr1","217641487","217641767","32","4130195"
"chr1","221776559","221776833","chr1","217649605","217649875","21","4126954"
"chr1","221843733","221844034","chr1","217713806","217714118","51","4129927"
"chr1","221894979","221895289","chr1","217766919","217767216","40","4128060"
"chr1","222052962","222053244","chr1","217922347","217922625","25","4130615"
"chr1","222096835","222097122","chr12","85477150","85477435","45","136619685"
"chr1","222099447","222099720","chr1","217969633","217969902","19","4129814"
"chr1","222108706","222108995","chr1","217979027","217979324","33","4129679"
"chr1","222140055","222140352","chr1","218008673","218008967","31","4131382"
"chr1","222187023","222187310","chr1","218088635","218088932","20","4098388"
"chr1","222201083","222201383","chr1","218103299","218103607","32","4097784"
"chr1","222248277","222248544","chr1","218198960","218199247","40","4049317"
"chr1","222268394","222268741","chr3","8685575","8685853","120","213582819"
"chr1","222270306","222270429","chr1","218221458","218221573","14","4048848"
"chr1","222288133","222288258","chr9","82847515","82847637","20","139440618"
"chr1","222295086","222295395","chr1","218247210","218247510","26","4047876"
"chr1","222306696","222306990","chr1","218263699","218263998","24","4042997"
"chr1","222307226","222307534","chr1","218264234","218264540","27","4042992"
"chr1","222354245","222354520","chr1","218312432","218312706","23","4041813"
"chr1","222380111","222380228","chr1","218338844","218338958","11","4041267"
"chr1","222406432","222406727","chr1","218365053","218365348","25","4041379"
"chr1","222410080","222410249","chr1","218368541","218368721","26","4041539"
"chr1","222435398","222435698","chr1","218397834","218398145","37","4037564"
"chr1","222441849","222442147","chr2","166328900","166329203","62","56112949"
"chr1","222442952","222443262","chr1","218403913","218404210","45","4039039"
"chr1","222461687","222461883","chr1","46757713","46757903","49","175703974"
"chr1","222462180","222462310","chr11","110654980","110655102","27","111807200"
"chr1","222474864","222474945","chr1","139910836","139910913","22","82564028"
"chr1","222480358","222480485","chr1","218435840","218435967","6","4044518"
"chr1","222481634","222481929","chr2","160551205","160551504","57","61930429"
"chr1","222484315","222484524","chr10","73195715","73195925","41","149288600"
"chr1","222499217","222499488","chr1","218465360","218465630","17","4033857"
"chr1","222504791","222505096","chr1","218470315","218470627","32","4034476"
"chr1","222507710","222507965","chr1","218472780","218473039","22","4034930"
"chr1","222509418","222509587","chr11","119448604","119448762","35","103060814"
"chr1","222539514","222539697","chr1","218511627","218511810","16","4027887"
"chr1","222546216","222546528","chr1","94546171","94546474","62","128000045"
"chr1","222547554","222547861","chr19","43210585","43210888","56","179336969"
"chr1","222547889","222548090","chr2","76010457","76010651","48","146537432"
"chr1","222570247","222570362","chr1","218539776","218539891","7","4030471"
"chr1","222575740","222575874","chr1","218549484","218549620","23","4026256"
"chr1","222613746","222614012","chr1","218597304","218597605","41","4016442"
"chr1","222639236","222639541","chr1","218621124","218621437","29","4018112"
"chr1","222639808","222639931","chr1","218621701","218621813","19","4018107"
"chr1","222663146","222663370","chr1","218645037","218645275","37","4018109"
"chr1","222780793","222781063","chr1","218767312","218767568","33","4013481"
"chr1","223322795","223322909","chr1","218875272","218875387","12","4447523"
"chr1","223384105","223384413","chr1","218930620","218930938","41","4453485"
"chr1","223390673","223390807","chr1","11243495","11243630","23","212147178"
"chr1","223472981","223473299","chr1","219013369","219013685","24","4459612"
"chr1","223511459","223511778","chr1","219052590","219052906","29","4458869"
"chr1","223528471","223528587","chr3","49334185","49334301","16","174194286"
"chr1","223632920","223633221","chr1","219167719","219168021","21","4465201"
"chr1","223649125","223649399","chr1","219182437","219182715","23","4466688"
"chr1","223681462","223681766","chr1","219211528","219211828","18","4469934"
"chr1","223786013","223786324","chr1","219314631","219314940","25","4471382"
"chr1","223875223","223875346","chr1","219404678","219404802","10","4470545"
"chr1","223904343","223904647","chr1","219433217","219433527","26","4471126"
"chr1","223930423","223930726","chr13","70734060","70734368","59","153196363"
"chr1","223948519","223948795","chr1","219476875","219477119","52","4471644"
"chr1","224084197","224084383","chr3","55598985","55599185","34","168485212"
"chr1","224091123","224091424","chr1","219533518","219533826","31","4557605"
"chr1","224097690","224097997","chr8","39165024","39165322","57","184932666"
"chr1","224113932","224114233","chr1","219557029","219557330","24","4556903"
"chr1","224117220","224117496","chr1","219560673","219560955","34","4556547"
"chr1","224194577","224194859","chr1","219640848","219641138","25","4553729"
"chr1","224264445","224264737","chr1","219703183","219703474","27","4561262"
"chr1","224362608","224362894","chr1","219804238","219804545","41","4558370"
"chr1","224440727","224440977","chr1","219889219","219889475","29","4551508"
"chr1","224478775","224479004","chr4","160303957","160304185","46","64174818"
"chr1","224503352","224503643","chr1","219952060","219952355","24","4551292"
"chr1","224512374","224512649","chrX","16345355","16345638","62","208167019"
"chr1","224530818","224531093","chr1","219981976","219982250","20","4548842"
"chr1","224546604","224546884","chr17","80641181","80641464","63","143905423"
"chr1","224576709","224576970","chr1","220026539","220026811","23","4550170"
"chr1","224640698","224640976","chr1","220098588","220098871","35","4542110"
"chr1","224705511","224705793","chr1","220210526","220210786","43","4494985"
"chr1","224706786","224707090","chr1","220211784","220212080","39","4495002"
"chr1","224709174","224709444","chr1","220214122","220214380","30","4495052"
"chr1","224726594","224726891","chr2","68173712","68173989","63","156552882"
"chr1","224741432","224741723","chr12","52717774","52718069","65","172023658"
"chr1","224766104","224766356","chr1","220272569","220272835","31","4493535"
"chr1","224770526","224770824","chr1","220276855","220277154","26","4493671"
"chr1","224775242","224775538","chr1","220281125","220281416","32","4494117"
"chr1","224784693","224784967","chr1","220290357","220290635","17","4494336"
"chr1","224826150","224826354","chr1","220327224","220327428","15","4498926"
"chr1","224827006","224827282","chr1","220328078","220328382","49","4498928"
"chr1","224842295","224842597","chr1","220342738","220343051","35","4499557"
"chr1","224874800","224875044","chr11","47127118","47127350","68","177747682"
"chr1","224877286","224877564","chr5","78558700","78558970","77","146318586"
"chr1","224926345","224926559","chr1","220418659","220418880","25","4507686"
"chr1","224928433","224928735","chr1","220420604","220420912","50","4507829"
"chr1","224935920","224936068","chr11","13579411","13579559","21","211356509"
"chr1","224940162","224940441","chr2","172053942","172054223","57","52886220"
"chr1","224972565","224972830","chr1","220464726","220465015","51","4507839"
"chr1","224987656","224987961","chr1","220480215","220480516","28","4507441"
"chr1","224994640","224994942","chr1","220487288","220487598","19","4507352"
"chr1","225006863","225007136","chr20","42179769","42180051","59","182827094"
"chr1","225015900","225015961","chr12","20509197","20509257","11","204506703"
"chr1","225025470","225025731","chr1","220518782","220519054","31","4506688"
"chr1","225061070","225061375","chr1","220555162","220555468","37","4505908"
"chr1","225070500","225070756","chr1","220564635","220564908","33","4505865"
"chr1","225079065","225079367","chr1","220573268","220573541","49","4505797"
"chr1","225128517","225128803","chr1","220622406","220622675","38","4506111"
"chr1","225138994","225139289","chr1","220632570","220632844","38","4506424"
"chr1","225141976","225142288","chr1","220635543","220635824","52","4506433"
"chr1","225161169","225161393","chr1","220653461","220653668","30","4507708"
"chr1","225220290","225220583","chr1","220711367","220711658","25","4508923"
"chr1","225223701","225223972","chr1","220714762","220715034","17","4508939"
"chr1","225233548","225233892","chr1","220724890","220725239","37","4508658"
"chr1","225260386","225260688","chr1","220752248","220752549","24","4508138"
"chr1","225271994","225272058","chr1","220765217","220765274","13","4506777"
"chr1","225272358","225272509","chr1","220765564","220765715","9","4506794"
"chr1","225276751","225277041","chr1","220769407","220769692","28","4507344"
"chr1","225280064","225280365","chr1","220772727","220773033","23","4507337"
"chr1","225287182","225287498","chr1","220779823","220780102","60","4507359"
"chr1","225287784","225287906","chr1","220780391","220780503","15","4507393"
"chr1","225304989","225305267","chr1","220797557","220797858","37","4507432"
"chr1","225307975","225308264","chr19","3353989","3354279","53","221953986"
"chr1","225311971","225312053","chr13","29152359","29152438","11","196159612"
"chr1","225313853","225314063","chr3","42390097","42390302","58","182923756"
"chr1","225319685","225319811","chr1","220812098","220812217","18","4507587"
"chr1","225325912","225326172","chr1","220818571","220818830","22","4507341"
"chr1","225333019","225333292","chr1","220826054","220826342","29","4506965"
"chr1","225338264","225338544","chr1","220831400","220831688","27","4506864"
"chr1","225339110","225339329","chr14","69113872","69114083","41","156225238"
"chr1","225366948","225367167","chr3","79858554","79858774","58","145508394"
"chr1","225376322","225376608","chr1","220874446","220874731","15","4501876"
"chr1","225383601","225383905","chrX","17672800","17673101","55","207710801"
"chr1","225385819","225386116","chr3","124267629","124267922","52","101118190"
"chr1","225427096","225427397","chr1","220926244","220926537","18","4500852"
"chr1","225454531","225454830","chr1","220954139","220954421","63","4500392"
"chr1","225467375","225467621","chr1","220967118","220967374","26","4500257"
"chr1","225474937","225475238","chr1","220975369","220975674","18","4499568"
"chr1","225478306","225478591","chr1","220979413","220979689","52","4498893"
"chr1","225499749","225499990","chr1","17778281","17778527","46","207721468"
"chr1","225530140","225530434","chr1","221044560","221044832","46","4485580"
"chr1","225534183","225534482","chr1","221048659","221048967","29","4485524"
"chr1","225583506","225583783","chr1","221097063","221097341","23","4486443"
"chr1","225601092","225601355","chr1","221113921","221114193","33","4487171"
"chr1","225638094","225638341","chr1","221153977","221154223","27","4484117"
"chr1","225651439","225651723","chr1","221167574","221167836","35","4483865"
"chr1","225657514","225657788","chr20","58964558","58964836","55","166692956"
"chr1","225696712","225697001","chr1","221217922","221218201","27","4478790"
"chr1","225699996","225700111","chr1","221221545","221221660","3","4478451"
"chr1","225702510","225702768","chr1","221224160","221224419","20","4478350"
"chr1","225703699","225703785","chr6","13962575","13962670","23","211741124"
"chr1","225712909","225713207","chr7","45639425","45639731","54","180073484"
"chr1","225726776","225726869","chrUn_NW_014806939v1","400","484","26","225726376"
"chr1","225726877","225727014","chr1","11243495","11243630","25","214483382"
"chr1","225731069","225731387","chr2","113332502","113332829","71","112398567"
"chr1","225740908","225741182","chr1","221269915","221270199","19","4470993"
"chr1","225748466","225748611","chr17","10251440","10251580","30","215497026"
"chr1","225748898","225749090","chr4","13599126","13599309","46","212149772"
"chr1","225753798","225754069","chr1","221282634","221282905","21","4471164"
"chr1","225767847","225767965","chr1","205464254","205464380","22","20303593"
"chr1","225770231","225770512","chr1","221303089","221303376","22","4467142"
"chr1","225785186","225785320","chr3","10002180","10002302","31","215783006"
"chr1","225787060","225787307","chr1","221319246","221319505","25","4467814"
"chr1","225808884","225809208","chr1","221341838","221342153","27","4467046"
"chr1","225844423","225844712","chr1","221377059","221377369","36","4467364"
"chr1","225847641","225847890","chr1","221381233","221381476","27","4466408"
"chr1","225848186","225848274","chr1","221381775","221381862","5","4466411"
"chr1","225848395","225848697","chr1","221381989","221382290","35","4466406"
"chr1","225855186","225855474","chr1","25629235","25629522","61","200225951"
"chr1","225864040","225864174","chr16","44482702","44482831","18","181381338"
"chr1","225866546","225866671","chr3","42126135","42126252","36","183740411"
"chr1","225874341","225874466","chr14","113225639","113225756","29","112648702"
"chr1","225880541","225880849","chr3","368876","369183","75","225511665"
"chr1","225898174","225898481","chr1","221429597","221429911","24","4468577"
"chr1","225902283","225902506","chr1","221433686","221433902","35","4468597"
"chr1","225906082","225906371","chr1","221437527","221437822","25","4468555"
"chr1","225929060","225929352","chr1","221461218","221461514","21","4467842"
"chr1","225942289","225942596","chr1","221476289","221476601","18","4466000"
"chr1","225955510","225955644","chr5","37288892","37289024","22","188666618"
"chr1","225956609","225956890","chr1","221490473","221490747","23","4466136"
"chr1","225961860","225962030","chr14","7002991","7003156","25","218958869"
"chr1","225978956","225979266","chr19","18064212","18064515","57","207914744"
"chr1","225984339","225984634","chr1","221521782","221522092","31","4462557"
"chr1","225988631","225988943","chr9","113024725","113025027","56","112963906"
"chr1","225989418","225989737","chrX","113634547","113634849","75","112354871"
"chr1","226020190","226020403","chr1","221560216","221560433","17","4459974"
"chr1","226025955","226026245","chr1","221566538","221566829","24","4459417"
"chr1","226036180","226036472","chr1","221578972","221579264","17","4457208"
"chr1","226049327","226049604","chr1","221592056","221592360","49","4457271"
"chr1","226050637","226050936","chr19","40926811","40927106","56","185123826"
"chr1","226053164","226053417","chr1","221596168","221596410","28","4456996"
"chr1","226076930","226077071","chr1","221618883","221619024","11","4458047"
"chr1","226086437","226086721","chr1","221628641","221628888","48","4457796"
"chr1","226096156","226096219","chrX","47032658","47032724","11","179063498"
"chr1","226096519","226096716","chr1","221639720","221639951","48","4456799"
"chr1","226099692","226099933","chr10","2083688","2083946","96","224016004"
"chr1","226102739","226103035","chr18","39207065","39207355","56","186895674"
"chr1","226108080","226108395","chr1","221647681","221647979","60","4460399"
"chr1","226121133","226121314","chr1","221660403","221660580","22","4460730"
"chr1","226121608","226121725","chr1","221660878","221660991","16","4460730"
"chr1","226127907","226128230","chr1","221667405","221667727","16","4460502"
"chr1","226157363","226157645","chr1","221696892","221697177","23","4460471"
"chr1","226185139","226185440","chr1","221725661","221725947","31","4459478"
"chr1","226191744","226192021","chr1","221732831","221733112","21","4458913"
"chr1","226194486","226194702","chr1","221735554","221735778","19","4458932"
"chr1","226215592","226215887","chr1","221755675","221755969","19","4459917"
"chr1","226218427","226218632","chr14","52870570","52870773","41","173347857"
"chr1","226221117","226221211","chr1","221762579","221762671","5","4458538"
"chr1","226222919","226223242","chr4","36484206","36484512","70","189738713"
"chr1","226262917","226263289","chr1","221800401","221800757","49","4462516"
"chr1","226285113","226285339","chr1","221823341","221823568","23","4461772"
"chr1","226288019","226288192","chr1","221826290","221826463","11","4461729"
"chr1","226291926","226291997","chr1","221830216","221830288","13","4461710"
"chr1","226292268","226292417","chr1","221830589","221830733","24","4461679"
"chr1","226350743","226351029","chr1","221887540","221887847","41","4463203"
"chr1","226361177","226361328","chr1","221898010","221898161","18","4463167"
"chr1","226364953","226365151","chr7","98187919","98188122","46","128177034"
"chr1","226401050","226401365","chr7","125197753","125198061","59","101203297"
"chr1","226407605","226407897","chr1","221947413","221947708","29","4460192"
"chr1","226416231","226416537","chr4","111451981","111452286","50","114964250"
"chr1","226437934","226438252","chr1","53872477","53872791","73","172565457"
"chr1","226463428","226463591","chr1","222005034","222005199","14","4458394"
"chr1","226463890","226464022","chr1","222005496","222005628","11","4458394"
"chr1","226480407","226480705","chr1","222022264","222022592","56","4458143"
"chr1","226507811","226508115","chr1","222052805","222053110","38","4455006"
"chr1","226518019","226518288","chr1","222063431","222063698","21","4454588"
"chr1","226539429","226539722","chr1","222085043","222085331","27","4454386"
"chr1","226577357","226577584","chr1","222126507","222126743","21","4450850"
"chr1","226609737","226610033","chr1","222159558","222159862","22","4450179"
"chr1","226610638","226610924","chr1","222160458","222160744","21","4450180"
"chr1","226624301","226624587","chr18","11757610","11757901","61","214866691"
"chr1","226629726","226630010","chr1","222179657","222179945","22","4450069"
"chr1","226640186","226640468","chr16","60142196","60142473","52","166497990"
"chr1","226676879","226677175","chr1","222228814","222229113","35","4448065"
"chr1","226699097","226699392","chr1","222257365","222257664","26","4441732"
"chr1","226729358","226729489","chr9","115052851","115052979","22","111676507"
"chr1","226729554","226729848","chr1","222287364","222287667","23","4442190"
"chr1","226761023","226761326","chr1","222324598","222324896","25","4436425"
"chr1","226829503","226829805","chr1","222385687","222385999","33","4443816"
"chr1","226878548","226878845","chr1","222437105","222437395","27","4441443"
"chr1","226918187","226918307","chr20","12117025","12117140","22","214801162"
"chr1","227035356","227035582","chr1","222636255","222636478","17","4399101"
"chr1","227042401","227042696","chr1","222642949","222643265","46","4399452"
"chr1","227043836","227044127","chr1","211353988","211354282","60","15689848"
"chr1","227063801","227063863","chr5","147426888","147426953","20","79636913"
"chr1","227084603","227084722","chr5","2631607","2631727","16","224452996"
"chr1","227084768","227084898","chr1","67637888","67638021","41","159446880"
"chr1","227100977","227101263","chr1","222700118","222700437","52","4400859"
"chr1","227104081","227104375","chr1","222704041","222704320","43","4400040"
"chr1","227122747","227123032","chr1","222724338","222724624","18","4398409"
"chr1","227135642","227135922","chr1","222737202","222737482","15","4398440"
"chr1","227156248","227156542","chr1","222758006","222758315","40","4398242"
"chr1","227162453","227162729","chr1","222764497","222764797","40","4397956"
"chr1","227174851","227175034","chr1","222776850","222777039","21","4398001"
"chr1","227246472","227246750","chr1","222843783","222844064","33","4402689"
"chr1","227250873","227251186","chr1","222848349","222848661","43","4402524"
"chr1","227262312","227262616","chr1","222859657","222859962","47","4402655"
"chr1","227345050","227345282","chr1","222943933","222944161","16","4401117"
"chr1","227349290","227349604","chr1","223059911","223060211","61","4289379"
"chr1","227367555","227367669","chr9","61837632","61837748","19","165529923"
"chr1","227370144","227370413","chr19","3618015","3618286","68","223752129"
"chr1","227371478","227371763","chr1","222979015","222979292","33","4392463"
"chr1","227382141","227382363","chr1","222988457","222988674","19","4393684"
"chr1","227402278","227402487","chr1","223005902","223006105","15","4396376"
"chr1","227406143","227406428","chr2","99648006","99648286","54","127758137"
"chr1","227449575","227449879","chr1","223052512","223052823","22","4397063"
"chr1","227457248","227457542","chr1","223059911","223060211","22","4397337"
"chr1","227457923","227458032","chr1","223060548","223060656","7","4397375"
"chr1","227462121","227462430","chr1","223064438","223064736","30","4397683"
"chr1","227471655","227471876","chr9","28839934","28840135","59","198631721"
"chr1","227511533","227511829","chr1","223119426","223119726","25","4392107"
"chr1","227515419","227515771","chr6","93662967","93663295","75","133852452"
"chr1","227517797","227518092","chr1","163060011","163060308","64","64457786"
"chr1","227522761","227523036","chr1","223132467","223132736","19","4390294"
"chr1","227524275","227524558","chr1","223134276","223134557","30","4389999"
"chr1","227527141","227527441","chr1","223137165","223137489","47","4389976"
"chr1","227545999","227546285","chr1","223156136","223156426","24","4389863"
"chr1","227555641","227555910","chr5","187095382","187095635","69","40460259"
"chr1","227557489","227557768","chr1","223173156","223173437","18","4384333"
"chr1","227565752","227566034","chr1","223187961","223188240","35","4377791"
"chr1","227568102","227568389","chr1","223190268","223190531","46","4377834"
"chr1","227716833","227717128","chr6","62495959","62496247","59","165220874"
"chr1","227736222","227736512","chr1","211215809","211216098","61","16520413"
"chr1","227749874","227750167","chr1","223251651","223251962","33","4498223"
"chr1","227756481","227756761","chr1","223259047","223259337","26","4497434"
"chr1","227758497","227758793","chr1","223261130","223261424","31","4497367"
"chr1","227782212","227782499","chr3","39571415","39571697","51","188210797"
"chr1","227784772","227785059","chr1","223298026","223298313","13","4486746"
"chr1","227789552","227789833","chr8","142417021","142417304","56","85372531"
"chr1","227791567","227791910","chr1","223303163","223303472","53","4488404"
"chr1","227805518","227805803","chr1","223322959","223323243","17","4482559"
"chr1","227828717","227828789","chr1","18290856","18290929","11","209537861"
"chr1","227836010","227836324","chr1","223355536","223355848","28","4480474"
"chr1","227838290","227838486","chr1","223357803","223358016","34","4480487"
"chr1","227838785","227838847","chr8","101419097","101419158","12","126419688"
"chr1","227868651","227868768","chr1","223393736","223393853","7","4474915"
"chr1","227890443","227890618","chr4","34069764","34069931","43","193820679"
"chr1","227919570","227919655","chr3","50227514","50227597","20","177692056"
"chr1","227939172","227939446","chr1","223467130","223467381","39","4472042"
"chr1","227941493","227941689","chr13","69384999","69385196","49","158556494"
"chr1","227965016","227965291","chr1","223493355","223493640","34","4471661"
"chr1","227983776","227984054","chr1","223512936","223513229","37","4470840"
"chr1","227987786","227988082","chr1","223517269","223517566","22","4470517"
"chr1","227989067","227989361","chr1","223518863","223519157","16","4470204"
"chr1","227992845","227993104","chr16","64075400","64075662","59","163917445"
"chr1","228025606","228025812","chr16","7881345","7881526","62","220144261"
"chr1","228038621","228038746","chr3","165142712","165142835","22","62895909"
"chr1","228052052","228052181","chr1","223587121","223587250","8","4464931"
"chr1","228054325","228054611","chr1","223589057","223589363","39","4465268"
"chr1","228055908","228056189","chr11","33303663","33303941","63","194752245"
"chr1","228058557","228058690","chr8","80697385","80697514","27","147361172"
"chr1","228078001","228078230","chr1","223615246","223615483","25","4462755"
"chr1","228103262","228103337","chr16","55863503","55863575","19","172239759"
"chr1","228110498","228110799","chr7","144503285","144503589","56","83607213"
"chr1","228114164","228114446","chr13","93973412","93973700","54","134140752"
"chr1","228129291","228129589","chr1","223675363","223675657","24","4453928"
"chr1","228184704","228184981","chr1","223721598","223721859","34","4463106"
"chr1","228251877","228252188","chr16","67475653","67475963","64","160776224"
"chr1","228274559","228274795","chr1","223829990","223830230","19","4444569"
"chr1","228278549","228278861","chr1","223834353","223834647","33","4444196"
"chr1","228291695","228291987","chr1","223846893","223847189","24","4444802"
"chr1","228321093","228321380","chr1","223891435","223891691","43","4429658"
"chr1","228321816","228322103","chr1","223892234","223892536","49","4429582"
"chr1","228328614","228328910","chr4","51948783","51949081","61","176379831"
"chr1","228332692","228332789","chr15","107545701","107545798","21","120786991"
"chr1","228333000","228333259","chr2","172188998","172189258","61","56144002"
"chr1","228366976","228367281","chr1","223907445","223907748","23","4459531"
"chr1","228372102","228372374","chr1","223912491","223912769","19","4459611"
"chr1","228384169","228384483","chr1","223925232","223925529","45","4458937"
"chr1","228409510","228409813","chr1","223948714","223949017","16","4460796"
"chr1","228426638","228426927","chrX","37786289","37786580","56","190640349"
"chr1","228428574","228428877","chrX","64991673","64991978","54","163436901"
"chr1","228437231","228437528","chr1","223979328","223979622","13","4457903"
"chr1","228437976","228438265","chr1","223980068","223980359","32","4457908"
"chr1","228466978","228467261","chr14","67184231","67184506","74","161282747"
"chr1","228475913","228476213","chr1","224019562","224019856","26","4456351"
"chr1","228477366","228477651","chr1","224020950","224021271","54","4456416"
"chr1","228491573","228491901","chr1","224033761","224034086","18","4457812"
"chr1","228500168","228500488","chr1","224042183","224042472","62","4457985"
"chr1","228502749","228503061","chr3","43652365","43652670","57","184850384"
"chr1","228516808","228516933","chr15","10437549","10437674","28","218079259"
"chr1","228563802","228563902","chr3","39605341","39605445","18","188958461"
"chr1","228564402","228564574","chr16","38738002","38738175","48","189826400"
"chr1","228593096","228593342","chr1","224135881","224136124","16","4457215"
"chr1","228606132","228606423","chr1","224150279","224150572","27","4455853"
"chr1","228672336","228672597","chr1","224215011","224215277","26","4457325"
"chr1","228722331","228722542","chr1","224260687","224260897","11","4461644"
"chr1","228815755","228815891","chr1","224359683","224359809","18","4456072"
"chr1","228912189","228912516","chr10","82148587","82148901","79","146763602"
"chr1","228949673","228949945","chr1","224506329","224506591","25","4443344"
"chr1","228953612","228953864","chr1","224510371","224510590","51","4443241"
"chr1","228969684","228969987","chr1","224526961","224527247","36","4442723"
"chr1","228979430","228979712","chr1","224537351","224537628","29","4442079"
"chr1","229039632","229039927","chr1","224678089","224678387","23","4361543"
"chr1","229151007","229151294","chr1","224813778","224814060","25","4337229"
"chr1","229438409","229438683","chr5","40762070","40762343","67","188676339"
"chr1","229440829","229441115","chr12","64290410","64290700","67","165150419"
"chr1","229516475","229516775","chr1","225010044","225010343","16","4506431"
"chr1","229526718","229527026","chr1","225019701","225019976","50","4507017"
"chr1","229609701","229609985","chr6","139759292","139759574","65","89850409"
"chr1","229640758","229641049","chr1","211215809","211216098","58","18424949"
"chr1","229749716","229750007","chr1","211215809","211216098","60","18533907"
"chr3","58720175","58720493","chr20","17218841","17219141","74","41501334"
"chr3","33816435","33816738","chrX","126706885","126707183","58","92890450"
"chr3","38403976","38404274","chr2","104537459","104537758","20","66133483"
"chr3","48627454","48627730","chr2","94883755","94884027","24","46256301"
"chr3","48758715","48758955","chr2","104672036","104672284","58","55913321"
"chr3","57278303","57278574","chr2","86051562","86051834","15","28773259"
"chr3","112852806","112853122","chr2","29867734","29868024","50","82985072"
"chr3","182321080","182321270","chr2","116335187","116335365","37","65985893"
"chr3","184024923","184025232","chr2","114465749","114466048","26","69559174"
"chr3","188874458","188874786","chr2","109376442","109376770","19","79498016"
"chr3","92598","92871","chr2","66675887","66676160","11","66583289"
"chr3","132896","133034","chrX","65810626","65810764","24","65677730"
"chr3","133683","133849","chr9","26520390","26520553","38","26386707"
"chr3","221248","221543","chr2","66544949","66545254","25","66323701"
"chr3","270899","271247","chrX","122173649","122173988","80","121902750"
"chr3","272319","272522","chr2","66494945","66495144","13","66222626"
"chr3","336196","336340","chr2","53664609","53664755","26","53328413"
"chr3","374502","374729","chr2","90596817","90597041","61","90222315"
"chr3","375083","375306","chr2","66390339","66390554","40","66015256"
"chr3","386049","386247","chr9","57786664","57786859","51","57400615"
"chr3","388209","388340","chr8","33978418","33978547","27","33590209"
"chr3","396732","396917","chr7","159041780","159041958","45","158645048"
"chr3","396954","397067","chr1","146993815","146993931","18","146596861"
"chr3","399480","399859","chr14","70576619","70576993","107","70177139"
"chr3","470142","470253","chr14","72745880","72745995","25","72275738"
"chr3","530343","530626","chr2","66229470","66229760","33","65699127"
"chr3","541656","541776","chr6","59480600","59480720","17","58938944"
"chr3","741241","741551","chr11","98281117","98281424","59","97539876"
"chr3","792281","792386","chr19","8750669","8750772","24","7958388"
"chr3","868001","868305","chr19","29145761","29146064","76","28277760"
"chr3","950218","950543","chr2","65736678","65736964","59","64786460"
"chr3","1006341","1006648","chr2","65681981","65682297","29","64675640"
"chr3","1033982","1034184","chr5","185428047","185428256","58","184394065"
"chr3","1172577","1172689","chr10","73913634","73913741","21","72741057"
"chr3","1198193","1198356","chr2","65427682","65427817","36","64229489"
"chr3","1198458","1198525","chrY","4524138","4524189","21","3325680"
"chr3","1204254","1204531","chr2","65422905","65423182","16","64218651"
"chr3","1254754","1255032","chr2","65370555","65370832","20","64115801"
"chr3","1259996","1260231","chr20","53017139","53017355","59","51757143"
"chr3","1295585","1295745","chr2","65332861","65333028","38","64037276"
"chr3","1295770","1296063","chr20","36425190","36425487","68","35129420"
"chr3","1375671","1376000","chr2","65254095","65254416","33","63878424"
"chr3","1398632","1398910","chr2","65230791","65231100","60","63832159"
"chr3","1465959","1466250","chr2","65165736","65166022","28","63699777"
"chr3","1522490","1522773","chr2","65111293","65111578","28","63588803"
"chr3","1549390","1549672","chr2","65084346","65084621","32","63534956"
"chr3","1610944","1611227","chr2","65025489","65025759","48","63414545"
"chr3","1700516","1700710","chr2","64938245","64938439","20","63237729"
"chr3","1718454","1718757","chr2","64923025","64923347","37","63204571"
"chr3","1829156","1829233","chr2","64817645","64817728","11","62988489"
"chr3","1902237","1902495","chr2","64735266","64735543","35","62833029"
"chr3","1911541","1911817","chr2","64726612","64726922","54","62815071"
"chr3","1987755","1988041","chr2","64651199","64651490","30","62663444"
"chr3","2068061","2068328","chr16","20789933","20790201","58","18721872"
"chr3","2077638","2077951","chr2","64560719","64561032","32","62483081"
"chr3","2093118","2093422","chr2","64552914","64553221","33","62459796"
"chr3","2109452","2109755","chr6","46179708","46180020","32","44070256"
"chr3","2110015","2110318","chr2","64536791","64537090","21","62426776"
"chr3","2135531","2135831","chr7","140100928","140101221","58","137965397"
"chr3","2208130","2208414","chr2","64432418","64432700","22","62224288"
"chr3","2257065","2257375","chr2","64380722","64381026","36","62123657"
"chr3","2607682","2607994","chr2","64028637","64028945","24","61420955"
"chr3","2615106","2615405","chr2","64022703","64023007","20","61407597"
"chr3","2636478","2636792","chr16","20691400","20691707","63","18054922"
"chr3","2649643","2649905","chr2","63988895","63989159","20","61339252"
"chr3","2676344","2676638","chr2","63960114","63960435","54","61283770"
"chr3","2778422","2778734","chr2","63863593","63863904","29","61085171"
"chr3","2784453","2784758","chr2","63857671","63857955","43","61073218"
"chr3","2827043","2827335","chr2","63815610","63815914","24","60988567"
"chr3","2869138","2869260","chr3","137079996","137080118","23","134210858"
"chr3","2869557","2869745","chr2","44622800","44622987","37","41753243"
"chr3","2872773","2873068","chr2","63767463","63767758","15","60894690"
"chr3","2901549","2901774","chr2","63738674","63738900","22","60837125"
"chr3","2964628","2964914","chr2","63669824","63670122","32","60705196"
"chr3","2975212","2975382","chr19","45146969","45147137","29","42171757"
"chr3","2975414","2975539","chr10","17234034","17234151","23","14258620"
"chr3","3067309","3067438","chr11","121219101","121219227","21","118151792"
"chr3","3081137","3081418","chr2","63550693","63550996","40","60469556"
"chr3","3087256","3087551","chr2","63544542","63544845","27","60457286"
"chr3","3126638","3126935","chr2","63503875","63504172","16","60377237"
"chr3","3170221","3170503","chr6","68750302","68750588","61","65580081"
"chr3","3182288","3182593","chr2","63432169","63432466","26","60249881"
"chr3","3249734","3249991","chr17","5695741","5696014","57","2446007"
"chr3","3298730","3298863","chr1","142196085","142196201","46","138897355"
"chr3","3299204","3299411","chr7","157630776","157630985","50","154331572"
"chr3","3351612","3351913","chr2","63260198","63260505","24","59908586"
"chr3","3362084","3362251","chr2","63249711","63249878","13","59887627"
"chr3","3397804","3398095","chr2","63214615","63214907","12","59816811"
"chr3","3403173","3403483","chr2","63209037","63209327","36","59805864"
"chr3","3416656","3416937","chr2","63195694","63195974","23","59779038"
"chr3","3491960","3492253","chr2","63122551","63122854","40","59630591"
"chr3","3654398","3654719","chrX","27323100","27323414","72","23668702"
"chr3","3708450","3708679","chr2","62902951","62903172","22","59194501"
"chr3","3746789","3746944","chr2","62868158","62868328","21","59121369"
"chr3","3748807","3749117","chr2","62866028","62866308","66","59117221"
"chr3","3787152","3787426","chr3","32720578","32720845","60","28933426"
"chr3","3911442","3911731","chr2","62710210","62710481","36","58798768"
"chr3","3983461","3983755","chr2","62648105","62648400","25","58664644"
"chr3","4026708","4026881","chr2","62606466","62606649","21","58579758"
"chr3","4034416","4034622","chr2","62599043","62599249","18","58564627"
"chr3","4089119","4089408","chr2","62544368","62544650","38","58455249"
"chr3","4105846","4106124","chr7","96759809","96760089","65","92653963"
"chr3","4168262","4168540","chr2","62486110","62486417","53","58317848"
"chr3","4212086","4212392","chr2","62446110","62446410","29","58234024"
"chr3","4245925","4246219","chr2","62412710","62413017","35","58166785"
"chr3","4288543","4288854","chr1","28763547","28763860","61","24475004"
"chr3","4324395","4324645","chr2","62322890","62323140","15","57998495"
"chr3","4352665","4352961","chr2","62293756","62294074","42","57941091"
"chr3","4362271","4362554","chr2","62285455","62285731","21","57923184"
"chr3","4382556","4382841","chr11","54506910","54507197","70","50124354"
"chr3","4388439","4388727","chr2","62263315","62263611","29","57874876"
"chr3","4408475","4408776","chr2","62243417","62243718","18","57834942"
"chr3","4413882","4414084","chr2","62238274","62238487","30","57824392"
"chr3","4414436","4414529","chr2","62237832","62237924","9","57823396"
"chr3","4417217","4417507","chr2","62234854","62235142","20","57817637"
"chr3","4430958","4431055","chr7","51585793","51585890","25","47154835"
"chr3","4432376","4432650","chr2","62225232","62225472","52","57792856"
"chr3","4434297","4434589","chr2","62223259","62223573","40","57788962"
"chr3","4450755","4451053","chr2","62159212","62159506","22","57708457"
"chr3","4471162","4471288","chr2","62138996","62139126","14","57667834"
"chr3","4471580","4471756","chr6","71966841","71967009","37","67495261"
"chr3","4500562","4500864","chr13","71248269","71248571","51","66747707"
"chr3","4502425","4502738","chr2","62104153","62104465","47","57601728"
"chr3","4517246","4517533","chr12","114130342","114130631","64","109613096"
"chr3","4525268","4525562","chr2","184143766","184144059","51","179618498"
"chr3","4527618","4527896","chr2","62069018","62069295","32","57541400"
"chr3","4556624","4556927","chr2","62039832","62040134","31","57483208"
"chr3","4565940","4566235","chr2","62030467","62030763","24","57464527"
"chr3","4568418","4568689","chr2","62028008","62028287","31","57459590"
"chr3","4583568","4583855","chr8","129433118","129433406","54","124849550"
"chr3","4602415","4602700","chr13","27388292","27388580","54","22785877"
"chr3","4607374","4607639","chr2","61989963","61990222","28","57382589"
"chr3","4628064","4628356","chr5","22397555","22397847","60","17769491"
"chr3","4632458","4632753","chr2","195639631","195639930","55","191007173"
"chr3","4698549","4698852","chr2","61861142","61861444","20","57162593"
"chr3","4733586","4733902","chr2","61826255","61826548","45","57092669"
"chr3","4824915","4825139","chr2","61733550","61733786","23","56908635"
"chr3","4891118","4891412","chr2","61667345","61667632","25","56776227"
"chr3","4926838","4927156","chr2","61631138","61631444","29","56704300"
"chr3","4945231","4945508","chr2","61613218","61613501","47","56667987"
"chr3","4959729","4959936","chr2","61598261","61598451","29","56638532"
"chr3","4963806","4964113","chr2","61593996","61594304","21","56630190"
"chr3","4972841","4973161","chr2","61585062","61585382","22","56612221"
"chr3","4976122","4976251","chr2","61581709","61581830","17","56605587"
"chr3","4981986","4982115","chr2","61574377","61574506","9","56592391"
"chr3","4995977","4996249","chr2","61559433","61559703","28","56563456"
"chr3","5010407","5010530","chr2","61544180","61544303","8","56533773"
"chr3","5011615","5011934","chr2","61542751","61543069","24","56531136"
"chr3","5040445","5040724","chr2","61516901","61517180","16","56476456"
"chr3","5041303","5041420","chr2","61516202","61516319","10","56474899"
"chr3","5042709","5042901","chr2","61514716","61514908","8","56472007"
"chr3","5047775","5048045","chr2","61509744","61510009","12","56461969"
"chr3","5057788","5057989","chr2","61499602","61499810","22","56441814"
"chr3","5079480","5079781","chr2","51986958","51987255","66","46907478"
"chr3","5114300","5114570","chr4","11454724","11454998","66","6340424"
"chr3","5115622","5115735","chr2","61439871","61439987","11","56324249"
"chr3","5122355","5122644","chr2","61432421","61432722","31","56310066"
"chr3","5123495","5123720","chr2","61431302","61431575","57","56307807"
"chr3","5132526","5132845","chr2","61422238","61422556","22","56289712"
"chr3","5139935","5140066","chr2","61414948","61415080","5","56275013"
"chr3","5140393","5140552","chr2","61414480","61414646","18","56274087"
"chr3","5164025","5164251","chr2","61393122","61393344","25","56229097"
"chr3","5172150","5172446","chr2","61385506","61385830","57","56213356"
"chr3","5177486","5177605","chr2","61380703","61380816","12","56203217"
"chr3","5185415","5185542","chr2","61373245","61373374","13","56187830"
"chr3","5199257","5199527","chr3","37042470","37042744","56","31843213"
"chr3","5207665","5207953","chr2","61354687","61354983","56","56147022"
"chr3","5237330","5237647","chr2","61323040","61323347","36","56085710"
"chr3","5247019","5247179","chr2","61313195","61313366","18","56066176"
"chr3","5247312","5247592","chr2","61312810","61313101","30","56065498"
"chr3","5271867","5272163","chr13","24137226","24137510","68","18865359"
"chr3","5311883","5312183","chr2","61247048","61247348","34","55935165"
"chr3","5330375","5330616","chr2","61228539","61228778","17","55898164"
"chr3","5340365","5340650","chr2","61218994","61219279","18","55878629"
"chr3","5446831","5447117","chr2","61040391","61040682","27","55593560"
"chr3","5470439","5470765","chr2","61016223","61016544","47","55545784"
"chr3","5483641","5483952","chr2","61003285","61003598","29","55519644"
"chr3","5524131","5524398","chr2","60959738","60960003","19","55435607"
"chr3","5593659","5593743","chr14","122066490","122066569","12","116472831"
"chr3","5918119","5918360","chr2","60560560","60560771","52","54642441"
"chr3","5944836","5945157","chr2","60532542","60532851","39","54587706"
"chr3","6117427","6117553","chr2","60367062","60367182","15","54249635"
"chr3","6120704","6120826","chr9","12674840","12674960","18","6554136"
"chr3","6176425","6176735","chr2","60329781","60330093","18","54153356"
"chr3","6247340","6247654","chr2","60219143","60219458","31","53971803"
"chr3","6387196","6387420","chr11","120676371","120676596","72","114289175"
"chr3","6675758","6676058","chr2","59773138","59773428","43","53097380"
"chr3","6696576","6696766","chr2","59757300","59757506","26","53060724"
"chr3","6697597","6697944","chr3","41630422","41630740","92","34932825"
"chr3","6784036","6784317","chr2","59670659","59670957","42","52886623"
"chr3","6829587","6829622","chr8","29452845","29452878","6","22623258"
"chr3","6863234","6863568","chr2","59592358","59592695","41","52729124"
"chr3","6893826","6893956","chr2","59560186","59560316","9","52666360"
"chr3","6895525","6895612","chr2","59558532","59558619","6","52663007"
"chr3","6950496","6950788","chr2","59508308","59508602","30","52557812"
"chr3","7012558","7012595","chr2","145901562","145901604","10","138889004"
"chr3","7058509","7058789","chr2","59404766","59405046","25","52346257"
"chr3","7118474","7118779","chr2","59345117","59345411","31","52226643"
"chr3","7139150","7139411","chr2","59324497","59324757","19","52185347"
"chr3","7371127","7371391","chr5","85525673","85525926","60","78154546"
"chr3","7556950","7557240","chr2","59041515","59041800","21","51484565"
"chr3","7568360","7568550","chr2","59029766","59029954","20","51461406"
"chr3","7615821","7616035","chr2","58975253","58975457","33","51359432"
"chr3","7666894","7667183","chr7","55406353","55406635","59","47739459"
"chr3","7705537","7705822","chr2","58873465","58873781","51","51167928"
"chr3","7737724","7737997","chr2","58842454","58842728","25","51104730"
"chr3","7828892","7829186","chr2","58752008","58752302","17","50923116"
"chr3","7908417","7908716","chr2","58663838","58664146","22","50755421"
"chr3","7916830","7917105","chr2","58655445","58655717","32","50738615"
"chr3","7918008","7918271","chrX","49679050","49679290","68","41761042"
"chr3","8136398","8136694","chr2","58430083","58430370","30","50293685"
"chr3","8160910","8161228","chr2","58404666","58404983","22","50243756"
"chr3","8227830","8228132","chr2","58340418","58340722","20","50112588"
"chr3","8427842","8427965","chr15","110025773","110025895","21","101597931"
"chr3","8605721","8606010","chr2","57964467","57964767","42","49358746"
"chr3","8611302","8611662","chr1","39515746","39516064","105","30904444"
"chr3","8718996","8719252","chr2","57837563","57837821","25","49118567"
"chr3","8755121","8755404","chr2","57801867","57802153","38","49046746"
"chr3","8800603","8800755","chr2","57758484","57758635","12","48957881"
"chr3","8909870","8910170","chr14","51828477","51828775","66","42918607"
"chr3","8984060","8984344","chr2","57623725","57624010","23","48639665"
"chr3","9026492","9026773","chr2","57582682","57582960","28","48556190"
"chr3","9034217","9034500","chr2","57574862","57575160","37","48540645"
"chr3","9045133","9045344","chr2","57563406","57563619","21","48518273"
"chr3","9045466","9045721","chr7","19580653","19580903","50","10535187"
"chr3","9090229","9090518","chr2","57517560","57517862","26","48427331"
"chr3","9117873","9118161","chr2","57486853","57487144","32","48368980"
"chr3","9158133","9158429","chr2","57453575","57453878","24","48295442"
"chr3","9170338","9170506","chr10","65990511","65990675","33","56820173"
"chr3","9170550","9170669","chr5","97470523","97470642","20","88299973"
"chr3","9172070","9172356","chr2","57437105","57437396","24","48265035"
"chr3","9195999","9196299","chr2","57413226","57413534","28","48217227"
"chr3","9238688","9238868","chrX","48663996","48664170","32","39425308"
"chr3","9246628","9246939","chr2","57366804","57367115","21","48120176"
"chr3","9258389","9258705","chr2","57354874","57355178","40","48096485"
"chr3","9292618","9292910","chr2","57319845","57320135","22","48027227"
"chr3","9293653","9293956","chr2","57318848","57319159","18","48025195"
"chr3","9294840","9295121","chr2","57317321","57317620","39","48022481"
"chr3","9306161","9306455","chr2","57306192","57306486","13","48000031"
"chr3","9315665","9315997","chr2","57296589","57296876","67","47980924"
"chr3","9324836","9325126","chr2","57286962","57287256","34","47962126"
"chr3","9325190","9325226","chr2","57286868","57286905","2","47961678"
"chr3","9325530","9325661","chr19","53061090","53061231","35","43735560"
"chr3","9379210","9379526","chr2","46260060","46260367","53","36880850"
"chr3","9408213","9408531","chr2","57200150","57200469","23","47791937"
"chr3","9415524","9415657","chr2","57193074","57193208","13","47777550"
"chr3","9417787","9418059","chr2","57190669","57190953","25","47772882"
"chr3","9450731","9451036","chr10","32154454","32154755","58","22703723"
"chr3","9472053","9472175","chr2","57131869","57131991","8","47659816"
"chr3","9481937","9482224","chr7","140537573","140537855","64","131055636"
"chr3","9482470","9482587","chr4","13998167","13998284","13","4515697"
"chr3","9532591","9532863","chr9","22680458","22680739","61","13147867"
"chr3","9541106","9541297","chr2","57063328","57063511","17","47522222"
"chr3","9554742","9555033","chr2","57049975","57050252","31","47495233"
"chr3","9567725","9568017","chr2","57036592","57036885","27","47468867"
"chr3","9577266","9577567","chr2","57027108","57027408","23","47449842"
"chr3","9584111","9584403","chr2","57019934","57020226","55","47435823"
"chr3","9607468","9607582","chr2","56995979","56996093","7","47388511"
"chr3","9610148","9610424","chr2","56993159","56993438","20","47383011"
"chr3","9621620","9621896","chr4","132392979","132393253","56","122771359"
"chr3","9635643","9635926","chr2","56965085","56965386","42","47329442"
"chr3","9646213","9646488","chr2","56954305","56954580","18","47308092"
"chr3","9652520","9652787","chr2","56947517","56947797","26","47294997"
"chr3","9660900","9661189","chr2","56939724","56940013","16","47278824"
"chr3","9682403","9682481","chr6","141271553","141271631","30","131589150"
"chr3","9682778","9682827","chr5","73307081","73307136","10","63624303"
"chr3","9689892","9690027","chr1","25668128","25668263","20","15978236"
"chr3","9690315","9690480","chr2","56908539","56908700","7","47218224"
"chr3","9698243","9698509","chr2","56900301","56900575","13","47202058"
"chr3","9707140","9707414","chr3","37042470","37042744","55","27335330"
"chr3","9710612","9710805","chr2","56887543","56887741","17","47176931"
"chr3","9712654","9712903","chr2","56885108","56885357","24","47172454"
"chr3","9725932","9726165","chr2","56871650","56871926","45","47145718"
"chr3","9734133","9734437","chr2","139523227","139523524","68","129789094"
"chr3","9736352","9736651","chr13","71248269","71248571","51","61511917"
"chr3","9738432","9738557","chr2","56858486","56858610","10","47120054"
"chr3","9740027","9740323","chr2","56856428","56856739","36","47116401"
"chr3","9742937","9743061","chr2","56853680","56853804","6","47110743"
"chr3","9755942","9756282","chr2","56840437","56840746","72","47084495"
"chr3","9757901","9758052","chr2","107600091","107600240","31","97842190"
"chr3","9766807","9767099","chr2","56830368","56830679","33","47063561"
"chr3","9786411","9786520","chr2","56810897","56810988","22","47024486"
"chr3","9786749","9786882","chr2","56810535","56810667","8","47023786"
"chr3","9796394","9796542","chr18","48189873","48190014","34","38393479"
"chr3","9800063","9800364","chr10","37707166","37707474","59","27907103"
"chr3","9801681","9801969","chr7","41578296","41578589","57","31776615"
"chr3","9806043","9806339","chr2","56803979","56804276","25","46997936"
"chr3","9813761","9814036","chr2","56795232","56795514","21","46981471"
"chr3","9816432","9816462","chr13","19012667","19012707","13","9196235"
"chr3","9816950","9817141","chr1","182889564","182889753","41","173072614"
"chr3","9819400","9819687","chr2","56788248","56788536","18","46968848"
"chr3","9819831","9819913","chr2","56788021","56788102","9","46968190"
"chr3","9835095","9835375","chr1","25629235","25629522","52","15794140"
"chr3","9841471","9841786","chr2","56763990","56764296","48","46922519"
"chr3","9846469","9846753","chr2","56758426","56758704","23","46911957"
"chr3","9861141","9861263","chr2","56741940","56742063","15","46880799"
"chr3","9897302","9897465","chr7","80140173","80140333","40","70242871"
"chr3","9897597","9897909","chr8","28623574","28623869","72","18725977"
"chr3","9900892","9901205","chr2","56699963","56700259","34","46799071"
"chr3","9913370","9913670","chr2","56685800","56686094","33","46772430"
"chr3","9914407","9914700","chr2","56684780","56685073","14","46770373"
"chr3","9919247","9919380","chr9","61444064","61444194","23","51524817"
"chr3","9960607","9960901","chr2","56803979","56804276","50","46843372"
"chr3","9971435","9971735","chr2","56624066","56624370","26","46652631"
"chr3","10002643","10002941","chr2","56590575","56590873","17","46587932"
"chr3","10012428","10012707","chr2","56578185","56578473","26","46565757"
"chr3","10014744","10015013","chr5","25258187","25258455","54","15243443"
"chr3","10024448","10024532","chr2","56565437","56565521","3","46540989"
"chr3","10024549","10024673","chr3","154492120","154492234","24","144467571"
"chr3","10052156","10052383","chr2","56502366","56502607","41","46450210"
"chr3","10056460","10056741","chr2","56500934","56501215","22","46444474"
"chr3","10180283","10180594","chr10","73016951","73017260","56","62836668"
"chr3","10180719","10181001","chr2","56487045","56487341","26","46306326"
"chr3","10192582","10192842","chr2","56471652","56471920","20","46279070"
"chr3","10200012","10200137","chr1","211231687","211231814","24","201031675"
"chr3","10232067","10232348","chr2","56431354","56431641","29","46199287"
"chr3","10241491","10241669","chr3","127962642","127962820","39","117721151"
"chr3","10247392","10247705","chr2","56415866","56416181","21","46168474"
"chr3","10258736","10259021","chr2","56403935","56404209","32","46145199"
"chr3","10260775","10260914","chr3","38715975","38716112","38","28455200"
"chr3","10274485","10274820","chr2","56386837","56387173","27","46112352"
"chr3","10283750","10283930","chr2","56365663","56365851","37","46081913"
"chr3","10303529","10303800","chr2","56323178","56323449","20","46019649"
"chr3","10306279","10306475","chr1","64648819","64648991","62","54342540"
"chr3","10306608","10306765","chr4","108470584","108470722","43","98163976"
"chr3","10308855","10309193","chr2","56386837","56387173","23","46077982"
"chr3","10313036","10313328","chr2","56305343","56305633","23","45992307"
"chr3","10316098","10316417","chr2","56377858","56378163","66","46061760"
"chr3","10387844","10388120","chr2","56236201","56236463","32","45848357"
"chr3","10401408","10401707","chr1","223979328","223979622","51","213577920"
"chr3","10410656","10410962","chr2","56206889","56207205","28","45796233"
"chr3","10412935","10413006","chr3","165647672","165647748","19","155234737"
"chr3","10418350","10418637","chr14","3349151","3349435","59","7069199"
"chr3","10420373","10420655","chr2","56196627","56196917","29","45776254"
"chr3","10433002","10433237","chr20","50658039","50658265","62","40225037"
"chr3","10436306","10436590","chr15","48983543","48983830","56","38547237"
"chr3","10439963","10440254","chr2","56176400","56176689","21","45736437"
"chr3","10446389","10446511","chr10","6875889","6876012","20","3570500"
"chr3","10460018","10460105","chr2","56157022","56157109","7","45697004"
"chr3","10464713","10464880","chr10","65990511","65990675","30","55525798"
"chr3","10465197","10465330","chr4","35427704","35427836","23","24962507"
"chr3","10466897","10467155","chr2","56150588","56150852","37","45683691"
"chr3","10490691","10490990","chr2","56123644","56123952","25","45632953"
"chr3","10502494","10502800","chr2","56111438","56111733","34","45608944"
"chr3","10509719","10509952","chr2","56103348","56103608","52","45593629"
"chr3","10521187","10521442","chr15","14063857","14064106","56","3542670"
"chr3","10581566","10581835","chr2","56019090","56019361","15","45437524"
"chr3","10594756","10595074","chr1","130626479","130626806","69","120031723"
"chr3","10636667","10636975","chr2","55964466","55964774","23","45327799"
"chr3","10670356","10670623","chr2","55930126","55930398","24","45259770"
"chr3","10727889","10727976","chr2","55868506","55868588","12","45140617"
"chr3","10864029","10864336","chr11","111040176","111040474","56","100176147"
"chr3","10893261","10893349","chr2","55703584","55703672","9","44810323"
"chr3","10893652","10893848","chr1","166832267","166832464","45","155938615"
"chr3","10895939","10896101","chr2","55700768","55700930","4","44804829"
"chr3","10910699","10910996","chr9","34485620","34485907","63","23574921"
"chr3","10936668","10936788","chr2","55660074","55660194","15","44723406"
"chr3","10961237","10961554","chr1","8981776","8982081","60","1979461"
"chr3","11023312","11023610","chr2","55579214","55579520","24","44555902"
"chr3","11146097","11146407","chr2","55448136","55448436","22","44302039"
"chr3","11246047","11246337","chr2","55347847","55348149","30","44101800"
"chr3","11264313","11264615","chr2","55328896","55329206","39","44064583"
"chr3","11325994","11326292","chr2","55267943","55268241","24","43941949"
"chr3","11335959","11336267","chr2","55258126","55258416","40","43922167"
"chr3","11389693","11389900","chr6","35387752","35387949","55","23998059"
"chr3","11392098","11392397","chr2","55206714","55207007","25","43814616"
"chr3","11407139","11407421","chr2","55190419","55190697","29","43783280"
"chr3","11462734","11463026","chr2","55134463","55134753","24","43671729"
"chr3","11473188","11473320","chr1","51206856","51206978","21","39733668"
"chr3","11473646","11473760","chr4","14099244","14099352","35","2625598"
"chr3","11492113","11492407","chr2","55103287","55103558","41","43611174"
"chr3","11551979","11552267","chr2","55049181","55049491","32","43497202"
"chr3","11568431","11568564","chr2","55033258","55033380","20","43464827"
"chr3","11590962","11591244","chr6","176458169","176458462","54","164867207"
"chr3","11603875","11604162","chr2","55001834","55002125","24","43397959"
"chr3","11638470","11638767","chr1","32090539","32090837","53","20452069"
"chr3","11677017","11677303","chr2","54929899","54930190","40","43252882"
"chr3","11683478","11683528","chr7","52416361","52416411","12","40732883"
"chr3","11687182","11687432","chr2","54919353","54919599","32","43232171"
"chr3","11689737","11689782","chr18","43239104","43239150","9","31549367"
"chr3","11705781","11706066","chr2","54900390","54900678","25","43194609"
"chr3","11713820","11714107","chr2","54892051","54892323","37","43178231"
"chr3","11722445","11722577","chr2","54883466","54883598","14","43161021"
"chr3","11723096","11723406","chr2","54882644","54882945","39","43159548"
"chr3","11745631","11745933","chr2","54859870","54860171","33","43114239"
"chr3","11754469","11754769","chr2","54849679","54849985","27","43095210"
"chr3","11760422","11760750","chr2","54843703","54844025","42","43083281"
"chr3","11779331","11779624","chr2","54830568","54830861","17","43051237"
"chr3","11819005","11819221","chr2","54794430","54794649","15","42975425"
"chr3","11830185","11830314","chr13","70830779","70830910","18","59000594"
"chr3","11877581","11877871","chr2","54733017","54733311","12","42855436"
"chr3","11928795","11929074","chr2","54682020","54682302","23","42753225"
"chr3","11948765","11949041","chr2","54662728","54663013","21","42713963"
"chr3","11963309","11963606","chr6","176458169","176458462","53","164494860"
"chr3","11975605","11975906","chr2","54634834","54635140","23","42659229"
"chr3","11996291","11996405","chr15","35525468","35525582","19","23529177"
"chr3","12021451","12021750","chr2","54591833","54592148","36","42570382"
"chr3","12033103","12033402","chr9","128228335","128228636","65","116195232"
"chr3","12044516","12044824","chr2","54570444","54570751","27","42525928"
"chr3","12044926","12045225","chr2","54570047","54570342","26","42525121"
"chr3","12046488","12046785","chr2","54569060","54569354","17","42522572"
"chr3","12051758","12051875","chr2","54564130","54564246","8","42512372"
"chr3","12056596","12056850","chr2","54558898","54559155","16","42502302"
"chr3","12064249","12064488","chr2","54550350","54550589","13","42486101"
"chr3","12071769","12072058","chr2","54542604","54542904","40","42470835"
"chr3","12078508","12078740","chr2","54535663","54535895","17","42457155"
"chr3","12086289","12086584","chr2","54525420","54525720","26","42439131"
"chr3","12091226","12091382","chr11","104192249","104192390","34","92101023"
"chr3","12091548","12091575","chr1","142183286","142183313","9","130091738"
"chr3","12091613","12091772","chr2","92025512","92025675","37","79933899"
"chr3","12094073","12094380","chr2","71005973","71006275","62","58911900"
"chr3","12103726","12104033","chr2","54511910","54512214","52","42408184"
"chr3","12131757","12132057","chr11","117366311","117366614","58","105234554"
"chr3","12145935","12146116","chr2","56365663","56365851","31","44219728"
"chr3","12146404","12146539","chr2","56365259","56365397","15","44218855"
"chr3","12202378","12202671","chr2","54477146","54477449","32","42274768"
"chr3","12205880","12206086","chr2","54473730","54473930","25","42267850"
"chr3","12216405","12216668","chr2","54463637","54463904","25","42247232"
"chr3","12217084","12217398","chr6","130557095","130557398","67","118340011"
"chr3","12240020","12240319","chr2","54440651","54440946","32","42200631"
"chr3","12243996","12244305","chr2","54436420","54436721","36","42192424"
"chr3","12263054","12263345","chr2","54416985","54417273","32","42153931"
"chr3","12263550","12263852","chr2","54416478","54416779","18","42152928"
"chr3","12290901","12291023","chr1","18663072","18663194","20","6372171"
"chr3","12300473","12300597","chr5","14863431","14863555","17","2562958"
"chr3","12315318","12315631","chr1","32297153","32297469","71","19981835"
"chr3","12341765","12342066","chr2","54349436","54349708","53","42007671"
"chr3","12473503","12473637","chr8","71179092","71179225","22","58705589"
"chr3","12506526","12506832","chr2","54176449","54176727","47","41669923"
"chr3","12513700","12513993","chrX","108129050","108129338","71","95615350"
"chr3","12547795","12548089","chr2","54134663","54134930","49","41586868"
"chr3","12556696","12556918","chr2","54125294","54125509","18","41568598"
"chr3","12589127","12589394","chr2","54092309","54092576","6","41503182"
"chr3","12591749","12592060","chr2","54089628","54089942","27","41497879"
"chr3","12630983","12631110","chr2","54051031","54051159","13","41420048"
"chr3","12633765","12634036","chr2","54044882","54045153","15","41411117"
"chr3","12638371","12638671","chr2","54040199","54040495","24","41401828"
"chr3","12653451","12653734","chr3","123351694","123351976","52","110698243"
"chr3","12670452","12670727","chr2","54007384","54007654","17","41336932"
"chr3","12674091","12674406","chr2","54003343","54003688","50","41329252"
"chr3","12702368","12702651","chr2","53974687","53974979","18","41272319"
"chr3","12719017","12719297","chr2","53957016","53957312","28","41237999"
"chr3","12729508","12729793","chr7","137856198","137856481","47","125126690"
"chr3","12747918","12748134","chr2","53927258","53927472","18","41179340"
"chr3","12748244","12748414","chr2","53926973","53927142","14","41178729"
"chr3","12773826","12774059","chr6","17533014","17533248","49","4759188"
"chr3","12774265","12774533","chr2","53901217","53901481","15","41126952"
"chr3","12778378","12778555","chr2","53896876","53897053","15","41118498"
"chr3","12804657","12804928","chr2","53868315","53868575","25","41063658"
"chr3","12817041","12817322","chr2","53854557","53854833","16","41037516"
"chr3","12837122","12837322","chr6","4944357","4944557","47","7892765"
"chr3","12864698","12864973","chr2","53805727","53805976","39","40941029"
"chr3","12879208","12879332","chr2","53791485","53791609","10","40912277"
"chr3","12880749","12881057","chr2","53789770","53790047","58","40909021"
"chr3","12899188","12899490","chr2","53770665","53770958","29","40871477"
"chr3","12902626","12902914","chr1","126177412","126177687","67","113274786"
"chr3","12914948","12915087","chr2","53754000","53754138","16","40839052"
"chr3","12922668","12922982","chr13","45006370","45006675","60","32083702"
"chr3","12937998","12938246","chr2","53726521","53726763","16","40788523"
"chr3","12947567","12947699","chr2","53715763","53715895","5","40768196"
"chr3","12975413","12975721","chr17","62261517","62261800","39","49286104"
"chr3","12985198","12985478","chr17","62272496","62272780","31","49287298"
"chr3","12986279","12986578","chr17","62273524","62273819","20","49287245"
"chr3","12991444","12991656","chr17","62278698","62278907","19","49287254"
"chr3","13002248","13002566","chr2","53685852","53686186","26","40683604"
"chr3","13005231","13005538","chr14","104459582","104459884","59","91454351"
"chr3","13008173","13008344","chr1","21942508","21942674","36","8934335"
"chr3","13021044","13021200","chr2","53664609","53664755","16","40643565"
"chr3","13029230","13029519","chr2","53651138","53651424","21","40621908"
"chr3","13039205","13039403","chr2","53641514","53641718","19","40602309"
"chr3","13075526","13075790","chr2","53604235","53604506","22","40528709"
"chr3","13105387","13105563","chr2","53572125","53572279","37","40466738"
"chr3","13109853","13110146","chr2","53567488","53567785","20","40457635"
"chr3","13111114","13111368","chr2","53561547","53561804","14","40450433"
"chr3","13148677","13148960","chr2","53527042","53527317","33","40378365"
"chr3","13153932","13154077","chr2","107600091","107600240","30","94446159"
"chr3","13186364","13186674","chr2","53489236","53489525","40","40302872"
"chr3","13245051","13245358","chr2","53429175","53429471","28","40184124"
"chr3","13288500","13288679","chr2","53384035","53384215","8","40095535"
"chr3","13327166","13327453","chr2","53343655","53343950","23","40016489"
"chr3","13344732","13344902","chr16","57935016","57935195","50","44590284"
"chr3","13348961","13349265","chr11","78321185","78321482","59","64972224"
"chr3","13357007","13357294","chr1","160420782","160421068","52","147063775"
"chr3","13404453","13404742","chr2","53270357","53270644","18","39865904"
"chr3","13405262","13405451","chr2","53269651","53269834","17","39864389"
"chr3","13410443","13410516","chr5","77676188","77676261","9","64265745"
"chr3","13466023","13466332","chr3","43051094","43051395","60","29585071"
"chr3","13504001","13504298","chr2","53161770","53162038","43","39657769"
"chr3","13522266","13522598","chr2","53143130","53143412","69","39620864"
"chr3","13555745","13556044","chr2","53110302","53110603","27","39554557"
"chr3","13675159","13675460","chr1","217464319","217464608","65","203789160"
"chr3","13690698","13691004","chr2","52973999","52974301","40","39283301"
"chr3","13714813","13714902","chr2","52950997","52951083","11","39236184"
"chr3","13722760","13723050","chr2","52942743","52943034","26","39219983"
"chr3","13726170","13726473","chr2","52939007","52939308","26","39212837"
"chr3","13746754","13747038","chr2","52918853","52919123","32","39172099"
"chr3","13815204","13815440","chr7","141105501","141105748","50","127290297"
"chr3","13828848","13828963","chr1","207476913","207477027","19","193648065"
"chr3","13831061","13831348","chr2","52828096","52828388","19","38997035"
"chr3","13853366","13853497","chr15","31336991","31337124","18","17483625"
"chr3","13859277","13859581","chr2","52798756","52799036","43","38939479"
"chr3","13864130","13864401","chr2","52793924","52794202","20","38929794"
"chr3","14017984","14018213","chr2","52643052","52643281","18","38625068"
"chr3","14127271","14127563","chr2","52534697","52534957","47","38407426"
"chr3","14240828","14240953","chr2","52425086","52425211","8","38184258"
"chr3","14295883","14296049","chr2","52397000","52397141","30","38101117"
"chr3","14320577","14320883","chr2","52370441","52370764","42","38049864"
"chr3","14323268","14323573","chr9","95575173","95575462","67","81251905"
"chr3","14368695","14368982","chr2","52335334","52335641","42","37966639"
"chr3","14389156","14389279","chr2","52314502","52314625","7","37925346"
"chr3","14440753","14440899","chr2","52262689","52262827","16","37821936"
"chr3","14466056","14466363","chr2","52236895","52237185","32","37770839"
"chr3","14473606","14473770","chr10","88808526","88808682","36","74334920"
"chr3","14473806","14473932","chr15","27774200","27774326","18","13300394"
"chr3","14501680","14501972","chr2","52202313","52202603","34","37700633"
"chr3","14517012","14517327","chr2","52144050","52144356","34","37627038"
"chr3","14525853","14526142","chr2","52135312","52135596","24","37609459"
"chr3","14530516","14530808","chr2","56803979","56804276","51","42273463"
"chr3","14560096","14560385","chr2","52100396","52100689","23","37540300"
"chr3","14564886","14565199","chr2","52096186","52096499","23","37531300"
"chr3","14575681","14575942","chr2","52085779","52086055","42","37510098"
"chr3","14585621","14585868","chr2","52075892","52076140","21","37490271"
"chr3","14587820","14588117","chr15","43687639","43687935","44","29099819"
"chr3","14589650","14589964","chr2","52072420","52072733","33","37482770"
"chr3","14602866","14603157","chr2","52059074","52059349","40","37456208"
"chr3","14615057","14615072","chr2","40760508","40760520","3","26145451"
"chr3","14615100","14615390","chr2","52046834","52047142","35","37431734"
"chr3","14676591","14676890","chr2","51986958","51987255","19","37310367"
"chr3","14679124","14679250","chr20","3524907","3525040","19","11154217"
"chr3","14699202","14699497","chr2","51964298","51964604","26","37265096"
"chr3","14746665","14746906","chr2","51917120","51917342","29","37170455"
"chr3","14761162","14761449","chr7","132933609","132933905","59","118172447"
"chr3","14805012","14805250","chr2","51857360","51857599","25","37052348"
"chr3","14822836","14823150","chr2","51837403","51837716","29","37014567"
"chr3","14857519","14857798","chr2","51801656","51801936","17","36944137"
"chr3","14857799","14857927","chr10","8237746","8237873","22","6620053"
"chr3","14976725","14977031","chr2","51679069","51679390","25","36702344"
"chr3","15016635","15016949","chr2","51636973","51637269","30","36620338"
"chr3","15052445","15052681","chr2","51607424","51607654","17","36554979"
"chr3","15135504","15135773","chr2","51524786","51525054","13","36389282"
"chr3","15141293","15141615","chr12","65551151","65551448","65","50409858"
"chr3","15149136","15149441","chr2","51510683","51510992","42","36361547"
"chr3","15154599","15154906","chr2","51506452","51506741","40","36351853"
"chr3","15155740","15155994","chr2","51505349","51505593","30","36349609"
"chr3","15166122","15166239","chr19","49289171","49289285","21","34123049"
"chr3","15188499","15188618","chr1","205464254","205464380","21","190275755"
"chr3","15188921","15189086","chrX","19264862","19265025","35","4075941"
"chr3","15189374","15189506","chr2","51471638","51471770","12","36282264"
"chr3","15196632","15196916","chr8","53907597","53907887","57","38710965"
"chr3","15227289","15227473","chr2","51432215","51432395","22","36204926"
"chr3","15245628","15245839","chr2","51414360","51414573","13","36168732"
"chr3","15250619","15250925","chr2","51409256","51409558","28","36158637"
"chr3","15255275","15255594","chr2","51403699","51404009","39","36148424"
"chr3","15258387","15258626","chr5","108923837","108924054","60","93665450"
"chr3","15265040","15265305","chrX","52930864","52931128","70","37665824"
"chr3","15268298","15268427","chr1","155846166","155846296","13","140577868"
"chr3","15269182","15269476","chr7","138266796","138267091","49","122997614"
"chr3","15299757","15299977","chr2","51360812","51361031","19","36061055"
"chr3","15300510","15300637","chr2","51360174","51360296","14","36059664"
"chr3","15349289","15349516","chr2","51313862","51314088","13","35964573"
"chr3","15355246","15355463","chr3","66577928","66578124","49","51222682"
"chr3","15356599","15356871","chr2","51306481","51306753","13","35949882"
"chr3","15360100","15360378","chr2","51302959","51303234","19","35942859"
"chr3","15380981","15381287","chr2","51279856","51280160","32","35898875"
"chr3","15382556","15382850","chr2","51277969","51278269","42","35895413"
"chr3","15404407","15404557","chr20","5281043","5281175","29","10123364"
"chr3","15425241","15425545","chr2","171769590","171769881","32","156344349"
"chr3","15432838","15433113","chr6","140195314","140195584","56","124762476"
"chr3","15448642","15448909","chr2","171793642","171793922","33","156345000"
"chr3","15472644","15472898","chr2","171844437","171844699","36","156371793"
"chr3","15498490","15498795","chr2","171870212","171870502","37","156371722"
"chr3","15500303","15500589","chr2","171872322","171872617","46","156372019"
"chr3","15512701","15512994","chr15","43687639","43687935","56","28174938"
"chr3","15560335","15560618","chr2","171931322","171931596","27","156370987"
"chr3","15561849","15562060","chr2","171932844","171933061","22","156370995"
"chr3","15590793","15591049","chr2","171964358","171964614","11","156373565"
"chr3","15597675","15597796","chr2","171970982","171971103","8","156373307"
"chr3","15598079","15598264","chr2","171971396","171971602","26","156373317"
"chr3","15600316","15600607","chr2","171973646","171973962","55","156373330"
"chr3","15600728","15601017","chr2","171974083","171974394","46","156373355"
"chr3","15616896","15617197","chr2","171990255","171990557","20","156373359"
"chr3","15622057","15622384","chr19","8237701","8238014","85","7384356"
"chr3","15625492","15625798","chr3","43294391","43294694","57","27668899"
"chr3","15628887","15628973","chr3","63877396","63877478","22","48248509"
"chr3","15629105","15629290","chr15","12062173","12062349","39","3566932"
"chr3","15642020","15642096","chr8","39297539","39297614","12","23655519"
"chr3","15642385","15642592","chr2","172015094","172015314","32","156372709"
"chr3","15646710","15646966","chr2","172019493","172019751","17","156372783"
"chr3","15652292","15652568","chr2","172025171","172025487","54","156372879"
"chr3","15671301","15671528","chr2","172037700","172037926","29","156366399"
"chr3","15677449","15677666","chr2","172043946","172044162","14","156366497"
"chr3","15678980","15679282","chr2","172045459","172045758","28","156366479"
"chr3","15681691","15681897","chr18","4097099","4097299","51","11584592"
"chr3","15684192","15684356","chr2","172051779","172051960","27","156367587"
"chr3","15684657","15684704","chr2","172052264","172052316","7","156367607"
"chr3","15686313","15686628","chr2","172053942","172054223","55","156367629"
"chr3","15700007","15700266","chr11","576346","576611","59","15123661"
"chr3","15708765","15708877","chr2","56180549","56180661","25","40471784"
"chr3","15717144","15717458","chr2","172086885","172087169","43","156369741"
"chr3","15735365","15735583","chr16","73992318","73992542","45","58256953"
"chr3","15820209","15820460","chr2","172188998","172189258","39","156368789"
"chr3","15821802","15822097","chr16","30244701","30244998","60","14422899"
"chr3","15834197","15834471","chr2","172203000","172203269","24","156368803"
"chr3","15837207","15837476","chr2","172205983","172206266","34","156368776"
"chr3","15876228","15876519","chr2","172244806","172245105","29","156368578"
"chr3","15880044","15880352","chr15","15103527","15103833","68","776517"
"chr3","15888603","15888908","chr2","172258235","172258529","30","156369632"
"chr3","15933884","15934176","chr2","172304675","172304978","28","156370791"
"chr3","15940729","15941000","chr2","172311745","172312022","18","156371016"
"chr3","15952272","15952576","chr2","172323698","172323999","14","156371426"
"chr3","15953881","15954185","chr2","172325291","172325597","23","156371410"
"chr3","15985161","15985445","chr2","172356096","172356364","33","156370935"
"chr3","16026357","16026575","chr11","123522499","123522711","60","107496142"
"chr3","16028245","16028491","chr2","172398914","172399164","17","156370669"
"chr3","16075227","16075513","chr2","172446247","172446520","54","156371020"
"chr3","16078872","16079173","chr2","172449914","172450224","31","156371042"
"chr3","16088045","16088323","chr2","172459196","172459481","26","156371151"
"chr3","16128169","16128478","chr2","172496830","172497130","21","156368661"
"chr3","16138222","16138269","chr6","174934448","174934498","7","158796226"
"chr3","16158820","16159118","chr2","172527764","172528060","25","156368944"
"chr3","16163956","16164258","chr2","172532685","172532993","19","156368729"
"chr3","16178052","16178185","chr2","172541359","172541485","13","156363307"
"chr3","16178485","16178658","chr2","172541779","172541952","12","156363294"
"chr3","16218090","16218362","chr2","172582468","172582739","17","156364378"
"chr3","16255582","16255856","chrX","62888507","62888783","53","46632925"
"chr3","16312806","16313089","chr2","172673363","172673643","32","156360557"
"chr3","16385951","16386245","chrY","6695113","6695409","49","9690838"
"chr3","16418261","16418382","chr2","172784322","172784442","4","156366061"
"chr3","16520583","16520846","chr2","172904782","172905045","21","156384199"
"chr3","16535452","16535762","chr2","172920990","172921287","29","156385538"
"chr3","16575315","16575600","chr2","172962678","172962977","29","156387363"
"chr3","16605174","16605463","chr2","172992235","172992524","20","156387061"
"chr3","16622506","16622781","chr19","25476896","25477182","60","8854390"
"chr3","16656372","16656688","chr7","40431950","40432255","63","23775578"
"chr3","16657730","16657982","chr2","173045671","173045929","21","156387941"
"chr3","16668993","16669308","chr7","40545236","40545532","65","23876243"
"chr3","16678873","16679165","chr2","173066016","173066283","40","156387143"
"chr3","16691991","16692301","chr3","161503080","161503385","65","144811089"
"chr3","16694443","16694571","chr2","173081956","173082072","16","156387513"
"chr3","16699749","16700033","chr2","173087322","173087596","25","156387573"
"chr3","16724163","16724328","chrY","10836463","10836639","28","5887700"
"chr3","16765667","16765834","chr12","52744864","52745024","42","35979197"
"chr3","16794162","16794475","chrY","10762126","10762423","48","6032036"
"chr3","16806408","16806718","chr2","173194050","173194335","42","156387642"
"chr3","16879439","16879649","chr2","173273569","173273777","11","156394130"
"chr3","16881996","16882106","chr2","173276121","173276232","8","156394125"
"chr3","16988618","16988913","chr2","173379146","173379454","38","156390528"
"chr3","17008985","17009191","chr2","173394366","173394597","41","156385381"
"chr3","17139722","17140024","chr2","173524461","173524773","40","156384739"
"chr3","17183820","17184112","chr2","173569227","173569512","19","156385407"
"chr3","17218294","17218595","chr2","173601121","173601407","31","156382827"
"chr3","17272161","17272333","chr2","173651763","173651935","8","156379602"
"chr3","17272630","17272763","chr2","173652232","173652366","10","156379602"
"chr3","17293445","17293569","chr2","173672838","173672963","8","156379393"
"chr3","17337173","17337436","chr2","173720154","173720419","20","156382981"
"chr3","17376669","17376792","chr9","28783871","28783993","34","11407202"
"chr3","17383554","17383828","chr2","84155954","84156223","67","66772400"
"chr3","17408573","17408853","chr12","96956675","96956961","53","79548102"
"chr3","17437834","17438119","chr2","173821492","173821780","22","156383658"
"chr3","17443716","17444034","chr2","173827341","173827670","44","156383625"
"chr3","17457062","17457348","chr2","173840618","173840896","44","156383556"
"chr3","17466605","17466830","chr2","173850228","173850461","24","156383623"
"chr3","17468841","17469127","chr2","173852474","173852761","31","156383633"
"chr3","17485136","17485445","chr2","173873105","173873430","29","156387969"
"chr3","17522565","17522820","chr2","173910155","173910411","17","156387590"
"chr3","17534878","17535157","chr2","173924328","173924599","18","156389450"
"chr3","17553863","17554082","chr2","173943211","173943420","27","156389348"
"chr3","17580649","17580918","chr2","173969132","173969397","11","156388483"
"chr3","17587515","17587814","chr2","173976077","173976390","34","156388562"
"chr3","17607248","17607524","chr9","29060080","29060341","66","11452832"
"chr3","17623066","17623191","chr2","105956206","105956326","28","88333140"
"chr3","17667665","17667953","chr2","174060877","174061163","20","156393212"
"chr3","17679010","17679332","chr12","120705770","120706089","77","103026760"
"chr3","17707376","17707465","chr13","28430056","28430142","27","10722680"
"chr3","17721602","17721895","chr4","35692118","35692417","53","17970516"
"chr3","17785688","17785938","chr6","175123572","175123817","60","157337884"
"chr3","17801908","17802023","chr1","139618381","139618504","24","121816473"
"chr3","17802864","17803176","chr2","174187559","174187858","37","156384695"
"chr3","17819846","17820141","chr2","174204527","174204819","44","156384681"
"chr3","17834550","17834841","chr2","174219110","174219386","36","156384560"
"chr3","17848679","17848748","chr2","174232682","174232751","3","156384003"
"chr3","17865590","17865886","chr2","174243398","174243692","32","156377808"
"chr3","17921215","17921507","chr2","174290599","174290890","13","156369384"
"chr3","17972048","17972336","chr2","174336417","174336709","29","156364369"
"chr3","17977035","17977313","chr2","174342791","174343069","21","156365756"
"chr3","17991420","17991737","chr2","174356982","174357295","24","156365562"
"chr3","18090831","18091061","chr2","174457655","174457885","15","156366824"
"chr3","18091859","18092158","chr2","174458675","174458974","12","156366816"
"chr3","18137097","18137386","chr2","174504096","174504380","28","156366999"
"chr3","18208838","18209042","chr16","2367209","2367407","38","15841629"
"chr3","18214082","18214404","chr2","174590396","174590696","39","156376314"
"chr3","18542830","18543149","chr2","174921407","174921705","43","156378577"
"chr3","18740879","18741108","chr2","175114111","175114339","12","156373232"
"chr3","18797510","18797594","chr2","175176935","175177019","5","156379425"
"chr3","18965884","18966077","chr2","175351470","175351659","29","156385586"
"chr3","19021581","19021705","chr10","27663251","27663372","20","8641670"
"chr3","19042965","19043010","chr3","143631352","143631393","11","124588387"
"chr3","19043046","19043219","chr6","68146972","68147145","42","49103926"
"chr3","19064620","19064928","chr2","175451450","175451754","24","156386830"
"chr3","19084742","19085042","chr2","175474734","175475028","21","156389992"
"chr3","19279970","19280195","chr10","11063247","11063471","50","8216723"
"chr3","19384997","19385259","chr4","111395763","111396029","65","92010766"
"chr3","19522697","19522977","chr17","82854019","82854302","65","63331322"
"chr3","19528965","19529293","chr2","178665397","178665704","56","159136432"
"chr3","19540237","19540511","chr2","178657642","178657917","20","159117405"
"chr3","19634167","19634460","chr2","178561878","178562174","22","158927711"
"chr3","19711504","19711802","chr2","178484420","178484721","18","158772916"
"chr3","19972896","19973127","chr2","178269281","178269510","23","158296385"
"chr3","19994706","19994987","chr2","178237372","178237655","21","158242666"
"chr3","20003208","20003484","chr2","178228868","178229154","31","158225660"
"chr3","20044639","20044944","chr17","11251715","11252011","69","8792924"
"chr3","20048050","20048345","chr2","178188436","178188717","31","158140386"
"chr3","20052430","20052681","chr2","178185209","178185465","18","158132779"
"chr3","20063286","20063573","chr2","178178215","178178503","28","158114929"
"chr3","20083803","20084108","chr2","178159023","178159338","43","158075220"
"chr3","20100321","20100601","chr1","191690399","191690678","67","171590078"
"chr3","20133428","20133735","chr2","178119588","178119898","17","157986160"
"chr3","20136961","20137189","chr2","178116185","178116419","21","157979224"
"chr3","20141563","20141833","chr2","178111547","178111817","17","157969984"
"chr3","20150601","20150738","chr2","178103015","178103145","15","157952414"
"chr3","20164576","20164820","chr3","130909973","130910202","61","110745397"
"chr3","20165401","20165700","chr2","178084802","178085098","23","157919401"
"chr3","20167675","20167804","chr2","178082637","178082751","19","157914962"
"chr3","20181106","20181349","chr2","178067028","178067271","13","157885922"
"chr3","20186336","20186561","chr3","54419249","54419492","71","34232913"
"chr3","20186562","20186795","chr8","38412179","38412409","49","18225617"
"chr3","20201518","20201786","chr2","178046134","178046417","45","157844616"
"chr3","20209050","20209348","chr2","178038509","178038794","33","157829459"
"chr3","20212318","20212633","chr2","178035355","178035660","63","157823037"
"chr3","20213169","20213462","chr2","178034514","178034807","12","157821345"
"chr3","20216319","20216614","chr2","178031351","178031634","37","157815032"
"chr3","20231364","20231655","chr2","178017017","178017319","38","157785653"
"chr3","20239563","20239831","chr5","173660605","173660865","57","153421042"
"chr3","20255533","20255782","chr2","177993134","177993356","54","157737601"
"chr3","20258172","20258467","chr2","177990990","177991285","14","157732818"
"chr3","20262130","20262456","chr2","177987294","177987605","33","157725164"
"chr3","20269134","20269439","chr7","45639425","45639731","63","25370291"
"chr3","20274289","20274413","chr2","177974572","177974713","22","157700283"
"chr3","20274720","20274907","chr2","177974097","177974279","21","157699377"
"chr3","20282438","20282736","chr2","177965005","177965301","19","157682567"
"chr3","20309105","20309379","chr2","177937742","177938030","44","157628637"
"chr3","20336616","20336911","chr2","177908885","177909198","40","157572269"
"chr3","20349291","20349600","chr2","177896249","177896558","28","157546958"
"chr3","20351377","20351711","chr10","82671076","82671397","68","62319699"
"chr3","20355070","20355336","chr2","177890440","177890704","20","157535370"
"chr3","20377301","20377609","chr2","177868051","177868360","24","157490750"
"chr3","20394875","20395084","chr2","177850071","177850298","39","157455196"
"chr3","20406266","20406548","chr2","177832388","177832671","23","157426122"
"chr3","20418942","20419233","chr2","177819785","177820076","14","157400843"
"chr3","20420347","20420655","chr2","177818346","177818668","44","157397999"
"chr3","20429017","20429296","chr5","165714831","165715111","62","145285814"
"chr3","20583220","20583353","chr4","36960164","36960294","18","16376944"
"chr3","20595122","20595414","chr2","177657830","177658135","30","157062708"
"chr3","20726326","20726602","chr2","177538941","177539224","26","156812615"
"chr3","20911607","20911857","chr11","49318275","49318517","64","28406668"
"chr3","21018095","21018298","chr2","177173398","177173607","17","156155303"
"chr3","21392936","21393110","chr2","176813070","176813248","17","155420134"
"chr3","21479242","21479354","chr2","176729191","176729289","18","155249949"
"chr3","21651943","21652227","chr4","71200248","71200539","59","49548305"
"chr3","21682709","21682988","chr3","2457479","2457754","62","19225230"
"chr3","21737330","21737468","chr1","153250707","153250848","27","131513377"
"chr3","21767861","21768146","chr2","176438969","176439259","26","154671108"
"chr3","21831781","21832110","chr4","36484206","36484512","84","14652425"
"chr3","21836868","21837152","chr2","176364687","176364980","35","154527819"
"chr3","21842537","21842794","chr2","176352566","176352857","54","154510029"
"chr3","21965637","21965919","chr2","176231244","176231521","27","154265607"
"chr3","22225561","22225891","chr2","175948836","175949160","41","153723275"
"chr3","22333709","22334004","chr2","175834487","175834814","58","153500778"
"chr3","22358648","22358922","chr2","175811600","175811860","38","153452952"
"chr3","22486315","22486625","chr2","107404547","107404835","89","84918232"
"chr3","22986284","22986562","chr2","179480468","179480743","26","156494184"
"chr3","23137192","23137496","chr2","179656943","179657252","38","156519751"
"chr3","23201665","23201961","chr18","12871350","12871641","57","10330315"
"chr3","23210317","23210628","chr2","179740385","179740687","34","156530068"
"chr3","23321093","23321372","chrX","30235373","30235651","49","6914280"
"chr3","23370526","23370717","chr2","179895041","179895231","24","156524515"
"chr3","23401294","23401569","chr2","179918042","179918317","39","156516748"
"chr3","23402709","23403008","chr2","179919032","179919326","34","156516323"
"chr3","23448865","23449151","chr2","179966843","179967143","26","156517978"
"chr3","23451723","23452017","chr2","179970023","179970322","18","156518300"
"chr3","23479404","23479705","chr2","179997760","179998084","46","156518356"
"chr3","23483551","23483702","chr3","79769611","79769747","39","56286060"
"chr3","23484012","23484153","chr10","27265282","27265432","30","3781270"
"chr3","23499739","23500000","chr2","180017029","180017317","46","156517290"
"chr3","23518891","23519177","chr2","180032485","180032766","17","156513594"
"chr3","23520994","23521311","chr2","180034560","180034865","30","156513566"
"chr3","23528303","23528620","chr2","180041892","180042183","58","156513589"
"chr3","23546619","23546667","chr19","873794","873842","11","22672825"
"chr3","23573043","23573335","chr2","180081018","180081311","26","156507975"
"chr3","23582128","23582294","chr3","47015232","47015392","53","23433104"
"chr3","23608528","23608810","chr2","180109518","180109811","30","156500990"
"chr3","23617696","23617990","chr2","180118754","180119048","21","156501058"
"chr3","23653782","23654093","chr2","180166600","180166916","30","156512818"
"chr3","23690262","23690537","chr2","180204357","180204600","49","156514095"
"chr3","23707464","23707764","chr2","71005973","71006275","54","47298509"
"chr3","23711222","23711512","chr2","180232577","180232864","27","156521355"
"chr3","23747030","23747340","chr20","28651476","28651780","51","4904446"
"chr3","23750460","23750768","chr2","180274341","180274654","46","156523881"
"chr3","23755435","23755710","chr2","180279270","180279579","49","156523835"
"chr3","23775527","23775693","chr2","180299307","180299462","31","156523780"
"chr3","23777829","23777951","chr2","180301586","180301698","12","156523757"
"chr3","23816562","23816789","chr2","180334405","180334636","15","156517843"
"chr3","23820583","23820877","chr2","180338540","180338835","21","156517957"
"chr3","23821793","23822085","chr2","180339746","180340044","24","156517953"
"chr3","23865167","23865435","chr2","180391661","180391930","22","156526494"
"chr3","23871661","23871995","chr2","180397901","180398209","39","156526240"
"chr3","23874960","23875254","chr2","180401473","180401767","11","156526513"
"chr3","23889707","23889861","chr2","180414846","180415000","7","156525139"
"chr3","23919892","23920159","chr2","180481533","180481809","20","156561641"
"chr3","23922706","23922892","chr2","180484347","180484547","34","156561641"
"chr3","23939882","23940184","chr2","180501495","180501807","23","156561613"
"chr3","23940934","23941222","chr2","180502560","180502844","33","156561626"
"chr3","23941525","23941654","chr2","180503223","180503352","9","156561698"
"chr3","23941954","23942042","chr1","20183520","20183607","18","3758434"
"chr3","23953913","23954212","chr2","180515640","180515944","20","156561727"
"chr3","23967553","23967852","chr2","180528017","180528332","44","156560464"
"chr3","23975298","23975601","chr2","180535728","180536031","16","156560430"
"chr3","23979173","23979464","chr2","180539739","180540030","16","156560566"
"chr3","23983272","23983580","chr2","180543865","180544172","23","156560593"
"chr3","23984763","23984927","chr2","180545369","180545533","11","156560606"
"chr3","23987379","23987644","chr2","180548315","180548586","28","156560936"
"chr3","23988982","23989298","chr2","180548705","180549020","26","156559723"
"chr3","24021179","24021399","chr2","180582470","180582690","12","156561291"
"chr3","24033270","24033542","chr2","180594885","180595165","30","156561615"
"chr3","24053517","24053815","chrX","17672800","17673101","69","6380717"
"chr3","24067740","24068011","chr2","180631697","180631973","27","156563957"
"chr3","24072259","24072544","chr6","171336994","171337274","62","147264735"
"chr3","24073732","24074032","chr2","180638012","180638312","20","156564280"
"chr3","24080783","24080977","chr8","32478230","32478427","46","8397447"
"chr3","24088588","24088702","chr2","180652903","180653017","5","156564315"
"chr3","24089090","24089365","chr3","80487968","80488265","66","56398878"
"chr3","24089898","24090189","chr2","180654214","180654498","24","156564316"
"chr3","24101090","24101353","chr2","180665784","180666037","26","156564694"
"chr3","24113413","24113670","chr2","180678347","180678600","24","156564934"
"chr3","24122430","24122725","chr2","180686408","180686695","28","156563978"
"chr3","24131553","24131824","chrX","16375073","16375338","65","7756480"
"chr3","24132941","24133252","chr2","180697821","180698130","56","156564880"
"chr3","24157538","24157647","chr4","51874979","51875091","19","27717441"
"chr3","24170768","24171083","chr2","180745623","180745934","24","156574855"
"chr3","24171152","24171455","chr2","160551205","160551504","54","136380053"
"chr3","24173578","24173874","chr2","180750091","180750390","37","156576513"
"chr3","24175420","24175719","chr2","180752267","180752576","34","156576847"
"chr3","24189398","24189700","chr2","84913076","84913368","70","60723678"
"chr3","24193741","24194030","chr2","180770784","180771078","21","156577043"
"chr3","24210338","24210637","chr2","180788394","180788657","56","156578056"
"chr3","24227883","24228158","chr2","180809205","180809519","60","156581322"
"chr3","24271807","24271917","chr1","68098160","68098266","26","43826353"
"chr3","24272249","24272375","chr2","180859473","180859599","9","156587224"
"chr3","24343134","24343439","chr2","180927916","180928221","18","156584782"
"chr3","24386080","24386385","chr2","180971138","180971441","15","156585058"
"chr3","24467342","24467413","chr2","181053562","181053633","8","156586220"
"chr3","24478200","24478503","chr2","181064414","181064717","16","156586214"
"chr3","24497282","24497563","chr20","38849629","38849902","55","14352347"
"chr3","24506647","24506951","chr2","181094059","181094359","26","156587412"
"chr3","24556841","24557141","chr2","181136731","181137034","15","156579890"
"chr3","24596713","24596795","chr2","181176233","181176313","6","156579520"
"chr3","24657559","24657686","chr2","181237426","181237554","6","156579867"
"chr3","24683860","24684167","chr2","181264447","181264749","30","156580587"
"chr3","24691078","24691366","chr20","34746844","34747145","66","10055766"
"chr3","24779918","24780206","chr2","181360466","181360773","38","156580548"
"chr3","24859219","24859366","chr4","132993640","132993786","32","108134421"
"chr3","24964692","24964901","chr2","181539367","181539607","41","156574675"
"chr3","24978511","24978803","chr2","181553333","181553605","37","156574822"
"chr3","25005270","25005560","chr2","181580831","181581136","32","156575561"
"chr3","25010410","25010693","chr12","59347258","59347555","54","34336848"
"chr3","25010753","25010902","chr2","181586244","181586395","19","156575491"
"chr3","25053775","25054062","chr2","181635907","181636181","46","156582132"
"chr3","25082811","25083103","chr6","62495959","62496247","60","37413148"
"chr3","25111160","25111285","chr2","181695609","181695735","11","156584449"
"chr3","25125157","25125447","chr2","181709871","181710173","19","156584714"
"chr3","25143228","25143351","chr13","48026720","48026844","14","22883492"
"chr3","25162243","25162548","chr11","119742158","119742460","76","94579915"
"chr3","25178112","25178388","chr2","181764507","181764785","31","156586395"
"chr3","25347320","25347562","chr2","181933247","181933490","15","156585927"
"chr3","25393706","25394014","chr2","181980755","181981061","22","156587049"
"chr3","25401230","25401538","chr4","54503118","54503421","61","29101888"
"chr3","25416628","25416811","chr2","88720898","88721077","48","63304270"
"chr3","25637974","25638091","chr8","142934040","142934158","14","117296066"
"chr3","25840199","25840493","chr2","182425372","182425663","19","156585173"
"chr3","25952344","25952582","chr12","2021886","2022127","65","23930458"
"chr3","25984612","25984839","chr10","73321840","73322069","61","47337228"
"chr3","25990354","25990653","chr2","182568236","182568531","15","156577882"
"chr3","26012271","26012546","chr2","182593749","182594019","24","156581478"
"chr3","26024164","26024373","chr10","81364788","81365002","48","55340624"
"chr3","26038253","26038569","chr2","182619624","182619929","42","156581371"
"chr3","26091389","26091607","chr2","182670046","182670244","39","156578657"
"chr3","26151030","26151335","chr9","57720841","57721119","91","31569811"
"chr3","26376361","26376647","chr2","182963410","182963695","16","156587049"
"chr3","26488142","26488429","chr1","212801492","212801783","60","186313350"
"chr3","26518401","26518706","chr2","183095444","183095754","34","156577043"
"chr3","26520842","26520929","chr2","183097906","183097987","12","156577064"
"chr3","26604217","26604533","chr2","183181877","183182198","32","156577660"
"chr3","26762535","26762817","chr2","183338715","183338995","13","156576180"
"chr3","26992545","26992804","chr2","183562006","183562263","44","156569461"
"chr3","27093827","27094130","chr4","159090526","159090826","50","131996699"
"chr3","27198146","27198473","chr2","183728868","183729206","29","156530722"
"chr3","27219628","27219895","chr2","183746091","183746372","39","156526463"
"chr3","27249916","27250123","chr2","183774007","183774209","31","156524091"
"chr3","27571139","27571429","chr2","184104695","184104998","30","156533556"
"chr3","27605698","27605981","chr2","184141204","184141488","45","156535506"
"chr3","27608896","27609190","chr2","184143766","184144059","14","156534870"
"chr3","27637137","27637425","chr2","184171748","184172035","22","156534611"
"chr3","27644274","27644572","chr2","184178737","184179009","44","156534463"
"chr3","27655889","27656188","chr2","184190148","184190442","23","156534259"
"chr3","27719502","27719747","chr2","184251054","184251301","15","156531552"
"chr3","27732355","27732631","chr2","184267564","184267852","27","156535209"
"chr3","27732655","27732844","chr3","41002961","41003155","50","13270306"
"chr3","27735872","27735993","chr15","110025773","110025895","22","82289901"
"chr3","27747540","27747879","chr2","184280628","184280930","59","156533088"
"chr3","27753044","27753336","chr2","184285853","184286143","24","156532809"
"chr3","27761320","27761614","chr2","184294145","184294428","28","156532825"
"chr3","27764414","27764514","chr19","7932520","7932619","30","19831894"
"chr3","27778918","27779214","chr2","184307847","184308134","30","156528929"
"chr3","27786313","27786614","chr2","184315363","184315650","30","156529050"
"chr3","27807570","27807670","chr2","184340967","184341074","15","156533397"
"chr3","27825806","27826082","chr2","184354708","184354995","22","156528902"
"chr3","27852884","27853218","chr9","22678796","22679125","72","5174088"
"chr3","27857020","27857304","chr2","184381744","184382029","20","156524724"
"chr3","27859033","27859346","chr2","184383759","184384072","30","156524726"
"chr3","27878528","27878837","chr2","184405013","184405317","28","156526485"
"chr3","27884199","27884497","chr1","216920851","216921152","60","189036652"
"chr3","27893589","27893871","chr11","48401419","48401716","69","20507830"
"chr3","27909625","27909906","chr12","31260025","31260303","68","3350400"
"chr3","27917277","27917576","chr2","184444407","184444698","63","156527130"
"chr3","27963175","27963298","chr2","184489215","184489338","6","156526040"
"chr3","27983194","27983502","chr2","184508459","184508743","48","156525265"
"chr3","27996422","27996690","chr2","184571181","184571448","18","156574759"
"chr3","28009974","28010256","chr2","184584687","184584984","32","156574713"
"chr3","28035870","28036153","chr2","184600888","184601175","26","156565018"
"chr3","28050676","28050962","chr2","184613872","184614138","39","156563196"
"chr3","28060495","28060771","chr1","26048278","26048559","59","2012217"
"chr3","28072182","28072487","chr2","184635698","184635992","39","156563516"
"chr3","28092273","28092543","chr12","43224167","43224446","71","15131894"
"chr3","28168232","28168497","chr2","184741337","184741608","29","156573105"
"chr3","28342871","28343175","chr2","184911263","184911558","31","156568392"
"chr3","28380136","28380251","chr1","92690108","92690223","21","64309972"
"chr3","28513064","28513351","chr2","185081129","185081414","24","156568065"
"chr3","28519122","28519344","chr2","185087418","185087640","19","156568296"
"chr3","28593605","28593808","chr2","185156814","185157013","11","156563209"
"chr3","28724692","28724962","chr2","185276781","185277055","17","156552089"
"chr3","29062470","29062776","chr2","186841882","186842204","39","157779412"
"chr3","29240160","29240461","chr2","186654271","186654581","38","157414111"
"chr3","29365632","29365928","chr2","186530193","186530493","39","157164561"
"chr3","29579010","29579296","chr2","186312210","186312502","41","156733200"
"chr3","29729365","29729618","chr2","186166631","186166890","40","156437266"
"chr3","29736614","29736927","chr1","10811316","10811617","59","18925298"
"chr3","29746009","29746302","chr2","186150386","186150659","44","156404377"
"chr3","29759761","29760014","chr2","186135559","186135812","18","156375798"
"chr3","29760925","29761221","chr2","186134375","186134658","38","156373450"
"chr3","29776466","29776755","chr2","186117028","186117315","26","156340562"
"chr3","30012185","30012252","chr1","85834401","85834469","12","55822216"
"chr3","30232266","30232411","chr8","21621594","21621739","31","8610672"
"chr3","30321707","30321985","chr2","185586002","185586284","27","155264295"
"chr3","30324938","30325250","chr2","185582377","185582660","44","155257439"
"chr3","30491799","30492070","chr2","190875795","190876067","21","160383996"
"chr3","30502814","30503111","chr2","190864684","190864983","34","160361870"
"chr3","30669675","30669949","chr2","190700531","190700802","24","160030856"
"chr3","30762362","30762663","chr2","190618276","190618581","27","159855914"
"chr3","30809173","30809478","chr3","43395486","43395788","59","12586313"
"chr3","30851105","30851417","chr2","190532137","190532458","36","159681032"
"chr3","30991551","30991832","chr2","190384491","190384772","27","159392940"
"chr3","31050066","31050358","chr2","190325512","190325783","55","159275446"
"chr3","31133145","31133271","chr2","190244568","190244700","16","159111423"
"chr3","31164107","31164422","chr2","190213207","190213522","37","159049100"
"chr3","31172202","31172488","chr6","68750302","68750588","65","37578100"
"chr3","31189933","31190226","chr10","11772454","11772749","62","19417479"
"chr3","31225429","31225718","chr2","190148908","190149195","22","158923479"
"chr3","31274792","31275098","chr2","190099592","190099897","16","158824800"
"chr3","31358758","31358890","chr11","50179416","50179546","27","18820658"
"chr3","31382746","31383033","chr2","189985690","189985991","37","158602944"
"chr3","31387873","31388172","chr2","189980578","189980853","36","158592705"
"chr3","31419929","31420098","chr10","61190119","61190273","47","29770190"
"chr3","31446989","31447278","chr3","122360384","122360664","62","90913395"
"chr3","31553896","31554025","chr3","85050626","85050755","25","53496730"
"chr3","31596259","31596373","chr9","82847515","82847637","22","51251256"
"chr3","31664524","31664829","chr2","189679610","189679916","18","158015086"
"chr3","31722142","31722446","chr2","189612550","189612883","45","157890408"
"chr3","31744017","31744315","chr2","189586570","189586878","30","157842553"
"chr3","31755511","31755831","chr6","77260247","77260553","66","45504736"
"chr3","31839572","31839721","chr2","189495774","189495921","13","157656202"
"chr3","31880869","31880999","chr2","189451666","189451801","18","157570797"
"chr3","31895303","31895483","chr2","189440024","189440204","7","157544721"
"chr3","31930652","31930931","chr2","189405615","189405894","26","157474963"
"chr3","31963689","31963963","chr2","189373299","189373582","23","157409610"
"chr3","31973582","31973783","chr2","189363831","189364035","14","157390249"
"chr3","31987884","31988225","chr2","189344804","189345129","48","157356920"
"chr3","32003130","32003440","chr2","189329569","189329855","38","157326439"
"chr3","32045644","32045904","chr2","189282636","189282904","20","157236992"
"chr3","32063320","32063605","chr2","189265077","189265369","26","157201757"
"chr3","32082720","32083015","chr2","189245782","189246092","35","157163062"
"chr3","32087665","32087792","chr2","189240709","189240836","11","157153044"
"chr3","32088092","32088262","chr2","189240229","189240402","7","157152137"
"chr3","32092958","32093230","chr5","165714831","165715111","68","133621873"
"chr3","32137803","32137972","chr2","189194620","189194798","16","157056817"
"chr3","32141410","32141725","chr2","189190804","189191107","31","157049394"
"chr3","32171459","32171755","chr2","189157661","189157958","27","156986202"
"chr3","32177846","32178052","chr2","189150981","189151180","26","156973135"
"chr3","32204780","32204864","chr9","87978451","87978536","23","55773671"
"chr3","32224163","32224462","chr2","189101120","189101438","38","156876957"
"chr3","32230134","32230439","chr2","189094043","189094349","16","156863909"
"chr3","32235172","32235484","chr2","189089950","189090236","37","156854778"
"chr3","32271601","32271798","chr11","55393537","55393735","43","23121936"
"chr3","32273383","32273668","chr1","10904976","10905255","60","21368407"
"chr3","32274689","32274798","chr6","152802412","152802524","15","120527723"
"chr3","32333144","32333432","chr5","78689579","78689868","62","46356435"
"chr3","32338796","32338920","chr2","189001800","189001921","8","156663004"
"chr3","32370558","32370836","chr9","22873625","22873899","55","9496933"
"chr3","32378980","32379244","chr2","188961636","188961951","67","156582656"
"chr3","32379343","32379424","chr2","188961474","188961557","6","156582131"
"chr3","32385096","32385391","chr4","87333067","87333363","57","54947971"
"chr3","32404983","32405238","chr2","188934141","188934409","28","156529158"
"chr3","32407972","32408268","chr2","188930963","188931267","22","156522991"
"chr3","32436030","32436309","chr2","188902227","188902505","30","156466197"
"chr3","32440000","32440329","chr17","29528627","29528926","83","2911373"
"chr3","32447631","32447896","chr2","188892427","188892711","54","156444796"
"chr3","32461410","32461700","chr2","188879004","188879290","16","156417594"
"chr3","32462644","32462951","chr2","188877778","188878086","24","156415134"
"chr3","32474587","32474888","chr2","188864818","188865117","45","156390231"
"chr3","32478007","32478291","chr19","1951603","1951893","61","30526404"
"chr3","32487174","32487364","chr2","22534822","22535005","46","9952352"
"chr3","32494430","32494634","chr2","188846177","188846381","13","156351747"
"chr3","32503458","32503582","chr2","188842730","188842857","13","156339272"
"chr3","32520726","32520935","chr2","188825704","188825918","16","156304978"
"chr3","32534023","32534280","chr2","188810954","188811220","24","156276931"
"chr3","32560100","32560260","chr2","188785256","188785392","30","156225156"
"chr3","32576312","32576596","chr2","188762659","188762942","16","156186347"
"chr3","32600280","32600561","chr20","22996900","22997178","57","9603380"
"chr3","32606284","32606588","chr11","120832938","120833247","71","88226654"
"chr3","32610822","32611145","chr2","188727526","188727859","23","156116704"
"chr3","32625485","32625697","chr2","188712252","188712453","29","156086767"
"chr3","32666449","32666734","chr2","188670668","188670947","23","156004219"
"chr3","32671594","32671875","chr2","188664914","188665199","35","155993320"
"chr3","32705787","32706002","chr2","188636033","188636257","28","155930246"
"chr3","32708781","32708956","chr2","188632951","188633125","10","155924170"
"chr3","32788603","32788900","chr2","188550034","188550322","22","155761431"
"chr3","32794150","32794434","chr2","188543943","188544225","18","155749793"
"chr3","32808914","32809119","chr3","92581046","92581256","44","59772132"
"chr3","32809157","32809275","chr11","113226186","113226302","19","80417029"
"chr3","32819145","32819442","chr6","78143135","78143436","63","45323990"
"chr3","32833668","32833769","chr19","15496154","15496255","17","17337514"
"chr3","32853703","32853999","chr11","122164387","122164686","63","89310684"
"chr3","32859600","32859640","chr4","161529528","161529566","4","128669928"
"chr3","32859941","32860039","chr2","74636905","74637003","17","41776964"
"chr3","32871143","32871431","chr2","188467550","188467838","20","155596407"
"chr3","32874116","32874403","chr2","188464589","188464876","15","155590473"
"chr3","32892561","32892820","chr2","61989963","61990222","53","29097402"
"chr3","32900523","32900730","chr20","3363292","3363496","48","29537231"
"chr3","32907945","32908238","chr2","188431556","188431846","32","155523611"
"chr3","32923738","32924013","chr2","188412887","188413160","22","155489149"
"chr3","32924792","32925075","chr2","188411685","188411980","31","155486893"
"chr3","32932371","32932672","chr3","40783093","40783379","57","7850722"
"chr3","32967619","32967740","chr2","188363821","188363939","10","155396202"
"chr3","32971491","32971783","chr2","188359804","188360098","20","155388313"
"chr3","32980899","32981176","chr3","39358673","39358948","57","6377774"
"chr3","32984801","32985071","chr2","188341786","188342056","22","155356985"
"chr3","32986334","32986629","chr2","188340816","188341119","56","155354482"
"chr3","33005497","33005792","chr10","69629356","69629644","56","36623859"
"chr3","33009734","33010019","chr20","36425190","36425487","60","3415456"
"chr3","33039072","33039363","chr2","184143766","184144059","58","151104694"
"chr3","33061208","33061355","chr11","121260648","121260779","34","88199440"
"chr3","33064528","33064809","chr2","188257089","188257361","29","155192561"
"chr3","33093688","33093816","chr8","320367","320492","22","32773321"
"chr3","33095432","33095633","chr2","188222961","188223160","41","155127529"
"chr3","33103187","33103259","chr2","188215118","188215185","11","155111931"
"chr3","33109484","33109709","chr14","112422624","112422842","56","79313140"
"chr3","33142729","33142844","chr2","188170656","188170771","8","155027927"
"chr3","33142996","33143238","chr9","12066098","12066309","75","21076898"
"chr3","33143725","33144012","chr2","188169216","188169502","21","155025491"
"chr3","33153518","33153809","chr20","36931483","36931776","59","3777965"
"chr3","33153893","33154013","chr8","30764780","30764890","28","2389113"
"chr3","33166134","33166442","chr2","188153245","188153578","39","154987111"
"chr3","33214346","33214654","chr2","188085557","188085836","46","154871211"
"chr3","33218338","33218640","chr20","24010200","24010492","54","9208138"
"chr3","33236858","33237181","chr2","188060710","188061039","28","154823852"
"chr3","33240026","33240266","chr2","188057658","188057892","28","154817632"
"chr3","33272598","33272888","chr2","188015550","188015856","37","154742952"
"chr3","33303962","33304244","chr2","187983263","187983544","30","154679301"
"chr3","33307226","33307514","chr2","187979954","187980242","15","154672728"
"chr3","33317118","33317417","chr2","187970923","187971222","18","154653805"
"chr3","33323241","33323533","chr2","187964857","187965160","33","154641616"
"chr3","33337493","33337782","chr2","187950387","187950679","27","154612894"
"chr3","33367148","33367282","chr10","8237746","8237873","18","25129402"
"chr3","33367576","33367741","chr15","8429087","8429254","35","24938489"
"chr3","33388476","33388610","chr2","187892779","187892913","11","154504303"
"chr3","33388659","33388870","chr2","187892524","187892733","17","154503865"
"chr3","33408667","33408839","chr19","40492112","40492283","34","7083445"
"chr3","33409154","33409280","chr16","39379692","39379819","19","5970538"
"chr3","33419945","33420226","chr2","187860947","187861237","22","154441002"
"chr3","33428471","33428643","chr7","50028509","50028691","39","16600038"
"chr3","33437623","33437919","chr2","187839961","187840262","27","154402338"
"chr3","33451115","33451399","chr2","187826123","187826411","17","154375008"
"chr3","33478802","33479020","chr2","187798780","187798998","17","154319978"
"chr3","33482697","33483002","chr1","11397782","11398082","66","22084915"
"chr3","33504534","33504845","chr2","187772974","187773269","34","154268440"
"chr3","33515051","33515339","chr2","187761085","187761374","22","154246034"
"chr3","33518207","33518501","chr2","187756805","187757069","46","154238598"
"chr3","33533970","33534102","chr7","16781339","16781468","23","16752631"
"chr3","33537529","33537826","chr2","187739195","187739491","23","154201666"
"chr3","33540968","33541272","chr6","148593360","148593661","60","115052392"
"chr3","33553737","33553985","chr2","187723588","187723849","30","154169851"
"chr3","33577026","33577305","chr2","187699093","187699386","31","154122067"
"chr3","33586903","33587073","chr5","153290091","153290253","44","119703188"
"chr3","33589463","33589746","chr2","187686466","187686747","13","154097003"
"chr3","33658608","33658814","chr2","187615485","187615700","19","153956877"
"chr3","33665933","33666256","chr3","44740474","44740789","78","11074541"
"chr3","33666303","33666432","chr2","187608354","187608483","10","153942051"
"chr3","33666722","33666890","chr2","187607888","187608063","13","153941166"
"chr3","33678777","33679041","chr2","187604098","187604359","35","153925321"
"chr3","33715059","33715360","chr2","187578236","187578544","61","153863177"
"chr3","33729979","33730274","chr2","187562183","187562486","32","153832204"
"chr3","33735320","33735624","chr2","187556896","187557172","51","153821576"
"chr3","33757288","33757574","chr2","187530884","187531170","17","153773596"
"chr3","33763270","33763547","chr2","187525379","187525681","46","153762109"
"chr3","33771773","33772068","chr1","92247752","92248049","73","58475979"
"chr3","33787572","33787855","chr2","187501304","187501585","26","153713732"
"chr3","33804977","33805288","chr2","187483397","187483710","17","153678420"
"chr3","33813922","33814203","chr2","187474760","187475030","24","153660838"
"chr3","33838363","33838440","chr3","43601787","43601863","19","9763424"
"chr3","33901195","33901482","chr2","187389578","187389864","17","153488383"
"chr3","33915692","33915979","chr2","187374493","187374773","36","153458801"
"chr3","33921976","33922245","chr2","187368316","187368598","29","153446340"
"chr3","33927319","33927640","chr2","187366517","187366815","47","153439198"
"chr3","33934344","33934383","chr11","108344667","108344705","5","74410323"
"chr3","33941423","33941549","chr2","187352743","187352869","5","153411320"
"chr3","33944382","33944671","chr18","39207065","39207355","59","5262683"
"chr3","33950731","33950866","chr2","187342534","187342667","11","153391803"
"chr3","33966912","33967195","chr1","155950012","155950287","63","121983100"
"chr3","33974995","33975304","chr2","187327853","187328156","25","153352858"
"chr3","33983925","33984220","chr2","187318976","187319279","29","153335051"
"chr3","33990580","33990865","chr7","131806155","131806433","52","97815575"
"chr3","34024390","34024639","chr2","187269485","187269770","53","153245095"
"chr3","34040385","34040694","chr2","187252770","187253070","30","153212385"
"chr3","34102672","34102967","chr2","187190992","187191276","28","153088320"
"chr3","34114628","34114702","chr2","187178692","187178766","3","153064064"
"chr3","34121436","34121717","chr2","187172186","187172474","20","153050750"
"chr3","34243497","34243627","chr2","187042784","187042914","4","152799287"
"chr3","34265042","34265350","chr2","187018980","187019288","20","152753938"
"chr3","34274088","34274246","chr7","80140173","80140333","33","45866085"
"chr3","34274567","34274707","chr1","142183123","142183260","24","107908556"
"chr3","34329949","34330238","chr2","195426094","195426382","13","161096145"
"chr3","34386102","34386420","chr10","70189754","70190068","71","35803652"
"chr3","34490509","34490803","chr1","211353988","211354282","54","176863479"
"chr3","34495154","34495395","chr7","17119992","17120225","50","17375162"
"chr3","34681987","34682274","chr2","195082203","195082498","36","160400216"
"chr3","34726668","34726957","chr2","195032569","195032853","21","160305901"
"chr3","34865184","34865477","chr2","194902698","194902996","42","160037514"
"chr3","35025502","35025783","chr2","194736779","194737059","19","159711277"
"chr3","35461006","35461239","chr2","194309883","194310128","31","158848877"
"chr3","35588608","35588770","chrX","144963915","144964074","43","109375307"
"chr3","35642850","35643111","chr2","194124455","194124706","34","158481605"
"chr3","35842398","35842631","chr2","193937112","193937331","28","158094714"
"chr3","35971240","35971529","chr2","193808850","193809139","27","157837610"
"chr3","36031083","36031196","chr2","193748385","193748498","8","157717302"
"chr3","36193778","36194098","chr2","193570239","193570547","40","157376461"
"chr3","36286479","36286690","chr2","193465697","193465902","13","157179218"
"chr3","36302814","36303095","chr2","193449656","193449950","33","157146842"
"chr3","36603681","36603969","chr2","193161246","193161541","32","156557565"
"chr3","36614154","36614406","chr2","193151820","193152073","19","156537666"
"chr3","36682649","36682932","chr11","108911962","108912248","50","72229313"
"chr3","36699446","36699750","chr2","193061378","193061690","34","156361932"
"chr3","36721852","36722142","chr2","193040755","193041044","11","156318903"
"chr3","36861963","36862267","chr2","106140204","106140518","40","69278241"
"chr3","36913615","36913890","chr2","106086046","106086327","25","69172431"
"chr3","37046887","37047000","chr2","105956206","105956326","12","68909319"
"chr3","37096379","37096665","chr2","105907865","105908151","19","68811486"
"chr3","37096877","37097176","chr2","105907350","105907650","13","68810473"
"chr3","37133080","37133375","chr2","105870474","105870766","28","68737394"
"chr3","37167771","37167904","chr16","49950206","49950338","23","12782435"
"chr3","37168496","37168694","chr2","105836351","105836531","43","68667855"
"chr3","37177150","37177442","chr2","105828020","105828328","44","68650870"
"chr3","37195454","37195745","chr6","132314042","132314327","63","95118588"
"chr3","37200776","37200992","chr2","105803759","105803974","13","68602983"
"chr3","37266253","37266540","chr2","105739098","105739388","12","68472845"
"chr3","37296920","37297229","chr2","105710827","105711137","25","68413907"
"chr3","37302057","37302274","chr2","94580235","94580453","55","57278178"
"chr3","37308868","37309164","chr2","105698063","105698360","21","68389195"
"chr3","37310062","37310368","chr2","105696824","105697143","29","68386762"
"chr3","37311700","37311997","chr2","105695214","105695529","37","68383514"
"chr3","37313669","37313917","chr2","105693305","105693564","28","68379636"
"chr3","37362081","37362330","chr16","26479824","26480045","62","10882257"
"chr3","37368311","37368544","chr2","105633310","105633547","24","68264999"
"chr3","37376806","37377119","chr10","37707166","37707474","71","330360"
"chr3","37394329","37394463","chr5","24916403","24916528","36","12477926"
"chr3","37394589","37394702","chr11","19603512","19603626","17","17791077"
"chr3","37407603","37407763","chr2","105547394","105547578","37","68139791"
"chr3","37408050","37408197","chr2","105546962","105547115","20","68138912"
"chr3","37420966","37421241","chr2","105533520","105533795","18","68112554"
"chr3","37442238","37442360","chrX","47196755","47196879","16","9754517"
"chr3","37461885","37462199","chr2","105493388","105493657","68","68031503"
"chr3","37490382","37490681","chr2","105464800","105465095","24","67974418"
"chr3","37543974","37544310","chr2","105412081","105412417","32","67868107"
"chr3","37552648","37552854","chr9","94186886","94187094","60","56634238"
"chr3","37568680","37568940","chr2","105388238","105388519","38","67819558"
"chr3","37597555","37597853","chr2","105353001","105353294","21","67755446"
"chr3","37607973","37608272","chr2","105342245","105342550","26","67734272"
"chr3","37623337","37623467","chr2","105327153","105327283","6","67703816"
"chr3","37630483","37630761","chr2","105319927","105320225","37","67689444"
"chr3","37671476","37671584","chr14","99484777","99484882","14","61813301"
"chr3","37705655","37705956","chr2","105237077","105237364","39","67531422"
"chr3","37809516","37809817","chr2","105131162","105131473","20","67321646"
"chr3","37894773","37895008","chr2","105041537","105041772","15","67146764"
"chr3","37904419","37904716","chr2","105032018","105032306","38","67127599"
"chr3","37940657","37940950","chr2","104996126","104996430","35","67055469"
"chr3","37943904","37943987","chr8","5304149","5304232","9","32639755"
"chr3","37966222","37966504","chr2","104969458","104969740","18","67003236"
"chr3","37968360","37968623","chr2","104967322","104967597","32","66998962"
"chr3","37987906","37988185","chr2","104945572","104945841","43","66957666"
"chr3","38010142","38010438","chr2","104921319","104921617","14","66911177"
"chr3","38076237","38076556","chr2","104850237","104850537","34","66774000"
"chr3","38078679","38078985","chr2","104847810","104848117","21","66769131"
"chr3","38113234","38113544","chr2","104814880","104815188","21","66701646"
"chr3","38116124","38116435","chr8","96575803","96576115","63","58459679"
"chr3","38218368","38218678","chr2","104710021","104710329","16","66491653"
"chr3","38222901","38223055","chr19","50866168","50866326","32","12643267"
"chr3","38223373","38223513","chr3","127298494","127298631","24","89075121"
"chr3","38232194","38232414","chr10","71004722","71004936","42","32772528"
"chr3","38243977","38244295","chrX","47748077","47748386","66","9504100"
"chr3","38270191","38270513","chr2","104673278","104673602","14","66403087"
"chr3","38271505","38271791","chr2","104672036","104672284","56","66400531"
"chr3","38299810","38300093","chr2","104643732","104643974","59","66343922"
"chr3","38357860","38358164","chr2","104586853","104587152","32","66228993"
"chr3","38366579","38366884","chr2","104578176","104578483","28","66211597"
"chr3","38371950","38372234","chr2","104571744","104572046","44","66199794"
"chr3","38380131","38380390","chr2","104563621","104563886","17","66183490"
"chr3","38400669","38400953","chr2","104540769","104541054","21","66140100"
"chr3","38452116","38452395","chr2","104489062","104489350","24","66036946"
"chr3","38469427","38469720","chr2","104468582","104468895","41","65999155"
"chr3","38481428","38481667","chr11","28409316","28409552","61","10072112"
"chr3","38482946","38483197","chr2","104452756","104453002","20","65969810"
"chr3","38490655","38490943","chr2","104445382","104445669","16","65954727"
"chr3","38503092","38503196","chr9","6051471","6051572","16","32451621"
"chr3","38571841","38572135","chr2","104356889","104357193","29","65785048"
"chr3","38616499","38616625","chr2","104291826","104291946","12","65675327"
"chr3","38616919","38617064","chr3","43797685","43797824","27","5180766"
"chr3","38626143","38626457","chr2","104282492","104282813","34","65656349"
"chr3","38646204","38646498","chr2","104260950","104261240","15","65614746"
"chr3","38674439","38674739","chr2","104232704","104233006","23","65558265"
"chr3","38682792","38683081","chr2","104224403","104224694","28","65541611"
"chr3","38718593","38718873","chr2","104188836","104189116","27","65470243"
"chr3","38751209","38751509","chr2","104155609","104155906","13","65404400"
"chr3","38861999","38862347","chr2","104041690","104042036","19","65179691"
"chr3","38911989","38912093","chr1","141319339","141319440","23","102407350"
"chr3","38973566","38973795","chr9","62480277","62480505","54","23506711"
"chr3","38996684","38996963","chr2","103905550","103905826","25","64908866"
"chr3","39173883","39174000","chr2","103724328","103724465","26","64550445"
"chr3","39186835","39187144","chr2","103711991","103712294","25","64525156"
"chr3","39264016","39264246","chr2","103585423","103585645","19","64321407"
"chr3","39268512","39268804","chr2","103580913","103581205","23","64312401"
"chr3","39287928","39288086","chr2","103561392","103561538","23","64273464"
"chr3","39293139","39293405","chr2","103555747","103556022","34","64262608"
"chr3","39336680","39336973","chr2","103512225","103512536","46","64175545"
"chr3","39354147","39354447","chr1","223979328","223979622","55","184625181"
"chr3","39449166","39449445","chr2","103413953","103414237","22","63964787"
"chr3","39460611","39460904","chr2","103402148","103402442","19","63941537"
"chr3","39471958","39472237","chr2","103390657","103390939","34","63918699"
"chr3","39478019","39478153","chr2","103384400","103384528","14","63906381"
"chr3","39511769","39511901","chr2","103358412","103358544","6","63846643"
"chr3","39585741","39586024","chr2","103303790","103304090","29","63718049"
"chr3","39593976","39594141","chr4","160825138","160825301","38","121231162"
"chr3","39599828","39600130","chr2","103288574","103288844","45","63688746"
"chr3","39634661","39634954","chr2","103188603","103188896","27","63553942"
"chr3","39639188","39639418","chr2","103184134","103184363","20","63544946"
"chr3","39640571","39640869","chr2","103182688","103182982","23","63542117"
"chr3","39673173","39673484","chr2","103154441","103154749","21","63481268"
"chr3","39742581","39742881","chr8","39165024","39165322","60","577557"
"chr3","39785255","39785380","chr2","103054445","103054573","9","63269190"
"chr3","39856533","39856847","chr2","102976728","102977024","44","63120195"
"chr3","39898250","39898552","chr2","102931316","102931610","33","63033066"
"chr3","39958128","39958434","chr2","102872220","102872524","27","62914092"
"chr3","40006675","40006984","chr2","102824794","102825093","24","62818119"
"chr3","40009071","40009380","chr2","102822389","102822685","31","62813318"
"chr3","40117679","40117801","chr2","102709726","102709849","10","62592047"
"chr3","40210623","40210919","chr2","102630295","102630582","44","62419672"
"chr3","40330964","40331252","chr2","102525595","102525908","33","62194631"
"chr3","40352380","40352552","chr1","159500001","159500172","41","119147621"
"chr3","40352845","40352988","chr2","102507593","102507742","10","62154748"
"chr3","40388003","40388287","chr7","20966917","20967214","62","19421086"
"chr3","40396804","40397088","chr9","57720841","57721119","61","17324037"
"chr3","40412284","40412410","chr2","102450456","102450582","11","62038172"
"chr3","40412467","40412588","chr2","102450278","102450399","3","62037811"
"chr3","40432487","40432786","chr2","102426463","102426750","32","61993976"
"chr3","40456390","40456713","chr2","102408591","102408902","25","61952201"
"chr3","40495964","40496252","chr2","102368592","102368879","19","61872628"
"chr3","40555404","40555707","chr2","102312097","102312390","34","61756693"
"chr3","40564739","40565019","chr2","102302756","102303026","29","61738017"
"chr3","40657853","40658143","chr2","102211116","102211415","18","61553263"
"chr3","40668287","40668412","chr2","102199948","102200086","16","61531661"
"chr3","40713528","40713803","chr2","102149246","102149514","34","61435718"
"chr3","40719168","40719367","chr2","102144032","102144219","36","61424864"
"chr3","40719634","40719727","chr2","102143700","102143804","17","61424066"
"chr3","40725330","40725452","chr2","102137497","102137619","5","61412167"
"chr3","40730635","40730928","chr2","102133009","102133302","15","61402374"
"chr3","40732561","40732910","chr2","102130979","102131323","34","61398418"
"chr3","40869551","40869852","chr2","101996092","101996386","26","61126541"
"chr3","41021255","41021565","chr2","101834922","101835207","40","60813667"
"chr3","41192726","41193026","chr2","101675964","101676264","30","60483238"
"chr3","41196908","41197230","chr2","101670595","101670928","25","60473687"
"chr3","41229694","41230017","chr15","2818281","2818589","64","38411413"
"chr3","41259162","41259471","chr2","101602695","101603004","23","60343533"
"chr3","41285985","41286295","chr2","101575751","101576060","24","60289766"
"chr3","41321785","41322108","chr2","101540384","101540701","42","60218599"
"chr3","41343271","41343385","chr2","101519210","101519325","3","60175939"
"chr3","41392212","41392440","chr2","101470158","101470392","15","60077946"
"chr3","41483523","41483798","chr2","163445135","163445414","64","121961612"
"chr3","41484039","41484163","chr2","101380232","101380353","16","59896193"
"chr3","41484202","41484352","chr2","101380040","101380184","11","59895838"
"chr3","41570390","41570722","chr2","101296593","101296896","50","59726203"
"chr3","41609377","41609633","chr2","101257340","101257603","33","59647963"
"chr3","41623935","41624247","chr2","101244785","101245081","30","59620850"
"chr3","41667479","41667654","chr2","62606466","62606649","44","20938987"
"chr3","41727233","41727540","chr2","101094570","101094881","29","59367337"
"chr3","41763681","41763987","chr2","101056785","101057059","45","59293104"
"chr3","41771323","41771615","chr2","101048123","101048406","24","59276800"
"chr3","41779066","41779361","chr2","101038545","101038841","31","59259479"
"chr3","41838471","41838779","chr2","100987442","100987752","26","59148971"
"chr3","41844429","41844725","chr2","100981153","100981445","21","59136724"
"chr3","41879960","41880254","chr2","100946999","100947301","30","59067039"
"chr3","41925329","41925622","chr1","53106748","53107031","58","11181419"
"chr3","41934209","41934513","chr2","100896657","100896961","23","58962448"
"chr3","41954854","41955151","chr2","100876724","100877025","32","58921870"
"chr3","41970200","41970478","chr2","100861450","100861755","50","58891250"
"chr3","41970931","41971224","chr2","100860742","100861035","24","58889811"
"chr3","42039888","42040181","chr2","100810057","100810356","30","58770169"
"chr3","42040266","42040623","chr2","100809611","100809972","24","58769345"
"chr3","42051237","42051432","chr2","100767823","100768018","12","58716586"
"chr3","42054175","42054353","chr2","100764579","100764759","18","58710404"
"chr3","42075476","42075758","chr2","100743466","100743743","21","58667990"
"chr3","42085582","42085755","chr2","100733580","100733754","16","58647998"
"chr3","42112079","42112201","chr2","100700279","100700401","5","58588200"
"chr3","42126722","42126885","chr7","55919986","55920158","43","13793264"
"chr3","42136165","42136444","chr8","19223807","19224090","67","22912358"
"chr3","42160966","42161130","chr4","13629108","13629270","42","28531858"
"chr3","42161181","42161311","chr6","17252977","17253107","15","24908204"
"chr3","42164721","42164996","chr2","100646002","100646276","12","58481281"
"chr3","42170497","42170806","chr2","100639107","100639418","24","58468610"
"chr3","42171398","42171688","chr2","100638236","100638516","31","58466838"
"chr3","42176767","42177068","chr2","100632239","100632545","45","58455472"
"chr3","42179212","42179423","chr14","12138606","12138816","41","30040606"
"chr3","42188786","42189056","chrX","73936","74201","60","42114850"
"chr3","42200937","42201035","chr2","84382983","84383080","12","42182046"
"chr3","42204643","42204835","chr2","100606905","100607107","22","58402262"
"chr3","42208005","42208179","chr2","100603591","100603771","19","58395586"
"chr3","42209593","42209760","chr3","42714739","42714905","45","505146"
"chr3","42210049","42210152","chr14","112213808","112213914","20","70003759"
"chr3","42218766","42219055","chr2","100592974","100593264","20","58374208"
"chr3","42227021","42227310","chr2","100586639","100586932","26","58359618"
"chr3","42239700","42239977","chr2","100573044","100573320","15","58333344"
"chr3","42241995","42242300","chr2","100570869","100571154","40","58328874"
"chr3","42265561","42265855","chr2","100547730","100548036","34","58282169"
"chr3","42298086","42298362","chr2","100519637","100519919","15","58221551"
"chr3","42301551","42301857","chr2","100515724","100516032","35","58214173"
"chr3","42310433","42310714","chr2","100506282","100506577","35","58195849"
"chr3","42320593","42320898","chr2","100495705","100496023","33","58175112"
"chr3","42327151","42327445","chrX","114124054","114124354","64","71796903"
"chr3","42335373","42335599","chr2","100481115","100481359","35","58145742"
"chr3","42353594","42353735","chr3","76563748","76563878","31","34210154"
"chr3","42354047","42354393","chr2","100459926","100460253","43","58105879"
"chr3","42372773","42373072","chr2","100441732","100442030","25","58068959"
"chr3","42377868","42378150","chr2","100436672","100436944","28","58058804"
"chr3","42442063","42442326","chr2","100376407","100376670","20","57934344"
"chr3","42468754","42468888","chr4","10699232","10699349","29","31769522"
"chr3","42468907","42469191","chr6","135837498","135837781","60","93368591"
"chr3","42469244","42469269","chr3","2827691","2827711","5","39641553"
"chr3","42471863","42472162","chr2","100344951","100345237","33","57873088"
"chr3","42486090","42486214","chr2","111956973","111957098","16","69470883"
"chr3","42502348","42502521","chr2","100311026","100311223","30","57808678"
"chr3","42517843","42518151","chr2","100292663","100292973","45","57774820"
"chr3","42639684","42639960","chr2","100158443","100158716","26","57518759"
"chr3","42718935","42719219","chr2","100080349","100080637","23","57361414"
"chr3","42722949","42723062","chr2","100076493","100076609","12","57353544"
"chr3","42734810","42735057","chr8","22093859","22094110","50","20640951"
"chr3","42740772","42741024","chr2","100058439","100058691","32","57317667"
"chr3","42741424","42741556","chr2","100057906","100058040","9","57316482"
"chr3","42742706","42743022","chr2","100056419","100056735","21","57313713"
"chr3","42743715","42743796","chr2","100055636","100055722","10","57311921"
"chr3","43573523","43573821","chr2","100025702","100025994","33","56452179"
"chr3","43585879","43585947","chr2","100014033","100014106","6","56428154"
"chr3","43588622","43588908","chr2","100011042","100011333","33","56422420"
"chr3","43622191","43622462","chr1","189706253","189706526","65","146084062"
"chr3","43654030","43654335","chr2","99945161","99945467","20","56291131"
"chr3","43727982","43728252","chr2","99869200","99869469","18","56141218"
"chr3","43729565","43729849","chr2","99866951","99867244","42","56137386"
"chr3","43741448","43741733","chr2","99856532","99856815","21","56115084"
"chr3","43748675","43748798","chr2","99850814","99850944","14","56102139"
"chr3","43801486","43801589","chr11","107116864","107116967","18","63315378"
"chr3","43801891","43801943","chr2","99796150","99796200","6","55994259"
"chr3","43860832","43860958","chr13","25546692","25546816","19","18314140"
"chr3","43896617","43896929","chr2","99704995","99705307","22","55808378"
"chr3","43910852","43911126","chr2","99690784","99691070","27","55779932"
"chr3","43912596","43912883","chr2","99689040","99689328","13","55776444"
"chr3","43928705","43928998","chr2","99672388","99672680","31","55743683"
"chr3","43955533","43955853","chr2","99648006","99648286","56","55692473"
"chr3","44045383","44045689","chr2","99545073","99545382","22","55499690"
"chr3","44077656","44077875","chr2","99512941","99513164","22","55435285"
"chr3","44118352","44118576","chr2","99472730","99472960","26","55354378"
"chr3","44234370","44234491","chr11","119643018","119643141","20","75408648"
"chr3","44237223","44237510","chr2","99356296","99356587","20","55119073"
"chr3","44256201","44256327","chr2","99335925","99336042","11","55079724"
"chr3","44264325","44264553","chr2","99327726","99327946","19","55063401"
"chr3","44290848","44291143","chr2","99303637","99303928","21","55012789"
"chr3","44360727","44360901","chr20","21449738","21449904","37","22910989"
"chr3","44388618","44388919","chr3","127162429","127162726","70","82773811"
"chr3","44502979","44503096","chr2","99087233","99087359","24","54584254"
"chr3","44558237","44558544","chr2","99041657","99041952","29","54483420"
"chr3","44619436","44619666","chr2","98989542","98989772","21","54370106"
"chr3","44623519","44623801","chr2","98985500","98985798","28","54361981"
"chr3","44635602","44635900","chr2","98980263","98980557","22","54344661"
"chr3","44670622","44670870","chr2","98944136","98944374","21","54273514"
"chr3","44785130","44785417","chr2","98821907","98822171","40","54036777"
"chr3","44802476","44802645","chr2","98804587","98804756","9","54002111"
"chr3","44863591","44863895","chr2","98742581","98742885","10","53878990"
"chr3","44912712","44912969","chr2","98699725","98699984","19","53787013"
"chr3","44987575","44987885","chr4","150280581","150280886","67","105293006"
"chr3","45030611","45030902","chr2","98585103","98585398","22","53554492"
"chr3","45064598","45064817","chr2","98549862","98550086","22","53485264"
"chr3","45163532","45163849","chr2","98448119","98448434","25","53284587"
"chr3","45178708","45179000","chr18","15096438","15096724","53","30082270"
"chr3","45188496","45188775","chr2","98420038","98420328","25","53231542"
"chr3","45199982","45200292","chr2","98408474","98408776","30","53208492"
"chr3","45205990","45206112","chr11","22265","22387","18","45183725"
"chr3","45279927","45280208","chr2","98324352","98324633","17","53044425"
"chr3","45299019","45299314","chr2","98308495","98308793","31","53009476"
"chr3","45305697","45305937","chr2","98301563","98301800","21","52995866"
"chr3","45317037","45317341","chr2","98287260","98287566","17","52970223"
"chr3","45322770","45323080","chr2","98281195","98281492","34","52958425"
"chr3","45341810","45341927","chr15","104360931","104361048","10","59019121"
"chr3","45359668","45359872","chr17","58924288","58924488","29","13564620"
"chr3","45370942","45371265","chr15","27668948","27669263","82","17701994"
"chr3","45378108","45378404","chr9","106607385","106607691","66","61229277"
"chr3","45402277","45402560","chr11","118569447","118569730","57","73167170"
"chr3","45405109","45405396","chr2","98135470","98135752","29","52730361"
"chr3","45417710","45417976","chr2","98122215","98122477","16","52704505"
"chr3","45442729","45443039","chr2","98097000","98097304","32","52654271"
"chr3","45463129","45463417","chr9","11380623","11380917","55","34082506"
"chr3","45480762","45481050","chr2","98063472","98063761","28","52582710"
"chr3","45506963","45507263","chr2","98025240","98025554","36","52518277"
"chr3","45514807","45515005","chr11","95142362","95142556","53","49627555"
"chr3","45515488","45515545","chr2","98017296","98017363","12","52501808"
"chr3","45525133","45525431","chr2","98007732","98008030","20","52482599"
"chr3","45536325","45536571","chr10","63399772","63400029","64","17863447"
"chr3","45538933","45539221","chr1","86913045","86913336","57","41374112"
"chr3","45548633","45548770","chr2","97988336","97988472","2","52439703"
"chr3","45577706","45578000","chr2","97958391","97958671","44","52380685"
"chr3","45584828","45585100","chr2","97951471","97951743","12","52366643"
"chr3","45585992","45586085","chr2","97950480","97950573","8","52364488"
"chr3","45586375","45586680","chr2","97949889","97950196","15","52363514"
"chr3","45633007","45633307","chr2","97899432","97899733","27","52266425"
"chr3","45655388","45655634","chr2","97879947","97880197","23","52224559"
"chr3","45678625","45678931","chr2","97860021","97860330","31","52181396"
"chr3","45679218","45679399","chr2","97859544","97859728","16","52180326"
"chr3","45679686","45679813","chr2","97859191","97859314","14","52179505"
"chr3","45685295","45685586","chr2","97851842","97852128","17","52166547"
"chr3","45698163","45698450","chr2","97841012","97841305","21","52142849"
"chr3","45702187","45702490","chr2","97836434","97836735","17","52134247"
"chr3","45735998","45736294","chr2","97809500","97809776","51","52073502"
"chr3","45752832","45753140","chr2","97782683","97782978","33","52029851"
"chr3","45765577","45765661","chr1","142335499","142335582","14","96569922"
"chr3","45766876","45767061","chr2","97768104","97768289","7","52001228"
"chr3","45769182","45769497","chr2","97765865","97766185","23","51996683"
"chr3","45791676","45791978","chrX","5251532","5251828","52","40540144"
"chr3","45807416","45807705","chr2","97725579","97725864","13","51918163"
"chr3","45834117","45834351","chr5","14844666","14844890","50","30989451"
"chr3","45836841","45837127","chr2","97689754","97690052","25","51852913"
"chr3","45845015","45845164","chr2","97681165","97681307","15","51836150"
"chr3","45850996","45851310","chr2","97674506","97674840","36","51823510"
"chr3","45879131","45879423","chr2","97645308","97645599","12","51766177"
"chr3","45905402","45905712","chr2","97618801","97619112","18","51713399"
"chr3","45924563","45924838","chr1","56103749","56104030","52","10179186"
"chr3","45940302","45940601","chr2","97584961","97585251","22","51644659"
"chr3","46022187","46022478","chr2","97560647","97560957","36","51538460"
"chr3","46025184","46025461","chr2","97557674","97557949","28","51532490"
"chr3","46031165","46031482","chr2","97550454","97550778","55","51519289"
"chr3","46190099","46190380","chr2","97391256","97391543","20","51201157"
"chr3","46195665","46195963","chr7","129554975","129555269","62","83359310"
"chr3","46203800","46204092","chr2","97376751","97377061","32","51172951"
"chr3","46216107","46216226","chr2","97364569","97364694","14","51148462"
"chr3","46268513","46268818","chr2","97317426","97317763","52","51048913"
"chr3","46366487","46366760","chr11","119765978","119766266","61","73399491"
"chr3","46399758","46400070","chr2","97185692","97186005","27","50785934"
"chr3","46461983","46462139","chr2","97122403","97122556","12","50660420"
"chr3","46464019","46464200","chr2","97120215","97120403","17","50656196"
"chr3","46500010","46500085","chr3","43601787","43601863","13","2898223"
"chr3","46500449","46500573","chr2","165531071","165531193","16","119030622"
"chr3","46514950","46515093","chr2","97069231","97069375","17","50554281"
"chr3","46515405","46515574","chr2","97068758","97068924","17","50553353"
"chr3","46521326","46521623","chr2","97062671","97062977","31","50541345"
"chr3","46539374","46539652","chr2","97043650","97043963","60","50504276"
"chr3","46543898","46544201","chr2","97039137","97039445","23","50495239"
"chr3","46556965","46557219","chr2","97025664","97025922","32","50468699"
"chr3","46571772","46571975","chr2","97010985","97011189","16","50439213"
"chr3","46585609","46585891","chr11","1767086","1767360","74","44818523"
"chr3","46592778","46592951","chr2","96989376","96989545","11","50396598"
"chr3","46593255","46593287","chr2","96989045","96989083","6","50395790"
"chr3","46599499","46599781","chr19","36112659","36112945","62","10486840"
"chr3","46605414","46605654","chr2","96976430","96976667","16","50371016"
"chr3","46613524","46613772","chr14","118239882","118240140","73","71626358"
"chr3","46619283","46619397","chr2","96961689","96961787","18","50342406"
"chr3","46627669","46627968","chr2","96954325","96954603","47","50326656"
"chr3","46629251","46629375","chr13","46512186","46512305","20","117065"
"chr3","46636578","46636895","chr2","96945173","96945488","23","50308595"
"chr3","46642837","46642953","chrX","40491044","40491160","16","6151793"
"chr3","46650428","46650478","chr7","33748467","33748511","11","12901961"
"chr3","46654024","46654311","chr2","96927226","96927521","27","50273202"
"chr3","46688710","46688987","chr2","96890334","96890611","19","50201624"
"chr3","46702953","46703171","chr2","96876088","96876296","21","50173135"
"chr3","46712464","46712539","chr12","101287198","101287277","14","54574734"
"chr3","46726512","46726790","chr2","96852220","96852498","32","50125708"
"chr3","46731361","46731639","chr2","70051004","70051282","57","23319643"
"chr3","46732928","46733088","chr2","96846068","96846219","18","50113140"
"chr3","46743494","46743780","chr18","47931505","47931784","57","1188011"
"chr3","46821412","46821728","chr2","96755035","96755341","26","49933623"
"chr3","46843837","46844129","chr2","96733046","96733366","44","49889209"
"chr3","46903314","46903610","chr2","96669679","96669977","23","49766365"
"chr3","46928539","46928816","chr2","96644392","96644672","20","49715853"
"chr3","47034155","47034467","chr2","96532971","96533286","20","49498816"
"chr3","47075893","47076183","chr2","96493297","96493588","20","49417404"
"chr3","47094467","47094768","chr7","131944896","131945201","60","84850429"
"chr3","47100305","47100448","chr2","96470205","96470347","9","49369900"
"chr3","47190122","47190433","chr2","96389551","96389863","28","49199429"
"chr3","47199791","47200072","chr2","96379744","96380019","36","49179953"
"chr3","47222652","47222968","chr7","140100928","140101221","73","92878276"
"chr3","47274583","47274872","chr1","52586719","52587013","56","5312136"
"chr3","47412326","47412627","chr2","96142791","96143091","30","48730465"
"chr3","47430530","47430725","chr2","96125057","96125246","20","48694527"
"chr3","47443755","47444057","chr2","96118271","96118594","39","48674516"
"chr3","47454489","47454785","chr2","96107589","96107899","37","48653100"
"chr3","47490210","47490327","chr11","49584848","49584965","19","2094638"
"chr3","47522669","47522951","chr2","96036910","96037209","35","48514241"
"chr3","47529029","47529324","chr2","96031233","96031551","40","48502204"
"chr3","47542375","47542654","chr2","96017126","96017409","21","48474751"
"chr3","47547529","47547793","chr2","96007474","96007727","39","48459945"
"chr3","47551899","47552120","chr2","96001904","96002105","31","48450005"
"chr3","47553863","47554201","chr11","46246424","46246728","93","1307439"
"chr3","47603192","47603488","chr2","95955285","95955580","17","48352093"
"chr3","47608540","47608812","chr2","95947400","95947672","17","48338860"
"chr3","47644445","47644729","chr2","95904040","95904328","29","48259595"
"chr3","47651819","47652114","chr2","95896612","95896907","18","48244793"
"chr3","47671096","47671376","chr10","84226479","84226745","62","36555383"
"chr3","47700889","47701019","chr2","95848897","95849021","8","48148008"
"chr3","47717736","47718055","chr2","95831621","95831892","57","48113885"
"chr3","47723971","47724257","chr13","45053818","45054106","52","2670153"
"chr3","47736664","47736932","chr2","95811547","95811815","10","48074883"
"chr3","47747269","47747528","chr2","95801890","95802149","14","48054621"
"chr3","47753355","47753608","chr2","95795820","95796095","37","48042465"
"chr3","47769760","47770064","chr6","140128245","140128544","55","92358485"
"chr3","47779478","47779593","chr2","95775272","95775388","7","47995794"
"chr3","47861698","47861958","chr2","95705185","95705445","15","47843487"
"chr3","47881060","47881358","chr2","95685774","95686077","32","47804714"
"chr3","47896673","47896883","chr2","95670260","95670472","19","47773587"
"chr3","47952318","47952629","chr8","119103235","119103541","71","71150917"
"chr3","47971110","47971309","chr2","95564771","95564965","16","47593661"
"chr3","47973962","47974086","chr2","95561970","95562094","7","47588008"
"chr3","48041777","48042072","chr11","113114919","113115214","56","65073142"
"chr3","48042568","48042702","chr2","95496284","95496418","3","47453716"
"chr3","48049846","48050106","chr2","95487360","95487631","25","47437514"
"chr3","48056782","48057079","chr2","95480228","95480529","22","47423446"
"chr3","48066560","48066857","chr2","95469662","95469933","46","47403102"
"chr3","48071976","48072065","chr2","95463417","95463506","5","47391441"
"chr3","48079646","48079900","chr2","95455642","95455904","26","47375996"
"chr3","48087357","48087646","chr2","95447261","95447544","19","47359904"
"chr3","48097002","48097323","chr2","95437237","95437558","43","47340235"
"chr3","48104791","48105079","chr2","95429051","95429351","31","47324260"
"chr3","48116986","48117293","chr10","81937384","81937691","71","33820398"
"chr3","48142060","48142335","chr2","95388726","95389001","11","47246666"
"chr3","48145569","48145867","chr2","95384916","95385207","26","47239347"
"chr3","48146484","48146781","chr15","43687639","43687935","64","4458845"
"chr3","48153275","48153579","chr2","95376528","95376831","16","47223253"
"chr3","48161467","48161749","chr2","95368367","95368660","21","47206900"
"chr3","48170691","48170891","chr1","34916004","34916198","39","13254687"
"chr3","48172105","48172358","chr20","29246987","29247224","65","18925118"
"chr3","48172960","48173249","chr3","178754819","178755107","51","130581859"
"chr3","48179702","48179860","chr2","95353469","95353624","15","47173767"
"chr3","48180175","48180305","chr2","95353003","95353133","7","47172828"
"chr3","48194480","48194587","chr2","98262271","98262382","23","50067791"
"chr3","48196140","48196434","chr2","95335450","95335749","32","47139310"
"chr3","48217910","48218126","chr2","95312128","95312323","30","47094218"
"chr3","48222400","48222535","chr11","62741170","62741305","20","14518770"
"chr3","48226535","48226652","chr4","97389877","97390000","32","49163342"
"chr3","48228260","48228564","chr2","95298698","95298977","39","47070438"
"chr3","48239372","48239653","chr2","95286725","95287006","23","47047353"
"chr3","48250067","48250350","chr2","95276057","95276339","17","47025990"
"chr3","48265263","48265562","chr2","95262701","95262998","20","46997438"
"chr3","48267188","48267488","chr2","95260786","95261086","19","46993598"
"chr3","48278609","48278888","chr2","95248218","95248500","19","46969609"
"chr3","48280591","48280871","chr2","95246155","95246436","20","46965564"
"chr3","48290651","48290955","chr18","28647220","28647521","54","19643431"
"chr3","48295769","48296066","chr2","95230647","95230952","24","46934878"
"chr3","48301969","48302283","chr2","95223788","95224105","22","46921819"
"chr3","48303954","48304178","chr2","95221863","95222119","43","46917909"
"chr3","48304428","48304679","chr3","126794297","126794543","50","78489869"
"chr3","48313483","48313789","chr3","43321649","43321949","75","4991834"
"chr3","48314306","48314568","chr2","95215198","95215459","13","46900892"
"chr3","48316611","48316731","chr2","95213193","95213314","8","46896582"
"chr3","48320798","48321093","chr2","95209104","95209398","18","46888306"
"chr3","48324695","48324998","chr2","95204884","95205181","44","46880189"
"chr3","48327064","48327334","chr15","17905215","17905491","62","30421849"
"chr3","48329980","48330266","chr2","95201993","95202274","25","46872013"
"chr3","48338568","48338868","chr2","95190860","95191168","28","46852292"
"chr3","48339129","48339401","chr2","95190308","95190583","32","46851179"
"chr3","48347548","48347776","chr2","95181980","95182208","18","46834432"
"chr3","48362298","48362520","chr1","9617419","9617649","60","38744879"
"chr3","48364699","48364991","chr3","124267629","124267922","59","75902930"
"chr3","48365706","48366002","chr2","95159163","95159464","34","46793457"
"chr3","48373434","48373732","chr2","95150815","95151107","28","46777381"
"chr3","48386018","48386315","chr2","95130253","95130563","38","46744235"
"chr3","48388036","48388242","chr7","18986491","18986688","43","29401545"
"chr3","48390646","48390948","chr2","95126273","95126546","50","46735627"
"chr3","48391867","48392164","chr2","95125016","95125310","18","46733149"
"chr3","48394202","48394324","chr2","169133199","169133321","20","120738997"
"chr3","48399542","48399829","chr14","7051780","7052083","62","41347762"
"chr3","48402738","48403041","chr2","95112894","95113193","18","46710156"
"chr3","48439436","48439727","chr1","53106748","53107031","51","4667312"
"chr3","48449745","48450041","chr2","95065115","95065419","28","46615370"
"chr3","48454129","48454430","chr2","95060016","95060318","27","46605887"
"chr3","48456086","48456376","chr5","82084686","82084965","64","33628600"
"chr3","48467077","48467253","chr19","36617059","36617221","47","11850018"
"chr3","48467568","48467617","chr1","93015201","93015250","7","44547633"
"chr3","48468736","48469034","chr15","43687639","43687935","50","4781097"
"chr3","48470044","48470350","chr3","43455801","43456111","58","5014243"
"chr3","48493574","48493852","chr14","18566419","18566712","54","29927155"
"chr3","48495280","48495517","chr14","18568163","18568424","37","29927117"
"chr3","48507135","48507308","chr3","41155065","41155246","48","7352070"
"chr3","48508294","48508347","chr3","40869130","40869181","10","7639164"
"chr3","48511827","48512095","chr2","94997486","94997776","45","46485659"
"chr3","48524760","48525046","chr3","46680596","46680884","59","1844164"
"chr3","48532645","48532937","chr2","94979807","94980095","19","46447162"
"chr3","48533157","48533456","chr4","159090526","159090826","49","110557369"
"chr3","48549902","48550186","chr2","94961508","94961789","24","46411606"
"chr3","48554049","48554337","chr1","1724256","1724542","56","46829793"
"chr3","48563478","48563772","chr2","94953903","94954198","21","46390425"
"chr3","48599096","48599231","chr2","94916218","94916365","24","46317122"
"chr3","48599526","48599661","chr2","94915774","94915908","10","46316248"
"chr3","48619871","48620182","chr2","94893174","94893491","32","46273303"
"chr3","48632406","48632684","chr2","94878600","94878878","20","46246194"
"chr3","48643408","48643673","chr2","94866889","94867175","34","46223481"
"chr3","48645797","48646104","chr2","94863847","94864154","28","46218050"
"chr3","48649984","48650287","chr2","94859340","94859645","20","46209356"
"chr3","48652119","48652428","chr7","150795674","150795979","58","102143555"
"chr3","48653564","48653851","chr2","94855818","94856106","20","46202254"
"chr3","48666987","48667023","chr17","2268417","2268452","4","46398570"
"chr3","48668962","48669086","chr2","94842155","94842279","8","46173193"
"chr3","48675742","48675803","chr2","94833751","94833812","2","46158009"
"chr3","48688255","48688378","chr2","94824557","94824695","21","46136302"
"chr3","48689401","48689630","chr2","94824154","94824385","16","46134753"
"chr3","48693500","48693641","chr11","114085615","114085755","29","65392115"
"chr3","48697494","48697724","chr2","94816016","94816246","22","46118522"
"chr3","48698020","48698052","chr20","51323785","51323817","6","2625765"
"chr3","48705026","48705323","chr2","94808568","94808852","43","46103542"
"chr3","48718060","48718109","chr19","873794","873842","11","47844266"
"chr3","48724747","48725024","chr3","69139050","69139315","74","20414303"
"chr3","48726118","48726198","chr5","185046850","185046932","16","136320732"
"chr3","48730414","48730704","chr17","80944041","80944326","64","32213627"
"chr3","48733499","48733659","chr2","94784133","94784293","15","46050634"
"chr3","48735701","48735819","chr7","112228179","112228294","23","63492478"
"chr3","48736116","48736238","chr7","68599953","68600068","37","19863837"
"chr3","48737454","48737768","chr2","94779436","94779745","30","46041982"
"chr3","48739655","48739961","chr2","94776937","94777243","19","46037282"
"chr3","48763752","48764031","chr2","94754652","94754928","19","45990900"
"chr3","48771836","48772132","chr2","94745228","94745514","38","45973392"
"chr3","48808923","48809227","chr1","44230646","44230948","55","4578277"
"chr3","48823782","48823905","chr2","94689900","94690033","14","45866118"
"chr3","48842034","48842329","chr8","8368623","8368919","56","40473411"
"chr3","48851553","48851846","chr2","94656296","94656585","22","45804743"
"chr3","48872082","48872306","chr5","129630846","129631050","71","80758764"
"chr3","48888720","48889010","chr2","94618740","94619025","27","45730020"
"chr3","48889442","48889686","chr2","94618129","94618330","56","45728687"
"chr3","48893482","48893595","chr2","94614167","94614280","13","45720685"
"chr3","48894512","48894815","chr1","190781513","190781814","62","141887001"
"chr3","48906757","48907061","chr2","94602467","94602780","45","45695710"
"chr3","48909973","48910258","chr18","52205960","52206247","54","3295987"
"chr3","48929026","48929266","chr18","20955709","20955949","46","27973317"
"chr3","48934641","48934923","chr2","94573656","94573923","29","45639015"
"chr3","48940743","48940929","chr3","43682713","43682905","39","5258030"
"chr3","48950204","48950411","chr1","125104979","125105165","49","76154775"
"chr3","48950655","48950955","chr14","3345341","3345646","62","45605314"
"chr3","48971887","48972172","chr2","94539176","94539462","15","45567289"
"chr3","48984663","48984980","chr2","94527124","94527442","20","45542461"
"chr3","48993701","48993818","chr2","94520285","94520392","15","45526584"
"chr3","48995949","48996225","chr2","94517922","94518199","20","45521973"
"chr3","49006825","49007143","chr2","94505588","94505907","26","45498763"
"chr3","49024101","49024401","chr2","94487658","94487960","19","45463557"
"chr3","49033735","49033868","chr1","26561536","26561668","27","22472199"
"chr3","49048181","49048417","chr2","94458367","94458592","28","45410186"
"chr3","49063787","49063946","chr9","26751852","26752004","38","22311935"
"chr3","49066000","49066346","chr2","94439416","94439764","53","45373416"
"chr3","49070476","49070636","chr7","93993532","93993685","41","44923056"
"chr3","49070686","49070794","chr3","55571720","55571831","20","6501034"
"chr3","49072422","49072712","chr15","43687639","43687935","63","5384783"
"chr3","49073697","49074004","chr2","94431489","94431773","37","45357792"
"chr3","49079514","49079873","chr8","23000386","23000729","96","26079128"
"chr3","49091037","49091290","chr2","94414266","94414518","17","45323229"
"chr3","49096520","49096807","chr2","94407045","94407318","51","45310525"
"chr3","49108493","49108786","chr2","94391356","94391652","26","45282863"
"chr3","49112137","49112363","chr2","94389516","94389745","22","45277379"
"chr3","49115393","49115665","chr10","41342964","41343242","60","7772429"
"chr3","49137638","49137751","chr2","94361421","94361537","14","45223783"
"chr3","49147728","49147900","chr2","94349676","94349857","25","45201948"
"chr3","49149868","49149997","chr13","87095059","87095190","16","37945191"
"chr3","49159895","49160105","chr19","39028175","39028394","40","10131720"
"chr3","49169560","49169876","chr2","93967367","93967677","76","44797807"
"chr3","49171694","49171816","chr2","94316379","94316500","12","45144685"
"chr3","49177060","49177338","chr2","94310371","94310648","20","45133311"
"chr3","49182747","49183037","chr2","94304005","94304328","58","45121258"
"chr3","49189766","49189966","chr2","94297172","94297353","25","45107406"
"chr3","49190257","49190389","chr2","94296754","94296879","17","45106497"
"chr3","49217348","49217570","chr2","141341147","141341369","46","92123799"
"chr3","49282247","49282547","chr2","94192165","94192475","41","44909918"
"chr3","49283320","49283606","chr2","94191106","94191397","20","44907786"
"chr3","49297084","49297168","chr2","94177262","94177346","2","44880178"
"chr3","49303041","49303319","chr2","94170908","94171161","45","44867867"
"chr3","49342197","49342485","chr2","94124388","94124677","11","44782191"
"chr3","49405611","49405825","chr2","94057768","94057983","22","44652157"
"chr3","49446591","49446894","chr2","94015922","94016247","64","44569331"
"chr3","49449171","49449331","chr2","94013055","94013214","10","44563884"
"chr3","49456521","49456813","chr3","124267629","124267922","45","74811108"
"chr3","49456985","49457292","chr2","94004005","94004322","36","44547020"
"chr3","49460274","49460414","chr2","93999468","93999607","13","44539194"
"chr3","49460721","49460885","chr2","93998979","93999148","17","44538258"
"chr3","49474795","49475064","chr2","93984206","93984474","13","44509411"
"chr3","49477261","49477480","chr2","93979931","93980136","25","44502670"
"chr3","49493560","49493836","chr2","93967367","93967677","53","44473807"
"chr3","49509608","49509815","chr2","93948387","93948597","16","44438779"
"chr3","49515633","49515757","chr4","6988605","6988727","21","42527028"
"chr3","49534983","49535198","chr5","56540327","56540546","48","7005344"
"chr3","49536520","49536835","chr2","93921101","93921386","54","44384581"
"chr3","49538448","49538674","chr19","5642965","5643188","40","43895483"
"chr3","49545315","49545613","chr15","34234250","34234544","57","15311065"
"chr3","49548798","49549017","chr2","93909368","93909574","22","44360570"
"chr3","49559451","49559743","chr2","93896216","93896491","41","44336765"
"chr3","49619613","49619924","chr2","93835002","93835310","22","44215389"
"chr3","49622732","49622924","chr2","93831404","93831604","34","44208672"
"chr3","49678922","49679235","chr2","93772374","93772688","19","44093452"
"chr3","49700121","49700277","chr1","44817809","44817958","37","4882312"
"chr3","49700784","49700889","chr13","31634723","31634833","22","18066061"
"chr3","49701192","49701356","chr10","83659293","83659458","31","33958101"
"chr3","49704811","49704972","chr19","28521693","28521857","28","21183118"
"chr3","49707460","49707732","chr9","93248519","93248787","68","43541059"
"chr3","49708266","49708522","chr2","93748053","93748304","23","44039787"
"chr3","49710845","49711130","chr2","93745417","93745684","34","44034572"
"chr3","49714658","49714786","chr20","54797040","54797166","23","5082382"
"chr3","49715085","49715249","chr19","6987858","6988025","42","42727227"
"chr3","49749160","49749463","chr2","93701177","93701474","26","43952017"
"chr3","49750914","49751096","chr9","59337601","59337779","36","9586687"
"chr3","49751398","49751513","chr2","93698408","93698523","8","43947010"
"chr3","49753720","49753899","chr1","115380309","115380494","44","65626589"
"chr3","49767176","49767326","chr2","93688140","93688268","35","43920964"
"chr3","49780597","49780882","chr11","109186448","109186735","44","59405851"
"chr3","49799757","49799948","chr1","34916004","34916198","41","14883753"
"chr3","49805637","49805831","chr2","93648730","93648924","14","43843093"
"chr3","49809885","49810153","chr2","93638448","93638717","11","43828563"
"chr3","49817639","49817922","chr8","129433118","129433406","58","79615479"
"chr3","49824827","49825112","chr2","93617189","93617474","17","43792362"
"chr3","49834689","49834979","chr2","93606143","93606430","38","43771454"
"chr3","49837673","49837906","chr2","93603319","93603577","39","43765646"
"chr3","49843325","49843481","chr16","48023623","48023770","30","1819702"
"chr3","49843782","49843953","chr2","93600053","93600226","15","43756271"
"chr3","49851936","49852231","chr2","93593773","93594069","21","43741837"
"chr3","49861104","49861383","chr7","10646642","10646913","58","39214462"
"chr3","49876702","49876978","chr7","153194818","153195090","65","103318116"
"chr3","49890409","49890634","chr2","93554282","93554509","28","43663873"
"chr3","49897884","49898089","chr2","93546655","93546863","36","43648771"
"chr3","49911175","49911235","chr9","58719520","58719575","20","8808345"
"chr3","49911252","49911389","chr2","93533856","93533996","13","43622604"
"chr3","49911693","49911870","chr2","93533374","93533553","12","43621681"
"chr3","49914278","49914552","chr1","37126383","37126644","60","12787895"
"chr3","49930399","49930677","chr2","93511306","93511583","19","43580907"
"chr3","49937349","49937470","chr2","93505083","93505199","7","43567734"
"chr3","49978036","49978147","chr2","93453462","93453571","10","43475426"
"chr3","49978456","49978523","chr2","93453102","93453167","10","43474646"
"chr3","50060236","50060521","chr9","95575173","95575462","59","45514937"
"chr3","50073207","50073448","chr9","35203725","35203980","61","14869482"
"chr3","50074474","50074674","chr2","93305000","93305200","14","43230526"
"chr3","50077678","50077976","chr2","93301336","93301639","29","43223658"
"chr3","50101277","50101563","chr2","93274826","93275127","33","43173549"
"chr3","50107215","50107481","chr2","93268762","93269064","53","43161547"
"chr3","50111128","50111336","chr1","124805622","124805832","46","74694494"
"chr3","50122229","50122500","chr13","95242483","95242755","68","45120254"
"chr3","50184620","50184868","chr2","93196641","93196872","48","43012021"
"chr3","50187258","50187543","chr6","68750302","68750588","50","18563044"
"chr3","50220629","50220651","chr2","93161706","93161730","3","42941077"
"chr3","50221572","50221759","chr2","93160596","93160776","19","42939024"
"chr3","50249620","50249927","chr4","157575558","157575861","76","107325938"
"chr3","50255297","50255611","chr2","93120329","93120641","18","42865032"
"chr3","50287910","50288019","chr2","93085960","93086069","4","42798050"
"chr3","50293147","50293290","chr12","51557433","51557575","36","1264286"
"chr3","50293584","50293789","chr6","4944357","4944557","47","45349227"
"chr3","50301349","50301456","chr2","93071221","93071331","8","42769872"
"chr3","50303460","50303734","chr2","93069072","93069343","25","42765612"
"chr3","50311392","50311515","chr3","57790746","57790867","19","7479354"
"chr3","50311552","50311729","chr15","88492699","88492875","35","38181147"
"chr3","50318535","50318652","chr2","93056169","93056285","10","42737634"
"chr3","50318919","50319146","chr10","91923764","91924004","59","41604845"
"chr3","50335169","50335341","chr3","36378214","36378355","54","13956955"
"chr3","50338175","50338381","chr2","93032866","93033072","10","42694691"
"chr3","50341154","50341424","chr2","93029856","93030159","47","42688702"
"chr3","50367982","50368176","chr11","95142362","95142556","46","44774380"
"chr3","50373704","50373855","chr3","124791642","124791791","29","74417938"
"chr3","50377677","50377969","chr2","92989943","92990249","42","42612266"
"chr3","50388485","50388608","chr13","9638870","9638993","20","40749615"
"chr3","50388708","50388820","chrX","97916876","97916974","27","47528168"
"chr3","50391823","50392006","chr13","37621224","37621407","35","12770599"
"chr3","50560577","50560861","chr2","92964475","92964763","24","42403898"
"chr3","50569341","50569468","chr2","92955794","92955921","8","42386453"
"chr3","50569769","50569927","chr12","21323547","21323703","33","29246222"
"chr3","50576607","50576907","chr2","92951862","92952154","44","42375255"
"chr3","50602258","50602414","chr9","11445686","11445863","51","39156572"
"chr3","50623230","50623516","chr2","92893902","92894210","38","42270672"
"chr3","50643441","50643770","chr19","6953784","6954109","74","43689657"
"chr3","50651922","50652198","chr2","92863474","92863751","17","42211552"
"chr3","50653726","50654038","chr2","92860007","92860322","26","42206281"
"chr3","50673662","50673937","chr19","14368657","14368933","63","36305005"
"chr3","50691410","50691539","chr2","92814805","92814935","5","42123395"
"chr3","50692556","50692849","chr2","92813495","92813793","17","42120939"
"chr3","50697442","50697572","chr2","92807766","92807887","20","42110324"
"chr3","50751336","50751615","chr2","92751150","92751429","40","41999814"
"chr3","50878942","50879093","chr2","92625425","92625580","22","41746483"
"chr3","50897478","50897622","chr2","92606028","92606189","28","41708550"
"chr3","50897930","50898074","chr2","92605572","92605717","9","41707642"
"chr3","50899925","50900226","chr2","92602976","92603278","21","41703051"
"chr3","50903070","50903364","chr2","92599575","92599861","18","41696505"
"chr3","50905042","50905157","chr11","19818584","19818699","18","31086458"
"chr3","50910719","50910909","chr3","60742818","60742996","53","9832099"
"chr3","50911219","50911265","chr2","92589317","92589363","2","41678098"
"chr3","50921134","50921330","chr19","44019178","44019366","50","6901956"
"chr3","50923520","50923635","chr2","92573485","92573600","8","41649965"
"chr3","50928278","50928569","chr2","92566990","92567293","32","41638712"
"chr3","50933869","50934159","chr2","92562586","92562878","29","41628717"
"chr3","50939780","50940072","chr2","107404547","107404835","63","56464767"
"chr3","50946439","50946717","chr2","92543706","92543974","35","41597267"
"chr3","50947479","50947780","chr2","56803979","56804276","58","5856500"
"chr3","50950766","50951022","chr9","32406558","32406824","73","18544208"
"chr3","50958111","50958340","chr2","92531604","92531797","53","41573493"
"chr3","50986365","50986657","chr2","92503065","92503359","28","41516700"
"chr3","50993618","50993901","chr8","41469111","41469397","64","9524507"
"chr3","50995952","50996268","chr2","92493282","92493590","26","41497330"
"chr3","51002938","51003233","chr2","92484417","92484738","37","41481479"
"chr3","51022893","51023197","chr2","92464957","92465267","26","41442064"
"chr3","51048171","51048465","chr2","92439204","92439486","27","41391033"
"chr3","51073561","51073687","chr4","123111964","123112088","22","72038403"
"chr3","51095032","51095228","chr2","92392609","92392805","7","41297577"
"chr3","51113559","51113681","chr2","92375276","92375405","17","41261717"
"chr3","51117022","51117182","chr7","84537557","84537711","31","33420535"
"chr3","51126661","51126957","chr2","92362735","92363015","52","41236074"
"chr3","51139712","51139810","chr14","107549055","107549153","21","56409343"
"chr3","51168986","51169266","chr2","92323738","92324040","37","41154752"
"chr3","51172419","51172703","chr2","92319897","92320207","61","41147478"
"chr3","51175729","51175880","chr2","92316189","92316340","10","41140460"
"chr3","51177336","51177645","chr2","92313772","92314079","14","41136436"
"chr3","51179614","51179926","chr20","57286075","57286381","61","6106461"
"chr3","51203566","51203865","chr2","92295283","92295587","25","41091717"
"chr3","51227888","51228195","chr2","92268667","92268950","48","41040779"
"chr3","51251289","51251570","chr2","92240167","92240448","23","40988878"
"chr3","51257917","51258114","chr2","92234410","92234617","27","40976493"
"chr3","51260004","51260297","chr7","140100928","140101221","72","88840924"
"chr3","51267781","51268083","chr2","92221914","92222217","18","40954133"
"chr3","51278031","51278261","chr2","92211287","92211511","20","40933256"
"chr3","51282667","51282809","chr16","50398074","50398218","34","884593"
"chr3","51386378","51386674","chr2","92096757","92097059","23","40710379"
"chr3","51434704","51434987","chr2","92046689","92046981","25","40611985"
"chr3","51457207","51457365","chr2","92025512","92025675","10","40568305"
"chr3","51457650","51457777","chr2","92025095","92025227","15","40567445"
"chr3","51494265","51494569","chr2","91979788","91980094","19","40485523"
"chr3","51508582","51508604","chr3","44466709","44466727","7","7041873"
"chr3","51508631","51508794","chr11","56432796","56432956","41","4924165"
"chr3","51562787","51562926","chr2","91910810","91910949","15","40348023"
"chr3","51759164","51759472","chr2","91715857","91716165","20","39956693"
"chr3","51760687","51760886","chr3","45308673","45308867","53","6452014"
"chr3","51783959","51784096","chr2","91690263","91690400","13","39906304"
"chr3","51784390","51784569","chr2","91689787","91689963","13","39905397"
"chr3","51844196","51844361","chr2","91631064","91631239","31","39786868"
"chr3","51844669","51844827","chr2","91630602","91630760","12","39785933"
"chr3","51857356","51857653","chr2","91615306","91615606","27","39757950"
"chr3","51866526","51866799","chr2","91599500","91599768","19","39732974"
"chr3","51879883","51880134","chr2","91586293","91586538","25","39706410"
"chr3","51896239","51896529","chr3","126975901","126976192","57","75079662"
"chr3","51899919","51900205","chrX","130394514","130394787","54","78494595"
"chr3","51919029","51919339","chr7","84841819","84842127","68","32922790"
"chr3","51925161","51925467","chr2","91576223","91576495","50","39651062"
"chr3","51972597","51972866","chr11","34412609","34412876","57","17559988"
"chr3","51974707","51974968","chr2","91532189","91532472","32","39557482"
"chr3","51975944","51976232","chr5","138937198","138937473","64","86961254"
"chr3","51978095","51978382","chr2","91528888","91529160","37","39550793"
"chr3","51987262","51987553","chr2","91518156","91518456","25","39530894"
"chr3","52013204","52013501","chr6","105142168","105142470","60","53128964"
"chr3","52018615","52018780","chrX","5568422","5568585","38","46450193"
"chr3","52018806","52018921","chr6","139383516","139383625","23","87364710"
"chr3","52109657","52109850","chr3","38240090","38240274","43","13869567"
"chr3","52134788","52134918","chr13","27834088","27834218","26","24300700"
"chr3","52195532","52195832","chr2","200415452","200415748","62","148219920"
"chr3","52212933","52213190","chr2","91270866","91271123","14","39057933"
"chr3","52235437","52235728","chr2","91249177","91249472","27","39013740"
"chr3","52263402","52263709","chr3","48763727","48764022","59","3499675"
"chr3","52276138","52276413","chr2","91205890","91206181","33","38929752"
"chr3","52298054","52298324","chr2","91178298","91178570","14","38880244"
"chr3","52317289","52317592","chr2","91159598","91159896","34","38842309"
"chr3","52320642","52320948","chr2","91156416","91156694","50","38835774"
"chr3","52347707","52347950","chr2","91137747","91138017","47","38790040"
"chr3","52390805","52391088","chr2","91088999","91089319","50","38698194"
"chr3","52461534","52461741","chr2","91013651","91013860","16","38552117"
"chr3","52463330","52463670","chr1","114742834","114743167","95","62279504"
"chr3","52471472","52471794","chr2","91004593","91004900","29","38533121"
"chr3","52472767","52473049","chr2","91003346","91003620","32","38530579"
"chr3","52580110","52580405","chr2","163045985","163046280","63","110465875"
"chr3","52592954","52593170","chr2","90877880","90878109","35","38284926"
"chr3","52593336","52593637","chr9","97547569","97547870","57","44954233"
"chr3","52598555","52598838","chr2","90872768","90873039","29","38274213"
"chr3","52604412","52604687","chr2","90865927","90866211","30","38261515"
"chr3","52610422","52610746","chr2","90860198","90860538","34","38249776"
"chr3","52614159","52614291","chr2","90856353","90856484","12","38242194"
"chr3","52617860","52618151","chr1","191690399","191690678","71","139072539"
"chr3","52619510","52619801","chr2","90850907","90851194","22","38231397"
"chr3","52634324","52634621","chr2","90842448","90842748","21","38208124"
"chr3","52640203","52640462","chr7","136741250","136741509","13","84101047"
"chr3","52643358","52643489","chr3","14224227","14224360","23","38419131"
"chr3","52649873","52650169","chr3","175740532","175740833","63","123090659"
"chr3","52664541","52664853","chr2","90828770","90829079","30","38164229"
"chr3","52675882","52676083","chr2","90816049","90816251","10","38140167"
"chr3","52678619","52678750","chr2","90813351","90813480","10","38134732"
"chr3","52683064","52683353","chr2","90808086","90808383","47","38125022"
"chr3","52683713","52683925","chr2","90807508","90807725","33","38123795"
"chr3","52687407","52687722","chr20","34220772","34221074","75","18466635"
"chr3","52690143","52690457","chr2","90800619","90800928","17","38110476"
"chr3","52708967","52709300","chr2","90782408","90782706","55","38073441"
"chr3","52714144","52714386","chr1","8008407","8008640","54","44705737"
"chr3","52715071","52715370","chr2","90776122","90776419","19","38061051"
"chr3","52719964","52720270","chr2","90770164","90770455","30","38050200"
"chr3","52753690","52753865","chr2","90735980","90736163","19","37982290"
"chr3","52768837","52769136","chr3","124267629","124267922","53","71498792"
"chr3","52769522","52769635","chr2","90718338","90718451","6","37948816"
"chr3","52779587","52779884","chr2","90708218","90708530","38","37928631"
"chr3","52779944","52780235","chr2","90707874","90708162","20","37927930"
"chr3","52782999","52783292","chr2","90704344","90704625","39","37921345"
"chr3","52790933","52791228","chr1","43902169","43902461","55","8888764"
"chr3","52797014","52797295","chr5","78689579","78689868","53","25892565"
"chr3","52895334","52895558","chr2","90596817","90597041","10","37701483"
"chr3","52897139","52897256","chr13","89958796","89958914","16","37061657"
"chr3","52935625","52935887","chr9","36221090","36221345","69","16714535"
"chr3","52955936","52956231","chr2","107411533","107411833","57","54455597"
"chr3","53005438","53005743","chr3","9401615","9401923","56","43603823"
"chr3","53046551","53046823","chr2","90363908","90364180","13","37317357"
"chr3","53092188","53092482","chr2","90316209","90316496","21","37224021"
"chr3","53093297","53093578","chr2","90315102","90315387","38","37221805"
"chr3","53110724","53111000","chr2","90296427","90296711","35","37185703"
"chr3","53201871","53202164","chr2","90193385","90193683","16","36991514"
"chr3","53204103","53204260","chr2","90191292","90191449","15","36987189"
"chr3","53204559","53204702","chr2","90190842","90190987","9","36986283"
"chr3","53317279","53317596","chr2","90075940","90076261","29","36758661"
"chr3","53321840","53322128","chr2","90071584","90071873","16","36749744"
"chr3","53359593","53359871","chr2","90039073","90039336","29","36679480"
"chr3","53372937","53373236","chr2","90025239","90025547","24","36652302"
"chr3","53375556","53375856","chr2","90022293","90022594","16","36646737"
"chr3","53387007","53387274","chr7","40038584","40038849","55","13348423"
"chr3","53445893","53446202","chr3","125514119","125514427","72","72068226"
"chr3","53481095","53481434","chr9","99101491","99101790","76","45620396"
"chr3","53504298","53504614","chr2","89883120","89883432","25","36378822"
"chr3","53630820","53631114","chr1","44171967","44172258","56","9458853"
"chr3","53639814","53639959","chr2","89732390","89732535","9","36092576"
"chr3","53640263","53640432","chr2","89731923","89732087","17","36091660"
"chr3","53696303","53696600","chr2","89674256","89674534","37","35977953"
"chr3","53749671","53749983","chr2","89619040","89619335","41","35869369"
"chr3","53750310","53750615","chr8","101745971","101746276","64","47995661"
"chr3","53753920","53754042","chr2","89614462","89614586","6","35860542"
"chr3","53773983","53774270","chr2","89585582","89585874","23","35811599"
"chr3","53775574","53775879","chr2","89583968","89584273","11","35808394"
"chr3","53782901","53783207","chr5","139723153","139723449","53","85940252"
"chr3","53801817","53802092","chr8","41859109","41859389","70","11942708"
"chr3","53814806","53814929","chr13","25546692","25546816","23","28268114"
"chr3","53824317","53824526","chr2","89536505","89536714","18","35712188"
"chr3","53828796","53829068","chr2","89531800","89532067","24","35703004"
"chr3","53834505","53834797","chr2","89526803","89527098","20","35692298"
"chr3","53852128","53852425","chr2","89506843","89507143","21","35654715"
"chr3","53877476","53877767","chr2","89481907","89482186","21","35604431"
"chr3","53890499","53890784","chr2","89464960","89465246","19","35574461"
"chr3","53890800","53891088","chr2","89464657","89464945","11","35573857"
"chr3","53911216","53911510","chr2","89434641","89434934","21","35523425"
"chr3","53914157","53914439","chr9","21275712","21275996","54","32638445"
"chr3","53916082","53916370","chr2","89429543","89429829","27","35513461"
"chr3","53926915","53927216","chr2","89420638","89420941","49","35493723"
"chr3","53939205","53939486","chr10","83280375","83280654","68","29341170"
"chr3","53940407","53940685","chr2","89406799","89407066","29","35466392"
"chr3","54023868","54024182","chr6","32190256","32190566","57","21833612"
"chr3","54025831","54026116","chr2","89319721","89320017","30","35293890"
"chr3","54094973","54095273","chr2","89244936","89245221","31","35149963"
"chr3","54108083","54108362","chr2","89232470","89232748","23","35124387"
"chr3","54108414","54108700","chr2","134217641","134217927","60","80109227"
"chr3","54114740","54115030","chr2","97391256","97391543","62","43276516"
"chr3","54116894","54117194","chr2","89226220","89226529","35","35109326"
"chr3","54117877","54118173","chr2","89225203","89225506","30","35107326"
"chr3","54134250","54134544","chr2","89209040","89209338","21","35074790"
"chr3","54145561","54145683","chr10","87818140","87818263","14","33672579"
"chr3","54164633","54164941","chr11","48401419","48401716","62","5763214"
"chr3","54170454","54170667","chr2","89168932","89169145","16","34998478"
"chr3","54174640","54174939","chr2","89165943","89166243","23","34991303"
"chr3","54187925","54188216","chr2","89150914","89151205","30","34962989"
"chr3","54194215","54194523","chr2","89143382","89143685","29","34949167"
"chr3","54200987","54201284","chr3","15235139","15235443","54","38965848"
"chr3","54201922","54202044","chr2","89134587","89134709","4","34932665"
"chr3","54210671","54210962","chr2","89124071","89124367","27","34913400"
"chr3","54222521","54222820","chr15","43687639","43687935","46","10534882"
"chr3","54223229","54223492","chr2","89111648","89111912","22","34888419"
"chr3","54233296","54233624","chr11","27900299","27900628","71","26332997"
"chr3","54236388","54236597","chr2","89098776","89098984","17","34862388"
"chr3","54242907","54243205","chr2","89092162","89092457","20","34849255"
"chr3","54244706","54244987","chr3","43111551","43111841","62","11133155"
"chr3","54249546","54249816","chr2","89084506","89084794","39","34834960"
"chr3","54253830","54254123","chr2","89080031","89080313","55","34826201"
"chr3","54254857","54255129","chr2","89079024","89079305","22","34824167"
"chr3","54259939","54260062","chr2","89074120","89074237","17","34814181"
"chr3","54260436","54260549","chr2","89073630","89073736","9","34813194"
"chr3","54275678","54275996","chr2","89056857","89057173","21","34781179"
"chr3","54284051","54284271","chr2","89047385","89047606","38","34763334"
"chr3","54293749","54293853","chr2","89034971","89035072","9","34741222"
"chr3","54342347","54342512","chr2","88980807","88980968","17","34638460"
"chr3","54371698","54372008","chr14","109630730","109631041","60","55259032"
"chr3","54374007","54374093","chr1","84694027","84694113","13","30320020"
"chr3","54403268","54403515","chr2","88924457","88924686","30","34521189"
"chr3","54414805","54415100","chr2","88910758","88911048","18","34495953"
"chr3","54417198","54417325","chr2","88908857","88908983","5","34491659"
"chr3","54428054","54428260","chr2","52074271","52074472","52","2353783"
"chr3","54429122","54429301","chr2","113985226","113985394","34","59556104"
"chr3","54441122","54441430","chr2","88878170","88878465","42","34437048"
"chr3","54447714","54448010","chr2","88872613","88872909","19","34424899"
"chr3","54469712","54469724","chr16","16366672","16366683","1","38103040"
"chr3","54469752","54470038","chr2","88848063","88848351","15","34378311"
"chr3","54473239","54473353","chr3","50347916","50348033","21","4125323"
"chr3","54475066","54475354","chr16","55700437","55700720","68","1225371"
"chr3","54475362","54475671","chr1","188530204","188530518","67","134054842"
"chr3","54480718","54480956","chr20","29246987","29247224","53","25233731"
"chr3","54500622","54500925","chr2","88822700","88823000","23","34322078"
"chr3","54528715","54528989","chr2","88793858","88794136","20","34265143"
"chr3","54530511","54530671","chrX","19470669","19470831","37","35059842"
"chr3","54536347","54536512","chr20","24073514","24073680","40","30462833"
"chr3","54541955","54542255","chr10","36075148","36075449","66","18466807"
"chr3","54560759","54561045","chr2","88768738","88769024","16","34207979"
"chr3","54565406","54565712","chr2","88764214","88764498","32","34198808"
"chr3","54569976","54570291","chr2","88759587","88759903","22","34189611"
"chr3","54571189","54571428","chr8","22085064","22085297","48","32486125"
"chr3","54572487","54572772","chr2","88757042","88757323","25","34184555"
"chr3","54574177","54574483","chr9","109164176","109164476","57","54589999"
"chr3","54607929","54608109","chr2","88720898","88721077","15","34112969"
"chr3","54620467","54620741","chr2","88709492","88709766","18","34089025"
"chr3","54626807","54626944","chr2","88703234","88703354","24","34076427"
"chr3","54627271","54627440","chr2","88702783","88702940","21","34075512"
"chr3","54635034","54635277","chr2","88694597","88694845","17","34059563"
"chr3","54637521","54637841","chr2","88691716","88692032","43","34054195"
"chr3","54642436","54642732","chr1","34579373","34579669","55","20063063"
"chr3","54644050","54644356","chr2","88685240","88685573","52","34041190"
"chr3","54666606","54666917","chr2","88661417","88661727","29","33994811"
"chr3","54681395","54681673","chr2","88646233","88646540","43","33964838"
"chr3","54690400","54690694","chr2","88637221","88637526","35","33946821"
"chr3","54701834","54702120","chr2","88625779","88626084","35","33923945"
"chr3","54770573","54770877","chr2","88556006","88556310","15","33785433"
"chr3","54841923","54842254","chr2","88482773","88483070","54","33640850"
"chr3","54849304","54849624","chr2","88471687","88472001","26","33622383"
"chr3","54855564","54855877","chr2","88465771","88466087","22","33610207"
"chr3","54870569","54870893","chr2","88450123","88450419","48","33579554"
"chr3","54895576","54895874","chr2","88423790","88424083","26","33528214"
"chr3","54896127","54896427","chr2","88423236","88423536","17","33527109"
"chr3","54938481","54938611","chr8","124405124","124405255","20","69466643"
"chr3","54995909","54996186","chr2","88322786","88323051","21","33326877"
"chr3","54999207","54999503","chr2","88319143","88319439","39","33319936"
"chr3","55000830","55001125","chr2","88316927","88317237","50","33316097"
"chr3","55008377","55008501","chr2","88309131","88309254","4","33300754"
"chr3","55025080","55025363","chr2","88290853","88291144","19","33265773"
"chr3","55042967","55043152","chr8","63839498","63839666","50","8796531"
"chr3","55070092","55070377","chr2","88236637","88236927","23","33166545"
"chr3","55110964","55111227","chr2","88202474","88202740","22","33091510"
"chr3","55152704","55152824","chr2","88162397","88162517","7","33009693"
"chr3","55171745","55172054","chr2","88144364","88144679","24","32972619"
"chr3","55173574","55173896","chr2","88142533","88142854","55","32968959"
"chr3","55195804","55196095","chr7","71549523","71549809","49","16353719"
"chr3","55200507","55200792","chr2","88112106","88112389","18","32911599"
"chr3","55227729","55228039","chr2","144665893","144666197","61","89438164"
"chr3","55242617","55242885","chr2","88070211","88070485","13","32827594"
"chr3","55258765","55258778","chr20","51748386","51748399","2","3510379"
"chr3","55259513","55259695","chr2","62606466","62606649","45","7346953"
"chr3","55386368","55386655","chr2","87925630","87925915","26","32539262"
"chr3","55389549","55389681","chr17","7192625","7192755","19","48196924"
"chr3","55410340","55410608","chr8","30257500","30257766","63","25152840"
"chr3","55460802","55461119","chr2","87855631","87855950","30","32394829"
"chr3","55478764","55478986","chr2","87836732","87836953","22","32357968"
"chr3","55707023","55707346","chr19","34715146","34715458","70","20991877"
"chr3","55868283","55868530","chr2","87458960","87459216","27","31590677"
"chr3","55868559","55868855","chr2","87458630","87458930","32","31590071"
"chr3","55934815","55935107","chr2","87385632","87385941","28","31450817"
"chr3","56102952","56103084","chr2","87226017","87226149","7","31123065"
"chr3","56103395","56103573","chr10","73372685","73372849","39","17269290"
"chr3","56117570","56117850","chr2","87210211","87210499","28","31092641"
"chr3","56208079","56208331","chr15","46765721","46765993","33","9442358"
"chr3","56294395","56294697","chr2","87039072","87039374","37","30744677"
"chr3","56391854","56391961","chr1","74562872","74562973","25","18171018"
"chr3","56410215","56410531","chr2","86928226","86928526","29","30518011"
"chr3","56412146","56412433","chr2","86926321","86926619","27","30514175"
"chr3","56611600","56611888","chr2","86724153","86724454","36","30112553"
"chr3","56654727","56655029","chr2","86680551","86680848","26","30025824"
"chr3","56686962","56687231","chr2","86647920","86648191","22","29960958"
"chr3","56758204","56758494","chr2","86575823","86576113","18","29817619"
"chr3","56809299","56809606","chr2","86519902","86520222","29","29710603"
"chr3","56882171","56882452","chr2","86445483","86445782","37","29563312"
"chr3","56927852","56928139","chr4","5085405","5085685","66","51842447"
"chr3","56928197","56928208","chr7","125425834","125425844","1","68497637"
"chr3","56981213","56981494","chr2","86347753","86348041","32","29366540"
"chr3","56983391","56983663","chr2","86345583","86345854","25","29362192"
"chr3","57064976","57065194","chr2","86270389","86270613","17","29205413"
"chr3","57071048","57071332","chr2","86263915","86264189","20","29192867"
"chr3","57131224","57131437","chr2","86202819","86203032","17","29071595"
"chr3","57142338","57142558","chr2","86191751","86191971","11","29049413"
"chr3","57216657","57216917","chr2","86114649","86114917","29","28897992"
"chr3","57246392","57246661","chr2","86084563","86084828","24","28838171"
"chr3","57256744","57257054","chr1","188530204","188530518","64","131273460"
"chr3","57345214","57345501","chr2","85982622","85982913","24","28637408"
"chr3","57354289","57354570","chr2","85973398","85973692","31","28619109"
"chr3","57386930","57387227","chr19","15562519","15562818","58","41824411"
"chr3","57433010","57433304","chr2","85898595","85898862","42","28465585"
"chr3","57502879","57503121","chr10","91923764","91924004","65","34420885"
"chr3","57562906","57563196","chr2","85773669","85773956","20","28210763"
"chr3","57582294","57582602","chr2","85751603","85751916","31","28169309"
"chr3","57597205","57597445","chr2","85736016","85736258","17","28138811"
"chr3","57603405","57603705","chr2","85729896","85730200","15","28126491"
"chr3","57604819","57604905","chr2","85728597","85728683","1","28123778"
"chr3","57614887","57615187","chr3","126975901","126976192","59","69361014"
"chr3","57640547","57640834","chr2","85691916","85692231","46","28051369"
"chr3","57658260","57658577","chr2","85674253","85674575","25","28015993"
"chr3","57663226","57663428","chr2","85669777","85669984","17","28006551"
"chr3","57697553","57697856","chr2","85636479","85636767","32","27938926"
"chr3","57701914","57702029","chr2","85630565","85630679","7","27928651"
"chr3","57702318","57702511","chr2","85630088","85630278","21","27927770"
"chr3","57732651","57732776","chr2","85604664","85604795","17","27872013"
"chr3","57735324","57735604","chr2","85602400","85602700","36","27867076"
"chr3","57738336","57738617","chr2","85592394","85592677","23","27854058"
"chr3","57747465","57747773","chr7","58791165","58791468","68","1043700"
"chr3","57765304","57765574","chr2","85565600","85565901","50","27800296"
"chr3","57784228","57784518","chr2","85546015","85546298","20","27761787"
"chr3","57787236","57787349","chr16","61292718","61292835","25","3505482"
"chr3","57799471","57799759","chr2","85530579","85530876","37","27731108"
"chr3","57802943","57803245","chr11","115886402","115886701","72","58083459"
"chr3","57807013","57807316","chr2","85522700","85523004","19","27715687"
"chr3","57816102","57816390","chr2","85512810","85513098","34","27696708"
"chr3","57821238","57821398","chr2","85506923","85507083","20","27685685"
"chr3","57863191","57863498","chr2","85468802","85469115","27","27605611"
"chr3","57877593","57877884","chr2","85454881","85455174","23","27577288"
"chr3","57910177","57910492","chr2","85421638","85421951","20","27511461"
"chr3","57911636","57911758","chr2","85420369","85420488","9","27508733"
"chr3","57914414","57914539","chr2","85417647","85417776","11","27503233"
"chr3","57954057","57954353","chr2","85320735","85321033","20","27366678"
"chr3","57958870","57959162","chr2","85315959","85316254","31","27357089"
"chr3","57970062","57970360","chr7","84841819","84842127","59","26871757"
"chr3","57989398","57989695","chr3","43652365","43652670","52","14337033"
"chr3","58010426","58010702","chr2","85262712","85263009","39","27252286"
"chr3","58043143","58043450","chr2","178119588","178119898","58","120076445"
"chr3","58051589","58051803","chr19","33330929","33331143","40","24720660"
"chr3","58062802","58063115","chr2","85210221","85210531","39","27147419"
"chr3","58114756","58114992","chr2","85167108","85167349","16","27052352"
"chr3","58122347","58122548","chr2","96001904","96002105","38","37879557"
"chr3","58127335","58127627","chr2","85153336","85153628","19","27026001"
"chr3","58135420","58135719","chr2","85144053","85144349","18","27008633"
"chr3","58166957","58167226","chr2","85111978","85112258","32","26945021"
"chr3","58182612","58182901","chr2","85097423","85097712","18","26914811"
"chr3","58193591","58193896","chr2","85077924","85078229","18","26884333"
"chr3","58204539","58204728","chrY","899637","899829","46","57304902"
"chr3","58211981","58212123","chr2","172054253","172054394","26","113842272"
"chr3","58212443","58212521","chr12","47646938","47647017","16","10565505"
"chr3","58214066","58214359","chr2","85065759","85066053","25","26851693"
"chr3","58215092","58215417","chr2","85064705","85065029","21","26849613"
"chr3","58226301","58226601","chr2","85053350","85053657","28","26827049"
"chr3","58232140","58232465","chr2","85047374","85047699","23","26815234"
"chr3","58232486","58232549","chr1","187626965","187627020","19","129394479"
"chr3","58246428","58246722","chr2","85033177","85033472","14","26786749"
"chr3","58280742","58281004","chr16","15975236","15975486","64","42305506"
"chr3","58298107","58298401","chr2","84980479","84980779","25","26682372"
"chr3","58300439","58300719","chr2","84978129","84978409","17","26677690"
"chr3","58319610","58319906","chr2","84958511","84958806","20","26638901"
"chr3","58320337","58320532","chr4","138462947","138463126","55","80142610"
"chr3","58334825","58335108","chr7","71260888","71261178","58","12926063"
"chr3","58336880","58337043","chr2","84939857","84940017","12","26602977"
"chr3","58337340","58337474","chr2","84939429","84939563","7","26602089"
"chr3","58349189","58349484","chrX","40130964","40131270","57","18218225"
"chr3","58363925","58364223","chr2","84914170","84914474","19","26550245"
"chr3","58365040","58365324","chr2","84913076","84913368","22","26548036"
"chr3","58372122","58372293","chr1","218816649","218816824","43","160444527"
"chr3","58372599","58372615","chr10","10734788","10734804","4","47637811"
"chr3","58374159","58374396","chr2","84902197","84902432","15","26528038"
"chr3","58376368","58376657","chr1","138872834","138873119","52","80496466"
"chr3","58389024","58389310","chr2","84885678","84885964","27","26496654"
"chr3","58455023","58455115","chr5","128099257","128099330","26","69644234"
"chr3","58455402","58455559","chr10","63504110","63504264","26","5048708"
"chr3","58481723","58482001","chr5","51322379","51322663","52","7159344"
"chr3","58509477","58509556","chr2","84773829","84773908","2","26264352"
"chr3","58525410","58525605","chr2","84757233","84757417","25","26231823"
"chr3","58537080","58537364","chr4","132392979","132393253","57","73855899"
"chr3","58557386","58557686","chr2","84728397","84728684","45","26171011"
"chr3","58563800","58563922","chr1","223444164","223444286","14","164880364"
"chr3","58566534","58566850","chr2","84720159","84720496","43","26153625"
"chr3","58595714","58595840","chr2","84690602","84690728","7","26094888"
"chr3","58607858","58608135","chr2","84669855","84670116","40","26061997"
"chr3","58609443","58609713","chr2","84668360","84668623","27","26058917"
"chr3","58646770","58647068","chr2","84638680","84638977","25","25991910"
"chr3","58687129","58687360","chr2","84598788","84599019","25","25911659"
"chr3","58688040","58688164","chr1","200289163","200289285","17","141601123"
"chr3","58692310","58692572","chr9","13907793","13908061","66","44784517"
"chr3","58704573","58704868","chr2","84579755","84580052","26","25875182"
"chr3","58714223","58714520","chr2","84573283","84573575","17","25859060"
"chr3","58719616","58719893","chr2","84567566","84567843","22","25847950"
"chr3","58729256","58729464","chr2","84557459","84557666","14","25828203"
"chr3","58733087","58733203","chr1","223060548","223060656","27","164327461"
"chr3","58978325","58978616","chr11","131260074","131260355","58","72281749"
"chr3","59005082","59005202","chr2","84502531","84502654","12","25497449"
"chr3","59011416","59011679","chr2","84496492","84496773","39","25485076"
"chr3","59030937","59031215","chr2","84476420","84476702","29","25445483"
"chr3","59034628","59034683","chr2","84472983","84473037","1","25438355"
"chr3","59034974","59035128","chr2","84472547","84472689","25","25437573"
"chr3","59038043","59038340","chr2","84469123","84469414","32","25431080"
"chr3","59041216","59041517","chr2","84464923","84465228","21","25423707"
"chr3","59043353","59043632","chr2","84462783","84463065","24","25419430"
"chr3","59047811","59048016","chr2","84456839","84457046","22","25409028"
"chr3","59048593","59048878","chr2","84455969","84456271","37","25407376"
"chr3","59051557","59051624","chr1","170288719","170288792","17","111237162"
"chr3","59052664","59052964","chr7","152485012","152485309","63","93432348"
"chr3","59054735","59055020","chr2","84448972","84449257","16","25394237"
"chr3","59057870","59058170","chr2","84446326","84446635","31","25388456"
"chr3","59063742","59063881","chr2","84440748","84440887","3","25377006"
"chr3","59065965","59066022","chr4","7229042","7229098","11","51836923"
"chr3","59067362","59067650","chr1","191690399","191690678","57","132623037"
"chr3","59072884","59073018","chrX","8417026","8417160","18","50655858"
"chr3","59073354","59073533","chr6","68146972","68147145","34","9073618"
"chr3","59094754","59095043","chr2","84409512","84409801","18","25314758"
"chr3","59119135","59119232","chr2","84382983","84383080","3","25263848"
"chr3","59129288","59129517","chr20","53017139","53017355","41","6112149"
"chr3","59131375","59131668","chr2","84370476","84370782","34","25239101"
"chr3","59187935","59188208","chr2","84312297","84312572","17","25124362"
"chr3","59191721","59192007","chr2","84308205","84308492","23","25116484"
"chr3","59202277","59202569","chr2","84297976","84298267","28","25095699"
"chr3","59220286","59220581","chr2","84279178","84279467","23","25058892"
"chr3","59221673","59221842","chr2","84278068","84278237","9","25056395"
"chr3","59225895","59226038","chr2","84273940","84274085","15","25048045"
"chr3","59226343","59226508","chr2","84273468","84273633","11","25047125"
"chr3","59227442","59227739","chr19","10072921","10073222","58","49154521"
"chr3","59232757","59233049","chr2","84266825","84267131","34","25034068"
"chr3","59244803","59245035","chr2","84253918","84254150","14","25009115"
"chr3","59289537","59289820","chr2","84207115","84207392","31","24917578"
"chr3","59290530","59290793","chr2","84206125","84206386","14","24915595"
"chr3","59314275","59314585","chr2","84179538","84179851","24","24865263"
"chr3","59324349","59324483","chr1","155846166","155846296","22","96521817"
"chr3","59324789","59324943","chr12","21323547","21323703","33","38001242"
"chr3","59326375","59326643","chr2","84168215","84168483","21","24841840"
"chr3","59326762","59327017","chr2","84167806","84168088","51","24841044"
"chr3","59369747","59370042","chr2","84128506","84128771","51","24758759"
"chr3","59379158","59379284","chr10","8237746","8237873","15","51141412"
"chr3","59379595","59379770","chr19","40492112","40492283","37","18887483"
"chr3","59389209","59389496","chr2","84108275","84108577","33","24719066"
"chr3","59450392","59450552","chr4","2017308","2017461","40","57433084"
"chr3","59450866","59450984","chr11","117416380","117416492","25","57965514"
"chr3","59491038","59491332","chr2","84003124","84003408","28","24512086"
"chr3","59516331","59516431","chr13","38315356","38315460","17","21200975"
"chr3","59531529","59531831","chr2","83962291","83962597","23","24430762"
"chr3","59565736","59566035","chr2","83922541","83922836","17","24356805"
"chr3","59576525","59576651","chr8","28020346","28020466","30","31556179"
"chr3","59593484","59593778","chr2","83892429","83892713","38","24298945"
"chr3","59603870","59603987","chr2","83882260","83882377","11","24278390"
"chr3","59604431","59604583","chr2","83881675","83881816","18","24277244"
"chr3","59622655","59622775","chr4","32979169","32979300","24","26643486"
"chr3","59638345","59638646","chr2","83847392","83847708","36","24209047"
"chr3","59649798","59650022","chr2","45945040","45945260","39","13704758"
"chr3","59658541","59658824","chr2","83826616","83826903","27","24168075"
"chr3","59673885","59674095","chrX","127636612","127636822","40","67962727"
"chr3","59676705","59677006","chr9","106351847","106352148","64","46675142"
"chr3","59694505","59694784","chr2","83777909","83778184","24","24083404"
"chr3","59705736","59706017","chr2","83765544","83765829","24","24059808"
"chr3","59754876","59755153","chr2","83717669","83717980","50","23962793"
"chr3","59775136","59775421","chr10","17690483","17690750","71","42084653"
"chr3","59791177","59791303","chr2","83671335","83671459","11","23880158"
"chr3","59793317","59793605","chr2","83668836","83669106","36","23875519"
"chr3","59812214","59812521","chr2","104356889","104357193","62","44544675"
"chr3","59863039","59863161","chr2","83590734","83590852","10","23727695"
"chr3","59919869","59920151","chr2","83529369","83529659","22","23609500"
"chr3","59923103","59923353","chr2","83526178","83526424","21","23603075"
"chr3","59925881","59926147","chr2","83523376","83523633","24","23597495"
"chr3","60105909","60106028","chr2","83318972","83319091","6","23213063"
"chr3","60133700","60133994","chr2","83290698","83290974","42","23156998"
"chr3","60402868","60403020","chr2","83016557","83016709","10","22613689"
"chr3","60469958","60470278","chr2","82932877","82933193","20","22462919"
"chr3","60476663","60476786","chr5","150516607","150516733","20","90039944"
"chr3","60502840","60503152","chr2","82902073","82902380","58","22399233"
"chr3","60588910","60589186","chr2","82809358","82809637","18","22220448"
"chr3","60597668","60597799","chr2","82801282","82801412","13","22203614"
"chr3","60633555","60633763","chr2","82765540","82765750","24","22131985"
"chr3","60736561","60736856","chr2","82672468","82672762","25","21935907"
"chr3","60976724","60976896","chr2","82445109","82445289","26","21468385"
"chr3","60976933","60977046","chr2","82444968","82445082","14","21468035"
"chr3","60991542","60991854","chr6","77260247","77260553","57","16268705"
"chr3","60993231","60993531","chr5","51350304","51350607","63","9642927"
"chr3","61115928","61116142","chr2","82303971","82304186","21","21188043"
"chr3","61236635","61236929","chr2","82184758","82185036","41","20948123"
"chr3","61246099","61246376","chr2","82172402","82172685","24","20926303"
"chr3","61263660","61263956","chr1","146741433","146741738","52","85477773"
"chr3","61354198","61354450","chr9","15387969","15388226","64","45966229"
"chr3","61439743","61440052","chr2","81980380","81980671","45","20540637"
"chr3","61445731","61445889","chr1","207948084","207948245","35","146502353"
"chr3","61464069","61464401","chr2","81955160","81955470","68","20491091"
"chr3","61504064","61504345","chr16","50570116","50570393","56","10933948"
"chr3","61505546","61505770","chr2","81914342","81914575","30","20408796"
"chr3","61551007","61551294","chr2","81861431","81861729","33","20310424"
"chr3","61573594","61573876","chr2","81838690","81838953","44","20265096"
"chr3","61673480","61673795","chr2","81733990","81734305","27","20060510"
"chr3","61768343","61768616","chr2","81643206","81643506","45","19874863"
"chr3","61873006","61873102","chr8","96949211","96949317","26","35076205"
"chr3","61917326","61917581","chr14","63607964","63608233","64","1690638"
"chr3","62179307","62179562","chr1","198157534","198157791","54","135978227"
"chr3","62201917","62202222","chr2","81203321","81203624","27","19001404"
"chr3","62297936","62298216","chr10","17455044","17455328","59","44842892"
"chr3","62305486","62305718","chr2","81115495","81115725","16","18810009"
"chr3","62318562","62318859","chr2","81101958","81102254","21","18783396"
"chr3","62495446","62495735","chr2","80913392","80913671","22","18417946"
"chr3","62546452","62546745","chr4","81996234","81996529","73","19449782"
"chr3","62592833","62593095","chr7","112215400","112215668","65","49622567"
"chr3","62599067","62599358","chr2","80790561","80790857","17","18191494"
"chr3","62630097","62630221","chr13","42830148","42830273","19","19799949"
"chr3","62654333","62654474","chr2","80733131","80733288","29","18078798"
"chr3","62670998","62671162","chr2","80713232","80713407","21","18042234"
"chr3","62671451","62671589","chr2","80712807","80712945","9","18041356"
"chr3","62673649","62673936","chr4","10788712","10788992","83","51884937"
"chr3","62687963","62688124","chr2","80694655","80694816","10","18006692"
"chr3","62728054","62728351","chr17","9505104","9505404","23","53222950"
"chr3","62781037","62781337","chr2","80609719","80610019","37","17828682"
"chr3","62793064","62793368","chr2","80597688","80598004","31","17804624"
"chr3","62795193","62795468","chr2","80595602","80595902","49","17800409"
"chr3","62796928","62797221","chr2","80593412","80593707","17","17796484"
"chr3","62800936","62801244","chr2","80589040","80589349","23","17788104"
"chr3","62805251","62805560","chr2","80584693","80585004","28","17779442"
"chr3","62834053","62834181","chr2","80549300","80549430","8","17715247"
"chr3","62834474","62834632","chr2","80548854","80549005","24","17714380"
"chr3","62840478","62840781","chr11","119742158","119742460","55","56901680"
"chr3","62855431","62855701","chr2","80526328","80526623","44","17670897"
"chr3","62859139","62859266","chr2","80523023","80523154","15","17663884"
"chr3","62863693","62863998","chr2","80517087","80517399","26","17653394"
"chr3","62884393","62884534","chr2","80496227","80496352","22","17611834"
"chr3","62902484","62902788","chr2","80478678","80478986","34","17576194"
"chr3","62920094","62920405","chr2","80460586","80460870","57","17540492"
"chr3","62969500","62969772","chr2","80404119","80404378","31","17434619"
"chr3","62969835","62970157","chr2","80403408","80403722","38","17433573"
"chr3","62971308","62971461","chr2","80402093","80402247","8","17430785"
"chr3","62974967","62975119","chr19","10004705","10004851","33","52970262"
"chr3","62979464","62979747","chr2","80393751","80394035","18","17414287"
"chr3","63040423","63040723","chr2","80332273","80332586","31","17291850"
"chr3","63050318","63050599","chr15","91122447","91122709","85","28072129"
"chr3","63070829","63071109","chr2","80301745","80302022","44","17230916"
"chr3","63080723","63081024","chr2","80291391","80291678","28","17210668"
"chr3","63094248","63094556","chr2","80278190","80278506","32","17183942"
"chr3","63094606","63094800","chr2","80277946","80278140","15","17183340"
"chr3","63100544","63100856","chr2","80271873","80272188","26","17171329"
"chr3","63103657","63103924","chr2","80268793","80269046","40","17165136"
"chr3","63130636","63130814","chr1","44389709","44389879","39","18740927"
"chr3","63156531","63156825","chr2","80218756","80219067","50","17062225"
"chr3","63183146","63183406","chr1","42143576","42143839","68","21039570"
"chr3","63196220","63196481","chr2","80177389","80177649","9","16981169"
"chr3","63211394","63211602","chr2","80161387","80161601","35","16949993"
"chr3","63222573","63222864","chr2","80152089","80152395","39","16929516"
"chr3","63224058","63224336","chr2","80150574","80150885","61","16926516"
"chr3","63287403","63287725","chr2","80084388","80084707","25","16796985"
"chr3","63324616","63324895","chr2","80046725","80047004","23","16722109"
"chr3","63366816","63367126","chr2","80002751","80003058","28","16635935"
"chr3","63372765","63372881","chr16","23573901","23574021","23","39798864"
"chr3","63378100","63378230","chr2","79990969","79991101","9","16612869"
"chr3","63378854","63378907","chr2","79990292","79990345","2","16611438"
"chr3","63388657","63388954","chr2","79978905","79979201","25","16590248"
"chr3","63390309","63390434","chr9","95066793","95066917","22","31676484"
"chr3","63390478","63390635","chr9","72272836","72272988","29","8882358"
"chr3","63391327","63391599","chr2","79976302","79976591","55","16584975"
"chr3","63423723","63424011","chr2","79941376","79941704","53","16517653"
"chr3","63426886","63427190","chr2","79938186","79938468","38","16511300"
"chr3","63462950","63463241","chr2","79902358","79902655","34","16439408"
"chr3","63498893","63499184","chr2","79867873","79868159","21","16368980"
"chr3","63562149","63562365","chr8","88328733","88328939","48","24766584"
"chr3","63562366","63562563","chr17","5229611","5229823","50","58332755"
"chr3","63586406","63586594","chr3","84781903","84782098","54","21195497"
"chr3","63658710","63658987","chr2","79708182","79708458","16","16049472"
"chr3","63673491","63673797","chr2","79693651","79693958","29","16020160"
"chr3","63697850","63698132","chr2","79668720","79669000","18","15970870"
"chr3","63764032","63764153","chr2","188363821","188363939","22","124599789"
"chr3","63764185","63764339","chr19","16079871","16080029","27","47684314"
"chr3","63799631","63799932","chr2","79565467","79565786","34","15765836"
"chr3","63866801","63867065","chr2","79497862","79498137","32","15631061"
"chr3","63873513","63873639","chr2","79491185","79491311","10","15617672"
"chr3","63890959","63891042","chr4","107839714","107839795","14","43948755"
"chr3","63892414","63892645","chr10","71004722","71004936","48","7112308"
"chr3","63959878","63960178","chr2","79399841","79400135","49","15439963"
"chr3","63982953","63983226","chr2","79376755","79377027","13","15393802"
"chr3","64030945","64031260","chr2","79329420","79329726","35","15298475"
"chr3","64057418","64057707","chr2","79303009","79303296","18","15245591"
"chr3","64065552","64065749","chr2","79294900","79295113","34","15229348"
"chr3","64091268","64091360","chr12","105353612","105353704","15","41262344"
"chr3","64091407","64091616","chr2","79268493","79268692","27","15177086"
"chr3","64097554","64097814","chr2","79262162","79262422","18","15164608"
"chr3","64103848","64104148","chr2","79255142","79255437","24","15151294"
"chr3","64104245","64104541","chr6","76152155","76152450","59","12047910"
"chr3","64144827","64145102","chr2","79212805","79213077","47","15067978"
"chr3","64188183","64188313","chr1","122059382","122059521","29","57871199"
"chr3","64200036","64200280","chr9","97202195","97202453","63","33002159"
"chr3","64205497","64205757","chr9","34974107","34974375","70","29231390"
"chr3","64227671","64227941","chr2","79129665","79129934","12","14901994"
"chr3","64290690","64290957","chr2","79067087","79067358","32","14776397"
"chr3","64327246","64327489","chr2","79036021","79036261","26","14708775"
"chr3","64330697","64331008","chr2","79032642","79032945","37","14701945"
"chr3","64337316","64337445","chr2","79026103","79026232","7","14688787"
"chr3","64392596","64392927","chr2","78964350","78964675","42","14571754"
"chr3","64414251","64414558","chr2","78942399","78942707","22","14528148"
"chr3","64493538","64493857","chr10","81937384","81937691","72","17443846"
"chr3","64626949","64627244","chr2","78725786","78726078","17","14098837"
"chr3","64686485","64686799","chr9","12005609","12005926","78","52680876"
"chr3","64731341","64731391","chr2","78621355","78621406","5","13890014"
"chr3","64828299","64828436","chr2","78517212","78517335","24","13688913"
"chr3","64895277","64895564","chr1","40567613","40567895","68","24327664"
"chr3","64901818","64902049","chr8","97359428","97359652","56","32457610"
"chr3","64946982","64947100","chr2","78407921","78408030","15","13460939"
"chr3","65056154","65056389","chr2","78301344","78301582","20","13245190"
"chr3","65059347","65059634","chr2","78298141","78298395","51","13238794"
"chr3","65075422","65075705","chr2","78284577","78284849","30","13209155"
"chr3","65123699","65123956","chr7","27105120","27105374","60","38018579"
"chr3","65148371","65148675","chr2","78207758","78208060","25","13059387"
"chr3","65173413","65173712","chr2","78181674","78181972","20","13008261"
"chr3","65183666","65183794","chr1","84247852","84247968","31","19064186"
"chr3","65204974","65205262","chr5","38006297","38006593","54","27198677"
"chr3","65372723","65373020","chr2","77981070","77981360","35","12608347"
"chr3","65446405","65446678","chr2","77907388","77907660","12","12460983"
"chr3","65465284","65465585","chr2","77887964","77888260","30","12422680"
"chr3","65475577","65475876","chr2","77877711","77878012","28","12402134"
"chr3","65549842","65550140","chr2","77801806","77802072","54","12251964"
"chr3","65556452","65556744","chr2","77795149","77795445","27","12238697"
"chr3","65559586","65559896","chr2","77792335","77792641","22","12232749"
"chr3","65593037","65593292","chr2","77758804","77759061","24","12165767"
"chr3","65599567","65599862","chr2","77751840","77752126","43","12152273"
"chr3","65652417","65652525","chr2","77698452","77698555","13","12046035"
"chr3","65742517","65742815","chr2","77608302","77608598","17","11865785"
"chr3","65745983","65746272","chr2","77604768","77605054","38","11858785"
"chr3","65767472","65767768","chr2","84913076","84913368","54","19145604"
"chr3","65793800","65794108","chr2","77560508","77560814","24","11766708"
"chr3","65835944","65836252","chr11","434869","435174","55","65401075"
"chr3","65877972","65878268","chr2","77478479","77478783","31","11600507"
"chr3","65909976","65910275","chr2","77445806","77446105","11","11535830"
"chr3","65923135","65923444","chr1","218247210","218247510","55","152324075"
"chr3","65937066","65937361","chr2","77418091","77418401","53","11481025"
"chr3","65946582","65946700","chr2","77408539","77408657","13","11461957"
"chr3","65955101","65955274","chr5","46725277","46725448","38","19229824"
"chr3","65961247","65961389","chr18","48189873","48190014","27","17771374"
"chr3","65970395","65970524","chr2","77382798","77382927","7","11412403"
"chr3","65995286","65995587","chr2","77357796","77358096","40","11362510"
"chr3","65996951","65997068","chr14","8294861","8294977","17","57702090"
"chr3","66015164","66015261","chr1","48775529","48775627","16","17239635"
"chr3","66020494","66020797","chr7","69145083","69145383","64","3124589"
"chr3","66032514","66032830","chr2","77312929","77313211","58","11280415"
"chr3","66049944","66050260","chr2","77294890","77295206","15","11244946"
"chr3","66101139","66101415","chr2","77246579","77246855","12","11145440"
"chr3","66108363","66108662","chr2","77238931","77239223","35","11130568"
"chr3","66114660","66114971","chr2","77232571","77232879","26","11117911"
"chr3","66124219","66124519","chr18","39207065","39207355","57","26917154"
"chr3","66127146","66127272","chr2","77219896","77220022","11","11092750"
"chr3","66168070","66168389","chr2","77179492","77179808","31","11011422"
"chr3","66216209","66216523","chr2","77131516","77131835","32","10915307"
"chr3","66224652","66224934","chr2","77119612","77119889","30","10894960"
"chr3","66225598","66225891","chr2","77118630","77118923","15","10893032"
"chr3","66252253","66252543","chr2","77090459","77090751","14","10838206"
"chr3","66394759","66395060","chr2","76954709","76955005","23","10559950"
"chr3","66406010","66406308","chr2","76949587","76949886","28","10543577"
"chr3","66413227","66413539","chr2","76942662","76942974","19","10529435"
"chr3","66458647","66458938","chr2","76900868","76901186","54","10442221"
"chr3","66489249","66489488","chr2","76869890","76870133","27","10380641"
"chr3","66581252","66581538","chr2","162961619","162961900","68","96380367"
"chr3","66612713","66612974","chr2","45832248","45832529","66","20780465"
"chr3","66677395","66677669","chr2","76681653","76681928","14","10004258"
"chr3","66752695","66752971","chr2","76605190","76605482","32","9852495"
"chr3","66774700","66775003","chr2","76582020","76582310","43","9807320"
"chr3","66800910","66801194","chr2","76549621","76549938","62","9748711"
"chr3","66806242","66806533","chr2","76544378","76544677","25","9738136"
"chr3","66834565","66834746","chr2","76516233","76516387","35","9681668"
"chr3","66858079","66858370","chr2","76491717","76492027","44","9633638"
"chr3","66910932","66910993","chrY","221023","221081","15","66689909"
"chr3","66911295","66911428","chr10","37946367","37946508","27","28964928"
"chr3","66920515","66920662","chr3","111515169","111515327","32","44594654"
"chr3","66920708","66920815","chr3","121183850","121183953","23","54263142"
"chr3","66921487","66921782","chr3","161883149","161883425","72","94961662"
"chr3","66965167","66965460","chr2","76385657","76385958","39","9420490"
"chr3","66976550","66976836","chr2","76374371","76374675","49","9397821"
"chr3","67027043","67027358","chr2","76321337","76321662","31","9294294"
"chr3","67035996","67036157","chr20","42549364","42549524","35","24486632"
"chr3","67054293","67054611","chr2","76293027","76293315","48","9238734"
"chr3","67119600","67119674","chr15","7899581","7899660","19","59220019"
"chr3","67120706","67121003","chr2","76225809","76226131","59","9105103"
"chr3","67132165","67132470","chr2","76213666","76213974","19","9081501"
"chr3","67135613","67135902","chr2","52236895","52237185","56","14898718"
"chr3","67139606","67139729","chr7","92846413","92846536","19","25706807"
"chr3","67146042","67146335","chr2","76200083","76200362","55","9054041"
"chr3","67155651","67155952","chr2","76189917","76190204","36","9034266"
"chr3","67161275","67161456","chrX","86222804","86222975","43","19061529"
"chr3","67162036","67162130","chr2","76183951","76184045","5","9021915"
"chr3","67162430","67162645","chr2","76183470","76183681","22","9021040"
"chr3","67184171","67184466","chr2","56803979","56804276","55","10380192"
"chr3","67200111","67200356","chr8","38412179","38412409","63","28787932"
"chr3","67212339","67212642","chr2","76134833","76135125","22","8922494"
"chr3","67256988","67257250","chr4","111720080","111720340","54","44463092"
"chr3","67272086","67272258","chr2","76071896","76072057","26","8799810"
"chr3","67272286","67272404","chr2","76071716","76071831","7","8799430"
"chr3","67290188","67290469","chr1","20845394","20845668","63","46444794"
"chr3","67291883","67291929","chr14","47689664","47689709","9","19602219"
"chr3","67292246","67292392","chr1","153250707","153250848","31","85958461"
"chr3","67305547","67305842","chr2","76038690","76039012","48","8733143"
"chr3","67315150","67315439","chr2","76028842","76029139","24","8713692"
"chr3","67341036","67341340","chr2","76005173","76005456","42","8664137"
"chr3","67357700","67358010","chr2","75988161","75988438","46","8630461"
"chr3","67367999","67368116","chr1","124846603","124846720","14","57478604"
"chr3","67376287","67376537","chr2","75968611","75968860","15","8592324"
"chr3","67387202","67387282","chr10","89492793","89492874","16","22105591"
"chr3","67387533","67387825","chr2","75961148","75961442","26","8573615"
"chr3","67407568","67407867","chr2","75941530","75941841","36","8533962"
"chr3","67466183","67466487","chr2","75894987","75895298","28","8428804"
"chr3","67475062","67475343","chr2","75887486","75887767","20","8412424"
"chr3","67489404","67489692","chr2","75872310","75872596","23","8382906"
"chr3","67498518","67498801","chr2","75862796","75863083","32","8364278"
"chr3","67509360","67509420","chr14","78931299","78931359","15","11421939"
"chr3","67509939","67510219","chr2","75851620","75851898","22","8341681"
"chr3","67519246","67519524","chr2","75842250","75842552","42","8323004"
"chr3","67546361","67546632","chr19","35299256","35299528","54","32247105"
"chr3","67616006","67616266","chr9","97202195","97202453","63","29586189"
"chr3","67621180","67621440","chr2","75738102","75738361","15","8116922"
"chr3","67632783","67633099","chr2","75726451","75726758","31","8093668"
"chr3","67635861","67636156","chr2","75723448","75723732","39","8087587"
"chr3","67691314","67691439","chr19","29369881","29370004","21","38321433"
"chr3","67729971","67730271","chr2","75624656","75624948","22","7894685"
"chr3","67793249","67793559","chr1","101094660","101094976","56","33301411"
"chr3","67820279","67820587","chr2","75534235","75534567","39","7713956"
"chr3","67822270","67822393","chr2","75532477","75532601","9","7710207"
"chr3","67830027","67830341","chr2","75525451","75525755","36","7695424"
"chr3","67834240","67834360","chr2","75520758","75520878","3","7686518"
"chr3","67863829","67864096","chr2","75490000","75490267","14","7626171"
"chr3","67865229","67865507","chr9","21318319","21318592","50","46546910"
"chr3","67888623","67888765","chr1","26561536","26561668","22","41327087"
"chr3","67888856","67889019","chr14","32139013","32139178","33","35749843"
"chr3","67894557","67894866","chr2","75459001","75459305","32","7564444"
"chr3","67908978","67909040","chr2","75444993","75445059","11","7536015"
"chr3","67921304","67921427","chr2","75433943","75434066","7","7512639"
"chr3","67926277","67926594","chr2","75429077","75429397","31","7502800"
"chr3","67990964","67991252","chr2","75364943","75365232","24","7373979"
"chr3","68073336","68073632","chr2","75287199","75287500","29","7213863"
"chr3","68085432","68085699","chr2","75275540","75275815","28","7190108"
"chr3","68093223","68093383","chr8","113289957","113290120","36","45196734"
"chr3","68140226","68140536","chr2","75229645","75229957","18","7089419"
"chr3","68147656","68147968","chr16","68450975","68451269","84","303319"
"chr3","68251104","68251410","chr2","75118270","75118572","25","6867166"
"chr3","68261991","68262287","chr2","75107275","75107539","51","6845284"
"chr3","68302762","68303053","chr2","75067879","75068174","27","6765117"
"chr3","68309003","68309286","chr2","75061803","75062109","41","6752800"
"chr3","68329132","68329237","chr2","74988391","74988493","7","6659259"
"chr3","68330450","68330750","chr2","74986865","74987162","13","6656415"
"chr3","68506849","68507145","chr2","74789309","74789621","40","6282460"
"chr3","68569066","68569352","chr2","74733626","74733912","20","6164560"
"chr3","68575886","68576167","chr2","74727103","74727388","29","6151217"
"chr3","68579279","68579583","chr2","74723648","74723952","25","6144369"
"chr3","68649644","68649947","chr3","41216080","41216386","59","27433564"
"chr3","68671853","68671966","chr3","35288048","35288159","16","33383805"
"chr3","68718592","68718875","chr2","74594418","74594721","41","5875826"
"chr3","68759328","68759424","chr4","87524216","87524313","21","18764888"
"chr3","68762467","68762768","chr2","74551530","74551829","35","5789063"
"chr3","68776561","68776679","chr2","74536967","74537084","7","5760406"
"chr3","68779970","68780210","chr2","74533143","74533385","11","5753173"
"chr3","68835445","68835721","chr2","74476659","74476964","41","5641214"
"chr3","68873766","68874070","chr2","74436605","74436908","28","5562839"
"chr3","68919711","68920027","chr2","74389672","74389977","28","5469961"
"chr3","68938888","68939202","chr2","74371333","74371649","23","5432445"
"chr3","68955268","68955497","chr3","126091436","126091662","54","57136168"
"chr3","68968160","68968450","chrX","126328105","126328399","57","57359945"
"chr3","68977534","68977833","chr2","74331831","74332155","59","5354297"
"chr3","69165305","69165608","chr2","74093638","74093939","27","4928333"
"chr3","69201513","69201779","chr2","74061626","74061916","41","4860113"
"chr3","69213946","69214217","chr2","74048882","74049164","29","4834936"
"chr3","69224946","69225248","chr2","74040034","74040336","30","4815088"
"chr3","69243317","69243599","chr2","74020597","74020887","30","4777280"
"chr3","69342821","69343123","chr2","73920483","73920785","42","4577662"
"chr3","69520575","69520770","chr7","127410012","127410207","49","57889437"
"chr3","69524629","69524919","chr2","73701382","73701685","29","4176753"
"chr3","69536671","69536797","chr2","73689571","73689694","9","4152900"
"chr3","69561574","69561863","chr2","73665264","73665577","45","4103690"
"chr3","69562042","69562156","chr2","73664990","73665104","12","4102948"
"chr3","69577033","69577157","chr1","214422082","214422206","24","144845049"
"chr3","69577195","69577488","chr2","73649749","73650029","43","4072554"
"chr3","69584911","69585230","chr2","73642300","73642614","35","4057389"
"chr3","69588000","69588292","chr2","73639222","73639517","37","4051222"
"chr3","69738424","69738549","chr2","73491195","73491319","12","3752771"
"chr3","69739657","69739971","chr2","73489787","73490106","30","3750130"
"chr3","69815578","69815860","chr2","73415108","73415402","36","3599530"
"chr3","69894186","69894479","chr9","93979962","93980254","62","24085776"
"chr3","69993074","69993295","chr2","73227605","73227823","22","3234531"
"chr3","70090968","70091276","chr2","73127739","73128046","24","3036771"
"chr3","70164666","70164987","chr2","73062671","73062987","27","2898005"
"chr3","70239846","70240138","chr2","72987033","72987321","12","2747187"
"chr3","70244863","70245161","chr2","72981728","72982025","21","2736865"
"chr3","70302179","70302480","chr2","72923747","72924047","17","2621568"
"chr3","70305712","70306025","chr2","72920238","72920539","37","2614526"
"chr3","70318633","70318763","chr2","72907418","72907541","19","2588785"
"chr3","70348727","70348999","chr2","72877345","72877616","22","2528618"
"chr3","70352057","70352344","chr5","91947753","91948032","62","21595696"
"chr3","70379457","70379626","chr15","8429087","8429254","30","61950370"
"chr3","70439700","70439990","chr19","16103250","16103537","55","54336450"
"chr3","70454186","70454488","chr12","20483358","20483659","62","49970828"
"chr3","70457071","70457354","chr2","72766967","72767258","19","2309896"
"chr3","70465936","70466234","chr2","72757411","72757709","23","2291475"
"chr3","70466718","70467025","chr2","72756633","72756928","39","2289915"
"chr3","70480295","70480585","chr2","72743306","72743609","38","2263011"
"chr3","70508563","70508878","chr2","72714790","72715105","21","2206227"
"chr3","70514742","70515060","chr2","72706990","72707306","25","2192248"
"chr3","70515661","70515950","chr2","72706083","72706388","34","2190422"
"chr3","70530102","70530400","chr2","72691321","72691621","21","2161219"
"chr3","70530563","70530869","chr2","72690861","72691165","26","2160298"
"chr3","70556509","70556687","chr3","42357857","42358034","37","28198652"
"chr3","70577318","70577579","chr2","72644693","72644977","37","2067375"
"chr3","70579276","70579567","chr2","72643922","72644203","32","2064646"
"chr3","70623329","70623629","chr2","72598073","72598370","39","1974744"
"chr3","70626674","70626951","chr2","72592847","72593136","26","1966173"
"chr3","70635087","70635218","chr16","50956105","50956236","23","19678982"
"chr3","70643948","70644237","chr2","72576975","72577264","20","1933027"
"chr3","70674251","70674534","chr2","72552841","72553118","25","1878590"
"chr3","70687737","70688011","chr2","172086885","172087169","65","101399148"
"chr3","70700702","70700993","chr2","124168334","124168607","63","53467632"
"chr3","70707325","70707637","chr2","72516996","72517305","28","1809671"
"chr3","70740192","70740471","chr2","72485212","72485495","19","1745020"
"chr3","70741217","70741495","chr2","72484474","72484761","30","1743257"
"chr3","70745189","70745478","chr2","72480517","72480811","21","1735328"
"chr3","70753349","70753574","chr2","72472536","72472761","17","1719187"
"chr3","70763144","70763449","chr6","178711109","178711412","63","107947965"
"chr3","70793237","70793481","chr2","72435314","72435575","27","1642077"
"chr3","70805314","70805631","chr3","123585503","123585819","59","52780189"
"chr3","70816171","70816447","chr2","72416204","72416480","17","1600033"
"chr3","70836567","70836866","chr2","72395738","72396011","40","1559171"
"chr3","70864158","70864435","chr2","72367217","72367493","28","1503059"
"chr3","70897782","70897982","chr2","72334307","72334519","22","1436525"
"chr3","70898283","70898376","chr4","18410063","18410154","25","52488220"
"chr3","70981033","70981162","chr2","72252765","72252881","24","1271732"
"chr3","70995587","70995670","chr2","72236720","72236804","7","1241133"
"chr3","70999265","70999389","chr20","60896915","60897039","19","10102350"
"chr3","71002736","71002861","chr2","72229306","72229435","11","1226570"
"chr3","71056425","71056722","chr2","72174494","72174802","31","1118069"
"chr3","71240935","71241225","chr2","71994992","71995303","37","754057"
"chr3","71352201","71352507","chr2","71895741","71896046","12","543540"
"chr3","71396613","71396892","chr2","71850046","71850313","24","453433"
"chr3","71406656","71406957","chr2","71839896","71840202","31","433240"
"chr3","71431871","71432138","chr2","71813650","71813919","27","381779"
"chr3","71486556","71486858","chr2","71753385","71753690","33","266829"
"chr3","71487125","71487433","chr2","71752789","71753102","31","265664"
"chr3","71493835","71494041","chr10","18663423","18663630","48","52830412"
"chr3","71536491","71536783","chr2","71702643","71702933","30","166152"
"chr3","71575122","71575425","chr2","71665091","71665377","41","89969"
"chr3","71595274","71595562","chr9","21527911","21528210","66","50067363"
"chr3","71613152","71613476","chr2","71632332","71632661","36","19180"
"chr3","71770114","71770393","chr2","71495851","71496134","25","274263"
"chr3","71970514","71970790","chr2","71292410","71292699","32","678104"
"chr3","72150569","72150772","chr2","71125427","71125623","19","1025142"
"chr3","72214982","72215296","chr2","71065812","71066116","32","1149170"
"chr3","72220239","72220534","chr18","12871350","12871641","68","59348889"
"chr3","72228323","72228612","chr2","71052974","71053271","35","1175349"
"chr3","72230915","72231161","chr2","71050136","71050393","23","1180779"
"chr3","72233395","72233701","chr2","71047567","71047886","30","1185828"
"chr3","72308691","72309013","chr2","70972389","70972698","43","1336302"
"chr3","72337573","72337875","chr3","48177577","48177869","56","24159996"
"chr3","72366291","72366407","chr7","130249121","130249241","24","57882830"
"chr3","72366457","72366671","chr13","37621224","37621407","60","34745233"
"chr3","72383863","72384170","chr2","70895978","70896284","26","1487885"
"chr3","72415513","72415810","chr2","70863792","70864096","38","1551721"
"chr3","72461844","72462145","chr2","70817348","70817649","22","1644496"
"chr3","72462284","72462579","chr2","70816881","70817179","26","1645403"
"chr3","72474287","72474430","chr10","87300860","87301011","43","14826573"
"chr3","72536438","72536752","chr2","70742804","70743116","46","1793634"
"chr3","72589219","72589490","chr4","18525744","18526014","64","54063475"
"chr3","72609999","72610312","chr2","2567477","2567782","57","70042522"
"chr3","72633872","72634178","chr7","140100928","140101221","69","67467056"
"chr3","72661262","72661549","chrX","125989015","125989296","50","53327753"
"chr3","72670257","72670541","chr2","70608536","70608806","36","2061721"
"chr3","72715022","72715315","chr2","70562792","70563102","41","2152230"
"chr3","72719471","72719690","chr14","69113872","69114083","39","3605599"
"chr3","72738120","72738232","chr13","89958796","89958914","19","17220676"
"chr3","72738543","72738718","chr1","118714448","118714617","31","45975905"
"chr3","72761413","72761695","chr2","70515223","70515512","32","2246190"
"chr3","72780197","72780497","chr3","124267629","124267922","58","51487432"
"chr3","72784610","72784707","chr2","70491794","70491893","8","2292816"
"chr3","72851297","72851591","chr2","70424139","70424435","27","2427158"
"chr3","72901084","72901386","chr2","70373349","70373648","13","2527735"
"chr3","72903291","72903475","chr1","15790118","15790296","42","57113173"
"chr3","72906034","72906229","chr4","137551997","137552166","55","64645963"
"chr3","72906547","72906629","chr20","2494844","2494926","21","70411703"
"chr3","72914349","72914583","chr2","70359625","70359859","16","2554724"
"chr3","72930322","72930621","chr10","15460316","15460612","60","57470006"
"chr3","72988743","72989035","chr2","70283947","70284237","23","2704796"
"chr3","72993166","72993455","chr2","70279834","70280133","21","2713332"
"chr3","73002677","73002967","chr2","70270322","70270594","35","2732355"
"chr3","73005521","73005816","chr3","13411522","13411814","57","59593999"
"chr3","73016284","73016574","chr2","70256646","70256968","57","2759638"
"chr3","73033617","73033743","chr2","70239638","70239757","15","2793979"
"chr3","73053103","73053384","chr16","49265995","49266270","54","23787108"
"chr3","73057210","73057518","chr2","70216084","70216387","32","2841126"
"chr3","73075461","73075757","chr2","70197627","70197910","44","2877834"
"chr3","73094206","73094484","chr2","70178193","70178480","38","2916013"
"chr3","73211475","73211769","chr3","40497938","40498240","61","32713537"
"chr3","73223681","73223809","chr2","70039954","70040083","8","3183727"
"chr3","73233794","73234095","chr2","70029055","70029356","30","3204739"
"chr3","73306548","73306679","chr2","69956335","69956468","9","3350213"
"chr3","73327969","73328264","chr2","69940767","69941061","22","3387202"
"chr3","73975159","73975471","chr2","69865179","69865477","43","4109980"
"chr3","73986114","73986397","chr3","124267629","124267922","57","50281515"
"chr3","73992699","73993015","chr5","165928913","165929218","65","91936214"
"chr3","74152236","74152524","chr2","69687996","69688261","36","4464240"
"chr3","74161429","74161773","chr2","69678536","69678808","77","4482893"
"chr3","74227075","74227299","chr2","69607089","69607299","30","4619986"
"chr3","74229587","74229888","chr2","69604177","69604470","23","4625410"
"chr3","74233310","74233607","chr2","69600448","69600744","26","4632862"
"chr3","74263830","74264137","chr2","69570379","69570659","64","4693451"
"chr3","74266220","74266373","chr19","34621943","34622103","33","39644277"
"chr3","74266399","74266506","chr12","110350854","110350960","22","36084455"
"chr3","74294049","74294346","chrX","47001532","47001822","82","27292517"
"chr3","74299985","74300279","chr2","69538208","69538500","21","4761777"
"chr3","74301737","74302053","chr2","69536492","69536805","25","4765245"
"chr3","74306137","74306432","chr2","69532458","69532743","35","4773679"
"chr3","74310444","74310747","chr11","109624796","109625101","66","35314352"
"chr3","74312749","74312858","chr1","15121551","15121655","24","59191198"
"chr3","74373268","74373499","chr2","69463652","69463882","18","4909616"
"chr3","74414130","74414435","chr2","69422885","69423179","28","4991245"
"chr3","74422715","74423017","chr2","69414639","69414948","28","5008076"
"chr3","74425889","74426203","chr2","69411442","69411755","26","5014447"
"chr3","74454840","74455129","chr2","69382070","69382369","29","5072770"
"chr3","74465825","74466056","chrX","8697309","8697538","42","65768516"
"chr3","74473856","74473966","chr2","69362970","69363081","9","5110886"
"chr3","74484205","74484490","chr2","69352539","69352838","42","5131666"
"chr3","74497568","74497635","chrUn_NW_014808278v1","821","882","10","74496747"
"chr3","74497645","74497955","chr2","69338438","69338749","29","5159207"
"chr3","74503420","74503723","chr19","25484097","25484403","58","49019323"
"chr3","74509817","74510034","chr2","69326325","69326540","23","5183492"
"chr3","74521049","74521163","chr4","111184206","111184321","23","36663157"
"chr3","74557846","74558143","chr2","69276630","69276922","22","5281216"
"chr3","74562144","74562274","chr2","69272390","69272517","8","5289754"
"chr3","74578378","74578683","chr7","45639425","45639731","55","28938953"
"chr3","74594344","74594466","chr2","69248051","69248191","24","5346293"
"chr3","74594754","74594929","chr2","69247588","69247752","23","5347166"
"chr3","74596983","74597299","chr1","138883544","138883854","70","64286561"
"chr3","74602170","74602450","chr2","69240686","69240983","36","5361484"
"chr3","74626509","74626793","chr2","69215644","69215955","44","5410865"
"chr3","74631836","74632133","chr2","69210320","69210619","23","5421516"
"chr3","74648821","74649095","chr2","69187573","69187871","50","5461248"
"chr3","74650605","74650723","chr2","69185993","69186111","3","5464612"
"chr3","74654018","74654263","chr2","69182456","69182701","39","5471562"
"chr3","74695048","74695359","chr2","69142685","69142962","51","5552363"
"chr3","74722656","74722965","chr2","69110446","69110745","29","5612210"
"chr3","74729449","74729591","chr1","110093577","110093726","30","35364128"
"chr3","74729892","74730040","chr11","63297233","63297378","24","11432659"
"chr3","74735702","74735986","chr2","69097327","69097611","15","5638375"
"chr3","74740175","74740488","chr2","69092235","69092547","20","5647940"
"chr3","74742440","74742743","chr2","69090007","69090310","18","5652433"
"chr3","74745915","74746180","chr2","69086370","69086632","22","5659545"
"chr3","74752963","74753085","chr2","69080466","69080595","17","5672497"
"chr3","74785058","74785175","chr2","69046448","69046564","9","5738610"
"chr3","74792877","74793197","chr2","69038195","69038510","41","5754682"
"chr3","74806664","74806784","chr16","19703099","19703221","16","55103565"
"chr3","74809353","74809653","chr2","69028361","69028667","32","5780992"
"chr3","74814300","74814601","chr2","69023945","69024254","39","5790355"
"chr3","74815120","74815438","chr2","69023144","69023461","34","5791976"
"chr3","74818329","74818455","chr16","34749367","34749491","21","40068962"
"chr3","74818756","74818912","chr10","27406902","27407056","26","47411854"
"chr3","74822216","74822489","chr2","69016241","69016514","25","5805975"
"chr3","74824469","74824638","chr3","63871341","63871523","40","10953128"
"chr3","74831350","74831481","chr2","69007150","69007283","12","5824200"
"chr3","74837315","74837511","chr2","69001123","69001308","25","5836192"
"chr3","74837615","74837738","chr2","21094950","21095071","22","53742665"
"chr3","74838031","74838164","chr2","69000448","69000581","6","5837583"
"chr3","74838452","74838593","chr2","69000023","69000158","12","5838429"
"chr3","74849279","74849568","chr2","68989504","68989808","35","5859775"
"chr3","74869431","74869704","chr2","170319257","170319535","67","95449826"
"chr3","74880809","74881117","chr2","68956742","68957044","24","5924067"
"chr3","74895258","74895550","chr2","68940905","68941206","31","5954353"
"chr3","74900862","74901155","chr2","68935750","68936043","17","5965112"
"chr3","74942650","74942934","chr2","68891398","68891671","27","6051252"
"chr3","74957002","74957278","chr2","68877326","68877601","15","6079676"
"chr3","75084110","75084442","chr4","7901884","7902207","83","67182226"
"chr3","75109271","75109441","chrX","5313319","5313490","34","69795952"
"chr3","75115005","75115295","chr2","68682945","68683217","44","6432060"
"chr3","75121785","75122091","chr20","17089720","17090029","71","58032065"
"chr3","75292704","75293004","chr2","68509810","68510088","39","6782894"
"chr3","75307235","75307553","chr2","68495187","68495476","57","6812048"
"chr3","75355087","75355393","chr2","68447003","68447298","28","6908084"
"chr3","75498021","75498237","chr15","2729172","2729384","43","72768849"
"chr3","75505151","75505430","chr2","68298286","68298560","31","7206865"
"chr3","75511351","75511657","chr2","68292083","68292377","29","7219268"
"chr3","75542807","75543119","chr2","68258899","68259213","36","7283908"
"chr3","75610762","75610987","chr16","43000933","43001152","66","32609829"
"chr3","75624189","75624465","chr2","68173712","68173989","10","7450477"
"chr3","75651380","75651654","chr1","140619322","140619603","58","64967942"
"chr3","75708952","75709066","chr2","68088374","68088488","4","7620578"
"chr3","75715274","75715560","chr3","14922155","14922440","70","60793119"
"chr3","75731332","75731399","chr6","148851388","148851455","12","73120056"
"chr3","75829035","75829240","chr2","67965417","67965618","34","7863618"
"chr3","75970985","75971268","chr2","67754621","67754904","25","8216364"
"chr3","76004929","76005241","chr2","67720200","67720501","30","8284729"
"chr3","76014941","76015234","chr2","67710158","67710454","24","8304783"
"chr3","76062660","76062961","chr6","175032863","175033157","68","98970203"
"chr3","76070309","76070610","chr2","84913076","84913368","66","8842767"
"chr3","76114429","76114707","chr2","67612292","67612579","27","8502137"
"chr3","76123553","76123680","chr2","67603219","67603349","11","8520334"
"chr3","76143830","76144159","chr2","67582490","67582812","31","8561340"
"chr3","76209490","76209750","chr2","67520298","67520569","24","8689192"
"chr3","76211016","76211310","chr15","46562677","46562961","61","29648339"
"chr3","76245665","76245968","chr2","67485118","67485425","28","8760547"
"chr3","76281384","76281496","chr2","67450471","67450583","3","8830913"
"chr3","76370137","76370435","chr2","67364585","67364886","18","9005552"
"chr3","76374461","76374658","chr3","91549388","91549576","53","15174927"
"chr3","76405248","76405508","chr11","52561127","52561382","54","23844121"
"chr3","76406151","76406441","chr2","67328736","67329025","20","9077415"
"chr3","76443923","76444177","chr2","67291530","67291784","21","9152393"
"chr3","76465184","76465474","chr6","37344828","37345112","72","39120356"
"chr3","76504014","76504181","chr9","87789640","87789800","37","11285626"
"chr3","76514393","76514680","chr2","67225625","67225914","17","9288768"
"chr3","76523260","76523551","chr2","67218487","67218768","35","9304773"
"chr3","76537813","76538121","chr2","67203649","67203954","27","9334164"
"chr3","76721060","76721191","chr3","55568507","55568639","25","21152553"
"chr3","76778248","76778537","chr2","66974802","66975098","38","9803446"
"chr3","76833635","76833721","chr6","5573531","5573614","17","71260104"
"chr3","76918172","76918464","chr2","66836370","66836661","25","10081802"
"chr3","76982145","76982437","chr2","66788543","66788821","29","10193602"
"chr3","77003578","77003841","chr7","118849662","118849923","65","41846084"
"chr3","77047200","77047478","chr12","122118476","122118760","68","45071276"
"chr3","77059539","77059829","chr2","66707853","66708163","37","10351686"
"chr3","77088951","77089216","chr2","66675887","66676160","19","10413064"
"chr3","77137898","77138081","chr14","7837183","7837361","43","69300715"
"chr3","77221876","77222160","chr3","14140868","14141172","43","63081008"
"chr3","77263207","77263341","chr3","14224227","14224360","14","63038980"
"chr3","77264195","77264500","chr3","14225210","14225521","32","63038985"
"chr3","77292226","77292526","chr20","5120448","5120745","53","72171778"
"chr3","77298045","77298362","chr20","5124825","5125144","41","72173220"
"chr3","77300457","77300737","chr20","25617473","25617738","64","51682984"
"chr3","77307439","77307748","chr11","117366311","117366614","59","40058872"
"chr3","77309731","77310031","chr18","41863993","41864264","74","35445738"
"chr3","77313485","77313794","chr11","113220012","113220319","54","35906527"
"chr3","77328608","77328909","chr20","5149734","5150049","47","72178874"
"chr3","77341683","77341964","chr20","5161183","5161481","47","72180500"
"chr3","77343470","77343747","chr20","5163297","5163592","43","72180173"
"chr3","77361093","77361397","chr20","5173233","5173556","53","72187860"
"chr3","77393957","77394107","chr20","5281043","5281175","25","72112914"
"chr3","77433658","77433747","chr10","23516015","23516104","22","53917643"
"chr3","77434306","77434590","chr7","58325092","58325367","58","19109214"
"chr3","77443790","77444042","chr10","62967534","62967750","52","14476256"
"chr3","77622796","77623051","chr14","95694534","95694780","73","18071738"
"chr3","77650708","77651008","chr2","68802783","68803084","28","8847925"
"chr3","77724451","77724758","chr2","79867873","79868159","110","2143422"
"chr3","77729503","77729681","chr8","48181200","48181372","47","29548303"
"chr3","77729695","77729945","chr7","122785492","122785748","62","45055797"
"chr3","77751199","77751458","chr11","62787364","62787606","68","14963835"
"chr3","77781794","77782083","chr16","47333848","47334123","66","30447946"
"chr3","77793339","77793610","chr3","13105019","13105290","56","64688320"
"chr3","77930097","77930367","chr2","420688","420958","29","77509409"
"chr3","77952277","77952583","chr2","397962","398286","35","77554315"
"chr3","78054267","78054566","chr2","295245","295537","31","77759022"
"chr3","78133879","78134165","chr2","214506","214795","20","77919373"
"chr3","78153189","78153487","chr2","195679","195990","41","77957510"
"chr3","78178122","78178427","chr2","116366","116671","26","78061756"
"chr3","78218945","78219126","chr2","81768","81946","28","78137177"
"chr3","78232631","78232913","chr2","67731","68013","20","78164900"
"chr3","78246131","78246314","chr2","189194620","189194798","49","110948489"
"chr3","78253809","78254092","chr2","47696","47981","27","78206113"
"chr3","78258631","78258826","chr2","42671","42866","23","78215960"
"chr3","78469151","78469431","chr2","909701","909990","34","77559450"
"chr3","78477432","78477744","chr2","918181","918471","39","77559251"
"chr3","78560277","78560583","chr11","108122224","108122524","55","29561947"
"chr3","78571824","78572027","chr2","1018076","1018290","30","77553748"
"chr3","78597665","78597747","chr15","41568444","41568526","16","37029221"
"chr3","78612115","78612408","chr2","1058546","1058829","32","77553569"
"chr3","78618159","78618455","chr2","1065210","1065519","73","77552949"
"chr3","78631614","78631884","chr11","131260074","131260355","65","52628460"
"chr3","78658233","78658491","chr4","159403614","159403872","68","80745381"
"chr3","78687510","78687804","chr20","73293494","73293786","61","5394016"
"chr3","78733782","78734092","chr2","1236015","1236297","55","77497767"
"chr3","78820443","78820746","chr2","1326510","1326803","35","77493933"
"chr3","78823960","78824119","chr2","1329905","1330060","17","77494055"
"chr3","78824411","78824491","chr2","1330356","1330440","6","77494055"
"chr3","78951653","78951788","chr2","1458854","1458974","23","77492799"
"chr3","78952301","78952463","chr10","54250811","54250962","46","24701490"
"chr3","78957119","78957432","chr6","73075808","73076118","70","5881311"
"chr3","79010470","79010774","chr2","1562483","1562781","41","77447987"
"chr3","79097658","79097783","chr2","1655695","1655814","16","77441963"
"chr3","79125942","79126092","chr2","1684186","1684353","30","77441756"
"chr3","79126385","79126533","chr2","1684651","1684799","9","77441734"
"chr3","79185561","79185782","chr2","1741681","1741913","32","77443880"
"chr3","79220677","79220862","chr2","1766506","1766693","10","77454171"
"chr3","79229300","79229591","chrX","125989015","125989296","71","46759715"
"chr3","79246379","79246587","chr2","1789318","1789515","33","77457061"
"chr3","79268931","79269016","chr16","66230794","66230880","19","13038137"
"chr3","79344518","79344824","chr3","166997174","166997482","73","87652656"
"chr3","79376551","79376697","chr15","107746120","107746255","31","28369569"
"chr3","79393527","79393835","chr2","1940905","1941212","36","77452622"
"chr3","79397502","79397625","chr2","1944893","1945015","8","77452609"
"chr3","79724144","79724463","chr2","2270138","2270445","37","77454006"
"chr3","79815391","79815620","chr2","2366888","2367115","21","77448503"
"chr3","79817028","79817147","chr1","60607903","60608022","25","19209125"
"chr3","79894454","79894665","chr2","2442882","2443094","25","77451572"
"chr3","79954014","79954322","chr17","80429135","80429431","65","475121"
"chr3","80023432","80023706","chr2","2567477","2567782","45","77455955"
"chr3","80044875","80045152","chr2","2588522","2588810","26","77456353"
"chr3","80258829","80258962","chr6","152366421","152366549","21","72107592"
"chr3","80292350","80292619","chr2","2848070","2848342","19","77444280"
"chr3","80352963","80353151","chr1","34871633","34871809","45","45481330"
"chr3","80353456","80353575","chr2","160572509","160572632","19","80219053"
"chr3","80416102","80416343","chr12","82286056","82286296","62","1869954"
"chr3","80433621","80433845","chr19","2412133","2412348","46","78021488"
"chr3","80507655","80507785","chr2","3100369","3100488","18","77407286"
"chr3","80510147","80510481","chr2","3102890","3103210","34","77407257"
"chr3","80611806","80612025","chr2","3189633","3189826","40","77422173"
"chr3","80621019","80621321","chr2","3198983","3199293","36","77422036"
"chr3","80654678","80654994","chr2","3233580","3233887","51","77421098"
"chr3","80693142","80693388","chr2","3262552","3262799","27","77430590"
"chr3","80740975","80741274","chr2","3310074","3310352","33","77430901"
"chr3","80743390","80743636","chr2","3312436","3312698","27","77430954"
"chr3","80752881","80753170","chr2","3321896","3322203","35","77430985"
"chr3","80770046","80770312","chr2","3338732","3338985","37","77431314"
"chr3","80788430","80788740","chr20","14535325","14535635","67","66253105"
"chr3","80865518","80865775","chr2","3434127","3434384","13","77431391"
"chr3","80866448","80866650","chr3","155044884","155045088","44","74178436"
"chr3","80872766","80872997","chr5","165743409","165743629","59","84870643"
"chr3","80897682","80897972","chr2","84913076","84913368","64","4015394"
"chr3","80902548","80902895","chr2","3470963","3471316","31","77431585"
"chr3","80913588","80913890","chr2","3481914","3482223","27","77431674"
"chr3","81017118","81017415","chr2","3581063","3581372","37","77436055"
"chr3","81057097","81057260","chr1","35417022","35417192","37","45640075"
"chr3","81057290","81057410","chr3","57790746","57790867","25","23266544"
"chr3","81093535","81093820","chr2","3682684","3682974","17","77410851"
"chr3","81204082","81204394","chr2","181136731","181137034","58","99932649"
"chr3","81207017","81207271","chr2","56485157","56485414","76","24721860"
"chr3","81232698","81232942","chr16","73992318","73992542","64","7240380"
"chr3","81240928","81241221","chr2","3839340","3839633","27","77401588"
"chr3","81292046","81292176","chr2","3887348","3887478","6","77404698"
"chr3","81392406","81392720","chr4","36470308","36470624","79","44922098"
"chr3","81412448","81412629","chr3","156205113","156205291","40","74792665"
"chr3","81424561","81424730","chr19","5561266","5561434","33","75863295"
"chr3","81425016","81425161","chr6","122098582","122098725","31","40673566"
"chr3","81428017","81428325","chrX","13185665","13185974","64","68242352"
"chr3","81498533","81498828","chr3","127162429","127162726","71","45663896"
"chr3","81508861","81509151","chr2","4102263","4102550","36","77406598"
"chr3","81575000","81575250","chr2","4170567","4170817","26","77404433"
"chr3","81635242","81635546","chr20","28651476","28651780","51","52983766"
"chr3","81687201","81687507","chr1","77944739","77945036","67","3742462"
"chr3","81848221","81848372","chr2","4475840","4475990","8","77372381"
"chr3","81960936","81961211","chr2","4638059","4638333","22","77322877"
"chr3","82012658","82012906","chr2","4689150","4689405","30","77323508"
"chr3","82038200","82038482","chr2","4717381","4717656","26","77320819"
"chr3","82059832","82060137","chr2","4737860","4738154","34","77321972"
"chr3","82067931","82068235","chr2","4746499","4746796","41","77321432"
"chr3","82320779","82321087","chr3","36904507","36904821","64","45416272"
"chr3","83126365","83126595","chr9","25195417","25195638","49","57930948"
"chr3","83492659","83492777","chr2","5950151","5950280","17","77542508"
"chr3","83500048","83500166","chr3","178269661","178269783","26","94769613"
"chr3","83500168","83500254","chr5","39328406","39328494","19","44171762"
"chr3","83526364","83526680","chr2","5985685","5985964","53","77540679"
"chr3","83610428","83610688","chr2","6069539","6069802","12","77540889"
"chr3","83720933","83721208","chr2","6174387","6174665","32","77546546"
"chr3","83767555","83767867","chr2","6221915","6222225","23","77545640"
"chr3","83769324","83769616","chr2","6223750","6224063","35","77545574"
"chr3","83825615","83825897","chr2","6277758","6278063","48","77547857"
"chr3","83888753","83889042","chr2","6338706","6339021","51","77550047"
"chr3","83945229","83945361","chr2","6390798","6390930","6","77554431"
"chr3","83945670","83945839","chr2","6391242","6391414","13","77554428"
"chr3","84228384","84228689","chr2","6675774","6676080","23","77552610"
"chr3","84245323","84245546","chr2","6692387","6692623","45","77552936"
"chr3","84277424","84277541","chr15","29268875","29268992","14","55008549"
"chr3","84278018","84278307","chr2","6754342","6754639","25","77523676"
"chr3","84289959","84290091","chr2","6766276","6766411","11","77523683"
"chr3","84330994","84331117","chr2","6804202","6804316","15","77526792"
"chr3","84544854","84545132","chr2","7019118","7019396","17","77525736"
"chr3","84630538","84630831","chr3","155762313","155762590","75","71131775"
"chr3","84667027","84667303","chr2","7267199","7267474","25","77399828"
"chr3","84876764","84877082","chr3","101985553","101985872","66","17108789"
"chr3","84947521","84947825","chr17","28950611","28950924","69","55996910"
"chr3","84967480","84967768","chr2","7585649","7585936","18","77381831"
"chr3","85069684","85069867","chr7","3252528","3252721","57","81817156"
"chr3","85146304","85146603","chr2","7770615","7770908","31","77375689"
"chr3","85204911","85205034","chr2","7824934","7825057","9","77379977"
"chr3","85278410","85278692","chr2","7898852","7899139","24","77379558"
"chr3","85300500","85300690","chr2","7922067","7922271","35","77378433"
"chr3","85300998","85301121","chr2","7922556","7922669","20","77378442"
"chr3","85309777","85310085","chr11","117366311","117366614","60","32056534"
"chr3","85352563","85352651","chr2","7962015","7962102","4","77390548"
"chr3","85374713","85375062","chr2","7982720","7983081","46","77391993"
"chr3","85461604","85461886","chr2","8062540","8062822","22","77399064"
"chr3","85477659","85477897","chr2","8073844","8074078","18","77403815"
"chr3","85595887","85596173","chrX","46453645","46453933","80","39142242"
"chr3","85637893","85638183","chr2","8242083","8242381","30","77395810"
"chr3","85664972","85665283","chr2","8268949","8269221","67","77396023"
"chr3","85666232","85666479","chr2","8270185","8270432","25","77396047"
"chr3","85689613","85689876","chr8","92441257","92441510","66","6751644"
"chr3","85693580","85693855","chr9","35955595","35955866","71","49737985"
"chr3","85730178","85730471","chr3","81122007","81122304","70","4608171"
"chr3","85794794","85795049","chr2","8404484","8404690","57","77390310"
"chr3","85844009","85844268","chr2","8459799","8460052","41","77384210"
"chr3","85993458","85993631","chr2","8607836","8608004","22","77385622"
"chr3","86127059","86127170","chr2","8746982","8747088","10","77380077"
"chr3","86176239","86176501","chr2","8839823","8840082","31","77336416"
"chr3","86322661","86322962","chr7","140100928","140101221","60","53778267"
"chr3","86501582","86501870","chr2","9148404","9148693","28","77353178"
"chr3","86871647","86871930","chr1","18695491","18695782","75","68176156"
"chr3","87091885","87092019","chr10","15286374","15286511","37","71805511"
"chr3","87105502","87105612","chr2","9639542","9639662","18","77465960"
"chr3","87162152","87162433","chr2","9689146","9689429","27","77473006"
"chr3","87176256","87176512","chr10","72533663","72533923","55","14642593"
"chr3","87179165","87179455","chr2","9707729","9708001","36","77471436"
"chr3","87243632","87243952","chr2","9773672","9773996","31","77469960"
"chr3","87260419","87260722","chr2","9789588","9789874","32","77470831"
"chr3","87284618","87284919","chr2","9813875","9814196","52","77470743"
"chr3","87365294","87365581","chr2","9894753","9895040","25","77470541"
"chr3","87384171","87384455","chr2","9910952","9911235","28","77473219"
"chr3","87573847","87574146","chr2","10084176","10084466","48","77489671"
"chr3","87651641","87651977","chr16","55153027","55153347","97","32498614"
"chr3","87722422","87722664","chr2","10235024","10235261","26","77487398"
"chr3","87730669","87730890","chr2","10243254","10243501","47","77487415"
"chr3","87734266","87734435","chr2","61281692","61281857","38","26452574"
"chr3","87770929","87771238","chr2","10284918","10285227","28","77486011"
"chr3","87902310","87902591","chr2","10423685","10423978","35","77478625"
"chr3","87989107","87989309","chr2","10564930","10565133","9","77424177"
"chr3","88012898","88013173","chr14","4933599","4933863","63","83079299"
"chr3","88087331","88087642","chr9","99341170","99341479","66","11253839"
"chr3","88089034","88089321","chr2","10663364","10663669","51","77425670"
"chr3","88237040","88237164","chr2","10810017","10810140","10","77427023"
"chr3","88359978","88360258","chr2","10907814","10908096","18","77452164"
"chr3","88369072","88369370","chr2","10916642","10916943","32","77452430"
"chr3","88415085","88415201","chr4","7006142","7006256","15","81408943"
"chr3","88475994","88476163","chr2","11027863","11028043","21","77448131"
"chr3","88493614","88493921","chr2","11047643","11047949","17","77445971"
"chr3","88628700","88628984","chr2","11182239","11182550","48","77446461"
"chr3","88635941","88636129","chr2","11189460","11189649","14","77446481"
"chr3","88644843","88645090","chr2","11198192","11198449","32","77446651"
"chr3","88646005","88646083","chr2","11199372","11199453","9","77446633"
"chr3","88662864","88663157","chr8","98751173","98751462","67","10088309"
"chr3","88675571","88675860","chr2","11233177","11233460","20","77442394"
"chr3","88678740","88678964","chr2","11236310","11236539","29","77442430"
"chr3","88694457","88694719","chr3","30268923","30269186","67","58425534"
"chr3","88713260","88713543","chr2","11273969","11274257","27","77439291"
"chr3","88781374","88781679","chr2","11339922","11340229","23","77441452"
"chr3","88926226","88926532","chr2","11487941","11488240","31","77438285"
"chr3","89031363","89031675","chr2","11580693","11581005","11","77450670"
"chr3","89225940","89226215","chr19","33824111","33824384","72","55401829"
"chr3","89234195","89234494","chr2","11778385","11778682","38","77455810"
"chr3","89271517","89271716","chr2","11807766","11807961","24","77463751"
"chr3","89320291","89320585","chr13","47263576","47263856","67","42056715"
"chr3","89326053","89326351","chr8","51532421","51532722","60","37793632"
"chr3","89402448","89402730","chr2","11924988","11925279","42","77477460"
"chr3","89414638","89414744","chr2","11938235","11938340","5","77476403"
"chr3","89502332","89502601","chr2","12025931","12026203","16","77476401"
"chr3","89512179","89512476","chr2","12035723","12036018","23","77476456"
"chr3","89641767","89642061","chr2","12166350","12166654","42","77475417"
"chr3","89703331","89703626","chr2","12226672","12226972","23","77476659"
"chr3","89727032","89727286","chr2","12250681","12250937","16","77476351"
"chr3","89755314","89755605","chr7","140588016","140588306","55","50832702"
"chr3","89815542","89815850","chr2","12341896","12342206","18","77473646"
"chr3","89939748","89940016","chr2","12457446","12457731","33","77482302"
"chr3","90055202","90055512","chr2","12555569","12555873","30","77499633"
"chr3","90086315","90086600","chr2","12588986","12589275","19","77497329"
"chr3","90155465","90155784","chr2","12659760","12660051","43","77495705"
"chr3","90185176","90185465","chr2","12688748","12689038","21","77496428"
"chr3","90211842","90211957","chr2","12709456","12709571","9","77502386"
"chr3","90245486","90245704","chr3","181164162","181164376","43","90918676"
"chr3","90296514","90296835","chr2","12799566","12799879","31","77496948"
"chr3","90404107","90404397","chr2","12904635","12904923","23","77499472"
"chr3","90426135","90426210","chr2","12927006","12927080","8","77499129"
"chr3","90426547","90426631","chr14","48072664","48072754","27","42353883"
"chr3","90431430","90431711","chr3","44999419","44999703","75","45432011"
"chr3","90458556","90458858","chr11","48283444","48283741","55","42175112"
"chr3","90490407","90490710","chr2","12981657","12981957","31","77508750"
"chr3","90553372","90553609","chr1","138935840","138936078","60","48382468"
"chr3","90557977","90558311","chr2","13055731","13056045","36","77502246"
"chr3","90583951","90584213","chr2","13080299","13080555","42","77503652"
"chr3","90643709","90643962","chr2","13139662","13139920","35","77504047"
"chr3","90772110","90772247","chr16","52385467","52385610","29","38386643"
"chr3","90992920","90993203","chr2","13475999","13476281","26","77516921"
"chr3","91125242","91125532","chr2","13605876","13606146","39","77519366"
"chr3","91240909","91241227","chr2","13715363","13715696","50","77525546"
"chr3","91257180","91257455","chr2","13732401","13732673","29","77524779"
"chr3","91364082","91364366","chr15","11971862","11972146","57","79392220"
"chr3","91394289","91394398","chr11","48466693","48466802","23","42927596"
"chr3","91394431","91394591","chr12","10462851","10463007","38","80931580"
"chr3","91499450","91499761","chr2","13981614","13981915","36","77517836"
"chr3","91531245","91531388","chr1","11243495","11243630","32","80287750"
"chr3","91598471","91598776","chr2","14078724","14079043","35","77519747"
"chr3","91693609","91693820","chr2","14168268","14168488","20","77525341"
"chr3","91697189","91697298","chr7","17004720","17004825","28","74692469"
"chr3","91797894","91798189","chr2","14269249","14269549","29","77528645"
"chr3","92106483","92106770","chr2","14604233","14604518","32","77502250"
"chr3","92206723","92206858","chr7","52941109","52941240","36","39265614"
"chr3","92206894","92207028","chr1","44614813","44614938","27","47592081"
"chr3","92260529","92260659","chr2","14732487","14732628","22","77528042"
"chr3","92387522","92387806","chr2","14846801","14847101","49","77540721"
"chr3","92514291","92514584","chr2","14950832","14951110","31","77563459"
"chr3","92528562","92528877","chr4","36470308","36470624","67","56058254"
"chr3","92529472","92529745","chr12","11161034","11161316","61","81368438"
"chr3","97543811","97544100","chr2","84913076","84913368","65","12630735"
"chr3","97610536","97610843","chr2","14906561","14906858","51","82703975"
"chr3","97654605","97654906","chr2","14950832","14951110","30","82703773"
"chr3","97670094","97670394","chr4","118260219","118260519","58","20590125"
"chr3","97712884","97713166","chr1","160869965","160870242","64","63157081"
"chr3","97715610","97715914","chr2","15010607","15010902","33","82705003"
"chr3","97719773","97720087","chr2","15015052","15015365","37","82704721"
"chr3","97736341","97736611","chr2","15031274","15031544","16","82705067"
"chr3","97741359","97741483","chr2","15036390","15036514","1","82704969"
"chr3","97743937","97744046","chrX","112088395","112088499","16","14344458"
"chr3","97768969","97769041","chr2","15064250","15064322","6","82704719"
"chr3","97814926","97815235","chr2","15106277","15106586","22","82708649"
"chr3","97845801","97846089","chr2","15137229","15137508","30","82708572"
"chr3","97881661","97881934","chr1","44248959","44249223","71","53632702"
"chr3","97904826","97905137","chr2","15187851","15188156","32","82716975"
"chr3","98038124","98038435","chr2","15345058","15345367","22","82693066"
"chr3","98169351","98169629","chr4","13481555","13481830","69","84687796"
"chr3","98307041","98307110","chr7","37558740","37558807","14","60748301"
"chr3","98425512","98425635","chr2","15697559","15697685","14","82727953"
"chr3","98489020","98489319","chr2","15751792","15752091","25","82737228"
"chr3","98511600","98511811","chr2","15769622","15769845","29","82741978"
"chr3","98528226","98528394","chr2","15788755","15788923","22","82739471"
"chr3","98673932","98674231","chr14","12540994","12541290","61","86132938"
"chr3","98859734","98860007","chr2","16106345","16106617","22","82753389"
"chr3","99209873","99210002","chr2","16472522","16472644","11","82737351"
"chr3","99216100","99216284","chr1","31430625","31430805","56","67785475"
"chr3","99216695","99216756","chr3","124326585","124326649","16","25109890"
"chr3","99230369","99230489","chr16","32696698","32696820","39","66533671"
"chr3","99274360","99274524","chr4","29399939","29400098","41","69874421"
"chr3","99441267","99441566","chr4","73913530","73913824","87","25527737"
"chr3","99444737","99445044","chr2","16694957","16695259","31","82749780"
"chr3","99473686","99473942","chr2","16725121","16725371","25","82748565"
"chr3","99567941","99568172","chr2","16826670","16826916","34","82741271"
"chr3","99643367","99643500","chr2","16897185","16897321","10","82746182"
"chr3","99675442","99675648","chr3","126129363","126129565","42","26453921"
"chr3","99675995","99676057","chr16","32597335","32597391","23","67078660"
"chr3","99713753","99714009","chr7","131398459","131398720","67","31684706"
"chr3","99715303","99715597","chr2","16969454","16969761","45","82745849"
"chr3","99852798","99853117","chr4","104021076","104021374","71","4168278"
"chr3","99870796","99871102","chr10","15460316","15460612","67","84410480"
"chr3","99931264","99931554","chr2","17177800","17178088","26","82753464"
"chr3","100000684","100000969","chr2","17251438","17251740","41","82749246"
"chr3","100004244","100004542","chr9","15110324","15110622","69","84893920"
"chr3","100091393","100091691","chr10","31573027","31573311","72","68518366"
"chr3","100150094","100150376","chr2","17439753","17440031","25","82710341"
"chr3","100169583","100169865","chr4","37321555","37321842","71","62848028"
"chr3","100211169","100211462","chr2","56487045","56487341","69","43724124"
"chr3","100522673","100522966","chr2","17769777","17770066","31","82752896"
"chr3","100544370","100544655","chr2","17791697","17791992","30","82752673"
"chr3","100607589","100607815","chr2","17856736","17856963","24","82750853"
"chr3","100613593","100613905","chr2","17862595","17862906","40","82750998"
"chr3","100660791","100660905","chr7","138446004","138446118","16","37785213"
"chr3","100660957","100661121","chr14","32139013","32139178","39","68521944"
"chr3","100701600","100701894","chr2","17948647","17948938","28","82752953"
"chr3","100880898","100881144","chr2","18129832","18130079","13","82751066"
"chr3","100892626","100892902","chr2","18141612","18141882","29","82751014"
"chr3","101085148","101085475","chr2","18323016","18323331","35","82762132"
"chr3","101170161","101170457","chr2","18413682","18413979","24","82756479"
"chr3","101194222","101194345","chr2","18438011","18438134","6","82756211"
"chr3","101278490","101278757","chr11","120898373","120898651","60","19619883"
"chr3","101382804","101383066","chr2","18624176","18624437","30","82758628"
"chr3","101496205","101496516","chr2","18729945","18730251","24","82766260"
"chr3","101517495","101517583","chr2","18751218","18751302","9","82766277"
"chr3","101570806","101571118","chr2","18806294","18806601","25","82764512"
"chr3","101594596","101594821","chr3","5270903","5271149","67","96323693"
"chr3","101597199","101597488","chr1","77371529","77371830","58","24225670"
"chr3","101658573","101658873","chr2","18897611","18897919","31","82760962"
"chr3","101716736","101717039","chr6","77210653","77210958","72","24506083"
"chr3","101788241","101788549","chr14","63858277","63858583","63","37929964"
"chr3","101865180","101865464","chr10","49449900","49450186","62","52415280"
"chr3","102091505","102091715","chr2","19149265","19149474","12","82942240"
"chr3","102149197","102149513","chrX","64991673","64991978","68","37157524"
"chr3","102212907","102213187","chr1","191690399","191690678","53","89477492"
"chr3","102235678","102235960","chr2","19284071","19284361","26","82951607"
"chr3","102284469","102284736","chr2","19311726","19311993","15","82972743"
"chr3","102285266","102285377","chr2","19312523","19312633","9","82972743"
"chr3","102381349","102381632","chr2","19416107","19416392","23","82965242"
"chr3","102441063","102441347","chr3","40783093","40783379","56","61657970"
"chr3","102447296","102447567","chrX","113906906","113907171","55","11459610"
"chr3","102501707","102501929","chr2","19515415","19515637","24","82986292"
"chr3","102506311","102506618","chr2","19521295","19521599","30","82985016"
"chr3","102521186","102521496","chr2","19536875","19537170","36","82984311"
"chr3","102597440","102597602","chr2","19660896","19661052","19","82936544"
"chr3","102597868","102598001","chr2","19661326","19661460","12","82936542"
"chr3","102619717","102619981","chr2","19684305","19684570","16","82935412"
"chr3","102738354","102738510","chr6","93577303","93577440","39","9161051"
"chr3","102834137","102834437","chr2","19884563","19884848","39","82949574"
"chr3","102844195","102844322","chr19","33711443","33711568","21","69132752"
"chr3","102872649","102872781","chr2","19918369","19918492","17","82954280"
"chr3","102919497","102919800","chr2","19967303","19967602","29","82952194"
"chr3","103019246","103019365","chr3","36373230","36373353","21","66646016"
"chr3","103124207","103124447","chr2","20248141","20248384","23","82876066"
"chr3","103243309","103243579","chr2","20372199","20372472","21","82871110"
"chr3","103292878","103293170","chr2","20420549","20420824","34","82872329"
"chr3","103329431","103329713","chr2","20457036","20457320","26","82872395"
"chr3","103397290","103397582","chr2","20530740","20531040","32","82866550"
"chr3","103582810","103583107","chr2","20709233","20709512","54","82873577"
"chr3","103592377","103592575","chr2","20718826","20719028","21","82873551"
"chr3","103604877","103605182","chr2","20731253","20731550","41","82873624"
"chr3","103758474","103758585","chr7","44267758","44267870","19","59490716"
"chr3","103758956","103759257","chr2","20892555","20892863","22","82866401"
"chr3","103761769","103762023","chr2","20895315","20895567","16","82866454"
"chr3","103932302","103932500","chr19","2803647","2803831","54","101128655"
"chr3","103932792","103932933","chr2","21073668","21073797","16","82859124"
"chr3","103953531","103953652","chr2","21094950","21095071","8","82858581"
"chr3","103969335","103969638","chr2","21110858","21111158","28","82858477"
"chr3","103977088","103977262","chr2","21118285","21118450","26","82858803"
"chr3","103977558","103977651","chr2","21118754","21118847","4","82858804"
"chr3","103978110","103978239","chr2","21119276","21119405","6","82858834"
"chr3","103995471","103995594","chr2","21137278","21137400","12","82858193"
"chr3","103995887","103996062","chr2","21137703","21137855","36","82858184"
"chr3","104004316","104004614","chr4","18422688","18422991","56","85581628"
"chr3","104012201","104012442","chrX","24513675","24513909","58","79498526"
"chr3","104012520","104012626","chr2","21154217","21154323","6","82858303"
"chr3","104067712","104067997","chr2","21212031","21212323","25","82855681"
"chr3","104122333","104122551","chr2","21267010","21267208","39","82855323"
"chr3","104124018","104124312","chr2","21268158","21268449","20","82855860"
"chr3","104227787","104228093","chr2","21359677","21359983","17","82868110"
"chr3","104228906","104229186","chr2","21361133","21361399","43","82867773"
"chr3","104238525","104238673","chr2","204656325","204656478","38","100417800"
"chr3","104258375","104258667","chr2","21394587","21394879","18","82863788"
"chr3","104260754","104261056","chr2","21396936","21397237","19","82863818"
"chr3","104275523","104275817","chr1","25648767","25649057","62","78626756"
"chr3","104298087","104298393","chr7","157800496","157800800","57","53502409"
"chr3","104314718","104314998","chr8","143157713","143157992","65","38842995"
"chr3","104388662","104388969","chr4","85565139","85565443","65","18823523"
"chr3","104457246","104457589","chr11","76067720","76068044","68","28389526"
"chr3","104490836","104491144","chr2","21661086","21661396","39","82829750"
"chr3","104526266","104526526","chr11","61495292","61495561","65","43030974"
"chr3","104621570","104621820","chr2","21791116","21791342","40","82830454"
"chr3","104683529","104683645","chr1","148386664","148386780","18","43703135"
"chr3","104857213","104857329","chr2","22032793","22032907","8","82824420"
"chr3","104857682","104857857","chr2","22033263","22033446","22","82824419"
"chr3","104866600","104866886","chr2","22041723","22042017","27","82824877"
"chr3","104958627","104958951","chr2","22125662","22125982","37","82832965"
"chr3","105018672","105018980","chr2","22184025","22184332","17","82834647"
"chr3","105028414","105028629","chr2","22193822","22194031","24","82834592"
"chr3","105110797","105111069","chr2","22284678","22284951","20","82826119"
"chr3","105141462","105141751","chr2","22315143","22315456","47","82826319"
"chr3","105174725","105174999","chr2","22347554","22347828","15","82827171"
"chr3","105178390","105178698","chr2","22351219","22351523","17","82827171"
"chr3","105215034","105215205","chr2","22393735","22393905","7","82821299"
"chr3","105222867","105223158","chr9","43049280","43049571","67","62173587"
"chr3","105239017","105239279","chr2","22410263","22410520","48","82828754"
"chr3","105253775","105254072","chr2","22425262","22425548","28","82828513"
"chr3","105254873","105255159","chr2","22426364","22426649","16","82828509"
"chr3","105268011","105268322","chr2","22439769","22440060","36","82828242"
"chr3","105273116","105273240","chr2","165531071","165531193","19","60257955"
"chr3","105278290","105278585","chr11","117851010","117851305","76","12572720"
"chr3","105279142","105279410","chr2","22450499","22450762","23","82828643"
"chr3","105279769","105280046","chr2","22451166","22451443","42","82828603"
"chr3","105284853","105285140","chr2","22457527","22457809","25","82827326"
"chr3","105287327","105287610","chr2","22459989","22460279","18","82827338"
"chr3","105294400","105294619","chr1","27274532","27274755","54","78019868"
"chr3","105296424","105296732","chr2","22466411","22466720","37","82830013"
"chr3","105312649","105312783","chr2","22481457","22481578","19","82831192"
"chr3","105317718","105318018","chr2","22486509","22486820","23","82831209"
"chr3","105331350","105331650","chr2","160551205","160551504","56","55219855"
"chr3","105360158","105360347","chr2","22534822","22535005","9","82825336"
"chr3","105371744","105371872","chr2","22546255","22546383","8","82825489"
"chr3","105372165","105372327","chr2","22546679","22546840","12","82825486"
"chr3","105379608","105379719","chrX","40440621","40440736","16","64938987"
"chr3","105380411","105380630","chr2","45945040","45945260","35","59435371"
"chr3","105387266","105387516","chr12","83658601","83658861","53","21728665"
"chr3","105390521","105390813","chr2","22579796","22580088","9","82810725"
"chr3","105394842","105395060","chr19","39028175","39028394","44","66366667"
"chr3","105395683","105395958","chr2","22583195","22583468","20","82812488"
"chr3","105399797","105400131","chr2","22587237","22587543","60","82812560"
"chr3","105422150","105422277","chr19","4529726","4529846","26","100892424"
"chr3","105444234","105444346","chr7","135164576","135164693","22","29720342"
"chr3","105452883","105453177","chr2","22633768","22634049","31","82819115"
"chr3","105472629","105472923","chr2","22643052","22643359","25","82829577"
"chr3","105475084","105475374","chr9","23116704","23116994","58","82358380"
"chr3","105477790","105478095","chr1","39092983","39093291","60","66384807"
"chr3","105481741","105481908","chr4","31597865","31598035","45","73883876"
"chr3","105484827","105484957","chr2","22657742","22657870","11","82827085"
"chr3","105486201","105486493","chr2","22659118","22659409","17","82827083"
"chr3","105503013","105503311","chr6","6301868","6302166","52","99201145"
"chr3","105523656","105523834","chr2","22687737","22687937","41","82835919"
"chr3","105524561","105524792","chrX","102156759","102156998","76","3367802"
"chr3","105529227","105529481","chr2","22694041","22694326","47","82835186"
"chr3","105532762","105532897","chr2","22697639","22697783","15","82835123"
"chr3","105533204","105533376","chr2","22698090","22698258","11","82835114"
"chr3","105537133","105537258","chr2","22702312","22702437","11","82834821"
"chr3","105551217","105551537","chr2","22718534","22718847","29","82832683"
"chr3","105558292","105558581","chr2","22725772","22726061","18","82832520"
"chr3","105566620","105566705","chr10","40874887","40874970","15","64691733"
"chr3","105590672","105590951","chr2","22757273","22757552","19","82833399"
"chr3","105599099","105599423","chr2","22766006","22766305","42","82833093"
"chr3","105610428","105610729","chr3","81122007","81122304","62","24488421"
"chr3","105612571","105612873","chr2","22779315","22779624","19","82833256"
"chr3","105634129","105634245","chr2","22800821","22800936","11","82833308"
"chr3","105635468","105635725","chr2","22802202","22802443","32","82833266"
"chr3","105641514","105641730","chr2","22808212","22808428","10","82833302"
"chr3","105650162","105650452","chr2","22814825","22815138","44","82835337"
"chr3","105656446","105656758","chr2","22821338","22821634","37","82835108"
"chr3","105658446","105658722","chr2","22823332","22823620","52","82835114"
"chr3","105699777","105700058","chr2","22862327","22862619","22","82837450"
"chr3","105701487","105701793","chr2","22864377","22864683","24","82837110"
"chr3","105807538","105807833","chr2","22985765","22986060","42","82821773"
"chr3","105912863","105913153","chr2","44461738","44462025","72","61451125"
"chr3","105964451","105964736","chr2","23138288","23138578","29","82826163"
"chr3","105977456","105977742","chr2","23153717","23153987","26","82823739"
"chr3","105999835","105999996","chr19","14918735","14918894","37","91081100"
"chr3","106000001","106000122","chr1","205464254","205464380","17","99464253"
"chr3","106030897","106031085","chr6","129533900","129534048","65","23503003"
"chr3","106135055","106135130","chr2","23316359","23316429","10","82818696"
"chr3","106309840","106310143","chr2","23497678","23497978","32","82812162"
"chr3","106351542","106351808","chr1","188619656","188619927","67","82268114"
"chr3","106455207","106455492","chr3","72383698","72383983","50","34071509"
"chr3","106499621","106499942","chr2","23695497","23695807","41","82804124"
"chr3","106534831","106535117","chr2","23730431","23730717","20","82804400"
"chr3","106769206","106769494","chr2","23957064","23957352","19","82812142"
"chr3","106822389","106822714","chr2","24008081","24008387","40","82814308"
"chr3","107076786","107077082","chr2","24261852","24262138","42","82814934"
"chr3","107091596","107091849","chr2","24276117","24276399","48","82815479"
"chr3","107470891","107471168","chr2","50547191","50547469","63","56923700"
"chr3","107486133","107486376","chr1","100753208","100753448","59","6732925"
"chr3","107718252","107718538","chr2","24892379","24892692","54","82825873"
"chr3","108179936","108180272","chr12","11730535","11730844","85","96449401"
"chr3","108429898","108430186","chr2","25398401","25398689","19","83031497"
"chr3","108460934","108461205","chr6","158654891","158655162","61","50193957"
"chr3","108481522","108481829","chr2","25438711","25439019","22","83042811"
"chr3","108624985","108625283","chr2","25573996","25574297","25","83050989"
"chr3","108699764","108699881","chr2","25642268","25642386","14","83057496"
"chr3","108722281","108722567","chr2","25664279","25664565","36","83058002"
"chr3","108773437","108773688","chr2","25711747","25712016","39","83061690"
"chr3","108813727","108814029","chr2","25752468","25752782","39","83061259"
"chr3","108863602","108863908","chr1","28260327","28260628","70","80603275"
"chr3","108869714","108870014","chr2","25807293","25807597","25","83062421"
"chr3","108879306","108879581","chr2","25817923","25818210","39","83061383"
"chr3","109095421","109095721","chr2","26029574","26029874","20","83065847"
"chr3","109117006","109117249","chr14","48082291","48082542","64","61034715"
"chr3","109166793","109167012","chr19","14635431","14635655","60","94531362"
"chr3","109204518","109204752","chr2","26143481","26143713","21","83061037"
"chr3","109315920","109316031","chr2","26251527","26251642","15","83064393"
"chr3","109346476","109346778","chr2","26281123","26281392","44","83065353"
"chr3","109384541","109384825","chr2","26312910","26313194","20","83071631"
"chr3","109482750","109483027","chr2","26408574","26408850","30","83074176"
"chr3","109534457","109534750","chr2","26461215","26461513","21","83073242"
"chr3","109622562","109622844","chr2","26549855","26550135","16","83072707"
"chr3","109654202","109654496","chr2","26582764","26583057","27","83071438"
"chr3","109685140","109685420","chr2","26611748","26612027","31","83073392"
"chr3","109740546","109740857","chr9","106607385","106607691","62","3133161"
"chr3","109747719","109747835","chr2","26674789","26674906","12","83072930"
"chr3","109756736","109756971","chr2","26683813","26684045","18","83072923"
"chr3","109911245","109911531","chr2","26838421","26838708","17","83072824"
"chr3","109923031","109923154","chr2","26850930","26851052","6","83072101"
"chr3","109959668","109959958","chr2","26885107","26885398","24","83074561"
"chr3","109998636","109998813","chr2","26934239","26934419","17","83064397"
"chr3","110004521","110004631","chr1","140328428","140328538","27","30323907"
"chr3","110051809","110051902","chr3","8509589","8509671","24","101542220"
"chr3","110138333","110138604","chr1","142159134","142159394","76","32020801"
"chr3","110281009","110281292","chr2","27261515","27261797","31","83019494"
"chr3","110340845","110341101","chr2","27323932","27324191","16","83016913"
"chr3","110459005","110459236","chr2","27436916","27437134","27","83022089"
"chr3","110466657","110466776","chr1","198395351","198395472","24","87928694"
"chr3","110467073","110467143","chr10","60477217","60477274","22","49989856"
"chr3","110486374","110486650","chr2","27463141","27463424","39","83023233"
"chr3","110529101","110529389","chr2","27504042","27504323","33","83025059"
"chr3","110539692","110539995","chr1","195814241","195814525","67","85274549"
"chr3","110542111","110542444","chrX","24009154","24009472","88","86532957"
"chr3","110785204","110785480","chr2","27730262","27730540","23","83054942"
"chr3","111074414","111074709","chr2","28055212","28055515","25","83019202"
"chr3","111146805","111147098","chr2","28127638","28127925","34","83019167"
"chr3","111156755","111156966","chr2","28137037","28137248","20","83019718"
"chr3","111202855","111203162","chr2","28182240","28182551","30","83020615"
"chr3","111314485","111314615","chr2","28287325","28287457","11","83027160"
"chr3","111367535","111367835","chr2","28340933","28341236","58","83026602"
"chr3","111400033","111400327","chr2","28431563","28431859","24","82968470"
"chr3","111429279","111429580","chr2","28457347","28457648","24","82971932"
"chr3","111431209","111431523","chr2","28459294","28459623","37","82971915"
"chr3","111445034","111445288","chr7","67935717","67935941","66","43509317"
"chr3","111500624","111500910","chr2","28530034","28530323","29","82970590"
"chr3","111535298","111535598","chr2","28563914","28564213","27","82971384"
"chr3","111548093","111548393","chr2","28576465","28576759","24","82971628"
"chr3","111557581","111557851","chr2","28585940","28586230","39","82971641"
"chr3","111704765","111705076","chrX","127203368","127203678","73","15498603"
"chr3","111722341","111722508","chr6","77837264","77837435","35","33885077"
"chr3","111745237","111745539","chr2","28768258","28768558","30","82976979"
"chr3","111757662","111757971","chr2","28780702","28781017","28","82976960"
"chr3","111778700","111778999","chr2","28795141","28795442","19","82983559"
"chr3","111796741","111796918","chr2","28811012","28811189","6","82985729"
"chr3","111832338","111832463","chr5","14863431","14863555","22","96968907"
"chr3","111835720","111836008","chr2","28850215","28850487","42","82985505"
"chr3","111883655","111883954","chr2","28898807","28899103","27","82984848"
"chr3","112038293","112038404","chr12","21338124","21338233","22","90700169"
"chr3","112077696","112078014","chr2","29094421","29094738","34","82983275"
"chr3","112091133","112091442","chr2","29107551","29107853","35","82983582"
"chr3","112101760","112102030","chr2","29118456","29118736","29","82983304"
"chr3","112202894","112203188","chr2","29222191","29222485","26","82980703"
"chr3","112271718","112271960","chr19","3350946","3351183","51","108920772"
"chr3","112275018","112275285","chr2","29298724","29298985","20","82976294"
"chr3","112312553","112312843","chr2","29337642","29337952","44","82974911"
"chr3","112545687","112545987","chr2","29553192","29553498","21","82992495"
"chr3","112550063","112550364","chr2","29557563","29557872","24","82992500"
"chr3","112604215","112604358","chr2","29626077","29626230","15","82978138"
"chr3","112651828","112652102","chr19","37220448","37220723","53","75431380"
"chr3","112798956","112799040","chr2","29820355","29820439","4","82978601"
"chr3","112799559","112799734","chr14","54336228","54336401","36","58463331"
"chr3","112847049","112847308","chr17","78010791","78011045","62","34836258"
"chr3","112870744","112870872","chr2","29893686","29893813","11","82977058"
"chr3","112888248","112888549","chr2","29909941","29910241","23","82978307"
"chr3","113009150","113009446","chr5","80475344","80475637","66","32533806"
"chr3","113124932","113125059","chr2","30148817","30148941","10","82976115"
"chr3","113225827","113225971","chr2","30254385","30254529","9","82971442"
"chr3","113257395","113257518","chr2","30291951","30292068","11","82965444"
"chr3","113306934","113307246","chr2","30345349","30345651","37","82961585"
"chr3","113327607","113327894","chr7","54431682","54431970","72","58895925"
"chr3","113343913","113344139","chr14","6862253","6862481","52","106481660"
"chr3","113345533","113345806","chr1","5819632","5819900","51","107525901"
"chr3","113351680","113351956","chr2","30397938","30398236","38","82953742"
"chr3","113352156","113352362","chr13","30070965","30071173","49","83281191"
"chr3","113369031","113369418","chr2","30414250","30414605","52","82954781"
"chr3","113370556","113370806","chr19","29380231","29380468","64","83990325"
"chr3","113371605","113371864","chr2","30416681","30416940","14","82954924"
"chr3","113387158","113387424","chr7","123257225","123257505","72","9870067"
"chr3","113388040","113388300","chr4","6959324","6959591","69","106428716"
"chr3","113398067","113398368","chr2","30445396","30445694","24","82952671"
"chr3","113421700","113421831","chr19","33727543","33727676","18","79694157"
"chr3","113471261","113471311","chr12","34502965","34503015","7","78968296"
"chr3","113471463","113471742","chr2","30524654","30524945","29","82946809"
"chr3","113491374","113491676","chr2","30552037","30552334","22","82939337"
"chr3","113591803","113592056","chr2","30649214","30649445","35","82942589"
"chr3","113626633","113626715","chr2","30678178","30678260","7","82948455"
"chr3","113696720","113697028","chrX","15099734","15100040","70","98596986"
"chr3","113738941","113739240","chr2","30782070","30782367","24","82956871"
"chr3","113842797","113843114","chr2","30883439","30883753","15","82959358"
"chr3","114178117","114178376","chr15","10061574","10061835","62","104116543"
"chr3","114385348","114385636","chr2","31375198","31375481","17","83010150"
"chr3","114546202","114546327","chr2","31556192","31556317","8","82990010"
"chr3","114589882","114589996","chr3","178929122","178929237","22","64339240"
"chr3","114590931","114591248","chr2","31597701","31598015","44","82993230"
"chr3","114605202","114605489","chr8","86768229","86768522","64","27836973"
"chr3","114701106","114701397","chr2","31713434","31713725","23","82987672"
"chr3","114820731","114821004","chr2","31826204","31826496","44","82994527"
"chr3","114846922","114847202","chr1","220290357","220290635","62","105443435"
"chr3","114867548","114867851","chr2","31881754","31882052","20","82985794"
"chr3","115061339","115061640","chr2","32067365","32067644","37","82993974"
"chr3","115120010","115120308","chr2","32133409","32133714","34","82986601"
"chr3","115139444","115139726","chr2","32153424","32153706","18","82986020"
"chr3","115140244","115140447","chr2","32154224","32154425","20","82986020"
"chr3","115157236","115157545","chr2","32171656","32171960","36","82985580"
"chr3","115264270","115264527","chr1","35913015","35913264","63","79351255"
"chr3","115307831","115308108","chr2","32323769","32324049","21","82984062"
"chr3","115805686","115805808","chr2","32806324","32806446","9","82999362"
"chr3","115816838","115817143","chr2","32817276","32817583","25","82999562"
"chr3","115862583","115862893","chr2","32857766","32858080","28","83004817"
"chr3","115868019","115868304","chr2","32863263","32863552","23","83004756"
"chr3","115880082","115880199","chr2","32875573","32875694","15","83004509"
"chr3","115908103","115908387","chr2","32903342","32903631","28","83004761"
"chr3","115923722","115924021","chr2","32919209","32919513","23","83004513"
"chr3","115967873","115967969","chr2","32962663","32962759","4","83005210"
"chr3","115977413","115977676","chr8","93540152","93540409","62","22437261"
"chr3","115980881","115981032","chr2","32976800","32976947","11","83004081"
"chr3","115997084","115997373","chr2","32993258","32993552","25","83003826"
"chr3","116024034","116024317","chr2","33020451","33020739","17","83003583"
"chr3","116099534","116099758","chr2","33099697","33099929","24","82999837"
"chr3","116106808","116107112","chr2","33106793","33107093","24","83000015"
"chr3","116132608","116132917","chr2","33131903","33132211","30","83000705"
"chr3","116133295","116133590","chr2","33132589","33132881","23","83000706"
"chr3","116251813","116252098","chr2","33243517","33243799","30","83008296"
"chr3","116338052","116338327","chr2","33320031","33320305","26","83018021"
"chr3","116340019","116340290","chr2","33322167","33322438","21","83017852"
"chr3","116354813","116355105","chr2","33336286","33336569","33","83018527"
"chr3","116360085","116360366","chr2","33341566","33341852","24","83018519"
"chr3","116367365","116367651","chr2","33348620","33348910","14","83018745"
"chr3","116370366","116370626","chr1","144291826","144292083","68","27921460"
"chr3","116395424","116395702","chr2","33389317","33389615","35","83006107"
"chr3","116402311","116402545","chr2","33396046","33396280","13","83006265"
"chr3","116403682","116403942","chr2","33397099","33397381","53","83006583"
"chr3","116414845","116415138","chr2","33408465","33408758","25","83006380"
"chr3","116436282","116436556","chr2","33429871","33430156","30","83006411"
"chr3","116500263","116500354","chr5","569659","569749","20","115930604"
"chr3","116577260","116577548","chr2","33571969","33572256","21","83005291"
"chr3","116864460","116864764","chr2","33890998","33891269","51","82973462"
"chr3","116869444","116869566","chr16","24790183","24790306","21","92079261"
"chr3","116932979","116933140","chr2","33958483","33958644","28","82974496"
"chr3","116979610","116979932","chr2","33980290","33980583","47","82999320"
"chr3","117046915","117047202","chr2","34028564","34028851","19","83018351"
"chr3","117060131","117060447","chr2","34039988","34040302","28","83020143"
"chr3","117063074","117063172","chr1","222777175","222777273","28","105714101"
"chr3","117176354","117176597","chr2","34156754","34157001","28","83019600"
"chr3","117179928","117180215","chr2","34160341","34160641","35","83019587"
"chr3","117188017","117188329","chr2","34168370","34168670","26","83019647"
"chr3","117195677","117195978","chr2","34175384","34175689","23","83020293"
"chr3","117219214","117219515","chr2","34199546","34199849","30","83019668"
"chr3","117235811","117236131","chr3","124583002","124583318","76","7347191"
"chr3","117360560","117360701","chr18","48189873","48190014","29","69170687"
"chr3","117500292","117500405","chr2","34475103","34475216","7","83025189"
"chr3","117529392","117529698","chr2","34506337","34506637","25","83023055"
"chr3","117569619","117569911","chr20","41706573","41706866","58","75863046"
"chr3","117577125","117577432","chr2","34546831","34547136","24","83030294"
"chr3","117598909","117599187","chr2","34574145","34574436","37","83024764"
"chr3","117634322","117634597","chr12","88739854","88740125","65","28894468"
"chr3","117641754","117642050","chr3","81122007","81122304","60","36519747"
"chr3","117658459","117658762","chr2","34627566","34627860","33","83030893"
"chr3","117686075","117686351","chr2","34655458","34655768","52","83030617"
"chr3","117700736","117700996","chr16","54192232","54192500","58","63508504"
"chr3","117742222","117742424","chr1","217290673","217290864","44","99548451"
"chr3","117742478","117742543","chr3","183745929","183745991","17","66003451"
"chr3","117749764","117749894","chr2","34714622","34714751","9","83035142"
"chr3","117764676","117764934","chr2","34729266","34729545","35","83035410"
"chr3","117771969","117772249","chr2","34738262","34738561","35","83033707"
"chr3","117815279","117815600","chr2","34783591","34783909","44","83031688"
"chr3","117838055","117838338","chr14","115049792","115050083","64","2788263"
"chr3","117846048","117846349","chr4","128630218","128630537","76","10784170"
"chr3","117852810","117853103","chr17","80429135","80429431","54","37423675"
"chr3","117861252","117861533","chr2","34827875","34828156","14","83033377"
"chr3","117877831","117878079","chr7","138589300","138589547","54","20711469"
"chr3","117881771","117881901","chr2","34852727","34852858","9","83029044"
"chr3","117882277","117882569","chr2","34853228","34853524","29","83029049"
"chr3","117885936","117886044","chr2","34857283","34857395","12","83028653"
"chr3","117888719","117889019","chr12","77073425","77073722","72","40815294"
"chr3","117900011","117900297","chr2","34869844","34870129","19","83030167"
"chr3","117908100","117908397","chr2","34878303","34878604","34","83029797"
"chr3","117919917","117920101","chr7","140976408","140976591","41","23056491"
"chr3","117928646","117928921","chr2","34897120","34897390","20","83031526"
"chr3","117929394","117929521","chr11","33393852","33393977","17","84535542"
"chr3","117929930","117930047","chr1","31118551","31118669","17","86811379"
"chr3","117930312","117930503","chr2","145371452","145371636","44","27441140"
"chr3","117949845","117950138","chr2","34916124","34916422","21","83033721"
"chr3","117970817","117971115","chr2","34936794","34937075","34","83034023"
"chr3","117977350","117977644","chr2","34943159","34943451","19","83034191"
"chr3","117991304","117991468","chr6","121805704","121805865","34","3814400"
"chr3","117991706","117991830","chr19","45569405","45569529","22","72422301"
"chr3","118029505","118029628","chr16","20959525","20959648","23","97069980"
"chr3","118048265","118048571","chr2","35016517","35016823","14","83031748"
"chr3","118053332","118053611","chr2","35021189","35021458","30","83032143"
"chr3","118062755","118062885","chr2","35030926","35031056","5","83031829"
"chr3","118140237","118140337","chr1","14445005","14445104","19","103695232"
"chr3","118142266","118142523","chr2","35108613","35108870","40","83033653"
"chr3","118152696","118152975","chr2","180481533","180481809","61","62328837"
"chr3","118157307","118157593","chr2","35124025","35124312","15","83033282"
"chr3","118158244","118158554","chr2","35125296","35125589","51","83032948"
"chr3","118189094","118189214","chr1","205347334","205347458","20","87158240"
"chr3","118206112","118206414","chr3","93760286","93760571","76","24445826"
"chr3","118234591","118234884","chr2","35201944","35202232","26","83032647"
"chr3","118256950","118257251","chr2","35226395","35226729","53","83030555"
"chr3","118312626","118312890","chr5","139263693","139263952","57","20951067"
"chr3","118511564","118511859","chr2","35484446","35484754","33","83027118"
"chr3","118602022","118602319","chr2","35577138","35577426","31","83024884"
"chr3","118668251","118668570","chr2","35643423","35643742","22","83024828"
"chr3","118777582","118777874","chr2","35756566","35756862","24","83021016"
"chr3","118834393","118834696","chr9","18533369","18533663","61","100301024"
"chr3","118890995","118891115","chr2","35863893","35864015","14","83027102"
"chr3","118923337","118923518","chr3","9517812","9517996","40","109405525"
"chr3","118923728","118923855","chr1","221236611","221236747","31","102312883"
"chr3","118935190","118935467","chr2","35952966","35953244","22","82982224"
"chr3","119154451","119154739","chr2","36167187","36167486","25","82987264"
"chr3","119172334","119172641","chr2","36183731","36184045","26","82988603"
"chr3","119255510","119255800","chr2","36278236","36278535","24","82977274"
"chr3","119280523","119280643","chr2","36307484","36307608","11","82973039"
"chr3","119338058","119338330","chr20","23073380","23073643","70","96264678"
"chr3","119345664","119345941","chr2","36366939","36367214","31","82978725"
"chr3","119349896","119350151","chr2","36371273","36371530","22","82978623"
"chr3","119442700","119443001","chr2","36459887","36460182","27","82982813"
"chr3","119488647","119488764","chr1","15003529","15003646","21","104485118"
"chr3","119488818","119489009","chr18","12820393","12820569","39","106668425"
"chr3","119535451","119535743","chr2","36552567","36552878","34","82982884"
"chr3","119639614","119639819","chr2","36649606","36649811","11","82990008"
"chr3","119679371","119679650","chr2","36689298","36689553","47","82990073"
"chr3","119693963","119694257","chr1","92244592","92244895","60","27449371"
"chr3","119710291","119710573","chr2","36723430","36723723","38","82986861"
"chr3","119711795","119712115","chr2","36725005","36725284","56","82986790"
"chr3","119996899","119997204","chr2","36996981","36997277","30","82999918"
"chr3","119999070","119999313","chr2","36999449","36999692","17","82999621"
"chr3","120042658","120042954","chr2","37051322","37051612","23","82991336"
"chr3","120091816","120092123","chr2","37103428","37103695","56","82988388"
"chr3","120100028","120100193","chrX","13233270","13233431","42","106866758"
"chr3","120100196","120100512","chr2","37112598","37112901","34","82987598"
"chr3","120146751","120147033","chr2","37165433","37165714","27","82981318"
"chr3","120191670","120192001","chr2","37207835","37208145","41","82983835"
"chr3","120202624","120202910","chr2","37218904","37219190","25","82983720"
"chr3","120293234","120293463","chr2","37307607","37307834","15","82985627"
"chr3","120322591","120322864","chr2","37338614","37338893","27","82983977"
"chr3","120389817","120390127","chr2","37407005","37407316","29","82982812"
"chr3","120438408","120438689","chr1","115528428","115528706","61","4909980"
"chr3","120455187","120455444","chr2","37473271","37473528","28","82981916"
"chr3","120521191","120521493","chr2","37537371","37537636","58","82983820"
"chr3","120534704","120534823","chr2","37554483","37554602","5","82980221"
"chr3","120535808","120536108","chr2","37555711","37556019","30","82980097"
"chr3","120573916","120574127","chr2","37590771","37590972","27","82983145"
"chr3","120711961","120712238","chr5","108586501","108586769","97","12125460"
"chr3","120902243","120902363","chr4","158520972","158521093","24","37618729"
"chr3","120954173","120954468","chr2","37981311","37981616","26","82972862"
"chr3","121036183","121036470","chr2","38063599","38063887","31","82972584"
"chr3","121092164","121092481","chr2","38124189","38124497","31","82967975"
"chr3","121113189","121113481","chr14","115049792","115050083","51","6063397"
"chr3","121125510","121125806","chr2","38157870","38158156","34","82967640"
"chr3","121149167","121149445","chr2","38182800","38183090","35","82966367"
"chr3","121216732","121217030","chr2","38252740","38253066","51","82963992"
"chr3","121308749","121308870","chr6","67595761","67595884","18","53712988"
"chr3","121395134","121395429","chr13","45053818","45054106","51","76341316"
"chr3","121467960","121468278","chr2","38504184","38504502","28","82963776"
"chr3","121540257","121540543","chr2","38577189","38577503","51","82963068"
"chr3","121615805","121616127","chr2","38653243","38653559","73","82962562"
"chr3","121621803","121622113","chr2","38659296","38659609","23","82962507"
"chr3","121629002","121629306","chr2","38668722","38669015","29","82960280"
"chr3","121663376","121663640","chr2","38704167","38704438","22","82959209"
"chr3","121678917","121679222","chr4","141890119","141890413","68","20211202"
"chr3","121679645","121679939","chr6","176458169","176458462","56","54778524"
"chr3","122037547","122037823","chr2","39082633","39082909","19","82954914"
"chr3","122060939","122061226","chr2","39106372","39106659","22","82954567"
"chr3","122116357","122116645","chr2","39153404","39153692","19","82962953"
"chr3","122367477","122367720","chr2","39461681","39461912","28","82905796"
"chr3","122384879","122385111","chr3","68617856","68618078","58","53767023"
"chr3","122438016","122438127","chr1","61804140","61804260","26","60633876"
"chr3","122587656","122587950","chr2","39701994","39702284","25","82885662"
"chr3","122662644","122662937","chr2","39775069","39775356","27","82887575"
"chr3","122666626","122666907","chr2","39778362","39778641","11","82888264"
"chr3","122687407","122687662","chr2","39799400","39799661","33","82888007"
"chr3","122703534","122703829","chr13","34170606","34170896","66","88532928"
"chr3","122800503","122800769","chr13","28680679","28680936","64","94119824"
"chr3","123032314","123032581","chr2","40164430","40164692","17","82867884"
"chr3","123113950","123114200","chr2","40233692","40233942","23","82880258"
"chr3","123128528","123128815","chr3","161970181","161970471","50","38841653"
"chr3","123160428","123160705","chr9","26605282","26605557","59","96555146"
"chr3","123227089","123227300","chr2","40347623","40347845","22","82879466"
"chr3","123230423","123230598","chr3","156452640","156452819","41","33222217"
"chr3","123283455","123283575","chr2","40403131","40403251","3","82880324"
"chr3","123348844","123349051","chr2","40473993","40474194","16","82874851"
"chr3","123428756","123429022","chr2","40553036","40553294","30","82875720"
"chr3","123541485","123541772","chr14","12376341","12376625","61","111165144"
"chr3","123556814","123556980","chr2","40681455","40681631","24","82875359"
"chr3","123571585","123571893","chr2","40705867","40706162","44","82865718"
"chr3","123630150","123630434","chr2","40760195","40760480","18","82869955"
"chr3","123697148","123697452","chr2","40831167","40831469","21","82865981"
"chr3","123723554","123723833","chr2","40858696","40858979","22","82864858"
"chr3","123729168","123729401","chr2","40863363","40863597","13","82865805"
"chr3","123755373","123755669","chr2","40888630","40888926","18","82866743"
"chr3","123763809","123764101","chr7","131000982","131001283","60","7237173"
"chr3","123782055","123782349","chr17","24307072","24307369","57","99474983"
"chr3","123807617","123807923","chr2","40937594","40937891","32","82870023"
"chr3","123814185","123814486","chr2","40943512","40943831","38","82870673"
"chr3","123822768","123823053","chr19","24268955","24269239","52","99553813"
"chr3","123823067","123823373","chr5","51350304","51350607","62","72472763"
"chr3","123828662","123828818","chr19","16079871","16080029","27","107748791"
"chr3","123829132","123829260","chr8","320367","320492","23","123508765"
"chr3","123851186","123851486","chr2","40977390","40977688","21","82873796"
"chr3","123877288","123877360","chr10","73667768","73667847","16","50209520"
"chr3","124028474","124028758","chr10","66771950","66772239","71","57256524"
"chr3","124057456","124057756","chr2","41181234","41181537","48","82876222"
"chr3","124133364","124133603","chr2","41265141","41265384","17","82868223"
"chr3","124133765","124134092","chr3","123570746","123571070","70","563019"
"chr3","124154891","124155150","chr2","41286280","41286571","43","82868611"
"chr3","124176325","124176537","chr20","23036266","23036487","45","101140059"
"chr3","124176831","124176925","chr7","97028822","97028914","16","27148009"
"chr3","124177681","124177841","chr2","41305740","41305900","6","82871941"
"chr3","124179408","124179722","chr8","101745971","101746276","59","22433437"
"chr3","124181376","124181649","chr2","41309432","41309729","53","82871944"
"chr3","124234982","124235265","chr2","41365810","41366093","32","82869172"
"chr3","124265174","124265474","chr2","41404113","41404416","26","82861061"
"chr3","124301674","124301949","chr2","41466589","41466842","50","82835085"
"chr3","124365271","124365518","chr7","19580653","19580903","53","104784618"
"chr3","124448691","124448989","chr2","41605750","41606036","37","82842941"
"chr3","124527527","124527659","chr9","19833812","19833941","21","104693715"
"chr3","124537966","124538240","chr5","49422042","49422306","60","75115924"
"chr3","124539266","124539543","chr2","41701993","41702266","18","82837273"
"chr3","124574086","124574350","chr2","41745919","41746183","13","82828167"
"chr3","124623494","124623651","chr2","41789822","41789979","8","82833672"
"chr3","124682624","124682928","chr2","71005973","71006275","53","53676651"
"chr3","124702610","124702900","chr1","17386249","17386538","55","107316361"
"chr3","124763037","124763308","chr2","41909683","41909956","20","82853354"
"chr3","124820045","124820163","chr2","41956917","41957034","9","82863128"
"chr3","124855683","124855807","chr13","95288408","95288530","19","29567275"
"chr3","124899622","124899767","chr2","42033433","42033571","14","82866189"
"chr3","124962040","124962345","chr10","15068395","15068698","57","109893645"
"chr3","125040752","125041029","chr2","42156997","42157278","28","82883755"
"chr3","125058674","125058966","chr2","42169391","42169682","18","82889283"
"chr3","125058983","125059249","chr2","42169689","42169958","26","82889294"
"chr3","125077445","125077586","chr2","42186275","42186420","13","82891170"
"chr3","125077613","125077733","chr7","113641019","113641138","16","11436594"
"chr3","125217455","125217630","chr4","160825138","160825301","37","35607683"
"chr3","125217660","125217773","chr2","188170656","188170771","23","62952996"
"chr3","125250661","125250972","chr2","42409079","42409377","36","82841582"
"chr3","125278657","125278940","chr2","104445382","104445669","54","20833275"
"chr3","125301768","125301885","chr2","42459811","42459928","6","82841957"
"chr3","125339460","125339576","chr2","42497705","42497821","5","82841755"
"chr3","125395939","125396211","chr2","42549320","42549592","14","82846619"
"chr3","125399095","125399220","chr2","42552450","42552567","11","82846645"
"chr3","125442002","125442134","chr9","16639092","16639222","16","108802910"
"chr3","125454629","125454928","chr2","42612263","42612577","38","82842366"
"chr3","125480487","125480796","chr2","42630868","42631168","29","82849619"
"chr3","125483166","125483463","chr2","105342245","105342550","58","20140921"
"chr3","125494627","125494752","chr2","42645372","42645505","12","82849255"
"chr3","125514111","125514230","chr2","42664221","42664340","10","82849890"
"chr3","125514243","125514476","chr2","42664353","42664582","17","82849890"
"chr3","125514625","125514907","chr2","42664730","42665015","18","82849895"
"chr3","125572176","125572469","chr2","42722271","42722564","18","82849905"
"chr3","125575659","125575729","chr1","54094474","54094540","15","71481185"
"chr3","125576028","125576082","chr1","41676005","41676055","18","83900023"
"chr3","125576111","125576252","chr1","122059382","122059521","40","3516729"
"chr3","125578483","125578794","chr2","42728703","42729008","32","82849780"
"chr3","125586590","125586636","chr1","173730956","173731005","9","48144366"
"chr3","125594785","125595094","chr5","4709062","4709363","59","120885723"
"chr3","125635257","125635540","chr2","42776249","42776542","26","82859008"
"chr3","125645013","125645315","chr2","42788063","42788372","37","82856950"
"chr3","125650353","125650446","chr18","8385273","8385372","17","117265080"
"chr3","125653536","125653834","chr1","139937638","139937941","58","14284102"
"chr3","125717182","125717499","chr2","42871640","42871949","39","82845542"
"chr3","125731181","125731458","chr2","42887555","42887832","10","82843626"
"chr3","125739182","125739468","chr2","42895459","42895767","43","82843723"
"chr3","125780385","125780657","chr2","42941996","42942268","17","82838389"
"chr3","125787435","125787729","chr16","1095250","1095541","52","124692185"
"chr3","125794168","125794451","chr2","42959841","42960124","18","82834327"
"chr3","125795360","125795644","chr1","35294285","35294565","49","90501075"
"chr3","125865220","125865350","chr9","97270771","97270897","23","28594449"
"chr3","125865359","125865655","chr2","43036767","43037061","30","82828592"
"chr3","125874422","125874531","chr3","64282047","64282157","18","61592375"
"chr3","125878468","125878777","chr2","43049935","43050248","34","82828533"
"chr3","125889037","125889332","chr2","43060530","43060852","60","82828507"
"chr3","125917755","125917887","chr1","14222547","14222679","17","111695208"
"chr3","125926291","125926584","chr2","43098932","43099196","49","82827359"
"chr3","125953656","125953949","chr2","43129497","43129790","14","82824159"
"chr3","125954894","125955193","chr2","43130960","43131253","28","82823934"
"chr3","125957539","125957853","chr2","43185823","43186133","25","82771716"
"chr3","125989210","125989517","chr2","43214219","43214528","30","82774991"
"chr3","125996586","125996902","chrX","100630173","100630473","69","25366413"
"chr3","126010944","126011164","chr2","43237958","43238150","39","82772986"
"chr3","126017997","126018278","chr2","43245233","43245545","47","82772764"
"chr3","126052462","126052578","chr13","46512186","46512305","18","79540276"
"chr3","126148671","126148974","chr2","43370759","43371067","33","82777912"
"chr3","126234445","126234643","chr11","111002893","111003106","46","15231552"
"chr3","126315259","126315543","chrX","109482319","109482606","55","16832940"
"chr3","126336027","126336278","chr2","43570804","43571080","46","82765223"
"chr3","126338959","126339264","chr2","43573783","43574101","35","82765176"
"chr3","126382659","126382970","chr2","43615619","43615927","46","82767040"
"chr3","126415307","126415479","chr9","108701802","108701986","48","17713505"
"chr3","126415769","126415817","chr11","56120181","56120225","13","70295588"
"chr3","126462460","126462735","chr2","43694157","43694431","31","82768303"
"chr3","126473114","126473386","chr2","43704448","43704720","16","82768666"
"chr3","126476198","126476487","chr2","43707767","43708056","19","82768431"
"chr3","126483716","126484017","chr2","43714930","43715229","26","82768786"
"chr3","126484744","126485017","chr2","43715993","43716273","45","82768751"
"chr3","126491823","126492111","chr2","43723133","43723421","16","82768690"
"chr3","126494582","126494884","chr20","36425190","36425487","61","90069392"
"chr3","126512971","126513243","chr2","43747034","43747310","17","82765937"
"chr3","126521457","126521565","chr6","32811011","32811118","33","93710446"
"chr3","126521609","126521724","chr2","43752839","43752949","11","82768770"
"chr3","126525552","126525681","chr2","43756626","43756755","7","82768926"
"chr3","126542181","126542487","chr2","43773001","43773313","29","82769180"
"chr3","126544107","126544422","chr2","43774942","43775236","37","82769165"
"chr3","126553362","126553673","chr2","43784458","43784770","15","82768904"
"chr3","126561018","126561300","chr2","43791830","43792108","20","82769188"
"chr3","126576757","126577059","chr2","43808054","43808361","23","82768703"
"chr3","126581941","126582243","chr2","43813431","43813735","21","82768510"
"chr3","126591969","126592273","chr1","222287364","222287667","53","95695395"
"chr3","126595542","126595847","chr6","117080557","117080869","64","9514985"
"chr3","126631204","126631511","chr2","43855303","43855598","22","82775901"
"chr3","126635123","126635328","chr2","43858147","43858372","38","82776976"
"chr3","126637729","126638043","chrX","63991893","63992186","75","62645836"
"chr3","126662281","126662542","chr2","43884971","43885235","17","82777310"
"chr3","126664630","126664827","chr2","43891482","43891652","40","82773148"
"chr3","126683711","126684015","chr1","213123771","213124075","55","86440060"
"chr3","126686566","126686857","chr2","43910348","43910633","22","82776218"
"chr3","126704726","126705014","chr2","43931172","43931446","31","82773554"
"chr3","126721739","126722037","chr2","43948644","43948947","34","82773095"
"chr3","126752079","126752389","chr2","43971648","43971962","19","82780431"
"chr3","126769622","126769901","chr16","52943194","52943477","53","73826428"
"chr3","126783375","126783505","chr2","44002542","44002670","16","82780833"
"chr3","126796998","126797130","chr2","44019369","44019495","14","82777629"
"chr3","126811338","126811630","chr2","44034334","44034620","36","82777004"
"chr3","126836251","126836445","chr2","44064217","44064411","15","82772034"
"chr3","126842570","126842830","chr2","44070474","44070755","34","82772096"
"chr3","126856770","126857062","chr2","44084886","44085171","34","82771884"
"chr3","126885373","126885464","chr12","43283820","43283911","18","83601553"
"chr3","126894103","126894396","chr2","44121864","44122154","24","82772239"
"chr3","126918957","126919259","chr2","44146860","44147163","12","82772097"
"chr3","126924010","126924104","chr4","2875346","2875431","22","124048664"
"chr3","126924566","126924775","chr2","44152490","44152687","25","82772076"
"chr3","126953658","126953975","chr3","163862917","163863217","77","36909259"
"chr3","126978127","126978440","chr2","44206346","44206669","29","82771781"
"chr3","127009524","127009821","chr2","44237798","44238112","35","82771726"
"chr3","127058775","127059081","chr3","166997174","166997482","64","39938399"
"chr3","127111781","127112069","chr2","44341391","44341676","30","82770390"
"chr3","127121361","127121564","chr2","44350896","44351113","23","82770465"
"chr3","127123838","127124109","chr5","165714831","165715111","50","38590993"
"chr3","127126763","127127000","chr2","44355954","44356183","25","82770809"
"chr3","127128691","127128973","chr2","44357870","44358152","25","82770821"
"chr3","127141042","127141342","chr15","8920430","8920718","53","118220612"
"chr3","127154698","127154966","chr2","44382728","44382999","20","82771970"
"chr3","127181012","127181324","chr2","44407946","44408270","31","82773066"
"chr3","127197992","127198296","chr2","44425487","44425805","33","82772505"
"chr3","127232395","127232685","chr2","44461738","44462025","14","82770657"
"chr3","127263240","127263526","chr2","44492813","44493099","31","82770427"
"chr3","127339446","127339753","chr2","44568279","44568577","46","82771167"
"chr3","127363058","127363356","chr7","28229276","28229575","50","99133782"
"chr3","127395029","127395345","chr6","132626059","132626373","62","5231030"
"chr3","127409305","127409603","chr2","44637393","44637694","29","82771912"
"chr3","127429995","127430151","chr17","28848467","28848611","45","98581528"
"chr3","127431194","127431502","chr2","44659234","44659536","19","82771960"
"chr3","127433682","127433978","chr2","44661971","44662262","22","82771711"
"chr3","127437412","127437707","chr2","44665647","44665961","42","82771765"
"chr3","127453287","127453598","chr2","44681656","44681959","41","82771631"
"chr3","127466592","127466887","chr2","44695708","44696000","24","82770884"
"chr3","127466889","127467022","chr2","44696013","44696135","18","82770876"
"chr3","127485818","127486114","chr2","44716164","44716460","18","82769654"
"chr3","127504625","127504907","chr14","119035025","119035308","56","8469600"
"chr3","127527271","127527481","chr8","28039825","28040037","55","99487446"
"chr3","127534343","127534611","chr2","44768166","44768435","29","82766177"
"chr3","127536819","127537120","chr2","44770668","44770947","44","82766151"
"chr3","127546418","127546550","chr2","6753772","6753904","23","120792646"
"chr3","127557230","127557486","chr2","44788884","44789158","33","82768346"
"chr3","127566114","127566409","chr2","44797892","44798205","31","82768222"
"chr3","127572023","127572317","chr2","44803783","44804082","16","82768240"
"chr3","127574902","127575211","chr2","44806704","44807004","29","82768198"
"chr3","127578063","127578355","chr2","44809541","44809832","13","82768522"
"chr3","127579085","127579393","chr2","44810563","44810907","49","82768522"
"chr3","127580282","127580583","chr2","44811798","44812098","19","82768484"
"chr3","127609960","127610077","chr14","122143875","122143993","14","5466085"
"chr3","127624144","127624422","chr2","44854786","44855060","38","82769358"
"chr3","127641662","127641756","chr2","44872641","44872734","6","82769021"
"chr3","127647724","127647853","chr2","44878801","44878925","11","82768923"
"chr3","127670460","127670748","chr2","44899891","44900177","15","82770569"
"chr3","127727746","127728060","chr8","20025978","20026291","67","107701768"
"chr3","127729120","127729413","chr2","44959148","44959438","20","82769972"
"chr3","127745633","127745715","chr2","44975657","44975739","5","82769976"
"chr3","127758224","127758559","chr1","154993241","154993575","75","27235017"
"chr3","127774479","127774778","chr2","45005162","45005460","19","82769317"
"chr3","127863926","127864150","chr2","45098749","45098970","17","82765177"
"chr3","128181111","128181406","chr2","45415251","45415548","37","82765860"
"chr3","128210957","128211239","chr9","97703670","97703951","55","30507287"
"chr3","128316775","128317051","chr16","23937822","23938096","48","104378953"
"chr3","128410997","128411289","chr2","45652482","45652760","26","82758515"
"chr3","128423117","128423416","chr2","45664895","45665184","22","82758222"
"chr3","128432829","128433146","chr2","45677602","45677924","24","82755227"
"chr3","128441503","128441778","chr2","45686775","45687052","28","82754728"
"chr3","128488749","128488987","chr17","81613119","81613364","52","46875630"
"chr3","128529119","128529358","chr2","45774273","45774509","25","82754846"
"chr3","128531799","128531929","chr13","87095059","87095190","19","41436740"
"chr3","128546723","128546855","chr2","45790834","45790966","5","82755889"
"chr3","128546863","128547162","chr2","45790974","45791259","36","82755889"
"chr3","128567128","128567311","chr4","61425777","61425954","40","67141351"
"chr3","128576919","128577173","chr2","45820498","45820786","43","82756421"
"chr3","128587042","128587330","chr2","45830613","45830892","23","82756429"
"chr3","128588673","128588951","chr2","45832248","45832529","15","82756425"
"chr3","128603997","128604208","chr2","45846632","45846805","53","82757365"
"chr3","128604209","128604468","chr3","166823723","166823967","56","38219514"
"chr3","128604469","128604580","chr2","45847101","45847212","8","82757368"
"chr3","128610066","128610373","chr2","45853408","45853761","64","82756658"
"chr3","128613667","128613976","chr2","45857234","45857548","17","82756433"
"chr3","128619171","128619488","chr2","45862272","45862583","29","82756899"
"chr3","128642268","128642390","chr2","45885421","45885538","16","82756847"
"chr3","128642569","128642829","chr2","45885699","45885979","40","82756870"
"chr3","128650715","128651026","chr1","7114733","7115046","52","121535982"
"chr3","128659022","128659307","chr2","45901601","45901884","17","82757421"
"chr3","128686827","128687117","chr2","45928599","45928867","48","82758228"
"chr3","128690469","128690760","chr2","45931837","45932110","39","82758632"
"chr3","128702461","128702688","chr2","45945040","45945260","17","82757421"
"chr3","128707003","128707283","chr7","71549523","71549809","51","57157480"
"chr3","128732366","128732487","chr2","45974364","45974480","16","82758002"
"chr3","128732774","128732985","chr2","45974754","45974939","41","82758020"
"chr3","128741588","128741877","chr2","45984107","45984401","37","82757481"
"chr3","128760804","128761103","chr2","45998509","45998807","17","82762295"
"chr3","128770710","128771025","chr6","15252676","15252979","56","113518034"
"chr3","128783270","128783559","chr2","46021521","46021794","41","82761749"
"chr3","128804670","128804999","chr2","46040297","46040604","49","82764373"
"chr3","128805796","128806090","chr2","46041347","46041638","19","82764449"
"chr3","128814808","128815068","chr2","46054103","46054399","53","82760705"
"chr3","128823299","128823606","chr2","46062606","46062915","25","82760693"
"chr3","128856234","128856346","chr2","46095319","46095436","9","82760915"
"chr3","128865664","128865959","chr6","171336994","171337274","48","42471330"
"chr3","128871909","128872218","chr2","46110943","46111251","24","82760966"
"chr3","128873144","128873264","chr2","46112170","46112288","7","82760974"
"chr3","128877313","128877628","chr18","1158360","1158673","50","127718953"
"chr3","128887904","128888212","chr2","46126929","46127234","29","82760975"
"chr3","128891449","128891548","chr2","46130144","46130243","13","82761305"
"chr3","128896486","128896795","chr3","64330246","64330544","65","64566240"
"chr3","128899013","128899318","chr6","77260247","77260553","54","51638766"
"chr3","128904607","128904834","chr2","46138962","46139184","24","82765645"
"chr3","128913842","128914134","chr2","46147828","46148122","18","82766014"
"chr3","128919295","128919401","chr8","72387775","72387878","17","56531520"
"chr3","128922507","128922829","chr2","46156648","46156927","54","82765859"
"chr3","128928388","128928685","chr2","46162785","46163075","18","82765603"
"chr3","128940649","128940938","chr2","46175322","46175592","43","82765327"
"chr3","128941006","128941115","chr17","23934580","23934688","25","105006426"
"chr3","128943103","128943415","chr2","46177728","46178034","20","82765375"
"chr3","128943447","128943771","chr3","36904507","36904821","64","92038940"
"chr3","128960570","128960862","chr9","64391956","64392242","63","64568614"
"chr3","128962452","128962697","chr2","46189736","46189982","16","82772716"
"chr3","128980005","128980277","chr11","1767086","1767360","57","127212919"
"chr3","128982474","128982644","chr11","8977096","8977265","32","120005378"
"chr3","128982675","128982789","chr15","2047564","2047680","16","126935111"
"chr3","129003629","129003840","chr2","46229896","46230107","18","82773733"
"chr3","129018962","129019257","chr2","46244620","46244915","21","82774342"
"chr3","129034824","129035121","chr2","46260060","46260367","38","82774764"
"chr3","129103797","129104084","chr2","46331604","46331894","16","82772193"
"chr3","129104259","129104560","chr2","46332081","46332377","26","82772178"
"chr3","129108508","129108804","chr13","65703304","65703594","53","63405204"
"chr3","129117444","129117765","chr2","46345333","46345613","58","82772111"
"chr3","129135201","129135265","chr2","46367002","46367070","5","82768199"
"chr3","129138493","129138606","chr2","46370222","46370341","11","82768271"
"chr3","129138641","129138758","chr2","46370380","46370499","8","82768261"
"chr3","129179971","129180272","chr13","10104164","10104455","58","119075807"
"chr3","129197423","129197726","chr2","46426506","46426801","21","82770917"
"chr3","129199073","129199377","chr2","46428135","46428445","24","82770938"
"chr3","129219548","129219750","chr2","46449163","46449364","24","82770385"
"chr3","129221072","129221311","chr2","46450695","46450934","15","82770377"
"chr3","129240844","129241161","chr2","46470047","46470356","33","82770797"
"chr3","129265880","129266004","chr2","46488254","46488378","7","82777626"
"chr3","129296574","129296696","chr2","46519005","46519127","4","82777569"
"chr3","129298419","129298517","chr2","46520753","46520846","15","82777666"
"chr3","129299288","129299599","chr2","46521635","46521945","20","82777653"
"chr3","129302722","129302985","chr2","46525040","46525262","55","82777682"
"chr3","129327407","129327737","chr3","155061423","155061718","89","25734016"
"chr3","129335059","129335355","chr2","46556693","46556998","34","82778366"
"chr3","129336286","129336412","chr2","46558582","46558700","14","82777704"
"chr3","129348174","129348510","chr2","46570462","46570791","36","82777712"
"chr3","129376558","129376855","chr2","46599135","46599426","31","82777423"
"chr3","129384381","129384687","chr2","46608873","46609169","52","82775508"
"chr3","129386024","129386318","chr2","46610518","46610788","44","82775506"
"chr3","129392608","129392698","chr2","46617943","46618032","7","82774665"
"chr3","129395311","129395610","chr2","46620660","46620941","28","82774651"
"chr3","129403399","129403691","chr2","46628753","46629057","34","82774646"
"chr3","129415466","129415739","chr2","46641578","46641871","41","82773888"
"chr3","129438292","129438576","chr5","14901284","14901569","49","114537008"
"chr3","129441597","129441731","chr2","46668810","46668949","13","82772787"
"chr3","129447605","129447715","chr1","31175608","31175721","18","98271997"
"chr3","129451674","129451975","chr2","46680373","46680670","30","82771301"
"chr3","129465232","129465541","chr2","46694345","46694636","37","82770887"
"chr3","129494402","129494658","chr2","46727574","46727840","33","82766828"
"chr3","129511104","129511419","chr16","44850975","44851287","58","84660129"
"chr3","129548791","129549079","chr19","30007363","30007647","60","99541428"
"chr3","129567100","129567393","chr2","46798821","46799130","34","82768279"
"chr3","129569811","129569969","chr7","151548321","151548487","41","21978510"
"chr3","129574981","129575285","chrX","52425364","52425668","59","77149617"
"chr3","129584214","129584410","chr2","46819567","46819760","21","82764647"
"chr3","129587028","129587282","chr2","46822289","46822554","30","82764739"
"chr3","129591146","129591353","chr2","46827066","46827277","20","82764080"
"chr3","129591419","129591683","chr2","46827341","46827581","61","82764078"
"chr3","129609148","129609427","chr17","30645541","30645822","59","98963607"
"chr3","129612951","129613275","chr2","46848507","46848804","42","82764444"
"chr3","129623728","129624035","chr2","46858400","46858670","53","82765328"
"chr3","129629480","129629609","chr2","46865208","46865337","9","82764272"
"chr3","129629923","129630099","chr2","46865647","46865847","35","82764276"
"chr3","129640682","129640982","chr4","20956325","20956625","68","108684357"
"chr3","129643965","129644224","chr2","46883577","46883838","21","82760388"
"chr3","129645593","129645885","chr2","46886382","46886679","30","82759211"
"chr3","129647748","129648040","chr2","46888509","46888812","29","82759239"
"chr3","129648729","129648854","chr12","19203606","19203730","20","110445123"
"chr3","129714428","129714651","chr20","51873831","51874064","52","77840597"
"chr3","130200866","130200995","chr20","5281043","5281175","15","124919823"
"chr3","130226713","130227012","chr20","5173233","5173556","56","125053480"
"chr3","130243942","130244236","chr20","5163297","5163592","22","125080645"
"chr3","130245816","130246097","chr20","5161183","5161481","44","125084633"
"chr3","130258809","130259117","chr20","5149734","5150049","42","125109075"
"chr3","130270855","130271164","chr11","113220012","113220319","52","17050843"
"chr3","130273494","130273791","chr18","41863993","41864264","71","88409501"
"chr3","130278568","130278883","chr9","121771852","121772166","58","8506716"
"chr3","130285011","130285142","chr20","5126828","5126940","25","125158183"
"chr3","130287397","130287679","chr20","25617473","25617738","62","104669924"
"chr3","130290404","130290721","chr20","5124825","5125144","31","125165579"
"chr3","130296098","130296396","chr20","5120448","5120745","43","125175650"
"chr3","130297888","130298158","chr20","5118734","5118979","64","125179154"
"chr3","130301197","130301476","chr20","5116289","5116575","35","125184908"
"chr3","130314709","130315022","chr18","69530574","69530885","62","60784135"
"chr3","130327697","130327875","chr1","173292200","173292385","46","42964503"
"chr3","130456175","130456480","chr2","47155040","47155331","59","83301135"
"chr3","130498202","130498436","chr9","22384891","22385125","56","108113311"
"chr3","130598694","130598992","chr1","218247210","218247510","70","87648516"
"chr3","130615584","130615789","chr2","47317673","47317878","9","83297911"
"chr3","130620480","130620600","chr2","47322241","47322366","13","83298239"
"chr3","130651299","130651594","chr2","47357732","47358028","26","83293567"
"chr3","130672160","130672458","chr5","181677386","181677678","59","51005226"
"chr3","130746720","130747020","chr2","47456286","47456608","39","83290434"
"chr3","130791489","130791776","chr2","47501256","47501547","18","83290233"
"chr3","130818025","130818295","chr2","47527542","47527820","26","83290483"
"chr3","130830917","130831209","chr8","45074900","45075192","54","85756017"
"chr3","130848323","130848442","chr2","47559783","47559903","10","83288540"
"chr3","130876817","130877098","chr3","183694819","183695107","53","52818002"
"chr3","130919174","130919386","chr2","47656293","47656502","20","83262881"
"chr3","130985932","130986209","chr1","35294285","35294565","58","95691647"
"chr3","130994852","130995102","chr2","172398914","172399164","65","41404062"
"chr3","131006218","131006399","chr1","15335340","15335517","38","115670878"
"chr3","131028058","131028336","chr2","163445135","163445414","52","32417077"
"chr3","131036191","131036496","chr2","47805102","47805401","22","83231089"
"chr3","131052713","131052852","chr3","50489768","50489894","42","80562945"
"chr3","131055900","131056220","chr2","47831473","47831784","30","83224427"
"chr3","131089196","131089455","chr2","47862558","47862815","20","83226638"
"chr3","131090123","131090439","chr2","47863466","47863775","25","83226657"
"chr3","131119882","131120118","chr2","47893439","47893672","20","83226443"
"chr3","131137124","131137410","chr8","118867437","118867723","68","12269687"
"chr3","131154266","131154552","chr2","47919201","47919485","19","83235065"
"chr3","131194670","131194943","chr2","47956663","47956926","22","83238007"
"chr3","131199007","131199316","chr2","47960610","47960912","27","83238397"
"chr3","131199353","131199640","chr2","47960949","47961258","48","83238404"
"chr3","131205377","131205631","chr4","44209572","44209824","67","86995805"
"chr3","131275878","131276183","chr2","48033454","48033756","25","83242424"
"chr3","131419332","131419638","chr2","48175336","48175652","33","83243996"
"chr3","131531696","131531993","chr2","48295503","48295801","26","83236193"
"chr3","131539413","131539598","chrX","52447863","52448045","44","79091550"
"chr3","131645913","131646028","chr2","48403630","48403752","18","83242283"
"chr3","131646055","131646342","chr2","48403779","48404098","55","83242276"
"chr3","131710020","131710321","chr2","48462729","48463037","26","83247291"
"chr3","131718803","131719093","chr4","87333067","87333363","56","44385736"
"chr3","131803750","131804040","chr2","48554608","48554905","25","83249142"
"chr3","131846341","131846508","chr1","131444832","131445004","36","401509"
"chr3","131857555","131857682","chr2","48609346","48609472","22","83248209"
"chr3","131870663","131870955","chr2","48622768","48623061","22","83247895"
"chr3","131881572","131881774","chr2","48630736","48630932","18","83250836"
"chr3","131897143","131897437","chr2","48646689","48646984","22","83250454"
"chr3","131909769","131910068","chr2","48658615","48658922","29","83251154"
"chr3","131937170","131937473","chr2","160551205","160551504","57","28614035"
"chr3","131956019","131956197","chr12","83938469","83938637","34","48017550"
"chr3","131956506","131956635","chr1","109570884","109571013","22","22385622"
"chr3","131971900","131972186","chr2","48720215","48720515","32","83251685"
"chr3","131979020","131979316","chr2","48727638","48727936","20","83251382"
"chr3","131992970","131993208","chr2","48742332","48742571","12","83250638"
"chr3","132008428","132008716","chr2","76605190","76605482","54","55403238"
"chr3","132035726","132036026","chrX","46711065","46711364","52","85324661"
"chr3","132077104","132077412","chr6","74722155","74722466","83","57354949"
"chr3","132121514","132121722","chr2","48872890","48873102","14","83248624"
"chr3","132130144","132130453","chr2","48881712","48882026","24","83248432"
"chr3","132140830","132141166","chr2","48892352","48892642","64","83248478"
"chr3","132157981","132158288","chr2","48914397","48914699","28","83243584"
"chr3","132192450","132192722","chr2","48949337","48949606","23","83243113"
"chr3","132195166","132195376","chr2","48950231","48950440","21","83244935"
"chr3","132211147","132211363","chr2","48966328","48966543","12","83244819"
"chr3","132248737","132249014","chrX","123773493","123773766","52","8475244"
"chr3","132261007","132261263","chr2","49010895","49011163","30","83250112"
"chr3","132341357","132341639","chr1","40023687","40023970","61","92317670"
"chr3","132348550","132348685","chr2","49103685","49103821","4","83244865"
"chr3","132348972","132349136","chr2","49104133","49104288","17","83244839"
"chr3","132432848","132433075","chr2","49128972","49129183","37","83303876"
"chr3","132463837","132464142","chr10","52418795","52419086","67","80045042"
"chr3","132469615","132469923","chr2","49159822","49160131","27","83309793"
"chr3","132532762","132532963","chr2","49223463","49223657","16","83309299"
"chr3","132535154","132535291","chr10","53842743","53842878","25","78692411"
"chr3","132535612","132535772","chr1","125421076","125421235","43","7114536"
"chr3","132652970","132653286","chr2","49342722","49343034","29","83310248"
"chr3","132709987","132710273","chr2","49399123","49399406","17","83310864"
"chr3","132835394","132835704","chr2","49526245","49526542","32","83309149"
"chr3","132842138","132842446","chr2","49532965","49533280","28","83309173"
"chr3","132905804","132906093","chr1","15871355","15871643","55","117034449"
"chr3","132912861","132913044","chr16","55452575","55452744","46","77460286"
"chr3","132938322","132938600","chr11","112211555","112211826","60","20726767"
"chr3","132973424","132973567","chr2","49670759","49670898","10","83302665"
"chr3","132981577","132981874","chr2","49678903","49679196","32","83302674"
"chr3","132986453","132986742","chr9","93979962","93980254","58","39006491"
"chr3","132988913","132989216","chr2","49685961","49686268","20","83302952"
"chr3","133017531","133017813","chr2","160551205","160551504","64","27533674"
"chr3","133035268","133035399","chr2","49730800","49730931","5","83304468"
"chr3","133035696","133035812","chr2","49731235","49731343","13","83304461"
"chr3","133048511","133048804","chr2","49745938","49746236","20","83302573"
"chr3","133057705","133058008","chr3","126932801","126933106","72","6124904"
"chr3","133064120","133064425","chr15","77801706","77802006","56","55262414"
"chr3","133087319","133087501","chr9","86593791","86593976","35","46493528"
"chr3","133089555","133089669","chr11","78863129","78863241","22","54226426"
"chr3","133098262","133098498","chr5","56540327","56540546","55","76557935"
"chr3","133102580","133102748","chr2","49800684","49800852","7","83301896"
"chr3","133127377","133127546","chr7","46359880","46360048","30","86767497"
"chr3","133137153","133137451","chr2","49832912","49833187","41","83304241"
"chr3","133144389","133144673","chr2","49838832","49839083","42","83305557"
"chr3","133163396","133163505","chr2","49864056","49864167","15","83299340"
"chr3","133163805","133163988","chr2","49864476","49864668","25","83299329"
"chr3","133166010","133166221","chr2","49866342","49866552","13","83299668"
"chr3","133188153","133188457","chr2","49888362","49888637","45","83299791"
"chr3","133196619","133196911","chr2","134217641","134217927","64","1021022"
"chr3","133199034","133199288","chr6","137502623","137502878","57","4303589"
"chr3","133200824","133201112","chr2","49894018","49894307","27","83306806"
"chr3","133207150","133207458","chr2","49900828","49901135","18","83306322"
"chr3","133230583","133230882","chr2","49926077","49926381","24","83304506"
"chr3","133287466","133287760","chr7","42448673","42448965","56","90838793"
"chr3","133313686","133313978","chr20","28914773","28915070","51","104398913"
"chr3","133324301","133324408","chr11","46321180","46321290","21","87003121"
"chr3","133350940","133351230","chr2","50034279","50034576","22","83316661"
"chr3","133371472","133371724","chr1","7488262","7488521","60","125883210"
"chr3","133386743","133387029","chr1","21560196","21560484","58","111826547"
"chr3","133396481","133396768","chr14","122733616","122733911","54","10662865"
"chr3","133401553","133401839","chr2","50204105","50204393","20","83197448"
"chr3","133488603","133488911","chr2","111686273","111686574","47","21802330"
"chr3","133496130","133496253","chr1","37064408","37064534","15","96431722"
"chr3","133499496","133499790","chr9","57165386","57165680","57","76334110"
"chr3","133529429","133529645","chr2","50329372","50329593","15","83200057"
"chr3","133535226","133535366","chr2","50336056","50336190","15","83199170"
"chr3","133541994","133542284","chr2","50343641","50343935","31","83198353"
"chr3","133548202","133548460","chr2","50349858","50350116","14","83198344"
"chr3","133562681","133562974","chr14","66461558","66461851","53","67101123"
"chr3","133580483","133580594","chr2","50392577","50392692","15","83187906"
"chr3","133580880","133581081","chr2","50392988","50393183","19","83187892"
"chr3","133613145","133613313","chr11","132145794","132145963","34","1467351"
"chr3","133619191","133619491","chr2","50435428","50435715","42","83183763"
"chr3","133628135","133628443","chr2","50443020","50443342","53","83185115"
"chr3","133641550","133641818","chr4","13407447","13407700","69","120234103"
"chr3","133654156","133654448","chr3","43681527","43681817","64","89972629"
"chr3","133656415","133656708","chr2","50478754","50479064","31","83177661"
"chr3","133657749","133658047","chr7","53545449","53545742","65","80112300"
"chr3","133664160","133664423","chr14","64685578","64685852","55","68978582"
"chr3","133677576","133677709","chr2","50497727","50497848","20","83179849"
"chr3","133677997","133678178","chr2","50498150","50498324","18","83179847"
"chr3","133680183","133680314","chr2","50500538","50500663","12","83179645"
"chr3","133719070","133719384","chr2","50543036","50543336","34","83176034"
"chr3","133722963","133723253","chr2","50547191","50547469","34","83175772"
"chr3","133779644","133779898","chr11","7508963","7509219","53","126270681"
"chr3","133782841","133783086","chr20","17976682","17976922","53","115806159"
"chr3","133783779","133784062","chr3","42107648","42107937","70","91676131"
"chr3","133816488","133816787","chr2","50652066","50652366","11","83164422"
"chr3","133821695","133822005","chr2","50657597","50657916","31","83164098"
"chr3","133822015","133822310","chr2","50657926","50658225","28","83164089"
"chr3","133828366","133828647","chr2","50664172","50664482","43","83164194"
"chr3","133835046","133835339","chr15","43687639","43687935","47","90147407"
"chr3","133841674","133841964","chr2","50678202","50678495","17","83163472"
"chr3","133862361","133862663","chr2","50715958","50716278","34","83146403"
"chr3","133865473","133865593","chr2","50719099","50719218","6","83146374"
"chr3","133872220","133872309","chr2","50725964","50726052","11","83146256"
"chr3","133883088","133883393","chr2","50736765","50737071","32","83146323"
"chr3","133883949","133884239","chr2","50737954","50738249","25","83145995"
"chr3","133885813","133886090","chr2","50739792","50740071","27","83146021"
"chr3","133890077","133890398","chr2","50744370","50744643","63","83145707"
"chr3","133935706","133935977","chr2","50794086","50794359","17","83141620"
"chr3","133947178","133947488","chr3","154459676","154459985","65","20512498"
"chr3","133950103","133950465","chr6","56818995","56819333","93","77131108"
"chr3","133972006","133972286","chr2","50830762","50831062","44","83141244"
"chr3","134033869","134034128","chr2","50893123","50893371","22","83140746"
"chr3","134044267","134044444","chr8","29505524","29505686","49","104538743"
"chr3","134044644","134044778","chr2","50902765","50902901","9","83141879"
"chr3","134052274","134052385","chr11","109407997","109408110","17","24644277"
"chr3","134055959","134056250","chr2","50914907","50915197","13","83141052"
"chr3","134068170","134068479","chr20","10624717","10625031","56","123443453"
"chr3","134076979","134077279","chr3","43652365","43652670","51","90424614"
"chr3","134081689","134081988","chr2","50942501","50942809","26","83139188"
"chr3","134094459","134094772","chr2","50956786","50957076","39","83137673"
"chr3","134100824","134101109","chr16","18006570","18006852","57","116094254"
"chr3","134121757","134122056","chr2","50982889","50983191","20","83138868"
"chr3","134122284","134122542","chr15","10061574","10061835","54","124060710"
"chr3","134129979","134130272","chr2","50991197","50991490","15","83138782"
"chr3","134138818","134138948","chr6","46500507","46500636","23","87638311"
"chr3","134144648","134144961","chr2","51006040","51006371","54","83138608"
"chr3","134153436","134153701","chr2","51016063","51016323","62","83137373"
"chr3","134155074","134155188","chr2","51017649","51017764","7","83137425"
"chr3","134160586","134160867","chr2","51023261","51023541","36","83137325"
"chr3","134170952","134171234","chr2","42959841","42960124","62","91211111"
"chr3","134173039","134173324","chr2","51035309","51035592","21","83137730"
"chr3","134175596","134175807","chr2","51037850","51038065","16","83137746"
"chr3","134178431","134178656","chr2","51041029","51041254","14","83137402"
"chr3","134180260","134180544","chr2","51042820","51043109","24","83137440"
"chr3","134181844","134182144","chr2","51044076","51044377","24","83137768"
"chr3","134183347","134183667","chr10","26678734","26679034","68","107504613"
"chr3","134184817","134185115","chr2","51047324","51047634","29","83137493"
"chr3","134192875","134193184","chr2","51055366","51055660","39","83137509"
"chr3","134204854","134205167","chr2","51067528","51067841","16","83137326"
"chr3","134213963","134214276","chr2","51077157","51077469","19","83136806"
"chr3","134247707","134248007","chr10","19614735","19615046","64","114632972"
"chr3","134254358","134254469","chr7","152899855","152899972","24","18645497"
"chr3","134267210","134267497","chr2","51129590","51129878","18","83137620"
"chr3","134281254","134281550","chr2","51145571","51145879","33","83135683"
"chr3","134282429","134282735","chr2","51146755","51147052","21","83135674"
"chr3","134284534","134284662","chr2","51149026","51149154","3","83135508"
"chr3","134298045","134298150","chr2","51163096","51163208","12","83134949"
"chr3","134306821","134307112","chr2","51171872","51172163","16","83134949"
"chr3","134316818","134316904","chr2","51182367","51182451","6","83134451"
"chr3","134321521","134321789","chr7","82023696","82023957","58","52297825"
"chr3","134336252","134336559","chr2","51202813","51203125","19","83133439"
"chr3","134339357","134339528","chr2","51206244","51206408","18","83133113"
"chr3","134379751","134380067","chr2","51245602","51245918","32","83134149"
"chr3","134381756","134382050","chr2","51247585","51247882","28","83134171"
"chr3","134454885","134455157","chr3","14140868","14141172","58","120314017"
"chr3","134511912","134512044","chr3","14224227","14224360","14","120287685"
"chr3","134512062","134512110","chr1","173730956","173731005","10","39218894"
"chr3","134541040","134541215","chr9","60473538","60473710","33","74067502"
"chr3","134541512","134541628","chr10","27067355","27067468","21","107474157"
"chr3","134544933","134545239","chr20","5124825","5125144","44","129420108"
"chr3","134546976","134547083","chr20","5126828","5126940","10","129420148"
"chr3","134547384","134547528","chr3","42988449","42988590","28","91558935"
"chr3","134548377","134548589","chr8","92766074","92766284","61","41782303"
"chr3","134557163","134557458","chr7","42260070","42260363","54","92297093"
"chr3","134581079","134581373","chr20","5163297","5163592","29","129417782"
"chr3","134734572","134734892","chr2","171645178","171645501","25","36910606"
"chr3","134872043","134872358","chr2","171521650","171521960","20","36649607"
"chr3","134881285","134881591","chr2","171512378","171512682","27","36631093"
"chr3","135112443","135112754","chr4","36484206","36484512","66","98628237"
"chr3","135297409","135297689","chr2","171095034","171095318","20","35797625"
"chr3","135342401","135342702","chr2","171051392","171051680","33","35708991"
"chr3","135429336","135429596","chr2","170962977","170963237","18","35533641"
"chr3","135457708","135458006","chr10","32611359","32611641","56","102846349"
"chr3","135462390","135462671","chr3","159059575","159059863","59","23597185"
"chr3","135488448","135488758","chr2","170905763","170906079","37","35417315"
"chr3","135498371","135498675","chr2","170895893","170896167","50","35397522"
"chr3","135551996","135552298","chr2","170853893","170854199","17","35301897"
"chr3","135651715","135652003","chr2","170745467","170745755","14","35093752"
"chr3","135699198","135699377","chr2","170701414","170701588","16","35002216"
"chr3","135734731","135735036","chr2","170665852","170666156","19","34931121"
"chr3","135765150","135765267","chr2","170640940","170641049","12","34875790"
"chr3","135838566","135838866","chr2","170519152","170519449","15","34680586"
"chr3","135846779","135847027","chr2","170511421","170511670","12","34664642"
"chr3","135878927","135879236","chr2","170478206","170478512","20","34599279"
"chr3","135912788","135913081","chr2","170442163","170442474","32","34529375"
"chr3","136024733","136025030","chr2","170319257","170319535","34","34294524"
"chr3","136228280","136228553","chr20","23073380","23073643","54","113154900"
"chr3","136258837","136258917","chr2","170078705","170078785","5","33819868"
"chr3","136301032","136301345","chr3","126999113","126999416","63","9301919"
"chr3","136485034","136485255","chr2","169869298","169869504","40","33384264"
"chr3","136485260","136485300","chr2","169869253","169869293","2","33383993"
"chr3","136569602","136569718","chr12","113652983","113653099","22","22916619"
"chr3","136569778","136569921","chr1","153250707","153250848","32","16680929"
"chr3","136590319","136590443","chr2","169766024","169766138","14","33175705"
"chr3","136610686","136610864","chr1","38133458","38133632","36","98477228"
"chr3","136717658","136717790","chr2","169644989","169645113","15","32927331"
"chr3","136754513","136754639","chr2","169608130","169608256","2","32853617"
"chr3","136765092","136765400","chr19","29108741","29109042","53","107656351"
"chr3","136966548","136966833","chr2","169559913","169560198","16","32593365"
"chr3","136974364","136974665","chr2","169552050","169552347","35","32577686"
"chr3","136985581","136985910","chr2","169540689","169541019","23","32555108"
"chr3","137032511","137032799","chr2","169491938","169492228","25","32459427"
"chr3","137034711","137035023","chr2","169489717","169490027","25","32455006"
"chr3","137070976","137071298","chr2","169453033","169453344","36","32382057"
"chr3","137110103","137110402","chr2","169410028","169410331","31","32299925"
"chr3","137141270","137141576","chr2","107411533","107411833","65","29729737"
"chr3","137173685","137173952","chr2","169315752","169316060","60","32142067"
"chr3","137180371","137180653","chr11","63273330","63273621","58","73907041"
"chr3","137234566","137234791","chr2","169257419","169257639","10","32022853"
"chr3","137256625","137256840","chr2","169236013","169236230","21","31979388"
"chr3","137263873","137264120","chr1","77441102","77441343","59","59822771"
"chr3","137355280","137355403","chr2","169133199","169133321","3","31777919"
"chr3","137359210","137359525","chr2","169129128","169129447","21","31769918"
"chr3","137386439","137386556","chr2","169103027","169103144","5","31716588"
"chr3","137386599","137386773","chr2","169102813","169102990","11","31716214"
"chr3","137392820","137393108","chr13","39475662","39475956","51","97917158"
"chr3","137458961","137459275","chr6","38543147","38543456","60","98915814"
"chr3","137480089","137480213","chr1","219404678","219404802","19","81924589"
"chr3","137516626","137516942","chr2","168967935","168968256","32","31451309"
"chr3","137565862","137566152","chr2","168924886","168925181","26","31359024"
"chr3","137588082","137588321","chr2","168902160","168902444","61","31314078"
"chr3","137639472","137639766","chr2","168842139","168842435","13","31202667"
"chr3","137755422","137755700","chr2","168740163","168740439","19","30984741"
"chr3","137800080","137800211","chr2","168697967","168698098","4","30897887"
"chr3","137810071","137810358","chr2","168687779","168688068","38","30877708"
"chr3","137919999","137920277","chr2","168590623","168590911","23","30670624"
"chr3","137950965","137951106","chr2","168563667","168563808","7","30612702"
"chr3","138004487","138004610","chr2","168516085","168516208","7","30511598"
"chr3","138042248","138042532","chr2","168478316","168478631","52","30436068"
"chr3","138051029","138051334","chr2","168468922","168469230","28","30417893"
"chr3","138064762","138065051","chr2","168452457","168452750","27","30387695"
"chr3","138085164","138085438","chr2","168431562","168431856","43","30346398"
"chr3","138091519","138091617","chr2","168427260","168427355","7","30335741"
"chr3","138104718","138104975","chr3","54419249","54419492","68","83685469"
"chr3","138120411","138120643","chr3","159248356","159248592","53","21127945"
"chr3","138123127","138123251","chr2","168401179","168401296","16","30278052"
"chr3","138123510","138123797","chr6","170943463","170943749","53","32819953"
"chr3","138127750","138128035","chr2","168396484","168396753","40","30268734"
"chr3","138154557","138154759","chr2","168364828","168365033","35","30210271"
"chr3","138173012","138173299","chr2","168345776","168346068","24","30172764"
"chr3","138176214","138176517","chr2","168342531","168342838","30","30166317"
"chr3","138177959","138178251","chr20","41706573","41706866","52","96471386"
"chr3","138270015","138270304","chr2","168248666","168248955","16","29978651"
"chr3","138287477","138287563","chr1","119288424","119288508","13","18999053"
"chr3","138324175","138324372","chr10","38897222","38897416","44","99426953"
"chr3","138324634","138324762","chr8","29642806","29642934","19","108681828"
"chr3","138327786","138327976","chr1","218511627","218511810","39","80183841"
"chr3","138379523","138379805","chr2","168135873","168136155","17","29756350"
"chr3","138424260","138424545","chr2","133589155","133589443","53","4835105"
"chr3","138470090","138470410","chr2","168037446","168037767","17","29567356"
"chr3","138489583","138489825","chr2","168010007","168010253","13","29520424"
"chr3","138526115","138526390","chr2","167973942","167974219","34","29447827"
"chr3","138566765","138567053","chr2","167942800","167943099","23","29376035"
"chr3","138622875","138623169","chr2","167895471","167895765","24","29272596"
"chr3","138646721","138646816","chr2","167870845","167870940","7","29224124"
"chr3","138704314","138704627","chr2","167809818","167810105","56","29105504"
"chr3","138747737","138748038","chr2","167767617","167767899","43","29019880"
"chr3","138802714","138802826","chr19","6624772","6624883","16","132177942"
"chr3","138909132","138909406","chr2","167601509","167601783","23","28692377"
"chr3","138952826","138953136","chr2","167558913","167559212","48","28606087"
"chr3","138981133","138981442","chr6","155213609","155213914","75","16232476"
"chr3","139015641","139015935","chr2","167490210","167490532","47","28474569"
"chr3","139465684","139465981","chr2","167044993","167045297","35","27579309"
"chr3","139560364","139560647","chr1","26048278","26048559","58","113512086"
"chr3","139572124","139572413","chr2","166944336","166944625","19","27372212"
"chr3","139806440","139806746","chr2","166718405","166718719","31","26911965"
"chr3","139836638","139836947","chr2","166689124","166689435","24","26852486"
"chr3","140104326","140104627","chr2","166438126","166438434","30","26333800"
"chr3","140214782","140215066","chr2","166341374","166341659","39","26126592"
"chr3","140227284","140227581","chr2","166328900","166329203","19","26101616"
"chr3","140288203","140288334","chr2","166268001","166268139","12","25979798"
"chr3","140288360","140288484","chr2","166267845","166267970","9","25979485"
"chr3","140386068","140386362","chr2","166177855","166178152","21","25791787"
"chr3","140480875","140481193","chr2","166088525","166088846","27","25607650"
"chr3","140560847","140561147","chr2","166000440","166000736","32","25439593"
"chr3","140585270","140585542","chr2","165977420","165977693","21","25392150"
"chr3","140610646","140610940","chr2","165952571","165952865","18","25341925"
"chr3","140617428","140617647","chr12","100306628","100306841","42","40310800"
"chr3","140686444","140686576","chr2","165866694","165866828","14","25180250"
"chr3","140693746","140694031","chr11","131260074","131260355","58","9433672"
"chr3","140694580","140694887","chr16","18006865","18007167","52","122687715"
"chr3","140697530","140697819","chr2","165855154","165855443","16","25157624"
"chr3","140706293","140706562","chr2","165845621","165845894","21","25139328"
"chr3","140708451","140708717","chr2","165844114","165844376","28","25135663"
"chr3","140709646","140709931","chr2","165842876","165843179","40","25133230"
"chr3","140752734","140752929","chr20","22071230","22071432","38","118681504"
"chr3","140762300","140762601","chr11","12216618","12216914","51","128545682"
"chr3","140782929","140783220","chr2","165742802","165743103","31","24959873"
"chr3","140791521","140791816","chr2","165732042","165732331","34","24940521"
"chr3","140797074","140797373","chr2","165717425","165717726","37","24920351"
"chr3","140809422","140809703","chr2","165704084","165704367","27","24894662"
"chr3","140818986","140819244","chr2","165696702","165696988","50","24877716"
"chr3","140820323","140820545","chr2","165695149","165695364","22","24874826"
"chr3","140825342","140825638","chr2","165689718","165689999","29","24864376"
"chr3","140827192","140827471","chr8","22914623","22914897","67","117912569"
"chr3","140831396","140831660","chr1","40364279","40364551","67","100467117"
"chr3","140831761","140832059","chr2","165682995","165683291","37","24851234"
"chr3","140864786","140865057","chr2","165648199","165648468","20","24783413"
"chr3","140872738","140872989","chr2","165640202","165640469","35","24767464"
"chr3","140901550","140901831","chr2","165613670","165613940","24","24712120"
"chr3","140905363","140905446","chr2","165609739","165609818","7","24704376"
"chr3","140910798","140910934","chr11","66292823","66292968","27","74617975"
"chr3","140911224","140911382","chr1","140043784","140043925","47","867440"
"chr3","140958415","140958696","chr2","165553461","165553741","17","24595046"
"chr3","141007550","141007819","chr2","165506339","165506613","24","24498789"
"chr3","141015932","141016240","chr2","165498084","165498403","40","24482152"
"chr3","141017007","141017300","chr2","165497031","165497341","46","24480024"
"chr3","141062725","141063028","chr2","165451672","165451973","24","24388947"
"chr3","141079622","141079922","chr4","154719395","154719689","67","13639773"
"chr3","141080922","141081236","chr2","165431913","165432187","58","24350991"
"chr3","141119303","141119678","chr2","165397637","165398008","39","24278334"
"chr3","141126928","141127238","chr2","165390088","165390381","41","24263160"
"chr3","141145190","141145406","chr2","165363083","165363302","9","24217893"
"chr3","141146424","141146639","chr2","165361870","165362082","15","24215446"
"chr3","141156565","141156697","chr2","165351620","165351741","19","24195055"
"chr3","141156994","141157173","chr2","165351113","165351306","26","24194119"
"chr3","141158000","141158303","chr2","165350004","165350290","42","24192004"
"chr3","141166775","141166897","chr2","165343506","165343628","5","24176731"
"chr3","141175920","141176232","chr2","165334861","165335167","27","24158941"
"chr3","141185245","141185377","chr6","46500507","46500636","19","94684738"
"chr3","141201028","141201320","chr2","165310583","165310880","25","24109555"
"chr3","141212102","141212218","chr1","21026778","21026893","19","120185324"
"chr3","141212245","141212415","chr4","18015620","18015790","36","123196625"
"chr3","141215173","141215319","chr4","111752382","111752531","43","29462791"
"chr3","141215618","141215646","chr1","42315028","42315058","7","98900590"
"chr3","141215779","141216057","chr2","165296666","165296948","20","24080887"
"chr3","141217676","141217885","chr2","165294478","165294692","23","24076802"
"chr3","141219954","141220082","chr13","105146939","105147067","25","36073015"
"chr3","141220391","141220505","chr5","41120819","41120943","41","100099572"
"chr3","141261292","141261579","chr2","165253870","165254161","11","23992578"
"chr3","141263223","141263482","chr2","165251973","165252232","21","23988750"
"chr3","141270117","141270424","chr7","117340197","117340504","57","23929920"
"chr3","141271309","141271580","chr5","165714831","165715111","53","24443522"
"chr3","141281118","141281364","chr3","64099959","64100210","64","77181159"
"chr3","141282483","141282752","chr3","39358673","39358948","55","101923810"
"chr3","141287326","141287624","chr2","165224516","165224819","20","23937190"
"chr3","141307405","141307636","chr1","23942951","23943176","71","117364454"
"chr3","141310990","141311287","chr2","165197398","165197695","10","23886408"
"chr3","141350952","141351227","chr2","165153598","165153870","18","23802646"
"chr3","141358523","141358688","chr2","165145342","165145503","8","23786819"
"chr3","141370958","141371257","chr2","165133181","165133490","38","23762223"
"chr3","141391719","141392018","chr2","165109106","165109405","16","23717387"
"chr3","141412525","141412832","chr2","165086997","165087317","32","23674472"
"chr3","141439702","141440014","chr2","165057110","165057423","19","23617408"
"chr3","141492767","141493067","chr2","165008183","165008489","18","23515416"
"chr3","141523308","141523512","chr2","164979071","164979268","24","23455763"
"chr3","141552131","141552426","chr2","164950526","164950804","56","23398395"
"chr3","141588021","141588130","chr9","102576871","102576979","24","39011150"
"chr3","141600933","141601222","chr2","164904361","164904663","22","23303428"
"chr3","141621356","141621669","chr2","164889201","164889521","36","23267845"
"chr3","141718153","141718454","chr2","164793215","164793516","19","23075062"
"chr3","141825976","141826273","chr2","164687342","164687638","33","22861366"
"chr3","141844444","141844653","chrX","76701868","76702087","51","65142576"
"chr3","141937653","141937768","chr2","164591467","164591574","16","22653814"
"chr3","141944202","141944496","chr2","164585015","164585313","45","22640813"
"chr3","141994873","141995130","chr4","111395763","111396029","55","30599110"
"chr3","142094368","142094621","chr20","9089100","9089338","59","133005268"
"chr3","142494065","142494364","chrX","20936707","20936993","66","121557358"
"chr3","142628705","142629006","chr2","163817530","163817835","26","21188825"
"chr3","142633949","142634238","chr1","34212899","34213191","61","108421050"
"chr3","142657500","142657798","chr2","163787259","163787545","30","21129759"
"chr3","142683199","142683326","chr2","163761108","163761235","5","21077909"
"chr3","142701385","142701536","chr2","163742693","163742808","42","21041308"
"chr3","142701776","142701976","chr2","163742194","163742394","14","21040418"
"chr3","142815482","142815744","chr19","12948232","12948495","50","129867250"
"chr3","142834046","142834320","chr2","163612510","163612786","15","20778464"
"chr3","142854133","142854437","chr3","12363236","12363543","62","130490897"
"chr3","142864392","142864600","chr3","127962642","127962820","63","14901750"
"chr3","142872284","142872405","chr2","163572985","163573102","11","20700701"
"chr3","142894149","142894445","chr2","163551024","163551322","20","20656875"
"chr3","142986562","142986839","chr2","163454850","163455143","34","20468288"
"chr3","142996174","142996453","chr2","163445135","163445414","9","20448961"
"chr3","143006525","143006776","chr3","30241225","30241450","72","112765300"
"chr3","143007074","143007214","chr20","3524907","3525040","27","139482167"
"chr3","143007393","143007688","chr2","163441322","163441613","24","20433929"
"chr3","143178468","143178581","chr11","110097545","110097658","20","33080923"
"chr3","143222211","143222522","chr2","163372799","163373071","54","20150588"
"chr3","143233851","143233979","chr2","163361817","163361941","7","20127966"
"chr3","143241260","143241563","chr7","68056030","68056319","62","75185230"
"chr3","143247913","143248212","chr2","163347467","163347766","19","20099554"
"chr3","143250794","143251077","chr2","163344605","163344891","33","20093811"
"chr3","143252410","143252566","chr2","163343076","163343219","16","20090666"
"chr3","143259287","143259570","chr2","163335438","163335721","24","20076151"
"chr3","143265576","143265822","chr2","163329164","163329413","19","20063588"
"chr3","143292594","143292904","chr6","71739431","71739729","54","71553163"
"chr3","143300594","143300886","chr2","163294699","163294995","36","19994105"
"chr3","143312401","143312658","chr19","45889563","45889807","69","97422838"
"chr3","143321858","143322139","chr2","163274058","163274344","16","19952200"
"chr3","143330514","143330816","chr2","163264853","163265148","23","19934339"
"chr3","143338606","143338904","chr2","163256401","163256699","23","19917795"
"chr3","143341010","143341229","chr20","26028650","26028871","44","117312360"
"chr3","143344636","143344929","chr2","163250097","163250374","34","19905461"
"chr3","143350741","143350848","chr9","22906816","22906917","21","120443925"
"chr3","143382346","143382626","chr2","163210798","163211079","11","19828452"
"chr3","143384710","143384971","chr2","51524786","51525054","52","91859924"
"chr3","143391719","143391854","chr7","97141598","97141741","38","46250121"
"chr3","143400946","143401049","chr5","1889927","1890031","21","141511019"
"chr3","143408107","143408329","chr2","163181599","163181818","17","19773492"
"chr3","143417103","143417416","chr2","163171808","163172108","48","19754705"
"chr3","143417464","143417759","chr1","188627840","188628135","65","45210376"
"chr3","143428779","143428903","chr2","163156931","163157055","12","19728152"
"chr3","143435332","143435606","chr12","83686829","83687113","57","59748503"
"chr3","143438908","143439207","chr2","160551205","160551504","57","17112297"
"chr3","143441758","143442049","chr2","163141317","163141613","27","19699559"
"chr3","143487509","143487635","chr10","7036419","7036542","21","136451090"
"chr3","143487746","143487786","chr14","52645848","52645891","7","90841898"
"chr3","143490691","143490982","chr6","60652847","60653144","67","82837844"
"chr3","143496376","143496708","chr4","27191661","27191993","87","116304715"
"chr3","143498059","143498151","chr7","37481324","37481413","26","106016735"
"chr3","143499722","143499947","chr3","3881369","3881580","50","139618353"
"chr3","143503206","143503383","chr2","163079415","163079598","20","19576209"
"chr3","143503681","143503814","chr2","163078972","163079105","7","19575291"
"chr3","143510852","143511055","chr2","163071425","163071630","10","19560573"
"chr3","143520902","143521114","chr6","176717360","176717573","43","33196458"
"chr3","143523347","143523625","chr2","163064220","163064503","29","19540873"
"chr3","143560516","143560810","chr2","163021727","163021995","40","19461211"
"chr3","143563190","143563506","chr10","36306327","36306622","86","107256863"
"chr3","143602271","143602549","chr2","162961619","162961900","19","19359348"
"chr3","143626641","143626808","chr2","162936434","162936601","4","19309793"
"chr3","143636191","143636499","chr2","162926478","162926788","29","19290287"
"chr3","143636509","143636814","chr4","110480234","110480546","70","33156275"
"chr3","143672672","143672944","chr15","13649680","13649954","58","130022992"
"chr3","143681767","143682075","chr2","162876101","162876409","18","19194334"
"chr3","143690694","143690995","chr9","94346653","94346954","62","49344041"
"chr3","143718332","143718418","chr2","162842350","162842433","6","19124018"
"chr3","143784923","143785213","chr2","162781101","162781397","23","18996178"
"chr3","143811796","143812089","chr2","162753406","162753695","19","18941610"
"chr3","143919511","143919818","chr2","162656254","162656560","16","18736743"
"chr3","144107020","144107232","chr2","162472395","162472619","24","18365375"
"chr3","144292256","144292529","chr2","162289438","162289713","17","17997182"
"chr3","144328854","144329110","chr2","162253913","162254167","27","17925059"
"chr3","144460427","144460559","chr2","162127199","162127344","20","17666772"
"chr3","144523532","144523658","chr19","40007059","40007188","29","104516473"
"chr3","144523693","144523855","chr7","80140173","80140333","41","64383520"
"chr3","144814185","144814463","chr2","161717810","161718084","21","16903625"
"chr3","144911796","144912092","chr2","161607461","161607730","41","16695665"
"chr3","144915244","144915537","chr2","161604196","161604496","32","16688952"
"chr3","145009600","145009862","chr2","161504725","161504985","22","16495125"
"chr3","145035792","145036080","chr2","161476034","161476329","36","16440242"
"chr3","145270528","145270786","chr7","82023696","82023957","74","63246832"
"chr3","145445090","145445342","chr1","213725125","213725374","59","68280035"
"chr3","145492569","145492699","chr13","87095059","87095190","18","58397510"
"chr3","145542614","145542907","chr2","160982891","160983158","43","15440277"
"chr3","145559420","145559673","chr9","129833577","129833832","46","15725843"
"chr3","145565079","145565302","chr7","40111984","40112209","64","105453095"
"chr3","145585932","145586252","chr6","39688785","39689097","64","105897147"
"chr3","145587961","145588251","chr2","160934481","160934761","27","15346520"
"chr3","145604650","145604904","chr2","104563621","104563886","66","41041029"
"chr3","145617802","145618028","chr2","160904526","160904746","36","15286724"
"chr3","145630890","145631179","chrX","51871583","51871875","52","93759307"
"chr3","145642393","145642683","chr2","160885575","160885871","29","15243182"
"chr3","145648560","145648866","chr2","160879192","160879495","32","15230632"
"chr3","145665284","145665591","chr2","160860803","160861113","25","15195519"
"chr3","145798814","145799115","chr2","160731728","160732036","32","14932914"
"chr3","145803103","145803408","chr2","160727076","160727394","32","14923973"
"chr3","145915553","145915871","chr2","160619688","160619983","50","14704135"
"chr3","145936463","145936754","chr2","160604557","160604878","48","14668094"
"chr3","145946588","145946852","chr2","160592986","160593271","35","14646398"
"chr3","145966839","145966973","chr3","156532967","156533099","13","10566128"
"chr3","145989940","145990240","chr2","160551205","160551504","16","14561265"
"chr3","146008216","146008510","chr2","160532367","160532665","32","14524151"
"chr3","146054796","146055094","chr2","160485213","160485509","17","14430417"
"chr3","146065462","146065795","chr2","160473915","160474248","17","14408453"
"chr3","146108422","146108707","chr2","160429367","160429651","16","14320945"
"chr3","146113118","146113418","chr2","160423897","160424204","21","14310779"
"chr3","146240791","146241079","chr2","99689040","99689328","55","46551751"
"chr3","146285289","146285596","chr2","160253700","160254022","21","13968411"
"chr3","146295364","146295636","chr2","160242784","160243058","24","13947420"
"chr3","146298865","146299183","chr15","24356454","24356770","70","121942411"
"chr3","146371240","146371490","chr2","160121940","160122181","20","13750700"
"chr3","146380357","146380643","chr1","195814241","195814525","42","49433884"
"chr3","146410445","146410554","chr2","160080631","160080745","10","13670186"
"chr3","146410845","146411019","chr2","160080155","160080339","22","13669310"
"chr3","146412795","146413090","chr2","160078094","160078405","36","13665299"
"chr3","146473318","146473622","chr2","160015757","160016048","34","13542439"
"chr3","146485270","146485547","chr2","160003690","160003981","30","13518420"
"chr3","146494782","146494934","chr2","159994336","159994487","14","13499554"
"chr3","146495321","146495476","chr3","55146551","55146709","27","91348770"
"chr3","146518506","146518845","chrX","27323100","27323414","83","119195406"
"chr3","146522203","146522359","chr7","84537557","84537711","24","61984646"
"chr3","146533409","146533707","chr19","3500436","3500734","62","143032973"
"chr3","146549156","146549407","chr2","159942888","159943143","19","13393732"
"chr3","146555257","146555541","chr2","159938043","159938325","22","13382786"
"chr3","146555575","146555597","chr8","62512371","62512390","3","84043204"
"chr3","146562668","146562924","chr2","159929735","159929996","29","13367067"
"chr3","146579358","146579611","chr2","159913458","159913713","23","13334100"
"chr3","146584470","146584613","chr2","159909193","159909336","14","13324723"
"chr3","146602946","146603249","chr2","159893558","159893848","33","13290612"
"chr3","146629381","146629677","chr2","159865040","159865338","15","13235659"
"chr3","146640189","146640468","chr2","159853383","159853660","23","13213194"
"chr3","146661962","146662075","chr2","159831386","159831508","19","13169424"
"chr3","146662376","146662559","chr2","159830906","159831092","14","13168530"
"chr3","146674171","146674462","chr2","159820911","159821206","29","13146740"
"chr3","146682326","146682408","chr2","159813340","159813422","6","13131014"
"chr3","146689818","146690113","chr6","153036392","153036685","64","6346574"
"chr3","146719687","146719983","chr7","41778789","41779094","61","104940898"
"chr3","146720904","146721028","chr13","25546692","25546816","16","121174212"
"chr3","146738328","146738621","chr2","159756740","159757038","19","13018412"
"chr3","146741845","146742035","chr2","159752903","159753095","14","13011058"
"chr3","146747038","146747344","chr2","159749793","159750092","21","13002755"
"chr3","146749484","146749544","chr2","159747731","159747789","6","12998247"
"chr3","146749877","146749984","chr2","159747324","159747428","9","12997447"
"chr3","146757353","146757540","chr2","159739325","159739515","13","12981972"
"chr3","146767342","146767613","chr2","159729255","159729533","34","12961913"
"chr3","146784980","146785281","chr2","159711184","159711480","18","12926204"
"chr3","146787965","146788089","chr3","39187033","39187156","16","107600932"
"chr3","146797150","146797441","chr2","159698664","159698951","23","12901514"
"chr3","146807531","146807720","chrX","113320960","113321125","39","33486571"
"chr3","146808011","146808148","chr2","159688647","159688771","21","12880636"
"chr3","146809369","146809671","chr7","151815909","151816208","62","5006540"
"chr3","146819574","146819866","chr2","159677046","159677346","23","12857472"
"chr3","146828248","146828528","chr2","159662448","159662702","42","12834200"
"chr3","146835716","146836019","chr2","159656056","159656363","14","12820340"
"chr3","146860327","146860546","chr2","159601125","159601342","20","12740798"
"chr3","146874060","146874235","chr15","50355573","50355749","42","96518487"
"chr3","146897029","146897303","chr2","159558956","159559232","25","12661927"
"chr3","146953013","146953293","chr2","159511996","159512287","37","12558983"
"chr3","146956367","146956493","chr20","26844688","26844811","18","120111679"
"chr3","146982766","146983064","chr14","15838457","15838757","61","131144309"
"chr3","146988095","146988404","chr2","159477557","159477868","18","12489462"
"chr3","146992844","146993127","chr2","159472942","159473228","33","12480098"
"chr3","147005526","147005818","chr11","37990957","37991239","72","109014569"
"chr3","147016297","147016593","chr2","159449107","159449409","28","12432810"
"chr3","147022308","147022584","chr2","159441815","159442088","20","12419507"
"chr3","147022714","147023008","chr2","159441056","159441357","25","12418342"
"chr3","147030849","147031118","chr2","159432221","159432481","31","12401372"
"chr3","147060378","147060549","chr2","159405897","159406069","13","12345519"
"chr3","147077360","147077505","chr2","159394605","159394748","7","12317245"
"chr3","147089568","147089878","chr2","159382460","159382746","36","12292892"
"chr3","147114782","147115086","chr2","159363568","159363871","17","12248786"
"chr3","147124776","147125070","chr2","159353996","159354295","25","12229220"
"chr3","147158711","147158977","chr14","48496157","48496415","65","98662554"
"chr3","147162842","147163073","chr20","26500350","26500587","65","120662492"
"chr3","147176772","147177107","chr11","124022145","124022465","86","23154627"
"chr3","147180261","147180567","chr2","159299113","159299409","42","12118852"
"chr3","147205339","147205656","chr2","159274494","159274819","24","12069155"
"chr3","147236186","147236467","chr2","159243002","159243280","27","12006816"
"chr3","147252721","147253022","chr2","159226288","159226586","17","11973567"
"chr3","147260828","147261138","chr2","159218081","159218380","34","11957253"
"chr3","147265874","147266071","chr2","159213114","159213315","22","11947240"
"chr3","147279319","147279613","chr3","65149988","65150281","53","82129331"
"chr3","147288414","147288626","chr2","159196181","159196359","42","11907767"
"chr3","147298061","147298278","chr2","159185489","159185722","25","11887428"
"chr3","147339495","147339611","chr2","159145820","159145942","11","11806325"
"chr3","147339913","147340094","chr4","8454525","8454703","39","138885388"
"chr3","147341093","147341374","chr2","159144119","159144399","32","11803026"
"chr3","147359436","147359566","chr2","159125913","159126043","6","11766477"
"chr3","147401700","147401966","chr2","159084744","159085027","31","11683044"
"chr3","147424162","147424437","chr2","159062141","159062415","22","11637979"
"chr3","147477923","147478198","chr2","158996852","158997141","38","11518929"
"chr3","147507085","147507381","chr8","92485975","92486254","71","55021110"
"chr3","147518546","147518709","chr10","46752990","46753157","27","100765556"
"chr3","147519046","147519168","chr4","159383035","159383157","17","11863989"
"chr3","147535891","147536023","chr2","158939321","158939453","9","11403430"
"chr3","147548702","147548980","chr14","109750820","109751109","62","37797882"
"chr3","147572249","147572373","chr10","63321341","63321465","17","84250908"
"chr3","147596956","147597261","chr2","158877149","158877454","20","11280193"
"chr3","147608595","147608877","chr2","158864218","158864513","28","11255623"
"chr3","147669577","147669798","chr11","40167028","40167241","53","107502549"
"chr3","147708757","147709050","chr2","158764301","158764595","16","11055544"
"chr3","147712979","147713281","chr2","158760054","158760358","28","11047075"
"chr3","147735932","147736254","chr2","158734803","158735123","25","10998871"
"chr3","147757677","147757974","chr3","43652365","43652670","69","104105312"
"chr3","147766428","147766750","chr2","158702576","158702891","39","10936148"
"chr3","147769165","147769433","chr2","158699904","158700176","17","10930739"
"chr3","147805467","147805740","chr20","22996900","22997178","54","124808567"
"chr3","147869583","147869835","chr2","158591796","158592046","16","10722213"
"chr3","147897255","147897553","chr2","158559957","158560256","35","10662702"
"chr3","148085676","148085940","chr2","158380538","158380834","44","10294862"
"chr3","148097466","148097774","chr2","158368615","158368927","26","10271149"
"chr3","148306567","148306682","chr2","158154556","158154670","12","9847989"
"chr3","148352245","148352555","chr7","8215563","8215872","56","140136682"
"chr3","148382507","148382799","chr2","158073362","158073663","41","9690855"
"chr3","148558907","148559132","chr2","157841378","157841604","16","9282471"
"chr3","148578791","148579090","chr2","157818507","157818788","42","9239716"
"chr3","148796382","148796485","chr7","129543479","129543585","25","19252903"
"chr3","148937955","148938169","chr2","157444469","157444683","13","8506514"
"chr3","148967294","148967550","chr2","157408585","157408840","8","8441291"
"chr3","149219063","149219360","chr2","157110005","157110299","38","7890942"
"chr3","149543058","149543351","chr2","156808630","156808924","36","7265572"
"chr3","149742074","149742399","chr2","156637100","156637414","34","6895026"
"chr3","149762376","149762611","chr6","72090583","72090845","77","77671793"
"chr3","149839088","149839219","chr2","156517389","156517520","10","6678301"
"chr3","149892840","149893019","chr7","85922873","85923051","42","63969967"
"chr3","149931337","149931585","chr2","156396395","156396645","23","6465058"
"chr3","149937991","149938291","chr2","156389388","156389676","35","6451397"
"chr3","150133135","150133254","chr9","12674840","12674960","26","137458295"
"chr3","150136269","150136549","chr2","156188125","156188406","25","6051856"
"chr3","150214816","150215097","chr2","156113798","156114076","28","5898982"
"chr3","150308909","150309182","chr2","156021507","156021803","55","5712598"
"chr3","150741267","150741466","chr1","88988374","88988562","44","61752893"
"chr3","150802169","150802465","chr2","155536752","155537049","12","4734583"
"chr3","150843661","150843955","chr2","155487393","155487689","29","4643732"
"chr3","150856957","150857236","chr2","155474928","155475216","31","4617971"
"chr3","150881417","150881544","chr2","155452015","155452142","3","4570598"
"chr3","150882203","150882511","chrX","96882597","96882896","76","53999606"
"chr3","151168560","151168853","chr2","155203172","155203493","47","4034612"
"chr3","151199258","151199553","chr2","155171987","155172269","40","3972729"
"chr3","151309411","151309691","chr2","155072880","155073150","28","3763469"
"chr3","151379464","151379732","chrY","6355613","6355864","79","145023851"
"chr3","151471134","151471294","chr3","126621167","126621327","31","24849967"
"chr3","151471339","151471436","chr7","71035496","71035593","17","80435843"
"chr3","151471437","151471542","chr2","154917553","154917660","10","3446116"
"chr3","151523692","151524011","chr2","154869278","154869595","22","3345586"
"chr3","151648584","151648846","chr19","4819808","4820082","61","146828776"
"chr3","151706448","151706735","chr2","202875969","202876255","74","51169521"
"chr3","151782706","151782997","chr2","188426626","188426924","56","36643920"
"chr3","151834797","151835023","chr12","82534959","82535164","61","69299838"
"chr3","151839397","151839699","chr9","14892871","14893167","57","136946526"
"chr3","151919682","151919986","chr2","154452880","154453205","37","2533198"
"chr3","151959618","151959808","chr2","154409754","154409961","30","2450136"
"chr3","152046861","152047167","chr2","154321834","154322140","21","2274973"
"chr3","152051731","152052047","chr2","154316915","154317224","26","2265184"
"chr3","152084390","152084704","chr2","154272585","154272883","49","2188195"
"chr3","152179354","152179534","chr2","154124645","154124826","7","1945291"
"chr3","152242162","152242399","chr19","3207654","3207880","60","149034508"
"chr3","152289257","152289534","chr2","154005136","154005409","22","1715879"
"chr3","152311769","152312048","chr2","153985141","153985413","27","1673372"
"chr3","152434172","152434280","chr2","153861987","153862093","8","1427815"
"chr3","152474739","152474979","chr3","126794297","126794543","58","25680442"
"chr3","152492807","152493088","chr2","153803840","153804107","34","1311033"
"chr3","152505407","152505732","chr2","153793486","153793760","69","1288079"
"chr3","152512094","152512388","chr2","153787802","153788111","33","1275708"
"chr3","152512640","152512928","chr2","153787264","153787568","35","1274624"
"chr3","152580592","152580888","chr2","153720632","153720928","18","1140040"
"chr3","152717018","152717292","chr2","99648006","99648286","62","53069012"
"chr3","152954603","152954890","chr2","153347249","153347538","56","392646"
"chr3","152995479","152995786","chr2","153306282","153306583","36","310803"
"chr3","153032409","153032718","chr2","153280430","153280747","30","248021"
"chr3","153171281","153171391","chr2","153148749","153148867","18","22532"
"chr3","153184593","153184823","chr2","153135867","153136098","18","48726"
"chr3","153186900","153187127","chr2","153133556","153133785","37","53344"
"chr3","153188893","153189015","chr2","153130993","153131115","6","57900"
"chr3","153307634","153307929","chr2","153009899","153010201","21","297735"
"chr3","153315308","153315608","chr2","153002202","153002493","34","313106"
"chr3","153347135","153347432","chr2","152970192","152970507","37","376943"
"chr3","153397147","153397444","chr2","135429736","135430035","24","17967411"
"chr3","153408146","153408408","chr2","135440587","135440875","47","17967559"
"chr3","153520311","153520608","chr2","135552840","135553130","28","17967471"
"chr3","153545771","153546093","chr2","135578525","135578845","20","17967246"
"chr3","153583277","153583572","chr2","135617036","135617329","16","17966241"
"chr3","153625973","153626202","chr2","135657213","135657439","27","17968760"
"chr3","153680671","153680938","chr2","135711762","135712053","40","17968909"
"chr3","153703898","153704228","chr2","135732668","135732990","28","17971230"
"chr3","153722752","153723060","chr2","135759728","135760019","41","17963024"
"chr3","153751574","153751826","chr2","135789489","135789742","15","17962085"
"chr3","153754298","153754420","chr20","24383852","24383976","19","129370446"
"chr3","153755073","153755374","chr2","135792778","135793074","33","17962295"
"chr3","153826609","153826941","chr2","135865698","135866019","91","17960911"
"chr3","153895832","153896106","chr2","135981637","135981888","51","17914195"
"chr3","153938082","153938375","chr7","81730787","81731078","54","72207295"
"chr3","153947947","153948222","chr2","136035003","136035273","38","17912944"
"chr3","153986292","153986562","chr2","136073025","136073319","51","17913267"
"chr3","154005801","154006081","chr1","212801492","212801783","65","58795691"
"chr3","154016236","154016363","chr2","136103432","136103559","9","17912804"
"chr3","154073431","154073725","chr6","127778368","127778672","63","26295063"
"chr3","154079951","154080077","chr11","113226186","113226302","22","40853765"
"chr3","154087786","154088120","chr14","78406801","78407123","69","75680985"
"chr3","154107883","154108003","chr2","136193352","136193469","15","17914531"
"chr3","154146286","154146597","chr15","31942614","31942929","55","122203672"
"chr3","154162676","154162797","chr2","136248445","136248572","16","17914231"
"chr3","154207736","154208029","chr2","136297985","136298278","19","17909751"
"chr3","154210414","154210710","chr2","136300645","136300946","34","17909769"
"chr3","154225068","154225381","chr2","136315375","136315675","40","17909693"
"chr3","154226180","154226461","chr2","136316462","136316722","37","17909718"
"chr3","154229423","154229715","chr2","136320135","136320432","30","17909288"
"chr3","154235550","154235822","chr2","136326109","136326384","23","17909441"
"chr3","154246264","154246376","chr2","136335506","136335618","7","17910758"
"chr3","154248665","154248961","chr2","136337589","136337887","22","17911076"
"chr3","154268901","154269081","chr3","127962642","127962820","41","26306259"
"chr3","154270049","154270339","chr16","23564506","23564783","65","130705543"
"chr3","154276987","154277223","chr2","136373189","136373394","54","17903798"
"chr3","154323836","154324128","chr2","136476423","136476715","19","17847413"
"chr3","154329089","154329381","chr2","136481485","136481749","46","17847604"
"chr3","154362812","154363114","chr2","136515498","136515798","20","17847314"
"chr3","154370140","154370249","chr1","19438111","19438224","22","134932029"
"chr3","154384615","154384745","chr2","136537796","136537923","7","17846819"
"chr3","154407153","154407459","chr2","136558630","136558931","27","17848523"
"chr3","154421046","154421202","chr15","7098680","7098841","28","147322366"
"chr3","154423842","154423958","chr2","136575585","136575702","4","17848257"
"chr3","154463256","154463412","chr12","21323547","21323703","25","133139709"
"chr3","154484942","154485153","chr5","78578822","78579040","40","75906120"
"chr3","154515826","154516094","chr2","136677280","136677549","10","17838546"
"chr3","154517485","154517752","chr2","136678928","136679212","35","17838557"
"chr3","154528340","154528646","chr7","116518734","116519041","60","38009606"
"chr3","154653526","154653847","chr10","33765504","33765814","80","120888022"
"chr3","154686819","154687110","chr2","136839773","136840073","28","17847046"
"chr3","154696427","154696723","chr2","136850010","136850318","30","17846417"
"chr3","154728204","154728461","chr2","136881730","136882001","33","17846474"
"chr3","154788659","154788784","chr20","27673789","27673919","17","127114870"
"chr3","154872307","154872611","chr7","125199067","125199377","59","29673240"
"chr3","154958462","154958765","chr2","137125274","137125577","19","17833188"
"chr3","155034429","155034688","chr2","137202123","137202382","12","17832306"
"chr3","155043584","155043769","chr1","199401689","199401890","58","44358105"
"chr3","155049201","155049321","chr2","137216972","137217085","12","17832229"
"chr3","155062727","155063019","chr2","137230685","137230983","32","17832042"
"chr3","155107736","155107888","chr2","137275379","137275537","12","17832357"
"chr3","155111660","155111869","chr2","137279218","137279411","28","17832442"
"chr3","155116300","155116558","chr6","135747025","135747278","62","19369275"
"chr3","155127862","155128154","chr2","137295598","137295876","25","17832264"
"chr3","155167337","155167635","chr2","137334398","137334691","19","17832939"
"chr3","155197288","155197506","chr20","22161284","22161503","49","133036004"
"chr3","155208408","155208602","chr2","137379711","137379905","11","17828697"
"chr3","155230273","155230392","chr2","137401124","137401250","13","17829149"
"chr3","155238567","155238712","chr17","29278861","29279007","35","125959706"
"chr3","155241686","155241799","chr14","72745880","72745995","18","82495806"
"chr3","155255368","155255687","chr2","137428174","137428494","28","17827194"
"chr3","155264629","155264916","chr2","137437337","137437625","17","17827292"
"chr3","155265082","155265376","chr8","28667638","28667936","60","126597444"
"chr3","155268534","155268715","chr15","64503449","64503624","46","90765085"
"chr3","155269009","155269138","chr2","137441834","137441962","8","17827175"
"chr3","155276696","155276894","chr16","72287582","72287780","41","82989114"
"chr3","155279720","155280026","chr2","137452554","137452848","37","17827166"
"chr3","155294915","155295085","chr2","137469873","137470045","11","17825042"
"chr3","155296497","155296664","chr9","26520390","26520553","36","128776107"
"chr3","155299967","155300250","chr2","137475022","137475306","16","17824945"
"chr3","155317610","155317894","chr2","137497363","137497641","27","17820247"
"chr3","155423500","155423772","chr11","50199778","50200051","61","105223722"
"chr3","155450218","155450493","chr2","137628627","137628930","39","17821591"
"chr3","155474555","155474826","chr2","137660670","137660943","33","17813885"
"chr3","155589474","155589740","chr3","156182074","156182342","56","592600"
"chr3","155627363","155627668","chr2","70279834","70280133","60","85347529"
"chr3","155669741","155670032","chr2","137860759","137861079","50","17808982"
"chr3","155692471","155692723","chr2","137883857","137884110","15","17808614"
"chr3","155701844","155702070","chr2","137893497","137893719","41","17808347"
"chr3","155705629","155705741","chr2","137897545","137897657","8","17808084"
"chr3","155730479","155730795","chr2","137922429","137922743","24","17808050"
"chr3","155776427","155776696","chr2","137965785","137966061","19","17810642"
"chr3","155858187","155858491","chr2","138041103","138041412","36","17817084"
"chr3","155946918","155947038","chr4","105553931","105554054","18","50392987"
"chr3","155953257","155953548","chr15","49822998","49823297","61","106130259"
"chr3","156041273","156041545","chr2","138225361","138225640","25","17815912"
"chr3","156150892","156151009","chr2","202498707","202498823","20","46347815"
"chr3","156151050","156151194","chr7","35936562","35936707","41","120214488"
"chr3","156187135","156187442","chr2","138372484","138372794","17","17814651"
"chr3","156218572","156218687","chr2","138405368","138405485","8","17813204"
"chr3","156224722","156224985","chr2","138412040","138412304","20","17812682"
"chr3","156252775","156253085","chr2","138454260","138454560","41","17798515"
"chr3","156294059","156294363","chr2","138502908","138503209","20","17791151"
"chr3","156311993","156312157","chr19","6987858","6988025","39","149324135"
"chr3","156347396","156347707","chr2","138575923","138576242","22","17771473"
"chr3","156371919","156372198","chr2","138600541","138600827","43","17771378"
"chr3","156392176","156392487","chr2","138621897","138622208","34","17770279"
"chr3","156399671","156399800","chr2","138663195","138663312","20","17736476"
"chr3","156434784","156434956","chr13","89864860","89865034","45","66569924"
"chr3","156450972","156451109","chr3","49998015","49998152","26","106452957"
"chr3","156465257","156465543","chr2","138725357","138725635","27","17739900"
"chr3","156525864","156526173","chr2","138787952","138788258","22","17737912"
"chr3","156571869","156572053","chr8","64731321","64731495","44","91840548"
"chr3","156637673","156637969","chr2","138915642","138915938","29","17722031"
"chr3","156644833","156645098","chr2","138922908","138923173","27","17721925"
"chr3","156648173","156648454","chr20","10875923","10876201","58","145772250"
"chr3","156753624","156753851","chr8","22439702","22439922","48","134313922"
"chr3","156814621","156814833","chr2","139104983","139105201","24","17709638"
"chr3","156881157","156881382","chr2","139170405","139170628","21","17710752"
"chr3","156882154","156882445","chr2","139171407","139171694","19","17710747"
"chr3","156919176","156919377","chr2","139210186","139210388","8","17708990"
"chr3","156929005","156929297","chr2","139220001","139220299","33","17709004"
"chr3","156970117","156970395","chr2","139261645","139261920","35","17708472"
"chr3","157010357","157010601","chr19","672684","672923","55","156337673"
"chr3","157060840","157061107","chr2","139350915","139351159","42","17709925"
"chr3","157081657","157081951","chr2","139371283","139371575","29","17710374"
"chr3","157104265","157104390","chr2","139399750","139399878","13","17704515"
"chr3","157104418","157104596","chr3","20603210","20603376","43","136501208"
"chr3","157132209","157132507","chr2","139428243","139428564","33","17703966"
"chr3","157186873","157187171","chr2","139490285","139490583","13","17696588"
"chr3","157200927","157201226","chr2","139498310","139498609","26","17702617"
"chr3","157216119","157216412","chr2","139513664","139513955","35","17702455"
"chr3","157226451","157226766","chr2","139523227","139523524","38","17703224"
"chr3","157249097","157249332","chr11","50503500","50503737","64","106745597"
"chr3","157254986","157255047","chr6","111070219","111070279","20","46184767"
"chr3","157255471","157255700","chr4","14161981","14162209","66","143093490"
"chr3","157320824","157321136","chr7","53097730","53098042","62","104223094"
"chr3","157325949","157326059","chr2","94457026","94457132","24","62868923"
"chr3","157338565","157338673","chr1","213086899","213087001","31","55748334"
"chr3","157352709","157352954","chr18","12446919","12447174","57","144905790"
"chr3","157385702","157385797","chr2","139694789","139694884","2","17690913"
"chr3","157476257","157476499","chr2","139785005","139785252","41","17691252"
"chr3","157507536","157507657","chr2","139816987","139817109","11","17690549"
"chr3","157509547","157509736","chr1","7188271","7188471","43","150321276"
"chr3","157544153","157544443","chr2","139855012","139855299","19","17689141"
"chr3","157563210","157563459","chr2","139876210","139876452","18","17687000"
"chr3","157567968","157568257","chr6","170625527","170625818","64","13057559"
"chr3","157605086","157605257","chr20","28166833","28167010","39","129438253"
"chr3","157606289","157606424","chr2","139909597","139909731","13","17696692"
"chr3","157606734","157606901","chr2","139910039","139910210","26","17696695"
"chr3","157614749","157615036","chr11","108911962","108912248","47","48702787"
"chr3","157629171","157629487","chr2","139933716","139934033","27","17695455"
"chr3","157639612","157639717","chr8","58651613","58651718","21","98987999"
"chr3","157659578","157659855","chr8","71901163","71901444","56","85758415"
"chr3","157677996","157678308","chr2","139981378","139981685","24","17696618"
"chr3","157687702","157687951","chr3","64882869","64883122","65","92804833"
"chr3","157775137","157775443","chr2","140141164","140141444","52","17633973"
"chr3","157785458","157785575","chr2","140152759","140152876","6","17632699"
"chr3","157793629","157793761","chr2","140163043","140163179","11","17630586"
"chr3","158323054","158323257","chr20","33873914","33874133","58","124449140"
"chr3","158376591","158376776","chr15","50715278","50715460","45","107661313"
"chr3","158377094","158377228","chr9","120580895","120581028","26","37796199"
"chr3","158463050","158463352","chr1","22392281","22392567","68","136070769"
"chr3","158574063","158574179","chr10","73131386","73131503","20","85442677"
"chr3","158629154","158629451","chr2","140976226","140976512","33","17652928"
"chr3","158649144","158649448","chr2","140996656","140996961","20","17652488"
"chr3","158699843","158700157","chr2","141096527","141096824","32","17603316"
"chr3","158798042","158798129","chr2","141195429","141195516","3","17602613"
"chr3","158822702","158823004","chr2","141218768","141219077","30","17603934"
"chr3","158824298","158824422","chr2","141220393","141220517","5","17603905"
"chr3","158902326","158902614","chr2","141300443","141300732","20","17601883"
"chr3","158917037","158917317","chr2","141315322","141315596","42","17601715"
"chr3","158938691","158938986","chr2","141337263","141337531","55","17601428"
"chr3","158942610","158942837","chr2","141341147","141341369","27","17601463"
"chr3","158955087","158955416","chr6","155398857","155399162","86","3556230"
"chr3","159011427","159011733","chr9","62091948","62092235","66","96919479"
"chr3","159048387","159048697","chr1","182642228","182642528","58","23593841"
"chr3","159074353","159074655","chr2","141460119","141460428","36","17614234"
"chr3","159151820","159152025","chr19","2554915","2555123","43","156596905"
"chr3","159174009","159174314","chr2","141560984","141561282","30","17613025"
"chr3","159305255","159305543","chrX","2542433","2542717","65","156762822"
"chr3","159339118","159339384","chr2","141719688","141719974","45","17619430"
"chr3","159500572","159500770","chr2","141876988","141877187","17","17623584"
"chr3","159789144","159789425","chr14","16570544","16570811","31","143218600"
"chr3","159899694","159899823","chr14","16479514","16479643","7","143420180"
"chr3","159905085","159905400","chr14","16473883","16474198","36","143431202"
"chr3","159935872","159936172","chr2","71005973","71006275","59","88929899"
"chr3","159987965","159988172","chr14","16391018","16391225","19","143596947"
"chr3","159992212","159992501","chr16","16185469","16185766","60","143806743"
"chr3","160026669","160026989","chr14","16355760","16356079","25","143670909"
"chr3","160088377","160088511","chr14","16295370","16295504","5","143793007"
"chr3","160139667","160139971","chr14","16241631","16241945","25","143898036"
"chr3","160149411","160149706","chr14","16231241","16231505","51","143918170"
"chr3","160149758","160149955","chr14","16231000","16231195","9","143918758"
"chr3","160324979","160325198","chr2","142198671","142198891","19","18126308"
"chr3","160367272","160367573","chr2","142248735","142249060","49","18118537"
"chr3","160429062","160429357","chr1","155141171","155141450","67","5287891"
"chr3","160613679","160613982","chr2","142521770","142522075","20","18091909"
"chr3","160621683","160621799","chr2","142593300","142593417","11","18028383"
"chr3","160661098","160661259","chr7","162104941","162105104","42","1443843"
"chr3","160669807","160670106","chr2","142635637","142635938","43","18034170"
"chr3","160695293","160695522","chr10","14031404","14031631","49","146663889"
"chr3","160753796","160754053","chr2","142709059","142709327","24","18044737"
"chr3","160761499","160761610","chr2","142716477","142716588","13","18045022"
"chr3","160770423","160770742","chr2","142725745","142726054","32","18044678"
"chr3","160777498","160777763","chr2","142733092","142733358","20","18044406"
"chr3","160823610","160823905","chr2","142779786","142780084","16","18043824"
"chr3","160846382","160846522","chr2","142802061","142802206","15","18044321"
"chr3","160846823","160846981","chr2","142802510","142802667","14","18044313"
"chr3","160907273","160907565","chr2","142864826","142865122","18","18042447"
"chr3","160911812","160912105","chr2","142869626","142869919","19","18042186"
"chr3","160912110","160912383","chr2","142869924","142870198","24","18042186"
"chr3","160931696","160931897","chr12","112420236","112420444","53","48511460"
"chr3","160931898","160932195","chr2","142898049","142898336","37","18033849"
"chr3","160932196","160932316","chr7","68599953","68600068","25","92332243"
"chr3","160943923","160944198","chr2","142910072","142910368","46","18033851"
"chr3","160945640","160945737","chr3","40442284","40442367","27","120503356"
"chr3","160959309","160959419","chr1","53070533","53070638","17","107888776"
"chr3","161014004","161014306","chr2","142991027","142991339","35","18022977"
"chr3","161016369","161016590","chrX","8697309","8697538","48","152319060"
"chr3","161028662","161028921","chr2","143005916","143006173","20","18022746"
"chr3","161033073","161033363","chr2","143010831","143011129","28","18022242"
"chr3","161055812","161056108","chr2","143031231","143031512","28","18024581"
"chr3","161074933","161075210","chr2","143049676","143049980","45","18025257"
"chr3","161102974","161103268","chr2","143070309","143070614","26","18032665"
"chr3","161178862","161179168","chrX","113948127","113948423","52","47230735"
"chr3","161181553","161181841","chr2","143149561","143149863","27","18031992"
"chr3","161295085","161295380","chr2","143271726","143272021","13","18023359"
"chr3","161460334","161460590","chr2","143432490","143432747","33","18027844"
"chr3","161470668","161470987","chr2","143442617","143442929","23","18028051"
"chr3","161471879","161472192","chr5","185678151","185678451","66","24206272"
"chr3","161580284","161580409","chr1","205464254","205464380","17","43883970"
"chr3","161709992","161710282","chr2","143680595","143680904","39","18029397"
"chr3","161726526","161726833","chr2","143698628","143698935","24","18027898"
"chr3","161779229","161779407","chr2","143813844","143814025","16","17965385"
"chr3","161779704","161779824","chr2","143814325","143814448","7","17965379"
"chr3","161781142","161781417","chr2","143815768","143816048","29","17965374"
"chr3","161797887","161798182","chr2","143832524","143832814","34","17965363"
"chr3","161804962","161805275","chr2","143839876","143840218","47","17965086"
"chr3","161809842","161810150","chr3","8126079","8126375","69","153683763"
"chr3","161822674","161822973","chr3","120550831","120551128","58","41271843"
"chr3","161837238","161837420","chr5","18275165","18275352","47","143562073"
"chr3","161874222","161874506","chr2","143906543","143906834","24","17967679"
"chr3","161874817","161875113","chr2","143907147","143907445","15","17967670"
"chr3","161932752","161933058","chr2","143960471","143960768","29","17972281"
"chr3","161955532","161955815","chr2","143984401","143984693","31","17971131"
"chr3","162009312","162009441","chr1","53704936","53705059","26","108304376"
"chr3","162012755","162013099","chr13","19986833","19987135","95","142025922"
"chr3","162045184","162045362","chr8","18395582","18395763","44","143649602"
"chr3","162128776","162129092","chr2","144166599","144166940","47","17962177"
"chr3","162150617","162150889","chr2","144188649","144188940","35","17961968"
"chr3","162172008","162172305","chr2","144210453","144210757","27","17961555"
"chr3","162175307","162175468","chr7","80140173","80140333","24","82035134"
"chr3","162182224","162182498","chr2","144221539","144221812","30","17960685"
"chr3","162273003","162273275","chr13","9550530","9550799","60","152722473"
"chr3","162286061","162286138","chr12","48383020","48383096","17","113903041"
"chr3","162305236","162305535","chrX","113634547","113634849","52","48670689"
"chr3","162318118","162318443","chr6","93662967","93663295","66","68655151"
"chr3","162321388","162321672","chr3","123699206","123699496","72","38622182"
"chr3","162324377","162324628","chr14","15716205","15716457","54","146608172"
"chr3","162371162","162371503","chr2","144420685","144421019","22","17950477"
"chr3","162373509","162373804","chr2","48622768","48623061","60","113750741"
"chr3","162414105","162414282","chr2","144465751","144465924","12","17948354"
"chr3","162447553","162447856","chr3","127162429","127162726","59","35285124"
"chr3","162534966","162535243","chr2","144581120","144581403","18","17953846"
"chr3","162550707","162551003","chr2","144596844","144597151","34","17953863"
"chr3","162618500","162618802","chr2","144665893","144666197","24","17952607"
"chr3","162647324","162647580","chr20","42703392","42703652","46","119943932"
"chr3","162704267","162704605","chr1","66428412","66428726","97","96275855"
"chr3","162706050","162706342","chr13","71273024","71273317","56","91433026"
"chr3","162847070","162847349","chr2","71665091","71665377","60","91181979"
"chr3","162848422","162848701","chr2","144896747","144897033","25","17951675"
"chr3","162947183","162947434","chr2","144994959","144995211","19","17952224"
"chr3","163042733","163043063","chr2","145077545","145077880","25","17965188"
"chr3","163046562","163046684","chr5","112526981","112527104","21","50519581"
"chr3","163056565","163056882","chr2","145093974","145094295","18","17962591"
"chr3","163138857","163139159","chr1","123440775","123441073","68","39698082"
"chr3","163210705","163210895","chr9","93207832","93208008","48","70002873"
"chr3","163216164","163216443","chr2","145305785","145306062","19","17910379"
"chr3","163217660","163217969","chr2","145307257","145307560","24","17910403"
"chr3","163264459","163264759","chr2","145349159","145349458","25","17915300"
"chr3","163276369","163276652","chr2","145360725","145360992","31","17915644"
"chr3","163286675","163286779","chr2","145371294","145371411","23","17915381"
"chr3","163286813","163286858","chr16","72124145","72124164","26","91162668"
"chr3","163286894","163287076","chr2","145371452","145371636","37","17915442"
"chr3","163301175","163301470","chr2","145381323","145381632","60","17919852"
"chr3","163382778","163383044","chr3","156182074","156182342","67","7200704"
"chr3","163413994","163414107","chr2","145497282","145497408","19","17916712"
"chr3","163438845","163439147","chr2","145516745","145517040","27","17922100"
"chr3","163443104","163443406","chr2","145521125","145521424","18","17921979"
"chr3","163467113","163467368","chrX","9704421","9704675","62","153762692"
"chr3","163504159","163504278","chr4","87053483","87053602","24","76450676"
"chr3","163545661","163545947","chr2","145623960","145624249","24","17921701"
"chr3","163598470","163598567","chr8","30496340","30496429","31","133102130"
"chr3","163599957","163600252","chr2","145673647","145673942","19","17926310"
"chr3","163633443","163633548","chr2","145710160","145710264","7","17923283"
"chr3","163634178","163634380","chr2","145710892","145711098","13","17923286"
"chr3","163668088","163668311","chr1","45544948","45545172","42","118123140"
"chr3","163763897","163764185","chr7","165685923","165686204","50","1922026"
"chr3","163781038","163781292","chr11","118504184","118504438","61","45276854"
"chr3","163807201","163807524","chr2","145927934","145928256","53","17879267"
"chr3","163829686","163829940","chr2","145950716","145950974","21","17878970"
"chr3","163879377","163879594","chr2","145999638","145999850","15","17879739"
"chr3","163903266","163903568","chr2","146021158","146021453","28","17882108"
"chr3","163957907","163958179","chr2","146074009","146074295","35","17883898"
"chr3","164133662","164133927","chr2","146254358","146254634","32","17879304"
"chr3","164204540","164204844","chr2","146318006","146318312","22","17886534"
"chr3","164318744","164318863","chr2","146428095","146428205","15","17890649"
"chr3","164384303","164384559","chr2","146494303","146494547","34","17890000"
"chr3","164479983","164480245","chr20","29357836","29358099","55","135122147"
"chr3","164659880","164660187","chr2","135171753","135172056","21","29488127"
"chr3","164785780","164786035","chr2","135037000","135037258","20","29748780"
"chr3","164886520","164886841","chr2","134940132","134940452","28","29946388"
"chr3","164889398","164889682","chr2","134937281","134937565","16","29952117"
"chr3","164958568","164958760","chr11","110757695","110757886","38","54200873"
"chr3","164975556","164975847","chr2","134846876","134847173","25","30128680"
"chr3","164985132","164985437","chr9","8485187","8485494","66","156499945"
"chr3","164996961","164997246","chr2","134825831","134826122","36","30171130"
"chr3","164999529","164999829","chr2","134823266","134823556","29","30176263"
"chr3","165012190","165012318","chr2","134810833","134810950","17","30201357"
"chr3","165034885","165035179","chr2","134790491","134790796","26","30244394"
"chr3","165036070","165036268","chr2","134786136","134786344","23","30249934"
"chr3","165041744","165042037","chr8","125828478","125828772","67","39213266"
"chr3","165052420","165052699","chr2","134772566","134772842","15","30279854"
"chr3","165058334","165058448","chr2","134766849","134766961","6","30291485"
"chr3","165058689","165058983","chr2","134766314","134766608","16","30292375"
"chr3","165082671","165082884","chr2","134742642","134742870","29","30340029"
"chr3","165083190","165083301","chr2","134742218","134742330","20","30340972"
"chr3","165086861","165087129","chr2","134738130","134738405","29","30348731"
"chr3","165100529","165100796","chr2","134723107","134723388","26","30377422"
"chr3","165116032","165116319","chr2","134710774","134711062","20","30405258"
"chr3","165140738","165141056","chr12","74282263","74282578","45","90858475"
"chr3","165145014","165145131","chr5","110659732","110659850","22","54485282"
"chr3","165151324","165151484","chr2","134676304","134676468","17","30475020"
"chr3","165151801","165151948","chr12","74298219","74298365","22","90853582"
"chr3","165199588","165199795","chr5","52884885","52885086","49","112314703"
"chr3","165216662","165216953","chr2","134559812","134560113","33","30656850"
"chr3","165219574","165219772","chr2","134557433","134557651","35","30662141"
"chr3","165239082","165239241","chr2","134536729","134536896","30","30702353"
"chr3","165253312","165253599","chr10","69629356","69629644","54","95623956"
"chr3","165324522","165324631","chr11","109358164","109358269","20","55966358"
"chr3","165332097","165332349","chr2","134437273","134437534","29","30894824"
"chr3","165402017","165402172","chr7","80140173","80140333","35","85261844"
"chr3","165402204","165402318","chr6","126567985","126568100","20","38834219"
"chr3","165425575","165425871","chr2","134360763","134361060","24","31064812"
"chr3","165426833","165427137","chr2","134359504","134359806","18","31067329"
"chr3","165427439","165427628","chr2","134359011","134359216","23","31068428"
"chr3","165451269","165451553","chr2","134334157","134334446","13","31117112"
"chr3","165482601","165482724","chr2","134300572","134300696","7","31182029"
"chr3","165512823","165513120","chr2","134267570","134267843","42","31245253"
"chr3","165515808","165516090","chr2","134264574","134264855","17","31251234"
"chr3","165573829","165574120","chr2","134203713","134203974","44","31370116"
"chr3","165579560","165579666","chr2","134198056","134198162","6","31381504"
"chr3","165619895","165620189","chr2","134159125","134159408","26","31460770"
"chr3","165627317","165627604","chr2","134151792","134152073","32","31475525"
"chr3","165667631","165667912","chr2","134118284","134118549","43","31549347"
"chr3","165695138","165695423","chr2","134090807","134091091","27","31604331"
"chr3","165715155","165715278","chr2","134068469","134068592","7","31646686"
"chr3","165844378","165844655","chr2","133936438","133936709","21","31907940"
"chr3","165847355","165847518","chr2","133933532","133933700","16","31913823"
"chr3","165950914","165951157","chr2","133822338","133822566","33","32128576"
"chr3","165962312","165962616","chr2","133810467","133810784","23","32151845"
"chr3","166041686","166041976","chr2","133731828","133732130","28","32309858"
"chr3","166056181","166056481","chr2","133718211","133718504","21","32337970"
"chr3","166085154","166085448","chr2","133699933","133700227","24","32385221"
"chr3","166091219","166091526","chr2","133694101","133694410","25","32397118"
"chr3","166099380","166099656","chr2","133681102","133681381","17","32418278"
"chr3","166123159","166123284","chr17","19750361","19750492","20","146372798"
"chr3","166141920","166142123","chr2","133642246","133642445","28","32499674"
"chr3","166155569","166155741","chr7","38518431","38518604","58","127637138"
"chr3","166186693","166186970","chr2","133590996","133591264","29","32595697"
"chr3","166188326","166188610","chr2","133589155","133589443","24","32599171"
"chr3","166192198","166192467","chr11","7508963","7509219","71","158683235"
"chr3","166197509","166197820","chr2","133579747","133580058","25","32617762"
"chr3","166219339","166219461","chr2","133545366","133545487","6","32673973"
"chr3","166235776","166236073","chr2","133529072","133529372","18","32706704"
"chr3","166246700","166246987","chr2","133517533","133517795","43","32729167"
"chr3","166248821","166249105","chr2","133515460","133515748","20","32733361"
"chr3","166290994","166291336","chrX","125397782","125398094","83","40893212"
"chr3","166301426","166301593","chr7","151036143","151036301","51","15265283"
"chr3","166301654","166301770","chr6","97599301","97599418","22","68702353"
"chr3","166308738","166309011","chr2","133461935","133462211","25","32846803"
"chr3","166366374","166366595","chr17","59264752","59264980","60","107101622"
"chr3","166366916","166367010","chr2","133403969","133404068","13","32962947"
"chr3","166373435","166373741","chr2","133397249","133397555","18","32976186"
"chr3","166414695","166414989","chr2","133354614","133354908","21","33060081"
"chr3","166433821","166434036","chr2","133330644","133330860","33","33103177"
"chr3","166471071","166471356","chr4","132355932","132356218","59","34115139"
"chr3","166528820","166529118","chr15","17816055","17816351","65","148712765"
"chr3","166807825","166808129","chr1","44516138","44516440","62","122291687"
"chr3","166832784","166833078","chr2","132861168","132861462","16","33971616"
"chr3","167054533","167054819","chr3","39889024","39889309","64","127165509"
"chr3","167092329","167092617","chr7","140100928","140101221","70","26991401"
"chr3","167112804","167113086","chr8","132070386","132070662","71","35042418"
"chr3","167138310","167138603","chr2","132476612","132476930","40","34661698"
"chr3","167161837","167162158","chr13","62500673","62500982","75","104661164"
"chr3","167371864","167372157","chr3","124286205","124286493","68","43085659"
"chr3","167516853","167517117","chr2","132048305","132048565","29","35468548"
"chr3","167684031","167684297","chr15","28498344","28498626","68","139185687"
"chr3","167793369","167793489","chr2","131781588","131781717","17","36011781"
"chr3","167927681","167927961","chr2","131618344","131618634","27","36309337"
"chr3","167931002","167931293","chr2","131613317","131613576","48","36317685"
"chr3","167957198","167957448","chr2","131577580","131577843","49","36379618"
"chr3","168364721","168365005","chrX","16345355","16345638","56","152019366"
"chr3","168595866","168596032","chr14","78815653","78815813","42","89780213"
"chr3","168608283","168608484","chr2","130987091","130987288","19","37621192"
"chr3","168700630","168700835","chr2","130887862","130888042","36","37812768"
"chr3","168713699","168713859","chr2","130861405","130861556","21","37852294"
"chr3","168782996","168783301","chr6","139778709","139779007","70","29004287"
"chr3","168887867","168888165","chr2","130674732","130675021","25","38213135"
"chr3","168910538","168910631","chr2","130646540","130646633","5","38263998"
"chr3","169032879","169032996","chr2","130527482","130527599","4","38505397"
"chr3","169034955","169035200","chr10","17727512","17727764","67","151307443"
"chr3","169294636","169294950","chr2","130242120","130242390","68","39052516"
"chr3","169362537","169362667","chr9","97270771","97270897","22","72091766"
"chr3","169364254","169364545","chr20","10428817","10429108","72","158935437"
"chr3","169571590","169571894","chr2","129951332","129951637","19","39620258"
"chr3","169590097","169590378","chr13","19754334","19754619","62","149835763"
"chr3","169637210","169637291","chr2","129880413","129880490","8","39756797"
"chr3","169664871","169665205","chr2","129836000","129836316","45","39828871"
"chr3","169703756","169704056","chr2","129786408","129786722","39","39917348"
"chr3","169740050","169740159","chr9","34836886","34837001","24","134903164"
"chr3","169926859","169927171","chr2","129551254","129551566","30","40375605"
"chr3","169971110","169971398","chr2","129507835","129508142","49","40463275"
"chr3","169983762","169984029","chr2","129492865","129493164","51","40490897"
"chr3","170046835","170047119","chr2","129386074","129386360","23","40660761"
"chr3","170061976","170062271","chr2","129372882","129373178","21","40689094"
"chr3","170421774","170422028","chr2","129012074","129012323","26","41409700"
"chr3","170426395","170426583","chr2","129007437","129007630","23","41418958"
"chr3","170456280","170456582","chr2","128978005","128978311","23","41478275"
"chr3","170460014","170460186","chr12","58446408","58446587","41","112013606"
"chr3","170496063","170496304","chr12","104726638","104726880","74","65769425"
"chr3","170561947","170562217","chr2","128868007","128868265","38","41693940"
"chr3","170579346","170579659","chr2","128856054","128856353","40","41723292"
"chr3","170591883","170592181","chr2","128840542","128840831","40","41751341"
"chr3","170592599","170592871","chr2","128839852","128840122","27","41752747"
"chr3","170594806","170595091","chr5","42278676","42278963","59","128316130"
"chr3","170640033","170640157","chr2","128787292","128787443","41","41852741"
"chr3","170641049","170641168","chr2","128786340","128786459","9","41854709"
"chr3","170664698","170664998","chr2","128769802","128770095","29","41894896"
"chr3","170896961","170897267","chr2","128515388","128515651","64","42381573"
"chr3","170911994","170912277","chr2","128500671","128500956","25","42411323"
"chr3","171002244","171002362","chr9","99524055","99524177","20","71478189"
"chr3","171017652","171017884","chr3","13343257","13343484","59","157674395"
"chr3","171023349","171023650","chr2","128377728","128378028","29","42645621"
"chr3","171195428","171195731","chr2","128209801","128210109","30","42985627"
"chr3","171288903","171289167","chr2","128085208","128085501","45","43203695"
"chr3","171315421","171315702","chr2","128059582","128059863","46","43255839"
"chr3","171458377","171458652","chr11","28761874","28762145","74","142696503"
"chr3","171688181","171688493","chr9","106607385","106607691","64","65080796"
"chr3","171865836","171865878","chr13","94326792","94326836","10","77539044"
"chr3","171919978","171920260","chr2","127271122","127271397","27","44648856"
"chr3","172087798","172087968","chr2","84278068","84278237","45","87809730"
"chr3","172123468","172123617","chr2","127023760","127023928","33","45099708"
"chr3","172144449","172144573","chr12","51647994","51648115","30","120496455"
"chr3","172144629","172144790","chr16","31064095","31064258","36","141080534"
"chr3","172156200","172156442","chr2","126935930","126936179","24","45220270"
"chr3","172160372","172160672","chr2","126931663","126931967","25","45228709"
"chr3","172182527","172182722","chr1","134600587","134600776","50","37581940"
"chr3","172512166","172512457","chr2","126569368","126569659","28","45942798"
"chr3","172599777","172599811","chr10","14717182","14717216","7","157882595"
"chr3","172599870","172600018","chr14","2894541","2894688","26","169705329"
"chr3","172654868","172654991","chr2","126419092","126419207","19","46235776"
"chr3","172736065","172736363","chr2","126343267","126343566","23","46392798"
"chr3","172770677","172770960","chr2","126307870","126308154","26","46462807"
"chr3","172778385","172778499","chr2","107613237","107613354","22","65165148"
"chr3","172870236","172870542","chr2","126209542","126209847","29","46660694"
"chr3","172912151","172912332","chr7","137325995","137326168","46","35586156"
"chr3","172912379","172912497","chr1","15677639","15677757","20","157234740"
"chr3","172917995","172918297","chr2","126163497","126163806","23","46754498"
"chr3","172924639","172924964","chr2","126156680","126157012","57","46767959"
"chr3","173012570","173012854","chr2","126066521","126066809","23","46946049"
"chr3","173130627","173130909","chr19","14244889","14245186","65","158885738"
"chr3","173245032","173245268","chr2","125787625","125787868","27","47457407"
"chr3","173309479","173309766","chr7","18998141","18998416","66","154311338"
"chr3","173382986","173383226","chr7","131561469","131561715","67","41821517"
"chr3","173394553","173394835","chr2","125624068","125624363","38","47770485"
"chr3","173483214","173483519","chr2","125518381","125518685","25","47964833"
"chr3","173526737","173527049","chr2","125469382","125469679","37","48057355"
"chr3","173541693","173541822","chr2","125454791","125454908","16","48086902"
"chr3","173701832","173702102","chr2","125287294","125287594","49","48414538"
"chr3","173834413","173834711","chr2","125135673","125135968","29","48698740"
"chr3","173882171","173882448","chr2","125085953","125086230","26","48796218"
"chr3","173892099","173892216","chr2","125075117","125075241","14","48816982"
"chr3","173963225","173963529","chr2","124960661","124960964","28","49002564"
"chr3","173986834","173987127","chr2","124941006","124941302","17","49045828"
"chr3","174086720","174086842","chr6","123282486","123282608","22","50804234"
"chr3","174134145","174134450","chr4","18422688","18422991","60","155711457"
"chr3","174174407","174174534","chr2","124754479","124754608","7","49419928"
"chr3","174270416","174270570","chr17","55742460","55742616","35","118527956"
"chr3","174699030","174699249","chr2","124211387","124211602","21","50487643"
"chr3","174740771","174741047","chr2","124168334","124168607","20","50572437"
"chr3","174791016","174791303","chr2","124123182","124123472","18","50667834"
"chr3","174795940","174796222","chr2","124118311","124118617","45","50677629"
"chr3","174844830","174845002","chr14","121786411","121786574","51","53058419"
"chr3","174845448","174845725","chr2","124065270","124065586","54","50780178"
"chr3","174934716","174934826","chr2","123977247","123977360","11","50957469"
"chr3","174970338","174970644","chr2","123939256","123939564","20","51031082"
"chr3","175039031","175039335","chr2","123868534","123868845","35","51170497"
"chr3","175044047","175044314","chr2","123863519","123863788","16","51180528"
"chr3","175057103","175057378","chr3","124634402","124634686","67","50422701"
"chr3","175058538","175058718","chr2","123848815","123848993","11","51209723"
"chr3","175077119","175077418","chr2","123830087","123830363","33","51247032"
"chr3","175079119","175079284","chr2","123828224","123828379","17","51250895"
"chr3","175079574","175079723","chr2","123827793","123827933","26","51251781"
"chr3","175096712","175096838","chr16","71082118","71082250","22","104014594"
"chr3","175111360","175111656","chr2","123796020","123796312","24","51315340"
"chr3","175127020","175127333","chr2","123776075","123776393","18","51350945"
"chr3","175128397","175128514","chr2","123774893","123775010","10","51353504"
"chr3","175326379","175326551","chr2","123713688","123713859","12","51612691"
"chr3","175367173","175367427","chr5","154804174","154804434","57","20562999"
"chr3","175371060","175371343","chr10","37934275","37934551","65","137436785"
"chr3","175378552","175378821","chr10","77333941","77334222","69","98044611"
"chr3","175383319","175383613","chr2","123611975","123612279","31","51771344"
"chr3","175385167","175385281","chr2","123610299","123610420","16","51774868"
"chr3","175398421","175398712","chr2","123598936","123599231","27","51799485"
"chr3","175409106","175409188","chr20","28842142","28842209","25","146566964"
"chr3","175419057","175419256","chr2","123575425","123575619","24","51843632"
"chr3","175424034","175424330","chr4","123481512","123481809","66","51942522"
"chr3","175434075","175434339","chr7","165155519","165155787","68","10278556"
"chr3","175437311","175437577","chr2","123562723","123562989","23","51874588"
"chr3","175441504","175441805","chr2","123557894","123558195","25","51883610"
"chr3","175443818","175443929","chr3","64803018","64803127","16","110640800"
"chr3","175446556","175446710","chr2","123552472","123552626","17","51894084"
"chr3","175446983","175447047","chr8","38780103","38780168","11","136666880"
"chr3","175479775","175480078","chr2","123513736","123514034","19","51966039"
"chr3","175482209","175482493","chr2","123510711","123511011","48","51971498"
"chr3","175499315","175499460","chr2","123495148","123495295","12","52004167"
"chr3","175499795","175499957","chr2","123494687","123494849","10","52005108"
"chr3","175502369","175502523","chr2","123492140","123492316","34","52010229"
"chr3","175502826","175502959","chr2","123491698","123491831","9","52011128"
"chr3","175510249","175510524","chrX","125989015","125989296","62","49521234"
"chr3","175512298","175512563","chr2","123481760","123482010","34","52030538"
"chr3","175515716","175515829","chrX","55418111","55418228","16","120097605"
"chr3","175579755","175580058","chr2","123417745","123418043","30","52162010"
"chr3","175584551","175584837","chr8","33663424","33663692","69","141921127"
"chr3","175590159","175590468","chr11","117366311","117366614","66","58223848"
"chr3","175603986","175604215","chr1","213911110","213911337","42","38307124"
"chr3","175608179","175608483","chr2","123397353","123397652","29","52210826"
"chr3","175613652","175613888","chr2","123391721","123391964","23","52221931"
"chr3","175616651","175616922","chr2","123388581","123388838","35","52228070"
"chr3","175619222","175619506","chr1","53106748","53107031","59","122512474"
"chr3","175659129","175659396","chr7","116661654","116661930","63","58997475"
"chr3","175718278","175718625","chr2","123288578","123288895","64","52429700"
"chr3","175742946","175743231","chr2","123263760","123264045","31","52479186"
"chr3","175811913","175812226","chr2","94102170","94102477","61","81709743"
"chr3","175832559","175832678","chr19","43315276","43315398","20","132517283"
"chr3","175908614","175908922","chr2","123116155","123116464","27","52792459"
"chr3","175985467","175985758","chr2","123022374","123022672","28","52963093"
"chr3","176015405","176015668","chr7","18063810","18064080","59","157951595"
"chr3","176046909","176047031","chr2","122965111","122965231","14","53081798"
"chr3","176051045","176051359","chr2","122960749","122961067","31","53090296"
"chr3","176055459","176055749","chr2","122955799","122956091","30","53099660"
"chr3","176078002","176078285","chr16","50207346","50207637","68","125870656"
"chr3","176091648","176091891","chr2","122927078","122927327","50","53164570"
"chr3","176182448","176182751","chr19","16469674","16469960","61","159712774"
"chr3","176213198","176213329","chr2","122812160","122812279","23","53401038"
"chr3","176222904","176223215","chr2","122802378","122802659","60","53420526"
"chr3","176232238","176232515","chr14","68590922","68591186","58","107641316"
"chr3","176303527","176303810","chr2","122720662","122720956","29","53582865"
"chr3","176356984","176357278","chr2","122664478","122664783","34","53692506"
"chr3","176362746","176363041","chr2","122657386","122657672","28","53705360"
"chr3","176400168","176400450","chr2","122613431","122613711","21","53786737"
"chr3","176429647","176429932","chr2","122582738","122583037","40","53846909"
"chr3","176484880","176485024","chr2","122529450","122529595","7","53955430"
"chr3","176485336","176485506","chr2","122528991","122529140","26","53956345"
"chr3","176509912","176510239","chr2","122504924","122505236","35","54004988"
"chr3","176602019","176602248","chr2","122412756","122412979","23","54189263"
"chr3","176621279","176621572","chr2","122395469","122395776","35","54225810"
"chr3","176625318","176625630","chr2","122391371","122391682","24","54233947"
"chr3","176634400","176634694","chr7","55740891","55741181","61","120893509"
"chr3","176645968","176646268","chr2","122370239","122370543","18","54275729"
"chr3","176655128","176655305","chr18","9795354","9795521","55","166859774"
"chr3","176655331","176655440","chr1","38149410","38149513","32","138505921"
"chr3","176658295","176658614","chr2","122357514","122357804","42","54300781"
"chr3","176666914","176667033","chr2","122348768","122348887","9","54318146"
"chr3","176675299","176675603","chr1","136053595","136053894","71","40621704"
"chr3","176686822","176686923","chr2","74636905","74637003","18","102049917"
"chr3","176712060","176712375","chr2","122304176","122304458","46","54407884"
"chr3","176732257","176732553","chr2","122284076","122284379","37","54448181"
"chr3","176802002","176802239","chr2","122209229","122209469","15","54592773"
"chr3","176803080","176803379","chr7","152324849","152325144","61","24478231"
"chr3","176845418","176845706","chr2","122174421","122174696","40","54670997"
"chr3","176879585","176879861","chr2","122138379","122138670","32","54741206"
"chr3","176892443","176892723","chr2","122125257","122125547","33","54767186"
"chr3","176924923","176925227","chr2","122090450","122090753","27","54834473"
"chr3","176953788","176954028","chrUn_NW_014807824v1","497","732","49","176953291"
"chr3","177025416","177025539","chr2","121992618","121992745","13","55032798"
"chr3","177120238","177120556","chr1","118159509","118159803","76","58960729"
"chr3","177164248","177164539","chr2","121845948","121846237","26","55318300"
"chr3","177210617","177210904","chr2","121798536","121798819","17","55412081"
"chr3","177220110","177220397","chr2","121788357","121788646","18","55431753"
"chr3","177228159","177228413","chr1","44248959","44249223","58","132979200"
"chr3","177236251","177236559","chr2","121770721","121771029","17","55465530"
"chr3","177274107","177274399","chr2","121732708","121732994","24","55541399"
"chr3","177276035","177276330","chr2","121730788","121731081","21","55545247"
"chr3","177282744","177283052","chr2","121724018","121724318","33","55558726"
"chr3","177283500","177283609","chr9","102576871","102576979","17","74706629"
"chr3","177312445","177312731","chr2","121695006","121695292","12","55617439"
"chr3","177326743","177327026","chr2","121680965","121681261","28","55645778"
"chr3","177352279","177352579","chr2","121654705","121655012","28","55697574"
"chr3","177386488","177386752","chr2","121620496","121620749","33","55765992"
"chr3","177389119","177389419","chr2","121617848","121618149","16","55771271"
"chr3","177400333","177400633","chr2","121606401","121606718","51","55793932"
"chr3","177406363","177406662","chr2","121600461","121600755","22","55805902"
"chr3","177415160","177415391","chr2","121591755","121591986","17","55823405"
"chr3","177452503","177452763","chr20","10574376","10574643","60","166878127"
"chr3","177459105","177459408","chr2","121546665","121546943","65","55912440"
"chr3","177497645","177497791","chr2","121508371","121508515","8","55989274"
"chr3","177527656","177527918","chr2","121477900","121478163","14","56049756"
"chr3","177551692","177551891","chr2","121454135","121454335","10","56097557"
"chr3","177557986","177558197","chr2","121447533","121447751","16","56110453"
"chr3","177645422","177645709","chr2","121358743","121359032","26","56286679"
"chr3","177668161","177668294","chr17","19750361","19750492","24","157917800"
"chr3","177760453","177760642","chr2","121218054","121218239","18","56542399"
"chr3","177808339","177808510","chr2","121164792","121164963","12","56643547"
"chr3","177882062","177882318","chr18","46707244","46707501","59","131174818"
"chr3","177888690","177888934","chr2","121074863","121075114","22","56813827"
"chr3","177893366","177893462","chr2","121070382","121070477","9","56822984"
"chr3","177932044","177932355","chr2","121030572","121030850","60","56901472"
"chr3","177940555","177940834","chr5","169061750","169062024","56","8878805"
"chr3","177961418","177961721","chr2","121000189","121000495","23","56961229"
"chr3","177966522","177966812","chr1","8665723","8666021","56","169300799"
"chr3","177971048","177971175","chr2","120990680","120990808","7","56980368"
"chr3","177990738","177991049","chr10","34111011","34111315","79","143879727"
"chr3","178053008","178053295","chr2","120905881","120906166","27","57147127"
"chr3","178053513","178053820","chr2","120905342","120905659","40","57148171"
"chr3","178120764","178121081","chr2","120838791","120839091","40","57281973"
"chr3","178137971","178138282","chr2","55049181","55049491","56","123088790"
"chr3","178157457","178157523","chr5","39638037","39638096","24","138519420"
"chr3","178201221","178201558","chr2","120710487","120710823","25","57490734"
"chr3","178309649","178309947","chr2","120600409","120600711","33","57709240"
"chr3","178489870","178490001","chr2","120415964","120416095","11","58073906"
"chr3","178536071","178536334","chr2","120358325","120358588","17","58177746"
"chr3","178678702","178679002","chr2","120218998","120219313","39","58459704"
"chr3","178761247","178761563","chr1","44108287","44108597","77","134652960"
"chr3","178780691","178780963","chr2","120126266","120126526","33","58654425"
"chr3","178925227","178925537","chr2","119923100","119923388","43","59002127"
"chr3","178939766","178940069","chr2","119908781","119909086","19","59030985"
"chr3","178952155","178952420","chr2","119895166","119895430","13","59056989"
"chr3","179036829","179037141","chr9","106337730","106338042","74","72699099"
"chr3","179055311","179055617","chr7","56163436","56163743","62","122891875"
"chr3","179110459","179110664","chr2","119730477","119730677","16","59379982"
"chr3","179146675","179146961","chr3","39968575","39968860","57","139178100"
"chr3","179157255","179157578","chr2","119679941","119680223","59","59477314"
"chr3","179199554","179199867","chr2","119636787","119637098","27","59562767"
"chr3","179277606","179277901","chr10","47303639","47303937","63","131973967"
"chr3","179575147","179575271","chr3","182536047","182536170","24","2960900"
"chr3","179627137","179627258","chr2","86592018","86592137","15","93035119"
"chr3","179749976","179750144","chr2","119060253","119060421","10","60689723"
"chr3","179750417","179750680","chr2","119059715","119059979","46","60690702"
"chr3","179752591","179752874","chr2","119057837","119058124","56","60694754"
"chr3","179772919","179773237","chr7","19915766","19916078","67","159857153"
"chr3","179784821","179785118","chr2","119016513","119016815","31","60768308"
"chr3","179871698","179871978","chr2","118928642","118928926","38","60943056"
"chr3","179931468","179931663","chr2","118861003","118861225","41","61070465"
"chr3","180047585","180047890","chr2","118732778","118733083","16","61314807"
"chr3","180058127","180058323","chr12","100347342","100347542","42","79710785"
"chr3","180104278","180104568","chr9","62091948","62092235","60","118012330"
"chr3","180150837","180151114","chr2","118616115","118616416","56","61534722"
"chr3","180231757","180231890","chr16","48623345","48623480","33","131608412"
"chr3","180236616","180236914","chr2","118533818","118534114","27","61702798"
"chr3","180408271","180408579","chr2","118354122","118354444","39","62054149"
"chr3","180459530","180459799","chr2","118260244","118260518","27","62199286"
"chr3","180512785","180513088","chr2","118199249","118199533","45","62313536"
"chr3","180556113","180556336","chr2","118149989","118150212","22","62406124"
"chr3","180580207","180580482","chr2","118126938","118127208","25","62453269"
"chr3","180647551","180647842","chr12","58206794","58207084","66","122440757"
"chr3","180680471","180680755","chr2","118034188","118034472","19","62646283"
"chr3","180689281","180689589","chr2","118025659","118025958","52","62663622"
"chr3","180743810","180744117","chr2","117974318","117974625","23","62769492"
"chr3","180916024","180916321","chr2","117766076","117766359","30","63149948"
"chr3","180947970","180948046","chr2","204116012","204116079","22","23168042"
"chr3","180979559","180979836","chr2","117703551","117703847","40","63276008"
"chr3","181040298","181040536","chr2","70698006","70698233","68","110342292"
"chr3","181084243","181084351","chr2","117608003","117608111","10","63476240"
"chr3","181219207","181219516","chr2","117477635","117477934","36","63741572"
"chr3","181340412","181340555","chr10","54508670","54508810","37","126831742"
"chr3","181552794","181552830","chr11","50681577","50681611","10","130871217"
"chr3","181573811","181574093","chr15","62839651","62839929","64","118734160"
"chr3","181577356","181577650","chr2","117079574","117079856","60","64497782"
"chr3","181799242","181799538","chr2","116890335","116890636","35","64908907"
"chr3","181856313","181856605","chr2","116809342","116809631","27","65046971"
"chr3","181949621","181949913","chr2","160551205","160551504","61","21398416"
"chr3","182132493","182132788","chr2","116534676","116534973","15","65597817"
"chr3","182216695","182216971","chr2","116445746","116446021","35","65770949"
"chr3","182230184","182230480","chr2","116431793","116432091","24","65798391"
"chr3","182236321","182236604","chr2","116425606","116425885","39","65810715"
"chr3","182253576","182253867","chr2","116402071","116402367","25","65851505"
"chr3","182308297","182308596","chr2","116349959","116350246","36","65958338"
"chr3","182311654","182311934","chr10","15425474","15425763","63","166886180"
"chr3","182320645","182320787","chr1","142183123","142183260","23","40137522"
"chr3","182419389","182419704","chr2","116226408","116226717","29","66192981"
"chr3","182435538","182435601","chr6","111070219","111070279","21","71365319"
"chr3","182437219","182437351","chr10","82790381","82790500","41","99646838"
"chr3","182458049","182458300","chr2","116189075","116189326","12","66268974"
"chr3","182462822","182463058","chr2","116182960","116183194","23","66279862"
"chr3","182466458","182466773","chr2","116179271","116179555","53","66287187"
"chr3","182476052","182476321","chr7","100497798","100498066","62","81978254"
"chr3","182488926","182489045","chr15","32071444","32071573","25","150417482"
"chr3","182491579","182491877","chr2","116151751","116152054","27","66339828"
"chr3","182492521","182492833","chr2","116150796","116151100","31","66341725"
"chr3","182498301","182498417","chr2","116144235","116144359","15","66354066"
"chr3","182547856","182548166","chr2","116093380","116093673","30","66454476"
"chr3","182595681","182595921","chr3","177981712","177981951","58","4613969"
"chr3","182688446","182688541","chrX","89867784","89867880","19","92820662"
"chr3","182693127","182693447","chr2","115942477","115942801","32","66750650"
"chr3","182728878","182729188","chr2","105342245","105342550","58","77386633"
"chr3","182896882","182897131","chr2","115745396","115745640","21","67151486"
"chr3","183051269","183051550","chr2","115581001","115581290","32","67470268"
"chr3","183105208","183105513","chr14","12540994","12541290","57","170564214"
"chr3","183128380","183128676","chr2","115443388","115443671","42","67684992"
"chr3","183224023","183224291","chr2","115284300","115284543","38","67939723"
"chr3","183262667","183262948","chr2","115247462","115247761","43","68015205"
"chr3","183520394","183520605","chr2","114987692","114987903","14","68532702"
"chr3","183872343","183872654","chr2","114615583","114615897","30","69256760"
"chr3","184034380","184034673","chr2","114456196","114456499","37","69578184"
"chr3","184078744","184078935","chr2","114410634","114410805","39","69668110"
"chr3","184128997","184129301","chr12","101551391","101551692","54","82577606"
"chr3","184195812","184196024","chr3","170352684","170352881","47","13843128"
"chr3","184197354","184197659","chr2","114299282","114299581","35","69898072"
"chr3","184331526","184331794","chr2","114154426","114154724","54","70177100"
"chr3","184335330","184335543","chr2","114149767","114149974","21","70185563"
"chr3","184350928","184351218","chr10","77425876","77426160","63","106925052"
"chr3","184373145","184373307","chr6","120560577","120560745","40","63812568"
"chr3","184410913","184411067","chr2","114071429","114071584","25","70339484"
"chr3","184436002","184436295","chr2","114045670","114045971","24","70390332"
"chr3","184505341","184505632","chr2","113961290","113961559","48","70544051"
"chr3","184513214","184513587","chr2","113952506","113952823","78","70560708"
"chr3","184535100","184535338","chr2","113929509","113929717","36","70605591"
"chr3","184537189","184537463","chr2","113927374","113927648","21","70609815"
"chr3","184539951","184540237","chr2","113924612","113924886","29","70615339"
"chr3","184546714","184547060","chr7","156293614","156293920","89","28253100"
"chr3","184551525","184551883","chr2","113915234","113915586","47","70636291"
"chr3","184588457","184588718","chr2","113879010","113879271","25","70709447"
"chr3","184600769","184600893","chr2","113867360","113867484","9","70733409"
"chr3","184629288","184629576","chr2","113836618","113836904","24","70792670"
"chr3","184635156","184635439","chr2","113830757","113831045","20","70804399"
"chr3","184642427","184642728","chr2","113821208","113821511","26","70821219"
"chr3","184647279","184647577","chr2","113816588","113816887","22","70830691"
"chr3","184668368","184668500","chr17","8231938","8232067","25","176436430"
"chr3","184670762","184671045","chr2","113790546","113790830","20","70880216"
"chr3","184692302","184692568","chr2","113768704","113768991","41","70923598"
"chr3","184705373","184705659","chr2","51636973","51637269","71","133068400"
"chr3","184710774","184710890","chr3","40677607","40677724","18","144033167"
"chr3","184712446","184712739","chr2","113745072","113745364","21","70967374"
"chr3","184732809","184733069","chr2","113727475","113727771","54","71005334"
"chr3","184733452","184733759","chr2","113726813","113727099","40","71006639"
"chr3","184742331","184742637","chr8","42028450","42028738","75","142713881"
"chr3","184744701","184744996","chr2","113715282","113715574","21","71029419"
"chr3","184746593","184746884","chr2","113713566","113713871","37","71033027"
"chr3","184763648","184763949","chr2","113696644","113696949","42","71067004"
"chr3","184772229","184772437","chrX","101243574","101243780","53","83528655"
"chr3","184782467","184782735","chr2","113667966","113668241","20","71114501"
"chr3","184790172","184790442","chr2","44461738","44462025","65","140328434"
"chr3","184835937","184836066","chr9","23175282","23175405","24","161660655"
"chr3","184889153","184889437","chr2","113540400","113540694","26","71348753"
"chr3","184917706","184918026","chr2","113505653","113505973","20","71412053"
"chr3","184926737","184926922","chr1","221237138","221237313","43","36310401"
"chr3","184927768","184928044","chr2","113498567","113498842","25","71429201"
"chr3","184934975","184935270","chr2","113491126","113491422","16","71443849"
"chr3","185032378","185032643","chr2","113388517","113388772","36","71643861"
"chr3","185046198","185046457","chr2","113374834","113375083","47","71671364"
"chr3","185075865","185076151","chr2","113343851","113344133","23","71732014"
"chr3","185081206","185081465","chr2","113338532","113338790","28","71742674"
"chr3","185087141","185087465","chr2","113332502","113332829","26","71754639"
"chr3","185101544","185101854","chr1","137753621","137753923","36","47347923"
"chr3","185173206","185173509","chr16","57556315","57556618","57","127616891"
"chr3","185188656","185188956","chr8","71415791","71416092","63","113772865"
"chr3","185203621","185203811","chr2","113219589","113219770","25","71984032"
"chr3","185204118","185204237","chr2","113219162","113219285","20","71984956"
"chr3","185242728","185243036","chr1","123516248","123516553","62","61726480"
"chr3","185480454","185480665","chr2","112937789","112938019","40","72542665"
"chr3","185498704","185498814","chr2","112918506","112918616","7","72580198"
"chr3","185789948","185790260","chr3","43051094","43051395","66","142738854"
"chr3","185811727","185811995","chr2","112585819","112586068","56","73225908"
"chr3","185877439","185877521","chr2","149846640","149846738","30","36030799"
"chr3","185896458","185896740","chr2","112501003","112501305","37","73395455"
"chr3","185901669","185901995","chr2","112495733","112496034","48","73405936"
"chr3","186036954","186037205","chr13","20032006","20032252","67","166004948"
"chr3","186052332","186052626","chr2","112293803","112294092","27","73758529"
"chr3","186064691","186064952","chr1","44703053","44703293","58","141361638"
"chr3","186078310","186078606","chr18","36205933","36206221","64","149872377"
"chr3","186099043","186099269","chr2","112239164","112239384","17","73859879"
"chr3","186125212","186125343","chr13","70830779","70830910","20","115294433"
"chr3","186157577","186157874","chr2","112177276","112177572","16","73980301"
"chr3","186159460","186159777","chr2","112175039","112175334","54","73984421"
"chr3","186167655","186167971","chr2","112164367","112164669","40","74003288"
"chr3","186203350","186203651","chr2","112129111","112129413","25","74074239"
"chr3","186226711","186226991","chr2","112105336","112105616","14","74121375"
"chr3","186236649","186236943","chr2","112089874","112090164","23","74146775"
"chr3","186255016","186255313","chr2","112072015","112072314","29","74183001"
"chr3","186320049","186320349","chr2","112003980","112004291","25","74316069"
"chr3","186360179","186360305","chr2","111956973","111957098","8","74403206"
"chr3","186467434","186467640","chr2","111853322","111853528","20","74614112"
"chr3","186549155","186549478","chr2","97039137","97039445","65","89510018"
"chr3","186549580","186549690","chr14","99484777","99484882","19","87064803"
"chr3","186553103","186553398","chr2","111763156","111763438","42","74789947"
"chr3","186578790","186579099","chr2","111686273","111686574","28","74892517"
"chr3","186650731","186651039","chr2","111613196","111613501","43","75037535"
"chr3","186657811","186657928","chr2","111606052","111606172","15","75051759"
"chr3","186734175","186734294","chr2","111528079","111528188","13","75206096"
"chr3","186781372","186781667","chr2","111481776","111482085","41","75299596"
"chr3","186855484","186855777","chr7","165716105","165716404","50","21139379"
"chr3","186885591","186885723","chr3","39810823","39810958","21","147074768"
"chr3","186886777","186886888","chr8","101968472","101968583","19","84918305"
"chr3","186979772","186980092","chr2","111287780","111288098","26","75691992"
"chr3","186999103","186999276","chr9","115643015","115643187","45","71356088"
"chr3","186999539","186999668","chr1","155846166","155846296","22","31153373"
"chr3","187006375","187006466","chrX","128420096","128420196","22","58586279"
"chr3","187014964","187015091","chr2","111251333","111251450","17","75763631"
"chr3","187029680","187029946","chr2","111237843","111238121","33","75791837"
"chr3","187038653","187038849","chr3","22427999","22428183","48","164610654"
"chr3","187040647","187040764","chr10","73437346","73437460","17","113603301"
"chr3","187041152","187041242","chr1","16674594","16674681","15","170366558"
"chr3","187042609","187042816","chr2","111232211","111232432","30","75810398"
"chr3","187052798","187053088","chr2","111224139","111224429","17","75828659"
"chr3","187056233","187056523","chr2","111220364","111220644","26","75835869"
"chr3","187059427","187059722","chr2","111217153","111217449","16","75842274"
"chr3","187090125","187090248","chr2","111185275","111185396","14","75904850"
"chr3","187093216","187093504","chr2","111181449","111181737","22","75911767"
"chr3","187095742","187096068","chr2","111178253","111178567","39","75917489"
"chr3","187103612","187103747","chr2","111168651","111168786","9","75934961"
"chr3","187104135","187104247","chr3","39517170","39517285","18","147586965"
"chr3","187104539","187104637","chr19","34337353","34337449","33","152767186"
"chr3","187164127","187164306","chr7","150438122","150438297","35","36726005"
"chr3","187396833","187397122","chr7","152260696","152260990","71","35136137"
"chr3","187398243","187398359","chr20","31966306","31966423","16","155431937"
"chr3","187403756","187404113","chr2","110866899","110867257","34","76536857"
"chr3","187575371","187575652","chr2","110694129","110694413","23","76881242"
"chr3","187626888","187627040","chr1","126946987","126947135","36","60679901"
"chr3","187869846","187870130","chr2","110394336","110394619","28","77475510"
"chr3","187870610","187870892","chr2","84207115","84207392","52","103663495"
"chr3","187897373","187897653","chr2","110366048","110366331","24","77531325"
"chr3","187904507","187904811","chr2","110358802","110359107","25","77545705"
"chr3","187982351","187982657","chr2","110309471","110309784","23","77672880"
"chr3","187986051","187986184","chr2","110305940","110306073","6","77680111"
"chr3","188000249","188000447","chr2","110293322","110293520","20","77706927"
"chr3","188002132","188002440","chr2","110291774","110292080","24","77710358"
"chr3","188081130","188081420","chr1","29831558","29831858","64","158249572"
"chr3","188112070","188112369","chr2","110171897","110172196","14","77940173"
"chr3","188126583","188126876","chr2","110157619","110157914","15","77968964"
"chr3","188136770","188137053","chr11","56768327","56768617","66","131368443"
"chr3","188151434","188151741","chr3","12967210","12967514","54","175184224"
"chr3","188159305","188159605","chr2","110118181","110118472","24","78041124"
"chr3","188171975","188172287","chr2","110105367","110105674","25","78066608"
"chr3","188173277","188173607","chr2","110104053","110104369","28","78069224"
"chr3","188180355","188180646","chr2","110097342","110097637","27","78083013"
"chr3","188203260","188203538","chr2","110075689","110075968","15","78127571"
"chr3","188210322","188210633","chr2","110068095","110068407","29","78142227"
"chr3","188211355","188211646","chr2","110067086","110067380","40","78144269"
"chr3","188213984","188214285","chr2","110064455","110064748","31","78149529"
"chr3","188233082","188233214","chr2","110045896","110046028","5","78187186"
"chr3","188251030","188251261","chr2","110027606","110027820","30","78223424"
"chr3","188254369","188254662","chr1","13605985","13606264","72","174648384"
"chr3","188256870","188257167","chr2","110022065","110022363","17","78234805"
"chr3","188272577","188272745","chr2","110006174","110006339","13","78266403"
"chr3","188272746","188273037","chr2","110005881","110006173","41","78266865"
"chr3","188273038","188273172","chr2","110005741","110005880","12","78267297"
"chr3","188283558","188283859","chr2","109994677","109994988","28","78288881"
"chr3","188285496","188285767","chr2","109992729","109992998","18","78292767"
"chr3","188298092","188298352","chr12","48189740","48190002","67","140108352"
"chr3","188313735","188313875","chr2","109959484","109959621","8","78354251"
"chr3","188314170","188314228","chr3","43494524","43494577","18","144819646"
"chr3","188314507","188314651","chr10","25262259","25262399","41","163052248"
"chr3","188317654","188317947","chr2","109956281","109956578","30","78361373"
"chr3","188319702","188320009","chr2","109950309","109950608","37","78369393"
"chr3","188326333","188326538","chr2","109943688","109943901","26","78382645"
"chr3","188327745","188328026","chr2","109942235","109942515","20","78385510"
"chr3","188329243","188329440","chr5","2023599","2023790","31","186305644"
"chr3","188343681","188343952","chr20","29357836","29358099","58","158985845"
"chr3","188348282","188348571","chr2","109919678","109919956","29","78428604"
"chr3","188351116","188351340","chr2","109916970","109917181","26","78434146"
"chr3","188364730","188365027","chr20","28651476","28651780","60","159713254"
"chr3","188371910","188372029","chr2","109893909","109894030","13","78478001"
"chr3","188393483","188393656","chr2","109876790","109876984","37","78516693"
"chr3","188393945","188394070","chr2","109876400","109876528","8","78517545"
"chr3","188480022","188480344","chr2","109791988","109792310","19","78688034"
"chr3","188514181","188514320","chr2","109757502","109757641","6","78756679"
"chr3","188514613","188514783","chr2","109757031","109757204","20","78757582"
"chr3","188528271","188528577","chr2","109743491","109743789","36","78784780"
"chr3","188534704","188535027","chr2","109737266","109737578","30","78797438"
"chr3","188548487","188548696","chr2","109725252","109725457","23","78823235"
"chr3","188563164","188563460","chr14","115049792","115050083","62","73513372"
"chr3","188567908","188568075","chr12","96011333","96011499","42","92556575"
"chr3","188595081","188595351","chr2","109672107","109672366","31","78922974"
"chr3","188625894","188626007","chr6","152802412","152802524","22","35823482"
"chr3","188671324","188671613","chr2","109582070","109582367","39","79089254"
"chr3","188711160","188711467","chr19","9536897","9537199","51","179174263"
"chr3","188719866","188720179","chr16","439527","439836","54","188280339"
"chr3","188724220","188724526","chr14","32393582","32393886","64","156330638"
"chr3","188780635","188780931","chr2","109468253","109468545","19","79312382"
"chr3","188792836","188793148","chr2","109454493","109454783","44","79338343"
"chr3","188802520","188802826","chr2","109444726","109445016","47","79357794"
"chr3","188852189","188852460","chr12","45481312","45481585","59","143370877"
"chr3","188854242","188854530","chr2","109397303","109397593","15","79456939"
"chr3","188865497","188865802","chr1","121643407","121643710","74","67222090"
"chr3","188880115","188880237","chr2","109370745","109370864","9","79509370"
"chr3","188889692","188889948","chr2","109360718","109360978","15","79528974"
"chr3","188891573","188891873","chr2","109359124","109359414","29","79532449"
"chr3","188895573","188895863","chr11","124404546","124404835","51","64491027"
"chr3","188898324","188898408","chr5","183641899","183641981","15","5256425"
"chr3","188907023","188907320","chr2","109344650","109344943","20","79562373"
"chr3","188914161","188914442","chr2","109337569","109337846","20","79576592"
"chr3","188934085","188934201","chr2","109318429","109318547","14","79615656"
"chr3","188938550","188938818","chr2","109313250","109313511","24","79625300"
"chr3","188985596","188985803","chr14","67233376","67233585","46","121752220"
"chr3","188988713","188988783","chr2","203428160","203428221","22","14439447"
"chr3","188989087","188989258","chr10","14457055","14457230","26","174532032"
"chr3","188998843","188999022","chr20","59734438","59734614","41","129264405"
"chr3","189008011","189008309","chr4","16014780","16015077","56","172993231"
"chr3","189055561","189055639","chr14","64982678","64982756","10","124072883"
"chr3","189068003","189068303","chr2","109188920","109189222","23","79879083"
"chr3","189177842","189178117","chr7","18063810","18064080","50","171114032"
"chr3","189193771","189193949","chr2","109067774","109067916","40","80125997"
"chr3","189199333","189199628","chr5","139756441","139756723","52","49442892"
"chr3","189202495","189202794","chr2","109059223","109059517","34","80143272"
"chr3","189211370","189211490","chr2","109050128","109050255","14","80161242"
"chr3","189247125","189247365","chr2","109014458","109014700","11","80232667"
"chr3","189280728","189281009","chr2","108974420","108974701","17","80306308"
"chr3","189288506","189288792","chr2","108962853","108963132","30","80325653"
"chr3","189297176","189297477","chr2","108954834","108955131","21","80342342"
"chr3","189298580","189298870","chr2","108953396","108953699","27","80345184"
"chr3","189626915","189627220","chr7","135565735","135566041","61","54061180"
"chr3","189642699","189642823","chr1","18100775","18100899","18","171541924"
"chr3","189646659","189646772","chr1","31175608","31175721","16","158471051"
"chr3","189667470","189667762","chr2","108901115","108901407","26","80766355"
"chr3","189676827","189677124","chr4","6937789","6938091","58","182739038"
"chr3","189680703","189680992","chr2","108888321","108888615","21","80792382"
"chr3","189702529","189702631","chr6","60336764","60336862","27","129365765"
"chr3","189715412","189715673","chr2","108853457","108853728","31","80861955"
"chr3","189727322","189727618","chr3","50156881","50157167","70","139570441"
"chr3","189734649","189734954","chr2","108832897","108833196","18","80901752"
"chr3","189738860","189739178","chr3","130342599","130342889","84","59396261"
"chr3","189781655","189781947","chr2","108787207","108787497","42","80994448"
"chr3","189788787","189789054","chr2","108778821","108779096","21","81009966"
"chr3","189790857","189791130","chr2","108776725","108777004","25","81014132"
"chr3","189837336","189837434","chr2","108728140","108728248","15","81109196"
"chr3","189884781","189885087","chr2","108679544","108679865","49","81205237"
"chr3","189909027","189909143","chr3","154492120","154492234","13","35416907"
"chr3","189921616","189921918","chr6","77350758","77351050","58","112570858"
"chr3","189947647","189947941","chr2","108613465","108613769","30","81334182"
"chr3","189975496","189975647","chr2","108581905","108582052","12","81393591"
"chr3","190043705","190044020","chr2","108510842","108511122","56","81532863"
"chr3","190057394","190057501","chr8","99162253","99162359","16","90895141"
"chr3","190129641","190129855","chr2","108423961","108424175","16","81705680"
"chr3","190177667","190177960","chr2","108376921","108377210","19","81800746"
"chr3","190216466","190216767","chr2","108338002","108338311","27","81878464"
"chr3","190292091","190292340","chr2","108261030","108261269","42","82031061"
"chr3","190322335","190322646","chr6","175445928","175446233","62","14876407"
"chr3","190342659","190342913","chr2","108210643","108210913","27","82132016"
"chr3","190348926","190349060","chr2","108204200","108204334","9","82144726"
"chr3","190387259","190387486","chr2","108165262","108165473","42","82221997"
"chr3","190404484","190404793","chr2","97039137","97039445","57","93365347"
"chr3","190420889","190421175","chr2","108134181","108134458","28","82286708"
"chr3","190511219","190511501","chr2","108037792","108038063","31","82473427"
"chr3","190648955","190649236","chr7","41643486","41643768","52","149005469"
"chr3","190680896","190681193","chr2","107868238","107868538","29","82812658"
"chr3","190682600","190682907","chr17","80429135","80429431","57","110253465"
"chr3","190705923","190706049","chr2","107844001","107844127","5","82861922"
"chr3","190708979","190709120","chr2","107840936","107841075","8","82868043"
"chr3","190709453","190709617","chr2","107840465","107840633","9","82868988"
"chr3","190808767","190809052","chr2","107726204","107726503","26","83082563"
"chr3","190926388","190926505","chr2","107613237","107613354","7","83313151"
"chr3","190962145","190962442","chr2","107579102","107579392","37","83383043"
"chr3","190991985","190992288","chr2","107549137","107549423","38","83442848"
"chr3","190998007","190998279","chr2","107543141","107543419","22","83454866"
"chr3","191013514","191013637","chr2","107527247","107527370","8","83486267"
"chr3","191036568","191036686","chr6","161562285","161562399","25","29474283"
"chr3","191055453","191055563","chr2","107471601","107471723","23","83583852"
"chr3","191056056","191056289","chr2","72472536","72472761","90","118583520"
"chr3","191059658","191059818","chr10","92151646","92151800","40","98908012"
"chr3","191065979","191066282","chr2","107461011","107461314","14","83604968"
"chr3","191092222","191092496","chr2","107434633","107434920","39","83657589"
"chr3","191113706","191114002","chr2","107411533","107411833","22","83702173"
"chr3","191119654","191119939","chr2","107405677","107405993","52","83713977"
"chr3","191119949","191120265","chr2","107405345","107405662","28","83714604"
"chr3","191157053","191157323","chr15","50027179","50027439","64","141129874"
"chr3","191178871","191178991","chr2","107347460","107347580","13","83831411"
"chr3","191183887","191184176","chr19","13383545","13383836","59","177800342"
"chr3","191219762","191219953","chr6","67303922","67304099","49","123915840"
"chr3","191223408","191223687","chr2","107303478","107303749","27","83919930"
"chr3","191253493","191253790","chr2","107271635","107271936","20","83981858"
"chr3","191265807","191266119","chr2","107257929","107258237","32","84007878"
"chr3","191266300","191266594","chr2","107257457","107257748","37","84008843"
"chr3","191267498","191267802","chr2","107256248","107256545","25","84011250"
"chr3","191272735","191273043","chr2","107251033","107251336","31","84021702"
"chr3","191282373","191282635","chr2","113667966","113668241","70","77614407"
"chr3","191285062","191285338","chr2","107186756","107187046","31","84098306"
"chr3","191325877","191326121","chr2","107144026","107144286","33","84181851"
"chr3","191328575","191328857","chr13","25090593","25090872","60","166237982"
"chr3","191336245","191336542","chr2","107132948","107133251","29","84203297"
"chr3","191338922","191339216","chr1","25260013","25260308","57","166078909"
"chr3","191340486","191340602","chr2","107129077","107129196","10","84211409"
"chr3","191361197","191361387","chr2","107085637","107085815","37","84275560"
"chr3","191394815","191395119","chr10","1679485","1679794","67","189715330"
"chr3","191396032","191396355","chr2","107044358","107044686","26","84351674"
"chr3","191422502","191422793","chr1","211215809","211216098","58","19793307"
"chr3","191443882","191444019","chr1","155846166","155846296","23","35597716"
"chr3","191470434","191470749","chr2","106971959","106972280","21","84498475"
"chr3","191479735","191480004","chr1","5819632","5819900","54","185660103"
"chr3","191480020","191480335","chr2","106961626","106961923","41","84518394"
"chr3","191516967","191517305","chr3","143007352","143007697","97","48509615"
"chr3","191528530","191528707","chr2","106903675","106903850","17","84624855"
"chr3","191591909","191592208","chr2","106839656","106839965","32","84752253"
"chr3","191596374","191596468","chrX","41466806","41466903","19","150129568"
"chr3","191662459","191662737","chr2","106771075","106771353","31","84891384"
"chr3","191826184","191826519","chr2","106607387","106607708","38","85218797"
"chr3","191869228","191869472","chr12","20398878","20399109","59","171470350"
"chr3","191889838","191889964","chr2","106545466","106545589","10","85344372"
"chr3","191904292","191904604","chr2","106525288","106525600","14","85379004"
"chr3","191930142","191930268","chr14","66818369","66818496","25","125111773"
"chr3","191978893","191979197","chr2","106454721","106455014","38","85524172"
"chr3","192046393","192046683","chr2","106387542","106387837","42","85658851"
"chr3","192048509","192048793","chr4","103532998","103533267","64","88515511"
"chr3","192061163","192061460","chr2","106373422","106373724","24","85687741"
"chr3","192062875","192063000","chr12","78570861","78570985","19","113492014"
"chr3","192078073","192078273","chr2","106354666","106354861","18","85723407"
"chr3","192132077","192132359","chr2","106254540","106254824","27","85877537"
"chr3","192135668","192135960","chr4","4467851","4468145","56","187667817"
"chr3","192250593","192250919","chr2","192880889","192881205","23","630296"
"chr3","192251760","192251909","chrX","19212518","19212664","29","173039242"
"chr3","192252237","192252417","chr7","39788872","39789057","41","152463365"
"chr3","192257239","192257515","chr2","192867744","192868028","22","610505"
"chr3","192295743","192296031","chr2","192828012","192828302","15","532269"
"chr3","192343315","192343579","chr2","192780667","192780956","42","437352"
"chr3","192366494","192366646","chr16","19819840","19819977","38","172546654"
"chr3","192367875","192368042","chr12","59016380","59016547","34","133351495"
"chr3","192390566","192390885","chr2","192732579","192732897","31","342013"
"chr3","192435505","192435795","chr2","192690837","192691126","29","255332"
"chr3","192489036","192489329","chr2","192637246","192637542","41","148210"
"chr3","192491396","192491683","chr1","8798660","8798961","81","183692736"
"chr3","192529291","192529461","chr2","192597769","192597933","18","68478"
"chr3","192593724","192594030","chr7","67632001","67632292","72","124961723"
"chr3","192609741","192610042","chr2","192522271","192522566","31","87470"
"chr3","192633789","192634088","chr2","192497248","192497549","25","136541"
"chr3","192681372","192681691","chr2","192449252","192449567","42","232120"
"chr3","192820724","192821012","chr2","192307772","192308075","26","512952"
"chr3","192892432","192892739","chr2","192237968","192238261","25","654464"
"chr3","192901090","192901213","chr7","92846413","92846536","20","100054677"
"chr3","192921435","192921760","chr2","192213370","192213687","36","708065"
"chr3","192965942","192966202","chr2","192172904","192173181","29","793038"
"chr3","192984945","192985244","chr2","192154613","192154914","32","830332"
"chr3","192987209","192987424","chr2","192152416","192152638","17","834793"
"chr3","193010124","193010432","chr20","42042273","42042584","68","150967851"
"chr3","193030145","193030454","chr2","192112119","192112428","28","918026"
"chr3","193039041","193039166","chr7","135077032","135077157","17","57962009"
"chr3","193338731","193339029","chr2","191883557","191883853","23","1455174"
"chr3","193364833","193364950","chr19","16292084","16292204","19","177072749"
"chr3","193365007","193365154","chr8","21621594","21621739","22","171743413"
"chr3","193371655","193371931","chr7","135915339","135915632","75","57456316"
"chr3","193419872","193420163","chr2","191799016","191799303","21","1620856"
"chr3","193432659","193432928","chr2","191786420","191786690","32","1646239"
"chr3","193495410","193495693","chr2","191734307","191734591","24","1761103"
"chr3","193508131","193508464","chr2","191721170","191721492","28","1786961"
"chr3","193717756","193718033","chr2","191513954","191514256","43","2203802"
"chr3","193751038","193751333","chr2","191480274","191480583","30","2270764"
"chr3","193835733","193835959","chr6","140007270","140007491","62","53828463"
"chr3","193848161","193848465","chr2","191384551","191384855","16","2463610"
"chr3","193881971","193882269","chr19","3500436","3500734","65","190381535"
"chr3","193897657","193897942","chr2","191334193","191334451","42","2563464"
"chr3","193967305","193967514","chr1","34871996","34872199","47","159095309"
"chr3","193980645","193980942","chr9","110786043","110786351","71","83194602"
"chr3","193989670","193989963","chr2","191245339","191245623","27","2744331"
"chr3","194078053","194078278","chr16","9664944","9665171","51","184413109"
"chr3","194307044","194307338","chr2","190929136","190929424","35","3377908"
"chr3","194424456","194424689","chr2","195562914","195563140","31","1138458"
"chr3","194461424","194461597","chr2","195607495","195607667","9","1146071"
"chr3","194497730","194498035","chr2","195639631","195639930","17","1141901"
"chr3","194506926","194507217","chr2","195657436","195657734","28","1150510"
"chr3","194512750","194513033","chr2","195662970","195663256","19","1150220"
"chr3","194575656","194575944","chr2","195722646","195722945","38","1146990"
"chr3","194636272","194636510","chr1","220619352","220619585","64","25983080"
"chr3","194646549","194646837","chr2","195790562","195790842","29","1144013"
"chr3","194715964","194716272","chr2","195858801","195859114","27","1142837"
"chr3","194774191","194774401","chr3","125681258","125681464","51","69092933"
"chr3","194814943","194815232","chr2","195955271","195955563","24","1140328"
"chr3","194895778","194896102","chr2","196038515","196038838","17","1142737"
"chr3","194914857","194915130","chr2","196058536","196058809","20","1143679"
"chr3","194934210","194934479","chr2","196077584","196077849","21","1143374"
"chr3","194986381","194986686","chr2","196128164","196128467","23","1141783"
"chr3","195339002","195339292","chr13","93973412","93973700","58","101365590"
"chr3","195424449","195424696","chr2","196569722","196569980","51","1145273"
"chr3","195476910","195477153","chr7","84548404","84548652","58","110928506"
"chr3","195477160","195477298","chr1","128086244","128086378","23","67390916"
"chr3","195508905","195509115","chr2","196653498","196653716","31","1144593"
"chr3","195525047","195525146","chr2","196668926","196669025","4","1143879"
"chr3","195552994","195553296","chr2","196698938","196699243","36","1145944"
"chr3","195762439","195762749","chr2","196894355","196894660","26","1131916"
"chr3","195835817","195836122","chr2","196968517","196968832","59","1132700"
"chr3","195904572","195904860","chr2","197038987","197039246","61","1134415"
"chr3","195948830","195949132","chr2","197079263","197079563","25","1130433"
"chr3","195967317","195967610","chr2","197096806","197097101","24","1129489"
"chr3","196146169","196146457","chr2","197296581","197296869","21","1150412"
"chr3","196151944","196152218","chr2","197302517","197302830","60","1150573"
"chr3","196281125","196281375","chr5","169927411","169927659","59","26353714"
"chr3","196315363","196315653","chr2","197468025","197468311","26","1152662"
"chr3","196392663","196392937","chr16","55700437","55700720","80","140692226"
"chr3","196442242","196442530","chr1","92897450","92897739","51","103544792"
"chr3","196599949","196600228","chr11","124551250","124551540","72","72048699"
"chr3","196606010","196606317","chr7","153693315","153693622","72","42912695"
"chr3","196647427","196647647","chr2","197754748","197754924","57","1107321"
"chr3","196647909","196648018","chr8","115807755","115807864","26","80840154"
"chr3","196680662","196680948","chr2","197780286","197780574","27","1099624"
"chr3","196739796","196740090","chr2","197836662","197836958","24","1096866"
"chr3","196757802","196758042","chr4","108601962","108602206","55","88155840"
"chr3","196888759","196889015","chr20","42703392","42703652","61","154185367"
"chr3","196980753","196981006","chr2","198083716","198083987","32","1102963"
"chr3","197144042","197144219","chr2","198234937","198235114","10","1090895"
"chr3","197219635","197219901","chr2","198307900","198308166","17","1088265"
"chr3","197413563","197413878","chr2","198541756","198542021","67","1128193"
"chr3","197435588","197435860","chr2","198560711","198561006","56","1125123"
"chr3","197485146","197485430","chr2","198593783","198594063","25","1108637"
"chr3","197507329","197507624","chr2","198616186","198616481","13","1108857"
"chr3","197536203","197536339","chr3","126122510","126122645","18","71413693"
"chr3","197536643","197536739","chr17","24575030","24575129","12","172961613"
"chr3","197550415","197550718","chr14","122733616","122733911","57","74816799"
"chr3","197561752","197561920","chr17","24562778","24562946","8","172998974"
"chr3","197567862","197568098","chr6","171622945","171623206","69","25944917"
"chr3","197568402","197568524","chr17","24556191","24556309","11","173012211"
"chr3","197569954","197570231","chr17","24554497","24554738","56","173015457"
"chr3","197571013","197571171","chr6","72440552","72440709","35","125130461"
"chr3","197605012","197605295","chr17","24519062","24519347","24","173085950"
"chr3","197614485","197614788","chr17","24510938","24511243","22","173103547"
"chr3","197640494","197640749","chr17","24483337","24483630","56","173157157"
"chr3","197641152","197641440","chr17","24482685","24482973","17","173158467"
"chr3","197679961","197680362","chr17","24445382","24445725","101","173234579"
"chr3","197733139","197733424","chr17","24389151","24389430","27","173343988"
"chr3","197745333","197745552","chr3","93515202","93515421","44","104230131"
"chr3","197753732","197754030","chr5","51567445","51567731","66","146186287"
"chr3","197756676","197756980","chr17","24361169","24361437","51","173395507"
"chr3","197781627","197781926","chr4","159090526","159090826","54","38691101"
"chr3","197796364","197796604","chr17","24323886","24324101","46","173472478"
"chr3","197798637","197798761","chr20","24383852","24383976","21","173414785"
"chr3","197807726","197808014","chr17","24313979","24314267","28","173493747"
"chr3","197820823","197821109","chr17","24299418","24299707","27","173521405"
"chr3","197835118","197835398","chr17","24281945","24282233","32","173553173"
"chr3","197838848","197839091","chr17","24278227","24278475","15","173560621"
"chr3","197852083","197852383","chr17","24266962","24267258","22","173585121"
"chr3","197862059","197862360","chr17","24257734","24258039","24","173604325"
"chr3","197865593","197865729","chr17","24254020","24254156","12","173611573"
"chr3","197866036","197866178","chr17","24253565","24253708","10","173612471"
"chr3","197868582","197868899","chr17","24250795","24251110","37","173617787"
"chr3","197876764","197877050","chr13","107408005","107408290","57","90468759"
"chr3","197882328","197882627","chr17","24236518","24236809","26","173645810"
"chr3","197904401","197904680","chr5","78034776","78035038","69","119869625"
"chr3","197915994","197916113","chr19","38233529","38233652","31","159682465"
"chr3","197921761","197922041","chr17","24193866","24194148","22","173727895"
"chr3","197929979","197930195","chr17","24184945","24185158","25","173745034"
"chr3","197961102","197961281","chr18","12820393","12820569","39","185140709"
"chr3","197965780","197966086","chr17","24143313","24143614","26","173822467"
"chr3","197987386","197987684","chr17","24123051","24123349","24","173864335"
"chr3","198008477","198008769","chr17","24102617","24102897","32","173905860"
"chr3","198010027","198010322","chr17","24101098","24101378","33","173908929"
"chr3","198017457","198017586","chr1","117811669","117811797","17","80205788"
"chr3","198032195","198032338","chr17","24079777","24079910","15","173952418"
"chr3","198056657","198056772","chr3","127146489","127146603","21","70910168"
"chr3","198056801","198056948","chr12","62178385","62178532","31","135878416"
"chr3","198098844","198099192","chr2","84720159","84720496","85","113378685"
"chr3","198117060","198117176","chr4","37779512","37779629","13","160337548"
"chr3","198134707","198134923","chr10","71004722","71004936","42","127129985"
"chr3","198150688","198150796","chr17","23934580","23934688","8","174216108"
"chr3","198235230","198235489","chr17","23855458","23855717","21","174379772"
"chr3","198242485","198242792","chr3","41604589","41604891","58","156637896"
"chr3","198255391","198255685","chr17","23835194","23835489","28","174420197"
"chr3","198261918","198262177","chr17","23828683","23828945","16","174433235"
"chr3","198263647","198263946","chr17","23826808","23827106","20","174436839"
"chr3","198286295","198286599","chr4","35692118","35692417","57","162594177"
"chr3","198288694","198288991","chr17","23800859","23801167","27","174487835"
"chr3","198295693","198295959","chr9","64014653","64014924","63","134281040"
"chr3","198301465","198301593","chr17","23789864","23789992","3","174511601"
"chr3","198302321","198302462","chr17","23788991","23789133","14","174513330"
"chr3","198332923","198333040","chr17","23758170","23758285","5","174574753"
"chr3","198395302","198395425","chr17","23693636","23693759","4","174701666"
"chr3","198399565","198399846","chr17","23688828","23689109","38","174710737"
"chr3","198403655","198403818","chr17","23684576","23684742","19","174719079"
"chr3","198404110","198404243","chr17","23684147","23684279","12","174719963"
"chr3","198405926","198406099","chr6","68146972","68147145","33","130258954"
"chr3","198406404","198406548","chr1","25332212","25332356","25","173074192"
"chr3","198410826","198410950","chr17","23679278","23679400","8","174731548"
"chr3","198423473","198423761","chr17","23666087","23666387","29","174757386"
"chr3","198535294","198535608","chr17","23555062","23555376","18","174980232"
"chr3","198542654","198542963","chr17","23547716","23548025","22","174994938"
"chr3","198543288","198543585","chr17","23547096","23547394","18","174996192"
"chr3","198604557","198604854","chr17","23485903","23486209","32","175118654"
"chr3","198650812","198650931","chr17","23439381","23439495","14","175211431"
"chr3","198650984","198651157","chr17","23439181","23439353","19","175211803"
"chr3","198653358","198653675","chr17","23436811","23437107","52","175216547"
"chr3","198764193","198764502","chr10","15460316","15460612","73","183303877"
"chr3","198926846","198927120","chr17","23171333","23171607","23","175755513"
"chr3","198970103","198970417","chr17","23127161","23127475","19","175842942"
"chr3","198988433","198988628","chr17","23108601","23108790","24","175879832"
"chr3","199050779","199051048","chr17","23046070","23046336","16","176004709"
"chr3","199115969","199116262","chr17","22980370","22980661","16","176135599"
"chr3","199137018","199137277","chr17","22960141","22960413","23","176176877"
"chr3","199245677","199245981","chr17","22856037","22856330","65","176389640"
"chr3","199303474","199303760","chr17","22799502","22799784","26","176503972"
"chr3","199310481","199310704","chr17","22792497","22792719","17","176517984"
"chr3","199351335","199351637","chr17","22748497","22748799","17","176602838"
"chr3","199353723","199354005","chr17","22746130","22746426","29","176607593"
"chr3","199473262","199473596","chr17","22627991","22628316","29","176845271"
"chr3","199672144","199672268","chr2","198778510","198778638","11","893634"
"chr3","199831747","199832091","chr2","198934428","198934725","67","897319"
"chr3","199873235","199873547","chr8","119103235","119103541","69","80770000"
"chr3","199920944","199921220","chr2","199018968","199019270","42","901976"
"chr3","199938322","199938473","chr9","68461918","68462067","31","131476404"
"chr3","200016417","200016707","chr16","39155555","39155844","62","160860862"
"chr3","200222166","200222489","chr14","63858277","63858583","62","136363889"
"chr3","200259713","200260015","chr11","120537606","120537911","64","79722107"
"chr3","200273751","200274042","chr2","199425614","199425907","21","848137"
"chr3","200311745","200312033","chr2","199462102","199462381","30","849643"
"chr3","200395437","200395572","chr4","3009835","3009974","22","197385602"
"chr3","200446092","200446330","chr2","199585715","199585951","19","860377"
"chr3","200455305","200455433","chr2","199593841","199593969","13","861464"
"chr3","200471040","200471318","chr2","199609566","199609844","17","861474"
"chr3","200489575","200489685","chr12","113159897","113160008","25","87329678"
"chr3","200518735","200519022","chr2","199658375","199658656","35","860360"
"chr3","200537494","200537801","chr2","199676364","199676670","23","861130"
"chr3","200559815","200560043","chr2","199699936","199700164","18","859879"
"chr3","200610652","200610925","chr2","199749239","199749511","16","861413"
"chr3","200677212","200677406","chrX","52447863","52448045","41","148229349"
"chr3","200677603","200677903","chr2","199816368","199816678","27","861235"
"chr3","200684510","200684797","chr2","199822836","199823125","21","861674"
"chr3","200737044","200737344","chr6","170943463","170943749","67","29793581"
"chr3","200796083","200796340","chr3","36424130","36424381","56","164371953"
"chr3","200983380","200983653","chr2","200133291","200133577","32","850089"
"chr3","201084699","201085004","chr2","200240312","200240622","25","844387"
"chr3","201147873","201147964","chr2","200301261","200301352","4","846612"
"chr3","201164817","201165109","chr13","44913128","44913422","57","156251689"
"chr3","201184046","201184348","chr20","56909535","56909827","70","144274511"
"chr3","201184533","201184839","chr2","200340048","200340331","52","844485"
"chr3","201202327","201202624","chr13","27388292","27388580","66","173814035"
"chr3","201268689","201268985","chr2","200415452","200415748","24","853237"
"chr3","201274344","201274573","chr2","200421044","200421274","15","853300"
"chr3","201280976","201281279","chr2","200428007","200428303","37","852969"
"chr3","201303254","201303548","chr2","200449760","200450040","38","853494"
"chr3","201315639","201315925","chr2","200462061","200462371","41","853578"
"chr3","201367504","201367832","chr4","15436521","15436847","66","185930983"
"chr3","201382303","201382509","chr2","200528536","200528738","29","853767"
"chr3","201400881","201401108","chr2","200547501","200547748","29","853380"
"chr3","201463133","201463451","chr2","200612142","200612467","24","850991"
"chr3","201492953","201493241","chr2","200642036","200642329","35","850917"
"chr3","201507597","201507887","chr1","182642228","182642528","63","18865369"
"chr3","201581475","201581784","chr7","164722657","164722964","61","36858818"
"chr3","201607944","201608132","chr1","25350026","25350222","31","176257918"
"chr3","201614341","201614508","chr2","200765902","200766047","27","848439"
"chr3","201614509","201614807","chr9","63095691","63095976","68","138518818"
"chr3","201614808","201614831","chr2","200766368","200766392","6","848440"
"chr3","201615134","201615308","chr2","200766692","200766851","25","848442"
"chr3","201690439","201690714","chr2","200839325","200839625","45","851114"
"chr3","201723235","201723364","chr2","200875602","200875729","8","847633"
"chr3","201723395","201723507","chr2","200875775","200875890","7","847620"
"chr3","201757220","201757357","chr2","92955794","92955921","25","108801426"
"chr3","201763669","201763972","chr2","200916902","200917211","41","846767"
"chr3","201775047","201775244","chr2","200928760","200928957","8","846287"
"chr3","201817696","201817980","chr7","100899136","100899415","69","100918560"
"chr3","201855763","201856069","chr2","178119588","178119898","61","23736175"
"chr3","201902807","201903109","chr2","201064573","201064884","31","838234"
"chr3","201908207","201908519","chr2","201069941","201070254","25","838266"
"chr3","201924585","201924868","chr15","12359724","12360004","52","189564861"
"chr3","201959722","201960026","chr2","201137417","201137725","27","822305"
"chr3","201984357","201984488","chr20","33372431","33372555","25","168611926"
"chr3","202052263","202052373","chr4","129557122","129557232","18","72495141"
"chr3","202092577","202092711","chr2","201276853","201276986","9","815724"
"chr3","202093003","202093190","chr2","201277282","201277446","38","815721"
"chr3","202113845","202114028","chr2","201298539","201298722","17","815306"
"chr3","202121894","202122201","chr2","201307101","201307401","43","814793"
"chr3","202122926","202123047","chr18","12833518","12833636","20","189289408"
"chr3","202145100","202145287","chr17","94846794","94846979","56","107298306"
"chr3","202145325","202145460","chr7","51796125","51796255","29","150349200"
"chr3","202215064","202215170","chr16","3122016","3122123","20","199093048"
"chr3","202231394","202231683","chr2","201427265","201427551","28","804129"
"chr3","202260134","202260256","chr2","201454404","201454526","8","805730"
"chr3","202276740","202277041","chr2","201469327","201469627","35","807413"
"chr3","202321719","202321848","chr2","201520652","201520778","14","801067"
"chr3","202348566","202348845","chr20","42705492","42705774","56","159643074"
"chr3","202397263","202397570","chr5","51350304","51350607","56","151046959"
"chr3","202485575","202485864","chr2","201713319","201713583","55","772256"
"chr3","202492054","202492275","chr2","201719874","201720088","13","772180"
"chr3","202499201","202499490","chr3","154616784","154617069","54","47882417"
"chr3","202522929","202523244","chr2","201751503","201751813","49","771426"
"chr3","202525450","202525734","chr2","201754348","201754625","23","771102"
"chr3","202614824","202615123","chr3","154993304","154993599","60","47621520"
"chr3","202646868","202647139","chr2","201867493","201867794","44","779375"
"chr3","202665275","202665445","chr3","5152601","5152765","35","197512674"
"chr3","202675883","202676182","chr2","201892312","201892616","30","783571"
"chr3","202784788","202785098","chr2","201997804","201998106","32","786984"
"chr3","202810334","202810456","chr2","202023671","202023792","6","786663"
"chr3","202882121","202882263","chr2","202100575","202100710","25","781546"
"chr3","202892181","202892485","chr2","202111234","202111547","27","780947"
"chr3","202934962","202935241","chr4","115143255","115143539","56","87791707"
"chr3","202940071","202940398","chr2","202163172","202163491","24","776899"
"chr3","202945245","202945405","chr2","202168351","202168511","9","776894"
"chr3","202945713","202946018","chr7","62754402","62754691","65","140191311"
"chr3","202996929","202997193","chr2","202216781","202217041","19","780148"
"chr3","202998544","202998782","chr16","449626","449842","65","202548918"
"chr3","203003215","203003354","chr2","202223315","202223455","9","779900"
"chr3","203010223","203010295","chr2","202230850","202230915","10","779373"
"chr3","203020573","203020871","chr2","202242431","202242741","47","778142"
"chr3","203021307","203021591","chr1","212890378","212890672","49","9869071"
"chr3","203022100","203022368","chr2","202243979","202244221","36","778121"
"chr3","203028225","203028519","chr2","202256346","202256632","23","771879"
"chr3","203039228","203039538","chr2","202266075","202266388","63","773153"
"chr3","203044295","203044595","chr19","43210585","43210888","51","159833710"
"chr3","203057519","203057672","chr10","7402377","7402528","29","195655142"
"chr3","203057977","203058107","chr2","202284626","202284749","17","773351"
"chr3","203091767","203092053","chr2","202311029","202311309","32","780738"
"chr3","203114824","203115136","chr2","202333249","202333565","37","781575"
"chr3","203116823","203117126","chr2","202335251","202335553","18","781572"
"chr3","203140612","203140889","chr2","202358590","202358853","46","782022"
"chr3","203249950","203250196","chr2","202603631","202603884","32","646319"
"chr3","203261965","203262272","chr2","202615945","202616256","28","646020"
"chr3","203265002","203265290","chr11","122201198","122201496","62","81063804"
"chr3","203318196","203318504","chr1","23321222","23321525","57","179996974"
"chr3","203325940","203326097","chr15","104302293","104302449","33","99023647"
"chr3","203340589","203340865","chr2","202676558","202676819","47","664031"
"chr3","203372005","203372292","chr2","202712682","202712972","23","659323"
"chr3","203377850","203377970","chr2","202714913","202715045","19","662937"
"chr3","203383124","203383292","chr9","97663437","97663600","38","105719687"
"chr3","203399978","203400296","chr3","500655","500980","75","202899323"
"chr3","203400977","203401194","chr19","39028175","39028394","49","164372802"
"chr3","203421007","203421122","chr16","65961932","65962048","16","137459075"
"chr3","203432206","203432321","chr8","38576227","38576342","17","164855979"
"chr3","203432508","203432644","chr4","37461855","37461993","31","165970653"
"chr3","203433814","203434110","chr2","84913076","84913368","52","118520738"
"chr3","203439886","203440097","chr2","202776841","202777044","36","663045"
"chr3","203454402","203454527","chrX","65945582","65945708","25","137508820"
"chr3","203458342","203458649","chr11","109624796","109625101","62","93833546"
"chr3","203460060","203460322","chr2","202789550","202789813","22","670510"
"chr3","203489126","203489214","chr1","196860676","196860765","17","6628450"
"chr3","203509086","203509316","chr2","202848252","202848484","20","660834"
"chr3","203514092","203514376","chr2","202852277","202852555","29","661815"
"chr3","203517640","203517813","chr19","35076846","35077012","38","168440794"
"chr3","203528300","203528605","chr2","202868535","202868838","14","659765"
"chr3","203543396","203543707","chr2","202880055","202880373","55","663341"
"chr3","203547646","203547939","chr7","140588016","140588306","56","62959630"
"chr3","203548101","203548241","chr19","16723801","16723938","29","186824300"
"chr3","203556534","203556831","chr2","202893911","202894212","26","662623"
"chr3","203560129","203560406","chr2","202897465","202897749","31","662664"
"chr3","203560493","203560684","chr16","1868228","1868413","55","201692265"
"chr3","203560985","203561120","chr2","202898341","202898475","4","662644"
"chr3","203570592","203570834","chr2","202907483","202907721","15","663109"
"chr3","203578349","203578483","chr2","202915204","202915338","5","663145"
"chr3","203579058","203579236","chr2","202915897","202916074","17","663161"
"chr3","203597805","203597927","chr2","202934108","202934230","7","663697"
"chr3","203599717","203599847","chr1","142196085","142196201","40","61403632"
"chr3","203603499","203603788","chr2","202939446","202939747","42","664053"
"chr3","203608160","203608461","chr20","10719806","10720100","58","192888354"
"chr3","203621886","203622180","chr2","202956765","202957080","38","665121"
"chr3","203654641","203654690","chr10","13621264","13621305","14","190033377"
"chr3","203655171","203655454","chr2","202993188","202993474","19","661983"
"chr3","203658530","203658851","chr2","202996479","202996794","46","662051"
"chr3","203659104","203659381","chr2","202997208","202997498","20","661896"
"chr3","203662080","203662213","chr1","54125507","54125638","25","149536573"
"chr3","203677498","203677788","chr2","203014804","203015094","14","662694"
"chr3","203678993","203679281","chr2","203016620","203016910","29","662373"
"chr3","203686642","203686936","chr2","203025589","203025868","33","661053"
"chr3","203687661","203687939","chr14","69720063","69720348","78","133967598"
"chr3","203704673","203704990","chr2","203044570","203044897","45","660103"
"chr3","203709279","203709566","chr2","203049135","203049422","26","660144"
"chr3","203709616","203709707","chr2","203049786","203049883","21","659830"
"chr3","203711465","203711750","chr1","212846655","212846936","69","9135190"
"chr3","203712495","203712618","chr2","203052373","203052507","18","660122"
"chr3","203717161","203717456","chr2","203057117","203057410","40","660044"
"chr3","203724683","203724977","chr2","203066541","203066854","39","658142"
"chr3","203730125","203730314","chr4","31513303","31513506","59","172216822"
"chr3","203734297","203734445","chr4","44439345","44439491","47","159294952"
"chr3","203734446","203734602","chr20","11957484","11957638","37","191776962"
"chr3","203734603","203734657","chrX","4619774","4619827","17","199114829"
"chr3","203738448","203738611","chr19","29492915","29493075","38","174245533"
"chr3","203739804","203739975","chr18","48162913","48163097","48","155576891"
"chr3","203742455","203742561","chr2","203084133","203084240","10","658322"
"chr3","203742860","203743069","chr10","16569967","16570165","26","187172893"
"chr3","203744074","203744376","chr10","2293202","2293503","72","201450872"
"chr3","203765915","203766203","chr2","203105663","203105946","21","660252"
"chr3","203768892","203768975","chr5","185201104","185201188","16","18567788"
"chr3","203772198","203772496","chr2","203113366","203113663","23","658832"
"chr3","203784243","203784375","chr2","203128524","203128640","23","655719"
"chr3","203797985","203798263","chr1","35572808","35573075","64","168225177"
"chr3","203799972","203800236","chrX","111904330","111904595","53","91895642"
"chr3","203823104","203823400","chr2","203163020","203163316","24","660084"
"chr3","203830406","203830531","chr2","203169966","203170091","3","660440"
"chr3","203840585","203840708","chr20","68874070","68874194","14","134966515"
"chr3","203844908","203845200","chr2","203177475","203177767","28","667433"
"chr3","203860194","203860407","chr5","38469068","38469280","34","165391126"
"chr3","203894203","203894508","chr2","203270942","203271247","22","623261"
"chr3","203894558","203894778","chr11","12596620","12596836","44","191297938"
"chr3","203898396","203898694","chr2","203275406","203275691","31","622990"
"chr3","203924866","203925171","chr2","203306090","203306386","33","618776"
"chr3","203953570","203953867","chr2","203335898","203336196","29","617672"
"chr3","203994751","203995055","chr2","203383935","203384244","19","610816"
"chr3","203998090","203998370","chr2","203388463","203388743","13","609627"
"chr3","203999585","203999778","chr2","203389971","203390172","16","609614"
"chr3","204005333","204005642","chr2","203396799","203397092","34","608534"
"chr3","204036580","204036699","chr14","111841907","111842022","36","92194673"
"chr3","204049800","204049945","chr20","27654163","27654300","33","176395637"
"chr3","204050257","204050300","chr9","60501578","60501624","10","143548679"
"chr3","204051175","204051457","chr2","203449587","203449876","25","601588"
"chr3","204118483","204118774","chr2","203522240","203522537","40","596243"
"chr3","204130584","204130826","chrX","112276995","112277237","54","91853589"
"chr3","204156114","204156229","chr2","203552461","203552576","9","603653"
"chr3","204159982","204160282","chr5","4709062","4709363","62","199450920"
"chr3","204170490","204170802","chr2","203568011","203568323","24","602479"
"chr3","204177810","204178043","chr3","36424130","36424381","68","167753680"
"chr3","204181425","204181696","chr7","131398459","131398720","66","72782966"
"chr3","204187253","204187564","chr2","203585523","203585833","24","601730"
"chr3","204192025","204192171","chr2","203590570","203590716","6","601455"
"chr3","204193771","204193863","chr7","37130453","37130536","25","167063318"
"chr3","204207782","204208047","chr2","203613478","203613733","29","594304"
"chr3","204215317","204215450","chr1","26561536","26561668","16","177653781"
"chr3","204219684","204219942","chr2","203625803","203626090","46","593881"
"chr3","204224011","204224174","chr3","126621167","126621327","42","77602844"
"chr3","204224485","204224627","chr10","33407535","33407677","26","170816950"
"chr3","204232514","204232786","chr3","48105482","48105749","61","156127032"
"chr3","204275695","204275846","chr8","106903218","106903361","42","97372477"
"chr3","204275882","204275994","chr8","38576227","38576342","16","165699655"
"chr3","204326615","204326907","chr2","203735626","203735930","43","590989"
"chr3","204337926","204338225","chr2","203748359","203748667","35","589567"
"chr3","204358453","204358747","chr2","203768598","203768906","42","589855"
"chr3","204360677","204361001","chr2","203770867","203771178","37","589810"
"chr3","204364658","204364953","chr1","111340126","111340424","70","93024532"
"chr3","204373434","204373735","chr2","203784229","203784531","24","589205"
"chr3","204393486","204393794","chr2","203808084","203808379","31","585402"
"chr3","204399739","204399880","chr8","21621594","21621739","36","182778145"
"chr3","204400559","204400660","chr2","203815368","203815468","5","585191"
"chr3","204404860","204405127","chr2","203819785","203820048","23","585075"
"chr3","204417973","204418273","chr2","203832046","203832333","28","585927"
"chr3","204471957","204472253","chr2","203900738","203901034","17","571219"
"chr3","204509251","204509480","chr2","203940304","203940526","19","568947"
"chr3","204522845","204522941","chr2","203953894","203953995","12","568951"
"chr3","204522940","204523015","chr16","53850496","53850568","31","150672444"
"chr3","204546999","204547153","chr2","203979349","203979507","11","567650"
"chr3","204552117","204552330","chr18","12486861","12487071","51","192065256"
"chr3","204554145","204554355","chr2","203982583","203982798","20","571562"
"chr3","204563563","204563901","chr10","92726752","92727064","89","111836811"
"chr3","204685580","204685884","chr2","204107613","204107912","38","577967"
"chr3","204694305","204694368","chr2","204116012","204116079","5","578293"
"chr3","204765592","204765894","chr2","204180543","204180841","19","585049"
"chr3","204768090","204768165","chr4","109463448","109463524","14","95304642"
"chr3","204986599","204986885","chr2","204337497","204337782","29","649102"
"chr3","205009045","205009163","chr2","204355798","204355920","15","653247"
"chr3","205013222","205013510","chr2","204358576","204358865","36","654646"
"chr3","205017380","205017659","chr2","204362428","204362718","35","654952"
"chr3","205029986","205030303","chr2","204376009","204376319","36","653977"
"chr3","205031902","205032218","chr2","204378231","204378536","37","653671"
"chr3","205035431","205035731","chr2","204382377","204382678","30","653054"
"chr3","205054819","205055117","chr8","10669455","10669749","62","194385364"
"chr3","205057544","205057806","chr7","26602255","26602529","68","178455289"
"chr3","205068155","205068366","chr2","204412415","204412626","16","655740"
"chr3","205071073","205071375","chr20","10719806","10720100","55","194351267"
"chr3","205078027","205078313","chr2","204421942","204422246","37","656085"
"chr3","205087704","205087998","chr2","204434036","204434324","22","653668"
"chr3","205108071","205108358","chr2","204454489","204454770","20","653582"
"chr3","205110873","205111075","chr2","204458376","204458585","17","652497"
"chr3","205113035","205113325","chr3","124267629","124267922","52","80845406"
"chr3","205124860","205125145","chr2","204472300","204472579","30","652560"
"chr3","205127782","205128060","chr1","67019962","67020252","60","138107820"
"chr3","205136368","205136635","chr2","204482992","204483258","24","653376"
"chr3","205136639","205136876","chr10","42722627","42722871","61","162414012"
"chr3","205171240","205171506","chr2","204515395","204515656","35","655845"
"chr3","205172901","205173071","chr2","204517043","204517208","16","655858"
"chr3","205179698","205179933","chr2","204522773","204523006","16","656925"
"chr3","205200374","205200658","chr2","204543176","204543460","21","657198"
"chr3","205201288","205201537","chr20","42703392","42703652","61","162497896"
"chr3","205225113","205225398","chr1","195814241","195814525","58","9410872"
"chr3","205229987","205230253","chr2","204568798","204569054","27","661189"
"chr3","205230643","205230930","chr2","204569446","204569735","38","661197"
"chr3","205250508","205250778","chr2","204587515","204587757","43","662993"
"chr3","205266742","205266990","chr2","204604091","204604348","33","662651"
"chr3","205271866","205272161","chr2","204609179","204609465","35","662687"
"chr3","205273687","205273971","chr2","204610983","204611262","22","662704"
"chr3","205288122","205288246","chr2","204624623","204624748","9","663499"
"chr3","205293445","205293671","chr8","22085064","22085297","51","183208381"
"chr3","205298314","205298444","chr2","204635944","204636074","5","662370"
"chr3","205310725","205310994","chr2","204648790","204649080","40","661935"
"chr3","205322039","205322229","chr2","204657215","204657411","20","664824"
"chr3","205330526","205330826","chr15","14854902","14855200","66","190475624"
"chr3","205348465","205348756","chr6","68750302","68750588","57","136598163"
"chr3","205361054","205361342","chr15","44673597","44673890","56","160687457"
"chr3","205371419","205371720","chr15","44684669","44684971","29","160686750"
"chr3","205372371","205372647","chr15","110827865","110828151","56","94544506"
"chr3","205384644","205384909","chr2","204699466","204699715","38","685178"
"chr4","97517269","97517571","chr5","93002466","93002779","32","4514803"
"chr4","59637629","59637790","chr7","10623619","10623769","38","49014010"
"chr4","74973121","74973410","chr8","23542683","23542967","58","51430438"
"chr4","104595393","104595590","chr1","112377723","112377914","63","7782330"
"chr4","160694123","160694383","chr8","100010905","100011161","48","60683218"
"chr4","163708876","163708991","chr2","111294975","111295088","21","52413901"
"chr4","179175352","179175568","chr5","93556927","93557139","57","85618425"
"chr4","181665583","181665807","chr5","177617248","177617474","22","4048335"
"chr4","189267798","189268101","chr11","48283444","48283741","48","140984354"
"chr4","192282513","192282767","chr7","92495818","92496066","53","99786695"
"chr4","175471","175535","chr5","251451","251515","3","75980"
"chr4","381766","382056","chr8","17315066","17315367","69","16933300"
"chr4","502042","502178","chr5","346263","346396","14","155779"
"chr4","528015","528244","chr5","489205","489420","37","38810"
"chr4","529708","529834","chr5","491188","491314","9","38520"
"chr4","563526","563831","chr5","528340","528601","56","35186"
"chr4","659203","659428","chr2","45945040","45945260","39","45285837"
"chr4","660095","660219","chr1","37064408","37064534","20","36404313"
"chr4","694749","695043","chr5","626584","626893","42","68165"
"chr4","778774","779068","chr5","708553","708850","29","70221"
"chr4","810195","810477","chr5","743110","743394","34","67085"
"chr4","812529","812812","chr5","745776","746078","51","66753"
"chr4","833120","833402","chr5","768597","768877","16","64523"
"chr4","845096","845399","chr5","780763","781069","25","64333"
"chr4","893600","893808","chr5","832576","832794","31","61024"
"chr4","918993","919288","chr5","860669","860955","42","58324"
"chr4","941018","941292","chr5","883795","884084","31","57223"
"chr4","959409","959698","chr5","898546","898835","21","60863"
"chr4","987955","988246","chr5","938446","938745","32","49509"
"chr4","1019411","1019718","chr5","971216","971537","39","48195"
"chr4","1027628","1027737","chr13","26680535","26680645","18","25652907"
"chr4","1140532","1140825","chr1","67019962","67020252","56","65879430"
"chr4","1161008","1161305","chr5","1113526","1113810","30","47482"
"chr4","1189794","1190078","chr5","1144735","1145013","22","45059"
"chr4","1223307","1223487","chr16","472589","472775","44","750718"
"chr4","1282085","1282271","chr19","39878357","39878534","37","38596272"
"chr4","1282297","1282414","chr7","127416421","127416539","32","126134124"
"chr4","1284320","1284630","chr5","1242709","1243015","18","41611"
"chr4","1288974","1289275","chr5","1253336","1253639","23","35638"
"chr4","1289800","1290097","chr9","26634754","26635048","59","25344954"
"chr4","1290369","1290446","chr7","651487","651564","12","638882"
"chr4","1317025","1317155","chr11","109736978","109737111","30","108419953"
"chr4","1330180","1330315","chr5","1308251","1308385","13","21929"
"chr4","1346039","1346334","chr9","45377875","45378169","57","44031836"
"chr4","1346594","1346854","chr5","1324519","1324778","22","22075"
"chr4","1359924","1360218","chr20","41706573","41706866","56","40346649"
"chr4","1378846","1379116","chr9","89526631","89526898","66","88147785"
"chr4","1414287","1414591","chr5","1393517","1393812","25","20770"
"chr4","1416776","1416933","chr5","1396297","1396461","14","20479"
"chr4","1416934","1417250","chr5","1396462","1396772","19","20472"
"chr4","1417251","1417395","chr5","1396773","1396918","11","20478"
"chr4","1417870","1418154","chr14","9434983","9435270","58","8017113"
"chr4","1456140","1456424","chr5","1433414","1433699","25","22726"
"chr4","1494073","1494366","chr6","14424000","14424296","64","12929927"
"chr4","1497196","1497490","chr5","1683370","1683656","22","186174"
"chr4","1601755","1602047","chr5","1637493","1637785","14","35738"
"chr4","1641997","1642295","chr5","1734837","1735136","24","92840"
"chr4","1654086","1654381","chr5","1746504","1746810","32","92418"
"chr4","1731712","1731974","chr5","1777541","1777823","34","45829"
"chr4","1733911","1734186","chr3","155792475","155792740","58","154058564"
"chr4","1749759","1749980","chr5","1806448","1806669","13","56689"
"chr4","1750242","1750321","chr5","1806966","1807039","16","56724"
"chr4","1750693","1750977","chr9","23116704","23116994","61","21366011"
"chr4","1752459","1752755","chr5","1809332","1809624","32","56873"
"chr4","1765831","1766125","chr7","140588016","140588306","48","138822185"
"chr4","1784464","1784775","chr5","1844246","1844563","24","59782"
"chr4","1785597","1785689","chr16","20572904","20572994","21","18787307"
"chr4","1825486","1825595","chr5","1889927","1890031","9","64441"
"chr4","1867117","1867418","chr5","1931483","1931784","24","64366"
"chr4","1877164","1877476","chr5","185678151","185678451","67","183800987"
"chr4","1886049","1886352","chr5","1954592","1954895","27","68543"
"chr4","1894806","1895115","chr5","1962648","1962962","30","67842"
"chr4","1897426","1897679","chr5","1964742","1965003","22","67316"
"chr4","1915727","1915999","chr5","1986636","1986910","20","70909"
"chr4","1923073","1923357","chr5","1994999","1995283","14","71926"
"chr4","1927780","1927868","chr5","2000506","2000587","17","72726"
"chr4","1928176","1928299","chr5","2000890","2001020","17","72714"
"chr4","1936046","1936332","chr2","99689040","99689328","56","97752994"
"chr4","1942911","1943181","chr5","2014519","2014794","27","71608"
"chr4","1943614","1943726","chr5","2017636","2017760","20","74022"
"chr4","1948699","1948777","chr5","2023320","2023396","8","74621"
"chr4","1948978","1949170","chr5","2023599","2023790","22","74621"
"chr4","1970095","1970184","chr3","101395274","101395364","13","99425179"
"chr4","1971743","1972041","chr5","2047187","2047490","24","75444"
"chr4","1973943","1974244","chr5","2049280","2049582","23","75337"
"chr4","2005456","2005752","chr5","2081538","2081829","24","76082"
"chr4","2009309","2009589","chr1","40364279","40364551","64","38354970"
"chr4","2014784","2015083","chr5","2090050","2090352","31","75266"
"chr4","2051730","2052029","chr5","2130240","2130553","36","78510"
"chr4","2052211","2052461","chr5","2131013","2131268","26","78802"
"chr4","2057606","2057869","chr5","2136320","2136568","34","78714"
"chr4","2059699","2059820","chr1","37064408","37064534","25","35004709"
"chr4","2085635","2085887","chr9","95738470","95738706","59","93652835"
"chr4","2088443","2088517","chr6","28055382","28055458","13","25966939"
"chr4","2101050","2101251","chrX","52841999","52842207","42","50740949"
"chr4","2102693","2102911","chr7","112625522","112625752","56","110522829"
"chr4","2129420","2129716","chr2","84913076","84913368","61","82783656"
"chr4","2148904","2149189","chr5","2279478","2279759","21","130574"
"chr4","2175263","2175559","chr5","2298898","2299177","33","123635"
"chr4","2180397","2180688","chr5","2303928","2304221","23","123531"
"chr4","2200592","2200630","chr5","2325280","2325318","2","124688"
"chr4","2203424","2203625","chr17","5229611","5229823","48","3026187"
"chr4","2211168","2211459","chr5","2335746","2336063","43","124578"
"chr4","2216441","2216732","chr5","2339662","2339965","36","123221"
"chr4","2221951","2222233","chr5","2345174","2345450","27","123223"
"chr4","2238445","2238730","chr5","2368608","2368893","11","130163"
"chr4","2246074","2246323","chr5","2376030","2376306","38","129956"
"chr4","2262947","2263259","chr5","2394507","2394818","28","131560"
"chr4","2276383","2276664","chr7","54431682","54431970","53","52155299"
"chr4","2331088","2331406","chr5","2463703","2464024","36","132615"
"chr4","2351683","2351993","chr10","37707166","37707474","66","35355483"
"chr4","2359407","2359702","chr7","140272125","140272413","66","137912718"
"chr4","2362476","2362775","chr2","84913076","84913368","56","82550600"
"chr4","2366932","2367212","chr13","107408005","107408290","49","105041073"
"chr4","2377674","2377967","chr14","86229895","86230185","67","83852221"
"chr4","2390297","2390569","chr1","221282634","221282905","59","218892337"
"chr4","2408477","2408764","chr5","2571581","2571867","17","163104"
"chr4","2421010","2421090","chr12","48383020","48383096","12","45962010"
"chr4","2421123","2421290","chr1","5430206","5430361","41","3009083"
"chr4","2426140","2426437","chr5","2589484","2589779","29","163344"
"chr4","2427253","2427561","chr1","165377858","165378165","56","162950605"
"chr4","2467637","2467757","chr5","2631607","2631727","6","163970"
"chr4","2473698","2473961","chr5","2639025","2639284","22","165327"
"chr4","2474713","2474904","chr5","2640399","2640565","38","165686"
"chr4","2482748","2483037","chr5","2648545","2648836","23","165797"
"chr4","2515958","2516168","chr5","2682706","2682920","15","166748"
"chr4","2525368","2525530","chr8","31187686","31187851","36","28662318"
"chr4","2525841","2525915","chr5","2692174","2692258","15","166333"
"chr4","2541855","2542048","chr15","65696716","65696907","41","63154861"
"chr4","2542353","2542444","chr5","2709626","2709715","11","167273"
"chr4","2553013","2553312","chr5","2720291","2720594","22","167278"
"chr4","2567487","2567619","chr5","2734549","2734680","21","167062"
"chr4","2572427","2572715","chr3","64697175","64697455","74","62124748"
"chr4","2593368","2593516","chr5","2766517","2766663","13","173149"
"chr4","2595645","2595816","chr3","36684318","36684493","44","34088673"
"chr4","2596018","2596194","chr3","69112924","69113079","55","66516906"
"chr4","2605878","2606150","chr3","156182074","156182342","76","153576196"
"chr4","2611118","2611235","chr16","44320962","44321073","25","41709844"
"chr4","2612496","2612799","chr5","2779358","2779658","19","166862"
"chr4","2626682","2626803","chr8","129193748","129193868","19","126567066"
"chr4","2630027","2630284","chr1","15040018","15040290","67","12409991"
"chr4","2634536","2634829","chr5","2810098","2810391","19","175562"
"chr4","2652846","2653159","chr5","2829798","2830093","61","176952"
"chr4","2660983","2661105","chr5","2837087","2837212","9","176104"
"chr4","2702603","2702761","chr5","2880365","2880523","7","177762"
"chr4","2703049","2703201","chr5","2880811","2880962","7","177762"
"chr4","2712566","2712896","chr5","2891017","2891311","64","178451"
"chr4","2715005","2715275","chr5","2893401","2893691","38","178396"
"chr4","2750544","2750754","chr1","8069535","8069739","46","5318991"
"chr4","2770522","2770738","chr5","2952019","2952220","25","181497"
"chr4","2771369","2771590","chr19","18897557","18897775","48","16126188"
"chr4","2773458","2773563","chr5","13977983","13978087","28","11204525"
"chr4","2796687","2796770","chr1","213344017","213344094","15","210547330"
"chr4","2799472","2799786","chr5","2984677","2984997","32","185205"
"chr4","2817186","2817497","chr5","3001860","3002195","42","184674"
"chr4","2819054","2819358","chr5","3004176","3004483","21","185122"
"chr4","2834600","2834890","chr5","3032012","3032302","19","197412"
"chr4","2864085","2864297","chr17","5229611","5229823","37","2365526"
"chr4","2884788","2885078","chr5","3091889","3092199","43","207101"
"chr4","2893363","2893663","chr5","3109513","3109811","41","216150"
"chr4","2903728","2903850","chr1","205464254","205464380","22","202560526"
"chr4","2906312","2906382","chr4","104483943","104484024","16","101577631"
"chr4","2908072","2908357","chr1","94545357","94545647","61","91637285"
"chr4","2919847","2920123","chr5","3141121","3141399","22","221274"
"chr4","2937409","2937714","chr5","3162161","3162469","22","224752"
"chr4","2939865","2940167","chr5","3164980","3165281","21","225115"
"chr4","2957455","2957763","chr5","3182679","3182974","38","225224"
"chr4","2998580","2998844","chr5","3225445","3225730","56","226865"
"chr4","3037387","3037682","chr3","124267629","124267922","50","121230242"
"chr4","3041921","3041999","chr6","141271553","141271631","10","138229632"
"chr4","3065366","3065653","chr10","51823199","51823491","54","48757833"
"chr4","3078437","3078605","chr5","3308056","3308234","26","229619"
"chr4","3125192","3125480","chr5","3358479","3358767","24","233287"
"chr4","3140016","3140307","chr5","3372072","3372365","13","232056"
"chr4","3151793","3152093","chr2","184143766","184144059","66","180991973"
"chr4","3176217","3176506","chr5","3410204","3410494","26","233987"
"chr4","3196448","3196738","chr1","105125761","105126059","59","101929313"
"chr4","3200811","3201106","chr5","3433508","3433797","25","232697"
"chr4","3233788","3234021","chrX","51567105","51567331","49","48333317"
"chr4","3235935","3236245","chr5","3464519","3464821","31","228584"
"chr4","3425496","3425814","chr5","3569975","3570277","30","144479"
"chr4","3427685","3427858","chr1","21576038","21576212","33","18148353"
"chr4","3448038","3448329","chr5","3591972","3592266","16","143934"
"chr4","3480868","3481178","chr5","3623722","3624030","24","142854"
"chr4","3513550","3513835","chr5","3663609","3663893","23","150059"
"chr4","3543464","3543637","chr5","3692164","3692336","10","148700"
"chr4","3553655","3553964","chr5","3704727","3705044","45","151072"
"chr4","3641536","3641839","chr5","3796377","3796671","42","154841"
"chr4","3826327","3826645","chr5","4054714","4055036","32","228387"
"chr4","4267411","4267732","chr5","4378828","4379123","48","111417"
"chr4","4276939","4277071","chr11","50179416","50179546","20","45902477"
"chr4","4277370","4277548","chr11","111382295","111382470","30","107104925"
"chr4","4292460","4292640","chr5","4403413","4403588","14","110953"
"chr4","4295853","4295927","chr5","4406822","4406896","3","110969"
"chr4","4302204","4302432","chr1","32000102","32000319","60","27697898"
"chr4","4305988","4306277","chr5","4416307","4416614","35","110319"
"chr4","4318072","4318282","chr5","4429225","4429445","20","111153"
"chr4","4378013","4378302","chr5","4537471","4537770","34","159458"
"chr4","4400303","4400484","chr2","201298539","201298722","51","196898236"
"chr4","4408495","4408766","chr5","4570748","4571048","55","162253"
"chr4","4412078","4412371","chr1","121643407","121643710","60","117231329"
"chr4","4455470","4455795","chr5","4633082","4633405","25","177612"
"chr4","4461878","4462211","chr4","168993761","168994090","88","164531883"
"chr4","4478701","4479008","chr1","205281400","205281708","46","200802699"
"chr4","4498778","4498981","chr5","4681113","4681316","20","182335"
"chr4","4526082","4526378","chr5","4709062","4709363","22","182980"
"chr4","4533035","4533319","chr5","4716028","4716290","52","182993"
"chr4","4572349","4572624","chr5","4757153","4757394","47","184804"
"chr4","4681905","4682181","chr20","11360693","11360974","56","6678788"
"chr4","4685401","4685671","chr5","4873263","4873530","32","187862"
"chr4","4699450","4699620","chr5","4887309","4887478","12","187859"
"chr4","4702517","4702656","chr5","4890670","4890808","12","188153"
"chr4","4702961","4703093","chr5","4891099","4891231","6","188138"
"chr4","4727360","4727547","chr5","4915639","4915825","14","188279"
"chr4","4765234","4765543","chr5","4955548","4955844","41","190314"
"chr4","4773938","4774200","chr5","4964206","4964469","18","190268"
"chr4","4789574","4789675","chr5","4980794","4980895","8","191220"
"chr4","4824792","4825087","chr5","5013547","5013840","12","188755"
"chr4","4875769","4876062","chr5","5069625","5069918","28","193856"
"chr4","4912211","4912503","chr5","5111591","5111882","16","199380"
"chr4","4925658","4925963","chr5","5125004","5125304","24","199346"
"chr4","4959689","4959980","chr5","5159366","5159646","33","199677"
"chr4","4989220","4989519","chr5","5188108","5188409","18","198888"
"chr4","4990571","4990687","chr8","98774347","98774464","17","93783776"
"chr4","4990729","4990889","chr20","32284199","32284357","30","27293470"
"chr4","5040227","5040522","chr5","5232924","5233236","37","192697"
"chr4","5116925","5117242","chr5","5304846","5305154","29","187921"
"chr4","5122234","5122537","chr5","5310140","5310430","34","187906"
"chr4","5132349","5132569","chr19","37244182","37244407","52","32111833"
"chr4","5177907","5178184","chr5","5365064","5365320","58","187157"
"chr4","5182159","5182288","chr5","5369120","5369247","6","186961"
"chr4","5285766","5286065","chr5","5471761","5472060","16","185995"
"chr4","5287339","5287634","chr5","5473353","5473647","19","186014"
"chr4","5579034","5579343","chr5","5732060","5732375","18","153026"
"chr4","5765779","5765902","chr5","5921918","5922041","7","156139"
"chr4","5777940","5778244","chr5","5934336","5934644","26","156396"
"chr4","5854625","5854914","chr2","188177755","188178041","62","182323130"
"chr4","5910933","5911230","chr5","6051202","6051502","19","140269"
"chr4","5933670","5933948","chr5","6074074","6074334","35","140404"
"chr4","5948919","5949225","chr8","42885230","42885538","64","36936311"
"chr4","6176406","6176689","chr5","6318826","6319115","22","142420"
"chr4","6202681","6202985","chr5","6346533","6346838","19","143852"
"chr4","6259937","6260241","chr3","80676477","80676775","55","74416540"
"chr4","6284106","6284416","chr5","6428890","6429186","37","144784"
"chr4","6291594","6291890","chr5","6434906","6435199","16","143312"
"chr4","6338218","6338547","chrX","37514809","37515122","64","31176591"
"chr4","6342011","6342318","chr10","88007645","88007955","60","81665634"
"chr4","6618746","6619048","chr5","6773543","6773862","39","154797"
"chr4","6625045","6625351","chr5","6779888","6780190","30","154843"
"chr4","6648315","6648607","chr5","6803969","6804257","21","155654"
"chr4","6656335","6656393","chr15","6999941","7000000","11","343606"
"chr4","6659690","6660005","chr5","6815922","6816230","37","156232"
"chr4","6676335","6676644","chr8","8534335","8534637","51","1858000"
"chr4","6686936","6687202","chr5","6841962","6842244","29","155026"
"chr4","6689149","6689442","chr5","6843994","6844285","15","154845"
"chr4","6770918","6771220","chr2","84913076","84913368","52","78142158"
"chr4","6771397","6771519","chr13","25546692","25546816","17","18775295"
"chr4","6792308","6792605","chr5","6944645","6944955","31","152337"
"chr4","6806958","6807232","chr5","6962313","6962586","20","155355"
"chr4","6826989","6827253","chr5","6982215","6982487","31","155226"
"chr4","6827355","6827651","chr5","6982590","6982892","34","155235"
"chr4","6847975","6848294","chr7","42323467","42323788","84","35475492"
"chr4","6865658","6865943","chr5","7025958","7026248","28","160300"
"chr4","6867538","6867852","chr5","7027876","7028198","41","160338"
"chr4","6868628","6868915","chr5","7028681","7028958","30","160053"
"chr4","6871379","6871663","chr5","7031792","7032052","44","160413"
"chr4","6872848","6873156","chr5","7033244","7033568","36","160396"
"chr4","6895310","6895591","chr5","7052357","7052636","28","157047"
"chr4","6896524","6896732","chr15","6503383","6503578","47","393141"
"chr4","6963812","6964053","chr5","7121175","7121429","31","157363"
"chr4","6968809","6969114","chr5","7133394","7133696","48","164585"
"chr4","6973852","6974151","chr5","7133394","7133696","24","159542"
"chr4","6989349","6989558","chr5","7148443","7148653","14","159094"
"chr4","6991468","6991692","chr13","62475074","62475295","50","55483606"
"chr4","7002799","7003090","chr5","7163069","7163339","47","160270"
"chr4","7004278","7004593","chr1","109806160","109806457","77","102801882"
"chr4","7026832","7027140","chr5","7187907","7188212","36","161075"
"chr4","7073896","7074021","chr5","7234755","7234885","11","160859"
"chr4","7130266","7130554","chr5","7290978","7291281","31","160712"
"chr4","7174360","7174644","chr5","7354685","7354970","17","180325"
"chr4","7181766","7182077","chr5","7354314","7354623","22","172548"
"chr4","7226458","7226754","chr5","7391866","7392162","36","165408"
"chr4","7240927","7241224","chr5","7409033","7409315","49","168106"
"chr4","7257411","7257670","chr5","7426038","7426278","38","168627"
"chr4","7385280","7385412","chr5","7568800","7568931","11","183520"
"chr4","7423502","7423695","chr5","7606951","7607144","15","183449"
"chr4","7423999","7424106","chr5","7607448","7607546","17","183449"
"chr4","7490750","7490857","chr5","7680481","7680572","21","189731"
"chr4","7597492","7597764","chr5","7798689","7798961","15","201197"
"chr4","7827057","7827192","chr5","8023525","8023662","22","196468"
"chr4","7827665","7827938","chrX","52930864","52931128","58","45103199"
"chr4","7853838","7854148","chr5","8055703","8055997","50","201865"
"chr4","7921105","7921348","chr5","8123419","8123669","22","202314"
"chr4","7927761","7928038","chr5","8129160","8129438","22","201399"
"chr4","7936515","7936684","chr2","61281692","61281857","31","53345177"
"chr4","7940750","7941013","chr7","61127662","61127921","64","53186912"
"chr4","7965150","7965460","chr2","69411442","69411755","65","61446292"
"chr4","7991086","7991375","chr13","103377120","103377403","31","95386034"
"chr4","8001868","8001997","chr5","8207935","8208064","5","206067"
"chr4","8004608","8004901","chr5","8210686","8210967","23","206078"
"chr4","8019137","8019268","chr5","8226147","8226278","4","207010"
"chr4","8019578","8019650","chr5","8226593","8226649","21","207015"
"chr4","8039913","8040202","chr5","8246617","8246904","15","206704"
"chr4","8052431","8052544","chr5","8261365","8261473","13","208934"
"chr4","8058511","8058806","chr5","8267783","8268084","27","209272"
"chr4","8089656","8089963","chr5","8298987","8299296","40","209331"
"chr4","8105971","8106270","chr5","8318868","8319166","27","212897"
"chr4","8127962","8128245","chr5","8341568","8341856","37","213606"
"chr4","8137234","8137533","chr5","8351374","8351668","28","214140"
"chr4","8160947","8161254","chr5","8371484","8371796","24","210537"
"chr4","8161416","8161532","chr5","8371959","8372075","7","210543"
"chr4","8192666","8192969","chr5","8403389","8403682","35","210723"
"chr4","8207697","8207817","chr5","8418270","8418387","9","210573"
"chr4","8244703","8245003","chr5","8454358","8454652","28","209655"
"chr4","8256351","8256643","chr5","14901284","14901569","51","6644933"
"chr4","8279367","8279666","chr17","80874177","80874471","67","72594810"
"chr4","8295934","8296066","chr8","7552791","7552922","10","743143"
"chr4","8319877","8320126","chr10","15268857","15269103","56","6948980"
"chr4","8354999","8355288","chr5","8569112","8569418","51","214113"
"chr4","8385154","8385432","chr5","8599209","8599485","27","214055"
"chr4","8386108","8386395","chr4","171551681","171551972","50","163165573"
"chr4","8438593","8438886","chr4","71517233","71517531","46","63078640"
"chr4","8456561","8456790","chr5","8674208","8674436","23","217647"
"chr4","8494508","8494610","chr5","8703428","8703530","10","208920"
"chr4","8510930","8511065","chr5","8717020","8717155","9","206090"
"chr4","8522678","8522820","chr9","61444064","61444194","28","52921386"
"chr4","8581677","8581985","chr5","8782943","8783256","33","201266"
"chr4","8596563","8596884","chr7","163126120","163126439","65","154529557"
"chr4","8708865","8709161","chr4","71517233","71517531","59","62808368"
"chr4","8725640","8725924","chr5","8921596","8921880","19","195956"
"chr4","8863523","8863790","chr15","49128958","49129213","67","40265435"
"chr4","8895363","8895645","chr5","4361518","4361802","13","4533845"
"chr4","9045584","9045808","chr19","29525976","29526197","47","20480392"
"chr4","9046913","9047063","chr20","5281043","5281175","29","3765870"
"chr4","9289291","9289563","chr9","32406558","32406824","52","23117267"
"chr4","9322933","9323241","chr20","5173233","5173556","49","4149700"
"chr4","9340111","9340417","chr20","5163297","5163592","36","4176814"
"chr4","9342291","9342569","chr20","5161183","5161481","46","4181108"
"chr4","9354960","9355242","chr20","5157357","5157639","20","4197603"
"chr4","9362590","9362868","chrX","103046997","103047266","70","93684407"
"chr4","9365022","9365326","chr20","5149734","5150049","49","4215288"
"chr4","9428313","9428629","chr20","5124825","5125144","38","4303488"
"chr4","9428804","9429052","chr8","92687825","92688073","57","83259021"
"chr4","9433128","9433234","chr9","38482405","38482520","24","29049277"
"chr4","9437732","9438014","chr20","5116289","5116575","31","4321443"
"chr4","9444870","9445182","chr19","15562519","15562818","58","6117649"
"chr4","9446425","9446647","chr1","23426501","23426719","65","13980076"
"chr4","9455997","9456079","chrX","53790985","53791067","7","44334988"
"chr4","9459464","9459770","chr3","14225210","14225521","32","4765746"
"chr4","9476484","9476759","chr3","14140868","14141172","54","4664384"
"chr4","9515247","9515556","chr5","9104943","9105251","26","410304"
"chr4","9589527","9589786","chr5","9176993","9177243","23","412534"
"chr4","9602306","9602567","chr5","9188923","9189192","48","413383"
"chr4","9784214","9784487","chr5","9422864","9423141","25","361350"
"chr4","9796917","9797057","chr1","153250707","153250848","27","143453790"
"chr4","10256727","10256849","chr1","164989377","164989493","26","154732650"
"chr4","10421666","10421975","chr5","10085661","10085972","26","336005"
"chr4","10456491","10456762","chr5","10119385","10119679","47","337106"
"chr4","10504412","10504639","chr9","30660872","30661106","64","20156460"
"chr4","10584443","10584725","chr5","10253707","10253992","22","330736"
"chr4","10612976","10613291","chr5","10281887","10282200","26","331089"
"chr4","10628839","10629131","chr5","10298158","10298435","48","330681"
"chr4","10753507","10753807","chr5","10423282","10423604","49","330225"
"chr4","10779224","10779524","chr5","10449848","10450147","16","329376"
"chr4","10853259","10853532","chr5","10513563","10513837","22","339696"
"chr4","10984941","10985219","chr5","10643105","10643382","27","341836"
"chr4","11032448","11032726","chr5","10687829","10688107","20","344619"
"chr4","11042606","11042885","chr5","10695242","10695528","24","347364"
"chr4","11260716","11261042","chr5","10914380","10914735","55","346336"
"chr4","11396564","11396754","chr8","126657765","126657960","46","115261201"
"chr4","11544416","11544547","chr5","11181379","11181500","13","363037"
"chr4","11596020","11596337","chr5","11234030","11234344","26","361990"
"chr4","11634858","11635139","chr5","11271941","11272221","15","362917"
"chr4","11649230","11649541","chr5","11284249","11284555","33","364981"
"chr4","11805136","11805249","chrX","134390092","134390203","26","122584956"
"chr4","11805606","11805627","chr5","11437275","11437296","0","368331"
"chr4","11904226","11904518","chr5","11539974","11540242","68","364252"
"chr4","11935910","11936199","chr1","148340688","148340972","58","136404778"
"chr4","12013086","12013191","chr1","22457543","22457653","21","10444457"
"chr4","12036489","12036766","chr5","11666037","11666292","35","370452"
"chr4","12070831","12071030","chrX","15957200","15957396","46","3886369"
"chr4","12166276","12166564","chr5","11785572","11785856","27","380704"
"chr4","12167112","12167405","chr5","11786668","11786922","59","380444"
"chr4","12363896","12364053","chr5","11980531","11980684","13","383365"
"chr4","12375288","12375444","chrY","1376967","1377123","38","10998321"
"chr4","12375795","12375883","chr20","33881111","33881188","26","21505316"
"chr4","12457970","12458236","chr5","12067069","12067335","23","390901"
"chr4","12532340","12532586","chr5","12143492","12143739","23","388848"
"chr4","12732202","12732326","chr5","12334599","12334723","6","397603"
"chr4","12897160","12897450","chr5","12503990","12504282","21","393170"
"chr4","13022909","13023202","chr5","12625709","12626023","35","397200"
"chr4","13178636","13178754","chr5","12784640","12784758","3","393996"
"chr4","13187926","13188211","chr5","12797339","12797623","26","390587"
"chr4","13221157","13221315","chr1","45405979","45406141","31","32184822"
"chr4","13222322","13222534","chr3","65463190","65463415","42","52240868"
"chr4","13223505","13223810","chr19","11314025","11314298","92","1909480"
"chr4","13227883","13228136","chr5","12838553","12838802","19","389330"
"chr4","13275919","13276200","chr5","12885947","12886222","31","389972"
"chr4","13276226","13276495","chr14","63990786","63991054","60","50714560"
"chr4","13293405","13293736","chr5","12902616","12902906","57","390789"
"chr4","13296588","13296754","chr5","12906045","12906206","11","390543"
"chr4","13347077","13347381","chr5","12956453","12956749","25","390624"
"chr4","13347602","13347861","chr5","12956966","12957251","51","390636"
"chr4","13379644","13379944","chrX","113200705","113201003","59","99821061"
"chr4","13513631","13513915","chr5","13104663","13104950","16","408968"
"chr4","13565729","13565987","chr5","13156626","13156898","37","409103"
"chr4","13594650","13594961","chr5","13185835","13186146","18","408815"
"chr4","13603724","13603838","chr5","13195785","13195898","10","407939"
"chr4","13724058","13724264","chr7","3252528","3252721","62","10471530"
"chr4","13789795","13789912","chr12","25897520","25897635","20","12107725"
"chr4","14112926","14113210","chr5","13709070","13709376","36","403856"
"chr4","14172550","14172837","chr5","13762357","13762640","21","410193"
"chr4","14186342","14186615","chr5","13776523","13776803","26","409819"
"chr4","14212764","14212907","chr5","13804079","13804222","10","408685"
"chr4","14385900","14386206","chr9","14892871","14893167","59","506971"
"chr4","14530460","14530729","chr5","14123009","14123292","46","407451"
"chr4","14577015","14577301","chr14","63866013","63866313","54","49288998"
"chr4","14719477","14719574","chr9","15337716","15337814","16","618239"
"chr4","14720298","14720563","chr5","14352535","14352789","26","367763"
"chr4","15242246","15242502","chr5","14804019","14804275","16","438227"
"chr4","15266341","15266630","chr5","14822657","14822945","17","443684"
"chr4","15273471","15273752","chr5","14829504","14829771","39","443967"
"chr4","15283254","15283371","chr5","14838720","14838837","10","444534"
"chr4","15308543","15308667","chr5","14863431","14863555","4","445112"
"chr4","15308989","15309278","chr5","14864191","14864482","15","444798"
"chr4","15338777","15339079","chr5","14893513","14893837","42","445264"
"chr4","15342855","15343144","chr5","14897602","14897891","22","445253"
"chr4","15346552","15346837","chr5","14901284","14901569","12","445268"
"chr4","15389396","15389695","chr5","14929946","14930248","25","459450"
"chr4","15397199","15397489","chr5","14937789","14938079","17","459410"
"chr4","15409157","15409454","chr5","14950708","14951015","33","458449"
"chr4","15420479","15420604","chr5","14963148","14963273","6","457331"
"chr4","15458400","15458682","chr5","15012485","15012773","18","445915"
"chr4","15470841","15471152","chr5","15026292","15026592","28","444549"
"chr4","15495601","15495910","chr5","15052541","15052846","24","443060"
"chr4","15543090","15543212","chr5","15095854","15095976","7","447236"
"chr4","15592876","15593186","chr1","62195366","62195671","59","46602490"
"chr4","15630257","15630449","chr9","54608773","54608962","32","38978516"
"chr4","15662523","15662818","chr5","15245193","15245505","36","417330"
"chr4","15685926","15686209","chr5","15269596","15269890","28","416330"
"chr4","15698401","15698681","chr5","15284847","15285159","48","413554"
"chr4","15703871","15704080","chr20","31947181","31947370","58","16243310"
"chr4","15734701","15734827","chr9","115052851","115052979","22","99318150"
"chr4","15773659","15773904","chr5","15362433","15362657","31","411226"
"chr4","15787065","15787137","chr3","34678345","34678414","19","18891280"
"chr4","15838046","15838328","chr5","15436744","15437025","18","401302"
"chr4","15843684","15843982","chr5","15442372","15442673","26","401312"
"chr4","15879009","15879182","chr5","15478124","15478300","12","400885"
"chr4","15892905","15893190","chr5","15490254","15490542","14","402651"
"chr4","15924360","15924648","chr5","15522619","15522907","27","401741"
"chr4","15925091","15925389","chr5","15523351","15523654","15","401740"
"chr4","15968117","15968198","chr5","15566622","15566700","8","401495"
"chr4","16122093","16122389","chr5","15727923","15728214","22","394170"
"chr4","16277538","16277844","chr5","15881828","15882118","35","395710"
"chr4","16327449","16327736","chr5","15925756","15926043","17","401693"
"chr4","16344783","16345075","chr1","25629235","25629522","63","9284452"
"chr4","16375145","16375427","chr5","15971268","15971560","22","403877"
"chr4","16567313","16567602","chr5","16170228","16170525","37","397085"
"chr4","16854303","16854609","chr1","195966885","195967183","60","179112582"
"chr4","16936486","16936788","chr5","16548151","16548459","20","388335"
"chr4","17080428","17080702","chr1","10904976","10905255","61","6175452"
"chr4","17099172","17099485","chr1","5086241","5086541","62","12012931"
"chr4","17106714","17106975","chr5","16700431","16700697","43","406283"
"chr4","17118642","17118929","chr5","16785828","16786107","32","332814"
"chr4","17141456","17141754","chr7","165716105","165716404","59","148574649"
"chr4","17156466","17156702","chr2","89047385","89047606","59","71890919"
"chr4","17162221","17162550","chr5","16828269","16828583","57","333952"
"chr4","17188069","17188324","chr5","16855544","16855823","34","332525"
"chr4","17198649","17198937","chr5","16866214","16866504","20","332435"
"chr4","17222873","17223172","chr5","16890230","16890543","37","332643"
"chr4","17227291","17227478","chr14","9094985","9095181","48","8132306"
"chr4","17233325","17233441","chr5","16900603","16900725","16","332722"
"chr4","17238164","17238399","chr5","16905770","16906015","28","332394"
"chr4","17271755","17272069","chr5","16933423","16933740","27","338332"
"chr4","17300130","17300413","chr5","16950767","16951057","36","349363"
"chr4","17304323","17304438","chr5","16955125","16955241","9","349198"
"chr4","17319256","17319429","chr6","77837264","77837435","29","60518008"
"chr4","17323637","17323951","chr5","16973966","16974286","29","349671"
"chr4","17326237","17326365","chr14","111812264","111812392","18","94486027"
"chr4","17326614","17326894","chr3","40783093","40783379","55","23456479"
"chr4","17335723","17336036","chr5","16985230","16985529","40","350493"
"chr4","17346207","17346463","chr3","2302914","2303193","72","15043293"
"chr4","17361713","17362010","chr5","17008854","17009147","23","352859"
"chr4","17365397","17365522","chr5","17012532","17012657","4","352865"
"chr4","17370803","17371094","chr9","39037044","39037333","58","21666241"
"chr4","17382658","17382962","chr8","98849115","98849422","63","81466457"
"chr4","17410591","17410905","chr5","17067178","17067485","31","343413"
"chr4","17411986","17412253","chr5","17068620","17068882","28","343366"
"chr4","17457949","17458185","chr5","17114382","17114612","23","343567"
"chr4","17458925","17458937","chr5","17115344","17115355","1","343581"
"chr4","17464448","17464743","chr16","67882541","67882832","66","50418093"
"chr4","17464918","17465041","chr5","17120906","17121029","9","344012"
"chr4","17470472","17470750","chr5","17126828","17127109","24","343644"
"chr4","17481068","17481366","chr5","17141719","17142020","19","339349"
"chr4","17490390","17490683","chr5","17149690","17149987","37","340700"
"chr4","17494872","17495175","chr5","17154627","17154931","24","340245"
"chr4","17500901","17501031","chr7","16781339","16781468","20","719562"
"chr4","17506459","17506746","chr5","17166965","17167242","31","339494"
"chr4","17521922","17522205","chr5","17180984","17181281","41","340938"
"chr4","17530760","17530983","chr5","17189932","17190154","11","340828"
"chr4","17551372","17551649","chr5","17210631","17210908","17","340741"
"chr4","17564546","17564726","chr7","92039014","92039198","36","74474468"
"chr4","17694110","17694406","chr5","17352759","17353056","29","341351"
"chr4","17697309","17697561","chr5","17355684","17355940","17","341625"
"chr4","17765999","17766282","chr5","17427339","17427620","27","338660"
"chr4","17777722","17778008","chr5","17440440","17440721","28","337282"
"chr4","17877923","17878000","chr5","17529519","17529596","1","348404"
"chr4","18015882","18016149","chr5","17664409","17664677","14","351473"
"chr4","18034066","18034364","chr5","17683050","17683347","25","351016"
"chr4","18155735","18156016","chr5","17800592","17800898","40","355143"
"chr4","18194150","18194407","chr5","17843536","17843794","20","350614"
"chr4","18605388","18605574","chr5","18275165","18275352","16","330223"
"chr4","18623066","18623368","chr5","18297096","18297394","21","325970"
"chr4","19456193","19456471","chr7","26602255","26602529","66","7146062"
"chr4","19625557","19625851","chr5","19297973","19298264","24","327584"
"chr4","19681007","19681290","chr5","19354070","19354370","37","326937"
"chr4","19682329","19682630","chr3","43395486","43395788","69","23713157"
"chr4","19745039","19745306","chr5","19413083","19413349","15","331956"
"chr4","19894790","19895039","chr5","19570120","19570369","20","324670"
"chr4","20001650","20001920","chr5","19672715","19672984","16","328935"
"chr4","20037728","20038014","chr5","19710703","19710991","26","327025"
"chr4","20040184","20040496","chr5","19713250","19713561","33","326934"
"chr4","20044915","20045043","chr5","19717978","19718098","16","326937"
"chr4","20060978","20061290","chr4","37761866","37762179","63","17700888"
"chr4","20336727","20336860","chr9","22648313","22648444","28","2311586"
"chr4","20421914","20422179","chr5","20095865","20096146","43","326049"
"chr4","20425214","20425495","chr1","191690399","191690678","74","171265185"
"chr4","20431981","20432275","chr2","48622768","48623061","65","28190787"
"chr4","20469442","20469724","chr7","50799934","50800222","55","30330492"
"chr4","20520061","20520372","chr8","11163640","11163945","66","9356421"
"chr4","20587259","20587556","chr9","99101491","99101790","57","78514232"
"chr4","20903347","20903603","chr14","70284941","70285205","57","49381594"
"chr4","20913524","20913596","chr5","20588978","20589049","10","324546"
"chr4","20943212","20943514","chr3","124286205","124286493","72","103342993"
"chr4","20950567","20950854","chr5","20623089","20623378","26","327478"
"chr4","21099073","21099362","chr5","20810546","20810829","57","288527"
"chr4","21182069","21182363","chr5","20895354","20895636","45","286715"
"chr4","21196919","21197216","chrX","64862488","64862779","58","43665569"
"chr4","21327971","21328312","chr19","40059558","40059894","69","18731587"
"chr4","21378761","21379093","chr5","21090834","21091190","46","287927"
"chr4","21493471","21493767","chr14","15838457","15838757","71","5655014"
"chr4","21580387","21580670","chr5","21288307","21288601","35","292080"
"chr4","21610461","21610602","chr5","21319395","21319536","12","291066"
"chr4","21676859","21676989","chr5","21385485","21385614","6","291374"
"chr4","21688026","21688094","chr2","106049199","106049272","17","84361173"
"chr4","21688130","21688287","chr3","104772367","104772528","33","83084237"
"chr4","21750272","21750562","chr5","21453039","21453331","16","297233"
"chr4","21806663","21806953","chr3","48055991","48056284","77","26249328"
"chr4","22032367","22032659","chr1","162529282","162529568","64","140496915"
"chr4","22065841","22066127","chr5","21782652","21782935","21","283189"
"chr4","22085711","22085990","chr5","21803264","21803553","34","282447"
"chr4","22103934","22104245","chr5","21821707","21822025","29","282227"
"chr4","22105730","22106041","chr5","21823800","21824095","42","281930"
"chr4","22182591","22182893","chr15","29615590","29615889","58","7432999"
"chr4","22192798","22193093","chr5","21914010","21914297","29","278788"
"chr4","22223107","22223387","chr11","1672304","1672588","62","20550803"
"chr4","22227142","22227425","chr3","124267629","124267922","55","102040487"
"chr4","22236349","22236643","chr5","21956622","21956934","39","279727"
"chr4","22718101","22718393","chr5","22397555","22397847","11","320546"
"chr4","22842746","22843048","chr5","22524000","22524275","36","318746"
"chr4","23099477","23099761","chr5","22797959","22798250","21","301518"
"chr4","23296495","23296785","chr5","23005651","23005939","42","290844"
"chr4","23370375","23370683","chr5","23080194","23080503","20","290181"
"chr4","23384751","23384963","chr5","23094659","23094875","33","290092"
"chr4","23391455","23391756","chr5","23101697","23101962","64","289758"
"chr4","23435667","23435955","chr5","23139626","23139925","36","296041"
"chr4","23551031","23551330","chr5","23252422","23252722","16","298609"
"chr4","23632083","23632374","chr5","23339368","23339658","27","292715"
"chr4","23779580","23779903","chr5","23486839","23487157","23","292741"
"chr4","23899038","23899328","chr5","23606618","23606908","16","292420"
"chr4","23954741","23955025","chr3","37470994","37471285","57","13516253"
"chr4","23968853","23969142","chr5","23677218","23677511","21","291635"
"chr4","24009196","24009497","chr5","23718057","23718359","34","291139"
"chr4","24083749","24083872","chr5","23788512","23788636","8","295237"
"chr4","24117732","24118039","chr5","23823036","23823359","40","294696"
"chr4","24144649","24144935","chr5","23849700","23849981","33","294949"
"chr4","24150271","24150547","chr5","23855464","23855751","37","294807"
"chr4","24182328","24182614","chr6","176235066","176235353","63","152052738"
"chr4","24218298","24218592","chr5","23916803","23917101","29","301495"
"chr4","24220682","24220961","chr9","22873625","22873899","60","1347057"
"chr4","24255290","24255584","chr5","23954465","23954757","20","300825"
"chr4","24267793","24268082","chr13","90154674","90154962","61","65886881"
"chr4","24269356","24269639","chr5","23968654","23968954","41","300702"
"chr4","24302072","24302190","chr4","83493280","83493396","20","59191208"
"chr4","24316423","24316717","chr2","160551205","160551504","51","136234782"
"chr4","24392135","24392238","chr5","24106480","24106583","8","285655"
"chr4","24411702","24412000","chr5","24125784","24126069","38","285918"
"chr4","24477482","24477773","chr5","24192413","24192724","44","285069"
"chr4","24501602","24501887","chr1","129289607","129289882","54","104788005"
"chr4","24593825","24594129","chr5","24307856","24308162","22","285969"
"chr4","24598976","24599103","chr5","24313076","24313192","19","285900"
"chr4","24647572","24647838","chr5","24355435","24355717","32","292137"
"chr4","24661465","24661757","chr5","24369721","24370005","32","291744"
"chr4","24697770","24698074","chr12","20483358","20483659","60","4214412"
"chr4","24729810","24730115","chr3","127162429","127162726","65","102432619"
"chr4","24736638","24736936","chr5","24447244","24447541","14","289394"
"chr4","24773405","24773689","chr5","24485499","24485783","18","287906"
"chr4","24780334","24780463","chr5","24493006","24493135","11","287328"
"chr4","24788966","24789264","chr5","24502413","24502703","28","286553"
"chr4","24856628","24856928","chr5","24578686","24578989","41","277942"
"chr4","24876064","24876356","chr5","24598966","24599259","21","277098"
"chr4","24877530","24877830","chr5","24600811","24601109","13","276719"
"chr4","24881318","24881445","chr6","64065434","64065559","19","39184116"
"chr4","24886640","24886921","chr1","129543506","129543782","50","104656866"
"chr4","24904450","24904674","chr5","24628218","24628442","20","276232"
"chr4","24914767","24915088","chr5","24636246","24636561","27","278521"
"chr4","24929802","24930091","chr5","24642511","24642812","24","287291"
"chr4","24944021","24944362","chr14","32156694","32157021","90","7212673"
"chr4","24954324","24954689","chr5","24665716","24666076","25","288608"
"chr4","24963371","24963654","chr5","24675090","24675373","36","288281"
"chr4","24986884","24987188","chr5","24695775","24696079","23","291109"
"chr4","25000501","25000806","chr1","94000509","94000808","62","69000008"
"chr4","25011923","25012220","chr5","24719701","24720005","24","292222"
"chr4","25015746","25016040","chr5","24723518","24723814","19","292228"
"chr4","25025442","25025527","chr5","24733572","24733657","4","291870"
"chr4","25100003","25100299","chr7","165716105","165716404","48","140616102"
"chr4","25109379","25109567","chr10","14633398","14633585","43","10475981"
"chr4","25112176","25112416","chr5","24821419","24821662","33","290757"
"chr4","25125383","25125672","chr5","24834529","24834820","18","290854"
"chr4","25166556","25166765","chr16","3344121","3344328","51","21822435"
"chr4","25179891","25180217","chr13","86944769","86945076","73","61764878"
"chr4","25187167","25187352","chr5","24895947","24896125","19","291220"
"chr4","25216994","25217283","chr17","24299418","24299707","60","917576"
"chr4","25223759","25224057","chr5","24933324","24933634","42","290435"
"chr4","25229292","25229590","chr5","24938842","24939135","35","290450"
"chr4","25235806","25235929","chr8","122404659","122404783","23","97168853"
"chr4","25246637","25246799","chr1","30378928","30379065","53","5132291"
"chr4","25256036","25256251","chr6","38094316","38094524","56","12838280"
"chr4","25256879","25256957","chr6","141271553","141271631","13","116014674"
"chr4","25281288","25281558","chr5","24990511","24990780","26","290777"
"chr4","25282372","25282675","chr1","182642228","182642528","60","157359856"
"chr4","25286301","25286573","chr5","24994974","24995234","25","291327"
"chr4","25306066","25306362","chr5","25017835","25018132","28","288231"
"chr4","25309399","25309600","chr2","93979931","93980136","49","68670532"
"chr4","25316268","25316400","chr5","25034164","25034294","9","282104"
"chr4","25319099","25319298","chr5","25037026","25037203","49","282073"
"chr4","25329341","25329601","chr5","25047371","25047628","49","281970"
"chr4","25371769","25372036","chr5","25097247","25097512","20","274522"
"chr4","25373332","25373658","chr14","3203588","3203909","66","22169744"
"chr4","25377042","25377356","chr3","47930685","47930995","69","22553643"
"chr4","25407029","25407145","chr13","100812951","100813068","14","75405922"
"chr4","25466542","25466837","chr5","25201745","25202041","22","264797"
"chr4","25486661","25486791","chr15","13362051","13362178","23","12124610"
"chr4","25522545","25522808","chr5","25258187","25258455","23","264358"
"chr4","25552966","25553266","chr5","25289503","25289795","34","263463"
"chr4","25562738","25563026","chrX","30235373","30235651","57","4672635"
"chr4","25566551","25566872","chr5","25302958","25303267","38","263593"
"chr4","25572174","25572448","chr5","25308790","25309058","30","263384"
"chr4","25580055","25580362","chr5","25316589","25316904","36","263466"
"chr4","25637875","25638162","chr5","25373819","25374114","30","264056"
"chr4","25650396","25650699","chr5","25386443","25386743","17","263953"
"chr4","25656426","25656696","chr5","25391197","25391487","36","265229"
"chr4","25665551","25665836","chr3","167305028","167305308","65","141639477"
"chr4","25668906","25668999","chr5","25404335","25404428","6","264571"
"chr4","25701234","25701516","chr5","25436975","25437257","15","264259"
"chr4","25717783","25718096","chr5","25450865","25451181","25","266918"
"chr4","25727566","25727854","chr5","25460696","25460994","33","266870"
"chr4","25736773","25736955","chr7","158781326","158781502","40","133044553"
"chr4","25737258","25737395","chr1","15031893","15032018","28","10705365"
"chr4","25745359","25745645","chr5","25479993","25480281","20","265366"
"chr4","25782119","25782319","chr5","25518598","25518797","15","263521"
"chr4","25826047","25826364","chr5","25562595","25562911","27","263452"
"chr4","25851484","25851622","chr1","102158767","102158902","31","76307283"
"chr4","25858408","25858687","chr5","25590085","25590352","33","268323"
"chr4","25870905","25871207","chr5","25602940","25603235","28","267965"
"chr4","25875087","25875312","chr16","55953387","55953607","44","30078300"
"chr4","25906790","25907096","chr5","25640165","25640468","35","266625"
"chr4","25913044","25913134","chr8","122314376","122314465","20","96401332"
"chr4","25918516","25918630","chr15","35525468","35525582","18","9606952"
"chr4","25921634","25921844","chr1","141026087","141026300","45","115104453"
"chr4","25951849","25952170","chr5","25686300","25686623","31","265549"
"chr4","25953913","25954220","chr5","25688362","25688678","32","265551"
"chr4","25956564","25956861","chr5","25690929","25691234","26","265635"
"chr4","25964389","25964696","chr5","25701897","25702215","35","262492"
"chr4","25967143","25967436","chr5","25705113","25705429","37","262030"
"chr4","25970440","25970741","chr1","44411796","44412097","60","18441356"
"chr4","26008878","26009171","chr5","25748512","25748805","24","260366"
"chr4","26025186","26025495","chr5","25764084","25764384","35","261102"
"chr4","26025602","26025865","chr5","25764487","25764751","20","261115"
"chr4","26035164","26035455","chr13","107408005","107408290","49","81372841"
"chr4","26055775","26055953","chr11","101104985","101105150","47","75049210"
"chr4","26056323","26056470","chr10","80160226","80160382","29","54103903"
"chr4","26062355","26062532","chr14","70262609","70262786","36","44200254"
"chr4","26064752","26064887","chr5","25806456","25806590","8","258296"
"chr4","26067348","26067637","chr20","27993097","27993383","56","1925749"
"chr4","26071789","26072081","chr14","51828477","51828775","66","25756688"
"chr4","26138249","26138364","chr13","12886800","12886913","20","13251449"
"chr4","26151967","26152275","chr5","25888055","25888343","37","263912"
"chr4","26173874","26174161","chr3","48177577","48177869","68","22003703"
"chr4","26176323","26176453","chr5","25911390","25911513","17","264933"
"chr4","26183787","26184117","chr5","25919464","25919776","35","264323"
"chr4","26186786","26187092","chr4","118260219","118260519","57","92073433"
"chr4","26213374","26213658","chr7","85702397","85702670","69","59489023"
"chr4","26238247","26238524","chr5","25977852","25978133","17","260395"
"chr4","26241117","26241408","chr5","25980749","25981053","30","260368"
"chr4","26314562","26314876","chr5","26048410","26048729","20","266152"
"chr4","26453064","26453367","chr5","26177789","26178084","25","275275"
"chr4","26490796","26491140","chr5","26213066","26213402","31","277730"
"chr4","26492590","26492902","chr5","26214978","26215282","26","277612"
"chr4","26633292","26633575","chr5","26362532","26362819","33","270760"
"chr4","26716609","26716720","chr5","26449090","26449201","11","267519"
"chr4","26807064","26807370","chr5","26546516","26546822","32","260548"
"chr4","26977802","26978095","chr11","63273330","63273621","61","36295528"
"chr4","27051503","27051768","chr5","26793377","26793642","16","258126"
"chr4","27073192","27073485","chr5","26815401","26815696","21","257791"
"chr4","27120760","27121032","chr5","26866954","26867226","26","253806"
"chr4","27142973","27143276","chr5","26888823","26889128","23","254150"
"chr4","27148424","27148734","chr5","26894314","26894629","29","254110"
"chr4","27221427","27221734","chr5","26977833","26978127","49","243594"
"chr4","27321029","27321316","chr5","27077564","27077857","26","243465"
"chr4","27399422","27399713","chr5","27162513","27162809","50","236909"
"chr4","27506518","27506647","chr5","27267488","27267617","5","239030"
"chr4","27770004","27770241","chr5","27521675","27521915","28","248329"
"chr4","27853230","27853557","chr5","27610531","27610858","22","242699"
"chr4","27861319","27861341","chr7","151672972","151672994","8","123811653"
"chr4","27863643","27863897","chr13","92466919","92467173","63","64603276"
"chr4","27867625","27867920","chr5","27625196","27625487","46","242429"
"chr4","28005399","28005528","chr5","27773653","27773780","11","231746"
"chr4","28122838","28123093","chrX","9704421","9704675","51","18418417"
"chr4","28283455","28283763","chr13","70734060","70734368","59","42450605"
"chr4","28375611","28375913","chr5","28164156","28164456","30","211455"
"chr4","28634925","28635203","chr5","28413518","28413802","30","221407"
"chr4","28669835","28670152","chr5","28453792","28454068","63","216043"
"chr4","28836435","28836716","chr5","28636900","28637181","22","199535"
"chr4","28885467","28885759","chr1","1700019","1700313","75","27185448"
"chr4","28989488","28989760","chr5","28801332","28801604","33","188156"
"chr4","28993563","28993861","chr12","73817603","73817890","72","44824040"
"chr4","29039877","29040149","chr5","28850577","28850820","56","189300"
"chr4","29093592","29093894","chr5","28908143","28908418","65","185449"
"chr4","29150530","29150827","chr5","28971565","28971829","52","178965"
"chr4","29226622","29226917","chr5","29045376","29045677","25","181246"
"chr4","29288655","29288992","chr1","121250490","121250817","75","91961835"
"chr4","29362999","29363305","chr5","29185766","29186074","29","177233"
"chr4","29595174","29595473","chr5","29435146","29435422","40","160028"
"chr4","29790810","29791055","chr5","29624965","29625203","28","165845"
"chr4","29846873","29846995","chrX","140971064","140971186","16","111124191"
"chr4","30169122","30169429","chr5","30008554","30008873","27","160568"
"chr4","30172793","30173092","chr5","30012230","30012539","35","160563"
"chr4","30386590","30386798","chr5","30235732","30235941","21","150858"
"chr4","30448476","30448766","chr5","30298751","30299050","49","149725"
"chr4","30490494","30490789","chr5","30341233","30341521","23","149261"
"chr4","30491738","30492043","chr5","30342445","30342755","19","149293"
"chr4","30527128","30527411","chr5","30376524","30376800","36","150604"
"chr4","30533748","30533977","chr5","30382604","30382832","17","151144"
"chr4","30576177","30576492","chr5","30425930","30426245","31","150247"
"chr4","30655762","30656055","chr5","30509125","30509415","37","146637"
"chr4","30656062","30656229","chr6","121805704","121805865","34","91149642"
"chr4","30721214","30721530","chr5","30575947","30576252","72","145267"
"chr4","30864412","30864668","chr5","30719520","30719788","26","144892"
"chr4","30879934","30880213","chr5","30735445","30735724","19","144489"
"chr4","30892968","30893275","chr10","73497926","73498218","75","42604958"
"chr4","30969594","30969881","chr5","30831912","30832218","33","137682"
"chr4","31131681","31131969","chr2","84913076","84913368","62","53781395"
"chr4","31206193","31206342","chr19","6765909","6766055","39","24440284"
"chr4","31449514","31449780","chr1","51864347","51864599","67","20414833"
"chr4","31468928","31469079","chr3","3805522","3805672","37","27663406"
"chr4","31523999","31524307","chr19","28669270","28669565","74","2854729"
"chr4","31566233","31566543","chr5","31451769","31452050","45","114464"
"chr4","31698020","31698207","chr2","53269651","53269834","49","21571631"
"chr4","31716022","31716308","chr5","31592990","31593278","19","123032"
"chr4","31744400","31744696","chr5","31619301","31619607","38","125099"
"chr4","31745955","31746051","chr2","184439175","184439260","19","152693220"
"chr4","32159134","32159445","chr5","32113972","32114284","25","45162"
"chr4","32227864","32228078","chr11","131124123","131124342","46","98896259"
"chr4","33012496","33012772","chr5","32370352","32370628","23","642144"
"chr4","33091945","33092233","chr5","32449272","32449533","54","642673"
"chr4","33111118","33111402","chr3","127361422","127361707","66","94250304"
"chr4","33154409","33154515","chrX","47541698","47541808","19","14387289"
"chr4","33214270","33214611","chr6","93662967","93663295","94","60448697"
"chr4","33245100","33245341","chr18","20111807","20112035","71","13133293"
"chr4","33495624","33495950","chr5","32856975","32857299","50","638649"
"chr4","33620114","33620397","chr5","32977029","32977325","34","643085"
"chr4","33630615","33630893","chr20","21003085","21003368","63","12627530"
"chr4","33657528","33657727","chr5","33010792","33010991","9","646736"
"chr4","33664486","33664761","chr12","11161034","11161316","67","22503452"
"chr4","33731265","33731556","chr5","33087727","33088015","19","643538"
"chr4","33755708","33756029","chr5","33113077","33113411","41","642631"
"chr4","33910495","33910787","chr5","33279022","33279321","42","631473"
"chr4","33917803","33917920","chr16","16389727","16389844","19","17528076"
"chr4","33976384","33976505","chr5","33355626","33355751","15","620758"
"chr4","33987161","33987467","chr5","33366173","33366479","27","620988"
"chr4","34058810","34058979","chr12","87917476","87917649","38","53858666"
"chr4","34253834","34253952","chr1","55555346","55555469","28","21301512"
"chr4","34257788","34258034","chr5","33642874","33643106","30","614914"
"chr4","34352881","34353158","chr5","33733628","33733912","40","619253"
"chr4","34441744","34441922","chr14","20073107","20073279","48","14368637"
"chr4","34539167","34539461","chr5","33902807","33903120","51","636360"
"chr4","34785021","34785306","chr5","34166530","34166818","38","618491"
"chr4","35006401","35006517","chr5","34425042","34425156","12","581359"
"chr4","35087880","35088169","chr5","34515315","34515610","21","572565"
"chr4","35106379","35106665","chr5","34532546","34532824","40","573833"
"chr4","35141419","35141603","chr8","98097983","98098163","51","62956564"
"chr4","35216446","35216726","chr5","34634269","34634551","40","582177"
"chr4","35248595","35248813","chr5","34664597","34664815","19","583998"
"chr4","35303318","35303647","chr5","42141877","42142205","91","6838559"
"chr4","35357559","35357842","chr5","34762077","34762351","28","595482"
"chr4","35475711","35475869","chr12","85591604","85591764","34","50115893"
"chr4","35562404","35562647","chr5","34957667","34957929","34","604737"
"chr4","35586394","35586698","chr19","39133570","39133877","65","3547176"
"chr4","35824768","35825056","chr5","35275178","35275469","30","549590"
"chr4","35829425","35829741","chr2","202333249","202333565","95","166503824"
"chr4","35852323","35852581","chr2","3434127","3434384","64","32418196"
"chr4","35899884","35899981","chr5","35347111","35347211","10","552773"
"chr4","36051520","36051800","chr5","35510065","35510337","30","541455"
"chr4","36304854","36305139","chr2","45901601","45901884","55","9596747"
"chr4","36531998","36532125","chr5","36003587","36003717","11","528411"
"chr4","36867779","36868052","chr16","70146711","70146978","68","33278932"
"chr4","36870203","36870497","chr5","36332598","36332895","32","537605"
"chr4","36920755","36921061","chr5","36381585","36381898","37","539170"
"chr4","37063150","37063412","chr3","38934767","38935033","59","1871617"
"chr4","37133987","37134110","chr5","36586593","36586715","6","547394"
"chr4","37182106","37182416","chr5","36633097","36633415","27","549009"
"chr4","37185847","37186142","chrX","64991673","64991978","74","27805826"
"chr4","37804173","37804347","chrX","19571236","19571401","38","18232937"
"chr4","37804766","37805035","chr5","37261936","37262205","13","542830"
"chr4","37820377","37820672","chr5","37277445","37277730","45","542932"
"chr4","37831845","37832139","chr8","127641570","127641859","55","89809725"
"chr4","37856361","37856667","chr5","37314313","37314601","33","542048"
"chr4","37874456","37874579","chr1","129880370","129880494","19","92005914"
"chr4","37890160","37890277","chr5","37350147","37350264","8","540013"
"chr4","37950472","37950774","chr5","37412601","37412875","52","537871"
"chr4","37995626","37995916","chr3","183694819","183695107","52","145699193"
"chr4","38015445","38015734","chr5","37476198","37476509","40","539247"
"chr4","38035222","38035422","chr5","37496143","37496341","12","539079"
"chr4","38104380","38104626","chr5","37565377","37565643","39","539003"
"chr4","38112921","38113209","chr5","37574200","37574490","18","538721"
"chr4","38222201","38222318","chr5","37683167","37683281","11","539034"
"chr4","38248667","38248970","chr9","5743881","5744173","61","32504786"
"chr4","38284878","38285181","chr5","37747609","37747903","34","537269"
"chr4","38367498","38367809","chr3","46869547","46869867","70","8502049"
"chr4","38379497","38379779","chr11","50535694","50535973","51","12156197"
"chr4","38392476","38392778","chr5","37854059","37854336","43","538417"
"chr4","38399156","38399346","chr5","37860423","37860614","10","538733"
"chr4","38489364","38489621","chr5","37966123","37966381","22","523241"
"chr4","38531508","38531804","chr5","38006297","38006593","14","525211"
"chr4","38552428","38552700","chr5","78034776","78035038","63","39482348"
"chr4","38604301","38604443","chr5","38083672","38083827","16","520629"
"chr4","38684534","38684744","chr5","38150647","38150849","26","533887"
"chr4","38696999","38697283","chr5","38163039","38163327","17","533960"
"chr4","38697796","38698080","chr5","38163852","38164127","41","533944"
"chr4","38712718","38713024","chr5","38177576","38177883","15","535142"
"chr4","38822468","38822767","chr5","38280868","38281179","32","541600"
"chr4","38867066","38867375","chr5","38325544","38325851","29","541522"
"chr4","38914578","38914862","chr5","38377199","38377453","47","537379"
"chr4","38963672","38963796","chr5","38429193","38429310","11","534479"
"chr4","38995095","38995390","chr5","38460795","38461082","22","534300"
"chr4","39003379","39003576","chr5","38469068","38469280","25","534311"
"chr4","39046434","39046731","chr8","28623574","28623869","58","10422860"
"chr4","39066854","39067118","chr5","38519976","38520240","18","546878"
"chr4","39069792","39070087","chr5","38522903","38523198","21","546889"
"chr4","39114386","39114696","chr1","8981776","8982081","60","30132610"
"chr4","39154591","39154768","chr8","25350058","25350236","30","13804533"
"chr4","39156937","39157150","chr13","107819277","107819468","54","68662340"
"chr4","39175912","39176196","chr5","38630381","38630676","31","545531"
"chr4","39203221","39203526","chr19","32872017","32872316","63","6331204"
"chr4","39214347","39214640","chr5","38665330","38665618","17","549017"
"chr4","39216734","39217008","chr5","38672489","38672761","20","544245"
"chr4","39221922","39222183","chr5","38677708","38677955","35","544214"
"chr4","39272648","39272937","chr5","38730235","38730539","54","542413"
"chr4","39297092","39297184","chr5","38755688","38755780","7","541404"
"chr4","39297490","39297660","chr5","38756089","38756264","15","541401"
"chr4","39309024","39309315","chr17","81291348","81291639","58","41982324"
"chr4","39317948","39318223","chr5","86925549","86925828","56","47607601"
"chr4","39325503","39325619","chr5","38778713","38778829","7","546790"
"chr4","39335070","39335325","chr5","38788200","38788454","21","546870"
"chr4","39394530","39394831","chr5","38840694","38840986","24","553836"
"chr4","39419245","39419541","chr5","38863801","38864085","31","555444"
"chr4","39421402","39421698","chr5","38865952","38866243","30","555450"
"chr4","39426150","39426505","chr10","81937384","81937691","101","42511234"
"chr4","39446242","39446512","chr5","38884303","38884592","35","561939"
"chr4","39484359","39484483","chr5","38926893","38927016","7","557466"
"chr4","39537586","39537859","chr5","38982650","38982951","44","554936"
"chr4","39554947","39555070","chr10","45386762","45386886","13","5831815"
"chr4","39567976","39568264","chr20","26912040","26912331","62","12655936"
"chr4","39570859","39570974","chr5","39017566","39017681","5","553293"
"chr4","39587001","39587203","chr5","39034264","39034479","27","552737"
"chr4","39598131","39598431","chr5","39045550","39045849","15","552581"
"chr4","39605508","39605618","chr4","51874979","51875091","27","12269471"
"chr4","39608447","39608738","chr5","39056028","39056336","38","552419"
"chr4","39608849","39608937","chr2","184439175","184439260","21","144830326"
"chr4","39645449","39645729","chr5","39095534","39095815","13","549915"
"chr4","39646904","39647194","chr5","39097020","39097301","38","549884"
"chr4","39679528","39679667","chr5","39130292","39130436","18","549236"
"chr4","39688458","39688768","chr7","116518734","116519041","66","76830276"
"chr4","39689048","39689332","chr5","39139891","39140171","19","549157"
"chr4","39695140","39695226","chr20","34166413","34166498","14","5528727"
"chr4","39695535","39695691","chr20","21940845","21941005","41","17754690"
"chr4","39725874","39726119","chr5","39232007","39232249","9","493867"
"chr4","39742468","39742780","chr6","35189860","35190164","60","4552608"
"chr4","39745302","39745611","chr5","39255080","39255394","22","490222"
"chr4","39753277","39753499","chrX","52841999","52842207","37","13088722"
"chr4","39760366","39760666","chr20","28109999","28110300","68","11650367"
"chr4","39768430","39768547","chr11","56084618","56084735","13","16316188"
"chr4","39771741","39772032","chr5","39271103","39271411","27","500638"
"chr4","39781728","39782022","chr5","39279232","39279532","20","502496"
"chr4","39786061","39786320","chr4","115129767","115130025","48","75343706"
"chr4","39810758","39811062","chr4","157144964","157145256","68","117334206"
"chr4","39821054","39821339","chr5","39319386","39319682","28","501668"
"chr4","39822897","39823142","chr5","39321106","39321339","36","501791"
"chr4","39829426","39829548","chr9","106471076","106471199","18","66641650"
"chr4","39839522","39839814","chr5","39343493","39343785","17","496029"
"chr4","39841349","39841658","chr5","39346003","39346298","35","495346"
"chr4","39861910","39862128","chr5","39369171","39369389","18","492739"
"chr4","39863467","39863749","chr13","65703304","65703594","60","25839837"
"chr4","39863938","39864235","chr3","65149988","65150281","60","25286050"
"chr4","39869150","39869399","chr18","22513444","22513691","67","17355706"
"chr4","39870923","39871216","chr5","39378847","39379133","39","492076"
"chr4","39873369","39873565","chr5","39381488","39381688","15","491881"
"chr4","39883124","39883415","chr5","39391530","39391821","15","491594"
"chr4","39887082","39887366","chr5","39396052","39396345","35","491030"
"chr4","39892478","39892789","chr8","38369272","38369586","80","1523206"
"chr4","39901133","39901401","chr1","186907121","186907386","44","147005988"
"chr4","39907988","39908136","chr5","39415363","39415511","18","492625"
"chr4","39924868","39924989","chr1","41882609","41882725","24","1957741"
"chr4","39930822","39930939","chr5","39440681","39440805","11","490141"
"chr4","39944980","39945202","chr5","39456081","39456303","15","488899"
"chr4","39945333","39945632","chr5","39456467","39456728","56","488866"
"chr4","39958620","39958825","chr5","39467543","39467775","41","491077"
"chr4","39971824","39972119","chr5","39482654","39482928","40","489170"
"chr4","39972366","39972684","chr15","43687639","43687935","77","3715273"
"chr4","39975057","39975393","chr5","40322008","40322330","79","346951"
"chr4","39992978","39993174","chr5","39502140","39502318","29","490838"
"chr4","39993482","39993596","chrX","40440621","40440736","12","447139"
"chr4","40001119","40001312","chr1","58348505","58348709","46","18347386"
"chr4","40010149","40010326","chr3","117785553","117785732","50","77775404"
"chr4","40030933","40031147","chr5","39544763","39544952","35","486170"
"chr4","40055485","40055748","chr11","55221279","55221540","70","15165794"
"chr4","40073961","40074239","chr7","42268119","42268393","58","2194158"
"chr4","40075248","40075295","chr9","51337129","51337181","15","11261881"
"chr4","40075595","40075775","chr5","39595048","39595226","15","480547"
"chr4","40087759","40087844","chr5","39606807","39606891","5","480952"
"chr4","40092885","40093155","chr5","39611592","39611876","27","481293"
"chr4","40093834","40094091","chr2","116189075","116189326","63","76095241"
"chr4","40094093","40094146","chr16","2262847","2262903","17","37831246"
"chr4","40115063","40115358","chr5","39632284","39632580","27","482779"
"chr4","40116879","40117174","chr5","39632284","39632580","58","484595"
"chr4","40125642","40125853","chr20","35094996","35095206","56","5030646"
"chr4","40139870","40139989","chr5","39663021","39663137","10","476849"
"chr4","40143271","40143559","chr10","80267093","80267391","71","40123822"
"chr4","40203307","40203574","chr12","114979940","114980222","63","74776633"
"chr4","40204570","40204866","chr5","39742683","39742974","25","461887"
"chr4","40215166","40215465","chr5","39758365","39758678","34","456801"
"chr4","40215800","40216091","chr5","39759008","39759290","40","456792"
"chr4","40220525","40220786","chr14","48496157","48496415","64","8275632"
"chr4","40224818","40225119","chr5","39768125","39768417","37","456693"
"chr4","40248960","40249260","chr5","39794192","39794503","22","454768"
"chr4","40264593","40264783","chr5","39808006","39808196","8","456587"
"chr4","40265899","40266188","chr1","21969926","21970214","57","18295973"
"chr4","40270980","40271286","chr5","39810097","39810396","31","460883"
"chr4","40285269","40285483","chr5","39824580","39824810","26","460689"
"chr4","40292718","40292835","chr11","70573457","70573574","13","30280739"
"chr4","40302411","40302718","chr5","39842422","39842731","14","459989"
"chr4","40307954","40308183","chr6","71524308","71524529","56","31216354"
"chr4","40309067","40309345","chr1","153113168","153113447","62","112804101"
"chr4","40309532","40309772","chr5","39849704","39849962","29","459828"
"chr4","40352821","40353124","chr5","39892862","39893177","36","459959"
"chr4","40401649","40401791","chr1","22499422","22499566","30","17902227"
"chr4","40417779","40418082","chr5","39958221","39958533","32","459558"
"chr4","40424782","40425097","chr5","39964608","39964915","27","460174"
"chr4","40454996","40455161","chr5","39993909","39994057","32","461087"
"chr4","40455463","40455601","chr5","39994359","39994495","6","461104"
"chr4","40457222","40457388","chr5","39995814","39995996","30","461408"
"chr4","40457415","40457537","chr5","39996030","39996152","8","461385"
"chr4","40459871","40460182","chr5","39998760","39999079","42","461111"
"chr4","40489741","40489947","chr5","40072433","40072637","17","417308"
"chr4","40500897","40501198","chr5","40086333","40086623","38","414564"
"chr4","40515892","40516102","chr13","75616065","75616265","41","35100173"
"chr4","40519342","40519466","chr5","40105342","40105469","15","414000"
"chr4","40529711","40529959","chr5","40116418","40116667","13","413293"
"chr4","40533118","40533408","chr2","44809541","44809832","50","4276423"
"chr4","40558655","40558824","chr10","83659293","83659458","38","43100638"
"chr4","40600617","40600714","chr4","15278126","15278223","16","25322491"
"chr4","40601978","40602262","chr6","15078628","15078906","54","25523350"
"chr4","40604852","40605139","chr5","40190657","40190932","29","414195"
"chr4","40605912","40606204","chr4","71517233","71517531","55","30911321"
"chr4","40620406","40620707","chr5","40205940","40206241","26","414466"
"chr4","40657976","40658271","chr7","140588016","140588306","61","99930040"
"chr4","40708412","40708587","chr7","41479584","41479757","29","771172"
"chr4","40708861","40708918","chr3","7315688","7315741","12","33393173"
"chr4","40713508","40713782","chr19","16268441","16268703","57","24445067"
"chr4","40717302","40717548","chr5","40305278","40305534","24","412024"
"chr4","40753657","40753964","chr5","40340984","40341271","41","412673"
"chr4","40772860","40773164","chr5","40361004","40361318","49","411856"
"chr4","40777095","40777402","chr5","40365330","40365630","22","411765"
"chr4","40791088","40791250","chr2","6391242","6391414","41","34399846"
"chr4","40821002","40821297","chr5","40412221","40412539","38","408781"
"chr4","40829091","40829217","chr5","40419915","40420040","8","409176"
"chr4","40830020","40830321","chr5","40420823","40421118","34","409197"
"chr4","40831437","40831564","chr2","44878801","44878925","20","4047364"
"chr4","40837811","40837924","chr14","70071051","70071162","18","29233240"
"chr4","40852804","40853008","chr6","153110581","153110780","47","112257777"
"chr4","40917660","40917942","chr5","40515951","40516240","30","401709"
"chr4","40952067","40952345","chr5","40546271","40546528","42","405796"
"chr4","40955301","40955533","chr9","95738470","95738706","39","54783169"
"chr4","40957701","40957894","chr10","85040491","85040692","46","44082790"
"chr4","40968892","40969181","chr5","40561898","40562184","28","406994"
"chr4","41003370","41003682","chr5","40596757","40597051","35","406613"
"chr4","41033705","41034034","chr13","62574372","62574673","82","21540667"
"chr4","41041746","41042048","chr5","40636481","40636778","34","405265"
"chr4","41056909","41057197","chr5","40652748","40653028","17","404161"
"chr4","41075262","41075570","chr5","40671017","40671326","33","404245"
"chr4","41104362","41104568","chr2","56487386","56487591","56","15383024"
"chr4","41114632","41114945","chr5","40709164","40709476","21","405468"
"chr4","41121310","41121486","chr5","40715841","40716017","16","405469"
"chr4","41121778","41121898","chr5","40716324","40716459","23","405454"
"chr4","41131570","41131865","chr5","40726514","40726810","16","405056"
"chr4","41136199","41136513","chr18","1158360","1158673","67","39977839"
"chr4","41150718","41151021","chr5","40743968","40744268","23","406750"
"chr4","41164989","41165291","chr5","40760865","40761170","31","404124"
"chr4","41166177","41166492","chrX","123872961","123873270","54","82706784"
"chr4","41168187","41168348","chr5","40763790","40763945","19","404397"
"chr4","41168349","41168625","chr5","40763946","40764223","30","404403"
"chr4","41168626","41168763","chr5","40764224","40764363","12","404402"
"chr4","41171965","41172262","chr5","40767574","40767871","14","404391"
"chr4","41212294","41212566","chr5","40808100","40808337","47","404194"
"chr4","41224549","41224670","chr5","40818727","40818859","20","405822"
"chr4","41237326","41237638","chr5","40831708","40832018","20","405618"
"chr4","41246147","41246479","chr5","40841177","40841479","49","404970"
"chr4","41249346","41249633","chr5","40844131","40844418","29","405215"
"chr4","41270528","41270818","chr5","40866180","40866472","26","404348"
"chr4","41305993","41306302","chr5","40902605","40902898","40","403388"
"chr4","41317903","41318047","chr5","40920145","40920282","15","397758"
"chr4","41318329","41318495","chr5","40920574","40920740","19","397755"
"chr4","41333509","41333813","chr5","40936460","40936764","30","397049"
"chr4","41334753","41335036","chr5","40937981","40938264","20","396772"
"chr4","41338157","41338492","chr5","40941722","40942068","33","396435"
"chr4","41400891","41401189","chr5","41007202","41007507","24","393689"
"chr4","41407827","41408114","chr5","41014156","41014460","34","393671"
"chr4","41410103","41410302","chr5","41015751","41015970","31","394352"
"chr4","41416704","41416993","chr5","41022160","41022440","23","394544"
"chr4","41438332","41438603","chr5","41043918","41044179","23","394414"
"chr4","41462993","41463266","chr5","41068957","41069228","25","394036"
"chr4","41484596","41484845","chr5","41087444","41087693","10","397152"
"chr4","41493427","41493725","chr5","41095986","41096289","26","397441"
"chr4","41503507","41503731","chr5","41105736","41105967","25","397771"
"chr4","41505002","41505283","chr3","41507864","41508152","61","2862"
"chr4","41505325","41505649","chr5","41107556","41107878","26","397769"
"chr4","41509720","41509972","chr5","41112155","41112399","32","397565"
"chr4","41516655","41516963","chr5","56317338","56317639","54","14800683"
"chr4","41518441","41518569","chr5","41120819","41120943","10","397622"
"chr4","41518607","41518641","chr5","41120969","41121004","1","397638"
"chr4","41521491","41521807","chr5","41123959","41124285","34","397532"
"chr4","41553072","41553196","chr5","41156601","41156724","8","396471"
"chr4","41579998","41580290","chr5","41182246","41182533","17","397752"
"chr4","41586092","41586376","chr5","41188321","41188604","30","397771"
"chr4","41631476","41631765","chr5","41236568","41236857","29","394908"
"chr4","41651482","41651772","chr5","41258764","41259049","33","392718"
"chr4","41750437","41750739","chr12","65551151","65551448","59","23800714"
"chr4","41759393","41759680","chr3","124267629","124267922","57","82508236"
"chr4","41764459","41764806","chr5","41369093","41369371","82","395366"
"chr4","41809259","41809547","chr13","65336897","65337186","60","23527638"
"chr4","41836993","41837320","chr3","137891231","137891557","70","96054238"
"chr4","41916351","41916704","chr5","41521465","41521809","79","394886"
"chr4","41933599","41933869","chr5","41538867","41539116","38","394732"
"chr4","42008281","42008613","chr5","41616595","41616933","30","391686"
"chr4","42023463","42023573","chrX","144692053","144692170","19","102668590"
"chr4","42067193","42067477","chr5","41675077","41675362","19","392116"
"chr4","42099096","42099382","chr14","32859064","32859345","69","9240032"
"chr4","42139938","42140229","chr5","41746259","41746533","39","393679"
"chr4","42143609","42143880","chr5","41749878","41750172","33","393731"
"chr4","42186020","42186304","chr5","41792721","41793006","22","393299"
"chr4","42194760","42195045","chr7","137856198","137856481","52","95661438"
"chr4","42221728","42222042","chr5","41834646","41834932","51","387082"
"chr4","42261032","42261056","chr5","41875872","41875896","2","385160"
"chr4","42261454","42261587","chr5","41876287","41876416","15","385167"
"chr4","42277493","42277774","chr5","41904204","41904485","21","373289"
"chr4","42279073","42279380","chr5","41905459","41905788","46","373614"
"chr4","42279908","42280023","chr1","219404678","219404802","25","177124770"
"chr4","42298045","42298338","chr5","41923745","41924039","31","374300"
"chr4","42300184","42300480","chr5","41925997","41926293","29","374187"
"chr4","42335298","42335555","chr5","41966291","41966549","20","369007"
"chr4","42390000","42390293","chr5","42025375","42025677","31","364625"
"chr4","42427501","42427813","chr5","42063352","42063664","18","364149"
"chr4","42449746","42450025","chr2","150902000","150902288","57","108452254"
"chr4","42466866","42466983","chr16","38853946","38854064","17","3612920"
"chr4","42468735","42469034","chr5","42102411","42102716","32","366324"
"chr4","42508466","42508758","chr5","42141877","42142205","53","366589"
"chr4","42512935","42513240","chr15","2493662","2493979","66","40019273"
"chr4","42519444","42519561","chr5","42153324","42153441","4","366120"
"chr4","42558464","42558768","chr3","64199068","64199370","65","21640604"
"chr4","42643656","42643950","chr5","42278676","42278963","20","364980"
"chr4","42647679","42647997","chr5","42283582","42283896","17","364097"
"chr4","42728498","42728803","chr5","42372946","42373235","35","355552"
"chr4","43055360","43055658","chr5","42718153","42718452","19","337207"
"chr4","43141899","43142093","chr20","21375220","21375416","53","21766679"
"chr4","43221741","43222026","chr5","42886649","42886935","23","335092"
"chr4","43234612","43234808","chr5","42900550","42900750","26","334062"
"chr4","43474916","43475157","chr5","43135919","43136155","19","338997"
"chr4","43540757","43540933","chr9","15628977","15629142","37","27911780"
"chr4","43580677","43580969","chr5","43252723","43253003","37","327954"
"chr4","43818888","43819164","chr5","43539003","43539279","15","279885"
"chr4","44180452","44180759","chr5","43883992","43884300","31","296460"
"chr4","44292392","44292637","chr19","12438308","12438546","58","31854084"
"chr4","44472451","44472756","chr20","21525221","21525520","67","22947230"
"chr4","44520201","44520485","chr5","44213670","44213946","29","306531"
"chr4","44579132","44579413","chr5","44278954","44279242","53","300178"
"chr4","44668628","44668913","chr12","83006376","83006658","70","38337748"
"chr4","44888881","44889075","chr5","44591761","44591957","16","297120"
"chr4","44941515","44941813","chr5","44638518","44638830","31","302997"
"chr4","44945063","44945348","chr5","44641721","44641986","51","303342"
"chr4","44960013","44960318","chr7","125864609","125864899","69","80904596"
"chr4","44965402","44965690","chr5","44672742","44673048","34","292660"
"chr4","45000102","45000379","chr5","49218085","49218386","41","4217983"
"chr4","45012772","45013105","chr5","49237315","49237620","55","4224543"
"chr4","45067036","45067325","chr5","49277173","49277476","29","4210137"
"chr4","45130957","45131233","chr5","49343861","49344143","26","4212904"
"chr4","45131393","45131717","chr5","49344248","49344565","34","4212855"
"chr4","45148397","45148682","chr3","124267629","124267922","56","79119232"
"chr4","45153755","45153989","chr5","49372938","49373172","21","4219183"
"chr4","45187540","45187847","chr9","99726642","99726948","73","54539102"
"chr4","45202390","45202628","chr5","49426781","49427020","16","4224391"
"chr4","45203165","45203401","chr5","49428063","49428327","44","4224898"
"chr4","45231761","45231897","chr1","142183123","142183260","22","96951362"
"chr4","45231968","45232134","chr19","41975098","41975257","52","3256870"
"chr4","45263239","45263546","chr5","49489184","49489482","29","4225945"
"chr4","45282618","45282920","chr5","49505040","49505357","35","4222422"
"chr4","45316866","45317141","chr5","49538944","49539219","21","4222078"
"chr4","45321042","45321156","chr5","49543249","49543363","7","4222207"
"chr4","45332624","45332903","chr5","49554830","49555118","27","4222206"
"chr4","45357298","45357422","chr13","25546692","25546816","17","19810606"
"chr4","45402419","45402700","chr5","49623186","49623498","44","4220767"
"chr4","45421195","45421381","chr9","86855636","86855825","40","41434441"
"chr4","45430019","45430323","chr5","49658142","49658454","23","4228123"
"chr4","45450895","45451196","chrX","53873075","53873371","61","8422180"
"chr4","45454811","45455078","chr6","64075568","64075827","59","18620757"
"chr4","45459860","45459979","chr5","49688071","49688193","11","4228211"
"chr4","45470535","45470793","chr7","166255526","166255782","64","120784991"
"chr4","45496177","45496491","chr5","49737270","49737575","24","4241093"
"chr4","45500001","45500208","chr19","6501771","6501986","65","38998230"
"chr4","45526682","45526969","chr5","49765933","49766228","35","4239251"
"chr4","45578882","45579170","chrX","125989015","125989296","53","80410133"
"chr4","45627271","45627573","chr5","49866157","49866442","38","4238886"
"chr4","45673396","45673640","chr12","53942015","53942257","61","8268619"
"chr4","45801472","45801783","chr5","50070826","50071120","33","4269354"
"chr4","45926976","45927265","chr5","50191159","50191447","10","4264183"
"chr4","45981406","45981505","chr6","169656271","169656367","18","123674865"
"chr4","46069111","46069378","chr5","50344419","50344689","48","4275308"
"chr4","46108130","46108459","chr5","50379736","50380028","52","4271606"
"chr4","46134338","46134615","chr5","50412784","50413060","25","4278446"
"chr4","46349585","46349860","chr5","50624914","50625200","26","4275329"
"chr4","46392894","46393071","chr5","50669555","50669734","13","4276661"
"chr4","46433405","46433694","chr5","50711969","50712266","27","4278564"
"chr4","46444532","46444794","chr5","50722558","50722851","43","4278026"
"chr4","46478243","46478536","chr5","50758079","50758371","27","4279836"
"chr4","46505338","46505453","chr8","38576227","38576342","15","7929111"
"chr4","46514475","46514764","chr5","50793201","50793493","17","4278726"
"chr4","46521299","46521585","chr8","129433118","129433406","54","82911819"
"chr4","46524996","46525151","chrX","10632766","10632921","41","35892230"
"chr4","46527377","46527684","chr5","50800794","50801085","31","4273417"
"chr4","46538952","46539151","chr5","50812933","50813130","17","4273981"
"chr4","46553117","46553287","chr6","68146972","68147145","49","21593855"
"chr4","46553570","46553606","chr4","120908708","120908743","10","74355138"
"chr4","46553914","46554046","chr1","16216913","16217045","28","30337001"
"chr4","46580326","46580451","chr2","107844001","107844127","20","61263675"
"chr4","46595229","46595539","chr3","126344900","126345208","60","79749671"
"chr4","46598549","46598840","chr5","50874362","50874620","51","4275813"
"chr4","46599756","46599895","chr5","50875545","50875689","17","4275789"
"chr4","46600167","46600358","chr5","50875953","50876133","42","4275786"
"chr4","46607881","46608149","chr9","110181990","110182266","50","63574109"
"chr4","46621533","46621675","chr1","153250707","153250848","30","106629174"
"chr4","46621961","46622106","chr1","34398287","34398429","34","12223674"
"chr4","46625940","46626205","chr1","89734834","89735093","67","43108894"
"chr4","46629636","46629930","chr4","7105213","7105513","60","39524423"
"chr4","46630534","46630811","chr5","50906466","50906744","40","4275932"
"chr4","46632232","46632497","chr5","50908209","50908468","24","4275977"
"chr4","46637944","46638140","chr5","50913897","50914078","25","4275953"
"chr4","46648611","46648913","chr5","50918323","50918626","9","4269712"
"chr4","46652203","46652348","chr5","50921905","50922051","8","4269702"
"chr4","46672785","46673095","chr2","75894987","75895298","58","29222202"
"chr4","46675552","46675756","chr13","44257104","44257310","44","2418448"
"chr4","46683429","46683741","chr5","50955437","50955753","15","4272008"
"chr4","46685207","46685507","chr5","50957248","50957546","23","4272041"
"chr4","46689219","46689350","chr11","121219101","121219227","17","74529882"
"chr4","46689431","46689720","chr20","25684721","25685017","60","21004710"
"chr4","46705681","46705993","chr5","50976713","50977024","21","4271032"
"chr4","46721479","46721595","chr5","50992750","50992866","5","4271271"
"chr4","46723209","46723515","chr5","50994537","50994813","54","4271328"
"chr4","46736098","46736377","chr5","51003237","51003514","25","4267139"
"chr4","46736579","46736869","chr5","51003722","51004014","29","4267143"
"chr4","46739345","46739488","chr5","51006492","51006634","8","4267147"
"chr4","46740601","46740631","chr5","55395637","55395664","10","8655036"
"chr4","46741363","46741522","chr5","51008800","51008951","14","4267437"
"chr4","46752844","46753110","chr5","51021561","51021827","18","4268717"
"chr4","46761516","46761744","chr5","51031300","51031545","32","4269784"
"chr4","46773667","46773980","chrUn_NW_014806094v1","67","376","64","46773600"
"chr4","46780461","46780752","chr5","51049809","51050089","30","4269348"
"chr4","46810527","46810649","chr5","51077959","51078081","9","4267432"
"chr4","46822111","46822403","chr5","51094461","51094748","40","4272350"
"chr4","46853639","46853941","chr9","35488681","35488984","71","11364958"
"chr4","46902003","46902301","chr5","51209440","51209743","28","4307437"
"chr4","46903963","46904063","chr5","51211395","51211514","21","4307432"
"chr4","46904421","46904611","chr5","51211872","51212056","21","4307451"
"chr4","46911686","46911972","chr5","51218573","51218857","21","4306887"
"chr4","46919284","46919577","chr5","51226828","51227133","28","4307544"
"chr4","46934152","46934423","chr16","24886270","24886545","65","22047882"
"chr4","46942527","46942832","chr5","51249100","51249395","25","4306573"
"chr4","46964578","46964683","chr3","55571720","55571831","17","8607142"
"chr4","46978460","46978576","chr19","10442881","10442997","5","36535579"
"chr4","46988541","46988685","chr5","51283123","51283265","9","4294582"
"chr4","46988975","46989144","chr5","51283561","51283733","13","4294586"
"chr4","46991039","46991319","chr5","185678151","185678451","64","138687112"
"chr4","46991331","46991602","chr5","51286495","51286752","29","4295164"
"chr4","46994371","46994488","chr9","54332676","54332800","26","7338305"
"chr4","47004683","47004986","chr5","51298996","51299291","25","4294313"
"chr4","47020302","47020437","chr3","50262642","50262767","24","3242340"
"chr4","47029409","47029689","chr5","51322379","51322663","23","4292970"
"chr4","47031693","47031900","chr5","151209638","151209845","54","104177945"
"chr4","47038431","47038622","chrX","52447863","52448045","37","5409432"
"chr4","47052284","47052588","chr5","51346127","51346434","28","4293843"
"chr4","47055435","47055726","chr5","51348903","51349201","20","4293468"
"chr4","47056827","47057130","chr5","51350304","51350607","15","4293477"
"chr4","47085465","47085682","chr5","51375008","51375226","27","4289543"
"chr4","47153176","47153430","chr5","51449135","51449398","25","4295959"
"chr4","47162122","47162408","chr5","51458402","51458680","31","4296280"
"chr4","47184102","47184345","chr5","51482649","51482894","10","4298547"
"chr4","47194470","47194772","chr5","51498235","51498534","21","4303765"
"chr4","47211635","47211939","chr5","51515511","51515811","24","4303876"
"chr4","47239891","47240173","chr5","51546221","51546504","19","4306330"
"chr4","47243151","47243418","chr10","15268857","15269103","55","31974294"
"chr4","47258889","47259149","chr5","51567445","51567731","34","4308556"
"chr4","47296433","47296704","chr10","26768717","26768984","60","20527716"
"chr4","47311131","47311423","chr5","51621094","51621364","27","4309963"
"chr4","47311474","47311735","chr5","51621425","51621686","16","4309951"
"chr4","47317993","47318287","chr5","51627565","51627858","20","4309572"
"chr4","47333733","47334051","chr5","51644481","51644795","16","4310748"
"chr4","47334468","47334769","chr5","51645190","51645502","29","4310722"
"chr4","47390017","47390197","chr7","129571844","129572031","43","82181827"
"chr4","47390521","47390642","chrX","41627824","41627940","15","5762697"
"chr4","47393140","47393433","chr5","51703674","51703968","25","4310534"
"chr4","47443572","47443879","chr5","51754919","51755224","12","4311347"
"chr4","47450839","47451135","chr5","51760723","51761020","22","4309884"
"chr4","47516306","47516585","chr5","51826673","51826973","45","4310367"
"chr4","47527165","47527454","chr10","62713234","62713530","52","15186069"
"chr4","47565733","47565910","chr6","67603718","67603884","41","20037985"
"chr4","47567320","47567538","chr5","51886995","51887206","23","4319675"
"chr4","47600173","47600365","chr20","66215016","66215210","49","18614843"
"chr4","47606535","47606838","chr5","51940994","51941287","30","4334459"
"chr4","47613128","47613399","chr5","51959320","51959585","21","4346192"
"chr4","47614676","47614795","chr3","65685104","65685225","18","18070428"
"chr4","47636309","47636449","chr1","92962365","92962502","26","45326056"
"chr4","47636741","47636882","chr5","51984497","51984637","8","4347756"
"chr4","47641243","47641559","chr5","51988866","51989188","40","4347623"
"chr4","47641720","47642013","chr5","51989375","51989672","23","4347655"
"chr4","47673793","47674050","chr5","52027320","52027574","22","4353527"
"chr4","47683127","47683385","chr5","52036589","52036866","61","4353462"
"chr4","47697720","47697996","chr5","52051163","52051433","39","4353443"
"chr4","47791694","47791990","chr5","52134944","52135232","41","4343250"
"chr4","47807553","47807905","chr5","52150724","52151075","30","4343171"
"chr4","47815878","47816175","chr2","84913076","84913368","53","37097198"
"chr4","47828906","47829147","chr5","52171932","52172163","26","4343026"
"chr4","47927691","47927815","chr15","91152840","91152964","14","43225149"
"chr4","47946891","47947195","chr5","52283795","52284101","24","4336904"
"chr4","48008422","48008712","chr15","48250296","48250575","63","241874"
"chr4","48022210","48022520","chr5","52356982","52357292","29","4334772"
"chr4","48152791","48153075","chr5","52481645","52481930","20","4328854"
"chr4","48198907","48199201","chr2","160551205","160551504","55","112352298"
"chr4","48214876","48215179","chr2","84913076","84913368","60","36698200"
"chr4","48254342","48254618","chr5","52584574","52584849","17","4330232"
"chr4","48303767","48303881","chr5","128066868","128066980","20","79763101"
"chr4","48323470","48323735","chr5","52652924","52653210","45","4329454"
"chr4","48429453","48429742","chr19","30007363","30007647","54","18422090"
"chr4","48498977","48499255","chr5","52831979","52832250","29","4333002"
"chr4","48514082","48514375","chr5","52842981","52843276","19","4328899"
"chr4","48537709","48538002","chr5","52869343","52869641","25","4331634"
"chr4","48553800","48553996","chr5","52884885","52885086","15","4331085"
"chr4","48592214","48592506","chr5","52923396","52923686","23","4331182"
"chr4","48613035","48613309","chr5","52944459","52944732","22","4331424"
"chr4","48637009","48637312","chr6","136763929","136764230","71","88126920"
"chr4","48656819","48657115","chr5","52987325","52987622","16","4330506"
"chr4","48805246","48805376","chr14","8489247","8489379","21","40315999"
"chr4","48823798","48824092","chr5","53151980","53152275","18","4328182"
"chr4","48953291","48953559","chr5","53456490","53456791","52","4503199"
"chr4","49092921","49093214","chr5","53310666","53310990","57","4217745"
"chr4","49272711","49273006","chr5","53620456","53620752","20","4347745"
"chr4","49355305","49355576","chr13","107408005","107408290","67","58052700"
"chr4","49396824","49397082","chr7","36926261","36926510","80","12470563"
"chr4","49500209","49500500","chr7","113150637","113150924","65","63650428"
"chr4","49557271","49557388","chr6","152170708","152170830","23","102613437"
"chr4","49593290","49593621","chr5","53949997","53950287","66","4356707"
"chr4","49645858","49646154","chr5","54004357","54004641","38","4358499"
"chr4","49734961","49735258","chr5","54091395","54091730","51","4356434"
"chr4","49788390","49788680","chr5","54145501","54145819","52","4357111"
"chr4","49791856","49792166","chr7","21735439","21735747","69","28056417"
"chr4","49803632","49803911","chr5","54210460","54210736","22","4406828"
"chr4","49831965","49832257","chr5","54238907","54239214","31","4406942"
"chr4","49872529","49872825","chr1","43902169","43902461","70","5970360"
"chr4","49932034","49932171","chr5","54343007","54343144","9","4410973"
"chr4","49933285","49933555","chr5","54344256","54344526","25","4410971"
"chr4","49986111","49986389","chr5","54397896","54398176","23","4411785"
"chr4","50046027","50046185","chr5","54513796","54513955","16","4467769"
"chr4","50193583","50193708","chr1","205464254","205464380","20","155270671"
"chr4","50236636","50236949","chr3","46869547","46869867","71","3367089"
"chr4","50491446","50491750","chr7","111736578","111736881","62","61245132"
"chr4","50494489","50494793","chr5","55007557","55007862","23","4513068"
"chr4","50592539","50592836","chr5","55105747","55106056","55","4513208"
"chr4","50643102","50643388","chr5","55157442","55157728","18","4514340"
"chr4","50709092","50709231","chr5","55231918","55232042","22","4522826"
"chr4","50717444","50717743","chr5","55240279","55240577","23","4522835"
"chr4","50745175","50745476","chr11","117366311","117366614","62","66621136"
"chr4","50767722","50767801","chr13","29152359","29152438","11","21615363"
"chr4","50769548","50769649","chr8","22929982","22930079","22","27839566"
"chr4","50867247","50867274","chr5","55395637","55395664","2","4528390"
"chr4","50867545","50867794","chr5","55395951","55396196","26","4528406"
"chr4","50891417","50891581","chr5","55420252","55420417","7","4528835"
"chr4","51007435","51007705","chr5","55546043","55546308","46","4538608"
"chr4","51116634","51116794","chr5","55650353","55650513","24","4533719"
"chr4","51116829","51116943","chr5","55650544","55650653","10","4533715"
"chr4","51140098","51140408","chr5","55673476","55673769","35","4533378"
"chr4","51145377","51145672","chr5","55678757","55679045","30","4533380"
"chr4","51147571","51147846","chr5","55680930","55681209","22","4533359"
"chr4","51150386","51150524","chr5","55683661","55683797","7","4533275"
"chr4","51157455","51157727","chr1","21560196","21560484","63","29597259"
"chr4","51188609","51188917","chr5","55724064","55724373","30","4535455"
"chr4","51203654","51203931","chr5","55739126","55739402","24","4535472"
"chr4","51245176","51245467","chr5","55781483","55781770","24","4536307"
"chr4","51256241","51256355","chr5","55791101","55791218","10","4534860"
"chr4","51269017","51269230","chr5","55803801","55804016","17","4534784"
"chr4","51273032","51273154","chr5","55807771","55807893","7","4534739"
"chr4","51279016","51279313","chr5","55814379","55814678","17","4535363"
"chr4","51297180","51297489","chrX","47948010","47948306","73","3349170"
"chr4","51297821","51298129","chr5","55832324","55832631","27","4534503"
"chr4","51305573","51305885","chr15","43687639","43687935","69","7617934"
"chr4","51315803","51316106","chr5","55851099","55851385","40","4535296"
"chr4","51317077","51317354","chr5","55852089","55852367","17","4535012"
"chr4","51317560","51317662","chr5","55852573","55852675","6","4535013"
"chr4","51334230","51334543","chr5","55864357","55864689","41","4530127"
"chr4","51348064","51348357","chr5","55879427","55879722","21","4531363"
"chr4","51357623","51357934","chr8","32459685","32459997","59","18897938"
"chr4","51360726","51361022","chr7","140100928","140101221","52","88740202"
"chr4","51363473","51363792","chr11","108048340","108048636","84","56684867"
"chr4","51368142","51368421","chr5","55900992","55901275","24","4532850"
"chr4","51375452","51375575","chr5","55908284","55908406","10","4532832"
"chr4","51391298","51391594","chr5","55924097","55924400","31","4532799"
"chr4","51402333","51402623","chr5","55945161","55945451","17","4542828"
"chr4","51414783","51414951","chr19","30446361","30446531","44","20968422"
"chr4","51431083","51431387","chr5","55963416","55963719","30","4532333"
"chr4","51443359","51443724","chrX","47229042","47229392","100","4214317"
"chr4","51459669","51459927","chr15","7539679","7539930","64","43919990"
"chr4","51471985","51472291","chr5","56005213","56005488","51","4533228"
"chr4","51487464","51487766","chr14","110784419","110784717","58","59296955"
"chr4","51542520","51542740","chr5","56081681","56081889","28","4539161"
"chr4","51598365","51598669","chr5","56139139","56139443","10","4540774"
"chr4","51673766","51674072","chr5","56215833","56216137","27","4542067"
"chr4","51683268","51683560","chr5","56225476","56225771","13","4542208"
"chr4","51699977","51700279","chr5","56242153","56242456","21","4542176"
"chr4","51939214","51939378","chr8","29653012","29653169","45","22286202"
"chr4","51990042","51990321","chr5","56490737","56491018","20","4500695"
"chr4","52038122","52038340","chr5","56540327","56540546","10","4502205"
"chr4","52076036","52076347","chr5","56571874","56572193","42","4495838"
"chr4","52076828","52077124","chr5","56572718","56573001","53","4495890"
"chr4","52133122","52133431","chr5","56628758","56629065","38","4495636"
"chr4","52150249","52150526","chr5","56644786","56645070","19","4494537"
"chr4","52151675","52151839","chr5","56646560","56646724","13","4494885"
"chr4","52157709","52158004","chr5","56652641","56652939","20","4494932"
"chr4","52178529","52178828","chr5","56675948","56676237","33","4497419"
"chr4","52194516","52194806","chr6","161557509","161557798","54","109362993"
"chr4","52199721","52200100","chr1","95711594","95711938","128","43511873"
"chr4","52240017","52240261","chr5","56740891","56741136","17","4500874"
"chr4","52240414","52240704","chr5","56741601","56741891","18","4501187"
"chr4","52249744","52249985","chr5","56751034","56751279","20","4501290"
"chr4","52256773","52257090","chr5","56758143","56758452","23","4501370"
"chr4","52279019","52279311","chr5","56777663","56777951","15","4498644"
"chr4","52288264","52288495","chr5","56785963","56786194","21","4497699"
"chr4","52318743","52319046","chr8","42885230","42885538","75","9433513"
"chr4","52346586","52346889","chr5","56842429","56842734","16","4495843"
"chr4","52379040","52379318","chr5","56873103","56873395","28","4494063"
"chr4","52413144","52413435","chr14","115049792","115050083","56","62636648"
"chr4","52427459","52427577","chr5","56924014","56924133","2","4496555"
"chr4","52430931","52431153","chrX","51567105","51567331","55","863826"
"chr4","52483496","52483773","chr12","123968383","123968654","75","71484887"
"chr4","52542138","52542438","chr5","57025229","57025526","17","4483091"
"chr4","52612872","52613122","chr1","110019322","110019585","75","57406450"
"chr4","52852486","52852794","chr13","27963158","27963457","57","24889328"
"chr4","52859268","52859575","chr5","57361384","57361694","24","4502116"
"chr4","52890538","52890839","chr5","57392576","57392903","44","4502038"
"chr4","52895881","52896150","chr5","57398257","57398525","14","4502376"
"chr4","52896510","52896636","chr5","57398888","57399020","13","4502378"
"chr4","52905042","52905328","chr5","57408214","57408500","20","4503172"
"chr4","52909402","52909506","chr1","125220606","125220704","25","72311204"
"chr4","52909621","52909778","chr1","19925804","19925957","37","32983817"
"chr4","52946279","52946581","chr5","57453729","57454034","24","4507450"
"chr4","52952455","52952736","chr5","57459929","57460224","40","4507474"
"chr4","52953898","52954124","chr5","57461424","57461652","11","4507526"
"chr4","52972287","52972571","chr7","136152194","136152470","66","83179907"
"chr4","52977127","52977388","chr5","57482362","57482623","28","4505235"
"chr4","52982051","52982336","chr5","57487532","57487806","23","4505481"
"chr4","53001412","53001691","chr5","57506081","57506363","11","4504669"
"chr4","53002060","53002347","chr5","57506735","57507005","31","4504675"
"chr4","53019355","53019651","chr5","57524585","57524887","26","4505230"
"chr4","53085695","53085829","chr7","45689838","45689967","25","7395857"
"chr4","53113792","53114108","chr5","57617925","57618244","23","4504133"
"chr4","53115152","53115453","chr5","57619304","57619614","23","4504152"
"chr4","53122649","53122936","chr5","51322379","51322663","54","1800270"
"chr4","53123801","53124074","chr5","57628244","57628517","12","4504443"
"chr4","53167151","53167369","chr5","57672110","57672319","35","4504959"
"chr4","53214040","53214327","chr5","57716775","57717074","39","4502735"
"chr4","53216681","53216991","chr5","57719418","57719707","42","4502737"
"chr4","53219379","53219680","chr5","57722146","57722448","36","4502767"
"chr4","53226842","53227155","chr5","57731643","57731953","43","4504801"
"chr4","53231499","53231808","chr5","57736299","57736605","23","4504800"
"chr4","53241796","53242090","chr5","57746992","57747293","54","4505196"
"chr4","53313564","53313705","chr5","57822776","57822902","21","4509212"
"chr4","53342961","53343269","chr5","57853356","57853664","22","4510395"
"chr4","53354216","53354489","chr5","57864318","57864551","50","4510102"
"chr4","53364624","53364910","chr5","57875919","57876205","15","4511295"
"chr4","53372887","53373191","chr9","13117729","13118036","62","40255158"
"chr4","53379324","53379609","chr5","57891674","57891963","23","4512350"
"chr4","53392029","53392339","chr5","57904665","57904975","18","4512636"
"chr4","53401712","53401907","chr5","57913331","57913535","23","4511619"
"chr4","53421979","53422271","chr5","57934987","57935280","27","4513008"
"chr4","53441845","53442124","chr2","71665091","71665377","63","18223246"
"chr4","53476332","53476610","chr5","57990483","57990766","23","4514151"
"chr4","53491094","53491371","chr5","58005613","58005885","21","4514519"
"chr4","53536402","53536686","chr5","58050088","58050383","22","4513686"
"chr4","53541237","53541539","chr5","58054927","58055227","21","4513690"
"chr4","53557752","53558061","chr5","58071716","58072017","28","4513964"
"chr4","53568720","53569018","chr6","6301868","6302166","49","47266852"
"chr4","53588700","53588977","chr5","58102280","58102561","27","4513580"
"chr4","53598013","53598298","chr3","40783093","40783379","64","12814920"
"chr4","53614985","53615102","chr5","58128713","58128830","6","4513728"
"chr4","53626367","53626638","chr1","32129278","32129554","63","21497089"
"chr4","53627057","53627348","chr5","58139235","58139519","22","4512178"
"chr4","53628105","53628229","chr5","58140236","58140360","4","4512131"
"chr4","53629142","53629443","chr5","58141273","58141559","30","4512131"
"chr4","53666100","53666367","chr5","58178202","58178472","17","4512102"
"chr4","53698053","53698317","chr3","92949155","92949418","72","39251102"
"chr4","53726783","53726905","chr5","58247794","58247916","4","4521011"
"chr4","53737517","53737598","chr16","44224787","44224868","13","9512730"
"chr4","53765763","53766067","chr5","58280220","58280517","31","4514457"
"chr4","53770566","53770720","chr7","10227085","10227248","34","43543481"
"chr4","53771032","53771177","chr12","87690105","87690243","30","33919073"
"chr4","53808799","53809070","chr5","58321906","58322177","23","4513107"
"chr4","53823008","53823297","chr5","58333872","58334141","34","4510864"
"chr4","53826063","53826362","chr5","58336931","58337232","15","4510868"
"chr4","53862755","53863048","chr5","58374664","58374949","25","4511909"
"chr4","53870979","53871298","chr14","69384104","69384414","64","15513125"
"chr4","53872065","53872340","chr5","58383917","58384177","52","4511852"
"chr4","53911375","53911715","chr1","8160350","8160658","99","45751025"
"chr4","53922584","53922764","chr5","58433828","58434005","13","4511244"
"chr4","53924626","53924924","chr5","58435736","58436059","42","4511110"
"chr4","53930165","53930464","chr5","58441284","58441584","22","4511119"
"chr4","53932244","53932370","chr18","8658222","8658357","21","45274022"
"chr4","53946746","53947031","chr5","58457971","58458249","38","4511225"
"chr4","53950801","53951112","chr5","58462017","58462330","27","4511216"
"chr4","53961032","53961257","chr1","222943933","222944161","36","168982901"
"chr4","54049473","54049600","chr9","97930771","97930897","21","43881298"
"chr4","54049896","54050053","chr5","58557756","58557920","14","4507860"
"chr4","54056661","54056945","chr11","118569447","118569730","58","64512786"
"chr4","54059223","54059501","chr5","58565912","58566184","21","4506689"
"chr4","54064676","54064988","chr5","58571029","58571307","50","4506353"
"chr4","54096475","54096756","chr5","58600619","58600896","25","4504144"
"chr4","54110885","54111169","chr11","78608626","78608891","63","24497741"
"chr4","54114239","54114341","chr9","6051471","6051572","21","48062768"
"chr4","54134052","54134176","chr6","179661185","179661307","29","125527133"
"chr4","54134460","54134630","chr12","94013946","94014112","35","39879486"
"chr4","54135350","54135588","chr3","85075977","85076214","68","30940627"
"chr4","54138124","54138368","chr5","58640510","58640751","16","4502386"
"chr4","54142333","54142506","chr5","58645345","58645535","30","4503012"
"chr4","54149198","54149364","chr5","58651995","58652158","11","4502797"
"chr4","54158859","54158985","chr5","58661067","58661194","3","4502208"
"chr4","54174496","54174806","chr5","58674127","58674432","31","4499631"
"chr4","54249838","54250067","chr5","58758312","58758541","17","4508474"
"chr4","54258686","54258988","chr5","58766876","58767173","25","4508190"
"chr4","54274570","54274872","chr10","81908379","81908683","53","27633809"
"chr4","54294089","54294362","chr5","58810188","58810477","35","4516099"
"chr4","54301121","54301413","chr5","58812508","58812803","27","4511387"
"chr4","54305885","54306190","chr5","58817191","58817472","31","4511306"
"chr4","54330206","54330506","chr5","58845044","58845352","24","4514838"
"chr4","54343285","54343558","chr5","58855876","58856147","30","4512591"
"chr4","54348199","54348430","chr5","58861493","58861735","18","4513294"
"chr4","54350748","54350874","chr5","58864037","58864164","4","4513289"
"chr4","54363528","54363797","chr1","155141171","155141450","74","100777643"
"chr4","54378472","54378632","chr6","121032982","121033144","53","66654510"
"chr4","54378659","54378743","chr20","6674896","6674976","20","47703763"
"chr4","54396055","54396336","chr11","121178437","121178716","57","66782382"
"chr4","54404562","54404842","chr2","68173712","68173989","52","13769150"
"chr4","54424894","54425201","chr5","58941311","58941619","22","4516417"
"chr4","54444948","54445262","chr2","84913076","84913368","67","30468128"
"chr4","54448840","54449134","chr5","58964275","58964576","32","4515435"
"chr4","54450261","54450647","chr5","58965709","58966051","69","4515448"
"chr4","54454338","54454637","chr5","58969892","58970204","28","4515554"
"chr4","54559229","54559503","chr5","59081659","59081940","32","4522430"
"chr4","54590508","54590762","chr1","186907121","186907386","64","132316613"
"chr4","54591951","54592011","chr6","167959065","167959123","14","113367114"
"chr4","54637528","54637777","chr5","59155331","59155601","37","4517803"
"chr4","54731234","54731525","chr5","59264245","59264538","19","4533011"
"chr4","54789053","54789179","chr4","73819458","73819584","18","19030405"
"chr4","54876551","54876820","chr5","59389057","59389307","36","4512506"
"chr4","54903368","54903665","chr5","59415584","59415880","20","4512216"
"chr4","54911888","54911981","chr5","59418538","59418617","19","4506650"
"chr4","55101389","55101670","chr5","59632687","59632973","41","4531298"
"chr4","55112596","55112862","chr12","87749598","87749866","59","32637002"
"chr4","55238986","55239095","chr5","59772102","59772211","3","4533116"
"chr4","55291527","55291835","chr3","61602105","61602418","63","6310578"
"chr4","55298033","55298256","chr5","59827745","59827965","24","4529712"
"chr4","55345503","55345729","chr5","59873836","59874062","16","4528333"
"chr4","55384153","55384329","chr16","4999830","5000000","40","50384323"
"chr4","55427927","55428026","chr5","59960978","59961075","9","4533051"
"chr4","55615232","55615532","chr5","60170567","60170856","37","4555335"
"chr4","55664923","55665229","chr5","60218668","60218985","26","4553745"
"chr4","55694966","55695222","chr5","25764487","25764751","61","29930479"
"chr4","55720498","55720770","chr5","60276056","60276328","26","4555558"
"chr4","56039431","56039541","chr5","60679418","60679528","11","4639987"
"chr4","56255337","56255624","chr5","60924657","60924954","38","4669320"
"chr4","56492162","56492473","chr5","61154315","61154625","25","4662153"
"chr4","56537508","56537665","chr5","61200210","61200395","40","4662702"
"chr4","56630947","56631240","chr7","140100928","140101221","54","83469981"
"chr4","56674401","56674701","chr5","61333279","61333581","32","4658878"
"chr4","56711511","56711819","chr5","61365113","61365416","21","4653602"
"chr4","56711914","56712028","chr5","61365504","61365631","21","4653590"
"chr4","56724474","56724787","chr5","61377892","61378206","24","4653418"
"chr4","56727738","56728034","chr5","61381719","61382022","24","4653981"
"chr4","56824113","56824403","chr5","61495421","61495718","28","4671308"
"chr4","56831580","56831865","chr5","61502544","61502827","27","4670964"
"chr4","56866700","56866999","chr5","61536243","61536548","53","4669543"
"chr4","56867365","56867507","chr5","61536905","61537057","16","4669540"
"chr4","56867804","56867961","chr5","61537356","61537513","11","4669552"
"chr4","57384983","57385254","chr5","61569569","61569852","30","4184586"
"chr4","57395507","57395811","chr2","147639798","147640096","23","90244291"
"chr4","57418767","57419054","chr2","147664054","147664355","38","90245287"
"chr4","57425245","57425385","chr3","42988449","42988590","25","14436796"
"chr4","57425703","57425855","chr1","53225263","53225421","33","4200440"
"chr4","57427517","57427749","chr2","147672333","147672560","16","90244816"
"chr4","57429341","57429508","chr11","132145794","132145963","42","74716453"
"chr4","57432598","57432896","chr2","147677239","147677535","28","90244641"
"chr4","57444266","57444582","chr2","150887742","150888055","71","93443476"
"chr4","57460439","57460509","chr7","107117745","107117806","15","49657306"
"chr4","57466026","57466265","chr5","61600465","61600686","28","4134439"
"chr4","57467959","57468086","chr5","61602265","61602386","16","4134306"
"chr4","57479262","57479359","chr5","61613596","61613693","5","4134334"
"chr4","57479391","57479690","chr5","61613725","61614027","17","4134334"
"chr4","57519165","57519295","chr5","61652725","61652855","12","4133560"
"chr4","57541260","57541393","chr5","61677699","61677833","13","4136439"
"chr4","57574419","57574671","chr5","61710549","61710810","42","4136130"
"chr4","57833573","57833830","chr5","61935745","61936027","48","4102172"
"chr4","57928900","57929145","chr5","62029171","62029443","59","4100271"
"chr4","58086833","58087110","chr5","62168830","62169112","38","4081997"
"chr4","58111990","58112296","chr1","4131757","4132050","66","53980233"
"chr4","58139374","58139645","chr5","62227092","62227361","16","4087718"
"chr4","58173837","58173954","chr10","17234034","17234151","17","40939803"
"chr4","58458511","58458808","chr2","46244620","46244915","56","12213891"
"chr4","58600061","58600281","chr5","62664956","62665169","25","4064895"
"chr4","58802958","58803233","chr5","62860544","62860820","20","4057586"
"chr4","59053166","59053245","chr3","127343427","127343506","13","68290261"
"chr4","59053245","59053315","chrX","117644407","117644477","15","58591162"
"chr4","59184813","59185095","chr5","63248374","63248656","19","4063561"
"chr4","59282102","59282265","chr7","94341083","94341236","19","35058981"
"chr4","59290836","59291119","chr5","63356316","63356602","17","4065480"
"chr4","59332519","59332830","chr5","63398129","63398454","38","4065610"
"chr4","59340921","59341223","chr5","63406479","63406737","59","4065558"
"chr4","59365470","59365765","chr5","63430925","63431214","25","4065455"
"chr4","59374765","59374888","chr1","205347334","205347458","17","145972569"
"chr4","59442519","59442820","chr5","63502276","63502581","29","4059757"
"chr4","59453445","59453668","chr3","79858554","79858774","49","20405109"
"chr4","59455768","59456070","chr5","63513931","63514230","22","4058163"
"chr4","59466718","59466939","chr5","63523543","63523747","35","4056825"
"chr4","59501158","59501453","chr5","63552573","63552878","31","4051415"
"chr4","59529225","59529529","chr5","63576323","63576628","19","4047098"
"chr4","59561167","59561435","chr5","63597808","63598075","17","4036641"
"chr4","59572382","59572669","chr11","48401419","48401716","64","11170963"
"chr4","59589950","59590248","chr5","63627607","63627893","36","4037657"
"chr4","59598501","59598785","chr5","63636281","63636570","24","4037780"
"chr4","59599783","59600098","chr5","63637516","63637829","17","4037733"
"chr4","59601053","59601250","chr5","63638801","63639010","27","4037748"
"chr4","59601544","59601644","chr5","63639302","63639404","10","4037758"
"chr4","59604525","59604729","chr1","58348505","58348709","43","1256020"
"chr4","59605692","59605954","chr3","39023062","39023328","65","20582630"
"chr4","59608384","59608683","chr5","63644758","63645058","16","4036374"
"chr4","59610181","59610486","chr5","63646533","63646852","36","4036352"
"chr4","59616201","59616470","chr1","14232868","14233136","61","45383333"
"chr4","59620596","59620814","chr5","63655602","63655816","25","4035006"
"chr4","59631736","59631824","chr5","63664933","63665021","1","4033197"
"chr4","59632783","59632967","chr5","63665960","63666145","22","4033177"
"chr4","59638025","59638184","chr3","126621167","126621327","38","66983142"
"chr4","59672466","59672586","chr2","165531071","165531193","21","105858605"
"chr4","59675402","59675666","chr14","31996033","31996311","71","27679369"
"chr4","59689540","59689607","chr5","63724462","63724529","3","4034922"
"chr4","59693196","59693338","chr5","63728897","63729039","10","4035701"
"chr4","59693628","59693780","chr5","63729333","63729475","18","4035705"
"chr4","59700338","59700460","chr14","126205105","126205228","27","66504767"
"chr4","59700747","59700880","chr6","178107208","178107341","20","118406461"
"chr4","59706332","59706628","chr5","63739933","63740245","32","4033601"
"chr4","59709376","59709678","chr5","63743330","63743629","19","4033954"
"chr4","59723175","59723484","chr3","12813207","12813510","64","46909968"
"chr4","59724325","59724610","chr5","63769183","63769468","18","4044858"
"chr4","59735310","59735421","chr16","53987830","53987945","20","5747480"
"chr4","59741402","59741564","chr5","63786878","63787027","22","4045476"
"chr4","59741847","59741909","chr5","63787310","63787378","8","4045463"
"chr4","59744193","59744493","chr20","28618222","28618522","53","31125971"
"chr4","59747451","59747755","chr5","63793142","63793445","20","4045691"
"chr4","59763151","59763425","chr5","63809184","63809474","33","4046033"
"chr4","59772739","59773037","chr5","63818900","63819192","18","4046161"
"chr4","59789699","59789985","chr5","63840429","63840718","16","4050730"
"chr4","59790098","59790220","chr2","52314502","52314625","20","7475596"
"chr4","59832720","59832921","chr19","42426407","42426603","46","17406313"
"chr4","59927772","59928039","chr11","131260074","131260355","57","71332302"
"chr4","59941169","59941392","chr1","128750800","128751012","56","68809631"
"chr4","60025715","60025978","chr5","64080836","64081113","37","4055121"
"chr4","60035726","60035966","chr5","64088882","64089118","16","4053156"
"chr4","60057107","60057359","chr5","64110018","64110283","34","4052911"
"chr4","60106155","60106430","chr5","64160296","64160569","19","4054141"
"chr4","60111652","60111934","chr5","64165543","64165825","12","4053891"
"chr4","60163188","60163337","chr1","24769307","24769455","34","35393881"
"chr4","60163656","60163689","chr1","81964847","81964878","7","21801191"
"chr4","60187015","60187150","chr7","68824427","68824555","20","8637412"
"chr4","60207228","60207434","chr10","73195715","73195925","51","12988487"
"chr4","60234487","60234582","chr5","64296769","64296863","17","4062282"
"chr4","60303410","60303546","chr5","64430991","64431123","13","4127581"
"chr4","60396552","60396838","chrX","41710109","41710397","58","18686443"
"chr4","60448132","60448420","chr7","131072574","131072863","62","70624442"
"chr4","60517873","60518160","chr5","64609228","64609498","33","4091355"
"chr4","60522086","60522344","chr5","64613011","64613270","22","4090925"
"chr4","60540489","60540759","chr5","64609228","64609498","26","4068739"
"chr4","60544556","60544844","chr5","64636261","64636578","52","4091705"
"chr4","60579730","60580012","chr5","64664294","64664595","32","4084564"
"chr4","60647745","60647862","chr5","64727646","64727763","7","4079901"
"chr4","60655436","60655739","chr4","58323608","58323898","66","2331828"
"chr4","60681713","60681817","chr4","5126561","5126661","19","55555152"
"chr4","60682200","60682376","chrX","66077218","66077384","45","5395018"
"chr4","60695768","60696076","chr7","45450102","45450409","71","15245666"
"chr4","60732586","60732824","chr11","92073209","92073444","50","31340623"
"chr4","60751714","60751955","chr5","64824575","64824798","38","4072861"
"chr4","60762981","60763193","chr5","64835955","64836168","13","4072974"
"chr4","60770364","60770668","chr5","64843082","64843382","46","4072718"
"chr4","60771769","60772063","chr11","108832514","108832807","66","48060745"
"chr4","60786697","60786988","chr5","64849353","64849677","60","4062656"
"chr4","60856221","60856343","chr5","64917326","64917446","9","4061105"
"chr4","60862074","60862376","chr5","64923823","64924139","34","4061749"
"chr4","60874731","60874950","chr5","64938941","64939158","26","4064210"
"chr4","61008049","61008333","chr16","55700437","55700720","79","5307612"
"chr4","61015609","61015880","chr3","45497800","45498068","71","15517809"
"chr4","61124701","61124966","chr5","65297940","65298197","31","4173239"
"chr4","61317195","61317277","chr7","135178876","135178961","17","73861681"
"chr4","61356394","61356476","chr7","135178876","135178961","18","73822482"
"chr4","61447414","61447707","chr5","65170467","65170753","34","3723053"
"chr4","61493961","61494245","chr5","65722720","65723024","42","4228759"
"chr4","61583890","61584157","chr5","65297940","65298197","34","3714050"
"chr4","61630112","61630384","chr5","65364871","65365166","73","3734759"
"chr4","61682496","61682736","chr15","11219189","11219424","62","50463307"
"chr4","61701779","61702061","chrX","6038434","6038718","79","55663345"
"chr4","61723930","61724156","chr1","9617419","9617649","59","52106511"
"chr4","61966330","61966630","chr4","159565684","159565981","56","97599354"
"chr4","62057533","62057818","chr5","65947116","65947406","35","3889583"
"chr4","62076290","62076538","chr5","65965797","65966045","18","3889507"
"chr4","62084700","62084928","chr5","65971861","65972096","18","3887161"
"chr4","62090340","62090626","chr5","65977660","65977951","48","3887320"
"chr4","62099670","62099937","chr5","65987615","65987883","28","3887945"
"chr4","62128719","62129002","chr5","66015507","66015810","40","3886788"
"chr4","62208421","62208717","chr5","66084067","66084355","49","3875646"
"chr4","62255684","62255966","chr5","66125583","66125864","18","3869899"
"chr4","62260139","62260258","chr1","160129406","160129525","15","97869267"
"chr4","62425511","62425793","chr7","96863166","96863444","68","34437655"
"chr4","62553218","62553520","chr5","66423920","66424214","30","3870702"
"chr4","62615439","62615683","chr6","50994896","50995145","64","11620543"
"chr4","62649070","62649350","chr5","66575996","66576295","34","3926926"
"chr4","62655111","62655410","chr5","66582594","66582905","24","3927483"
"chr4","62661023","62661146","chr5","66588947","66589070","8","3927924"
"chr4","62683497","62683700","chr4","156570328","156570538","48","93886831"
"chr4","62691074","62691344","chr1","188873437","188873698","70","126182363"
"chr4","62709018","62709315","chr5","66633942","66634229","23","3924924"
"chr4","62727184","62727497","chr5","66648071","66648385","25","3920887"
"chr4","62847608","62847761","chr11","3089756","3089899","45","59757852"
"chr4","62847790","62847885","chr15","108718998","108719088","26","45871208"
"chr4","62850173","62850452","chr5","66761304","66761591","24","3911131"
"chr4","62853055","62853345","chr5","66764195","66764496","38","3911140"
"chr4","62877574","62877848","chr5","66790804","66791082","18","3913230"
"chr4","62889577","62889844","chr5","66802584","66802848","42","3913007"
"chr4","62906876","62907162","chr2","160551205","160551504","58","97644329"
"chr4","62913109","62913405","chr5","66824031","66824337","33","3910922"
"chr4","63076310","63076433","chr5","66987056","66987179","11","3910746"
"chr4","63510341","63510600","chr5","67416299","67416562","24","3905958"
"chr4","63631842","63631963","chr4","105553931","105554054","22","41922089"
"chr4","63694734","63694904","chr5","67610623","67610789","22","3915889"
"chr4","63780271","63780436","chr3","36329290","36329452","40","27450981"
"chr4","64101625","64101920","chr9","98661850","98662144","64","34560225"
"chr4","64531826","64531998","chr5","68476423","68476593","11","3944597"
"chr4","64700498","64700794","chr5","68642431","68642726","24","3941933"
"chr4","64761517","64761775","chr9","13907793","13908061","66","50853724"
"chr4","65152391","65152706","chr5","69146438","69146743","33","3994047"
"chr4","65195411","65195699","chr5","69187295","69187563","48","3991884"
"chr4","65392886","65393189","chrX","46805715","46806015","69","18587171"
"chr4","65652089","65652366","chr5","69705256","69705529","38","4053167"
"chr4","65720943","65721230","chr5","69760052","69760333","27","4039109"
"chr4","65864525","65864848","chr7","24872405","24872701","76","40992120"
"chr4","65919471","65919730","chr19","36211992","36212250","80","29707479"
"chr4","66071187","66071467","chr7","131359953","131360236","69","65288766"
"chr4","66109276","66109573","chr19","18064212","18064515","69","48045064"
"chr4","66142305","66142615","chr5","70164014","70164308","37","4021709"
"chr4","66186215","66186506","chr3","43572948","43573229","77","22613267"
"chr4","66561773","66562054","chr2","68173712","68173989","66","1611939"
"chr4","66626166","66626311","chr5","70685787","70685924","25","4059621"
"chr4","66933535","66933794","chr5","71000659","71000917","34","4067124"
"chr4","66961731","66961818","chr3","158873113","158873201","18","91911382"
"chr4","67215055","67215352","chr5","71387018","71387317","32","4171963"
"chr4","67234926","67235072","chr13","32676639","32676781","38","34558287"
"chr4","67335858","67336146","chr6","68750302","68750588","61","1414444"
"chr4","67355129","67355269","chr5","71463252","71463391","13","4108123"
"chr4","67646878","67647038","chr5","71845385","71845542","16","4198507"
"chr4","67647098","67647218","chr5","71845570","71845689","10","4198472"
"chr4","67738844","67739144","chr5","71948648","71948947","27","4209804"
"chr4","67862686","67862986","chr2","134217641","134217927","62","66354955"
"chr4","68043601","68043867","chr5","72245791","72246058","24","4202190"
"chr4","68058547","68058849","chr5","72260972","72261278","27","4202425"
"chr4","68111099","68111362","chr5","72315484","72315733","34","4204385"
"chr4","68112387","68112591","chr5","72316570","72316775","14","4204183"
"chr4","68141808","68142109","chr5","72345093","72345406","34","4203285"
"chr4","68197083","68197206","chr5","72404304","72404428","9","4207221"
"chr4","68200715","68201001","chr8","50015645","50015929","62","18185070"
"chr4","68298597","68298725","chr5","39904708","39904838","30","28393889"
"chr4","68345459","68345748","chr5","72545425","72545712","20","4199966"
"chr4","68393156","68393465","chr3","49101972","49102270","62","19291184"
"chr4","68399771","68400085","chr5","72603185","72603502","39","4203414"
"chr4","68449660","68449784","chr5","72653762","72653886","5","4204102"
"chr4","68480338","68480619","chr5","72685342","72685635","41","4205004"
"chr4","68508857","68509143","chr5","72715641","72715929","24","4206784"
"chr4","68518766","68519075","chr10","51775022","51775322","66","16743744"
"chr4","68541954","68542264","chr5","72750828","72751124","36","4208874"
"chr4","68543639","68543940","chr5","72752392","72752696","32","4208753"
"chr4","68547674","68547990","chr5","72756524","72756809","73","4208850"
"chr4","68548158","68548467","chr3","47930685","47930995","60","20617473"
"chr4","68592134","68592378","chr5","72803142","72803408","51","4211008"
"chr4","68624841","68625133","chr5","72832668","72832972","30","4207827"
"chr4","68625146","68625271","chr5","72832985","72833110","10","4207839"
"chr4","68790998","68791241","chr5","72994049","72994277","27","4203051"
"chr4","68795754","68796057","chr5","72998822","72999097","44","4203068"
"chr4","68810038","68810340","chr5","73012090","73012401","28","4202052"
"chr4","68816357","68816517","chr14","22691663","22691823","30","46124694"
"chr4","68816573","68816696","chr3","39187033","39187156","22","29629540"
"chr4","68861132","68861412","chr5","73065156","73065429","26","4204024"
"chr4","68896156","68896288","chr5","73100273","73100401","19","4204117"
"chr4","68973977","68974269","chr5","73175775","73176073","31","4201798"
"chr4","69038606","69038915","chr5","73234954","73235301","62","4196348"
"chr4","69110215","69110477","chr4","35749480","35749733","65","33360735"
"chr4","69123812","69124059","chr1","23942951","23943176","63","45180861"
"chr4","69154420","69154554","chr19","40432218","40432352","20","28722202"
"chr4","69157600","69157897","chr20","21744624","21744918","60","47412976"
"chr4","69166496","69166784","chr5","73363557","73363869","62","4197061"
"chr4","69262423","69262736","chr5","73466486","73466803","22","4204063"
"chr4","69263957","69264153","chr5","73465043","73465228","33","4201086"
"chr4","69268828","69269126","chr5","73460005","73460290","36","4191177"
"chr4","69313190","69313296","chr5","73516514","73516622","13","4203324"
"chr4","69382873","69383162","chr5","73579730","73580030","30","4196857"
"chr4","69428873","69429150","chrX","52880421","52880689","54","16548452"
"chr4","69434213","69434538","chr5","73628990","73629281","61","4194777"
"chr4","69440222","69440530","chr7","150795674","150795979","63","81355452"
"chr4","69456933","69457237","chr5","73649900","73650208","24","4192967"
"chr4","69474637","69474939","chr5","73665753","73666037","45","4191116"
"chr4","69483913","69484209","chr5","73677104","73677424","44","4193191"
"chr4","69566837","69567103","chr9","63247751","63248014","63","6319086"
"chr4","69579209","69579443","chr5","73775247","73775485","17","4196038"
"chr4","69629205","69629458","chr5","73819426","73819683","28","4190221"
"chr4","69667950","69668238","chr4","7164581","7164866","61","62503369"
"chr4","69681425","69681524","chr5","73867711","73867810","7","4186286"
"chr4","69681604","69681640","chr5","73867891","73867927","3","4186287"
"chr4","69723771","69724068","chr5","73911586","73911887","32","4187815"
"chr4","69844484","69844782","chr19","18064212","18064515","68","51780272"
"chr4","69886648","69886803","chr1","61992086","61992239","35","7894562"
"chr4","69938479","69938795","chr5","74122916","74123250","50","4184437"
"chr4","69990352","69990640","chr5","74175918","74176208","29","4185566"
"chr4","69993035","69993324","chr5","74179004","74179295","56","4185969"
"chr4","70103056","70103353","chr7","52199292","52199594","65","17903764"
"chr4","70141348","70141659","chr14","21340239","21340560","67","48801109"
"chr4","70183475","70183739","chr5","74378431","74378697","27","4194956"
"chr4","70371064","70371350","chr18","24117221","24117510","64","46253843"
"chr4","70393958","70394260","chr5","74585078","74585381","31","4191120"
"chr4","70436255","70436564","chr5","74627760","74628054","34","4191505"
"chr4","70721976","70722270","chr5","74912684","74912972","34","4190708"
"chr4","70933105","70933301","chr9","54608773","54608962","40","16324332"
"chr4","70941174","70941466","chr1","18889461","18889747","59","52051713"
"chr4","70948511","70948800","chr5","75144819","75145076","49","4196308"
"chr4","71039353","71039475","chr1","27092545","27092673","35","43946808"
"chr4","71174016","71174097","chr5","75378940","75379021","2","4204924"
"chr4","71475446","71475736","chr5","75689474","75689764","21","4214028"
"chr4","71540897","71541203","chr5","75748761","75749053","32","4207864"
"chr4","71552254","71552370","chr5","75759046","75759162","10","4206792"
"chr4","71577511","71577663","chr10","87300860","87301011","45","15723349"
"chr4","71609527","71609829","chr2","165008183","165008489","64","93398656"
"chr4","71628288","71628580","chr16","50406135","50406426","59","21222153"
"chr4","71795927","71795984","chr1","187626965","187627020","19","115831038"
"chr4","71832067","71832301","chr5","76060325","76060554","27","4228258"
"chr4","71852913","71853221","chr5","76081212","76081479","64","4228299"
"chr4","72117791","72118055","chr5","76352987","76353281","51","4235196"
"chr4","72121773","72122028","chr9","15298440","15298677","68","56823333"
"chr4","72399126","72399222","chr4","15278126","15278223","22","57121000"
"chr4","72402417","72402716","chr5","76516394","76516679","39","4113977"
"chr4","72415709","72416002","chr5","76529489","76529776","26","4113780"
"chr4","72507685","72507976","chr5","76618591","76618907","45","4110906"
"chr4","72640265","72640524","chr5","76741053","76741310","25","4100788"
"chr4","72657063","72657362","chr10","12389093","12389387","69","60267970"
"chr4","72680863","72681169","chr5","76781281","76781565","46","4100418"
"chr4","72796223","72796518","chr5","76928415","76928706","21","4132192"
"chr4","72856061","72856372","chr5","76987564","76987871","45","4131503"
"chr4","72956876","72957174","chr5","77073666","77073960","23","4116790"
"chr4","73229311","73229598","chr5","77342272","77342564","30","4112961"
"chr4","73270170","73270441","chr5","77385888","77386156","25","4115718"
"chr4","73274661","73274938","chr5","77391157","77391436","21","4116496"
"chr4","73324460","73324580","chr5","77447409","77447527","11","4122949"
"chr4","73341813","73342114","chr5","77464031","77464329","28","4122218"
"chr4","73342469","73342757","chr14","115049792","115050083","52","41707323"
"chr4","73364274","73364531","chr5","77487419","77487696","39","4123145"
"chr4","73376027","73376330","chr5","77499282","77499592","26","4123255"
"chr4","73392735","73393058","chr5","77516016","77516327","31","4123281"
"chr4","73393081","73393381","chr5","77516339","77516639","15","4123258"
"chr4","73404914","73405028","chr11","93637594","93637711","17","20232680"
"chr4","73405055","73405213","chr15","368842","369001","26","73036213"
"chr4","73408100","73408412","chr3","84623464","84623767","63","11215364"
"chr4","73421229","73421345","chr5","77547110","77547227","7","4125881"
"chr4","73423512","73423886","chr2","188526906","188527267","107","115103394"
"chr4","73435914","73436211","chr5","77560820","77561119","21","4124906"
"chr4","73442344","73442640","chr5","77567598","77567903","20","4125254"
"chr4","73451327","73451629","chr5","77576844","77577146","33","4125517"
"chr4","73453234","73453495","chr5","77578745","77579037","50","4125511"
"chr4","73466800","73466919","chr5","77592640","77592758","9","4125840"
"chr4","73467221","73467446","chr5","77593052","77593285","19","4125831"
"chr4","73476623","73476888","chr13","105368958","105369221","59","31892335"
"chr4","73502324","73502572","chr5","77625864","77626111","23","4123540"
"chr4","73509415","73509663","chr5","77633552","77633797","16","4124137"
"chr4","73529624","73529741","chr5","77655117","77655235","7","4125493"
"chr4","73531886","73532180","chr5","77657610","77657925","47","4125724"
"chr4","73535275","73535582","chr5","77659453","77659757","27","4124178"
"chr4","73546889","73547193","chr5","77671584","77671886","20","4124695"
"chr4","73554785","73555085","chr5","77678226","77678538","36","4123441"
"chr4","73566907","73567135","chr5","77690727","77690955","19","4123820"
"chr4","73567666","73567950","chr7","164732639","164732932","59","91164973"
"chr4","73568268","73568389","chr12","56628142","56628264","20","16940126"
"chr4","73573353","73573616","chr5","77697972","77698262","44","4124619"
"chr4","73573617","73573749","chr15","7149803","7149940","30","66423814"
"chr4","73578734","73578844","chr12","61028445","61028555","19","12550289"
"chr4","73588137","73588433","chr10","71274420","71274712","54","2313717"
"chr4","73625674","73625973","chrX","43540969","43541269","54","30084705"
"chr4","73638814","73639134","chr5","77761125","77761437","35","4122311"
"chr4","73658829","73658934","chr5","77782056","77782157","11","4123227"
"chr4","73663175","73663275","chr4","2875346","2875431","27","70787829"
"chr4","73663573","73663672","chr5","77786811","77786907","7","4123238"
"chr4","73685840","73685969","chr5","77803162","77803289","12","4117322"
"chr4","73698822","73698943","chr5","77816734","77816855","3","4117912"
"chr4","73699678","73699792","chr5","77817593","77817710","11","4117915"
"chr4","73706164","73706477","chr5","77824590","77824914","32","4118426"
"chr4","73713911","73714212","chr5","77839738","77840031","28","4125827"
"chr4","73721580","73721871","chr5","77845659","77845970","40","4124079"
"chr4","73721919","73721931","chr1","31365204","31365214","6","42356715"
"chr4","73722912","73723017","chr5","77847434","77847543","9","4124522"
"chr4","73724872","73725185","chr5","77849400","77849714","26","4124528"
"chr4","73733908","73734175","chr5","140929535","140929798","57","67195627"
"chr4","73738018","73738313","chr5","77861383","77861691","36","4123365"
"chr4","73756532","73756825","chr5","77880206","77880498","38","4123674"
"chr4","73757401","73757710","chr3","155814442","155814753","61","82057041"
"chr4","73763247","73763541","chr5","77888094","77888398","31","4124847"
"chr4","73816734","73816998","chr5","106717050","106717317","74","32900316"
"chr4","73826471","73826772","chr5","77945138","77945439","16","4118667"
"chr4","73838532","73838851","chr5","77957453","77957783","30","4118921"
"chr4","73839042","73839366","chr5","147436991","147437305","72","73597949"
"chr4","73848208","73848339","chr1","83361255","83361383","35","9513047"
"chr4","73857701","73858002","chr6","108897035","108897337","55","35039334"
"chr4","73890045","73890164","chr5","153557344","153557463","17","79667299"
"chr4","73893332","73893622","chr5","78014294","78014598","35","4120962"
"chr4","73907074","73907350","chr5","78024728","78025002","14","4117654"
"chr4","73911541","73911817","chr5","109550554","109550822","57","35639013"
"chr4","73920031","73920316","chr5","78034776","78035038","32","4114745"
"chr4","73958162","73958472","chr5","78078169","78078478","38","4120007"
"chr4","73964941","73965064","chr5","78084901","78085025","7","4119960"
"chr4","73968650","73968956","chr5","78088993","78089300","18","4120343"
"chr4","74000001","74000127","chr5","78120684","78120825","22","4120683"
"chr4","74015005","74015300","chr5","78134819","78135094","35","4119814"
"chr4","74031088","74031237","chr19","36617059","36617221","41","37414029"
"chr4","74032571","74032874","chr5","78152981","78153270","39","4120410"
"chr4","74036058","74036350","chr5","78156783","78157056","43","4120725"
"chr4","74077919","74078223","chr5","78196149","78196425","57","4118230"
"chr4","74111619","74111751","chr5","78231242","78231369","15","4119623"
"chr4","74115608","74115838","chr5","78235631","78235863","19","4120023"
"chr4","74118367","74118672","chr19","3500436","3500734","53","70617931"
"chr4","74135661","74135955","chr5","78248054","78248351","24","4112393"
"chr4","74145968","74146260","chr5","78257508","78257802","23","4111540"
"chr4","74188031","74188206","chr5","78293544","78293709","21","4105513"
"chr4","74188496","74188632","chr5","78294035","78294171","10","4105539"
"chr4","74193263","74193561","chr5","78299275","78299567","20","4106012"
"chr4","74200431","74200699","chr5","78306485","78306754","14","4106054"
"chr4","74203736","74204028","chr5","78310025","78310320","16","4106289"
"chr4","74208265","74208586","chr5","78314214","78314532","26","4105949"
"chr4","74210265","74210403","chr2","163144861","163145003","33","88934596"
"chr4","74210698","74210863","chr3","126170332","126170491","39","51959634"
"chr4","74212272","74212550","chr5","78317230","78317528","34","4104958"
"chr4","74240196","74240449","chr5","78345069","78345318","17","4104873"
"chr4","74256995","74257264","chr5","78360857","78361127","27","4103862"
"chr4","74273683","74273967","chr5","78377702","78378001","38","4104019"
"chr4","74289009","74289302","chr5","78393942","78394237","40","4104933"
"chr4","74291940","74292232","chr5","78396826","78397127","24","4104886"
"chr4","74309598","74309898","chr5","78413960","78414277","31","4104362"
"chr4","74326106","74326393","chr5","78429888","78430167","25","4103782"
"chr4","74339455","74339559","chr11","109358164","109358269","17","35018709"
"chr4","74344062","74344427","chr5","78449325","78449705","49","4105263"
"chr4","74348515","74348805","chr5","78453471","78453765","17","4104956"
"chr4","74355099","74355203","chr20","65428137","65428240","13","8926962"
"chr4","74371723","74372018","chr5","78476469","78476779","28","4104746"
"chr4","74390230","74390538","chr5","78495305","78495600","51","4105075"
"chr4","74392017","74392290","chr3","46725621","46725892","58","27666396"
"chr4","74393076","74393378","chr5","78497898","78498202","26","4104822"
"chr4","74402237","74402443","chr5","153597130","153597339","46","79194893"
"chr4","74404616","74404936","chr5","78509561","78509872","28","4104945"
"chr4","74405500","74405588","chr5","78510440","78510525","6","4104940"
"chr4","74416378","74416503","chr5","78521531","78521656","10","4105153"
"chr4","74445247","74445364","chr4","111036807","111036921","22","36591560"
"chr4","74454347","74454631","chr5","78558700","78558970","43","4104353"
"chr4","74457232","74457499","chr5","78561866","78562134","17","4104634"
"chr4","74461007","74461302","chr13","54864773","54865067","55","19596234"
"chr4","74473802","74474090","chr4","17925503","17925807","65","56548299"
"chr4","74485791","74486076","chr5","78590584","78590867","22","4104793"
"chr4","74491562","74491851","chr5","78596272","78596579","37","4104710"
"chr4","74492992","74493300","chr2","85137734","85138041","56","10644742"
"chr4","74506175","74506476","chr5","78611339","78611642","25","4105164"
"chr4","74520472","74520768","chr7","161967505","161967801","62","87447033"
"chr4","74526568","74526854","chr5","78630860","78631166","47","4104292"
"chr4","74529962","74530250","chr5","78634265","78634551","13","4104303"
"chr4","74536518","74536605","chr5","78641620","78641707","5","4105102"
"chr4","74537452","74537751","chr8","125828478","125828772","59","51291026"
"chr4","74566415","74566750","chr6","93918185","93918479","107","19351770"
"chr4","74574829","74575146","chr5","78683544","78683864","21","4108715"
"chr4","74580862","74581153","chr5","78689579","78689868","19","4108717"
"chr4","74585158","74585450","chr5","78693856","78694148","14","4108698"
"chr4","74588292","74588590","chr5","78697170","78697484","29","4108878"
"chr4","74590333","74590644","chr5","78699792","78700094","44","4109459"
"chr4","74591158","74591445","chr5","78700604","78700893","15","4109446"
"chr4","74656917","74657196","chr5","78770880","78771150","21","4113963"
"chr4","74668179","74668521","chr5","78782197","78782501","52","4114018"
"chr4","74672410","74672700","chr5","78786375","78786670","27","4113965"
"chr4","74697086","74697389","chr5","78810774","78811078","22","4113688"
"chr4","74718193","74718486","chr5","78831734","78832041","34","4113541"
"chr4","74731981","74732154","chr5","78845715","78845899","23","4113734"
"chr4","74732454","74732555","chr5","78846208","78846308","5","4113754"
"chr4","74769360","74769644","chr5","78886741","78887032","32","4117381"
"chr4","74812887","74812987","chr8","96949211","96949317","19","22136324"
"chr4","74841135","74841448","chr5","78957389","78957702","15","4116254"
"chr4","74844036","74844242","chr5","78960301","78960530","28","4116265"
"chr4","74863746","74864023","chr5","78995700","78995977","19","4131954"
"chr4","74881613","74881740","chr10","31227853","31227982","19","43653760"
"chr4","74885239","74885461","chr5","79016791","79017011","18","4131552"
"chr4","74901843","74902124","chr5","79031450","79031735","27","4129607"
"chr4","74909687","74909897","chr2","94796729","94796934","61","19887042"
"chr4","74920287","74920418","chr5","79048978","79049109","9","4128691"
"chr4","74932559","74932861","chr5","79061590","79061891","24","4129031"
"chr4","74958046","74958228","chr12","98603527","98603705","53","23645481"
"chr4","74966073","74966284","chr5","79094002","79094214","19","4127929"
"chr4","74968358","74968620","chr5","14829504","14829771","66","60138854"
"chr4","74971712","74972010","chr5","79099112","79099361","58","4127400"
"chr4","74981807","74982087","chr5","79108896","79109200","44","4127089"
"chr4","75053020","75053081","chr13","82728212","82728275","14","7675192"
"chr4","75077880","75078157","chr5","79207118","79207398","20","4129238"
"chr4","75078397","75078661","chr5","79207637","79207902","11","4129240"
"chr4","75082120","75082236","chr5","79211495","79211619","13","4129375"
"chr4","75096667","75096970","chr5","79226767","79227051","36","4130100"
"chr4","75117325","75117614","chrX","108129050","108129338","50","33011725"
"chr4","75134923","75135046","chr16","40227398","40227521","15","34907525"
"chr4","75137957","75138255","chr5","79268795","79269101","41","4130838"
"chr4","75138696","75138828","chr4","1420218","1420339","37","73718478"
"chr4","75172918","75173212","chr5","79310218","79310508","26","4137300"
"chr4","75212603","75212915","chr5","79346480","79346768","50","4133877"
"chr4","75235003","75235307","chr5","79363546","79363847","18","4128543"
"chr4","75276240","75276359","chrX","144541284","144541398","35","69265044"
"chr4","75278354","75278663","chr5","79397702","79398012","22","4119348"
"chr4","75289452","75289745","chr5","79414855","79415153","51","4125403"
"chr4","75344958","75345083","chr5","79473137","79473262","3","4128179"
"chr4","75404098","75404386","chr5","79532549","79532857","39","4128451"
"chr4","75404418","75404437","chr2","142079372","142079390","3","66674954"
"chr4","75439994","75440309","chr5","79569362","79569667","36","4129368"
"chr4","75464814","75464944","chr5","79588861","79588993","11","4124047"
"chr4","75474349","75474642","chr5","79598185","79598484","30","4123836"
"chr4","75633924","75634169","chr5","79760856","79761104","34","4126932"
"chr4","75716409","75716719","chr5","79844920","79845230","19","4128511"
"chr4","75791400","75791674","chrX","16345355","16345638","63","59446045"
"chr4","75807915","75808215","chrX","66926890","66927190","68","8881025"
"chr4","75865760","75866067","chr5","80055309","80055617","31","4189549"
"chr4","75945842","75945983","chr4","35579957","35580092","22","40365885"
"chr4","76008282","76008578","chr5","80192845","80193132","42","4184563"
"chr4","76019663","76019983","chr20","22512994","22513298","67","53506669"
"chr4","76081646","76081821","chr3","156452640","156452819","43","80370994"
"chr4","76098447","76098700","chrX","105702256","105702529","60","29603809"
"chr4","76100674","76100981","chr5","80281188","80281497","25","4180514"
"chr4","76119797","76119999","chr5","80296448","80296664","29","4176651"
"chr4","76160808","76161024","chr5","80346720","80346926","26","4185912"
"chr4","76161757","76162079","chr5","80347655","80347978","19","4185898"
"chr4","76166431","76166555","chr5","80351962","80352083","9","4185531"
"chr4","76187955","76188241","chr5","80373748","80374036","17","4185793"
"chr4","76233318","76233627","chr5","80418625","80418935","20","4185307"
"chr4","76239607","76239900","chr3","43652365","43652670","58","32587242"
"chr4","76240955","76241140","chr19","13922376","13922548","55","62318579"
"chr4","76243293","76243605","chr5","80430453","80430768","18","4187160"
"chr4","76261193","76261506","chr16","45622944","45623242","68","30638249"
"chr4","76275896","76276115","chr5","80457322","80457543","24","4181426"
"chr4","76290015","76290341","chr5","80471455","80471742","62","4181440"
"chr4","76294429","76294741","chr5","80475344","80475637","29","4180915"
"chr4","76297153","76297434","chr17","82183382","82183667","59","5886229"
"chr4","76302850","76303120","chr5","80484456","80484731","24","4181606"
"chr4","76307890","76308158","chr5","80489282","80489553","33","4181392"
"chr4","76314196","76314486","chr5","80496002","80496295","22","4181806"
"chr4","76329390","76329687","chr16","11545677","11545975","51","64783713"
"chr4","76340899","76341016","chr5","80524218","80524334","5","4183319"
"chr4","76379577","76379876","chrX","112227503","112227781","64","35847926"
"chr4","76468572","76468864","chr20","22445913","22446203","58","54022659"
"chr4","76499611","76499905","chr5","80682248","80682532","31","4182637"
"chr4","76502836","76503091","chr5","80693291","80693546","15","4190455"
"chr4","76509828","76510102","chr5","80701006","80701281","20","4191178"
"chr4","76549010","76549107","chr17","29540717","29540814","22","47008293"
"chr4","76549117","76549241","chr5","23788512","23788636","25","52760605"
"chr4","76567920","76568199","chr5","80759340","80759617","16","4191420"
"chr4","76569188","76569500","chr5","80760617","80760930","26","4191429"
"chr4","76581269","76581442","chr5","80771790","80771960","18","4190521"
"chr4","76597184","76597468","chr5","80787398","80787682","12","4190214"
"chr4","76615259","76615560","chr5","80806135","80806405","51","4190876"
"chr4","76632502","76632787","chr5","80858858","80859146","32","4226356"
"chr4","76640377","76640683","chr5","80866761","80867067","19","4226384"
"chr4","76776778","76777037","chr2","88694597","88694845","63","11917819"
"chr4","76853173","76853462","chr5","81082860","81083166","39","4229687"
"chr4","76854369","76854634","chr5","81084074","81084339","17","4229705"
"chr4","76907605","76907906","chr5","81181539","81181845","22","4273934"
"chr4","76924902","76925024","chr5","81198943","81199057","15","4274041"
"chr4","76930643","76930936","chr5","81204731","81205020","24","4274088"
"chr4","76936530","76936835","chr5","81210358","81210667","23","4273828"
"chr4","76980294","76980564","chr5","81254472","81254743","16","4274178"
"chr4","77018091","77018205","chr5","81298665","81298782","11","4280574"
"chr4","77087863","77088142","chr5","81350480","81350773","30","4262617"
"chr4","77091022","77091316","chr5","81353795","81354098","28","4262773"
"chr4","77134366","77134642","chr8","78511957","78512224","54","1377591"
"chr4","77147137","77147447","chr5","81403689","81403998","20","4256552"
"chr4","77150997","77151112","chr5","81407578","81407693","6","4256581"
"chr4","77193623","77193894","chr9","29787795","29788072","58","47405828"
"chr4","77193925","77193952","chr1","15603034","15603058","6","61590891"
"chr4","77246562","77246680","chr15","110025773","110025895","19","32779211"
"chr4","77256539","77256843","chr1","44516138","44516440","57","32740401"
"chr4","77296601","77296716","chr5","81543570","81543687","7","4246969"
"chr4","77373746","77374023","chr5","81617932","81618206","32","4244186"
"chr4","77474726","77475032","chr5","81721908","81722212","21","4247182"
"chr4","77483270","77483575","chr5","81730554","81730860","30","4247284"
"chr4","77543363","77543483","chr5","81794461","81794581","8","4251098"
"chr4","77594063","77594349","chr5","81837472","81837757","23","4243409"
"chr4","77605207","77605512","chr15","2849675","2849975","72","74755532"
"chr4","77694611","77694903","chr5","81939561","81939847","31","4244950"
"chr4","77730484","77730770","chr5","81979852","81980138","18","4249368"
"chr4","77733160","77733426","chr5","81982527","81982824","54","4249367"
"chr4","77751997","77752229","chr4","160303957","160304185","50","82551960"
"chr4","77753781","77753949","chr5","82007676","82007817","37","4253895"
"chr4","77763413","77763628","chr5","86573335","86573568","71","8809922"
"chr4","77784328","77784458","chr13","87095059","87095190","17","9310731"
"chr4","77797463","77797777","chr5","82045619","82045933","30","4248156"
"chr4","77799738","77799987","chr5","82047527","82047780","20","4247789"
"chr4","77808918","77809233","chr5","82056394","82056710","12","4247476"
"chr4","77837062","77837351","chr5","82084686","82084965","43","4247624"
"chr4","77849236","77849476","chr5","82095848","82096102","33","4246612"
"chr4","77849706","77849995","chr5","82096332","82096628","27","4246626"
"chr4","77899274","77899320","chr10","81540592","81540634","15","3641318"
"chr4","77899594","77899719","chr13","95288408","95288530","20","17388814"
"chr4","77998108","77998234","chr5","82273117","82273236","14","4275009"
"chr4","77998541","77998704","chr5","82273537","82273706","13","4274996"
"chr4","78279240","78279447","chr5","82536000","82536205","21","4256760"
"chr4","78317663","78317959","chr5","82570481","82570781","17","4252818"
"chr4","78431819","78432091","chr5","82678268","82678540","17","4246449"
"chr4","78446388","78446685","chr2","184143766","184144059","55","105697378"
"chr4","78518543","78518811","chr5","82773487","82773794","60","4254944"
"chr4","78540916","78541169","chr5","82785161","82785414","20","4244245"
"chr4","78541343","78541540","chr15","78402368","78402546","58","138975"
"chr4","78555564","78555852","chr5","82800356","82800648","37","4244792"
"chr4","78562979","78563081","chr5","82807998","82808088","24","4245019"
"chr4","83820210","83820502","chr5","49109419","49109719","36","34710791"
"chr4","83868010","83868327","chr17","79200191","79200506","72","4667819"
"chr4","83877781","83878049","chr3","46886686","46886971","59","36991095"
"chr4","83885106","83885291","chr4","58130431","58130605","47","25754675"
"chr4","83903006","83903285","chr10","22250904","22251186","69","61652102"
"chr4","83909853","83910038","chr5","49003757","49003942","14","34906096"
"chr4","83910400","83910532","chr5","49003278","49003410","10","34907122"
"chr4","83917510","83917805","chr11","120832938","120833247","63","36915428"
"chr4","83942518","83942641","chr5","150516607","150516733","15","66574089"
"chr4","83955285","83955433","chr20","19291159","19291310","32","64664126"
"chr4","83970782","83971079","chr5","48948862","48949167","29","35021920"
"chr4","83979610","83979890","chr5","48939349","48939620","22","35040261"
"chr4","83981987","83982310","chr5","48937283","48937582","48","35044704"
"chr4","84011466","84011609","chr5","48906469","48906612","9","35104997"
"chr4","84011932","84012094","chr5","48905984","48906154","15","35105948"
"chr4","84022297","84022590","chr5","48901641","48901936","21","35120656"
"chr4","84025206","84025509","chr2","107411533","107411833","60","23386327"
"chr4","84076241","84076522","chr5","48846035","48846309","30","35230206"
"chr4","84080025","84080306","chr16","60192855","60193133","66","23887170"
"chr4","84082429","84082713","chr5","48840066","48840351","23","35242363"
"chr4","84085950","84086261","chr5","48835305","48835614","29","35250645"
"chr4","84094895","84095205","chr5","48826376","48826685","23","35268519"
"chr4","84105429","84105645","chr5","48817357","48817573","11","35288072"
"chr4","84109603","84109873","chr5","48813044","48813314","19","35296559"
"chr4","84114367","84114527","chr10","27406902","27407056","29","56707465"
"chr4","84114557","84114656","chr4","55083017","55083118","19","29031540"
"chr4","84120022","84120328","chr5","48802631","48802940","22","35317391"
"chr4","84126566","84126836","chr5","48798391","48798656","22","35328175"
"chr4","84133368","84133649","chr5","48791426","48791742","56","35341942"
"chr4","84144477","84144758","chr10","60492874","60493152","59","23651603"
"chr4","84159058","84159340","chr5","48757271","48757574","32","35401787"
"chr4","84164626","84164918","chr10","25047921","25048219","65","59116705"
"chr4","84173551","84173813","chr5","48749547","48749840","41","35424004"
"chr4","84181149","84181456","chr5","48742076","48742383","24","35439073"
"chr4","84223927","84224146","chr13","66065755","66065967","54","18158172"
"chr4","84229570","84229699","chr1","128924857","128924980","30","44695287"
"chr4","84229757","84229862","chr20","11118468","11118550","36","73111289"
"chr4","84319177","84319487","chr5","48590950","48591261","12","35728227"
"chr4","84321595","84321783","chr2","76010457","76010651","48","8311138"
"chr4","84408539","84408815","chr5","48496123","48496410","25","35912416"
"chr4","84422000","84422287","chr5","48476419","48476718","27","35945581"
"chr4","84423713","84423953","chr5","48474738","48475011","51","35948975"
"chr4","84490846","84491037","chr5","48412045","48412227","24","36078801"
"chr4","84499711","84499835","chr5","48402716","48402844","14","36096995"
"chr4","84516328","84516471","chr5","48384860","48385003","10","36131468"
"chr4","84516777","84516950","chrX","19264862","19265025","33","65251915"
"chr4","84536745","84537034","chr15","14032398","14032694","58","70504347"
"chr4","84547127","84547364","chr1","40452779","40453017","50","44094348"
"chr4","84562181","84562430","chr5","48344609","48344878","42","36217572"
"chr4","84627329","84627656","chr5","48281488","48281795","33","36345841"
"chr4","84678259","84678554","chr5","48230953","48231257","58","36447306"
"chr4","84680945","84681249","chr5","48228234","48228534","18","36452711"
"chr4","84696651","84696895","chr5","48206187","48206378","65","36490464"
"chr4","84812022","84812307","chr5","48078807","48079117","38","36733215"
"chr4","84815757","84816019","chr5","48074957","48075225","29","36740800"
"chr4","84837698","84837980","chr5","48053611","48053895","34","36784087"
"chr4","84918475","84918763","chr5","47978909","47979190","30","36939566"
"chr4","84924078","84924373","chr5","47972569","47972871","21","36951509"
"chr4","84972930","84973214","chr5","47919375","47919670","24","37053555"
"chr4","84984036","84984315","chr5","47907981","47908271","33","37076055"
"chr4","84994739","84995034","chr5","47897200","47897499","26","37097539"
"chr4","85068748","85069031","chr5","47824678","47824964","20","37244070"
"chr4","85297429","85297723","chr5","47576679","47576979","25","37720750"
"chr4","85299522","85299810","chr5","47574579","47574877","26","37724943"
"chr4","85454279","85454576","chr5","47413479","47413788","41","38040800"
"chr4","85607968","85608276","chr5","47261198","47261488","47","38346770"
"chr4","85713341","85713464","chr10","30072549","30072675","21","55640792"
"chr4","85714433","85714713","chr13","11181858","11182152","73","74532575"
"chr4","85729439","85729750","chr5","47140508","47140822","31","38588931"
"chr4","85752440","85752721","chr5","47113538","47113810","29","38638902"
"chr4","85753584","85753878","chr5","47112386","47112679","45","38641198"
"chr4","85893166","85893449","chr5","46962659","46962940","25","38930507"
"chr4","86133582","86133753","chr5","46725277","46725448","12","39408305"
"chr4","86133791","86133906","chr5","46725113","46725227","11","39408678"
"chr4","86502853","86503140","chrX","47589945","47590230","58","38912908"
"chr4","86542852","86543164","chr5","46280630","46280942","23","40262222"
"chr4","86553822","86554092","chr5","46269747","46270007","23","40284075"
"chr4","86583449","86583742","chr13","86970329","86970627","69","386880"
"chr4","86644301","86644614","chr5","46174770","46175086","35","40469531"
"chr4","86655521","86655644","chr5","46167359","46167488","15","40488162"
"chr4","86910661","86910784","chr5","45897190","45897307","24","41013471"
"chr4","86933575","86933844","chr14","13450862","13451129","58","73482713"
"chr4","87035400","87035690","chr13","92187353","92187630","76","5151953"
"chr4","87089803","87089973","chr5","45721841","45722014","17","41367962"
"chr4","87098235","87098513","chr12","57150572","57150851","65","29947663"
"chr4","87265824","87266083","chr5","45538907","45539165","31","41726917"
"chr4","87495986","87496289","chr2","107411533","107411833","67","19915547"
"chr4","87543615","87543920","chr5","45276508","45276808","39","42267107"
"chr4","87880145","87880442","chr5","44905417","44905702","49","42974728"
"chr4","87891892","87892015","chr5","44896223","44896341","23","42995669"
"chr4","87892314","87892511","chr5","44895757","44895925","49","42996557"
"chr4","88130380","88130669","chr5","83308323","83308617","28","4822057"
"chr4","88142194","88142507","chr5","138990487","138990792","25","50848293"
"chr4","88189660","88189850","chrY","899637","899829","45","87290023"
"chr4","88244746","88245035","chr5","81837472","81837757","71","6407274"
"chr4","88340597","88340912","chr5","83544275","83544576","32","4796322"
"chr4","88446668","88446891","chr5","83654824","83655040","20","4791844"
"chr4","88469638","88469939","chr5","83677624","83677929","33","4792014"
"chr4","88570435","88570723","chr10","33479269","33479564","64","55091166"
"chr4","88726622","88726826","chr5","83976334","83976539","18","4750288"
"chr4","88726847","88727150","chr5","83976565","83976858","40","4750282"
"chr4","88785839","88785951","chr5","84042703","84042815","9","4743136"
"chr4","88863792","88864088","chr5","84121695","84121991","25","4742097"
"chr4","88995014","88995326","chr5","84298428","84298723","29","4696586"
"chr4","89109070","89109389","chr5","84410280","84410595","36","4698790"
"chr4","89126296","89126601","chr19","29145761","29146064","68","59980535"
"chr4","89202904","89203210","chr5","84506318","84506617","36","4696586"
"chr4","89249359","89249629","chr7","112290682","112290943","55","23041323"
"chr4","89325425","89325710","chr5","84628778","84629034","51","4696647"
"chr4","89396334","89396631","chr6","150576153","150576447","61","61179819"
"chr4","89447479","89447681","chr4","42842355","42842557","48","46605124"
"chr4","89461985","89462287","chr9","87656906","87657196","60","1805079"
"chr4","89472808","89473089","chr5","84783475","84783755","36","4689333"
"chr4","89478828","89478949","chr5","84789597","84789722","14","4689231"
"chr4","89506262","89506385","chr19","43315276","43315398","19","46190986"
"chr4","89537756","89538025","chr5","84852345","84852631","40","4685411"
"chr4","89542520","89542799","chr5","84857129","84857408","13","4685391"
"chr4","89543660","89543930","chr1","137895644","137895908","60","48351984"
"chr4","89545511","89545794","chr5","84859731","84860017","28","4685780"
"chr4","89559489","89559801","chr5","84874185","84874484","37","4685304"
"chr4","89579940","89580228","chr7","137856198","137856481","56","48276258"
"chr4","89580298","89580313","chr7","41910575","41910588","3","47669723"
"chr4","89590154","89590463","chr5","84909842","84910154","23","4680312"
"chr4","89604327","89604469","chr1","8482643","8482782","35","81121684"
"chr4","89608141","89608425","chr5","84926554","84926845","24","4681587"
"chr4","89627734","89628039","chr5","84944455","84944742","41","4683279"
"chr4","89661915","89662210","chr1","211215809","211216098","65","121553894"
"chr4","89717625","89717928","chr5","85024921","85025223","29","4692704"
"chr4","89735864","89736147","chr5","85043316","85043598","24","4692548"
"chr4","89763918","89764197","chr5","85075269","85075580","52","4688649"
"chr4","89783046","89783338","chr5","85094843","85095136","22","4688203"
"chr4","89789198","89789487","chr5","85101565","85101862","25","4687633"
"chr4","89795385","89795599","chr5","85107731","85107940","11","4687654"
"chr4","89836088","89836383","chr5","85152280","85152546","47","4683808"
"chr4","89862415","89862703","chr5","85179981","85180263","22","4682434"
"chr4","89874773","89875078","chr6","107165254","107165549","55","17290481"
"chr4","89895429","89895574","chr5","85212747","85212892","11","4682682"
"chr4","89913163","89913474","chr5","85223736","85224051","25","4689427"
"chr4","89917248","89917544","chr5","85228252","85228532","48","4688996"
"chr4","89922265","89922538","chr5","85229888","85230143","33","4692377"
"chr4","89922545","89922811","chr5","85230152","85230402","30","4692393"
"chr4","89933158","89933458","chrX","41541015","41541312","67","48392143"
"chr4","89938468","89938604","chr5","85246730","85246866","9","4691738"
"chr4","89938911","89939074","chr5","85247205","85247377","16","4691706"
"chr4","89945197","89945371","chr5","85254159","85254328","18","4691038"
"chr4","89945672","89945812","chr5","85254666","85254802","30","4691006"
"chr4","89950446","89950757","chr5","85260168","85260461","48","4690278"
"chr4","89953307","89953602","chr5","85262962","85263264","28","4690345"
"chr4","89971009","89971332","chr5","85281414","85281727","32","4689595"
"chr4","89974670","89974814","chr2","163081320","163081464","26","73106650"
"chr4","89975120","89975270","chr3","125536846","125536999","31","35561726"
"chr4","89978701","89978987","chr3","177488181","177488477","60","87509480"
"chr4","89980090","89980414","chr5","85291205","85291522","42","4688885"
"chr4","89996982","89997314","chr5","85309350","85309653","44","4687632"
"chr4","90003484","90003612","chr5","85315282","85315397","21","4688202"
"chr4","90013560","90013731","chr5","85326418","85326598","22","4687142"
"chr4","90017333","90017616","chr5","85330496","85330785","22","4686837"
"chr4","90019842","90020064","chr5","85332772","85332994","22","4687070"
"chr4","90034508","90034803","chr5","85348123","85348401","37","4686385"
"chr4","90054201","90054461","chr5","85366744","85367030","44","4687457"
"chr4","90064098","90064391","chr5","85379015","85379308","9","4685083"
"chr4","90086365","90086556","chr7","127193563","127193753","48","37107198"
"chr4","90132142","90132430","chr5","85449787","85450097","40","4682355"
"chr4","90143774","90144050","chr5","85461367","85461609","60","4682407"
"chr4","90149013","90149246","chr5","85466584","85466827","47","4682429"
"chr4","90149789","90150083","chr5","85467389","85467700","43","4682400"
"chr4","90182741","90183011","chr5","85500950","85501211","49","4681791"
"chr4","90186314","90186587","chr20","20708335","20708610","53","69477979"
"chr4","90195588","90195885","chr5","85514005","85514315","35","4681583"
"chr4","90199954","90200268","chr5","85518095","85518401","23","4681859"
"chr4","90208049","90208299","chr5","85525673","85525926","21","4682376"
"chr4","90209927","90210232","chr5","85527527","85527826","21","4682400"
"chr4","90234700","90234987","chr5","85550515","85550800","15","4684185"
"chr4","90241969","90242221","chr5","85558651","85558902","30","4683318"
"chr4","90254813","90254936","chr11","101244413","101244522","34","10989600"
"chr4","90256860","90257153","chr5","85573580","85573879","33","4683280"
"chr4","90292533","90292849","chr7","12809179","12809488","68","77483354"
"chr4","90296450","90296566","chr13","92229940","92230056","16","1933490"
"chr4","90298186","90298477","chr5","85619777","85620088","29","4678409"
"chr4","90306681","90306964","chr5","85628578","85628869","38","4678103"
"chr4","90307728","90308038","chr7","53097730","53098042","66","37209998"
"chr4","90336955","90337088","chr5","85654019","85654144","13","4682936"
"chr4","90366689","90366995","chr5","85684211","85684515","34","4682478"
"chr4","90376659","90376994","chr5","85711862","85712199","27","4664797"
"chr4","90381664","90381951","chr5","85716874","85717160","18","4664790"
"chr4","90391742","90392048","chr5","85725285","85725590","15","4666457"
"chr4","90447270","90447574","chr5","85783273","85783597","40","4663997"
"chr4","90448557","90448831","chr5","85784051","85784316","39","4664506"
"chr4","90451851","90452147","chr5","85787140","85787436","15","4664711"
"chr4","90527632","90527938","chr13","20546405","20546718","60","69981227"
"chr4","90530272","90530550","chr5","85875009","85875300","32","4655263"
"chr4","90583770","90583902","chr5","85928031","85928161","11","4655739"
"chr4","90650566","90650802","chr5","85996350","85996602","29","4654216"
"chr4","90739268","90739541","chr5","86083981","86084261","26","4655287"
"chr4","90749505","90749794","chr3","177676366","177676657","61","86926861"
"chr4","90898783","90898896","chr5","86239070","86239183","6","4659713"
"chr4","90936166","90936433","chr2","104563621","104563886","63","13627455"
"chr4","90970588","90970798","chr5","86314935","86315142","16","4655653"
"chr4","91028464","91028706","chr5","86374768","86375010","15","4653696"
"chr4","91032079","91032379","chr5","86378338","86378638","23","4653741"
"chr4","91036555","91036841","chr5","86382789","86383089","28","4653766"
"chr4","91048320","91048644","chr5","86394923","86395229","40","4653397"
"chr4","91058647","91058957","chr5","86405431","86405742","20","4653216"
"chr4","91068335","91068650","chr5","86414933","86415230","38","4653402"
"chr4","91078737","91078983","chr5","86424988","86425229","25","4653749"
"chr4","91081954","91082236","chr5","86428174","86428473","33","4653780"
"chr4","91082364","91082527","chr7","40952086","40952247","32","50130278"
"chr4","91097928","91098118","chrX","53144517","53144697","48","37953411"
"chr4","91109855","91110151","chr5","86455990","86456286","18","4653865"
"chr4","91111539","91111688","chr5","86457908","86458053","17","4653631"
"chr4","91122814","91123121","chr7","45639425","45639731","59","45483389"
"chr4","91125019","91125150","chr5","86471517","86471640","18","4653502"
"chr4","91147163","91147409","chr5","86491043","86491289","12","4656120"
"chr4","91159975","91160182","chr15","6503383","6503578","48","84656592"
"chr4","91172233","91172467","chr3","120419412","120419644","53","29247179"
"chr4","91186225","91186531","chr5","86533416","86533722","24","4652809"
"chr4","91191563","91191839","chr5","86539097","86539382","50","4652466"
"chr4","91195496","91195800","chr8","99621127","99621413","68","8425631"
"chr4","91203946","91204228","chr20","66457137","66457415","66","24746809"
"chr4","91212852","91213152","chr5","86560320","86560630","22","4652532"
"chr4","91220524","91220642","chr5","86567427","86567546","10","4653097"
"chr4","91224830","91225102","chr5","86573335","86573568","44","4651495"
"chr4","91227135","91227424","chr5","86575610","86575900","25","4651525"
"chr4","91231965","91232255","chr5","86580405","86580698","25","4651560"
"chr4","91241111","91241392","chr5","86590602","86590876","39","4650509"
"chr4","91260954","91261248","chr13","85683662","85683961","64","5577292"
"chr4","91269456","91269739","chr5","86617068","86617346","32","4652388"
"chr4","91278271","91278343","chr8","78537587","78537659","16","12740684"
"chr4","91294053","91294183","chr5","86642081","86642211","7","4651972"
"chr4","91294426","91294646","chr5","86642482","86642691","37","4651944"
"chr4","91302050","91302244","chr5","86650471","86650658","20","4651579"
"chr4","91302604","91302909","chr5","86651017","86651329","36","4651587"
"chr4","91310067","91310357","chr9","24679254","24679546","73","66630813"
"chr4","91319919","91320089","chr1","124727385","124727542","49","33407466"
"chr4","91320438","91320756","chr11","120832938","120833247","67","29512500"
"chr4","91323431","91323713","chr5","86667131","86667409","16","4656300"
"chr4","91332853","91333121","chr5","86674248","86674523","21","4658605"
"chr4","91371440","91371742","chr5","86755417","86755722","16","4616023"
"chr4","91382774","91383080","chr5","86772612","86772918","21","4610162"
"chr4","91400945","91401247","chr9","128228335","128228636","53","36827390"
"chr4","91409513","91409630","chr7","157070537","157070654","17","65661024"
"chr4","91420856","91421173","chr5","86813776","86814097","25","4607080"
"chr4","91425787","91426031","chr5","86818720","86818959","20","4607067"
"chr4","91474023","91474320","chr5","86867827","86868121","16","4606196"
"chr4","91484649","91484941","chr5","86878981","86879259","31","4605668"
"chr4","91495567","91495848","chr5","86891373","86891669","49","4604194"
"chr4","91539551","91539870","chr1","7183552","7183862","58","84355999"
"chr4","91543542","91543639","chr1","9701072","9701171","20","81842470"
"chr4","91557783","91558061","chr5","86953708","86954000","36","4604075"
"chr4","91569579","91569687","chr7","6445216","6445311","23","85124363"
"chr4","91584878","91585183","chr5","86971355","86971654","18","4613523"
"chr4","91601803","91602063","chr5","86989090","86989348","24","4612713"
"chr4","91713371","91713661","chr3","53703040","53703330","53","38010331"
"chr4","91809033","91809322","chr5","87202791","87203095","39","4606242"
"chr4","91817425","91817718","chr5","87211138","87211439","28","4606287"
"chr4","91826613","91826888","chr19","24268955","24269239","54","67557658"
"chr4","91841003","91841187","chr5","87236425","87236609","16","4604578"
"chr4","91867911","91868200","chr5","87263287","87263586","42","4604624"
"chr4","91903329","91903604","chr5","87292346","87292626","22","4610983"
"chr4","91954930","91955216","chr5","87336743","87336996","47","4618187"
"chr4","91982315","91982603","chr5","87362617","87362905","15","4619698"
"chr4","92014756","92014882","chr5","87394900","87395018","15","4619856"
"chr4","92037672","92037972","chr5","87413082","87413379","19","4624590"
"chr4","92050076","92050434","chr5","87425862","87426216","31","4624214"
"chr4","92054247","92054565","chr6","139778709","139779007","70","47724462"
"chr4","92109629","92109818","chr5","87489738","87489927","13","4619891"
"chr4","92127778","92127966","chr11","88961679","88961861","71","3166099"
"chr4","92148649","92148933","chr5","87532034","87532328","32","4616615"
"chr4","92165230","92165308","chr19","8316981","8317063","17","83848249"
"chr4","92182393","92182675","chr5","87565644","87565920","24","4616749"
"chr4","92187126","92187426","chr5","87570410","87570722","26","4616716"
"chr4","92350157","92350372","chr7","127063719","127063934","48","34713562"
"chr4","92355880","92356174","chr5","87733381","87733674","23","4622499"
"chr4","92431490","92431761","chr5","87806252","87806524","25","4625238"
"chr4","92576165","92576434","chr5","87954079","87954347","22","4622086"
"chr4","92595685","92595942","chr5","87990334","87990637","61","4605351"
"chr4","92708196","92708462","chr5","88096765","88097027","22","4611431"
"chr4","93178036","93178186","chr5","185899996","185900148","30","92721960"
"chr4","93178214","93178334","chrX","144692053","144692170","22","51513839"
"chr4","93237727","93237856","chr4","36960164","36960294","24","56277563"
"chr4","93258466","93258721","chr5","88631151","88631430","44","4627315"
"chr4","93321690","93322005","chr5","88695452","88695738","42","4626238"
"chr4","93333210","93333414","chr5","88705634","88705853","28","4627576"
"chr4","93387233","93387518","chr5","88766703","88766994","24","4620530"
"chr4","93408279","93408343","chr14","78931299","78931359","12","14476980"
"chr4","93412603","93412900","chr10","15460316","15460612","65","77952287"
"chr4","93442139","93442391","chrX","148305511","148305763","54","54863372"
"chr4","93459713","93460022","chr5","88822660","88822972","26","4637053"
"chr4","93660623","93660924","chr5","89032972","89033276","26","4627651"
"chr4","93711227","93711495","chr2","71850046","71850313","52","21861181"
"chr4","93956953","93957233","chr5","89325469","89325770","48","4631484"
"chr4","94052287","94052585","chr5","8246617","8246904","57","85805670"
"chr4","94137449","94137743","chr5","89551433","89551723","22","4586016"
"chr4","94322365","94322683","chr15","65121377","65121685","60","29200988"
"chr4","94475687","94475988","chr5","89885021","89885301","45","4590666"
"chr4","94665021","94665332","chr5","90050347","90050638","53","4614674"
"chr4","94754455","94754742","chr5","90141923","90142186","40","4612532"
"chr4","94787910","94788096","chr15","50355573","50355749","56","44432337"
"chr4","94800123","94800452","chr5","90192036","90192363","29","4608087"
"chr4","94840655","94840961","chr5","90292548","90292858","27","4548107"
"chr4","94859161","94859452","chr7","44087877","44088171","66","50771284"
"chr4","95083184","95083459","chr5","90538633","90538919","23","4544551"
"chr4","95270336","95270662","chrX","48014954","48015278","60","47255382"
"chr4","95566970","95567258","chr7","140100928","140101221","60","44533958"
"chr4","95677740","95677856","chr5","91142881","91143000","18","4534859"
"chr4","95688841","95689122","chrX","54221929","54222209","70","41466912"
"chr4","95755350","95755653","chr10","80646276","80646582","69","15109074"
"chr4","95771155","95771460","chr5","91241170","91241490","34","4529985"
"chr4","95775518","95775829","chr5","91245393","91245693","32","4530125"
"chr4","95804184","95804375","chr2","53384035","53384215","49","42420149"
"chr4","95820029","95820333","chr14","15838457","15838757","67","79981572"
"chr4","95826845","95827132","chr5","91297361","91297648","18","4529484"
"chr4","95851989","95852294","chr2","163441322","163441613","65","67589333"
"chr4","95879252","95879564","chr19","4771576","4771890","66","91107676"
"chr4","96013576","96013876","chr5","91481095","91481391","32","4532481"
"chr4","96212971","96213270","chr5","91709179","91709453","49","4503792"
"chr4","96401631","96401921","chr5","91911557","91911844","22","4490074"
"chr4","96406632","96406928","chr5","91915375","91915669","23","4491257"
"chr4","96438753","96439036","chr5","91947753","91948032","19","4491000"
"chr4","96449989","96450264","chr5","91965173","91965452","30","4484816"
"chr4","96474088","96474376","chr5","91988049","91988328","35","4486039"
"chr4","96920034","96920241","chrX","4057388","4057588","51","92862646"
"chr4","97003047","97003341","chr5","92522658","92522958","33","4480389"
"chr4","97008866","97009126","chr14","18972433","18972689","57","78036433"
"chr4","97024187","97024480","chr5","92546565","92546834","39","4477622"
"chr4","97035923","97036196","chr5","92557410","92557684","18","4478513"
"chr4","97056589","97056878","chr3","183694819","183695107","53","86638230"
"chr4","97166487","97166784","chr12","38307089","38307382","57","58859398"
"chr4","97232657","97232960","chr5","92727045","92727341","37","4505612"
"chr4","97237813","97237929","chr5","92732554","92732670","7","4505259"
"chr4","97260806","97260937","chr20","12120652","12120782","20","85140154"
"chr4","97440997","97441297","chr5","92925152","92925437","33","4515845"
"chr4","97460089","97460375","chr5","92944443","92944731","21","4515646"
"chr4","97462553","97462823","chr5","92946898","92947178","31","4515655"
"chr4","97476573","97476816","chr5","92961663","92961923","30","4514910"
"chr4","97484484","97484771","chr5","92969575","92969845","38","4514909"
"chr4","97500711","97501023","chr5","92985946","92986238","39","4514765"
"chr4","97509466","97509743","chr5","92994551","92994839","50","4514915"
"chr4","97514137","97514437","chr14","115083182","115083487","48","17569045"
"chr4","97521355","97521662","chr5","93006382","93006665","45","4514973"
"chr4","97528586","97528895","chr5","93016044","93016351","22","4512542"
"chr4","97535847","97536055","chr9","105624622","105624818","44","8088775"
"chr4","97653449","97653477","chr15","93446601","93446625","5","4206848"
"chr4","97653762","97654036","chr7","77763841","77764109","73","19889921"
"chr4","97658141","97658433","chr5","93138850","93139147","34","4519291"
"chr4","97665102","97665367","chr5","93145809","93146087","37","4519293"
"chr4","97694968","97695276","chr5","93175750","93176074","33","4519218"
"chr4","97715298","97715567","chr19","53249067","53249335","53","44466231"
"chr4","97720103","97720300","chr5","93201674","93201868","15","4518429"
"chr4","97729139","97729428","chr5","93210576","93210889","56","4518563"
"chr4","97743542","97743846","chr5","93225412","93225715","35","4518130"
"chr4","97745821","97746135","chr5","93228261","93228580","28","4517560"
"chr4","97826378","97826540","chr12","87917476","87917649","39","9908902"
"chr4","97826861","97827005","chr2","95163528","95163671","28","2663333"
"chr4","97856403","97856696","chr1","1724256","1724542","53","96132147"
"chr4","97862769","97863075","chr5","93339025","93339344","34","4523744"
"chr4","97866900","97867116","chr7","53260826","53261051","51","44606074"
"chr4","97870507","97870761","chr5","93346967","93347253","48","4523540"
"chr4","97917162","97917475","chr5","93390583","93390895","21","4526579"
"chr4","97934752","97935049","chr5","93408512","93408832","42","4526240"
"chr4","97944703","97944921","chr16","11319970","11320167","60","86624733"
"chr4","97947461","97947745","chr5","93421300","93421584","6","4526161"
"chr4","97958836","97959111","chr5","93432671","93432947","19","4526165"
"chr4","98029341","98029633","chr5","93507867","93508154","24","4521474"
"chr4","98051647","98051911","chr5","93531681","93531943","29","4519966"
"chr4","98056946","98057249","chr5","93538385","93538711","46","4518561"
"chr4","98077921","98078170","chr8","92687825","92688073","49","5390096"
"chr4","98085592","98085877","chr5","93564656","93564945","25","4520936"
"chr4","98153885","98154179","chr5","93631222","93631513","30","4522663"
"chr4","98197010","98197297","chr5","93673399","93673704","37","4523611"
"chr4","98214046","98214318","chr5","93686009","93686277","24","4528037"
"chr4","98262337","98262641","chr5","93734760","93735072","36","4527577"
"chr4","98281802","98282096","chr5","93755797","93756093","19","4526005"
"chr4","98313336","98313649","chr5","93787095","93787402","44","4526241"
"chr4","98324561","98324870","chr5","93798443","93798753","50","4526118"
"chr4","98362990","98363258","chr5","93838190","93838462","16","4524800"
"chr4","98387886","98388180","chr5","93862613","93862899","36","4525273"
"chr4","98389319","98389603","chr5","93864009","93864307","32","4525310"
"chr4","98390491","98390804","chr5","93865189","93865503","16","4525302"
"chr4","98390871","98391174","chr5","93865557","93865867","26","4525314"
"chr4","98426221","98426523","chr11","108895131","108895429","59","10468910"
"chr4","98430894","98431160","chr5","93906550","93906819","35","4524344"
"chr4","98431544","98431829","chr5","93907187","93907494","50","4524357"
"chr4","98481278","98481555","chr5","93953893","93954201","49","4527385"
"chr4","98489234","98489506","chr5","93961550","93961823","41","4527684"
"chr4","98494384","98494639","chr7","61127662","61127921","65","37366722"
"chr4","98541281","98541561","chr5","94063660","94063955","36","4477621"
"chr4","98625301","98625549","chr5","94147646","94147880","36","4477655"
"chr4","98660954","98661178","chr5","94181806","94182025","30","4479148"
"chr4","98702132","98702440","chr15","94658660","94658956","65","4043472"
"chr4","98743157","98743436","chr5","94255459","94255724","33","4487698"
"chr4","98865481","98865779","chr5","94373139","94373443","33","4492342"
"chr4","98933354","98933630","chr13","47263576","47263856","58","51669778"
"chr4","99080109","99080376","chr5","94617579","94617846","14","4462530"
"chr4","99098189","99098485","chr5","94634590","94634896","55","4463599"
"chr4","99222916","99223206","chr5","94753781","94754077","49","4469135"
"chr4","99224035","99224318","chr5","94755170","94755475","42","4468865"
"chr4","99244120","99244423","chr5","94776898","94777209","17","4467222"
"chr4","99263388","99263683","chr5","94796214","94796509","30","4467174"
"chr4","99285569","99285700","chr5","94817883","94818005","19","4467686"
"chr4","99339327","99339562","chr5","94881739","94881984","40","4457588"
"chr4","99485156","99485434","chr5","95004384","95004664","13","4480772"
"chr4","99552106","99552350","chr18","20955709","20955949","52","78596397"
"chr4","99563664","99564003","chr5","95096250","95096580","22","4467414"
"chr4","99603920","99604222","chr5","95129304","95129607","38","4474616"
"chr4","99745156","99745278","chr7","12743103","12743227","20","87002053"
"chr4","99781766","99781841","chr5","95351390","95351471","10","4430376"
"chr4","99971289","99971414","chr18","59375027","59375150","15","40596262"
"chr4","100110933","100111060","chr5","95673405","95673531","6","4437528"
"chr4","100141604","100141727","chr8","11303387","11303509","20","88838217"
"chr4","100149951","100150029","chr11","956174","956250","18","99193777"
"chr4","100150061","100150164","chr20","22980639","22980749","21","77169422"
"chr4","100263243","100263528","chr5","95834628","95834914","18","4428615"
"chr4","100918001","100918169","chr3","40421992","40422160","31","60496009"
"chr4","100947479","100947850","chr6","158859659","158860029","100","57912180"
"chr4","101028212","101028492","chr1","20022643","20022928","68","81005569"
"chr4","101044643","101044763","chr5","96601143","96601261","9","4443500"
"chr4","101045058","101045228","chr5","96601558","96601732","24","4443500"
"chr4","101133922","101134087","chr5","96688761","96688926","9","4445161"
"chr4","101135059","101135231","chr5","96689890","96690058","13","4445169"
"chr4","101230690","101230990","chr5","96778664","96778965","25","4452026"
"chr4","101244446","101244715","chr5","96806081","96806361","25","4438365"
"chr4","101261559","101261781","chr1","124805622","124805832","55","23544063"
"chr4","101264505","101264818","chr1","111261918","111262214","78","9997413"
"chr4","101266696","101267005","chr1","218103299","218103607","66","116836603"
"chr4","101267389","101267552","chr5","96827385","96827554","34","4440004"
"chr4","101267809","101267933","chr5","96827816","96827940","12","4439993"
"chr4","101282920","101283208","chr16","1095250","1095541","54","100187670"
"chr4","101295287","101295586","chr9","117609917","117610227","54","16314630"
"chr4","101333043","101333158","chr5","96892126","96892250","17","4440917"
"chr4","101360895","101361189","chr5","96919605","96919892","28","4441290"
"chr4","101366995","101367306","chr5","96924892","96925205","19","4442103"
"chr4","101382827","101382944","chr5","183493014","183493130","20","82110187"
"chr4","101386510","101386789","chr5","96943304","96943581","24","4443206"
"chr4","101388416","101388708","chr5","96944911","96945210","22","4443505"
"chr4","101419613","101419743","chr5","96972633","96972765","8","4446980"
"chr4","101420033","101420207","chr5","96973067","96973228","24","4446966"
"chr4","101432106","101432395","chr5","96985116","96985400","17","4446990"
"chr4","101433627","101433919","chr5","96986590","96986873","28","4447037"
"chr4","101468662","101468946","chr5","97030103","97030387","14","4438559"
"chr4","101478821","101478947","chrX","111859251","111859381","27","10380430"
"chr4","101481058","101481353","chr5","97040054","97040346","26","4441004"
"chr4","101486027","101486308","chr5","97044672","97044973","35","4441355"
"chr4","101500232","101500507","chr5","97058893","97059182","36","4441339"
"chr4","101513873","101514141","chr5","97071830","97072120","55","4442043"
"chr4","101532961","101533216","chr11","122383259","122383514","60","20850298"
"chr4","101534784","101535064","chr5","97095010","97095303","51","4439774"
"chr4","101540108","101540250","chr1","44817809","44817958","48","56722299"
"chr4","101540979","101541282","chr2","160551205","160551504","56","59010226"
"chr4","101555030","101555153","chr5","97114497","97114620","9","4440533"
"chr4","101559175","101559465","chr5","97118672","97118962","16","4440503"
"chr4","101585450","101585763","chr9","88871993","88872304","74","12713457"
"chr4","101596991","101597286","chr5","97156660","97156949","34","4440331"
"chr4","101610141","101610424","chr16","60142196","60142473","55","41467945"
"chr4","101642630","101642886","chr3","143033608","143033876","66","41390978"
"chr4","101698205","101698482","chr5","97258084","97258364","24","4440121"
"chr4","101710750","101711048","chr5","97271534","97271831","31","4439216"
"chr4","101738284","101738594","chr1","188530204","188530518","62","86791920"
"chr4","101740953","101741247","chrX","52404177","52404469","72","49336776"
"chr4","101779521","101779812","chr5","97337503","97337811","38","4442018"
"chr4","101788997","101789289","chr5","97345150","97345430","29","4443847"
"chr4","101795570","101795852","chr5","97351750","97352028","25","4443820"
"chr4","101832214","101832517","chr5","97388321","97388624","17","4443893"
"chr4","101848295","101848574","chr5","97403148","97403429","18","4445147"
"chr4","101849820","101849935","chr5","97405002","97405120","9","4444818"
"chr4","101870584","101870921","chr5","97425009","97425338","39","4445575"
"chr4","101894788","101895081","chr5","97449445","97449736","22","4445343"
"chr4","101897989","101898263","chr17","82183382","82183667","50","19714607"
"chr4","101915771","101915888","chr5","97470523","97470642","5","4445248"
"chr4","101948297","101948579","chr5","97541171","97541460","27","4407126"
"chr4","101952348","101952478","chr5","97545215","97545345","4","4407133"
"chr4","101958051","101958311","chr3","36424130","36424381","64","65533921"
"chr4","101974665","101974944","chr5","97568038","97568316","32","4406627"
"chr4","101990086","101990363","chr5","97580347","97580623","13","4409739"
"chr4","101995646","101995942","chr5","97585952","97586230","48","4409694"
"chr4","101997890","101998181","chr5","97590425","97590727","34","4407465"
"chr4","102015960","102016267","chr5","97609839","97610141","28","4406121"
"chr4","102040396","102040675","chr5","139182915","139183194","49","37142519"
"chr4","102049168","102049471","chr5","97635867","97636171","21","4413301"
"chr4","102051563","102051717","chr5","97638263","97638395","28","4413300"
"chr4","102052003","102052112","chr11","117416380","117416492","19","15364377"
"chr4","102057604","102057927","chr15","17816055","17816351","83","84241549"
"chr4","102075191","102075284","chr6","28929552","28929647","22","73145639"
"chr4","102103579","102103818","chr5","97692427","97692667","21","4411152"
"chr4","102129860","102130108","chr5","97717592","97717853","25","4412268"
"chr4","102140355","102140627","chr12","88356059","88356317","62","13784296"
"chr4","102141195","102141354","chr5","97734406","97734569","12","4406789"
"chr4","102182127","102182437","chr5","97756032","97756334","24","4426095"
"chr4","102197739","102198024","chr5","97773041","97773329","22","4424698"
"chr4","102226077","102226359","chr5","97811066","97811348","19","4415011"
"chr4","102258272","102258402","chr2","172002574","172002691","34","69744302"
"chr4","102259894","102259969","chr4","109463448","109463524","13","7203554"
"chr4","102264390","102264622","chr5","97841959","97842194","29","4422431"
"chr4","102277535","102277841","chr5","97855271","97855570","24","4422264"
"chr4","102481900","102482219","chr5","98126486","98126791","27","4355414"
"chr4","102484729","102484956","chr5","98129292","98129519","10","4355437"
"chr4","102559818","102559921","chr1","144335455","144335554","19","41775637"
"chr4","102603133","102603364","chrX","38946469","38946692","60","63656664"
"chr4","102710797","102711102","chr5","98386930","98387229","36","4323867"
"chr4","102843183","102843480","chr5","98527260","98527548","25","4315923"
"chr4","102889266","102889566","chr5","98559727","98559993","50","4329539"
"chr4","102890221","102890533","chr5","98560627","98560931","27","4329594"
"chr4","102892126","102892247","chr5","98562516","98562630","16","4329610"
"chr4","102977021","102977240","chr5","98653201","98653423","25","4323820"
"chr4","102991020","102991327","chr5","98667378","98667684","28","4323642"
"chr4","103007357","103007486","chr5","98683705","98683841","14","4323652"
"chr4","103037580","103037672","chr2","74636905","74637003","20","28400675"
"chr4","103074000","103074162","chr5","148676254","148676417","39","45602254"
"chr4","103088095","103088200","chr5","98764778","98764879","16","4323317"
"chr4","103095814","103096100","chr5","98772497","98772799","31","4323317"
"chr4","103098513","103098792","chr5","98775204","98775481","19","4323309"
"chr4","103100613","103100904","chr5","98777268","98777546","29","4323345"
"chr4","103135799","103136102","chr5","98805903","98806213","33","4329896"
"chr4","103154107","103154398","chr5","98829978","98830260","19","4324129"
"chr4","103177673","103177831","chr10","31817079","31817240","40","71360594"
"chr4","103179755","103180038","chr5","98855333","98855609","22","4324422"
"chr4","103262229","103262527","chr11","48283444","48283741","59","54978785"
"chr4","103264671","103264909","chr5","98939664","98939906","22","4325007"
"chr4","103383102","103383414","chr5","99057715","99058022","23","4325387"
"chr4","103402845","103403155","chr5","99077598","99077907","47","4325247"
"chr4","103506605","103506908","chr5","99219114","99219436","62","4287491"
"chr4","103634385","103634705","chr5","99341561","99341870","36","4292824"
"chr4","103667280","103667541","chr5","99383178","99383435","23","4284102"
"chr4","103806088","103806208","chr5","99518538","99518658","3","4287550"
"chr4","103860606","103860908","chr5","99574321","99574622","29","4286285"
"chr4","103921413","103921453","chr5","116161394","116161432","11","12239981"
"chr4","104093278","104093535","chr12","88356059","88356317","72","15737219"
"chr4","104098578","104098852","chr5","99809440","99809722","25","4289138"
"chr4","104150054","104150321","chr5","99861692","99861960","19","4288362"
"chr4","104195928","104196150","chr6","170454936","170455168","55","66259008"
"chr4","104253791","104254095","chr5","99973252","99973547","37","4280539"
"chr4","104264133","104264435","chr5","99981941","99982244","32","4282192"
"chr4","104270370","104270692","chr5","99988858","99989153","50","4281512"
"chr4","104330560","104330837","chr5","100052122","100052400","26","4278438"
"chr4","104332326","104332595","chr5","100053901","100054174","28","4278425"
"chr4","104357429","104357631","chr6","60308516","60308718","43","44048913"
"chr4","104365314","104365620","chr5","100089911","100090217","21","4275403"
"chr4","104397502","104397770","chr5","100122579","100122854","22","4274923"
"chr4","104399463","104399722","chr5","100124609","100124869","23","4274854"
"chr4","104422088","104422406","chr3","175789427","175789740","63","71367339"
"chr4","104457231","104457534","chr5","100183718","100184033","65","4273513"
"chr4","104518961","104519082","chr5","100240509","100240630","10","4278452"
"chr4","104571510","104571771","chr5","100301963","100302231","25","4269547"
"chr4","104595953","104596045","chr5","109387299","109387388","15","4791346"
"chr4","104677007","104677305","chr5","100411973","100412255","34","4265034"
"chr4","104750196","104750488","chr5","100485749","100486042","25","4264447"
"chr4","104783407","104783683","chr5","100518274","100518574","41","4265133"
"chr4","104808778","104809045","chr5","100543647","100543928","29","4265131"
"chr4","104844689","104844875","chr8","64731321","64731495","39","40113368"
"chr4","104844916","104845036","chr8","94798198","94798319","17","10046718"
"chr4","104946683","104946799","chr5","100677048","100677170","14","4269635"
"chr4","105127153","105127416","chr5","100877213","100877495","46","4249940"
"chr4","105179396","105179691","chr5","100948816","100949114","21","4230580"
"chr4","105336471","105336763","chr5","101093113","101093407","17","4243358"
"chr4","105360544","105360673","chr5","101115481","101115623","24","4245063"
"chr4","105360948","105361080","chr5","101115911","101116055","19","4245037"
"chr4","105386159","105386463","chr5","101141139","101141447","24","4245020"
"chr4","105402136","105402432","chr5","101158084","101158380","15","4244052"
"chr4","105445587","105445893","chr5","101202524","101202820","30","4243063"
"chr4","105482453","105482679","chr5","101235870","101236080","32","4246583"
"chr4","105505579","105505901","chr5","101251866","101252187","23","4253713"
"chr4","105553014","105553323","chr13","61935938","61936245","57","43617076"
"chr4","105560772","105561061","chr5","101308240","101308533","17","4252532"
"chr4","105598767","105599076","chr5","101340938","101341250","35","4257829"
"chr4","105599714","105600018","chr5","101341890","101342197","20","4257824"
"chr4","105669975","105670256","chr3","124595256","124595537","65","18925281"
"chr4","105671820","105672147","chr5","101421833","101422161","38","4249987"
"chr4","105695695","105696002","chr5","101446038","101446339","46","4249657"
"chr4","105739295","105739599","chr5","101488244","101488549","16","4251051"
"chr4","105746968","105747231","chr5","101496092","101496372","28","4250876"
"chr4","105767364","105767685","chr5","101523881","101524202","13","4243483"
"chr4","105777835","105778139","chr5","101534013","101534318","31","4243822"
"chr4","105782277","105782572","chr5","185678151","185678451","58","79895874"
"chr4","105835829","105836126","chr2","84913076","84913368","53","20922753"
"chr4","105872806","105873114","chr1","160323872","160324177","64","54451066"
"chr4","105927967","105928261","chr5","101684611","101684919","32","4243356"
"chr4","105929941","105930072","chr1","109570884","109571013","23","3640943"
"chr4","105932400","105932705","chr5","101688737","101689059","26","4243663"
"chr4","105933395","105933653","chr5","79313234","79313490","77","26620161"
"chr4","105940994","105941269","chr5","101697249","101697525","16","4243745"
"chr4","105953515","105953713","chr5","101709608","101709823","35","4243907"
"chr4","105977934","105978218","chr5","101735246","101735530","15","4242688"
"chr4","105992258","105992560","chr5","101760574","101760877","23","4231684"
"chr4","106000877","106001178","chr5","101769559","101769860","21","4231318"
"chr4","106038626","106038700","chr2","181053562","181053633","17","75014936"
"chr4","106039098","106039236","chr5","101809690","101809829","3","4229408"
"chr4","106055159","106055470","chr5","101829758","101830071","19","4225401"
"chr4","106076847","106077138","chr5","101851377","101851673","23","4225470"
"chr4","106087624","106087877","chr14","70308418","70308680","56","35779206"
"chr4","106133916","106134215","chr10","82057101","82057392","65","24076815"
"chr4","106182445","106182688","chr5","101961958","101962209","20","4220487"
"chr4","106201011","106201315","chr5","101979318","101979616","22","4221693"
"chr4","106278191","106278537","chr5","102053372","102053694","52","4224819"
"chr4","106501032","106501352","chr5","102282845","102283165","18","4218187"
"chr4","106536372","106536504","chr5","102334646","102334778","5","4201726"
"chr4","106640395","106640657","chr5","102431960","102432228","18","4208435"
"chr4","106777646","106777974","chr5","102584718","102585031","51","4192928"
"chr4","106953098","106953384","chr5","102782438","102782744","45","4170660"
"chr4","106976493","106976790","chr5","102814117","102814414","21","4162376"
"chr4","107073189","107073489","chr5","106385003","106385300","27","688186"
"chr4","107427153","107427425","chrX","134994896","134995166","60","27567743"
"chr4","107500047","107500339","chr5","105946822","105947121","57","1553225"
"chr4","107602965","107603292","chr5","105840473","105840771","54","1762492"
"chr4","107679052","107679363","chr5","105764983","105765271","42","1914069"
"chr4","107878103","107878324","chr5","105583958","105584176","17","2294145"
"chr4","107929411","107929697","chr9","28116760","28117047","59","79812651"
"chr4","107948116","107948316","chr5","105512158","105512360","19","2435958"
"chr4","108008179","108008487","chr5","105456073","105456383","21","2552106"
"chr4","108175593","108175797","chr5","105270177","105270382","11","2905416"
"chr4","108204389","108204655","chr5","105240605","105240871","20","2963784"
"chr4","108230094","108230213","chr5","105215072","105215191","11","3015022"
"chr4","108280327","108280632","chr5","105164248","105164544","31","3116079"
"chr4","108332891","108333183","chr5","105112841","105113141","32","3220050"
"chr4","108462951","108463246","chr5","104953315","104953624","36","3509636"
"chr4","108473255","108473530","chr5","104940175","104940447","20","3533080"
"chr4","108522053","108522204","chr2","88726812","88726967","38","19795241"
"chr4","108537191","108537476","chr5","104876285","104876578","24","3660906"
"chr4","108594699","108594880","chr8","64731321","64731495","31","43863378"
"chr4","108595190","108595333","chr5","104813991","104814129","14","3781199"
"chr4","108671576","108671872","chr5","104734896","104735189","34","3936680"
"chr4","108736522","108736756","chr5","104668769","104669003","12","4067753"
"chr4","108747107","108747384","chr7","16319728","16320012","53","92427379"
"chr4","108767942","108768237","chr3","165341563","165341858","46","56573621"
"chr4","108784527","108784802","chr16","45788271","45788537","64","62996256"
"chr4","108820955","108821179","chr5","104592777","104593007","21","4228178"
"chr4","108847865","108848168","chr5","104566101","104566398","23","4281764"
"chr4","108868476","108868756","chr5","104545526","104545802","20","4322950"
"chr4","108890444","108890559","chr1","31118551","31118669","18","77771893"
"chr4","109022157","109022462","chr5","104402267","104402580","30","4619890"
"chr4","109054969","109055293","chr5","104372115","104372434","42","4682854"
"chr4","109288538","109288831","chr16","50281660","50281955","53","59006878"
"chr4","109298841","109298925","chr5","104169227","104169311","3","5129614"
"chr4","109334794","109334918","chr3","165833572","165833694","18","56498778"
"chr4","109374446","109374760","chr5","104092217","104092505","44","5282229"
"chr4","109423329","109423620","chr15","26072924","26073215","59","83350405"
"chr4","109512559","109512809","chr5","103965917","103966167","20","5546642"
"chr4","109540960","109541242","chr5","103935114","103935398","31","5605846"
"chr4","109639080","109639374","chr3","177488181","177488477","61","67849101"
"chr4","109685886","109686185","chr3","148208225","148208513","61","38522339"
"chr4","109890919","109891234","chr5","103595997","103596283","42","6294922"
"chr4","109924697","109924842","chr10","31729982","31730125","30","78194715"
"chr4","110028827","110029106","chr5","103470670","103470945","18","6558157"
"chr4","110322552","110322828","chr5","103177327","103177584","37","7145225"
"chr4","110502272","110502568","chr5","102971830","102972127","17","7530442"
"chr4","110503200","110503501","chr5","102970909","102971217","33","7532291"
"chr4","110748297","110748600","chr5","106576573","106576878","15","4171724"
"chr4","110771809","110772035","chr5","106593628","106593857","15","4178181"
"chr4","110830371","110830626","chr5","106650011","106650274","22","4180360"
"chr4","110843195","110843489","chr2","33980290","33980583","30","76862905"
"chr4","110891552","110891806","chr10","670095","670355","62","110221457"
"chr4","110912692","110912976","chr3","9506822","9507112","63","101405870"
"chr4","110919603","110919882","chr5","106742055","106742345","37","4177548"
"chr4","110954852","110955125","chr19","14258571","14258837","69","96696281"
"chr4","111022108","111022414","chr5","106844287","106844589","21","4177821"
"chr4","111097952","111098262","chr5","106920296","106920583","42","4177656"
"chr4","111136895","111137169","chr5","106956923","106957229","56","4179972"
"chr4","111137252","111137534","chr5","106957314","106957605","40","4179938"
"chr4","111150461","111150614","chr5","106971684","106971854","42","4178777"
"chr4","111199940","111200244","chr5","107022513","107022802","30","4177427"
"chr4","111201316","111201615","chr5","107023870","107024169","14","4177446"
"chr4","111257040","111257345","chr5","107079477","107079785","21","4177563"
"chr4","111277612","111277915","chr5","107099963","107100264","21","4177649"
"chr4","111282854","111283147","chr5","107105187","107105484","24","4177667"
"chr4","111311648","111311747","chr5","107138820","107138922","10","4172828"
"chr4","111358668","111358897","chr5","107188617","107188848","15","4170051"
"chr4","111375297","111375566","chr5","107205231","107205502","26","4170066"
"chr4","111503018","111503336","chr5","107334874","107335170","45","4168144"
"chr4","111505220","111505529","chr5","107337195","107337495","27","4168025"
"chr4","111518975","111519241","chr5","107344498","107344774","39","4174477"
"chr4","111573660","111573783","chr8","70813544","70813666","19","40760116"
"chr4","111615771","111616064","chr8","41469111","41469397","53","70146660"
"chr4","111628031","111628282","chr2","115284300","115284543","59","3656269"
"chr4","111642377","111642672","chr5","107474683","107474981","23","4167694"
"chr4","111667015","111667216","chr3","3766379","3766574","49","107900636"
"chr4","111667512","111667528","chr7","137612271","137612285","3","25944759"
"chr4","111667709","111667808","chr19","15496154","15496255","24","96171555"
"chr4","111692202","111692487","chr5","107524655","107524948","23","4167547"
"chr4","111700804","111700939","chr3","34414634","34414764","30","77286170"
"chr4","111706877","111707192","chr5","107538751","107539068","25","4168126"
"chr4","111749691","111749992","chr5","107586073","107586394","37","4163618"
"chr4","111822794","111823088","chr5","107644476","107644771","45","4178318"
"chr4","111853582","111853874","chr5","107674799","107675090","17","4178783"
"chr4","111858283","111858571","chr5","107679007","107679307","42","4179276"
"chr4","111865422","111865711","chr5","107686266","107686560","28","4179156"
"chr4","111894834","111895131","chr5","107715404","107715702","24","4179430"
"chr4","111899938","111900231","chr5","107720508","107720800","13","4179430"
"chr4","111901639","111901754","chr19","52862045","52862167","22","59039594"
"chr4","111908936","111909180","chr5","107729226","107729469","15","4179710"
"chr4","111916336","111916608","chr5","107737055","107737335","17","4179281"
"chr4","111946885","111947193","chr5","107767102","107767409","15","4179783"
"chr4","111998308","111998610","chr5","107818578","107818886","24","4179730"
"chr4","112004492","112004787","chr9","64297145","64297442","65","47707347"
"chr4","112086831","112087045","chr9","40644809","40645021","48","71442022"
"chr4","112102969","112103235","chr5","107925393","107925664","15","4177576"
"chr4","112131813","112132061","chr3","126535617","126535868","53","14403804"
"chr4","112141303","112141616","chr5","107969492","107969792","25","4171811"
"chr4","112143850","112144137","chr5","107972055","107972355","32","4171795"
"chr4","112166531","112166796","chr5","107995042","107995307","11","4171489"
"chr4","112167654","112167965","chr5","107996164","107996496","46","4171490"
"chr4","112248256","112248518","chr10","61695759","61696020","59","50552497"
"chr4","112355362","112355606","chr5","108195405","108195658","49","4159957"
"chr4","112382406","112382735","chr5","42141877","42142205","68","70240529"
"chr4","112384817","112385108","chr5","108225267","108225562","18","4159550"
"chr4","112401995","112402292","chr5","108240126","108240430","31","4161869"
"chr4","112445934","112446241","chr5","108283520","108283835","43","4162414"
"chr4","112475993","112476294","chr14","54046910","54047205","59","58429083"
"chr4","112477080","112477348","chr5","108320194","108320465","21","4156886"
"chr4","112483116","112483400","chr5","108326532","108326815","16","4156584"
"chr4","112488876","112489234","chr1","86012715","86013056","90","26476161"
"chr4","112490141","112490422","chr5","108333485","108333788","41","4156656"
"chr4","112499472","112499698","chr5","108344729","108344958","19","4154743"
"chr4","112500598","112500872","chr3","155157095","155157373","56","42656497"
"chr4","112511288","112511573","chr5","108359174","108359452","24","4152114"
"chr4","112518209","112518518","chr5","108368925","108369239","33","4149284"
"chr4","112522570","112522855","chr5","108372995","108373293","26","4149575"
"chr4","112549192","112549509","chr5","108400180","108400490","26","4149012"
"chr4","112551465","112551615","chr5","108402462","108402608","19","4149003"
"chr4","112564512","112564768","chr14","103198548","103198796","59","9365964"
"chr4","112609957","112610136","chr5","108461031","108461206","17","4148926"
"chr4","112610442","112610594","chrX","129770380","129770523","38","17159938"
"chr4","112615168","112615458","chr5","108466304","108466623","45","4148864"
"chr4","112649039","112649312","chr5","108499472","108499748","33","4149567"
"chr4","112697019","112697303","chr5","108545550","108545839","29","4151469"
"chr4","112730530","112730753","chr5","108570184","108570399","25","4160346"
"chr4","112752103","112752376","chr5","108586501","108586769","25","4165602"
"chr4","112755536","112755804","chr2","89406799","89407066","54","23348737"
"chr4","112762526","112762819","chr5","108597691","108597984","20","4164835"
"chr4","112771237","112771415","chr7","158074481","158074672","49","45303244"
"chr4","112778621","112778837","chr17","533424","533638","67","112245197"
"chr4","112778865","112778986","chr13","25546692","25546816","15","87232173"
"chr4","112791626","112791810","chr4","10620248","10620428","38","102171378"
"chr4","112802045","112802345","chr5","108632609","108632905","30","4169436"
"chr4","112803945","112804251","chr5","108634497","108634803","21","4169448"
"chr4","112811119","112811401","chr5","108640558","108640827","23","4170561"
"chr4","112857069","112857375","chr5","108685261","108685548","34","4171808"
"chr4","112860065","112860354","chr5","108688217","108688507","24","4171848"
"chr4","112866846","112866947","chr5","108695568","108695669","2","4171278"
"chr4","112880116","112880240","chr5","97114497","97114620","23","15765619"
"chr4","112927310","112927598","chr5","108757470","108757771","43","4169840"
"chr4","112956373","112956472","chr2","56499880","56499978","23","56456493"
"chr4","112957467","112957622","chr4","137551997","137552166","50","24594530"
"chr4","112969351","112969633","chr19","26015208","26015490","66","86954143"
"chr4","112990774","112991004","chr5","108819981","108820231","33","4170793"
"chr4","113060944","113060982","chr12","115695478","115695517","8","2634534"
"chr4","113061237","113061381","chr11","63297233","63297378","21","49764004"
"chr4","113069546","113069836","chr5","108901311","108901604","30","4168235"
"chr4","113075854","113076114","chr5","108907675","108907941","23","4168179"
"chr4","113091748","113091968","chr5","108923837","108924054","13","4167911"
"chr4","113101533","113101853","chr4","36470308","36470624","63","76631225"
"chr4","113116516","113116787","chr5","108950802","108951067","23","4165714"
"chr4","113173177","113173464","chr5","109001793","109002085","22","4171384"
"chr4","113176086","113176396","chr5","109004354","109004664","38","4171732"
"chr4","113178258","113178382","chr1","205464254","205464380","20","92285996"
"chr4","113197553","113197838","chr5","109027546","109027831","21","4170007"
"chr4","113216923","113217096","chr9","123266663","123266835","34","10049740"
"chr4","113217406","113217452","chr3","121077140","121077186","10","7859734"
"chr4","113219261","113219555","chr5","109052209","109052504","22","4167052"
"chr4","113225186","113225480","chr5","109058376","109058670","14","4166810"
"chr4","113230451","113230723","chr5","109063607","109063858","29","4166844"
"chr4","113233956","113234246","chr5","109067722","109067998","33","4166234"
"chr4","113239406","113239692","chr5","109073157","109073447","22","4166249"
"chr4","113251546","113251827","chr5","109086881","109087160","19","4164665"
"chr4","113262400","113262640","chr5","109098554","109098795","19","4163846"
"chr4","113269255","113269380","chr3","178749148","178749275","32","65479893"
"chr4","113269678","113269861","chr12","106687738","106687925","46","6581940"
"chr4","113272742","113272790","chr12","34502965","34503015","8","78769777"
"chr4","113273093","113273278","chrX","5313319","5313490","45","107959774"
"chr4","113288053","113288184","chr13","87095059","87095190","21","26192994"
"chr4","113292799","113293019","chr20","53017139","53017355","37","60275660"
"chr4","113313568","113313833","chr5","109202276","109202535","19","4111292"
"chr4","113318979","113319275","chrX","30604149","30604445","62","82714830"
"chr4","113319997","113320286","chr5","109209318","109209601","21","4110679"
"chr4","113335131","113335360","chr5","109223133","109223363","19","4111998"
"chr4","113347741","113347932","chr12","84919365","84919556","43","28428376"
"chr4","113369986","113370203","chr5","109275499","109275718","18","4094487"
"chr4","113375762","113376047","chr5","109281379","109281640","43","4094383"
"chr4","113418137","113418358","chr5","109312919","109313146","23","4105218"
"chr4","113425226","113425349","chr6","169525376","169525499","30","56100150"
"chr4","113461429","113461699","chr5","109353504","109353746","41","4107925"
"chr4","113474038","113474337","chr5","109361014","109361313","24","4113024"
"chr4","113505543","113505632","chr5","109387299","109387388","3","4118244"
"chr4","113579729","113579966","chr8","28424414","28424640","60","85155315"
"chr4","113583313","113583597","chr8","71344285","71344564","63","42239028"
"chr4","113598003","113598116","chrX","40491044","40491160","15","73106959"
"chr4","113623824","113624083","chr5","109523213","109523459","27","4100611"
"chr4","113635065","113635371","chr5","109534250","109534558","26","4100815"
"chr4","113635680","113635978","chr5","109534895","109535182","27","4100785"
"chr4","113640718","113641021","chr12","91704994","91705286","74","21935724"
"chr4","113653327","113653594","chr5","109550554","109550822","18","4102773"
"chr4","113796888","113797204","chr2","107411533","107411833","66","6385355"
"chr4","113835324","113835502","chr19","28356007","28356185","31","85479317"
"chr4","113835545","113835657","chr7","129704408","129704518","19","15868863"
"chr4","113950586","113950878","chr17","15345725","15346009","71","98604861"
"chr4","113953802","113954110","chr5","109834705","109835007","32","4119097"
"chr4","114027616","114027907","chr16","49230039","49230309","77","64797577"
"chr4","114116744","114116929","chr13","47508388","47508574","44","66608356"
"chr4","114218486","114218807","chr10","64879020","64879341","73","49339466"
"chr4","114767902","114768020","chr5","110659732","110659850","3","4108170"
"chr4","114881666","114881956","chr5","110774069","110774359","21","4107597"
"chr4","114948127","114948463","chr12","59156271","59156597","81","55791856"
"chr4","114963111","114963233","chr5","110856831","110856953","9","4106280"
"chr4","115011494","115011799","chr5","110908983","110909287","30","4102511"
"chr4","115111341","115111631","chr5","111012643","111012934","25","4098698"
"chr4","115168498","115168792","chr5","111059640","111059935","27","4108858"
"chr4","115176356","115176683","chr12","120705770","120706089","69","5529414"
"chr4","115280988","115281265","chr15","67957591","67957872","60","47323397"
"chr4","115314874","115315153","chr5","111208447","111208724","21","4106427"
"chr4","115376959","115377266","chr5","111265437","111265751","28","4111522"
"chr4","115389893","115390193","chr5","111277545","111277874","53","4112348"
"chr4","115427639","115427856","chr16","31100169","31100379","40","84327470"
"chr4","115450752","115451048","chr5","111336206","111336504","38","4114546"
"chr4","115469070","115469366","chr5","111354576","111354886","46","4114494"
"chr4","115540754","115540993","chr5","111420566","111420818","28","4120188"
"chr4","115547746","115548008","chr5","111428158","111428410","35","4119588"
"chr4","115556748","115557053","chr5","111437443","111437742","22","4119305"
"chr4","115557838","115558134","chr5","111438524","111438808","32","4119314"
"chr4","115582474","115582597","chr5","111464681","111464804","10","4117793"
"chr4","115594642","115594770","chr5","111476907","111477032","16","4117735"
"chr4","115618895","115619176","chr5","111498528","111498833","50","4120367"
"chr4","115646673","115646783","chr6","88369840","88369952","24","27276833"
"chr4","115648325","115648501","chr7","92039014","92039198","39","23609311"
"chr4","115650380","115650682","chr3","43455801","43456111","60","72194579"
"chr4","115650986","115651263","chrX","123574210","123574485","60","7923224"
"chr4","115658088","115658400","chr5","111526119","111526430","25","4131969"
"chr4","115658627","115658917","chr5","111526665","111526949","23","4131962"
"chr4","115673668","115673812","chr5","111539557","111539701","10","4134111"
"chr4","115673813","115674118","chr5","111539702","111540006","24","4134111"
"chr4","115674119","115674279","chr5","111540007","111540166","9","4134112"
"chr4","115678079","115678385","chr5","111544720","111545011","35","4133359"
"chr4","115684084","115684208","chr5","111551258","111551389","12","4132826"
"chr4","115715605","115715831","chr1","160389426","160389648","46","44673821"
"chr4","115715866","115715961","chr4","15278126","15278223","17","100437740"
"chr4","115718518","115718819","chr5","111592362","111592658","23","4126156"
"chr4","115719974","115720181","chr5","111593822","111594012","30","4126152"
"chr4","115720278","115720551","chr4","128534300","128534581","59","12814022"
"chr4","115741061","115741252","chr1","88862952","88863130","52","26878109"
"chr4","115747411","115747703","chr5","111627147","111627431","37","4120264"
"chr4","115751246","115751419","chr5","111631924","111632089","18","4119322"
"chr4","115751716","115751859","chr5","111632386","111632528","17","4119330"
"chr4","115752803","115752937","chr6","93577303","93577440","28","22175500"
"chr4","115753524","115753657","chr11","54678543","54678677","24","61074981"
"chr4","115770159","115770287","chr5","111655249","111655376","6","4114910"
"chr4","115771699","115771978","chr5","111656789","111657070","25","4114910"
"chr4","115783038","115783154","chr10","88509301","88509403","41","27273737"
"chr4","115789262","115789555","chr6","73061285","73061586","68","42727977"
"chr4","115789724","115789984","chr4","81670831","81671108","74","34118893"
"chr4","115791925","115792210","chr5","111672329","111672631","37","4119596"
"chr4","115799780","115799968","chr5","111680775","111680968","22","4119005"
"chr4","115800266","115800276","chr3","42787293","42787303","2","73012973"
"chr4","115800542","115800671","chr5","111681572","111681701","13","4118970"
"chr4","115820083","115820381","chr5","111702303","111702595","35","4117780"
"chr4","115863907","115864161","chr5","111753722","111753988","26","4110185"
"chr4","115865724","115866026","chr5","111755637","111755938","19","4110087"
"chr4","115883057","115883355","chr5","111774359","111774660","27","4108698"
"chr4","115931006","115931315","chr5","111820866","111821180","20","4110140"
"chr4","115937160","115937461","chr5","111827753","111828053","32","4109407"
"chr4","115937560","115937865","chr5","111828153","111828452","32","4109407"
"chr4","115983987","115984163","chr1","187334824","187335000","38","71350837"
"chr4","115999682","115999989","chr5","111891324","111891626","26","4108358"
"chr4","116054344","116054625","chr5","111942256","111942542","17","4112088"
"chr4","116084449","116084752","chr5","111971456","111971772","35","4112993"
"chr4","116093480","116093777","chr5","111981100","111981386","24","4112380"
"chr4","116216597","116216853","chr5","112107289","112107570","37","4109308"
"chr4","116260336","116260618","chr5","112150008","112150279","32","4110328"
"chr4","116271740","116272041","chr5","112161802","112162085","36","4109938"
"chr4","116325568","116325729","chr3","126621167","126621327","32","10295599"
"chr4","116325755","116325870","chr12","82551636","82551752","19","33774119"
"chr4","116372587","116372886","chr5","112263080","112263383","22","4109507"
"chr4","116472562","116472867","chr5","112365103","112365405","41","4107459"
"chr4","116481568","116481778","chr5","112374134","112374346","25","4107434"
"chr4","116512290","116512588","chr9","115685420","115685715","51","826870"
"chr4","116528537","116528826","chr5","112421734","112422040","48","4106803"
"chr4","116534263","116534562","chr5","112427533","112427852","39","4106730"
"chr4","116555326","116555618","chr5","112449086","112449378","31","4106240"
"chr4","116589856","116590152","chr4","2519086","2519378","56","114070770"
"chr4","116612572","116612699","chr14","20015104","20015228","19","96597468"
"chr4","116638180","116638303","chr5","112526981","112527104","9","4111199"
"chr4","116669706","116669988","chr5","112565342","112565611","34","4104364"
"chr4","116672836","116672959","chr5","112568022","112568151","10","4104814"
"chr4","116688661","116688864","chr5","112585065","112585265","12","4103596"
"chr4","116706726","116707032","chr5","112601222","112601542","33","4105504"
"chr4","116728004","116728291","chr5","112617259","112617546","18","4110745"
"chr4","116776742","116777024","chr20","52360928","52361210","69","64415814"
"chr4","116806493","116806791","chr5","112689231","112689529","20","4117262"
"chr4","116846330","116846625","chr14","19958929","19959220","64","96887401"
"chr4","116958343","116958548","chr9","57893553","57893752","58","59064790"
"chr4","116959904","116960196","chr5","112853133","112853427","27","4106771"
"chr4","117031686","117031820","chr5","112929726","112929857","7","4101960"
"chr4","117048136","117048352","chr5","112946735","112946938","20","4101401"
"chr4","117109282","117109483","chr5","113007283","113007463","28","4101999"
"chr4","117399358","117399480","chr5","113343061","113343185","10","4056297"
"chr4","117448011","117448271","chr5","186597229","186597499","68","69149218"
"chr4","117475864","117476163","chr5","113488314","113488605","24","3987550"
"chr4","117593916","117594209","chr20","26839945","26840237","62","90753971"
"chr4","117775068","117775359","chr5","113797406","113797712","36","3977662"
"chr4","117887640","117887943","chr2","165008183","165008489","63","47120543"
"chr4","118182917","118183240","chr5","114212806","114213093","52","3970111"
"chr4","118191115","118191401","chr5","114220995","114221295","41","3970120"
"chr4","118403500","118403780","chr5","114423263","114423544","15","3980237"
"chr4","118474198","118474508","chr5","114515818","114516128","32","3958380"
"chr4","118475211","118475503","chr5","114516849","114517144","25","3958362"
"chr4","118662928","118663116","chr3","84781903","84782098","54","33881025"
"chr4","118757479","118757759","chr3","92949155","92949418","79","25808324"
"chr4","118974649","118974936","chr9","63095691","63095976","69","55878958"
"chr4","119120016","119120317","chr5","115165275","115165576","37","3954741"
"chr4","119210227","119210531","chr5","115265269","115265562","38","3944958"
"chr4","119210979","119211242","chr3","45191768","45192031","67","74019211"
"chr4","119414279","119414567","chr5","115476893","115477218","67","3937386"
"chr4","119431601","119431725","chr5","115494937","115495061","9","3936664"
"chr4","119446779","119447070","chr4","18697171","18697456","61","100749608"
"chr4","119458461","119458574","chr7","138446004","138446118","19","18987543"
"chr4","119493499","119493782","chr5","115550730","115551023","34","3942769"
"chr4","119523964","119524254","chr7","138266796","138267091","55","18742832"
"chr4","119534094","119534399","chr5","115601302","115601601","26","3932792"
"chr4","119571063","119571369","chr5","115632592","115632897","27","3938471"
"chr4","119627411","119627578","chr10","72119610","72119772","54","47507801"
"chr4","119740143","119740291","chr1","52423090","52423229","48","67317053"
"chr4","119971823","119972126","chr5","116124917","116125200","47","3846906"
"chr4","119988310","119988569","chr5","116164159","116164437","49","3824151"
"chr4","120085318","120085444","chr5","116257704","116257830","5","3827614"
"chr4","120132086","120132374","chr5","116315283","116315568","30","3816803"
"chr4","120207468","120207587","chr5","116375364","116375489","15","3832104"
"chr4","120461601","120461893","chr11","113114919","113115214","63","7346682"
"chr4","120486954","120487259","chr5","116780159","116780509","66","3706795"
"chr4","120526591","120526872","chr5","116815184","116815466","12","3711407"
"chr4","120532104","120532387","chr5","116820837","116821146","42","3711267"
"chr4","120687369","120687428","chr6","33931797","33931855","17","86755572"
"chr4","120837231","120837527","chr5","117111656","117111926","55","3725575"
"chr4","120877301","120877402","chr5","117152809","117152909","5","3724492"
"chr4","121102797","121103001","chr3","38839947","38840148","35","82262850"
"chr4","121234552","121234855","chr5","117477782","117478096","34","3756770"
"chr4","121299781","121300092","chr1","39092983","39093291","61","82206798"
"chr4","121319361","121319675","chr5","117564842","117565156","14","3754519"
"chr4","121320010","121320293","chr5","117565480","117565763","19","3754530"
"chr4","121327461","121327745","chr5","117572891","117573180","25","3754570"
"chr4","121328914","121329081","chr5","117574310","117574479","17","3754604"
"chr4","121329383","121329491","chr5","117574786","117574879","20","3754597"
"chr4","121343437","121343678","chr2","43858147","43858372","57","77485290"
"chr4","121367111","121367430","chr5","117613693","117614005","25","3753418"
"chr4","121368372","121368687","chr5","117614955","117615260","25","3753417"
"chr4","121391032","121391205","chrX","19065498","19065662","37","102325534"
"chr4","121391207","121391523","chr5","117637746","117638064","22","3753461"
"chr4","121423707","121424024","chr18","1158360","1158673","57","120265347"
"chr4","121446744","121447058","chr5","117680879","117681183","31","3765865"
"chr4","121492615","121492909","chr5","117726402","117726685","31","3766213"
"chr4","121534177","121534479","chrX","48162977","48163283","66","73371200"
"chr4","121534490","121534769","chr5","117767278","117767552","24","3767212"
"chr4","121561915","121562218","chr5","117793840","117794146","37","3768075"
"chr4","121570126","121570420","chr5","117801957","117802257","17","3768169"
"chr4","121575211","121575502","chr5","117806673","117806969","28","3768538"
"chr4","121602520","121602779","chr5","117832757","117833008","29","3769763"
"chr4","121652872","121653132","chr5","117898969","117899232","19","3753903"
"chr4","121663043","121663351","chr9","105999659","105999970","65","15663384"
"chr4","121667214","121667532","chr5","117913365","117913681","20","3753849"
"chr4","121676905","121677210","chr1","8981776","8982081","55","112695129"
"chr4","121712063","121712325","chr5","117958619","117958888","25","3753444"
"chr4","121733653","121733902","chr5","117979144","117979383","27","3754509"
"chr4","121778477","121778592","chr5","118026897","118027012","9","3751580"
"chr4","121801670","121801947","chr5","118050622","118050899","12","3751048"
"chr4","121904117","121904239","chr10","8237746","8237873","19","113666371"
"chr4","121935332","121935616","chr5","118173079","118173366","26","3762253"
"chr4","121980168","121980480","chr3","43652365","43652670","60","78327803"
"chr4","122014532","122014782","chr5","118248841","118249092","15","3765691"
"chr4","122017426","122017728","chr5","118251737","118252047","34","3765689"
"chr4","122040729","122040822","chr5","118273945","118274029","13","3766784"
"chr4","122042861","122043150","chr5","118276149","118276444","25","3766712"
"chr4","122048351","122048464","chr5","118281663","118281773","10","3766688"
"chr4","122061730","122062041","chr5","118295018","118295324","28","3766712"
"chr4","122072773","122072890","chr5","165493499","165493616","11","43420726"
"chr4","122906058","122906339","chr5","118392044","118392318","29","4514014"
"chr4","122945226","122945533","chr5","118425154","118425458","26","4520072"
"chr4","122979038","122979341","chr5","118458581","118458852","49","4520457"
"chr4","123026988","123027132","chr16","50394120","50394272","35","72632868"
"chr4","123080975","123081235","chr7","131398459","131398720","63","8317484"
"chr4","123092909","123093080","chr9","29821088","29821253","31","93271821"
"chr4","123132860","123133158","chr5","118602381","118602677","36","4530479"
"chr4","123148104","123148285","chrX","117522589","117522767","44","5625515"
"chr4","123286705","123286820","chr20","12349654","12349770","17","110937051"
"chr4","123301701","123301900","chr2","93948387","93948597","52","29353314"
"chr4","123344943","123345108","chr3","40421992","40422160","40","82922951"
"chr4","123365958","123366080","chr5","118883966","118884084","17","4481992"
"chr4","123751309","123751437","chr5","119259540","119259661","15","4491769"
"chr4","123826547","123826842","chr5","119325449","119325729","42","4501098"
"chr4","123904546","123904847","chr5","119405127","119405422","26","4499419"
"chr4","123939897","123940119","chr5","119437889","119438093","33","4502008"
"chr4","123955703","123955956","chr5","119443936","119444191","20","4511767"
"chr4","124048197","124048509","chr5","119537821","119538128","25","4510376"
"chr4","124204058","124204371","chr5","119682732","119683045","27","4521326"
"chr4","124217325","124217579","chr5","119696710","119696970","16","4520615"
"chr4","124240168","124240366","chr5","119720534","119720732","5","4519634"
"chr4","124240532","124240602","chr4","109565285","109565356","16","14675247"
"chr4","124250496","124250773","chr5","119731220","119731504","24","4519276"
"chr4","124270424","124270591","chr5","119753942","119754113","19","4516482"
"chr4","124270652","124270775","chr5","119754148","119754270","7","4516504"
"chr4","124277673","124277974","chr5","119761153","119761470","31","4516520"
"chr4","124352754","124353025","chr5","119833179","119833481","50","4519575"
"chr4","124354218","124354373","chr1","19925804","19925957","32","104428414"
"chr4","124354399","124354431","chr3","164879589","164879624","6","40525190"
"chr4","124362915","124363201","chr5","119842652","119842935","15","4520263"
"chr4","124367790","124368106","chr5","119847495","119847820","32","4520295"
"chr4","124388422","124388753","chr5","119867405","119867693","65","4521017"
"chr4","124390896","124391195","chr5","119869830","119870128","17","4521066"
"chr4","124486632","124486949","chr5","119973795","119974121","31","4512837"
"chr4","124568900","124568977","chr11","956174","956250","15","123612726"
"chr4","124623952","124624077","chr1","159678880","159679002","23","35054928"
"chr4","124679882","124680185","chr5","120169824","120170132","28","4510058"
"chr4","124953832","124953951","chr5","120474890","120475011","9","4478942"
"chr4","124975482","124975763","chr5","120505900","120506213","57","4469582"
"chr4","125001103","125001375","chr5","120530796","120531069","8","4470307"
"chr4","125052230","125052537","chr5","120585843","120586141","32","4466387"
"chr4","125120157","125120441","chr5","120653065","120653347","23","4467092"
"chr4","125124441","125124730","chr5","120657355","120657646","19","4467086"
"chr4","125146340","125146634","chr5","120681090","120681400","29","4465250"
"chr4","125178428","125178734","chr5","120721257","120721570","30","4457171"
"chr4","125179478","125179784","chr5","120722406","120722726","28","4457072"
"chr4","125194998","125195298","chrX","19017046","19017338","56","106177952"
"chr4","125214028","125214113","chr5","120757371","120757456","7","4456657"
"chr4","125261995","125262279","chr5","120804987","120805288","36","4457008"
"chr4","125284335","125284641","chr5","120893084","120893375","33","4391251"
"chr4","125324088","125324214","chr13","87117447","87117570","18","38206641"
"chr4","125324265","125324446","chrX","97446542","97446722","43","27877723"
"chr4","125376907","125377189","chr1","211215809","211216098","58","85838902"
"chr4","125384808","125385103","chr5","120995097","120995409","29","4389711"
"chr4","125538481","125538661","chr10","36355352","36355529","57","89183129"
"chr4","125606770","125607019","chr5","121216313","121216562","12","4390457"
"chr4","125613201","125613481","chr5","121222660","121222965","35","4390541"
"chr4","125641796","125642093","chr5","121250929","121251228","13","4390867"
"chr4","125649895","125650191","chr5","121260176","121260471","13","4389719"
"chr4","125707436","125707703","chr11","40462262","40462512","79","85245174"
"chr4","125713512","125713768","chr5","121329670","121329925","9","4383842"
"chr4","125739800","125740093","chr5","121356858","121357160","36","4382942"
"chr4","125747671","125747968","chr5","121364761","121365065","22","4382910"
"chr4","125840683","125840902","chr5","121496926","121497146","19","4343757"
"chr4","125874216","125874491","chr5","121523167","121523449","14","4351049"
"chr4","125876320","125876493","chr5","121525271","121525445","19","4351049"
"chr4","125911472","125911754","chr5","121554351","121554639","24","4357121"
"chr4","126028527","126028732","chr5","121672992","121673196","12","4355535"
"chr4","126043755","126044058","chr5","121688863","121689171","23","4354892"
"chr4","126125122","126125431","chr5","121793227","121793512","42","4331895"
"chr4","126167603","126167882","chr5","121836256","121836544","28","4331347"
"chr4","126208792","126209103","chr5","121878196","121878494","23","4330596"
"chr4","126243735","126244032","chr5","121914192","121914491","23","4329543"
"chr4","126289245","126289529","chr5","121953933","121954220","24","4335312"
"chr4","126289787","126289921","chr5","121954475","121954611","15","4335312"
"chr4","126312620","126312920","chr5","121976873","121977176","41","4335747"
"chr4","126367234","126367529","chr1","17757381","17757681","65","108609853"
"chr4","126404092","126404375","chr5","122102160","122102441","22","4301932"
"chr4","126448849","126449158","chr5","122149200","122149504","24","4299649"
"chr4","126472997","126473299","chr2","165008183","165008489","70","38535186"
"chr4","126507303","126507589","chr5","122209672","122209964","27","4297631"
"chr4","126534198","126534499","chr5","122242986","122243293","25","4291212"
"chr4","126538657","126538971","chr8","52130405","52130708","58","74408252"
"chr4","126561273","126561554","chr5","122261266","122261547","22","4300007"
"chr4","126620973","126621267","chr5","122323599","122323892","15","4297374"
"chr4","126632889","126633183","chr5","122335558","122335838","31","4297331"
"chr4","126659571","126659873","chr5","122362122","122362413","28","4297449"
"chr4","126665018","126665327","chr5","122367560","122367840","52","4297458"
"chr4","126675072","126675363","chr5","122378030","122378317","20","4297042"
"chr4","126727533","126727826","chr15","41976516","41976818","72","84751017"
"chr4","126741147","126741465","chr5","122443176","122443482","28","4297971"
"chr4","126766768","126767076","chr5","122467208","122467500","28","4299560"
"chr4","126768025","126768292","chr5","122468442","122468690","43","4299583"
"chr4","126782684","126782984","chr5","122479859","122480176","33","4302825"
"chr4","126785831","126786143","chr5","122483022","122483326","27","4302809"
"chr4","126873463","126873771","chr7","165716105","165716404","52","38842642"
"chr4","126889664","126889953","chr10","69629356","69629644","56","57260308"
"chr4","126960298","126960490","chr5","122714565","122714765","25","4245733"
"chr4","126978896","126979175","chr5","122733210","122733482","18","4245686"
"chr4","127048265","127048567","chr5","122798164","122798448","39","4250101"
"chr4","127048744","127049034","chr1","60679452","60679746","51","66369292"
"chr4","127070357","127070664","chr5","122817576","122817881","28","4252781"
"chr4","127156394","127156672","chr5","122902151","122902404","42","4254243"
"chr4","127162287","127162586","chr5","122908414","122908712","32","4253873"
"chr4","127350716","127350941","chr5","123146709","123146933","17","4204007"
"chr4","127393383","127393672","chr8","28623574","28623869","75","98769809"
"chr4","127509788","127510076","chr5","123294138","123294427","22","4215650"
"chr4","127617258","127617550","chr5","123393637","123393930","29","4223621"
"chr4","127670126","127670424","chr5","123443149","123443449","42","4226977"
"chr4","127796667","127796977","chr5","123559133","123559425","47","4237534"
"chr4","127848252","127848504","chr17","81613119","81613364","64","46235133"
"chr4","127963907","127964026","chr20","65014620","65014741","24","62949287"
"chr4","127967975","127968100","chr5","14863431","14863555","18","113104544"
"chr4","128227655","128227850","chr4","26024801","26024989","56","102202854"
"chr4","128313111","128313422","chr5","124132601","124132897","37","4180510"
"chr4","128360570","128360873","chr5","124179118","124179435","28","4181452"
"chr4","128464276","128464589","chr5","124345445","124345761","25","4118831"
"chr4","128507796","128508084","chr5","124389006","124389296","27","4118790"
"chr4","128572138","128572259","chr5","124452904","124453011","22","4119234"
"chr4","128970737","128970858","chr5","124896066","124896187","7","4074671"
"chr4","129093305","129093550","chr8","38412179","38412409","58","90681126"
"chr4","129301335","129301633","chr5","125239410","125239695","34","4061925"
"chr4","129422624","129422932","chr5","125347858","125348166","37","4074766"
"chr4","129692961","129693230","chr5","125618744","125619016","20","4074217"
"chr4","129775078","129775375","chr5","125710012","125710306","23","4065066"
"chr4","129899571","129899861","chr5","125876166","125876456","17","4023405"
"chr4","129996955","129997226","chr5","125971408","125971679","24","4025547"
"chr4","130018732","130019050","chr14","63858277","63858583","72","66160455"
"chr4","130038575","130038911","chr5","126019862","126020184","42","4018713"
"chr4","130258317","130258612","chr5","126066468","126066769","25","4191849"
"chr4","130331787","130331906","chr16","46274531","46274645","27","84057256"
"chr4","130371041","130371346","chr5","126182595","126182880","39","4188446"
"chr4","130468010","130468345","chr4","114742517","114742838","75","15725493"
"chr4","130476664","130476962","chr5","126305930","126306224","34","4170734"
"chr4","130478317","130478605","chr5","126307575","126307892","46","4170742"
"chr4","130495955","130496237","chr5","126325714","126326019","51","4170241"
"chr4","130592779","130593064","chr5","126417875","126418141","40","4174904"
"chr4","130611238","130611415","chr5","126434699","126434858","36","4176539"
"chr4","130775009","130775315","chr5","126602886","126603186","34","4172123"
"chr4","130806385","130806486","chr14","51273729","51273813","23","79532656"
"chr4","130814985","130815096","chr5","126643194","126643304","8","4171791"
"chr4","130816094","130816310","chr5","126644167","126644368","32","4171927"
"chr4","130831277","130831584","chr5","126659356","126659655","30","4171921"
"chr4","131078245","131078504","chr5","126892884","126893146","25","4185361"
"chr4","131112684","131112971","chr5","126925700","126925990","25","4186984"
"chr4","131159916","131160238","chr5","126979217","126979543","19","4180699"
"chr4","131193756","131194033","chr5","127015455","127015763","49","4178301"
"chr4","131197256","131197548","chr5","127019014","127019304","19","4178242"
"chr4","131199292","131199504","chr3","41270686","41270884","53","89928606"
"chr4","131207234","131207532","chr5","127029461","127029753","19","4177773"
"chr4","131236235","131236510","chr5","127048870","127049131","26","4187365"
"chr4","131245876","131246124","chr8","45404265","45404504","62","85841611"
"chr4","131256127","131256412","chr5","127067580","127067866","19","4188547"
"chr4","131269833","131270137","chr5","127081264","127081568","24","4188569"
"chr4","131280068","131280356","chr5","127096926","127097199","24","4183142"
"chr4","131295569","131295853","chr5","127112325","127112592","36","4183244"
"chr4","131356294","131356572","chr5","127165907","127166197","31","4190387"
"chr4","131384306","131384415","chr12","81357208","81357320","25","50027098"
"chr4","131387365","131387595","chr5","127193556","127193767","32","4193809"
"chr4","131392763","131392893","chr5","127198899","127199025","12","4193864"
"chr4","131395897","131396192","chr3","70148308","70148600","54","61247589"
"chr4","131404537","131404824","chr5","127213017","127213310","31","4191520"
"chr4","131419223","131419559","chr6","70441047","70441347","86","60978176"
"chr4","131420490","131420801","chr5","127255489","127255795","21","4165001"
"chr4","131444078","131444382","chr5","127283289","127283594","28","4160789"
"chr4","131444986","131445116","chr6","171645003","171645132","20","40200017"
"chr4","131445426","131445595","chr3","7457961","7458121","35","123987465"
"chr4","131479272","131479561","chr11","108543104","108543382","69","22936168"
"chr4","131492116","131492333","chr5","127334703","127334903","28","4157413"
"chr4","131496977","131497236","chr3","136459749","136460007","55","4962772"
"chr4","131502442","131502721","chr4","115169933","115170214","56","16332509"
"chr4","131541818","131541937","chr19","18096089","18096207","24","113445729"
"chr4","131556045","131556346","chr5","127413950","127414260","27","4142095"
"chr4","131581570","131581821","chr5","127440645","127440893","27","4140925"
"chr4","131599766","131599891","chr5","127459357","127459483","4","4140409"
"chr4","131603704","131603998","chr16","55700437","55700720","70","75903267"
"chr4","131619915","131620213","chr5","127479150","127479446","24","4140765"
"chr4","131628494","131628795","chr5","127487906","127488188","37","4140588"
"chr4","131640692","131640972","chr5","127500543","127500824","17","4140149"
"chr4","131649707","131649824","chr7","96669674","96669791","16","34980033"
"chr4","131662296","131662607","chr5","127523001","127523310","33","4139295"
"chr4","131686263","131686381","chr5","127552189","127552307","6","4134074"
"chr4","131737613","131737912","chr5","127606751","127607063","29","4130862"
"chr4","131804985","131805294","chr5","127676336","127676647","26","4128649"
"chr4","131809512","131809784","chr2","113667966","113668241","68","18141546"
"chr4","131845584","131845857","chr5","127724391","127724668","60","4121193"
"chr4","131935836","131936114","chr5","127806206","127806475","29","4129630"
"chr4","131942089","131942171","chrX","53790985","53791067","10","78151104"
"chr4","132007673","132007957","chr5","127878545","127878826","20","4129128"
"chr4","132019450","132019727","chr5","127890371","127890651","18","4129079"
"chr4","132082269","132082570","chr9","96028798","96029097","59","36053471"
"chr4","132122366","132122675","chr5","127983728","127984024","32","4138638"
"chr4","132131826","132132126","chr5","127993576","127993854","51","4138250"
"chr4","132138414","132138720","chr5","127998773","127999071","22","4139641"
"chr4","132146318","132146612","chr1","211353988","211354282","67","79207670"
"chr4","132188886","132189174","chr5","128048931","128049208","40","4139955"
"chr4","132192111","132192332","chr5","128052447","128052660","33","4139664"
"chr4","132197362","132197497","chr5","128057439","128057572","9","4139923"
"chr4","132198978","132199271","chr5","128059069","128059363","29","4139909"
"chr4","132207529","132207763","chr16","47705039","47705279","71","84502490"
"chr4","132211916","132212237","chr5","128073998","128074288","48","4137918"
"chr4","132233600","132233884","chr5","128096556","128096838","17","4137044"
"chr4","132235196","132235497","chr11","40484053","40484354","62","91751143"
"chr4","132236301","132236523","chr3","128728563","128728790","52","3507738"
"chr4","132241278","132241608","chr5","128103958","128104280","38","4137320"
"chr4","132245301","132245590","chr5","128107662","128107948","19","4137639"
"chr4","132317200","132317510","chr2","29337642","29337952","63","102979558"
"chr4","132346071","132346345","chr1","211215809","211216098","67","78869738"
"chr4","132349608","132349916","chr5","128217561","128217863","34","4132047"
"chr4","132363289","132363574","chr11","27873752","27874033","60","104489537"
"chr4","132370606","132370901","chr5","128233224","128233527","21","4137382"
"chr4","132385162","132385372","chr5","128247866","128248078","15","4137296"
"chr4","132407677","132407892","chr5","128272222","128272435","17","4135455"
"chr4","132532745","132533025","chr5","128394377","128394655","13","4138368"
"chr4","132545518","132545802","chr5","128407022","128407290","36","4138496"
"chr4","132654423","132654701","chr5","128516583","128516861","19","4137840"
"chr4","132684307","132684593","chr5","128552135","128552421","20","4132172"
"chr4","132921730","132922022","chr3","43306164","43306451","58","89615566"
"chr4","132937177","132937301","chr5","128808476","128808600","11","4128701"
"chr4","133065329","133065656","chr5","128940492","128940748","83","4124837"
"chr4","133145146","133145443","chr5","129077085","129077376","25","4068061"
"chr4","133217674","133217928","chr5","129145825","129146111","45","4071849"
"chr4","133240612","133240733","chr5","129168403","129168528","8","4072209"
"chr4","133264471","133264752","chr5","129192441","129192717","48","4072030"
"chr4","133310452","133310732","chr5","129237600","129237886","23","4072852"
"chr4","133374623","133374866","chr5","129294409","129294649","26","4080214"
"chr4","133482447","133482562","chr18","5830260","5830376","10","127652187"
"chr4","133611599","133611880","chr9","22873625","22873899","71","110737974"
"chr4","133652030","133652348","chr15","5184509","5184816","86","128467521"
"chr4","133718324","133718522","chr12","104789078","104789268","48","28929246"
"chr4","133815102","133815295","chr5","129735248","129735441","17","4079854"
"chr4","133824926","133825206","chr5","129745106","129745382","30","4079820"
"chr4","134006860","134007134","chr20","3615799","3616074","69","130391061"
"chr4","134020701","134020927","chr5","130011783","130012027","28","4008918"
"chr4","134043376","134043675","chr5","130034886","130035188","32","4008490"
"chr4","134047273","134047560","chr5","130038864","130039156","35","4008409"
"chr4","134125859","134126158","chr5","130106862","130107160","23","4018997"
"chr4","134213337","134213636","chr5","130191393","130191715","50","4021944"
"chr4","134279636","134279722","chr1","16674594","16674681","20","117605042"
"chr4","134448912","134449173","chr5","130482772","130482995","58","3966140"
"chr4","134526095","134526401","chr5","130576685","130576994","31","3949410"
"chr4","134595790","134596068","chr5","130634521","130634803","17","3961269"
"chr4","134599378","134599675","chr5","130638119","130638398","44","3961259"
"chr4","134666014","134666298","chr5","130710470","130710754","27","3955544"
"chr4","134780587","134780766","chr5","130726505","130726688","14","4054082"
"chr4","134803744","134804041","chr13","106703780","106704068","65","28099964"
"chr4","134933128","134933350","chr16","73992318","73992542","53","60940810"
"chr4","134968912","134969228","chr5","130914113","130914409","45","4054799"
"chr4","134992709","134992990","chr5","8246617","8246904","64","126746092"
"chr4","135047084","135047354","chr5","130977584","130977880","47","4069500"
"chr4","135049106","135049388","chr17","10027637","10027911","64","125021469"
"chr4","135112625","135112932","chr5","131047744","131048051","23","4064881"
"chr4","135155669","135155963","chr3","41763867","41764167","76","93391802"
"chr4","135172061","135172340","chr5","131113084","131113374","48","4058977"
"chr4","135177357","135177640","chr5","131118614","131118909","39","4058743"
"chr4","135730432","135730666","chr1","23942951","23943176","64","111787481"
"chr4","135784253","135784428","chr5","131693817","131693992","17","4090436"
"chr4","135831710","135832008","chr5","131741813","131742101","41","4089897"
"chr4","135903418","135903695","chr10","73547951","73548234","70","62355467"
"chr4","135905770","135906040","chr5","131813957","131814224","19","4091813"
"chr4","135926378","135926708","chr5","131836749","131837083","39","4089629"
"chr4","136052988","136053268","chr3","84606981","84607263","62","51446007"
"chr4","136080099","136080420","chr5","120169824","120170132","72","15910275"
"chr4","136162323","136162601","chr5","132086043","132086342","39","4076280"
"chr4","136187947","136188216","chr20","23086388","23086644","65","113101559"
"chr4","136421279","136421563","chr5","132436713","132436983","30","3984566"
"chr4","136552706","136552999","chr5","132561350","132561644","37","3991356"
"chr4","136594467","136594773","chr5","132603404","132603706","33","3991063"
"chr4","136695575","136695735","chr5","77716038","77716186","37","58979537"
"chr4","136696045","136696162","chr7","122693234","122693341","30","14002811"
"chr4","136789169","136789441","chr2","90039073","90039336","72","46750096"
"chr4","137011930","137012010","chr5","133044055","133044132","10","3967875"
"chr4","137116461","137116735","chr7","17594103","17594388","70","119522358"
"chr4","137136770","137137062","chr5","133172797","133173087","36","3963973"
"chr4","137166366","137166617","chr9","72031803","72032071","67","65134563"
"chr4","137250040","137250375","chr17","23800859","23801167","93","113449181"
"chr4","137276555","137276871","chr5","133377996","133378304","37","3898559"
"chr4","137305292","137305576","chr5","133397537","133397824","22","3907755"
"chr4","137448088","137448385","chr3","47930685","47930995","71","89517403"
"chr4","137532551","137532774","chr1","23942951","23943176","55","113589600"
"chr4","137587618","137587815","chr12","120617029","120617231","69","16970589"
"chr4","137734772","137734972","chr5","133847452","133847656","20","3887320"
"chr4","137777894","137778219","chr5","133891376","133891685","32","3886518"
"chr4","137793173","137793450","chr5","133901318","133901594","22","3891855"
"chr4","137839828","137840043","chr5","133948562","133948775","19","3891266"
"chr4","138052793","138053096","chr19","31799117","31799415","56","106253676"
"chr4","138110039","138110323","chr5","134217923","134218201","25","3892116"
"chr4","138128511","138128640","chr15","40763679","40763790","44","97364832"
"chr4","138192504","138192802","chr5","134298696","134298995","16","3893808"
"chr4","138303583","138303864","chr5","134413161","134413455","64","3890422"
"chr4","138480405","138480716","chr5","134567190","134567494","27","3913215"
"chr4","138602611","138602904","chr5","134684572","134684871","46","3918039"
"chr4","138703542","138703839","chr5","134781445","134781742","13","3922097"
"chr4","138772936","138773208","chr10","18685448","18685721","62","120087488"
"chr4","139030714","139030973","chr5","135140363","135140626","25","3890351"
"chr4","139048036","139048343","chr9","128228335","128228636","64","10819701"
"chr4","139191769","139192073","chr5","135243406","135243679","49","3948363"
"chr4","139221912","139222065","chr5","135288268","135288421","12","3933644"
"chr4","139222111","139222231","chr1","18100775","18100899","25","121121336"
"chr4","139327125","139327344","chrX","49452152","49452377","62","89874973"
"chr4","139555199","139555427","chr5","135594278","135594506","20","3960921"
"chr4","139573758","139574043","chr11","109186448","109186735","68","30387310"
"chr4","139608058","139608331","chr5","135655621","135655877","42","3952437"
"chr4","139642193","139642258","chr15","12931710","12931775","11","126710483"
"chr4","139778431","139778706","chr5","135861721","135862012","45","3916710"
"chr4","139902278","139902563","chr5","136003279","136003587","54","3898999"
"chr4","140091466","140091576","chr5","136206868","136206983","17","3884598"
"chr4","140091598","140091744","chr11","13579411","13579559","30","126512187"
"chr4","140191267","140191503","chr5","136352766","136353017","40","3838501"
"chr4","140268198","140268338","chr5","136434045","136434185","9","3834153"
"chr4","140309752","140310050","chr19","30737326","30737611","76","109572426"
"chr4","140378168","140378477","chr2","170442163","170442474","64","30063995"
"chr4","140449365","140449537","chr9","20342313","20342478","43","120107052"
"chr4","140556117","140556416","chr5","136772709","136773011","27","3783408"
"chr4","140764076","140764307","chr5","136988400","136988633","22","3775676"
"chr4","140769177","140769402","chr5","136993629","136993833","44","3775548"
"chr4","140833838","140834057","chr5","137058000","137058248","53","3775838"
"chr4","140841262","140841590","chr3","107070117","107070407","89","33771145"
"chr4","140861156","140861452","chr10","73497926","73498218","70","67363230"
"chr4","140869078","140869327","chr5","137097824","137098057","61","3771254"
"chr4","140921458","140921731","chr5","137150016","137150291","19","3771442"
"chr4","141072882","141072991","chr1","127003631","127003740","22","14069251"
"chr4","141139806","141140088","chr5","137368357","137368651","29","3771449"
"chr4","141276226","141276533","chr5","137503769","137504080","32","3772457"
"chr4","141336263","141336429","chr5","137566678","137566844","16","3769585"
"chr4","141336457","141336575","chr5","137566904","137567023","10","3769553"
"chr4","141950275","141950564","chr19","6261946","6262240","53","135688329"
"chr4","142012474","142012735","chr5","138328292","138328589","48","3684182"
"chr4","142378198","142378321","chr5","138704485","138704608","6","3673713"
"chr4","142437700","142438000","chr5","138764616","138764921","23","3673084"
"chr4","142443646","142443837","chr3","55187260","55187443","36","87256386"
"chr4","142527217","142527440","chr5","138853223","138853440","16","3673994"
"chr4","142554626","142554922","chr5","138879640","138879952","35","3674986"
"chr4","142573639","142573948","chr5","138892857","138893164","16","3680782"
"chr4","142622491","142622784","chr5","56317338","56317639","28","86305153"
"chr4","142634749","142635047","chr13","62945409","62945715","53","79689340"
"chr4","142639849","142640159","chr5","138956047","138956362","36","3683802"
"chr4","142642711","142642794","chr5","138958862","138958946","9","3683849"
"chr4","142646140","142646389","chr3","17460128","17460373","60","125186012"
"chr4","142646594","142646904","chr5","138964269","138964574","38","3682325"
"chr4","142652823","142652972","chr16","54031136","54031283","40","88621687"
"chr4","142653836","142653915","chr14","9090039","9090113","22","133563797"
"chr4","142658164","142658376","chr5","138976265","138976489","27","3681899"
"chr4","142659258","142659543","chr5","138977352","138977637","23","3681906"
"chr4","142680563","142680687","chr5","138995412","138995529","13","3685151"
"chr4","142685105","142685404","chr5","139000581","139000876","32","3684524"
"chr4","142697758","142697823","chr5","139013333","139013398","5","3684425"
"chr4","142699089","142699387","chr5","139014735","139015036","23","3684354"
"chr4","142702815","142702886","chr13","71390242","71390311","20","71312573"
"chr4","142709182","142709486","chr5","139026186","139026499","28","3682996"
"chr4","142733588","142733886","chr5","139051219","139051520","33","3682369"
"chr4","142740318","142740558","chr5","139057868","139058109","26","3682450"
"chr4","142752824","142753112","chr5","139070754","139071036","32","3682070"
"chr4","142761115","142761236","chr5","139079034","139079139","22","3682081"
"chr4","142763744","142764039","chr5","139081647","139081892","63","3682097"
"chr4","142765295","142765580","chr11","34067460","34067749","58","108697835"
"chr4","142770987","142771116","chr13","89243067","89243200","30","53527920"
"chr4","142779712","142780004","chr5","158926737","158927025","53","16147025"
"chr4","142787183","142787473","chr5","139098792","139099084","21","3688391"
"chr4","142808242","142808359","chr18","10472737","10472855","20","132335505"
"chr4","142813418","142813678","chr5","139123668","139123927","12","3689750"
"chr4","142830335","142830628","chr5","139152774","139153050","42","3677561"
"chr4","142844073","142844317","chr5","139163202","139163494","58","3680871"
"chr4","142856991","142857247","chr5","139178379","139178630","19","3678612"
"chr4","142862074","142862373","chr5","139182915","139183194","31","3679159"
"chr4","142881623","142881891","chr1","103965005","103965271","69","38916618"
"chr4","142881998","142882308","chr2","107411533","107411833","54","35470465"
"chr4","142898529","142898664","chr10","30449663","30449796","19","112448866"
"chr4","142898957","142899128","chr3","35498090","35498256","35","107400867"
"chr4","142918719","142919028","chr5","139250803","139251105","34","3667916"
"chr4","142930151","142930451","chr5","139262217","139262500","49","3667934"
"chr4","142931328","142931588","chr5","139263693","139263952","13","3667635"
"chr4","142935407","142935697","chr5","139267239","139267525","22","3668168"
"chr4","142940440","142940722","chr5","139272288","139272570","24","3668152"
"chr4","142953940","142954157","chr5","139284488","139284707","15","3669452"
"chr4","142960923","142961047","chr5","139291275","139291393","17","3669648"
"chr4","142961350","142961511","chr5","139291964","139292124","26","3669386"
"chr4","142962881","142963093","chr16","18472818","18473033","47","124490063"
"chr4","142972928","142973239","chr5","139303208","139303501","39","3669720"
"chr4","142985746","142985926","chr11","28028835","28029019","46","114956911"
"chr4","142986536","142986823","chr5","139320958","139321221","52","3665578"
"chr4","142994710","142994831","chr5","139330310","139330431","3","3664400"
"chr4","142995213","142995338","chr5","139330806","139330930","12","3664407"
"chr4","142999759","142999998","chr5","139336500","139336775","48","3663259"
"chr4","143007503","143007825","chr20","28651476","28651780","77","114356027"
"chr4","143008950","143009066","chr15","7561024","7561142","20","135447926"
"chr4","143013207","143013495","chr5","139350911","139351194","22","3662296"
"chr4","143037445","143037740","chr5","139375020","139375322","29","3662425"
"chr4","143072140","143072329","chr20","53399339","53399533","37","89672801"
"chr4","143106961","143107247","chr5","139448598","139448880","19","3658363"
"chr4","143109610","143109907","chr5","139451244","139451542","21","3658366"
"chr4","143127925","143128050","chr5","139472272","139472412","19","3655653"
"chr4","143135528","143135909","chr16","20560305","20560658","103","122575223"
"chr4","143155004","143155307","chr20","21422886","21423193","53","121732118"
"chr4","143198437","143198751","chr5","139546339","139546652","16","3652098"
"chr4","143244618","143244831","chr9","54924211","54924455","62","88320407"
"chr4","143251144","143251374","chr1","160389426","160389648","60","17138282"
"chr4","143284321","143284624","chr5","139632314","139632620","24","3652007"
"chr4","143321884","143322147","chr5","139668620","139668873","27","3653264"
"chr4","143322843","143323140","chr5","139669566","139669871","31","3653277"
"chr4","143346104","143346225","chrX","89900044","89900167","20","53446060"
"chr4","143354270","143354571","chr5","139704074","139704374","20","3650196"
"chr4","143362632","143362752","chr5","139713162","139713279","10","3649470"
"chr4","143372067","143372350","chr5","139721256","139721540","13","3650811"
"chr4","143373985","143374280","chr5","139723153","139723449","19","3650832"
"chr4","143405913","143406219","chr5","139748693","139748986","31","3657220"
"chr4","143413689","143413971","chr5","139756441","139756723","16","3657248"
"chr4","143437866","143438169","chrX","48162977","48163283","58","95274889"
"chr4","143454106","143454393","chr5","139797422","139797705","18","3656684"
"chr4","143482061","143482361","chr5","139825389","139825686","13","3656672"
"chr4","143483858","143484134","chr8","53966848","53967147","61","89517010"
"chr4","143556817","143557128","chr5","139902915","139903239","35","3653902"
"chr4","143695911","143696196","chr5","140038291","140038581","28","3657620"
"chr4","143728749","143728939","chr5","140071433","140071623","14","3657316"
"chr4","143747051","143747286","chr5","140088459","140088684","26","3658592"
"chr4","143747568","143747672","chr5","140088966","140089070","9","3658602"
"chr4","143761299","143761385","chr5","140103554","140103636","8","3657745"
"chr4","143796539","143796673","chr5","140139485","140139611","19","3657054"
"chr4","143809930","143810209","chr5","140153210","140153489","17","3656720"
"chr4","143810349","143810472","chr5","140153625","140153748","11","3656724"
"chr4","143832470","143832618","chr5","140176397","140176549","13","3656073"
"chr4","143843220","143843436","chr5","140186838","140187052","20","3656382"
"chr4","143859758","143860054","chr5","140203537","140203837","21","3656221"
"chr4","143873068","143873368","chr5","140217319","140217624","37","3655749"
"chr4","143893204","143893351","chr5","140232680","140232827","9","3660524"
"chr4","143909740","143909950","chr5","140249614","140249830","38","3660126"
"chr4","143929865","143929983","chr5","140269764","140269881","9","3660101"
"chr4","143933100","143933338","chr5","140273004","140273267","31","3660096"
"chr4","143937618","143937913","chr5","140277510","140277805","22","3660108"
"chr4","143945666","143945957","chr5","140285603","140285894","38","3660063"
"chr4","143972343","143972630","chr5","140359330","140359618","21","3613013"
"chr4","144006291","144006534","chr19","3350946","3351183","49","140655345"
"chr4","144058815","144059119","chr5","140452680","140452992","31","3606135"
"chr4","144153171","144153219","chr8","91889698","91889740","11","52263473"
"chr4","144153248","144153366","chr10","62530419","62530538","25","81622829"
"chr4","144153508","144153773","chr5","140542284","140542538","24","3611224"
"chr4","144306071","144306386","chr5","140687638","140687949","31","3618433"
"chr4","144307283","144307561","chr5","140688853","140689133","19","3618430"
"chr4","144359313","144359593","chr5","140741772","140742046","26","3617541"
"chr4","144360448","144360719","chr20","25617473","25617738","66","118742975"
"chr4","144385359","144385662","chr5","140766412","140766710","14","3618947"
"chr4","144386716","144387016","chr5","140767762","140768060","11","3618954"
"chr4","144394212","144394476","chr3","13296332","13296600","66","131097880"
"chr4","144401843","144401966","chr5","140783621","140783744","4","3618222"
"chr4","144404934","144405237","chr5","140786686","140786991","19","3618248"
"chr4","144419435","144419568","chr13","16171033","16171161","22","128248402"
"chr4","144419892","144420029","chr19","2291690","2291824","25","142128202"
"chr4","144434172","144434479","chr5","140818315","140818622","42","3615857"
"chr4","144435545","144435720","chr5","140819683","140819847","19","3615862"
"chr4","144437934","144438141","chr1","96965774","96965977","47","47472160"
"chr4","144438376","144438690","chr5","140822770","140823106","39","3615606"
"chr4","144468495","144468787","chr5","140846000","140846285","43","3622495"
"chr4","144470568","144470862","chr1","220743035","220743333","61","76272467"
"chr4","144510507","144510640","chr13","25546692","25546816","26","118963815"
"chr4","144519128","144519249","chr5","140899389","140899501","14","3619739"
"chr4","144520672","144520953","chr5","140901576","140901847","34","3619096"
"chr4","144521848","144522144","chr5","140902720","140903016","24","3619128"
"chr4","144524345","144524654","chr5","140905443","140905759","23","3618902"
"chr4","144527024","144527141","chr5","140908145","140908264","9","3618879"
"chr4","144543677","144543985","chr5","140925143","140925435","37","3618534"
"chr4","144547923","144548182","chr5","140929535","140929798","23","3618388"
"chr4","144560908","144561198","chr5","140946225","140946513","16","3614683"
"chr4","144612123","144612448","chr5","140990970","140991305","36","3621153"
"chr4","144614261","144614375","chr5","140993120","140993240","14","3621141"
"chr4","144713589","144713892","chr5","141101402","141101702","23","3612187"
"chr4","144725317","144725626","chr5","141116596","141116906","26","3608721"
"chr4","144775216","144775504","chr5","141171192","141171495","32","3604024"
"chr4","144803698","144803998","chr5","141199696","141200000","24","3604002"
"chr4","144815689","144816010","chr5","141211773","141212092","16","3603916"
"chr4","144816121","144816173","chr5","141212210","141212261","5","3603911"
"chr4","144841609","144841905","chr5","141234252","141234553","21","3607357"
"chr4","144975204","144975292","chr12","99065056","99065143","15","45910148"
"chr4","145006118","145006364","chr5","141393364","141393616","31","3612754"
"chr4","145091934","145092051","chr5","141501897","141502014","11","3590037"
"chr4","145182934","145183207","chr5","141584639","141584949","72","3598295"
"chr4","145186165","145186454","chr5","141587831","141588132","33","3598334"
"chr4","145200229","145200532","chr5","141600730","141601040","31","3599499"
"chr4","145244926","145245056","chr1","129880370","129880494","20","15364556"
"chr4","145477789","145478079","chr5","141864912","141865218","39","3612877"
"chr4","145485812","145485925","chr5","141868401","141868514","8","3617411"
"chr4","145761103","145761379","chr5","142145701","142145970","26","3615402"
"chr4","145817689","145817816","chr5","142199203","142199326","17","3618486"
"chr4","145842684","145842828","chr19","35723023","35723164","31","110119661"
"chr4","145852562","145852844","chr5","142232833","142233114","34","3619729"
"chr4","146017650","146017970","chr5","142392255","142392573","20","3625395"
"chr4","146099662","146099981","chr14","66997874","66998185","65","79101788"
"chr4","146168363","146168668","chr7","140100928","140101221","69","6067435"
"chr4","146183426","146183650","chr5","142566854","142567083","21","3616572"
"chr4","146270880","146271172","chr5","142652105","142652418","47","3618775"
"chr4","146321885","146322194","chr5","142699977","142700270","35","3621908"
"chr4","146394810","146395088","chr2","163445135","163445414","53","17050325"
"chr4","146459242","146459396","chr9","44946240","44946401","38","101513002"
"chr4","146497837","146498137","chr5","142943447","142943748","20","3554390"
"chr4","146556582","146556875","chr20","26733808","26734109","57","119822774"
"chr4","146665061","146665376","chr5","143094209","143094518","21","3570852"
"chr4","146667396","146667554","chr5","143098859","143099028","22","3568537"
"chr4","146931262","146931385","chr5","143351353","143351476","7","3579909"
"chr4","146955030","146955145","chr9","99705197","99705312","23","47249833"
"chr4","146982414","146982714","chr5","143403127","143403435","35","3579287"
"chr4","146985883","146986165","chr16","40678177","40678457","62","106307706"
"chr4","147005993","147006060","chr5","143420768","143420836","7","3585225"
"chr4","147044091","147044381","chr5","143458534","143458827","30","3585557"
"chr4","147046688","147046982","chr5","143461138","143461425","24","3585550"
"chr4","147064845","147065046","chr5","143479584","143479795","31","3585261"
"chr4","147159919","147160234","chr5","143570387","143570711","31","3589532"
"chr4","147216085","147216353","chr5","143627320","143627592","21","3588765"
"chr4","147229726","147230025","chr5","143640892","143641196","29","3588834"
"chr4","147256762","147257051","chr5","143673832","143674118","19","3582930"
"chr4","147278758","147279044","chr5","143694971","143695257","14","3583787"
"chr4","147308830","147309108","chr5","143725336","143725615","18","3583494"
"chr4","147310580","147310851","chr5","109550554","109550822","58","37760026"
"chr4","147328838","147329102","chr5","143743102","143743396","53","3585736"
"chr4","147377161","147377459","chr5","143786262","143786562","30","3590899"
"chr4","147390025","147390330","chr5","143796095","143796377","54","3593930"
"chr4","147405183","147405483","chr5","143810069","143810368","17","3595114"
"chr4","147413048","147413312","chr5","139756441","139756723","65","7656607"
"chr4","147997882","147998172","chr5","143967189","143967478","25","4030693"
"chr4","148010709","148010999","chr5","143967189","143967478","24","4043520"
"chr4","148140249","148140538","chr5","143967189","143967478","20","4173060"
"chr4","148179115","148179368","chr5","144002297","144002562","22","4176818"
"chr4","148199045","148199318","chr5","144024169","144024460","33","4174876"
"chr4","148302375","148302667","chr5","144135522","144135823","33","4166853"
"chr4","148566944","148567256","chr2","69411442","69411755","71","79155502"
"chr4","148647338","148647621","chr5","144490168","144490451","24","4157170"
"chr4","148672699","148672975","chr7","162822637","162822913","59","14149938"
"chr4","149031307","149031554","chr5","144886505","144886733","36","4144802"
"chr4","149046256","149046384","chr3","41303396","41303525","23","107742860"
"chr4","149057442","149057712","chr5","144912876","144913175","47","4144566"
"chr4","149080687","149080978","chr5","144936151","144936453","31","4144536"
"chr4","149088666","149088781","chr5","144943869","144943985","10","4144797"
"chr4","149089546","149089677","chr5","144944749","144944877","7","4144797"
"chr4","149107861","149108023","chr5","144962994","144963135","35","4144867"
"chr4","149274731","149275057","chr5","145125897","145126213","33","4148834"
"chr4","149275742","149276039","chr4","1294654","1294954","50","147981088"
"chr4","149282187","149282469","chr5","145132455","145132737","19","4149732"
"chr4","149291240","149291472","chr5","145141209","145141446","19","4150031"
"chr4","149340955","149341243","chr5","145193716","145194000","22","4147239"
"chr4","149417372","149417643","chr5","145262238","145262508","21","4155134"
"chr4","149467417","149467669","chr5","145315432","145315695","35","4151985"
"chr4","149494964","149495259","chr8","129368934","129369243","73","20126030"
"chr4","149510620","149510885","chr5","145359446","145359721","49","4151174"
"chr4","149532405","149532712","chr5","145381101","145381425","39","4151304"
"chr4","149650727","149651016","chr5","145496933","145497211","30","4153794"
"chr4","149654584","149654887","chr5","145500462","145500772","24","4154122"
"chr4","149667021","149667315","chr5","145513574","145513864","22","4153447"
"chr4","149775329","149775636","chr5","145618774","145619058","48","4156555"
"chr4","149807937","149808250","chr5","145650389","145650702","12","4157548"
"chr4","149857076","149857389","chr5","145694167","145694480","19","4162909"
"chr4","149862997","149863324","chr1","140660327","140660628","72","9202670"
"chr4","149917449","149917749","chr5","145754832","145755136","23","4162617"
"chr4","149956351","149956474","chr9","12674840","12674960","22","137281511"
"chr4","149972103","149972408","chr5","145807795","145808098","24","4164308"
"chr4","149980930","149981223","chr5","145819879","145820171","19","4161051"
"chr4","149986462","149986761","chr1","195966885","195967183","54","45980423"
"chr4","149992266","149992434","chr5","145831705","145831879","17","4160561"
"chr4","150007953","150008254","chr5","145841105","145841424","47","4166848"
"chr4","150010831","150010913","chr16","21348692","21348774","17","128662139"
"chr4","150071081","150071382","chr5","145900066","145900365","20","4171015"
"chr4","150076367","150076652","chr5","145905286","145905594","39","4171081"
"chr4","150153867","150153987","chr5","145985240","145985362","9","4168627"
"chr4","150210309","150210431","chr6","171633151","171633269","19","21422842"
"chr4","150272717","150273012","chr5","146105476","146105774","22","4167241"
"chr4","150286088","150286359","chr3","45497800","45498068","57","104788288"
"chr4","150361430","150361725","chr5","146192914","146193199","31","4168516"
"chr4","150392468","150392756","chr5","146221424","146221713","23","4171044"
"chr4","150393067","150393192","chr5","146222003","146222128","6","4171064"
"chr4","150409197","150409492","chr5","146238365","146238660","12","4170832"
"chr4","150412490","150412784","chr5","146241769","146242040","40","4170721"
"chr4","150416334","150416648","chr9","98807840","98808149","59","51608494"
"chr4","150422265","150422542","chr3","54481480","54481765","61","95940785"
"chr4","150452201","150452482","chr5","146285113","146285377","30","4167088"
"chr4","150452537","150452846","chr8","24323188","24323494","59","126129349"
"chr4","150458381","150458661","chr5","146291247","146291525","29","4167134"
"chr4","150472785","150473073","chr5","146306258","146306546","16","4166527"
"chr4","150678769","150678975","chr5","146499222","146499425","18","4179547"
"chr4","150686444","150686732","chr5","146506750","146507062","42","4179694"
"chr4","150712873","150713163","chr6","129061647","129061938","54","21651226"
"chr4","150713509","150713799","chr10","70271181","70271471","63","80442328"
"chr4","150728284","150728519","chr7","84548404","84548652","67","66179880"
"chr4","150736539","150736831","chr5","146561383","146561668","40","4175156"
"chr4","150990135","150990434","chr5","146835387","146835692","30","4154748"
"chr4","151171707","151171983","chr5","147018379","147018655","15","4153328"
"chr4","151208695","151208978","chr5","147056441","147056720","23","4152254"
"chr4","151358612","151358908","chr5","147225728","147226024","16","4132884"
"chr4","151402835","151403153","chr5","147275386","147275705","33","4127449"
"chr4","151409997","151410288","chr5","147285478","147285779","28","4124519"
"chr4","151428167","151428338","chr1","7010663","7010833","35","144417504"
"chr4","151474425","151474738","chr5","147340507","147340814","27","4133918"
"chr4","151489781","151490087","chr5","147356162","147356469","22","4133619"
"chr4","151518499","151518759","chr5","147383547","147383830","48","4134952"
"chr4","151541371","151541645","chr13","27438525","27438790","65","124102846"
"chr4","151558501","151558565","chr5","147426888","147426953","7","4131613"
"chr4","151558994","151559269","chr5","147427385","147427663","14","4131609"
"chr4","151568656","151568969","chr5","147436991","147437305","26","4131665"
"chr4","151571209","151571468","chr5","147439592","147439851","15","4131617"
"chr4","151596596","151596881","chr5","147463398","147463692","34","4133198"
"chr4","151616601","151616837","chr5","147484308","147484538","20","4132293"
"chr4","151627037","151627265","chr5","147496097","147496328","23","4130940"
"chr4","151634423","151634706","chr13","107408005","107408290","59","44226418"
"chr4","151637413","151637654","chr5","147505439","147505676","17","4131974"
"chr4","151649227","151649503","chr5","147513853","147514128","24","4135374"
"chr4","151649994","151650170","chr5","147514957","147515133","16","4135037"
"chr4","151650481","151650592","chr5","147515401","147515512","3","4135080"
"chr4","151662745","151663020","chr5","147526640","147526912","24","4136105"
"chr4","151681876","151682155","chr5","127356060","127356351","34","24325816"
"chr4","151683775","151684081","chr5","147552772","147553077","26","4131003"
"chr4","151693773","151694061","chr5","147563578","147563896","48","4130195"
"chr4","151742826","151743107","chr5","147616199","147616490","37","4126627"
"chr4","151753455","151753619","chr5","147627298","147627464","11","4126157"
"chr4","151755059","151755353","chr5","147628896","147629203","29","4126163"
"chr4","151759360","151759657","chr5","147633474","147633766","39","4125886"
"chr4","151798924","151799089","chr2","61281692","61281857","38","90517232"
"chr4","151808823","151809104","chr5","147682034","147682315","29","4126789"
"chr4","151827482","151827758","chr6","144833269","144833549","66","6994213"
"chr4","151888723","151889029","chr5","147761760","147762060","28","4126963"
"chr4","151890615","151890738","chr5","147763649","147763770","5","4126966"
"chr4","151903366","151903680","chr5","147774428","147774737","26","4128938"
"chr4","151927908","151928194","chr5","147797706","147798000","26","4130202"
"chr4","151944722","151944839","chr5","147814682","147814799","9","4130040"
"chr4","152009160","152009456","chr5","147874291","147874587","24","4134869"
"chr4","152127330","152127625","chr5","147995689","147995983","20","4131641"
"chr4","152138316","152138603","chr5","148006985","148007289","25","4131331"
"chr4","152200968","152201249","chr5","148069472","148069770","32","4131496"
"chr4","152203338","152203648","chr2","159938043","159938325","83","7734705"
"chr4","152214126","152214421","chr5","148084192","148084493","20","4129934"
"chr4","152214558","152214851","chr5","148084631","148084928","26","4129927"
"chr4","152237020","152237311","chr5","148107261","148107558","35","4129759"
"chr4","152274291","152274583","chr5","148146269","148146567","34","4128022"
"chr4","152399346","152399672","chr5","148266415","148266728","40","4132931"
"chr4","152442775","152442994","chr3","79858554","79858774","45","72584221"
"chr4","152456708","152457000","chr5","148324346","148324629","27","4132362"
"chr4","152479308","152479593","chr5","148347333","148347618","18","4131975"
"chr4","152529623","152529702","chr5","148399747","148399826","6","4129876"
"chr4","152530002","152530171","chr5","148400127","148400304","29","4129875"
"chr4","152534915","152535184","chr12","19509663","19509930","57","133025252"
"chr4","152560675","152560815","chr5","148430655","148430795","13","4130020"
"chr4","152561112","152561245","chr5","148431099","148431231","4","4130013"
"chr4","152696463","152696728","chr5","148580457","148580744","42","4116006"
"chr4","152713973","152714299","chr5","148599569","148599859","59","4114404"
"chr4","152724330","152724585","chr4","37217880","37218123","59","115506450"
"chr4","152772717","152772977","chr5","148654881","148655164","47","4117836"
"chr4","152793842","152793996","chr5","148676254","148676417","14","4117588"
"chr4","152813919","152814125","chr5","148691884","148692100","32","4122035"
"chr4","152829191","152829489","chr5","148706554","148706866","27","4122637"
"chr4","152841162","152841462","chr1","30761063","30761352","61","122080099"
"chr4","152853674","152853794","chr4","6988605","6988727","17","145865069"
"chr4","152959920","152960225","chr6","60652847","60653144","50","92307073"
"chr4","153124353","153124570","chr4","152792139","152792363","42","332214"
"chr4","153135651","153135767","chr12","82551636","82551752","15","70584015"
"chr4","153358800","153359079","chr5","149152568","149152851","28","4206232"
"chr4","153381710","153381996","chr5","149174976","149175254","21","4206734"
"chr4","153444260","153444565","chr5","149263626","149263950","46","4180634"
"chr4","153626630","153626918","chr5","149452799","149453091","41","4173831"
"chr4","153808887","153809174","chr5","149637118","149637397","22","4171769"
"chr4","153958385","153958720","chr5","17020788","17021093","83","136937597"
"chr4","153975703","153976001","chr5","149848834","149849132","25","4126869"
"chr4","154042239","154042481","chr3","36424130","36424381","52","117618109"
"chr4","154057777","154058066","chr11","104445609","104445897","65","49612168"
"chr4","154085104","154085401","chr5","149955520","149955801","32","4129584"
"chr4","154093013","154093167","chr5","149963413","149963572","19","4129600"
"chr4","154108122","154108395","chr5","149979827","149980068","49","4128295"
"chr4","154128999","154129277","chr12","61099578","61099857","54","93029421"
"chr4","154139899","154140039","chrX","6264000","6264142","28","147875899"
"chr4","154140116","154140439","chr5","150013166","150013464","43","4126950"
"chr4","154145342","154145645","chr5","150018415","150018720","35","4126927"
"chr4","154147265","154147376","chr8","28328472","28328589","22","125818793"
"chr4","154149521","154149829","chr5","51350304","51350607","48","102799217"
"chr4","154173700","154174003","chr5","86925549","86925828","72","67248151"
"chr4","154176604","154176877","chr5","150051271","150051549","24","4125333"
"chr4","154204679","154204921","chr5","150079841","150080112","45","4124838"
"chr4","154225823","154226008","chr5","150100856","150101058","23","4124967"
"chr4","154226013","154226320","chr10","36280517","36280821","66","117945496"
"chr4","154265896","154266174","chr5","150140990","150141263","20","4124906"
"chr4","154288816","154289025","chr5","150162281","150162475","32","4126535"
"chr4","154301826","154302122","chr5","150176450","150176736","23","4125376"
"chr4","154308435","154308684","chr5","150183860","150184098","26","4124575"
"chr4","154325819","154326095","chr5","150200866","150201133","20","4124953"
"chr4","154327057","154327348","chr5","150202095","150202388","19","4124962"
"chr4","154375698","154375987","chr5","150251081","150251362","25","4124617"
"chr4","154380816","154381126","chr5","150256155","150256464","23","4124661"
"chr4","154388002","154388294","chr5","150263175","150263465","31","4124827"
"chr4","154402136","154402420","chr5","150278181","150278464","29","4123955"
"chr4","154419625","154419906","chr5","150295190","150295456","37","4124435"
"chr4","154427105","154427377","chr5","150301871","150302137","20","4125234"
"chr4","154456466","154456780","chr5","150331729","150332050","30","4124737"
"chr4","154459871","154460164","chr5","150335108","150335392","37","4124763"
"chr4","154474283","154474567","chr1","94307059","94307353","73","60167224"
"chr4","154479840","154480107","chr5","150354368","150354635","18","4125472"
"chr4","154501845","154501969","chr5","150369986","150370110","11","4131859"
"chr4","154516083","154516385","chr5","150384134","150384436","16","4131949"
"chr4","154522640","154522881","chr14","106331776","106332024","68","48190864"
"chr4","154536710","154537003","chr5","150406007","150406301","26","4130703"
"chr4","154543717","154544007","chr5","150412960","150413251","21","4130757"
"chr4","154573511","154573817","chr7","42278598","42278899","61","112294913"
"chr4","154584323","154584639","chr5","150453588","150453914","56","4130735"
"chr4","154584968","154585252","chr5","150454242","150454534","25","4130726"
"chr4","154627760","154628016","chr5","150515430","150515672","34","4112330"
"chr4","154628946","154629072","chr5","150516607","150516733","8","4112339"
"chr4","154635990","154636254","chr5","150522984","150523278","51","4113006"
"chr4","154648102","154648375","chr13","63381643","63381937","70","91266459"
"chr4","154665371","154665670","chr5","150550599","150550890","26","4114772"
"chr4","154668166","154668464","chr20","11370789","11371088","62","143297377"
"chr4","154673429","154673706","chr5","150557214","150557494","21","4116215"
"chr4","154676602","154676891","chr5","150560391","150560681","20","4116211"
"chr4","154685582","154685892","chr5","150569366","150569674","34","4116216"
"chr4","154701182","154701476","chr5","150585705","150586004","29","4115477"
"chr4","154735473","154735777","chr5","150668209","150668487","39","4067264"
"chr4","154736497","154736740","chr10","68119189","68119444","63","86617308"
"chr4","154787985","154788100","chr13","92229940","92230056","18","62558045"
"chr4","154788134","154788309","chr2","75488309","75488482","34","79299825"
"chr4","154790882","154791014","chr6","34104600","34104727","33","120686282"
"chr4","154796322","154796622","chr5","150728583","150728906","40","4067739"
"chr4","154797222","154797524","chr5","150729829","150730124","39","4067393"
"chr4","154798650","154798907","chr8","28287757","28288013","61","126510893"
"chr4","154808177","154808463","chr20","30461489","30461784","62","124346688"
"chr4","154810473","154810748","chr5","150745049","150745326","19","4065424"
"chr4","154848872","154849125","chr5","150777537","150777792","23","4071335"
"chr4","154889202","154889440","chrX","51567105","51567331","58","103322097"
"chr4","154917288","154917582","chr5","150854635","150854934","30","4062653"
"chr4","154917744","154917897","chr5","150855093","150855247","13","4062651"
"chr4","154959583","154959872","chr5","150886963","150887258","28","4072620"
"chr4","154962350","154962467","chr5","150890070","150890187","9","4072280"
"chr4","154983318","154983604","chr5","150912048","150912328","36","4071270"
"chr4","154991246","154991527","chr5","150920364","150920645","22","4070882"
"chr4","154996093","154996332","chr16","43473883","43474099","56","111522210"
"chr4","155003981","155004215","chr5","150925800","150926023","29","4078181"
"chr4","155009356","155009440","chr19","32062110","32062186","18","122947246"
"chr4","155011448","155011721","chr5","150934266","150934542","20","4077182"
"chr4","155035404","155035663","chr6","155858026","155858290","50","822622"
"chr4","155037465","155037779","chr5","150958862","150959171","33","4078603"
"chr4","155037950","155038247","chr5","150959363","150959624","45","4078587"
"chr4","155049048","155049339","chr5","150968860","150969161","38","4080188"
"chr4","155078901","155079064","chr6","138881841","138882006","32","16197060"
"chr4","155079364","155079416","chr16","74127212","74127263","10","80952152"
"chr4","155100457","155100706","chr5","151011946","151012226","40","4088511"
"chr4","155104457","155104593","chr1","138912435","138912568","25","16192022"
"chr4","155106704","155106980","chr5","151018426","151018708","27","4088278"
"chr4","155107969","155108247","chr16","21941769","21942047","46","133166200"
"chr4","155112664","155112798","chr5","151024261","151024396","9","4088403"
"chr4","155113110","155113283","chr5","151024724","151024886","17","4088386"
"chr4","155120988","155121114","chr13","25546692","25546816","17","129574296"
"chr4","155123491","155123785","chr5","151034872","151035167","41","4088619"
"chr4","155129408","155129524","chr5","151041101","151041217","9","4088307"
"chr4","155135922","155136121","chr5","151047376","151047574","33","4088546"
"chr4","155137428","155137716","chr5","151048866","151049163","30","4088562"
"chr4","155141551","155141751","chr1","200732157","200732341","59","45590606"
"chr4","155170822","155171080","chr5","151081967","151082221","30","4088855"
"chr4","155204340","155204611","chr8","71689849","71690123","63","83514491"
"chr4","155205851","155206131","chr5","151116500","151116772","19","4089351"
"chr4","155219739","155220062","chr5","151130588","151130908","28","4089151"
"chr4","155231084","155231207","chr5","151140929","151141053","10","4090155"
"chr4","155231243","155231533","chr5","151141072","151141383","44","4090171"
"chr4","155249482","155249768","chr5","151157234","151157540","40","4092248"
"chr4","155255519","155255823","chr5","151163370","151163674","24","4092149"
"chr4","155262692","155262982","chr5","151169605","151169898","26","4093087"
"chr4","155267297","155267578","chr5","151174185","151174456","27","4093112"
"chr4","155272375","155272555","chr12","87917476","87917649","35","67354899"
"chr4","155275231","155275493","chr5","151182262","151182526","12","4092969"
"chr4","155277377","155277583","chr5","151184460","151184674","15","4092917"
"chr4","155279327","155279590","chr5","151186454","151186733","32","4092873"
"chr4","155281677","155281953","chr5","151189218","151189502","21","4092459"
"chr4","155283735","155284029","chr5","151191209","151191482","47","4092526"
"chr4","155301096","155301386","chr11","109186448","109186735","49","46114648"
"chr4","155301424","155301580","chr17","29269902","29270063","33","126031522"
"chr4","155303301","155303596","chr5","151207126","151207430","28","4096175"
"chr4","155321768","155322005","chr2","33396046","33396280","51","121925722"
"chr4","155340874","155341178","chr5","151247753","151248069","41","4093121"
"chr4","155342106","155342364","chr1","130906396","130906655","74","24435710"
"chr4","155346565","155346852","chr3","48203268","48203560","64","107143297"
"chr4","155348441","155348576","chr5","151255800","151255935","6","4092641"
"chr4","155361841","155362132","chr5","151269312","151269592","31","4092529"
"chr4","155383833","155384138","chr5","151298738","151299067","50","4085095"
"chr4","155396963","155397225","chr5","151311921","151312200","36","4085042"
"chr4","155407636","155407945","chr5","151323628","151323940","29","4084008"
"chr4","155427677","155427919","chr5","151343653","151343895","12","4084024"
"chr4","155431992","155432315","chr5","151347985","151348282","42","4084007"
"chr4","155440792","155441106","chr6","77260247","77260553","62","78180545"
"chr4","155450880","155451169","chr5","151366262","151366550","34","4084618"
"chr4","155453926","155454217","chr5","151369232","151369523","33","4084694"
"chr4","155465162","155465411","chr4","88147349","88147596","48","67317813"
"chr4","155494698","155494974","chr5","151426206","151426489","22","4068492"
"chr4","155495903","155496169","chr5","151427418","151427685","13","4068485"
"chr4","155498883","155499184","chr5","151430448","151430760","27","4068435"
"chr4","155507482","155507744","chr5","151432970","151433232","15","4074512"
"chr4","155520107","155520325","chr2","96001904","96002105","57","59518203"
"chr4","155521851","155522149","chr1","32090539","32090837","56","123431312"
"chr4","155550610","155550897","chr5","151482072","151482360","16","4068538"
"chr4","155557356","155557528","chr5","151488856","151489028","11","4068500"
"chr4","155631329","155631634","chr5","151562734","151563039","15","4068595"
"chr4","155682706","155683033","chr5","151613964","151614276","39","4068742"
"chr4","155693865","155694163","chr5","151624450","151624745","24","4069415"
"chr4","155702848","155703133","chr5","151633386","151633662","37","4069462"
"chr4","155713661","155713964","chr12","65551151","65551448","61","90162510"
"chr4","155780313","155780433","chr7","154055978","154056093","18","1724335"
"chr4","155780486","155780628","chr12","112074749","112074889","33","43705737"
"chr4","155781632","155781916","chr5","151708138","151708428","20","4073494"
"chr4","155851149","155851436","chr5","151773817","151774099","19","4077332"
"chr4","155894634","155894915","chr5","151817128","151817405","24","4077506"
"chr4","156081264","156081551","chr11","121290594","121290887","53","34790670"
"chr4","156087522","156087816","chr5","152018656","152018936","41","4068866"
"chr4","156165224","156165538","chr5","152095584","152095897","32","4069640"
"chr4","156228344","156228638","chr5","152159061","152159356","21","4069283"
"chr4","156238031","156238163","chr5","152168731","152168863","13","4069300"
"chr4","156242118","156242279","chrX","22690614","22690775","35","133551504"
"chr4","156259817","156260103","chr5","152190322","152190602","24","4069495"
"chr4","156271206","156271497","chr5","152200750","152201043","32","4070456"
"chr4","156292056","156292360","chr7","99436660","99436957","67","56855396"
"chr4","156325966","156326112","chr5","152254924","152255076","12","4071042"
"chr4","156349939","156350228","chr10","49792821","49793120","65","106557118"
"chr4","156447783","156448084","chr5","152373018","152373315","46","4074765"
"chr4","156463449","156463742","chr5","152388149","152388456","32","4075300"
"chr4","156465326","156465519","chr14","9094985","9095181","44","147370341"
"chr4","156466980","156467250","chr5","152392172","152392454","30","4074808"
"chr4","156487751","156488051","chr5","152412395","152412695","16","4075356"
"chr4","156510175","156510476","chr5","152433718","152434001","38","4076457"
"chr4","156519074","156519372","chr5","152442582","152442874","27","4076492"
"chr4","156552478","156552785","chr5","152475965","152476275","23","4076513"
"chr4","156557646","156557751","chr11","109358164","109358269","16","47199482"
"chr4","156599432","156599565","chr1","128086244","128086378","22","28513188"
"chr4","156599865","156600030","chr19","4960640","4960806","33","151639225"
"chr4","156621638","156621939","chr5","152543316","152543618","16","4078322"
"chr4","156623047","156623334","chr5","152544731","152545005","37","4078316"
"chr4","156629546","156629859","chr5","152551189","152551502","21","4078357"
"chr4","156639755","156640060","chr5","152561409","152561713","25","4078346"
"chr4","156699733","156699991","chr20","42703392","42703652","49","113996341"
"chr4","156712493","156712765","chr19","2507487","2507757","42","154205006"
"chr4","156726091","156726383","chr5","152650678","152650940","46","4075413"
"chr4","156744797","156745053","chr9","52202198","52202452","69","104542599"
"chr4","156755083","156755339","chr5","152671389","152671654","25","4083694"
"chr4","156757856","156758149","chr13","87882034","87882326","57","68875822"
"chr4","156802715","156803016","chr5","152724240","152724549","22","4078475"
"chr4","156864656","156864946","chr5","152783080","152783361","49","4081576"
"chr4","156885346","156885646","chr5","152804326","152804635","30","4081020"
"chr4","156892002","156892283","chr5","152811009","152811290","20","4080993"
"chr4","156921525","156921836","chr5","152841338","152841636","37","4080187"
"chr4","156938219","156938445","chr1","7495568","7495795","45","149442651"
"chr4","156938455","156938763","chr5","152858302","152858602","23","4080153"
"chr4","156948917","156949030","chr5","152868670","152868780","8","4080247"
"chr4","156956182","156956461","chr5","152875905","152876212","49","4080277"
"chr4","156960426","156960695","chr5","152880195","152880462","14","4080231"
"chr4","156992665","156992967","chr5","152911839","152912135","21","4080826"
"chr4","156997635","156997946","chr5","152916248","152916559","20","4081387"
"chr4","157015654","157015777","chr5","152934575","152934698","7","4081079"
"chr4","157046636","157046834","chr5","152953935","152954134","14","4092701"
"chr4","157052437","157052741","chr8","33501347","33501642","61","123551090"
"chr4","157088100","157088386","chr5","153006147","153006442","32","4081953"
"chr4","157110855","157110987","chr5","153028178","153028309","9","4082677"
"chr4","157110988","157111257","chr5","153028310","153028611","42","4082678"
"chr4","157111258","157111381","chr5","153028612","153028735","9","4082646"
"chr4","157115346","157115638","chr5","153032676","153032968","18","4082670"
"chr4","157127896","157128182","chr5","153044030","153044317","46","4083866"
"chr4","157136522","157136824","chr5","153053624","153053924","15","4082898"
"chr4","157138121","157138435","chr5","153055450","153055764","17","4082671"
"chr4","157138700","157138976","chr5","153056024","153056303","25","4082676"
"chr4","157139255","157139549","chr5","153056594","153056879","34","4082661"
"chr4","157150708","157150829","chr5","153068406","153068522","10","4082302"
"chr4","157153453","157153739","chr5","153071152","153071441","44","4082301"
"chr4","157159132","157159421","chr6","176458169","176458462","69","19299037"
"chr4","157163577","157163688","chr3","64873136","64873250","17","92290441"
"chr4","157166226","157166517","chr5","153083055","153083350","33","4083171"
"chr4","157178567","157178652","chr1","16674594","16674681","13","140503973"
"chr4","157190432","157190485","chr1","14711798","14711853","14","142478634"
"chr4","157198215","157198479","chr5","153116190","153116475","34","4082025"
"chr4","157208390","157208664","chr3","39159304","39159586","51","118049086"
"chr4","157215921","157216188","chr5","153134232","153134532","50","4081689"
"chr4","157227134","157227427","chr5","153145499","153145827","53","4081635"
"chr4","157234236","157234539","chr3","40073763","40074063","66","117160473"
"chr4","157268293","157268606","chr1","109806160","109806457","63","47462133"
"chr4","157280450","157280745","chr5","153198809","153199105","19","4081641"
"chr4","157290652","157290694","chr5","153208959","153209003","5","4081693"
"chr4","157290989","157291129","chr5","153209306","153209447","6","4081683"
"chr4","157301496","157301624","chr2","42645372","42645505","19","114656124"
"chr4","157483333","157483622","chr5","153224086","153224377","19","4259247"
"chr4","157496676","157496976","chr5","153238583","153238883","17","4258093"
"chr4","157505375","157505668","chr1","52586719","52587013","66","104918656"
"chr4","157507753","157508059","chr7","136572483","136572769","65","20935270"
"chr4","157520220","157520541","chr5","153264392","153264690","46","4255828"
"chr4","157520623","157520915","chr12","84883590","84883883","48","72637033"
"chr4","157529732","157530018","chr5","153273805","153274084","29","4255927"
"chr4","157544890","157545016","chr10","77052809","77052937","27","80492081"
"chr4","157549618","157549932","chr5","153295093","153295408","27","4254525"
"chr4","157551555","157551829","chr3","46725621","46725892","50","110825934"
"chr4","157552818","157553113","chr5","121554351","121554639","66","35998467"
"chr4","157553544","157553836","chr5","153299029","153299303","36","4254515"
"chr4","157565138","157565453","chr5","153310826","153311140","30","4254312"
"chr4","157565653","157565957","chr5","153311335","153311639","14","4254318"
"chr4","157568116","157568389","chr5","153314172","153314450","26","4253944"
"chr4","157572943","157573250","chr5","153319079","153319399","42","4253864"
"chr4","157585806","157586096","chr5","153331639","153331927","22","4254167"
"chr4","157597761","157598065","chr5","153348686","153348983","34","4249075"
"chr4","157602229","157602535","chr5","153352669","153352973","24","4249560"
"chr4","157612562","157612872","chr5","153362551","153362865","30","4250011"
"chr4","157673230","157673476","chr5","153421992","153422263","43","4251238"
"chr4","157710446","157710717","chr12","17826363","17826631","63","139884083"
"chr4","157746724","157747048","chr5","153495732","153496053","34","4250992"
"chr4","157764498","157764810","chr5","153514019","153514327","27","4250479"
"chr4","157791036","157791334","chr5","153540705","153540998","23","4250331"
"chr4","157797745","157798050","chr5","153547274","153547588","30","4250471"
"chr4","157803832","157804111","chr5","153553663","153553942","19","4250169"
"chr4","157805815","157806109","chr5","153555649","153555943","24","4250166"
"chr4","157808960","157809250","chr5","185678151","185678451","63","27869191"
"chr4","157833616","157833716","chr7","37098048","37098147","21","120735568"
"chr4","157934237","157934422","chr15","13927684","13927861","48","144006553"
"chr4","158005931","158006155","chr3","170242210","170242417","49","12236279"
"chr4","158046841","158047073","chr5","153787842","153788074","13","4258999"
"chr4","158483550","158483867","chr5","154197291","154197562","73","4286259"
"chr4","158494752","158495057","chr5","154208373","154208682","35","4286379"
"chr4","158613144","158613450","chr5","154331724","154332022","29","4281420"
"chr4","158619032","158619310","chr5","154337635","154337914","27","4281397"
"chr4","158630387","158630691","chr5","154348995","154349302","27","4281392"
"chr4","158638525","158638732","chr2","91013651","91013860","44","67624874"
"chr4","158665703","158665817","chr5","154384862","154384970","14","4280841"
"chr4","158678124","158678437","chr5","154397911","154398217","45","4280213"
"chr4","158689415","158689712","chr5","154409330","154409626","18","4280085"
"chr4","158696009","158696303","chr15","8961807","8962085","73","149734202"
"chr4","158716689","158716987","chr1","179235994","179236288","63","20519305"
"chr4","158753250","158753551","chr7","41272468","41272762","77","117480782"
"chr4","158758603","158758719","chr5","154478888","154479004","6","4279715"
"chr4","158763442","158763607","chr20","15163851","15164003","39","143599591"
"chr4","158763638","158763756","chr1","31118551","31118669","18","127645087"
"chr4","158765042","158765254","chr5","154485454","154485663","18","4279588"
"chr4","158787783","158788106","chr5","154508375","154508700","39","4279408"
"chr4","158809616","158809929","chr5","154530590","154530904","21","4279026"
"chr4","158819016","158819178","chr11","7045224","7045395","36","151773792"
"chr4","158819206","158819286","chr8","43723081","43723159","19","115096125"
"chr4","158874338","158874644","chr5","154602667","154602974","30","4271671"
"chr4","158887621","158887925","chr5","154616557","154616872","27","4271064"
"chr4","158909473","158909738","chr5","154640038","154640299","28","4269435"
"chr4","158910955","158911216","chr5","154641500","154641788","40","4269455"
"chr4","158946181","158946462","chr5","154675846","154676121","24","4270335"
"chr4","158964139","158964311","chr5","154690417","154690593","7","4273722"
"chr4","159046439","159046704","chr5","154756057","154756325","16","4290382"
"chr4","159089173","159089494","chr5","154789931","154790244","41","4299242"
"chr4","159103387","159103652","chr5","154804174","154804434","23","4299213"
"chr4","159218766","159219062","chr5","154915715","154916012","28","4303051"
"chr4","159569818","159570106","chr5","155447614","155447901","22","4122204"
"chr4","159572893","159573007","chr14","8294861","8294977","16","151278032"
"chr4","159574744","159574895","chr2","159909193","159909336","37","334449"
"chr4","159576902","159577178","chr5","155440478","155440780","43","4136424"
"chr4","159577208","159577224","chr1","196102937","196102955","3","36525729"
"chr4","159585149","159585436","chr16","21444324","21444617","51","138140825"
"chr4","159620069","159620105","chr1","31665037","31665074","7","127955032"
"chr4","159697561","159697774","chr2","45945040","45945260","47","113752521"
"chr4","159795161","159795443","chr5","155173772","155174061","22","4621389"
"chr4","159820049","159820344","chr5","155149217","155149524","36","4670832"
"chr4","159946288","159946398","chr5","155699678","155699787","8","4246610"
"chr4","159955483","159955772","chr10","77425876","77426160","62","82529607"
"chr4","160222399","160222673","chr4","7575359","7575618","70","152647040"
"chr4","160309096","160309400","chr5","156121522","156121821","24","4187574"
"chr4","160338734","160339015","chr5","156152066","156152348","30","4186668"
"chr4","160479208","160479333","chr5","156299824","156299947","7","4179384"
"chr4","160612532","160612658","chr16","23266280","23266408","28","137346252"
"chr4","160725922","160726163","chr5","156553336","156553577","11","4172586"
"chr4","160858984","160859241","chr5","156688571","156688871","62","4170413"
"chr4","160977198","160977259","chr5","156812450","156812511","4","4164748"
"chr4","160981682","160981971","chr5","156815998","156816284","23","4165684"
"chr4","161046467","161046736","chr5","156887846","156888131","59","4158621"
"chr4","161054096","161054389","chr5","156895770","156896080","45","4158326"
"chr4","161150740","161151003","chr8","93540152","93540409","57","67610588"
"chr4","161205423","161205546","chr5","157047310","157047433","12","4158113"
"chr4","161236030","161236338","chr5","157080291","157080613","47","4155739"
"chr4","161246876","161247026","chr5","157091963","157092113","10","4154913"
"chr4","161391157","161391347","chr5","157231760","157231935","34","4159397"
"chr4","161391659","161391795","chr5","157232245","157232382","13","4159414"
"chr4","161409248","161409531","chr5","157250900","157251181","27","4158348"
"chr4","161419233","161419528","chr5","157260110","157260399","28","4159123"
"chr4","161667829","161668130","chr5","157513788","157514128","54","4154041"
"chr4","161798803","161799094","chr5","157638746","157639039","25","4160057"
"chr4","161891986","161892276","chr5","157728489","157728794","44","4163497"
"chr4","162110434","162110685","chrX","20526906","20527158","65","141583528"
"chr4","162124357","162124639","chr14","63990786","63991054","62","98133571"
"chr4","162279134","162279410","chr5","158125078","158125352","31","4154056"
"chr4","162334856","162335165","chr5","158181813","158182116","25","4153043"
"chr4","162375475","162375774","chr5","158232665","158232961","26","4142810"
"chr4","162392709","162392985","chr5","158249521","158249807","26","4143188"
"chr4","162449137","162449426","chr5","158312166","158312457","19","4136971"
"chr4","162453313","162453608","chr1","22392281","22392567","55","140061032"
"chr4","162454465","162454763","chr5","158317524","158317806","41","4136941"
"chr4","162477554","162477850","chr5","158337199","158337508","32","4140355"
"chr4","162511170","162511476","chr5","158364620","158364929","35","4146550"
"chr4","162516542","162516843","chr5","158369888","158370187","21","4146654"
"chr4","162554713","162554839","chr5","158405688","158405812","16","4149025"
"chr4","162598680","162598800","chr5","158438692","158438811","5","4159988"
"chr4","162622408","162622721","chr5","158459385","158459674","43","4163023"
"chr4","162658350","162658627","chr5","158494945","158495226","21","4163405"
"chr4","162680187","162680480","chr5","158510228","158510513","32","4169959"
"chr4","162721030","162721312","chr5","158546111","158546405","24","4174919"
"chr4","162727127","162727386","chr5","158552221","158552475","18","4174906"
"chr4","162737849","162738137","chr5","158563322","158563619","30","4174527"
"chr4","162746909","162747214","chr5","158572874","158573178","25","4174035"
"chr4","162769606","162769910","chr5","158595772","158596079","25","4173834"
"chr4","162778785","162778906","chr10","49362098","49362218","16","113416687"
"chr4","162784781","162785059","chr5","158610449","158610728","19","4174332"
"chr4","162809462","162809757","chr5","158626889","158627183","18","4182573"
"chr4","162820622","162820848","chr5","158639186","158639409","17","4181436"
"chr4","162826371","162826656","chr5","158645245","158645531","13","4181126"
"chr4","162865858","162866150","chr16","25771061","25771357","48","137094797"
"chr4","162880474","162880773","chr5","158699094","158699395","16","4181380"
"chr4","162882604","162882888","chr5","158701169","158701458","31","4181435"
"chr4","162907558","162907866","chr5","158725535","158725843","30","4182023"
"chr4","162918068","162918370","chr5","158737302","158737587","33","4180766"
"chr4","162925595","162925906","chr5","158744858","158745169","25","4180737"
"chr4","162931952","162932240","chr5","158751210","158751498","19","4180742"
"chr4","162934765","162935073","chr5","158754015","158754324","27","4180750"
"chr4","162950071","162950356","chr5","158769412","158769698","18","4180659"
"chr4","163003199","163003451","chr5","158821763","158822030","31","4181436"
"chr4","163038590","163038864","chr5","158857904","158858193","36","4180686"
"chr4","163052760","163052823","chr15","86064768","86064833","18","76987992"
"chr4","163054484","163054726","chr20","65637934","65638174","52","97416550"
"chr4","163055911","163056208","chr5","158873564","158873832","43","4182347"
"chr4","163066829","163067085","chr5","158884777","158885031","17","4182052"
"chr4","163095660","163095952","chr11","48401419","48401716","44","114694241"
"chr4","163117950","163118236","chr5","158921043","158921332","17","4196907"
"chr4","163123684","163123972","chr5","158926737","158927025","16","4196947"
"chr4","163128436","163128498","chr5","158931521","158931583","1","4196915"
"chr4","163164426","163164692","chr5","158973943","158974188","36","4190483"
"chr4","163165929","163166205","chr5","158975432","158975706","15","4190497"
"chr4","163176051","163176352","chr5","158985704","158985992","27","4190347"
"chr4","163179186","163179461","chr5","158988854","158989150","39","4190332"
"chr4","163190561","163190766","chr13","42904008","42904210","36","120286553"
"chr4","163205522","163205816","chrX","13287297","13287589","68","149918225"
"chr4","163210643","163210940","chr5","78689579","78689868","60","84521064"
"chr4","163224734","163225036","chr5","159033012","159033310","28","4191722"
"chr4","163246072","163246359","chr5","159102740","159103035","29","4143332"
"chr4","163271812","163271941","chr5","159127456","159127583","9","4144356"
"chr4","163344848","163345167","chr5","159198993","159199277","58","4145855"
"chr4","163367389","163367690","chr5","159221598","159221909","49","4145791"
"chr4","163431249","163431544","chr5","159286784","159287079","24","4144465"
"chr4","163450772","163451071","chr5","159305923","159306236","46","4144849"
"chr4","163486441","163486726","chr5","159341158","159341449","21","4145283"
"chr4","163492021","163492314","chr5","159347066","159347355","23","4144955"
"chr4","163501924","163502200","chr5","159357765","159358010","43","4144159"
"chr4","163525311","163525596","chr5","159386369","159386654","17","4138942"
"chr4","163529419","163529713","chr1","212801492","212801783","83","49272073"
"chr4","163532941","163533205","chr5","159394566","159394829","24","4138375"
"chr4","163533837","163533979","chr1","153250707","153250848","28","10283130"
"chr4","163535893","163536154","chr5","9176993","9177243","67","154358900"
"chr4","163549740","163550013","chr2","69678536","69678808","49","93871204"
"chr4","163561811","163561926","chr16","18459919","18460034","18","145101892"
"chr4","163580804","163580988","chr5","159482968","159483149","21","4097836"
"chr4","163602143","163602443","chr5","159504705","159504982","36","4097438"
"chr4","163609349","163609646","chr5","159511972","159512271","21","4097377"
"chr4","163654296","163654581","chr2","152865614","152865900","73","10788682"
"chr4","163708676","163708844","chr19","8026553","8026714","48","155682123"
"chr4","163783428","163783719","chr5","159679146","159679434","26","4104282"
"chr4","163827878","163828219","chr5","159721276","159721598","65","4106602"
"chr4","163884930","163885212","chr5","159775229","159775516","29","4109701"
"chr4","163926214","163926532","chr5","159816509","159816802","54","4109705"
"chr4","163933514","163933818","chr5","159824406","159824709","25","4109108"
"chr4","164309869","164310187","chr5","160232646","160232953","42","4077223"
"chr4","164544726","164545026","chr7","152260696","152260990","79","12284030"
"chr4","164571709","164571985","chr6","32308893","32309173","88","132262816"
"chr4","164593433","164593739","chr4","17579096","17579410","73","147014337"
"chr4","164685111","164685390","chr5","160627759","160628026","56","4057352"
"chr4","164741500","164741802","chr5","160679005","160679281","47","4062495"
"chr4","164814773","164814899","chr6","131856171","131856294","29","32958602"
"chr4","165050429","165050714","chr5","161073519","161073813","40","3976910"
"chr4","165051016","165051031","chr11","55257758","55257773","2","109793258"
"chr4","165151759","165151898","chr15","92614353","92614489","28","72537406"
"chr4","165258140","165258413","chr5","161336504","161336778","41","3921636"
"chr4","165311237","165311517","chr5","161390251","161390532","19","3920986"
"chr4","165403374","165403516","chr6","147066247","147066387","38","18337127"
"chr4","165423909","165424039","chr5","161499641","161499771","8","3924268"
"chr4","165566518","165566818","chr5","161633811","161634112","26","3932707"
"chr4","165628826","165629015","chr5","161701384","161701591","32","3927442"
"chr4","165712443","165712714","chr5","161790200","161790445","40","3922243"
"chr4","165748363","165748667","chr5","161826666","161826964","25","3921697"
"chr4","165769763","165770056","chr5","161848512","161848814","29","3921251"
"chr4","165810113","165810402","chr5","161896104","161896395","38","3914009"
"chr4","166018420","166018715","chr5","162118970","162119261","19","3899450"
"chr4","166080593","166080877","chr5","162188177","162188470","27","3892416"
"chr4","166174414","166174677","chr5","162341217","162341488","22","3833197"
"chr4","166361769","166362013","chr18","11878122","11878373","61","154483647"
"chr4","166443714","166443993","chr5","162685669","162685948","22","3758045"
"chr4","166480474","166480735","chr5","162724950","162725216","25","3755524"
"chr4","166528490","166528755","chr3","47322453","47322711","60","119206037"
"chr4","166668260","166668524","chr20","53473173","53473435","67","113195087"
"chr4","166676413","166676708","chr2","84913076","84913368","64","81763337"
"chr4","166692352","166692619","chr5","162948335","162948605","20","3744017"
"chr4","166791268","166791551","chr5","163032825","163033112","31","3758443"
"chr4","166859992","166860184","chr1","135834735","135834928","59","31025257"
"chr4","166872141","166872431","chr5","163114540","163114834","23","3757601"
"chr4","167052304","167052542","chr5","163317809","163318051","27","3734495"
"chr4","167109598","167109892","chr5","163371794","163372080","26","3737804"
"chr4","167111530","167111726","chr2","10564930","10565133","42","156546600"
"chr4","167139513","167139804","chr5","163402783","163403084","35","3736730"
"chr4","167260573","167260872","chr5","163518026","163518323","18","3742547"
"chr4","167272498","167272778","chr5","163530360","163530662","51","3742138"
"chr4","167288073","167288369","chr5","163547801","163548090","24","3740272"
"chr4","167306293","167306641","chr16","61825300","61825623","87","105480993"
"chr4","167309115","167309390","chr5","163569807","163570077","24","3739308"
"chr4","167336895","167337027","chr5","163598149","163598280","6","3738746"
"chr4","167360901","167361033","chr12","81148637","81148769","22","86212264"
"chr4","167396685","167396997","chr5","163657120","163657422","54","3739565"
"chr4","167402735","167403031","chr5","163662858","163663138","31","3739877"
"chr4","167489695","167489822","chr5","163744933","163745060","9","3744762"
"chr4","167553797","167554080","chr5","163808040","163808323","27","3745757"
"chr4","167566641","167566942","chr5","163820821","163821130","51","3745820"
"chr4","167765812","167766123","chr5","164016831","164017145","28","3748981"
"chr4","167793784","167794078","chr5","164038168","164038459","19","3755616"
"chr4","167882402","167882667","chr5","164129537","164129824","36","3752865"
"chr4","167985176","167985450","chr5","164230963","164231239","26","3754213"
"chr4","168031916","168032184","chr5","164274613","164274891","37","3757303"
"chr4","168295971","168296094","chr5","164504489","164504618","14","3791482"
"chr4","168789887","168790161","chr5","164786056","164786330","20","4003831"
"chr4","168830373","168830687","chr10","70947259","70947566","63","97883114"
"chr4","168891554","168891796","chr5","164887939","164888185","22","4003615"
"chr4","169016582","169016889","chr8","99634627","99634930","64","69381955"
"chr4","169068821","169069128","chr5","165065493","165065795","39","4003328"
"chr4","169081321","169081622","chr3","75011834","75012134","61","94069487"
"chr4","169140797","169141103","chr5","165134325","165134629","21","4006472"
"chr4","169147586","169147877","chr5","165141718","165142006","28","4005868"
"chr4","169181635","169181905","chr5","165173966","165174246","28","4007669"
"chr4","169186230","169186514","chr5","165178339","165178625","19","4007891"
"chr4","169197034","169197307","chr5","165192193","165192466","20","4004841"
"chr4","169203005","169203329","chr5","165198159","165198468","44","4004846"
"chr4","169218941","169219040","chr19","12711258","12711353","19","156507683"
"chr4","169230055","169230177","chr11","118369813","118369937","18","50860242"
"chr4","169262771","169262886","chr3","127146489","127146603","21","42116282"
"chr4","169266569","169266696","chr1","23489427","23489544","31","145777142"
"chr4","169277697","169277982","chr5","165292154","165292439","26","3985543"
"chr4","169305615","169305791","chr5","165325417","165325590","10","3980198"
"chr4","169306090","169306261","chr5","165325881","165326041","22","3980209"
"chr4","169309845","169309974","chr9","97930771","97930897","20","71379074"
"chr4","169331156","169331469","chr5","165357502","165357816","19","3973654"
"chr4","169342039","169342340","chr4","5341609","5341902","65","164000430"
"chr4","169343783","169343998","chr5","165368791","165369028","38","3974992"
"chr4","169357142","169357448","chr19","43881644","43881949","58","125475498"
"chr4","169357577","169357768","chr1","13746336","13746531","46","155611241"
"chr4","169363106","169363254","chr6","145629603","145629744","34","23733503"
"chr4","169367918","169368072","chrX","54000161","54000318","28","115367757"
"chr4","169374347","169374630","chr12","582908","583194","59","168791439"
"chr4","169376448","169376754","chr7","85656483","85656785","75","83719965"
"chr4","169395335","169395615","chr5","165417581","165417864","25","3977754"
"chr4","169539552","169539863","chr15","7988541","7988851","52","161551011"
"chr4","169624324","169624616","chr5","165618061","165618315","61","4006263"
"chr4","169664060","169664319","chr5","165666008","165666274","60","3998052"
"chr4","169678362","169678659","chr5","165679471","165679774","27","3998891"
"chr4","169687979","169688120","chr5","165689207","165689341","12","3998772"
"chr4","169688420","169688545","chr5","165689658","165689778","9","3998762"
"chr4","169722425","169722726","chr5","165724569","165724885","36","3997856"
"chr4","169750169","169750470","chr5","165749408","165749715","26","4000761"
"chr4","169801194","169801472","chr5","165800740","165801024","32","4000454"
"chr4","169959289","169959401","chr11","117416380","117416492","26","52542909"
"chr4","169983293","169983611","chr10","81937384","81937691","82","88045909"
"chr4","170054616","170054924","chr5","166048702","166048997","34","4005914"
"chr4","170117788","170118087","chr5","166108581","166108894","32","4009207"
"chr4","170248500","170248800","chr1","138872834","138873119","65","31375666"
"chr4","170263192","170263351","chr5","166249493","166249653","18","4013699"
"chr4","170285969","170286277","chr5","166272073","166272391","40","4013896"
"chr4","170433363","170433625","chr10","82870493","82870762","65","87562870"
"chr4","170465685","170466005","chr5","166447749","166448051","37","4017936"
"chr4","170941705","170942018","chr19","15562519","15562818","63","155379186"
"chr4","170994196","170994342","chr5","166962493","166962664","34","4031703"
"chr4","171011252","171011454","chr5","166970205","166970416","33","4041047"
"chr4","171055790","171056098","chr5","167004491","167004808","28","4051299"
"chr4","171097076","171097366","chr5","167047835","167048129","22","4049241"
"chr4","171101307","171101579","chr5","167052116","167052390","24","4049191"
"chr4","171154264","171154575","chr3","42442443","42442729","83","128711821"
"chr4","171165312","171165527","chrX","48222572","48222783","47","122942740"
"chr4","171183982","171184283","chr5","167127360","167127659","39","4056622"
"chr4","171298127","171298414","chr5","167241619","167241898","30","4056508"
"chr4","171412716","171412954","chr5","167365567","167365806","13","4047149"
"chr4","171502952","171503250","chr5","167458129","167458449","44","4044823"
"chr4","171503643","171503943","chr5","167458843","167459144","44","4044800"
"chr4","171528333","171528548","chr3","126851510","126851690","77","44676823"
"chr4","171528581","171528689","chr7","96373512","96373619","31","75155069"
"chr4","171599700","171599818","chr5","167550943","167551052","22","4048757"
"chr4","171847597","171847851","chr5","167824028","167824281","23","4023569"
"chr4","171864754","171865070","chr5","167840577","167840882","31","4024177"
"chr4","171947138","171947407","chr13","65981878","65982141","71","105965260"
"chr4","171983735","171983994","chr5","167958670","167958932","23","4025065"
"chr4","172123264","172123539","chr5","168090440","168090706","25","4032824"
"chr4","172193205","172193475","chr5","168147665","168147935","14","4045540"
"chr4","172289884","172290172","chr5","168226838","168227126","21","4063046"
"chr4","172292689","172292813","chr5","168230213","168230336","8","4062476"
"chr4","172648904","172649107","chr5","168579800","168580002","11","4069104"
"chr4","172649529","172649651","chr5","168580445","168580567","2","4069084"
"chr4","172669232","172669489","chr5","168601042","168601304","26","4068190"
"chr4","172701370","172701468","chr4","30644663","30644754","24","142056707"
"chr4","172749195","172749317","chr5","168674699","168674823","9","4074496"
"chr4","172762680","172762797","chr5","168688230","168688357","21","4074450"
"chr4","172775937","172776249","chr5","168701497","168701809","21","4074440"
"chr4","172785094","172785401","chr5","168710161","168710464","23","4074933"
"chr4","172785858","172786106","chr1","69947558","69947799","62","102838300"
"chr4","172787354","172787634","chr5","168712429","168712705","23","4074925"
"chr4","172845785","172846106","chr4","31751916","31752223","76","141093869"
"chr4","172850812","172851117","chr5","63743330","63743629","63","109107482"
"chr4","172887064","172887346","chr5","168811181","168811467","22","4075883"
"chr4","172920258","172920558","chr5","168844345","168844649","26","4075913"
"chr4","172942303","172942608","chr5","168866981","168867286","27","4075322"
"chr4","172959393","172959692","chr5","168884577","168884876","31","4074816"
"chr4","172986600","172986747","chr9","72272836","72272988","27","100713764"
"chr4","173011255","173011529","chr6","161557509","161557798","59","11453746"
"chr4","173015718","173015864","chr5","168973759","168973905","4","4041959"
"chr4","173022861","173022956","chr5","168980800","168980895","6","4042061"
"chr4","173030729","173031034","chr5","168989010","168989329","45","4041719"
"chr4","173067932","173068056","chr5","169026766","169026895","16","4041166"
"chr4","173092641","173092909","chr5","169051411","169051678","27","4041230"
"chr4","173102521","173102795","chr5","169061750","169062024","11","4040771"
"chr4","173119221","173119498","chr5","169078540","169078800","32","4040681"
"chr4","173141387","173141588","chr8","17833358","17833560","42","155308029"
"chr4","173150582","173150876","chr5","169112810","169113108","28","4037772"
"chr4","173154916","173155187","chr4","154445507","154445774","61","18709409"
"chr4","173185569","173185867","chr5","169147487","169147792","23","4038082"
"chr4","173222089","173222171","chr18","21177033","21177118","23","152045056"
"chr4","173232130","173232474","chr3","12059943","12060263","82","161172187"
"chr4","173281234","173281521","chr5","78689579","78689868","59","94591655"
"chr4","173295570","173295810","chr5","169258188","169258426","16","4037382"
"chr4","173311584","173311890","chr5","169269684","169270011","58","4041900"
"chr4","173320021","173320044","chr7","28906739","28906762","4","144413282"
"chr4","173320070","173320354","chr1","146553304","146553584","56","26766766"
"chr4","173325543","173325838","chr5","169283675","169283971","28","4041868"
"chr4","173332748","173333025","chr5","169291171","169291436","32","4041577"
"chr4","173344360","173344668","chr5","169301813","169302118","27","4042547"
"chr4","173353770","173354060","chr2","72620227","72620511","58","100733543"
"chr4","173362279","173362569","chr5","169320135","169320427","23","4042144"
"chr4","173382366","173382624","chr5","169341282","169341554","31","4041084"
"chr4","173385075","173385187","chr20","12117025","12117140","16","161268050"
"chr4","173409594","173409874","chr5","169369475","169369758","17","4040119"
"chr4","173424879","173425186","chr5","169384437","169384743","26","4040442"
"chr4","173433273","173433396","chr5","169392964","169393082","9","4040309"
"chr4","173465890","173466158","chr5","169425566","169425834","27","4040324"
"chr4","173480883","173480950","chr5","169441828","169441890","10","4039055"
"chr4","173481542","173481723","chr5","169442487","169442653","20","4039055"
"chr4","173485138","173485408","chr5","169445071","169445342","23","4040067"
"chr4","173504921","173505216","chr5","169465356","169465645","26","4039565"
"chr4","173524761","173525064","chr5","169485240","169485537","24","4039521"
"chr4","173535222","173535339","chr5","169495746","169495863","7","4039476"
"chr4","173554436","173554739","chr5","169515096","169515386","38","4039340"
"chr4","173581757","173582072","chr5","169543686","169543989","28","4038071"
"chr4","173637473","173637752","chr16","67007202","67007465","67","106630271"
"chr4","173653839","173654131","chr13","107514555","107514851","60","66139284"
"chr4","173681095","173681387","chr5","169624162","169624445","25","4056933"
"chr4","173686823","173687107","chr5","169630090","169630375","28","4056733"
"chr4","173688856","173689134","chr5","169632088","169632382","45","4056768"
"chr4","173696413","173696726","chr5","169639563","169639851","50","4056850"
"chr4","173700084","173700367","chr5","169643503","169643793","28","4056581"
"chr4","173702430","173702613","chr5","169645795","169645980","22","4056635"
"chr4","173702903","173703029","chr5","169646273","169646400","14","4056630"
"chr4","173713257","173713539","chr5","169657384","169657659","28","4055873"
"chr4","173721832","173722094","chr5","169666273","169666533","19","4055559"
"chr4","173722191","173722457","chr5","169666636","169666898","47","4055555"
"chr4","173724480","173724753","chr5","169668902","169669175","21","4055578"
"chr4","173732545","173732827","chr5","169675363","169675655","31","4057182"
"chr4","173739380","173739660","chr5","169682181","169682471","22","4057199"
"chr4","173741778","173742068","chrX","29528777","29529067","69","144213001"
"chr4","173769710","173769970","chrX","7354555","7354813","59","166415155"
"chr4","173770331","173770457","chr15","46151444","46151568","18","127618887"
"chr4","173777452","173777585","chr11","33003609","33003740","25","140773843"
"chr4","173778944","173779259","chr5","169716685","169716967","46","4062259"
"chr4","173816480","173816792","chr5","169749312","169749612","37","4067168"
"chr4","173822926","173823208","chr5","169755795","169756089","34","4067131"
"chr4","173843116","173843432","chr1","7114733","7115046","59","166728383"
"chr4","173852068","173852363","chr5","169785689","169785970","42","4066379"
"chr4","173870803","173871103","chrX","125989015","125989296","68","47881788"
"chr4","173874427","173874719","chr5","169807315","169807613","29","4067112"
"chr4","173886829","173887133","chr5","169820209","169820522","37","4066620"
"chr4","173926914","173927037","chr5","169859754","169859877","5","4067160"
"chr4","173930637","173930825","chr11","32274431","32274618","46","141656206"
"chr4","173931654","173931773","chr5","169864067","169864190","13","4067587"
"chr4","173947486","173947793","chr5","169877540","169877841","27","4069946"
"chr4","173948730","173948954","chr5","169878752","169878975","11","4069978"
"chr4","173976233","173976423","chr15","68943681","68943880","24","105032552"
"chr4","173993945","173994141","chr16","24543604","24543803","40","149450341"
"chr4","173997366","173997517","chr13","38978600","38978741","46","135018766"
"chr4","173997701","173997925","chr5","169927411","169927659","39","4070290"
"chr4","174044611","174044892","chr5","169975823","169976097","67","4068788"
"chr4","174066941","174067216","chr3","125025764","125026069","49","49041177"
"chr4","174088866","174089146","chr5","170022116","170022414","50","4066750"
"chr4","174103258","174103578","chr5","170033327","170033641","30","4069931"
"chr4","174106323","174106602","chr5","170035780","170036061","20","4070543"
"chr4","174125069","174125199","chr1","27434443","27434574","25","146690626"
"chr4","174125526","174125813","chr5","170051170","170051473","33","4074356"
"chr4","174127585","174127862","chr20","72489521","72489798","63","101638064"
"chr4","174131001","174131270","chr5","170055598","170055866","22","4075403"
"chr4","174149013","174149326","chr5","170076345","170076658","23","4072668"
"chr4","174151582","174151905","chr5","170078912","170079228","34","4072670"
"chr4","174162633","174162782","chr9","8174046","8174195","29","165988587"
"chr4","174185099","174185386","chr5","170114444","170114734","21","4070655"
"chr4","174197493","174197670","chr5","170126727","170126918","33","4070766"
"chr4","174212072","174212147","chr5","170135370","170135445","7","4076702"
"chr4","174249948","174250237","chr2","99689040","99689328","59","74560908"
"chr4","174296395","174296685","chr5","170217332","170217617","23","4079063"
"chr4","174314905","174315180","chr5","170235750","170236025","16","4079155"
"chr4","174328044","174328353","chr5","170249008","170249316","21","4079036"
"chr4","174375229","174375344","chr5","170298749","170298864","7","4076480"
"chr4","174379508","174379775","chr5","170303095","170303385","43","4076413"
"chr4","174386925","174387238","chr5","170309098","170309411","33","4077827"
"chr4","174445295","174445596","chr15","29474670","29474963","66","144970625"
"chr4","174482834","174483133","chr5","101158084","101158380","65","73324750"
"chr4","174497759","174498049","chr2","104260950","104261240","56","70236809"
"chr4","174516243","174516522","chr11","114543497","114543784","62","59972746"
"chr4","174643392","174643668","chr5","170523726","170524001","28","4119666"
"chr4","174768514","174768782","chr5","170654504","170654770","16","4114010"
"chr4","174779338","174779416","chr5","170668245","170668332","15","4111093"
"chr4","174820243","174820525","chr5","170712486","170712772","27","4107757"
"chr4","174838492","174838778","chr5","170728508","170728776","40","4109984"
"chr4","174998433","174998726","chr5","170881581","170881873","25","4116852"
"chr4","175043943","175044230","chr5","170926320","170926617","36","4117623"
"chr4","175100326","175100508","chr5","170989558","170989738","15","4110768"
"chr4","175345867","175346093","chr7","116163053","116163281","47","59182814"
"chr4","175352786","175353042","chr5","171236762","171237017","33","4116024"
"chr4","175353232","175353570","chr5","171237184","171237486","81","4116048"
"chr4","175423691","175423987","chr16","68450975","68451269","55","106972716"
"chr4","175457329","175457493","chr1","7021253","7021406","47","168436076"
"chr4","175609767","175610059","chr5","171491578","171491862","51","4118189"
"chr4","175626645","175626916","chr8","72810099","72810372","69","102816546"
"chr4","175782143","175782471","chr5","171672226","171672525","65","4109917"
"chr4","175787851","175787996","chr11","48792463","48792610","32","126995388"
"chr4","175797649","175797939","chr5","171688256","171688547","23","4109393"
"chr4","175828527","175828824","chr5","171720389","171720702","36","4108138"
"chr4","175889782","175890116","chr1","219052590","219052906","100","43162808"
"chr4","175900718","175900994","chr5","171788723","171789002","23","4111995"
"chr4","176018675","176018958","chr20","26230829","26231113","59","149787846"
"chr4","176020050","176020252","chr3","155044884","155045088","56","20975166"
"chr4","176041994","176042325","chr7","116518734","116519041","81","59523260"
"chr4","176043965","176044307","chr19","16671882","16672196","94","159372083"
"chr4","176048540","176048708","chr5","171970391","171970565","22","4078149"
"chr4","176051028","176051167","chr5","171972879","171973022","20","4078149"
"chr4","176087392","176087676","chr5","172008651","172008937","31","4078741"
"chr4","176134318","176134603","chr5","172054421","172054697","30","4079897"
"chr4","176156769","176157054","chr5","172082541","172082827","23","4074228"
"chr4","176193161","176193443","chr5","172112727","172113005","20","4080434"
"chr4","176198678","176198888","chr5","172119057","172119263","19","4079621"
"chr4","176343420","176343693","chr5","172252516","172252814","42","4090904"
"chr4","176358517","176358792","chr5","172268419","172268695","15","4090098"
"chr4","176905876","176906180","chr5","172621799","172622089","32","4284077"
"chr4","176918242","176918367","chr5","172636682","172636807","5","4281560"
"chr4","176921970","176922304","chr5","172640391","172640699","41","4281579"
"chr4","176923439","176923763","chr5","172641824","172642148","26","4281615"
"chr4","176934118","176934402","chr5","172652263","172652574","47","4281855"
"chr4","176950716","176950995","chr5","172668687","172668969","23","4282029"
"chr4","176978719","176979015","chr1","32090539","32090837","60","144888180"
"chr4","177013315","177013613","chr5","172732727","172733013","64","4280588"
"chr4","177328207","177328348","chr3","39810823","39810958","42","137517384"
"chr4","177403700","177403996","chr5","173120641","173120953","39","4283059"
"chr4","177405371","177405679","chr16","51221973","51222278","61","126183398"
"chr4","177420770","177421066","chr5","173138301","173138598","23","4282469"
"chr4","177578814","177578960","chr5","173280119","173280281","24","4298695"
"chr4","177601467","177601744","chr5","173305302","173305577","20","4296165"
"chr4","177612781","177612942","chr10","27406902","27407056","34","150205879"
"chr4","177613210","177613392","chr16","1119774","1119913","58","176493436"
"chr4","177632853","177633158","chr5","173336837","173337145","32","4296016"
"chr4","177698638","177698921","chr5","173399845","173400135","23","4298793"
"chr4","177765986","177766153","chr5","173468103","173468270","4","4297883"
"chr4","177779082","177779396","chr5","173481421","173481728","22","4297661"
"chr4","177813592","177813882","chr5","173517105","173517392","16","4296487"
"chr4","177820372","177820662","chr5","173523897","173524188","16","4296475"
"chr4","177825490","177825608","chr5","173529245","173529357","17","4296245"
"chr4","177852823","177853120","chr5","173556466","173556766","15","4296357"
"chr4","177853175","177853391","chr5","173556838","173557056","12","4296337"
"chr4","177892142","177892445","chr5","173597575","173597878","23","4294567"
"chr4","177894980","177895277","chr5","173600339","173600632","17","4294641"
"chr4","177942291","177942319","chr16","72124145","72124164","9","105818146"
"chr4","177942438","177942693","chr5","173656378","173656662","50","4286060"
"chr4","177947184","177947461","chr5","173660605","173660865","31","4286579"
"chr4","178028563","178028863","chr1","220772727","220773033","74","42744164"
"chr4","178032555","178032852","chr5","173743983","173744294","41","4288572"
"chr4","178049486","178049602","chr5","173760385","173760510","15","4289101"
"chr4","178097854","178098144","chr5","173795563","173795890","58","4302291"
"chr4","178152177","178152489","chr5","173848705","173849024","26","4303472"
"chr4","178174697","178174986","chr5","173872530","173872814","30","4302167"
"chr4","178219687","178219994","chr9","39037044","39037333","68","139182643"
"chr4","178311596","178311874","chr5","173994246","173994524","18","4317350"
"chr4","178491198","178491488","chr5","174238039","174238329","24","4253159"
"chr4","178518707","178518899","chr5","174265868","174266060","13","4252839"
"chr4","178530431","178530560","chr1","14179041","14179172","24","164351390"
"chr4","178545783","178546065","chr5","174293478","174293747","29","4252305"
"chr4","178550116","178550419","chr5","174297822","174298126","33","4252294"
"chr4","178556629","178556837","chr11","26823620","26823827","48","151733009"
"chr4","178669163","178669278","chr5","174415507","174415621","11","4253656"
"chr4","178786257","178786557","chr15","43687639","43687935","56","135098618"
"chr4","178789880","178790181","chr5","174605245","174605551","28","4184635"
"chr4","178797195","178797482","chr5","174612615","174612924","43","4184580"
"chr4","178803117","178803177","chrX","9067252","9067316","16","169735865"
"chr4","178818069","178818297","chr5","174635725","174635962","35","4182344"
"chr4","178889417","178889708","chr5","174705079","174705355","30","4184338"
"chr4","178905796","178906077","chr10","82403814","82404102","61","96501982"
"chr4","178926075","178926344","chr5","174743090","174743373","33","4182985"
"chr4","178940202","178940288","chr5","174758449","174758536","7","4181753"
"chr4","178940344","178940498","chr2","92505782","92505938","27","86434562"
"chr4","178963704","178964013","chr5","174780650","174780957","25","4183054"
"chr4","178996487","178996797","chr5","174814204","174814506","34","4182283"
"chr4","178997813","178998043","chr5","174815512","174815730","29","4182301"
"chr4","179129643","179129935","chr5","174946360","174946651","15","4183283"
"chr4","179161049","179161293","chr3","36424130","36424381","52","142736919"
"chr4","179288843","179289136","chr5","175101668","175101967","26","4187175"
"chr4","179295377","179295674","chr5","175108506","175108800","28","4186871"
"chr4","179376774","179376929","chr1","43681663","43681817","45","135695111"
"chr4","179452418","179452615","chr2","92392609","92392805","40","87059809"
"chr4","179577297","179577610","chr16","71054388","71054696","78","108522909"
"chr4","179634010","179634297","chr5","175533320","175533604","31","4100690"
"chr4","179693946","179694226","chr15","43687639","43687935","62","136006307"
"chr4","179747000","179747166","chr20","23349014","23349178","33","156397986"
"chr4","179747200","179747309","chr3","101090196","101090312","29","78657004"
"chr4","179782123","179782437","chr5","175696528","175696849","33","4085595"
"chr4","179823796","179824082","chr5","175740251","175740530","36","4083545"
"chr4","179848880","179849172","chr5","175766064","175766357","26","4082816"
"chr4","179876613","179876871","chr12","87749598","87749866","51","92127015"
"chr4","179913901","179914093","chr1","130390091","130390280","61","49523810"
"chr4","179914377","179914478","chr9","32334641","32334745","29","147579736"
"chr4","179944718","179945028","chr5","175863620","175863926","20","4081098"
"chr4","180115439","180115748","chr5","176033794","176034089","40","4081645"
"chr4","180151916","180152196","chr1","35294285","35294565","50","144857631"
"chr4","180162421","180162722","chr5","176081273","176081592","44","4081148"
"chr4","180222085","180222374","chr5","176142715","176143004","23","4079370"
"chr4","180241968","180242077","chr4","35739553","35739656","31","144502415"
"chr4","180242382","180242575","chr3","40145144","40145328","46","140097238"
"chr4","180317619","180317915","chr5","176235089","176235355","45","4082530"
"chr4","180357499","180357807","chr16","38661527","38661829","63","141695972"
"chr4","180374929","180375063","chr7","96669674","96669791","29","83705255"
"chr4","180405731","180406001","chr5","176329762","176330023","24","4075969"
"chr4","180411874","180412186","chr5","176335793","176336120","40","4076081"
"chr4","180444362","180444632","chr5","176375727","176376006","33","4068635"
"chr4","180448271","180448587","chr2","22643052","22643359","66","157805219"
"chr4","180488285","180488587","chr5","176417322","176417584","54","4070963"
"chr4","180492228","180492493","chr5","176420133","176420424","41","4072095"
"chr4","180493471","180493738","chr5","176421390","176421660","28","4072081"
"chr4","180572309","180572629","chr7","150901584","150901892","69","29670725"
"chr4","180612754","180612996","chr5","176550669","176550893","30","4062085"
"chr4","180614553","180614843","chr5","176552455","176552745","22","4062098"
"chr4","180646855","180647184","chr5","176579085","176579414","29","4067770"
"chr4","180659929","180660261","chr6","78539322","78539612","97","102120607"
"chr4","180720218","180720527","chr5","176651460","176651750","34","4068758"
"chr4","180941589","180941870","chr5","176872670","176872951","20","4068919"
"chr4","180956872","180957164","chr5","176888464","176888755","16","4068408"
"chr4","181042437","181042583","chr5","176978168","176978314","7","4064269"
"chr4","181042594","181042911","chr5","176978356","176978686","47","4064238"
"chr4","181056267","181056435","chr5","21941609","21941775","39","159114658"
"chr4","181088241","181088516","chr15","109942479","109942756","54","71145762"
"chr4","181162860","181163120","chr15","77278368","77278620","68","103884492"
"chr4","181174588","181174854","chr1","50066866","50067138","62","131107722"
"chr4","181239284","181239398","chr5","177172683","177172796","6","4066601"
"chr4","181409002","181409222","chr5","177350956","177351180","21","4058046"
"chr4","181424550","181424835","chr5","177368464","177368744","25","4056086"
"chr4","181536726","181536975","chr5","177487533","177487782","20","4049193"
"chr4","181552643","181552897","chr5","177502808","177503074","41","4049835"
"chr4","181653356","181653576","chr5","177603326","177603551","20","4050030"
"chr4","181682500","181682797","chr5","177633960","177634263","27","4048540"
"chr4","181691096","181691380","chr7","58370727","58371021","71","123320369"
"chr4","181703084","181703391","chr5","177655311","177655604","29","4047773"
"chr4","181707052","181707365","chr20","41910029","41910330","67","139797023"
"chr4","181711075","181711360","chr5","177658518","177658825","44","4052557"
"chr4","181719173","181719465","chr5","177666634","177666918","36","4052539"
"chr4","181726292","181726415","chr5","177674296","177674419","8","4051996"
"chr4","181732030","181732334","chr5","177680036","177680324","32","4051994"
"chr4","181768188","181768349","chr5","177716437","177716599","17","4051751"
"chr4","181775101","181775352","chr5","177723746","177723995","19","4051355"
"chr4","181779803","181780098","chr5","177728430","177728723","26","4051373"
"chr4","181811147","181811276","chr20","15150663","15150791","26","166660484"
"chr4","181816803","181816912","chr7","152899855","152899972","28","28916948"
"chr4","181816938","181817064","chr1","166832758","166832882","24","14984180"
"chr4","181843236","181843458","chr5","177797718","177797940","12","4045518"
"chr4","181845777","181846067","chr5","177800287","177800580","42","4045490"
"chr4","181878398","181878693","chr10","15460316","15460612","74","166418082"
"chr4","181885691","181885983","chr5","177841048","177841337","42","4044643"
"chr4","182050835","182051137","chr3","65149988","65150281","60","116900847"
"chr4","182105086","182105388","chr5","178061074","178061388","39","4044012"
"chr4","182184183","182184486","chr5","178141846","178142142","28","4042337"
"chr4","182242866","182243126","chr5","178212122","178212387","43","4030744"
"chr4","182356397","182356508","chr5","178312790","178312900","5","4043607"
"chr4","182374389","182374708","chr5","178332235","178332547","22","4042154"
"chr4","182426179","182426532","chr10","58688339","58688656","95","123737840"
"chr4","182497078","182497329","chr5","178461591","178461855","37","4035487"
"chr4","182631357","182631640","chr5","178809000","178809299","41","3822357"
"chr4","182694725","182695031","chr5","178770570","178770875","26","3924155"
"chr4","182726175","182726442","chr13","48886530","48886794","72","133839645"
"chr4","182773597","182773875","chr6","155784541","155784813","75","26989056"
"chr4","182838425","182838553","chr9","35853288","35853411","25","146985137"
"chr4","182903146","182903370","chr1","109931573","109931800","65","72971573"
"chr4","182903879","182904189","chr5","178909982","178910294","31","3993897"
"chr4","182986516","182986811","chr5","178989122","178989383","49","3997394"
"chr4","183018718","183018859","chr5","179020927","179021068","11","3997791"
"chr4","183019166","183019344","chr5","179021378","179021551","18","3997788"
"chr4","183027593","183027863","chr5","179030740","179031011","19","3996853"
"chr4","183033160","183033449","chr5","179036350","179036627","34","3996810"
"chr4","183199524","183199647","chr6","129305028","129305141","33","53894496"
"chr4","183251723","183252029","chr11","117366311","117366614","61","65885412"
"chr4","183283100","183283404","chr20","10719806","10720100","53","172563294"
"chr4","183379946","183380233","chr5","179372140","179372429","25","4007806"
"chr4","183397855","183398097","chr5","179389202","179389443","16","4008653"
"chr4","183398460","183398750","chr14","8439133","8439435","67","174959327"
"chr4","183430688","183430965","chr5","179418256","179418556","42","4012432"
"chr4","183461278","183461573","chr12","56268787","56269085","62","127192491"
"chr4","183533807","183534079","chr5","179508027","179508258","54","4025780"
"chr4","183623587","183623876","chr7","113150637","113150924","60","70472950"
"chr4","183626721","183626784","chr10","29331231","29331296","20","154295490"
"chr4","183636099","183636271","chr5","179605600","179605771","17","4030499"
"chr4","183740051","183740338","chr5","179708291","179708575","28","4031760"
"chr4","183816992","183817269","chr5","179783894","179784169","23","4033098"
"chr4","183835998","183836293","chr5","179798706","179798998","42","4037292"
"chr4","183846410","183846535","chr14","4236077","4236202","17","179610333"
"chr4","183876164","183876450","chr5","179834828","179835104","32","4041336"
"chr4","183885016","183885316","chr5","179844003","179844282","53","4041013"
"chr4","183921986","183922232","chr5","179882780","179883023","19","4039206"
"chr4","183934874","183935050","chr5","179895948","179896134","24","4038926"
"chr4","183990060","183990182","chr5","179949598","179949718","12","4040462"
"chr4","184033720","184034042","chr5","179994207","179994490","55","4039513"
"chr4","184059836","184060134","chr5","180019360","180019657","29","4040476"
"chr4","184084110","184084392","chr5","180037232","180037516","37","4046878"
"chr4","184342002","184342286","chr5","180301019","180301324","45","4040983"
"chr4","184363534","184363832","chr5","180321188","180321503","45","4042346"
"chr4","184400833","184401142","chr5","180360233","180360521","42","4040600"
"chr4","184441855","184441980","chr5","180398406","180398519","20","4043449"
"chr4","184451777","184452079","chr5","180408345","180408648","33","4043432"
"chr4","184538015","184538139","chr5","180498293","180498409","18","4039722"
"chr4","184550768","184551006","chr5","180511474","180511707","39","4039294"
"chr4","184605960","184606069","chr5","180567098","180567219","20","4038862"
"chr4","184630836","184631145","chr5","180591991","180592295","31","4038845"
"chr4","184658310","184658582","chr8","29558523","29558807","61","155099787"
"chr4","184691015","184691257","chr16","60876216","60876475","70","123814799"
"chr4","184705041","184705350","chr5","180663291","180663593","33","4041750"
"chr4","184759384","184759679","chr5","180721165","180721479","46","4038219"
"chr4","184823978","184824232","chr5","180783047","180783305","31","4040931"
"chr4","184830544","184830842","chr4","32981554","32981854","61","151848990"
"chr4","184907323","184907450","chr5","180867628","180867755","5","4039695"
"chr4","184915889","184915968","chr4","108247077","108247154","19","76668812"
"chr4","184956397","184956672","chr1","5540674","5540949","69","179415723"
"chr4","184968415","184968723","chr5","180929518","180929830","28","4038897"
"chr4","185019935","185020055","chr11","116382029","116382153","20","68637906"
"chr4","185029793","185030078","chr5","180988770","180989067","29","4041023"
"chr4","185055305","185055614","chr5","181014063","181014365","47","4041242"
"chr4","185066398","185066486","chr19","3024654","3024753","21","182041744"
"chr4","185066516","185066701","chr5","181025083","181025239","42","4041433"
"chr4","185074632","185074955","chr5","181033800","181034132","38","4040832"
"chr4","185169316","185169435","chr5","181129488","181129616","16","4039828"
"chr4","185171393","185171676","chr5","181131593","181131876","29","4039800"
"chr4","185196056","185196354","chr5","181156502","181156798","28","4039554"
"chr4","185200763","185200885","chr5","181161199","181161321","7","4039564"
"chr4","185208863","185209168","chr5","181168037","181168338","42","4040826"
"chr4","185211097","185211353","chr1","26631916","26632186","79","158579181"
"chr4","185262619","185262904","chr2","78739193","78739481","63","106523426"
"chr4","185324793","185325007","chr5","181286845","181287064","25","4037948"
"chr4","185340542","185340823","chr5","181304364","181304632","28","4036178"
"chr4","185360099","185360423","chr5","181323936","181324296","52","4036163"
"chr4","185369573","185369876","chr5","181338959","181339264","28","4030614"
"chr4","185491676","185491938","chr5","181463795","181464071","29","4027881"
"chr4","185515041","185515155","chr5","181486834","181486948","9","4028207"
"chr4","185597447","185597705","chr5","181567019","181567293","36","4030428"
"chr4","185606405","185606631","chr5","181576099","181576327","18","4030306"
"chr4","185624992","185625119","chr5","181594757","181594884","10","4030235"
"chr4","185644173","185644498","chr5","181614137","181614451","32","4030036"
"chr4","185645590","185645894","chr5","181615537","181615875","65","4030053"
"chr4","185652590","185652891","chr12","11161034","11161316","60","174491556"
"chr4","185705354","185705640","chr5","181677386","181677678","25","4027968"
"chr4","185739918","185740273","chr8","58504583","58504914","108","127235335"
"chr4","185756474","185756790","chr5","181730605","181730895","58","4025869"
"chr4","185766998","185767273","chr5","181748194","181748474","22","4018804"
"chr4","185863679","185863986","chr5","181845231","181845532","31","4018448"
"chr4","185927326","185927617","chr5","181911933","181912223","32","4015393"
"chr4","185965318","185965607","chr15","47855867","47856141","60","138109451"
"chr4","185994114","185994350","chr5","181979343","181979577","22","4014771"
"chr4","186122847","186123169","chr5","182112173","182112484","56","4010674"
"chr4","186205727","186205986","chr5","182192795","182193054","20","4012932"
"chr4","186225707","186225931","chr5","182213314","182213559","30","4012393"
"chr4","186246071","186246354","chr5","182234116","182234389","28","4011955"
"chr4","186317133","186317430","chr5","182310295","182310609","41","4006838"
"chr4","186395112","186395409","chr5","182385777","182386073","70","4009335"
"chr4","186467124","186467383","chr5","182457140","182457415","42","4009984"
"chr4","186478102","186478407","chr5","182467829","182468126","26","4010273"
"chr4","186496570","186496841","chr5","182485637","182485914","18","4010933"
"chr4","186513005","186513295","chr5","182502008","182502303","28","4010997"
"chr4","186535484","186535772","chr1","182642228","182642528","60","3893256"
"chr4","186583416","186583703","chr5","182577049","182577346","40","4006367"
"chr4","186610443","186610713","chr5","182604261","182604534","50","4006182"
"chr4","186664414","186664630","chr14","105129753","105129968","50","81534661"
"chr4","186665854","186666147","chr5","182660065","182660357","26","4005789"
"chr4","186673988","186674279","chr5","182668189","182668479","20","4005799"
"chr4","186690431","186690710","chr5","182684136","182684429","33","4006295"
"chr4","186701710","186702012","chr5","182695738","182696040","18","4005972"
"chr4","186703708","186703995","chr5","182698524","182698818","22","4005184"
"chr4","186722874","186723189","chr5","182718227","182718525","31","4004647"
"chr4","186741157","186741442","chr5","182736628","182736930","43","4004529"
"chr4","186818374","186818625","chr7","63770247","63770499","54","123048127"
"chr4","186848451","186848741","chr5","182837303","182837595","30","4011148"
"chr4","186871734","186872031","chr5","182861980","182862292","38","4009754"
"chr4","186880537","186880732","chr5","182870756","182870952","16","4009781"
"chr4","186886810","186887038","chr5","182877358","182877597","14","4009452"
"chr4","186887796","186888037","chr5","182878340","182878600","30","4009456"
"chr4","186946900","186947184","chr5","182939918","182940209","20","4006982"
"chr4","186949079","186949373","chr8","140342617","140342917","60","46606462"
"chr4","186955396","186955692","chr5","182949402","182949708","33","4005994"
"chr4","186961507","186961806","chr5","182956081","182956383","26","4005426"
"chr4","186965718","186965855","chr1","109888864","109888999","39","77076854"
"chr4","186999459","186999743","chr5","182994733","182995017","21","4004726"
"chr4","187007817","187007981","chr5","183003355","183003533","27","4004462"
"chr4","187023799","187024082","chr5","183019385","183019669","16","4004414"
"chr4","187033793","187033951","chr12","10462851","10463007","30","176570942"
"chr4","187045783","187046100","chr5","183042910","183043228","17","4002873"
"chr4","187135105","187135384","chr5","183138475","183138755","23","3996630"
"chr4","187212081","187212340","chr5","183210945","183211213","33","4001136"
"chr4","187263983","187264277","chr5","183260920","183261211","34","4003063"
"chr4","187265928","187265985","chr5","183262870","183262920","17","4003058"
"chr4","187266536","187266612","chr5","183263471","183263546","2","4003065"
"chr4","187300070","187300386","chr5","183301573","183301881","34","3998497"
"chr4","187308616","187308890","chr5","183310404","183310678","16","3998212"
"chr4","187313549","187313843","chr9","23116704","23116994","52","164196845"
"chr4","187357085","187357396","chr5","183365414","183365685","62","3991671"
"chr4","187391617","187391661","chr5","47471105","47471146","13","139920512"
"chr4","187394268","187394564","chr5","183409128","183409417","30","3985140"
"chr4","187404749","187405048","chr1","77944739","77945036","60","109460010"
"chr4","187427684","187427833","chr5","183433688","183433849","24","3993996"
"chr4","187428125","187428313","chr5","183434144","183434322","27","3993981"
"chr4","187430508","187430796","chr5","183436899","183437201","33","3993609"
"chr4","187438361","187438487","chr5","183450668","183450796","8","3987693"
"chr4","187474566","187474886","chr14","65800601","65800908","67","121673965"
"chr4","187486711","187486990","chr16","72266438","72266711","64","115220273"
"chr4","187492248","187492556","chr5","183493923","183494231","18","3998325"
"chr4","187492639","187492715","chr1","25652931","25653008","17","161839708"
"chr4","187493042","187493167","chr8","38103837","38103971","25","149389205"
"chr4","187515734","187516042","chr5","96720051","96720354","54","90795683"
"chr4","187517597","187517728","chr1","8744078","8744207","22","178773519"
"chr4","187531761","187531827","chr1","221830216","221830288","14","34298455"
"chr4","187532134","187532288","chrX","47256571","47256728","28","140275563"
"chr4","187555761","187556048","chr20","10719806","10720100","50","176835955"
"chr4","187556453","187556737","chr5","183560663","183560946","22","3995790"
"chr4","187572791","187572926","chr1","30378928","30379065","22","157193863"
"chr4","187574045","187574288","chr5","183578173","183578407","36","3995872"
"chr4","187576415","187576697","chr5","183580809","183581081","25","3995606"
"chr4","187595210","187595497","chr5","183602406","183602689","29","3992804"
"chr4","187614613","187614744","chr5","183621162","183621293","7","3993451"
"chr4","187635142","187635224","chr5","183641899","183641981","6","3993243"
"chr4","187656408","187656694","chr5","183662769","183663041","35","3993639"
"chr4","187675290","187675580","chr5","183682423","183682707","28","3992867"
"chr4","187695402","187695683","chr2","49010895","49011163","64","138684507"
"chr4","187700156","187700243","chr13","1772973","1773060","14","185927183"
"chr4","187713464","187713731","chr5","183719675","183719937","29","3993789"
"chr4","187746692","187747004","chr9","99101491","99101790","70","88645201"
"chr4","187765075","187765315","chr5","183782803","183783047","12","3982272"
"chr4","187774582","187774872","chr12","20693356","20693651","64","167081226"
"chr4","187802240","187802384","chr1","16030873","16031006","35","171771367"
"chr4","187816737","187816843","chr18","11330690","11330794","12","176486047"
"chr4","187820517","187820602","chr5","183843216","183843301","7","3977301"
"chr4","187825487","187825768","chr5","183845658","183845961","45","3979829"
"chr4","187828742","187829040","chr5","183848900","183849174","38","3979842"
"chr4","187846895","187847068","chr5","183867483","183867657","20","3979412"
"chr4","187878615","187879021","chrX","47229042","47229392","122","140649573"
"chr4","187879840","187880105","chr7","126461298","126461565","58","61418542"
"chr4","187884482","187884769","chr5","183906032","183906331","26","3978450"
"chr4","187903088","187903363","chr5","183922977","183923265","29","3980111"
"chr4","187927864","187928149","chr5","183947821","183948119","28","3980043"
"chr4","187933132","187933424","chr5","183953026","183953317","33","3980106"
"chr4","187941159","187941457","chr20","28618222","28618522","52","159322937"
"chr4","187943627","187943890","chr5","183957337","183957601","23","3986290"
"chr4","187950321","187950602","chr5","183964059","183964340","16","3986262"
"chr4","187955783","187955941","chr15","10103412","10103570","28","177852371"
"chr4","187958604","187958921","chr5","183972896","183973201","32","3985708"
"chr4","187965664","187965962","chr5","183979740","183980041","30","3985924"
"chr4","187983346","187983652","chr5","183997418","183997713","44","3985928"
"chr4","187991633","187991949","chr5","184005289","184005606","31","3986344"
"chr4","187996451","187996757","chr5","184009820","184010127","23","3986631"
"chr4","188019858","188020150","chr5","184034425","184034717","19","3985433"
"chr4","188036618","188036908","chr5","184052068","184052346","26","3984550"
"chr4","188056032","188056160","chr4","114936919","114937049","16","73119113"
"chr4","188064746","188065020","chr5","184078871","184079160","29","3985875"
"chr4","188086341","188086640","chr5","184101492","184101794","19","3984849"
"chr4","188100000","188100285","chr5","184115326","184115612","25","3984674"
"chr4","188103797","188104091","chr5","184118875","184119168","26","3984922"
"chr4","188121029","188121295","chr5","184137172","184137444","24","3983857"
"chr4","188126864","188127145","chr13","25090593","25090872","58","163036271"
"chr4","188134268","188134379","chr5","184147045","184147156","18","3987223"
"chr4","188143792","188144092","chr5","184157038","184157345","33","3986754"
"chr4","188150792","188151065","chr5","184162817","184163090","15","3987975"
"chr4","188161708","188162008","chr5","184180053","184180370","41","3981655"
"chr4","188173240","188173548","chr19","3500436","3500734","51","184672804"
"chr4","188195054","188195331","chr5","184212662","184212939","19","3982392"
"chr4","188202979","188203209","chr5","184220975","184221187","31","3982004"
"chr4","188203889","188203976","chr5","184221556","184221643","1","3982333"
"chr4","188206138","188206451","chr5","184224300","184224605","30","3981838"
"chr4","188209701","188210009","chr5","184232212","184232524","38","3977489"
"chr4","188212550","188212849","chr5","184235044","184235334","29","3977506"
"chr4","188215603","188215890","chr7","127125441","127125745","71","61090162"
"chr4","188226352","188226648","chr5","184249516","184249807","26","3976836"
"chr4","188239935","188240219","chr12","60801497","60801778","82","127438438"
"chr4","188284767","188285081","chr5","184311012","184311329","38","3973755"
"chr4","188287872","188288155","chrX","112592523","112592805","49","75695349"
"chr4","188316587","188316868","chr5","184343509","184343789","10","3973078"
"chr4","188327071","188327177","chr4","14099244","14099352","18","174227827"
"chr4","188366291","188366581","chr5","184395993","184396284","21","3970298"
"chr4","188410160","188410395","chr5","184439751","184439998","29","3970409"
"chr4","188457065","188457375","chr5","98386930","98387229","62","90070135"
"chr4","188475431","188475686","chr5","184509635","184509893","27","3965796"
"chr4","188484655","188484983","chr5","184519740","184520068","24","3964915"
"chr4","188486818","188487091","chr20","22445913","22446203","61","166040905"
"chr4","188489182","188489480","chr5","184524448","184524744","19","3964734"
"chr4","188542596","188542895","chr5","184574868","184575169","21","3967728"
"chr4","188614291","188614555","chr5","184641210","184641483","25","3973081"
"chr4","188692228","188692515","chr7","18998141","18998416","44","169694087"
"chr4","188707537","188707854","chr5","184776910","184777231","26","3930627"
"chr4","188744108","188744415","chr5","184814703","184815005","21","3929405"
"chr4","188780575","188780876","chr5","184850781","184851060","40","3929794"
"chr4","188821984","188822276","chr6","68750302","68750588","47","120071682"
"chr4","188828137","188828306","chr5","184897946","184898116","16","3930191"
"chr4","188828610","188828751","chr5","184898424","184898565","8","3930186"
"chr4","188846540","188846641","chr10","29571273","29571370","12","159275267"
"chr4","188860510","188860803","chr5","184930587","184930880","11","3929923"
"chr4","188871509","188871821","chr17","30630630","30630943","69","158240879"
"chr4","188874386","188874671","chr5","184944036","184944325","39","3930350"
"chr4","188894266","188894565","chr5","184960314","184960613","20","3933952"
"chr4","188923834","188924145","chr5","184990604","184990919","27","3933230"
"chr4","188945196","188945293","chr5","185012078","185012175","1","3933118"
"chr4","188962852","188963143","chr5","185028146","185028434","20","3934706"
"chr4","188969222","188969516","chr5","185033126","185033420","20","3936096"
"chr4","188981966","188982049","chr5","185046850","185046932","10","3935116"
"chr4","189006926","189007229","chr5","185069659","185069945","38","3937267"
"chr4","189026775","189027083","chr5","185087152","185087450","31","3939623"
"chr4","189027713","189027974","chr5","40762070","40762343","61","148265643"
"chr4","189036282","189036589","chr4","103518320","103518630","61","85517962"
"chr4","189079500","189079751","chr6","78756571","78756823","62","110322929"
"chr4","189094456","189094656","chr5","185152842","185153063","32","3941614"
"chr4","189101225","189101513","chr8","29021743","29022036","52","160079482"
"chr4","189140455","189140576","chr5","185196894","185197010","19","3943561"
"chr4","189141988","189142278","chr5","185198429","185198716","20","3943559"
"chr4","189144682","189144766","chr5","185201104","185201188","3","3943578"
"chr4","189148095","189148379","chr5","185204507","185204790","23","3943588"
"chr4","189189536","189189839","chr2","160551205","160551504","49","28638331"
"chr4","189190820","189191119","chr5","185252051","185252351","17","3938769"
"chr4","189227902","189228223","chr5","185289473","185289798","55","3938429"
"chr4","189256947","189257234","chr5","185321951","185322199","53","3934996"
"chr4","189264033","189264312","chr5","185329161","185329430","26","3934872"
"chr4","189302399","189302665","chr5","185363052","185363328","33","3939347"
"chr4","189330367","189330657","chr5","185397430","185397725","23","3932937"
"chr4","189364038","189364230","chr5","185428047","185428256","29","3935991"
"chr4","189372175","189372482","chr5","185434805","185435104","34","3937370"
"chr4","189386592","189386717","chr5","185453534","185453660","10","3933058"
"chr4","189394296","189394584","chr5","185461852","185462119","37","3932444"
"chr4","189398377","189398649","chr5","185464072","185464344","18","3934305"
"chr4","189399104","189399395","chr5","185464803","185465099","22","3934301"
"chr4","189418367","189418617","chr3","42360413","42360669","55","147057954"
"chr4","189421114","189421231","chr5","185484652","185484769","12","3936462"
"chr4","189451936","189452234","chr5","185507365","185507665","25","3944571"
"chr4","189490922","189491229","chr5","185549064","185549382","25","3941858"
"chr4","189500910","189501031","chr4","158520972","158521093","14","30979938"
"chr4","189538354","189538542","chr5","7150541","7150724","49","182387813"
"chr4","189575201","189575498","chr5","185637070","185637361","27","3938131"
"chr4","189581415","189581697","chr5","185645926","185646214","40","3935489"
"chr4","189600048","189600368","chr5","185665235","185665529","49","3934813"
"chr4","189606990","189607163","chr1","44389709","44389879","36","145217281"
"chr4","189607460","189607582","chr10","19345446","19345570","32","170262014"
"chr4","189612594","189612889","chr5","185678151","185678451","16","3934443"
"chr4","189675894","189675970","chr5","185737038","185737113","6","3938856"
"chr4","189676284","189676484","chr5","185737412","185737656","51","3938872"
"chr4","189691024","189691294","chr5","185752277","185752547","20","3938747"
"chr4","189728118","189728412","chr5","185788297","185788594","34","3939821"
"chr4","189762341","189762640","chr5","185823303","185823582","34","3939038"
"chr4","189765710","189766003","chr5","185829646","185829941","19","3936064"
"chr4","189784699","189784997","chr5","185849747","185850043","36","3934952"
"chr4","189808971","189809256","chr5","185875028","185875323","44","3933943"
"chr4","189809905","189810187","chr5","185875974","185876260","29","3933931"
"chr4","189811859","189812152","chr5","185877897","185878197","39","3933962"
"chr4","189833849","189834000","chr5","185899996","185900148","12","3933853"
"chr4","189869174","189869461","chr5","185927975","185928261","61","3941199"
"chr4","189871652","189871946","chr5","185931281","185931577","29","3940371"
"chr4","189900504","189900806","chr5","185959761","185960065","29","3940743"
"chr4","189906888","189907206","chr5","185966131","185966451","27","3940757"
"chr4","189972822","189973102","chr5","186024529","186024813","22","3948293"
"chr4","190007514","190007812","chr19","3353989","3354279","53","186653525"
"chr4","190008765","190009043","chr5","186059625","186059900","15","3949140"
"chr4","190067022","190067300","chr5","186123871","186124153","24","3943151"
"chr4","190090814","190091140","chr4","36484206","36484512","73","153606608"
"chr4","190224272","190224568","chr5","186341732","186342032","29","3882540"
"chr4","190284907","190285030","chr13","95288408","95288530","16","94996499"
"chr4","190302545","190302829","chr5","186423777","186424077","48","3878768"
"chr4","190339655","190339865","chr13","30070965","30071173","52","160268690"
"chr4","190355387","190355696","chr18","45361942","45362253","58","144993445"
"chr4","190367463","190367766","chr5","186488973","186489278","33","3878490"
"chr4","190448025","190448314","chr5","186564435","186564739","44","3883590"
"chr4","190452661","190452968","chr5","186576060","186576359","37","3876601"
"chr4","190468277","190468552","chr5","186593693","186593968","12","3874584"
"chr4","190471504","190471787","chr5","186597229","186597499","22","3874275"
"chr4","190485253","190485540","chr5","186610156","186610437","21","3875097"
"chr4","190511247","190511535","chr5","186630081","186630370","18","3881166"
"chr4","190517806","190518077","chr5","186636747","186637039","42","3881059"
"chr4","190524333","190524611","chr1","70364492","70364776","54","120159841"
"chr4","190534583","190534845","chr5","186659525","186659781","23","3875058"
"chr4","190633029","190633283","chr5","186759358","186759613","16","3873671"
"chr4","190651117","190651386","chr5","186777808","186778097","38","3873309"
"chr4","190658532","190658840","chr5","186786824","186787131","21","3871708"
"chr4","190662361","190662661","chr5","186792265","186792565","21","3870096"
"chr4","190713466","190713758","chr10","13692197","13692486","55","177021269"
"chr4","190747723","190747989","chr1","45089164","45089431","63","145658559"
"chr4","190789746","190790045","chr5","186929572","186929869","49","3860174"
"chr4","190813822","190814131","chr5","186943696","186944039","52","3870126"
"chr4","190821897","190822199","chr5","186952580","186952885","30","3869317"
"chr4","190829045","190829317","chr5","186959752","186960048","41","3869293"
"chr4","190834826","190834977","chr16","30767425","30767572","48","160067401"
"chr4","190845349","190845648","chr5","186976909","186977209","15","3868440"
"chr4","190854805","190855004","chr20","13999688","13999882","49","176855117"
"chr4","190856555","190856817","chr10","670095","670355","63","190186460"
"chr4","190858909","190859032","chr5","186995546","186995657","18","3863363"
"chr4","190890080","190890360","chr5","187023993","187024269","29","3866087"
"chr4","190934415","190934666","chr5","187066168","187066418","8","3868247"
"chr4","190938158","190938488","chr13","67067334","67067646","71","123870824"
"chr4","190954637","190954767","chr5","187086160","187086290","9","3868477"
"chr4","190963582","190963831","chr5","187095382","187095635","30","3868200"
"chr4","191056107","191056420","chr5","187188678","187188992","36","3867429"
"chr4","191071433","191071721","chr5","187203406","187203698","34","3868027"
"chr4","191113698","191113986","chr5","187247050","187247329","45","3866648"
"chr4","191160274","191160566","chr5","187292972","187293264","30","3867302"
"chr4","191212168","191212465","chr15","94040235","94040531","65","97171933"
"chr4","191252509","191252800","chr5","187390975","187391278","36","3861534"
"chr4","191422781","191423077","chr1","43756628","43756917","67","147666153"
"chr4","191433860","191434147","chr5","187565921","187566209","25","3867939"
"chr4","191550820","191551104","chr3","43444472","43444752","66","148106348"
"chr4","191559475","191559763","chr5","187698718","187699023","37","3860757"
"chr4","191577619","191577897","chr5","187717159","187717451","38","3860460"
"chr4","191608313","191608437","chr13","25546692","25546816","18","166061621"
"chr4","191634985","191635281","chr5","187774173","187774476","54","3860812"
"chr4","191697140","191697344","chr16","10119715","10119923","45","181577425"
"chr4","191956904","191957215","chr5","188105135","188105442","34","3851769"
"chr4","191957402","191957673","chr5","188105610","188105895","42","3851792"
"chr4","191968110","191968388","chr5","188115962","188116238","17","3852148"
"chr4","192138005","192138343","chr1","108931373","108931666","95","83206632"
"chr4","192197457","192197681","chr1","213911110","213911337","52","21713653"
"chr4","192211384","192211673","chr5","188337391","188337669","36","3873993"
"chr4","192232679","192232919","chr5","188365323","188365563","16","3867356"
"chr4","192284808","192285102","chr5","188412112","188412409","33","3872696"
"chr4","192292235","192292535","chrX","15902142","15902434","54","176390093"
"chr4","192304320","192304622","chr5","188428672","188428972","22","3875648"
"chr4","192312715","192313016","chr5","188437181","188437478","29","3875534"
"chr4","192323957","192324087","chr6","17252977","17253107","19","175070980"
"chr4","192350504","192350654","chr1","19455281","19455427","33","172895223"
"chr4","192350956","192351144","chr19","7887117","7887299","43","184463839"
"chr4","192359570","192359841","chr5","188485845","188486123","34","3873725"
"chr4","192362119","192362410","chr5","188488408","188488692","35","3873711"
"chr4","192365303","192365614","chr5","188494462","188494775","31","3870841"
"chr4","192380395","192380707","chr5","188531308","188531618","32","3849087"
"chr4","192410386","192410679","chr5","188558226","188558501","33","3852160"
"chr4","192423278","192423597","chr5","188570270","188570577","34","3853008"
"chr4","192430533","192430826","chr5","188581099","188581376","43","3849434"
"chr4","192461061","192461312","chr1","123538356","123538620","73","68922705"
"chr4","192473982","192474269","chr5","188627720","188628016","32","3846262"
"chr4","192474710","192475016","chr7","11236501","11236808","66","181238209"
"chr4","192477172","192477329","chr7","151036143","151036301","34","41441029"
"chr4","192502375","192502504","chr19","11198445","11198574","19","181303930"
"chr4","192502512","192502767","chr1","139819859","139820112","69","52682653"
"chr4","192563378","192563501","chr2","21094950","21095071","21","171468428"
"chr4","192591101","192591316","chr10","17041385","17041582","49","175549716"
"chr4","192613116","192613374","chr5","188779115","188779375","26","3834001"
"chr4","192801031","192801313","chr5","189011008","189011288","25","3790023"
"chr4","192890239","192890408","chr5","189079316","189079474","18","3810923"
"chr4","192913675","192913989","chr5","189101535","189101829","65","3812140"
"chr4","192995331","192995557","chrX","51567105","51567331","54","141428226"
"chr4","193024744","193024934","chr5","189196406","189196598","15","3828338"
"chr4","193053553","193053851","chr5","189227457","189227732","45","3826096"
"chr4","193182494","193182796","chr5","189352000","189352269","58","3830494"
"chr4","193229100","193229399","chr5","189406969","189407273","31","3822131"
"chr4","193257312","193257435","chr5","189430168","189430292","16","3827144"
"chr4","193305266","193305541","chr5","189478456","189478746","36","3826810"
"chr4","193417911","193418037","chr5","189604830","189604956","6","3813081"
"chr4","193432520","193432797","chr5","189624162","189624448","31","3808358"
"chr4","193577532","193577827","chr5","189764626","189764919","23","3812906"
"chr4","193586888","193587172","chr5","189773543","189773846","45","3813345"
"chr4","193588864","193589175","chr1","188530204","188530518","72","5058660"
"chr4","193688382","193688642","chr5","189867722","189867986","37","3820660"
"chr4","195026473","195026750","chr5","190237281","190237532","40","4789192"
"chr4","195045158","195045458","chr5","190258076","190258364","50","4787082"
"chr4","195064361","195064651","chr19","35320177","35320461","36","159744184"
"chr4","195066640","195066785","chrX","19212518","19212664","30","175854122"
"chr4","195070812","195071111","chr5","190360900","190361212","40","4709912"
"chr4","195111046","195111170","chr5","190372323","190372448","10","4738723"
"chr4","195118305","195118594","chr10","69345427","69345732","70","125772878"
"chr4","195147240","195147394","chr5","190406348","190406502","16","4740892"
"chr4","195148913","195149067","chr5","190406348","190406502","16","4742565"
"chr4","195183848","195184152","chr3","33546460","33546746","46","161637388"
"chr4","195229081","195229345","chr3","43551400","43551672","57","151677681"
"chr4","195229414","195229698","chr5","190360900","190361212","47","4868514"
"chr4","195231430","195231716","chr5","190362901","190363185","19","4868529"
"chr4","195240928","195241052","chr5","190372323","190372448","9","4868605"
"chr4","195248191","195248480","chr10","69345427","69345732","70","125902764"
"chr4","195285373","195285525","chr5","190406348","190406502","17","4879025"
"chr4","195304279","195304585","chr3","33546460","33546746","40","161757819"
"chr4","195308321","195308616","chr16","4601017","4601301","51","190707304"
"chr4","195314211","195314477","chr6","168234974","168235236","63","27079237"
"chr4","195415344","195415601","chr15","44662594","44662852","36","150752750"
"chr4","195425429","195425746","chr4","28668899","28669209","79","166756530"
"chr4","195447373","195447729","chr2","50942501","50942809","112","144504872"
"chr4","195720164","195720412","chr16","21456395","21456661","59","174263769"
"chr4","195760944","195761047","chr3","33528457","33528560","11","162232487"
"chr5","82837343","82837610","chr1","140407048","140407323","63","57569705"
"chr5","182452107","182452227","chr6","178635084","178635205","7","3817023"
"chr5","19791632","19791941","chr6","92686049","92686359","23","72894417"
"chr5","28442560","28442840","chr6","83974940","83975226","32","55532380"
"chr5","40632162","40632398","chr6","71968364","71968600","13","31336202"
"chr5","46530496","46530629","chrX","112619741","112619873","19","66089245"
"chr5","59637631","59637878","chr1","30942392","30942638","54","28695239"
"chr5","73268980","73269261","chr6","42750727","42751013","24","30518253"
"chr5","79036393","79036641","chr3","36424130","36424381","56","42612263"
"chr5","82050961","82051156","chr6","34354088","34354278","23","47696873"
"chr5","136052736","136053009","chr6","132207984","132208241","34","3844752"
"chr5","143523633","143524001","chr6","165958816","165959138","112","22435183"
"chr5","146669405","146669718","chr6","143127024","143127327","28","3542381"
"chr5","165150409","165150725","chr6","161298113","161298429","21","3852296"
"chr5","166854360","166854672","chr16","71054388","71054696","61","95799972"
"chr5","168558332","168558622","chr6","164655965","164656254","23","3902367"
"chr5","179175215","179175516","chr6","175317144","175317456","35","3858071"
"chr5","180486081","180486210","chr19","33727543","33727676","25","146758538"
"chr5","291836","292128","chr6","121357","121654","21","170479"
"chr5","294765","295072","chr6","124297","124582","37","170468"
"chr5","362783","363077","chr2","160551205","160551504","50","160188422"
"chr5","373014","373304","chr6","210890","211185","27","162124"
"chr5","389569","389857","chr6","225089","225382","28","164480"
"chr5","404976","405069","chr6","233270","233363","5","171706"
"chr5","461522","461827","chr6","301104","301411","23","160418"
"chr5","465414","465531","chr6","305258","305375","4","160156"
"chr5","515832","516141","chr6","354219","354495","50","161613"
"chr5","540303","540619","chr6","379631","379947","23","160672"
"chr5","684316","684625","chr6","527465","527770","18","156851"
"chr5","747935","748236","chr6","596029","596320","30","151906"
"chr5","759861","760033","chr5","78293544","78293709","50","77533683"
"chr5","968150","968456","chr1","128735197","128735508","64","127767047"
"chr5","1187799","1188051","chr5","151427418","151427685","68","150239619"
"chr5","1298023","1298336","chr6","1153432","1153740","36","144591"
"chr5","1330588","1330894","chr10","81646451","81646762","63","80315863"
"chr5","1348508","1348786","chr6","1200962","1201261","38","147546"
"chr5","1350315","1350623","chr6","1202772","1203089","30","147543"
"chr5","1395077","1395347","chr19","28888910","28889196","60","27493833"
"chr5","1487094","1487408","chr3","85132730","85133034","67","83645636"
"chr5","1909140","1909385","chr7","106941402","106941653","57","105032262"
"chr5","2019187","2019495","chr6","1783002","1783309","20","236185"
"chr5","2167422","2167709","chr6","1914463","1914750","20","252959"
"chr5","2694391","2694564","chr6","2502004","2502174","20","192387"
"chr5","2757879","2758172","chr6","2561696","2561991","19","196183"
"chr5","2831605","2831873","chr6","2634388","2634660","30","197217"
"chr5","3155455","3155748","chr6","2963701","2964002","30","191754"
"chr5","3157913","3158209","chr6","2966509","2966818","35","191404"
"chr5","3161756","3161978","chr9","42393657","42393879","57","39231901"
"chr5","3164170","3164293","chr6","2973304","2973429","14","190866"
"chr5","3170532","3170818","chr6","2981451","2981763","42","189081"
"chr5","3175774","3175929","chr19","5693782","5693937","33","2518008"
"chr5","3182803","3182934","chr3","76563748","76563878","19","73380945"
"chr5","3439614","3439899","chr6","3294448","3294720","31","145166"
"chr5","3463714","3464031","chr6","3311533","3311832","38","152181"
"chr5","3591518","3591628","chr20","42862414","42862525","17","39270896"
"chr5","3658327","3658640","chr6","3512599","3512902","30","145728"
"chr5","3791803","3792099","chr6","3635033","3635327","38","156770"
"chr5","3890033","3890292","chr2","6069539","6069802","68","2179506"
"chr5","4074241","4074364","chr6","3917834","3917959","12","156407"
"chr5","4105448","4105743","chr2","159299113","159299409","73","155193665"
"chr5","4130765","4130889","chr1","140571870","140571990","22","136441105"
"chr5","4135313","4135621","chr6","3977147","3977451","31","158166"
"chr5","4294702","4294961","chr6","4141774","4142035","20","152928"
"chr5","4431912","4432201","chr6","4281952","4282242","24","149960"
"chr5","4878156","4878425","chr5","140153210","140153489","62","135275054"
"chr5","4912950","4913171","chr6","4760948","4761152","33","152002"
"chr5","4990406","4990677","chr6","4840707","4840977","17","149699"
"chr5","5203698","5203994","chr6","5053675","5053968","28","150023"
"chr5","5409000","5409311","chr6","5265847","5266143","54","143153"
"chr5","5414420","5414732","chr19","15562519","15562818","65","10148099"
"chr5","5543749","5544059","chr6","5400563","5400873","30","143186"
"chr5","5695185","5695479","chr6","5553182","5553476","25","142003"
"chr5","5714017","5714099","chr6","5573531","5573614","4","140486"
"chr5","5733678","5733980","chr8","139927709","139928008","61","134194031"
"chr5","5766546","5766783","chr6","5625440","5625688","31","141106"
"chr5","5833233","5833554","chr6","5693962","5694273","34","139271"
"chr5","5912695","5912962","chr6","5779599","5779904","60","133096"
"chr5","5921685","5921992","chr6","5788635","5788917","45","133050"
"chr5","6006138","6006412","chr16","56479316","56479590","58","50473178"
"chr5","6183359","6183650","chr6","6041160","6041461","34","142199"
"chr5","6330515","6330833","chr6","6168738","6169050","57","161777"
"chr5","6366937","6367245","chr6","6209008","6209301","30","157929"
"chr5","6454035","6454320","chr6","6301868","6302166","31","152167"
"chr5","6489272","6489565","chr6","6337956","6338254","27","151316"
"chr5","6646095","6646383","chr2","84913076","84913368","64","78266981"
"chr5","6693363","6693666","chr6","6556122","6556429","23","137241"
"chr5","6760360","6760650","chr6","6623206","6623494","31","137154"
"chr5","6777146","6777231","chr6","6630668","6630754","4","146478"
"chr5","6778199","6778518","chr6","6631741","6632036","45","146458"
"chr5","6962866","6963164","chr6","6837545","6837860","39","125321"
"chr5","7153734","7153946","chr3","116444016","116444218","48","109290282"
"chr5","7181686","7182006","chr1","35356266","35356568","70","28174580"
"chr5","7245490","7245605","chr6","7103281","7103392","9","142209"
"chr5","7457851","7458135","chr19","16469674","16469960","61","9011823"
"chr5","7459956","7460250","chr6","7136365","7136644","46","323591"
"chr5","7525276","7525405","chr6","7217924","7218053","7","307352"
"chr5","7592136","7592192","chr5","73307081","73307136","9","65714945"
"chr5","7716607","7716922","chr6","7401356","7401673","33","315251"
"chr5","7725417","7725543","chr6","7411062","7411186","10","314355"
"chr5","7978115","7978412","chr4","149135439","149135743","53","141157324"
"chr5","8131559","8131656","chr3","40165859","40165963","26","32034300"
"chr5","8131693","8131870","chr17","3981656","3981840","47","4150037"
"chr5","8151319","8151626","chr6","7887809","7888104","25","263510"
"chr5","8167201","8167320","chr6","7903893","7904012","6","263308"
"chr5","8178150","8178285","chr6","7914791","7914921","24","263359"
"chr5","8178593","8178770","chr6","7915218","7915382","26","263375"
"chr5","8244340","8244646","chr6","8048626","8048927","28","195714"
"chr5","8254174","8254488","chr20","28651476","28651780","71","20397302"
"chr5","8319149","8319456","chr3","37013479","37013784","76","28694330"
"chr5","8352669","8352941","chr9","123745173","123745449","66","115392504"
"chr5","8366231","8366533","chr6","8134667","8134976","25","231564"
"chr5","8475784","8476074","chr6","8278396","8278677","44","197388"
"chr5","8601299","8601432","chr6","8451105","8451223","24","150194"
"chr5","8680921","8681192","chr6","8561141","8561423","38","119780"
"chr5","8821482","8821760","chr6","8733695","8733976","50","87787"
"chr5","8879878","8880117","chr7","49378464","49378703","61","40498586"
"chr5","8896896","8897205","chr6","8800718","8801032","35","96178"
"chr5","9029739","9030052","chr20","33801140","33801443","66","24771401"
"chr5","9265591","9265837","chr6","9145069","9145314","16","120522"
"chr5","9281713","9281838","chr3","40637514","40637640","24","31355801"
"chr5","9316623","9316918","chr6","9196924","9197208","30","119699"
"chr5","9326564","9326861","chr6","9203695","9203992","29","122869"
"chr5","9509138","9509444","chr6","9382353","9382650","29","126785"
"chr5","9707785","9707945","chr6","9615775","9615934","10","92010"
"chr5","9720406","9720723","chr6","9625931","9626241","28","94475"
"chr5","9738709","9738984","chr6","9643866","9644144","20","94843"
"chr5","9757648","9757935","chr11","49013409","49013695","63","39255761"
"chr5","9803825","9803927","chr6","9716017","9716125","12","87808"
"chr5","9844365","9844480","chr6","116160077","116160192","18","106315712"
"chr5","10028430","10028725","chr6","9898299","9898579","40","130131"
"chr5","10086033","10086315","chr6","9966212","9966499","23","119821"
"chr5","10192872","10193174","chr6","10060575","10060880","24","132297"
"chr5","10224736","10225049","chr6","10090827","10091123","42","133909"
"chr5","10299768","10299881","chr3","49801213","49801326","22","39501445"
"chr5","10313548","10313670","chr6","10177970","10178089","7","135578"
"chr5","10326143","10326456","chr16","23949857","23950175","69","13623714"
"chr5","10359405","10359705","chr20","17218841","17219141","52","6859436"
"chr5","10380096","10380332","chr6","10251632","10251870","24","128464"
"chr5","10418887","10419186","chr6","10294155","10294463","31","124732"
"chr5","10421604","10421863","chr2","104672036","104672284","54","94250432"
"chr5","10427648","10427771","chr7","51796125","51796255","25","41368477"
"chr5","10430658","10430923","chr6","10305748","10305998","36","124910"
"chr5","10454988","10455280","chr6","10330816","10331108","24","124172"
"chr5","10465937","10466237","chr6","10341705","10342000","43","124232"
"chr5","10468020","10468306","chr7","63125628","63125903","60","52657608"
"chr5","10474265","10474532","chr6","10354675","10354974","55","119590"
"chr5","10478401","10478500","chr6","10357062","10357158","9","121339"
"chr5","10486524","10486786","chr6","10366108","10366370","21","120416"
"chr5","10515586","10515872","chr11","48401419","48401716","53","37885833"
"chr5","10543535","10543689","chr6","10421248","10421395","16","122287"
"chr5","10552678","10552795","chr6","10427621","10427731","11","125057"
"chr5","10581827","10581949","chr6","10456752","10456873","4","125075"
"chr5","10585409","10585700","chr6","10460804","10461096","27","124605"
"chr5","10590294","10590573","chr2","84168215","84168483","72","73577921"
"chr5","10600662","10600911","chr6","10476344","10476599","21","124318"
"chr5","10619985","10620300","chr6","10494670","10494982","17","125315"
"chr5","10625014","10625315","chr6","10501273","10501563","35","123741"
"chr5","10639875","10640172","chr6","10516278","10516577","23","123597"
"chr5","10670934","10671260","chr20","20742237","20742544","66","10071303"
"chr5","10710111","10710394","chr6","10579968","10580260","34","130143"
"chr5","10716871","10717134","chr6","10591441","10591675","51","125430"
"chr5","10725116","10725428","chr6","10599295","10599606","28","125821"
"chr5","10739827","10740135","chr6","10614451","10614747","21","125376"
"chr5","10744079","10744397","chr6","10619064","10619377","27","125015"
"chr5","10783506","10783620","chr15","104360931","104361048","16","93577425"
"chr5","10805242","10805542","chr6","10680104","10680407","22","125138"
"chr5","10816593","10816828","chr6","10691895","10692123","31","124698"
"chr5","10851130","10851425","chr6","10724986","10725269","44","126144"
"chr5","10907908","10908199","chr6","10777569","10777859","30","130339"
"chr5","11000002","11000160","chr14","56966155","56966316","39","45966153"
"chr5","11073991","11074083","chr6","10965458","10965551","6","108533"
"chr5","11074446","11074652","chr6","10965835","10966047","24","108611"
"chr5","11334402","11334696","chr15","68356982","68357276","55","57022580"
"chr5","11464006","11464295","chr6","11349968","11350271","31","114038"
"chr5","11490399","11490708","chr6","11374191","11374488","34","116208"
"chr5","11510402","11510695","chr6","11394129","11394401","35","116273"
"chr5","11583946","11584242","chr6","11467316","11467603","26","116630"
"chr5","11608096","11608296","chr12","123982421","123982602","61","112374325"
"chr5","11608356","11608526","chr1","27684255","27684415","42","16075899"
"chr5","11617153","11617318","chr19","16079871","16080029","33","4462718"
"chr5","11617362","11617482","chr7","131134719","131134841","19","119517357"
"chr5","11625805","11626010","chr6","11511132","11511336","14","114673"
"chr5","11634743","11634971","chr6","11520597","11520835","22","114146"
"chr5","11646102","11646381","chr6","11531996","11532270","18","114106"
"chr5","11678730","11679018","chr6","11565207","11565500","25","113523"
"chr5","11682757","11682988","chr6","11569266","11569498","19","113491"
"chr5","11684635","11684898","chr6","11571148","11571384","41","113487"
"chr5","11704862","11705175","chr6","11590835","11591155","28","114027"
"chr5","11815180","11815466","chr6","11701898","11702203","41","113282"
"chr5","11861000","11861270","chr6","11748162","11748432","12","112838"
"chr5","11982390","11982514","chr6","11869567","11869691","7","112823"
"chr5","12034671","12034957","chr6","11920208","11920494","16","114463"
"chr5","12213147","12213441","chr7","64902516","64902798","64","52689369"
"chr5","12226885","12227168","chr6","12117191","12117471","34","109694"
"chr5","12328921","12329072","chr11","105301908","105302057","33","92972987"
"chr5","12371753","12371835","chr2","111767213","111767301","17","99395460"
"chr5","12391620","12391909","chr8","129433118","129433406","65","117041498"
"chr5","12470108","12470326","chr6","12340068","12340296","23","130040"
"chr5","12481155","12481471","chr6","12351113","12351440","46","130042"
"chr5","12508344","12508601","chr6","12376426","12376703","46","131918"
"chr5","12706416","12706713","chr4","149426544","149426840","65","136720128"
"chr5","12743136","12743438","chr6","12640087","12640400","26","103049"
"chr5","12743672","12743847","chr6","12640635","12640811","12","103037"
"chr5","12836425","12836708","chr6","12762023","12762304","26","74402"
"chr5","12889873","12890149","chr6","12841356","12841601","48","48517"
"chr5","13030724","13030946","chr7","39396713","39396942","49","26365989"
"chr5","13085745","13085840","chr6","13207796","13207891","10","122051"
"chr5","13193988","13194276","chr7","44087877","44088171","55","30893889"
"chr5","13234198","13234545","chr6","13423582","13423907","46","189384"
"chr5","13338484","13338723","chr6","13569337","13569574","49","230853"
"chr5","13414033","13414128","chr6","13635170","13635265","4","221137"
"chr5","13414396","13414627","chr6","13635534","13635767","20","221138"
"chr5","13444200","13444417","chr6","13662793","13663015","31","218593"
"chr5","13669329","13669452","chr6","13893066","13893190","8","223737"
"chr5","13740526","13740813","chr2","54599109","54599391","61","40858583"
"chr5","13749360","13749630","chr6","13970609","13970913","59","221249"
"chr5","13770516","13770775","chr6","13988725","13988986","21","218209"
"chr5","13817799","13818085","chrX","19470110","19470392","73","5652311"
"chr5","13863371","13863657","chr6","14081079","14081362","21","217708"
"chr5","13964443","13964743","chr6","14182675","14182970","29","218232"
"chr5","14016712","14016835","chr5","112526981","112527104","19","98510269"
"chr5","14089961","14090253","chr6","14345344","14345649","33","255383"
"chr5","14100074","14100383","chr6","14357434","14357740","25","257360"
"chr5","14111742","14111966","chr6","14369938","14370161","21","258196"
"chr5","14123855","14124002","chr12","21235373","21235528","33","7111518"
"chr5","14192343","14192639","chr6","14446504","14446780","47","254161"
"chr5","14212032","14212282","chr6","14466931","14467173","35","254899"
"chr5","14222740","14223038","chr6","14474659","14474957","34","251919"
"chr5","14225924","14226196","chr6","14477663","14477935","11","251739"
"chr5","14234547","14234864","chr6","14486283","14486574","46","251736"
"chr5","14239386","14239677","chr6","14491125","14491422","28","251739"
"chr5","14249200","14249471","chr6","14501184","14501457","27","251984"
"chr5","14281675","14281994","chr6","14532594","14532917","36","250919"
"chr5","14306292","14306607","chrX","19558762","19559074","60","5252470"
"chr5","14309483","14309764","chr6","14560486","14560767","23","251003"
"chr5","14327977","14328244","chr6","14578137","14578408","24","250160"
"chr5","14338746","14338984","chr6","14589295","14589539","23","250549"
"chr5","14339678","14339965","chr5","165618061","165618315","68","151278383"
"chr5","14380714","14380831","chr6","14632594","14632714","11","251880"
"chr5","14380835","14381170","chr6","14632749","14633049","54","251914"
"chr5","14389662","14389864","chr6","14641884","14642086","13","252222"
"chr5","14436034","14436151","chr6","14688821","14688938","6","252787"
"chr5","14436613","14436765","chr9","88102134","88102290","42","73665521"
"chr5","14441192","14441417","chr10","25232545","25232767","42","10791353"
"chr5","14530306","14530444","chr1","214707438","214707571","36","200177132"
"chr5","14620817","14621132","chr6","14871728","14872042","31","250911"
"chr5","14624845","14625154","chr6","14876377","14876687","36","251532"
"chr5","14719684","14719814","chr16","19898484","19898618","28","5178800"
"chr5","14722050","14722399","chr6","14971515","14971873","31","249465"
"chr5","14750311","14750580","chr7","132165443","132165714","60","117415132"
"chr5","14794701","14795005","chr6","15044013","15044309","25","249312"
"chr5","14795505","14795707","chr3","124118064","124118255","53","109322559"
"chr5","14798382","14798628","chr6","15045794","15046042","20","247412"
"chr5","14812064","14812361","chr7","138266796","138267091","59","123454732"
"chr5","14814175","14814465","chr6","15073017","15073299","26","258842"
"chr5","14815300","14815528","chr6","15074791","15075016","14","259491"
"chr5","14819160","14819456","chr6","15078628","15078906","35","259468"
"chr5","14868125","14868407","chr6","15129377","15129674","44","261252"
"chr5","14911012","14911321","chr19","18064212","18064515","56","3153200"
"chr5","14945314","14945625","chr6","15202314","15202616","33","257000"
"chr5","14958089","14958381","chr2","85033177","85033472","53","70075088"
"chr5","14998342","14998652","chr3","49937718","49938031","75","34939376"
"chr5","15004701","15004748","chr13","11102037","11102082","7","3902664"
"chr5","15067162","15067473","chr6","15325626","15325932","19","258464"
"chr5","15074453","15074738","chr6","9643866","9644144","64","5430587"
"chr5","15097642","15097921","chr5","138937198","138937473","59","123839556"
"chr5","15113430","15113772","chr13","65734242","65734569","72","50620812"
"chr5","15137894","15138201","chr19","14607936","14608247","55","529958"
"chr5","15225353","15225653","chr6","15536417","15536710","33","311064"
"chr5","15250160","15250465","chr6","15559544","15559833","29","309384"
"chr5","15367769","15368032","chr6","15677742","15678009","35","309973"
"chr5","15634474","15634753","chr6","15982389","15982669","23","347915"
"chr5","15745870","15746163","chr6","16091427","16091717","24","345557"
"chr5","15754781","15755087","chr6","16099350","16099669","36","344569"
"chr5","15772023","15772315","chr6","16115896","16116184","54","343873"
"chr5","15891484","15891714","chr1","19688905","19689125","67","3797421"
"chr5","15915908","15916195","chr6","16265398","16265680","27","349490"
"chr5","15946757","15947055","chr6","16295568","16295869","30","348811"
"chr5","16065307","16065617","chr6","16415537","16415835","28","350230"
"chr5","16399187","16399473","chr1","53106748","53107031","63","36707561"
"chr5","16485998","16486313","chr6","16832187","16832476","46","346189"
"chr5","16589334","16589648","chr7","84841819","84842127","61","68252485"
"chr5","16685330","16685622","chr6","17034002","17034310","30","348672"
"chr5","16707193","16707504","chr6","17055189","17055493","29","347996"
"chr5","16738334","16738659","chr6","17087027","17087354","31","348693"
"chr5","16740539","16740828","chr16","52172870","52173148","72","35432331"
"chr5","16802065","16802365","chr6","17144620","17144921","26","342555"
"chr5","16820757","16820981","chr7","32150859","32151088","49","15330102"
"chr5","16825138","16825419","chr6","17166506","17166776","28","341368"
"chr5","16837915","16838193","chr6","17179397","17179687","28","341482"
"chr5","16884941","16885262","chr5","80760617","80760930","63","63875676"
"chr5","16895863","16896163","chr6","17238516","17238814","43","342653"
"chr5","16901378","16901685","chr6","17244812","17245105","29","343434"
"chr5","16909453","16909582","chr6","17252977","17253107","10","343524"
"chr5","16912973","16913177","chr6","17257113","17257302","36","344140"
"chr5","16942796","16942991","chr17","7587158","7587367","47","9355638"
"chr5","16947924","16948236","chr6","17292509","17292821","20","344585"
"chr5","16950248","16950525","chr6","17295133","17295423","43","344885"
"chr5","16981808","16982076","chr6","17327084","17327329","50","345276"
"chr5","16984545","16984826","chr6","17329779","17330053","27","345234"
"chr5","16998584","16998854","chr6","17344614","17344912","43","346030"
"chr5","17062496","17062800","chr6","17409966","17410273","26","347470"
"chr5","17091096","17091364","chr6","17436618","17436897","49","345522"
"chr5","17093533","17093813","chr6","17439681","17439980","32","346148"
"chr5","17100282","17100382","chr6","17447534","17447639","7","347252"
"chr5","17101642","17101922","chr6","17448901","17449190","26","347259"
"chr5","17108766","17109045","chr6","17456576","17456857","17","347810"
"chr5","17111328","17111599","chr6","17459729","17460004","28","348401"
"chr5","17133316","17133516","chr8","144166719","144166924","39","127033403"
"chr5","17185178","17185311","chr19","12212993","12213123","20","4972185"
"chr5","17185622","17185724","chr6","124030144","124030244","20","106844522"
"chr5","17189911","17190107","chr6","4944357","4944557","51","12245554"
"chr5","17193560","17193861","chr3","44658285","44658586","61","27464725"
"chr5","17208736","17209037","chr6","17557173","17557466","24","348437"
"chr5","17215353","17215671","chr6","17563395","17563704","33","348042"
"chr5","17228333","17228622","chr9","11771085","11771376","56","5457248"
"chr5","17237904","17238201","chr6","17585223","17585520","24","347319"
"chr5","17261956","17262237","chr6","17609699","17609979","13","347743"
"chr5","17263191","17263464","chr19","2507487","2507757","55","14755704"
"chr5","17266738","17267033","chr6","17614782","17615078","23","348044"
"chr5","17268508","17268820","chr6","17617801","17618106","27","349293"
"chr5","17281251","17281526","chr14","109750820","109751109","57","92469569"
"chr5","17284316","17284590","chr6","17635301","17635575","23","350985"
"chr5","17306191","17306480","chrX","113149918","113150210","67","95843727"
"chr5","17477340","17477615","chr6","17828368","17828645","27","351028"
"chr5","17503946","17504248","chr6","17853571","17853873","17","349625"
"chr5","17505814","17506105","chr6","17855441","17855740","44","349627"
"chr5","18013296","18013600","chr6","18094934","18095252","44","81638"
"chr5","18037088","18037387","chr6","18112242","18112543","21","75154"
"chr5","18084123","18084415","chr6","18154900","18155193","20","70777"
"chr5","18127179","18127468","chr6","18192290","18192580","30","65111"
"chr5","18151890","18152187","chr6","18214416","18214715","65","62526"
"chr5","18299723","18299941","chr15","13117864","13118086","54","5181859"
"chr5","18424811","18425096","chr7","140100928","140101221","68","121676117"
"chr5","18546190","18546355","chr6","18649002","18649167","20","102812"
"chr5","18556936","18557234","chr6","18659805","18660099","34","102869"
"chr5","18581565","18581860","chr6","18684746","18685039","21","103181"
"chr5","18616466","18616679","chr6","18725049","18725273","28","108583"
"chr5","18648202","18648503","chr6","18755074","18755381","33","106872"
"chr5","18690209","18690512","chr6","18796451","18796752","33","106242"
"chr5","18784589","18784872","chr9","97703670","97703951","62","78919081"
"chr5","18790443","18790744","chr6","18894385","18894687","44","103942"
"chr5","18802223","18802511","chr6","18916111","18916436","54","113888"
"chr5","18805940","18806013","chr3","29922154","29922221","23","11116214"
"chr5","18841125","18841280","chr6","93531577","93531744","25","74690452"
"chr5","18841314","18841432","chr6","93531421","93531538","10","74690107"
"chr5","18907118","18907234","chr6","93474233","93474349","8","74567115"
"chr5","19050338","19050481","chr13","38978600","38978741","38","19928262"
"chr5","19123064","19123274","chr6","93334244","93334454","17","74211180"
"chr5","19227539","19227866","chr6","93233366","93233707","73","74005827"
"chr5","19253775","19253899","chr14","111633956","111634082","22","92380181"
"chr5","19255455","19255641","chr13","71348575","71348760","41","52093120"
"chr5","19278857","19279158","chr6","93184879","93185194","41","73906022"
"chr5","19282388","19282692","chr6","93181365","93181667","20","73898977"
"chr5","19283070","19283361","chr6","93180684","93180985","24","73897614"
"chr5","19394195","19394315","chr6","93081408","93081529","3","73687213"
"chr5","19400403","19400665","chrX","67277926","67278182","67","47877523"
"chr5","19425972","19426094","chr6","93049415","93049540","6","73623443"
"chr5","19426165","19426465","chr6","93049070","93049321","62","73622905"
"chr5","19468695","19468969","chr7","19429103","19429369","71","39592"
"chr5","19492286","19492580","chr6","92984738","92985037","20","73492452"
"chr5","19495896","19496166","chr6","92981153","92981428","18","73485257"
"chr5","19510185","19510498","chr6","92966370","92966673","33","73456185"
"chr5","19523297","19523574","chr6","92953437","92953722","25","73430140"
"chr5","19556778","19557058","chr6","92920437","92920716","15","73363659"
"chr5","19674300","19674574","chr6","92800187","92800480","39","73125887"
"chr5","19755033","19755312","chr1","26048278","26048559","58","6293245"
"chr5","19797675","19797954","chr6","92679947","92680226","19","72882272"
"chr5","19800390","19800677","chr6","92676925","92677211","18","72876535"
"chr5","19806011","19806303","chr6","92673818","92674105","28","72867807"
"chr5","19842772","19843057","chr6","92636757","92637030","27","72793985"
"chr5","19882334","19882622","chr6","92602063","92602352","30","72719729"
"chr5","19888382","19888692","chr6","92595948","92596261","25","72707566"
"chr5","20015794","20016097","chr6","92474039","92474337","27","72458245"
"chr5","20197608","20197914","chr6","92300379","92300682","26","72102771"
"chr5","20323075","20323381","chr1","14298700","14299005","72","6024375"
"chr5","20412411","20412636","chr6","92101231","92101445","29","71688820"
"chr5","20497876","20497998","chr6","92003921","92004041","13","71506045"
"chr5","20500001","20500213","chr13","30070965","30071173","50","9570964"
"chr5","20539758","20540041","chr6","91960883","91961175","30","71421125"
"chr5","20600106","20600455","chr6","91898847","91899200","55","71298741"
"chr5","20676644","20676950","chr6","91821614","91821891","45","71144970"
"chr5","20708360","20708644","chr14","121643575","121643857","46","100935215"
"chr5","20722486","20722840","chr9","110786043","110786351","104","90063557"
"chr5","20777954","20778172","chr6","91721548","91721772","27","70943594"
"chr5","20778771","20778981","chr6","91720739","91720945","21","70941968"
"chr5","20783075","20783352","chr6","91714642","91714915","23","70931567"
"chr5","20788976","20789263","chr6","91708811","91709107","36","70919835"
"chr5","20825781","20826084","chr6","91672827","91673131","17","70847046"
"chr5","20833826","20834129","chr18","52579006","52579304","58","31745180"
"chr5","20839722","20840036","chr6","91658927","91659224","31","70819205"
"chr5","20848898","20849095","chr6","91649670","91649867","18","70800772"
"chr5","20866976","20867248","chr6","91631970","91632239","42","70764994"
"chr5","20881153","20881405","chr6","91618152","91618411","22","70736999"
"chr5","20901213","20901518","chr6","91598278","91598573","27","70697065"
"chr5","20947690","20947806","chr6","91553727","91553843","8","70606037"
"chr5","20947838","20948066","chr10","71004722","71004936","63","50056884"
"chr5","21078629","21078927","chr6","91419203","91419501","20","70340574"
"chr5","21080014","21080130","chr1","39347501","39347617","19","18267487"
"chr5","21080170","21080275","chrX","89867784","89867880","28","68787614"
"chr5","21087016","21087308","chr6","91409095","91409390","12","70322079"
"chr5","21142316","21142590","chr6","91351758","91352030","27","70209442"
"chr5","21146585","21146712","chr6","91342507","91342638","11","70195922"
"chr5","21206679","21206983","chr6","91281192","91281473","48","70074513"
"chr5","21219416","21219636","chr6","91268208","91268425","16","70048792"
"chr5","21245475","21245765","chr6","91239465","91239787","41","69993990"
"chr5","21262144","21262402","chr6","91222820","91223080","13","69960676"
"chr5","21343889","21344173","chr8","19223807","19224090","68","2120082"
"chr5","21353931","21354054","chr4","18342650","18342774","21","3011281"
"chr5","21384541","21384893","chr4","111672740","111673074","84","90288199"
"chr5","21413589","21413814","chr7","63452167","63452395","60","42038578"
"chr5","21455681","21455968","chr6","91001829","91002121","25","69546148"
"chr5","21532330","21532636","chr20","10719806","10720100","69","10812524"
"chr5","21561040","21561313","chr3","124267629","124267922","67","102706589"
"chr5","21581832","21582109","chr9","28463586","28463868","63","6881754"
"chr5","21587726","21588020","chr6","90877788","90878081","32","69290062"
"chr5","21637199","21637498","chr6","90822900","90823197","27","69185701"
"chr5","21641976","21642265","chr6","90818461","90818738","36","69176485"
"chr5","21658682","21658988","chr6","90804916","90805218","32","69146234"
"chr5","21689695","21690001","chr19","33697202","33697506","55","12007507"
"chr5","21694125","21694427","chr6","90771211","90771515","25","69077086"
"chr5","21730713","21731009","chr6","90732315","90732621","36","69001602"
"chr5","21735903","21736159","chr11","100989317","100989570","53","79253414"
"chr5","21753928","21754222","chr6","90716383","90716653","53","68962455"
"chr5","21800474","21800737","chr6","90670550","90670812","15","68870076"
"chr5","21837265","21837534","chr6","90633527","90633796","17","68796262"
"chr5","21840652","21840950","chr6","90630144","90630445","22","68789492"
"chr5","21853253","21853545","chr10","22499535","22499827","53","646282"
"chr5","21862191","21862405","chr6","90600503","90600708","20","68738312"
"chr5","22006170","22006304","chr6","90454724","90454863","12","68448554"
"chr5","22049605","22049925","chr9","21207777","21208088","70","841828"
"chr5","22124877","22125166","chr7","138266796","138267091","60","116141919"
"chr5","22228456","22228762","chr6","90219389","90219692","34","67990933"
"chr5","22590981","22591063","chr6","89873561","89873644","3","67282580"
"chr5","22639725","22640018","chr6","89827469","89827761","24","67187744"
"chr5","22824430","22824601","chr6","89640938","89641109","14","66816508"
"chr5","22849216","22849463","chr6","89615364","89615620","31","66766148"
"chr5","22979787","22979992","chr1","58348505","58348709","54","35368718"
"chr5","23034428","23034685","chr6","89429865","89430121","19","66395437"
"chr5","23087823","23088114","chr6","89378128","89378420","21","66290305"
"chr5","23373425","23373684","chr6","89115674","89115945","27","65742249"
"chr5","23402370","23402657","chr6","89087827","89088108","21","65685457"
"chr5","23437065","23437372","chr6","89063552","89063870","39","65626487"
"chr5","23696072","23696351","chr6","88792697","88792985","25","65096625"
"chr5","23697193","23697452","chr9","24251773","24252042","55","554580"
"chr5","23797254","23797537","chr6","88688042","88688327","20","64890788"
"chr5","23852080","23852368","chr6","88561222","88561510","17","64709142"
"chr5","23903647","23903946","chr6","88509824","88510124","19","64606177"
"chr5","23918548","23918832","chr6","88494689","88494992","39","64576141"
"chr5","23965218","23965449","chr6","88447715","88447952","32","64482497"
"chr5","24015794","24016061","chr10","31897186","31897473","72","7881392"
"chr5","24017647","24017938","chr6","88395993","88396271","32","64378346"
"chr5","24041511","24041628","chr6","88369840","88369952","10","64328329"
"chr5","24071397","24071520","chr6","88339598","88339721","6","64268201"
"chr5","24086081","24086385","chr6","88325373","88325690","36","64239292"
"chr5","24094323","24094621","chr6","88317262","88317561","20","64222939"
"chr5","24104741","24105025","chr6","88306874","88307160","19","64202133"
"chr5","24141922","24142215","chr6","88268441","88268727","25","64126519"
"chr5","24143491","24143786","chr3","126975901","126976192","57","102832410"
"chr5","24147112","24147439","chr6","88263487","88263808","32","64116375"
"chr5","24178576","24178764","chr16","68429406","68429593","43","44250830"
"chr5","24204356","24204520","chr6","112634956","112635113","47","88430600"
"chr5","24207652","24207951","chr6","88202884","88203183","16","63995232"
"chr5","24215307","24215599","chr6","88194569","88194851","29","63979262"
"chr5","24219651","24219773","chr6","88189730","88189836","18","63970079"
"chr5","24250692","24250965","chr6","88160167","88160418","48","63909475"
"chr5","24255528","24255814","chr6","88152709","88153005","38","63897181"
"chr5","24289850","24289967","chr1","203489878","203489996","14","179200028"
"chr5","24313553","24313878","chr6","88091622","88091939","31","63778069"
"chr5","24325966","24326264","chr12","3354245","3354541","51","20971721"
"chr5","24353311","24353585","chr6","88050840","88051112","29","63697529"
"chr5","24378611","24378905","chr6","88022322","88022605","49","63643711"
"chr5","24396881","24397180","chr6","88003655","88003952","21","63606774"
"chr5","24423327","24423508","chr19","41683694","41683869","45","17260367"
"chr5","24445280","24445581","chr6","155065278","155065564","79","130619998"
"chr5","24454911","24455166","chr6","87946522","87946754","41","63491611"
"chr5","24469053","24469204","chr7","96766828","96766981","38","72297775"
"chr5","24469451","24469560","chr11","101244413","101244522","20","76774962"
"chr5","24470743","24470978","chr6","87926033","87926283","34","63455290"
"chr5","24504183","24504477","chr6","87891381","87891677","13","63387198"
"chr5","24604986","24605295","chr6","87799473","87799778","24","63194487"
"chr5","24608807","24609067","chr6","87795378","87795633","26","63186571"
"chr5","24621942","24622205","chr6","87782036","87782299","24","63160094"
"chr5","24628752","24628904","chr6","87773437","87773578","19","63144685"
"chr5","24644619","24644726","chr6","87756864","87756971","5","63112245"
"chr5","24721770","24722037","chr6","87685349","87685582","47","62963579"
"chr5","24726934","24727218","chr6","87673902","87674185","14","62946968"
"chr5","24771267","24771549","chr8","129433118","129433406","74","104661851"
"chr5","24830752","24831038","chr6","87575841","87576148","43","62745089"
"chr5","24849211","24849557","chr20","51103321","51103651","91","26254110"
"chr5","24921781","24922074","chr6","87484147","87484442","25","62562366"
"chr5","25014167","25014485","chr6","87402288","87402607","37","62388121"
"chr5","25040239","25040546","chr6","87372945","87373253","22","62332706"
"chr5","25068008","25068131","chr6","87341995","87342118","6","62273987"
"chr5","25106283","25106592","chr6","87307807","87308113","26","62201524"
"chr5","25205283","25205389","chr11","46321180","46321290","22","21115897"
"chr5","25219323","25219624","chr7","78606719","78607017","58","53387396"
"chr5","25227113","25227411","chr6","87182991","87183287","30","61955878"
"chr5","25232817","25233083","chr6","87177373","87177680","53","61944556"
"chr5","25583038","25583328","chr6","86842076","86842355","35","61259038"
"chr5","25626409","25626706","chr6","86798843","86799138","19","61172434"
"chr5","25706730","25707028","chr1","22392281","22392567","63","3314449"
"chr5","25802696","25802989","chr6","86631637","86631923","19","60828941"
"chr5","25923505","25923791","chr6","86532971","86533257","18","60609466"
"chr5","25935745","25936065","chr6","86520511","86520827","47","60584766"
"chr5","26022511","26022798","chr4","149530055","149530345","76","123507544"
"chr5","26030870","26031151","chr6","86424473","86424776","38","60393603"
"chr5","26186154","26186345","chr6","86263184","86263408","52","60077030"
"chr5","26272489","26272818","chr6","86165331","86165652","66","59892842"
"chr5","26308229","26308468","chr6","86128950","86129195","18","59820721"
"chr5","26601366","26601668","chr14","104459582","104459884","63","77858216"
"chr5","26602528","26602819","chr20","62582251","62582546","56","35979723"
"chr5","26640309","26640436","chr10","87818140","87818263","32","61177831"
"chr5","26640727","26640883","chr10","54250811","54250962","42","27610084"
"chr5","26652269","26652546","chr6","85794435","85794707","23","59142166"
"chr5","26663948","26664255","chr14","52830835","52831139","66","26166887"
"chr5","26741434","26741738","chr6","85705082","85705391","26","58963648"
"chr5","26759242","26759531","chr6","85687552","85687841","28","58928310"
"chr5","26799302","26799619","chr6","85649436","85649742","33","58850134"
"chr5","26855407","26855454","chr7","50855234","50855277","12","23999827"
"chr5","26856565","26856787","chr11","109923440","109923658","58","83066875"
"chr5","26974761","26975065","chr6","85472549","85472833","58","58497788"
"chr5","27006622","27006705","chr6","85434651","85434734","8","58428029"
"chr5","27053667","27053970","chr3","130448018","130448321","66","103394351"
"chr5","27081109","27081231","chr10","87415587","87415710","15","60334478"
"chr5","27084449","27084734","chr6","85357276","85357580","41","58272827"
"chr5","27087648","27087972","chr6","85353972","85354262","55","58266324"
"chr5","27091721","27091888","chr6","85349913","85350078","13","58258192"
"chr5","27092184","27092322","chr6","85349469","85349608","12","58257285"
"chr5","27157661","27157972","chr6","85275584","85275894","24","58117923"
"chr5","27171344","27171613","chr6","85264393","85264695","43","58093049"
"chr5","27175328","27175608","chr6","85259893","85260173","38","58084565"
"chr5","27200188","27200468","chr11","131260074","131260355","54","104059886"
"chr5","27203024","27203144","chr6","85233257","85233377","8","58030233"
"chr5","27207908","27208191","chr6","85228175","85228458","16","58020267"
"chr5","27217094","27217396","chr6","85218682","85218977","17","58001588"
"chr5","27221696","27221812","chr10","73131386","73131503","18","45909690"
"chr5","27226415","27226545","chr6","85209595","85209711","23","57983180"
"chr5","27230284","27230570","chr6","85206905","85207191","21","57976621"
"chr5","27241913","27242185","chr2","49010895","49011163","66","21768982"
"chr5","27250727","27251042","chr6","85189488","85189779","41","57938761"
"chr5","27275340","27275639","chr6","85164973","85165267","29","57889633"
"chr5","27275670","27275787","chr6","85164825","85164942","14","57889155"
"chr5","27278498","27278711","chr3","126944977","126945174","62","99666479"
"chr5","27278956","27279037","chr6","85161651","85161725","8","57882695"
"chr5","27372176","27372466","chr6","85070175","85070465","37","57697999"
"chr5","27389541","27389833","chr6","85052170","85052445","34","57662629"
"chr5","27521994","27522126","chr6","84933825","84933948","17","57411831"
"chr5","27684685","27684881","chr13","54729337","54729522","48","27044652"
"chr5","27706496","27706625","chr6","84736492","84736620","8","57029996"
"chr5","28024501","28024766","chr6","84382605","84382859","25","56358104"
"chr5","28124458","28124774","chr6","84283861","84284179","30","56159403"
"chr5","28162751","28163050","chr6","84247348","84247647","12","56084597"
"chr5","28200331","28200628","chr6","84209755","84210051","22","56009424"
"chr5","28207088","28207382","chr14","35724096","35724377","68","7517008"
"chr5","28215968","28216249","chr6","84193558","84193844","17","55977590"
"chr5","28254523","28254656","chr6","84156665","84156798","6","55902142"
"chr5","28268094","28268387","chr6","84143467","84143754","39","55875373"
"chr5","28292721","28292845","chr6","84118155","84118279","7","55825434"
"chr5","28318572","28318653","chr6","84096643","84096724","6","55778071"
"chr5","28377411","28377620","chr6","84032217","84032435","29","55654806"
"chr5","28408834","28408960","chr7","152899855","152899972","30","124491021"
"chr5","28502423","28502720","chr6","83918308","83918607","26","55415885"
"chr5","28570372","28570507","chr6","17252977","17253107","23","11317395"
"chr5","28587448","28587743","chr6","83826505","83826801","47","55239057"
"chr5","28673129","28673442","chr6","83731218","83731532","24","55058089"
"chr5","28678340","28678626","chr6","83726368","83726653","27","55048028"
"chr5","28783314","28783553","chr13","107731373","107731594","66","78948059"
"chr5","28867777","28868091","chr6","83534185","83534490","26","54666408"
"chr5","28881259","28881555","chr6","83520800","83521081","48","54639541"
"chr5","28894720","28894993","chr6","83505972","83506252","30","54611252"
"chr5","28959987","28960258","chr13","65860732","65860999","51","36900745"
"chr5","28965326","28965624","chr2","188426626","188426924","53","159461300"
"chr5","29006283","29006559","chr6","83391875","83392154","26","54385592"
"chr5","29144225","29144545","chr9","24972535","24972840","82","4171690"
"chr5","29164089","29164263","chr12","59016380","59016547","35","29852291"
"chr5","29164310","29164426","chr1","39347501","39347617","24","10183191"
"chr5","29428510","29428790","chr1","109410164","109410447","35","79981654"
"chr5","29456361","29456644","chr12","61099578","61099857","58","31643217"
"chr5","29569665","29569937","chr6","91618152","91618411","84","62048487"
"chr5","29588282","29588576","chr6","83039135","83039427","26","53450853"
"chr5","29589734","29589873","chr6","83037841","83037980","7","53448107"
"chr5","29743112","29743409","chr6","82780818","82781113","27","53037706"
"chr5","29757680","29757978","chr6","82766941","82767224","51","53009261"
"chr5","30063932","30064045","chr3","43296339","43296454","18","13232407"
"chr5","30245824","30246107","chr19","25502042","25502334","70","4743782"
"chr5","30478774","30479098","chr6","82014510","82014856","64","51535736"
"chr5","30629105","30629446","chr6","81856448","81856767","47","51227343"
"chr5","30714640","30714751","chr13","61497780","61497887","25","30783140"
"chr5","30847617","30847921","chr6","81616166","81616463","31","50768549"
"chr5","30849957","30850184","chr6","81612924","81613156","22","50762967"
"chr5","30940151","30940281","chr6","81511813","81511943","14","50571662"
"chr5","30976852","30977121","chr6","81474697","81474998","63","50497845"
"chr5","31059231","31059506","chr6","81388714","81388989","46","50329483"
"chr5","31267410","31267700","chr20","56605571","56605868","60","25338161"
"chr5","31316802","31317107","chr6","81116782","81117090","33","49799980"
"chr5","31323369","31323672","chr4","7851032","7851349","63","23472337"
"chr5","31538350","31538635","chr6","80886377","80886663","29","49348027"
"chr5","31625846","31626107","chr6","80801640","80801881","46","49175794"
"chr5","31682408","31682723","chr6","80744613","80744941","42","49062205"
"chr5","31754229","31754517","chr6","166077036","166077322","61","134322807"
"chr5","31783332","31783412","chr4","104483943","104484024","17","72700611"
"chr5","32158596","32158892","chr6","80267535","80267831","29","48108939"
"chr5","32197709","32197997","chr6","80229494","80229793","43","48031785"
"chr5","32360667","32360969","chr6","80047868","80048130","54","47687201"
"chr5","32480248","32480583","chr6","79920883","79921190","47","47440635"
"chr5","32505367","32505542","chr10","19600755","19600917","47","12904612"
"chr5","32577937","32578236","chr6","79822475","79822779","31","47244538"
"chr5","32678111","32678407","chr6","79734411","79734701","26","47056300"
"chr5","32786701","32786820","chr8","29505366","29505484","18","3281335"
"chr5","33123408","33123707","chr6","79272655","79272957","28","46149247"
"chr5","33263166","33263465","chr7","140588016","140588306","55","107324850"
"chr5","33327926","33328032","chr10","51692908","51693007","22","18364982"
"chr5","33418527","33418637","chr6","78989163","78989277","10","45570636"
"chr5","33426120","33426242","chr6","78981559","78981681","7","45555439"
"chr5","33450195","33450323","chr6","78957227","78957342","17","45507032"
"chr5","33539529","33539830","chr6","78822970","78823262","29","45283441"
"chr5","33551496","33551787","chr6","78809793","78810099","30","45258297"
"chr5","33574811","33575108","chr6","78786608","78786907","19","45211797"
"chr5","33607613","33607866","chr6","78756571","78756823","8","45148958"
"chr5","33611847","33612139","chr3","7265114","7265410","54","26346733"
"chr5","33697713","33698006","chr6","78672663","78672975","44","44974950"
"chr5","33834377","33834516","chr1","128720611","128720750","22","94886234"
"chr5","33845216","33845458","chr16","15975236","15975486","60","17869980"
"chr5","33886950","33887263","chr6","78484456","78484765","30","44597506"
"chr5","33907781","33908114","chr6","78463154","78463486","21","44555373"
"chr5","33974540","33974836","chr12","19505062","19505360","60","14469478"
"chr5","34008761","34009025","chr6","78362146","78362413","15","44353385"
"chr5","34013781","34014064","chr6","78357096","78357416","58","44343315"
"chr5","34060834","34061139","chr6","78307855","78308158","40","44247021"
"chr5","34113330","34113462","chr6","78250783","78250919","13","44137453"
"chr5","34113767","34113929","chr6","78250288","78250472","29","44136521"
"chr5","34159199","34159498","chr6","78204470","78204767","18","44045271"
"chr5","34202783","34203083","chr4","136447356","136447660","68","102244573"
"chr5","34219057","34219363","chr6","78143135","78143436","25","43924078"
"chr5","34243253","34243502","chr6","78117597","78117845","14","43874344"
"chr5","34248360","34248666","chr6","78112187","78112492","22","43863827"
"chr5","34257553","34257867","chr6","78102689","78103010","35","43845136"
"chr5","34264620","34264888","chr6","78095473","78095749","19","43830853"
"chr5","34304303","34304643","chr6","78056720","78057053","57","43752417"
"chr5","34321440","34321722","chr6","78045177","78045480","39","43723737"
"chr5","34389953","34390186","chr3","13343257","13343484","44","21046696"
"chr5","34395478","34395775","chr6","77971190","77971484","25","43575712"
"chr5","34428373","34428549","chr6","77937122","77937302","27","43508749"
"chr5","34428813","34428980","chr1","128086244","128086378","50","93657431"
"chr5","34428985","34429113","chr6","77936689","77936820","11","43507704"
"chr5","34449138","34449440","chr6","77917242","77917530","27","43468104"
"chr5","34461682","34461974","chr6","77904643","77904929","26","43442961"
"chr5","34468615","34468937","chr5","51350304","51350607","61","16881689"
"chr5","34495452","34495751","chr6","77868977","77869274","37","43373525"
"chr5","34532816","34532965","chr15","8429557","8429700","39","26103259"
"chr5","34533278","34533446","chr6","77837264","77837435","15","43303986"
"chr5","34536153","34536345","chr6","77834375","77834572","17","43298222"
"chr5","34556064","34556365","chr2","56803979","56804276","59","22247915"
"chr5","34596848","34596968","chr1","39347501","39347617","22","4750653"
"chr5","34597020","34597199","chr1","21942508","21942674","35","12654512"
"chr5","34627208","34627490","chr6","77750624","77750897","27","43123416"
"chr5","34651755","34651868","chr5","52152547","52152647","34","17500792"
"chr5","34653732","34654053","chr6","77724325","77724642","34","43070593"
"chr5","34655319","34655453","chr3","50142617","50142746","21","15487298"
"chr5","34671571","34671836","chr6","77696516","77696791","23","43024945"
"chr5","34676562","34676871","chrX","18781652","18781959","57","15894910"
"chr5","34681495","34681817","chr1","18648918","18649231","66","16032577"
"chr5","34683398","34683535","chr6","77684679","77684816","9","43001281"
"chr5","34683829","34684013","chr6","77684197","77684376","11","43000368"
"chr5","34712033","34712134","chr8","96949211","96949317","26","62237178"
"chr5","34732374","34732670","chr3","43652365","43652670","57","8919991"
"chr5","34805768","34806057","chr6","77560941","77561233","26","42755173"
"chr5","34876181","34876455","chr6","77488903","77489178","19","42612722"
"chr5","34903039","34903355","chr6","77463469","77463793","46","42560430"
"chr5","34918356","34918485","chr6","77447919","77448048","9","42529563"
"chr5","34934342","34934641","chr6","77430094","77430394","12","42495752"
"chr5","34965604","34965874","chr1","142400833","142401103","22","107435229"
"chr5","34975069","34975359","chr6","77350758","77351050","20","42375689"
"chr5","34982745","34983011","chr6","77342815","77343086","42","42360070"
"chr5","34999542","34999820","chr6","77327194","77327464","31","42327652"
"chr5","35003702","35004005","chr6","77322962","77323255","24","42319260"
"chr5","35004893","35005162","chr6","77321781","77322090","57","42316888"
"chr5","35027659","35027790","chr15","109869590","109869722","21","74841931"
"chr5","35031340","35031626","chr6","77294400","77294680","24","42263060"
"chr5","35062172","35062321","chr11","118108232","118108390","32","83046060"
"chr5","35069484","35069782","chr6","77260247","77260553","24","42190763"
"chr5","35077923","35078227","chr6","134870801","134871115","63","99792878"
"chr5","35105863","35106148","chr11","48401419","48401716","54","13295556"
"chr5","35107047","35107345","chr6","77223428","77223735","25","42116381"
"chr5","35120277","35120562","chr6","77210653","77210958","37","42090376"
"chr5","35125358","35125673","chr6","77205535","77205847","25","42080177"
"chr5","35145066","35145365","chrX","19545469","19545761","82","15599597"
"chr5","35155083","35155385","chr6","77174928","77175230","23","42019845"
"chr5","35177856","35178145","chr6","77158730","77159017","26","41980874"
"chr5","35183378","35183689","chr6","77152839","77153146","28","41969461"
"chr5","35185550","35185874","chr19","25391809","25392114","84","9793741"
"chr5","35188862","35189169","chr6","77147399","77147706","23","41958537"
"chr5","35211424","35211708","chr6","77127877","77128178","40","41916453"
"chr5","35226450","35226558","chr6","77110770","77110876","6","41884320"
"chr5","35226584","35226739","chr6","77110580","77110735","14","41883996"
"chr5","35228545","35228838","chr1","44171967","44172258","59","8943422"
"chr5","35243496","35243722","chr1","213911110","213911337","43","178667614"
"chr5","35250627","35250772","chr19","14696877","14697012","41","20553750"
"chr5","35250773","35251072","chr6","77087758","77088048","34","41836985"
"chr5","35251073","35251185","chr2","85718857","85718967","28","50467784"
"chr5","35253627","35253932","chr6","77084899","77085199","17","41831272"
"chr5","35279280","35279413","chr6","77055071","77055193","17","41775791"
"chr5","35293938","35294215","chr6","76990212","76990488","15","41696274"
"chr5","35306849","35307135","chr7","66487950","66488236","64","31181101"
"chr5","35315222","35315503","chr6","76968864","76969127","34","41653642"
"chr5","35322471","35322736","chr11","7508963","7509219","62","27813508"
"chr5","35337320","35337516","chr6","76947545","76947740","14","41610225"
"chr5","35359321","35359588","chr6","76924706","76924977","20","41565385"
"chr5","35364879","35365161","chr16","39964733","39965029","61","4599854"
"chr5","35398160","35398516","chr6","76888244","76888524","91","41490084"
"chr5","35431663","35431880","chr16","1659659","1659883","48","33772004"
"chr5","35438238","35438354","chr6","76845509","76845629","14","41407271"
"chr5","35450685","35450975","chr6","76831542","76831822","41","41380857"
"chr5","35452319","35452529","chr2","100610118","100610341","59","65157799"
"chr5","35459006","35459324","chr3","43652365","43652670","54","8193359"
"chr5","35465207","35465525","chr6","76817620","76817935","32","41352413"
"chr5","35475647","35475947","chr6","76807052","76807346","24","41331405"
"chr5","35490291","35490581","chr6","76792820","76793112","24","41302529"
"chr5","35496015","35496307","chr6","76786891","76787179","23","41290876"
"chr5","35501351","35501599","chr6","76782124","76782372","15","41280773"
"chr5","35557616","35557754","chr6","76727215","76727354","9","41169599"
"chr5","35558057","35558233","chr6","76726734","76726902","17","41168677"
"chr5","35566271","35566564","chr6","76718373","76718669","33","41152102"
"chr5","35577908","35578155","chr20","65752644","65752894","58","30174736"
"chr5","35663364","35663658","chr6","76622948","76623243","17","40959584"
"chr5","35678904","35679228","chr10","77243813","77244130","64","41564909"
"chr5","35685702","35685899","chr6","76606783","76606975","20","40921081"
"chr5","35697709","35697885","chr6","76594838","76595018","21","40897129"
"chr5","35760971","35761069","chr4","5126561","5126661","23","30634410"
"chr5","35764320","35764614","chr6","76529233","76529542","37","40764913"
"chr5","35767930","35768065","chr6","76525794","76525930","8","40757864"
"chr5","35768350","35768532","chr6","76525306","76525485","25","40756956"
"chr5","35805336","35805420","chr6","76488746","76488826","7","40683410"
"chr5","35839026","35839328","chr6","76454507","76454807","30","40615481"
"chr5","35857369","35857665","chr9","115146364","115146659","66","79288995"
"chr5","35876750","35877035","chr6","76415706","76415977","52","40538956"
"chr5","35878461","35878601","chr18","70047695","70047842","35","34169234"
"chr5","35896607","35896966","chr6","76395223","76395559","37","40498616"
"chr5","35926538","35926840","chr6","76364826","76365129","19","40438288"
"chr5","35932967","35933263","chr6","76358090","76358385","16","40425123"
"chr5","35942677","35942877","chr6","76348260","76348462","17","40405583"
"chr5","35960987","35961290","chr6","76330276","76330576","29","40369289"
"chr5","35971455","35971567","chr11","102229016","102229130","16","66257561"
"chr5","35988351","35988656","chr6","76302805","76303118","33","40314454"
"chr5","36020370","36020657","chr6","76273757","76274043","22","40253387"
"chr5","36024257","36024569","chr6","76269437","76269728","36","40245180"
"chr5","36043635","36043764","chr14","105065778","105065908","20","69022143"
"chr5","36051908","36052216","chr6","76242312","76242619","29","40190404"
"chr5","36088351","36088624","chr6","76207125","76207430","52","40118774"
"chr5","36096243","36096535","chr6","76199061","76199354","23","40102818"
"chr5","36104893","36105191","chr6","76190588","76190848","56","40085695"
"chr5","36124087","36124336","chr6","76170584","76170825","54","40046497"
"chr5","36134944","36135073","chr6","76159063","76159191","13","40024119"
"chr5","36141340","36141638","chr6","76152155","76152450","24","40010815"
"chr5","36164120","36164407","chr6","76129927","76130214","20","39965807"
"chr5","36183776","36184054","chr6","76111982","76112254","19","39928206"
"chr5","36191501","36191754","chr19","3253095","3253354","58","32938406"
"chr5","36219064","36219359","chr6","76077463","76077785","39","39858399"
"chr5","36225502","36225609","chr12","65558994","65559099","21","29333492"
"chr5","36236288","36236577","chr6","76056993","76057278","27","39820705"
"chr5","36255040","36255201","chr17","3933207","3933362","34","32321833"
"chr5","36509466","36509583","chr8","39199930","39200045","22","2690464"
"chr5","36510402","36510683","chr8","28447582","28447871","76","8062820"
"chr5","36514186","36514257","chr9","30243622","30243697","14","6270564"
"chr5","36522835","36523113","chr2","56788248","56788536","67","20265413"
"chr5","36525934","36526065","chr6","75988176","75988302","11","39462242"
"chr5","36526352","36526542","chr6","75987716","75987906","14","39461364"
"chr5","36534976","36535255","chr6","75980326","75980593","33","39445350"
"chr5","36546627","36546771","chr15","109543198","109543336","41","72996571"
"chr5","36546848","36546970","chr6","75969265","75969388","11","39422417"
"chr5","36573146","36573434","chr9","115146364","115146659","71","78573218"
"chr5","36594996","36595302","chr2","71005973","71006275","61","34410977"
"chr5","36603663","36603941","chr3","55299063","55299339","51","18695400"
"chr5","36614579","36614813","chr6","75904309","75904545","14","39289730"
"chr5","36616034","36616147","chr16","61292718","61292835","23","24676684"
"chr5","36624690","36624987","chr6","75895430","75895731","32","39270740"
"chr5","36633476","36633752","chr6","75886987","75887271","22","39253511"
"chr5","36678771","36678903","chr6","75842905","75843034","15","39164134"
"chr5","36698653","36698918","chr6","75822455","75822755","56","39123802"
"chr5","36885407","36885699","chr6","75637206","75637509","36","38751799"
"chr5","36893658","36893902","chr3","46270497","46270736","59","9376839"
"chr5","36924952","36925234","chr6","75601315","75601612","24","38676363"
"chr5","36952616","36952795","chr20","38199511","38199684","35","1246895"
"chr5","36952837","36952955","chr1","61964228","61964344","23","25011391"
"chr5","36987865","36988159","chr6","75545752","75546051","24","38557887"
"chr5","37012087","37012425","chr6","75521226","75521555","38","38509139"
"chr5","37013774","37013876","chr9","87727843","87727952","21","50714069"
"chr5","37014078","37014354","chr6","75519270","75519543","21","38505192"
"chr5","37021915","37022222","chr6","75511423","75511731","18","38489508"
"chr5","37057585","37057673","chr6","75475115","75475199","5","38417530"
"chr5","37057878","37058194","chr1","21474061","21474377","62","15583817"
"chr5","37058475","37058774","chr6","75473990","75474293","31","38415515"
"chr5","37107869","37107993","chr6","75430701","75430831","11","38322832"
"chr5","37133326","37133634","chr6","75411587","75411913","44","38278261"
"chr5","37136497","37136769","chr6","75408452","75408724","13","38271955"
"chr5","37139084","37139384","chr6","75405534","75405841","30","38266450"
"chr5","37204492","37204789","chr6","75340720","75341030","39","38136228"
"chr5","37269975","37270275","chr6","75280861","75281160","52","38010886"
"chr5","37329156","37329502","chr6","75215434","75215751","61","37886278"
"chr5","37390421","37390731","chr6","75151967","75152278","19","37761546"
"chr5","37405838","37406118","chr1","191690399","191690678","59","154284561"
"chr5","37409990","37410115","chr6","75136695","75136820","7","37726705"
"chr5","37433545","37433738","chr1","13746336","13746531","39","23687209"
"chr5","37475678","37475971","chr1","123654708","123654992","65","86179030"
"chr5","37493218","37493531","chr7","21557750","21558053","58","15935468"
"chr5","37502197","37502499","chr6","75015204","75015496","33","37513007"
"chr5","37520947","37521234","chr20","30457170","30457461","54","7063777"
"chr5","37522400","37522677","chr6","74990722","74991003","16","37468322"
"chr5","37531833","37532149","chr6","74981228","74981547","30","37449395"
"chr5","37613209","37613464","chr6","74895957","74896204","24","37282748"
"chr5","37629839","37630108","chr6","74879590","74879870","32","37249751"
"chr5","37631040","37631339","chr6","74878352","74878661","29","37247312"
"chr5","37651827","37651975","chr14","2894541","2894688","20","34757286"
"chr5","37685586","37685831","chr8","92687825","92688073","53","55002239"
"chr5","37701404","37701690","chr6","74804071","74804339","27","37102667"
"chr5","37751977","37752271","chr6","74752362","74752651","34","37000385"
"chr5","37764727","37764852","chr6","74739017","74739141","14","36974290"
"chr5","37837982","37838284","chr6","74708811","74709104","32","36870829"
"chr5","37872322","37872624","chr10","72675751","72676049","46","34803429"
"chr5","37929672","37930000","chr6","74567073","74567389","31","36637401"
"chr5","38009344","38009460","chr6","74488006","74488119","10","36478662"
"chr5","38032641","38032943","chr6","74464066","74464369","25","36431425"
"chr5","38046604","38046910","chr6","74447697","74448007","55","36401093"
"chr5","38122416","38122703","chr6","74373926","74374212","21","36251510"
"chr5","38129869","38130147","chr6","74366474","74366752","19","36236605"
"chr5","38228183","38228487","chr6","74276288","74276588","23","36048105"
"chr5","38306131","38306420","chr6","74189215","74189519","28","35883084"
"chr5","38372455","38372760","chr14","8439133","8439435","56","29933322"
"chr5","38373152","38373273","chr6","74132606","74132729","9","35759454"
"chr5","38648165","38648269","chr6","73861847","73861951","7","35213682"
"chr5","38666954","38667268","chr6","73841601","73841915","12","35174647"
"chr5","38701155","38701414","chr6","73798229","73798510","53","35097074"
"chr5","38702576","38702844","chr6","73796785","73797063","45","35094209"
"chr5","38707983","38708273","chr3","42107648","42107937","57","3399665"
"chr5","38729334","38729640","chr1","182642228","182642528","65","143912894"
"chr5","38755763","38756059","chr6","73744967","73745271","26","34989204"
"chr5","38768069","38768177","chr6","73732862","73732979","14","34964793"
"chr5","38787209","38787506","chr6","73713345","73713639","19","34926136"
"chr5","38810428","38810739","chr6","73693291","73693593","37","34882863"
"chr5","38829308","38829437","chr6","73674621","73674736","21","34845313"
"chr5","38849788","38849909","chr9","121352885","121353007","17","82503097"
"chr5","38850203","38850376","chr2","95039433","95039620","45","56189230"
"chr5","38892427","38892733","chr6","73610204","73610504","31","34717777"
"chr5","38924037","38924212","chr3","156205113","156205291","35","117281076"
"chr5","38971456","38971760","chr6","73543296","73543580","37","34571840"
"chr5","38972743","38972872","chr6","73542099","73542226","11","34569356"
"chr5","38995057","38995349","chr1","211353988","211354282","54","172358931"
"chr5","39011008","39011282","chr6","73494811","73495053","50","34483803"
"chr5","39014207","39014325","chr14","8294861","8294977","17","30719346"
"chr5","39014770","39015079","chr6","73490671","73490977","22","34475901"
"chr5","39025564","39025679","chr6","73480144","73480259","3","34454580"
"chr5","39042583","39042697","chr6","73461905","73462019","9","34419322"
"chr5","39042892","39043199","chr19","33697202","33697506","57","5345690"
"chr5","39046858","39047061","chr3","40442095","40442283","48","1395237"
"chr5","39053900","39054210","chr6","73453733","73454030","32","34399833"
"chr5","39068436","39068739","chr6","73439305","73439595","43","34370869"
"chr5","39069440","39069687","chr4","5783364","5783616","60","33286076"
"chr5","39109002","39109301","chr6","73401345","73401635","18","34292343"
"chr5","39125212","39125484","chr6","73385322","73385588","21","34260110"
"chr5","39164491","39164756","chr6","73339991","73340289","58","34175500"
"chr5","39167333","39167637","chr6","73337111","73337413","30","34169778"
"chr5","39240674","39240930","chr3","36424130","36424381","59","2816544"
"chr5","39250139","39250432","chr6","73327873","73328180","36","34077734"
"chr5","39303980","39304284","chr6","73275801","73276103","20","33971821"
"chr5","39321871","39321990","chr6","73258016","73258136","8","33936145"
"chr5","39325300","39325590","chr6","73254122","73254420","30","33928822"
"chr5","39357793","39357939","chr1","194894728","194894873","27","155536935"
"chr5","39360567","39360860","chr6","73216576","73216847","27","33856009"
"chr5","39379142","39379402","chr15","18291594","18291841","68","21087548"
"chr5","39417748","39418058","chr6","73160417","73160725","17","33742669"
"chr5","39435556","39435838","chr6","73142264","73142535","42","33706708"
"chr5","39446828","39446940","chr6","73130904","73131016","10","33684076"
"chr5","39480087","39480202","chr6","73097475","73097590","7","33617388"
"chr5","39498175","39498468","chr6","73075808","73076118","36","33577633"
"chr5","39500460","39500663","chr10","63092747","63092940","59","23592287"
"chr5","39502741","39502965","chr6","73071323","73071549","19","33568582"
"chr5","39505141","39505263","chr3","142026097","142026218","17","102520956"
"chr5","39544368","39544667","chr6","73028928","73029226","16","33484560"
"chr5","39545136","39545385","chr6","73028202","73028460","32","33483066"
"chr5","39548072","39548383","chr6","73024900","73025206","22","33476828"
"chr5","39552438","39552558","chr8","122404659","122404783","17","82852221"
"chr5","39612684","39612954","chr6","72964863","72965139","28","33352179"
"chr5","39619041","39619277","chr18","3557498","3557746","59","36061543"
"chr5","39642729","39642927","chr6","72933779","72933977","22","33291050"
"chr5","39666036","39666159","chr6","72910268","72910393","8","33244232"
"chr5","39668591","39668893","chr6","72907527","72907829","35","33238936"
"chr5","39677123","39677413","chr6","72898005","72898325","43","33220882"
"chr5","39717787","39718098","chr6","72859318","72859625","22","33141531"
"chr5","39764346","39764650","chr19","29108741","29109042","57","10655605"
"chr5","39766519","39766822","chr6","72807369","72807674","19","33040850"
"chr5","39789250","39789541","chr6","72784903","72785202","27","32995653"
"chr5","40080262","40080555","chr6","72517024","72517322","30","32436762"
"chr5","40168735","40168889","chr6","72440552","72440709","16","32271817"
"chr5","40180902","40181024","chr6","72428398","72428520","9","32247496"
"chr5","40195123","40195234","chr1","125176900","125177016","17","84981777"
"chr5","40211791","40212074","chr6","72397741","72398031","18","32185950"
"chr5","40260148","40260466","chr6","72353448","72353754","56","32093300"
"chr5","40263680","40263896","chr6","72350029","72350244","6","32086349"
"chr5","40271993","40272292","chr14","111297951","111298245","58","71025958"
"chr5","40298341","40298457","chr11","26329155","26329272","17","13969186"
"chr5","40303761","40304064","chr6","72311351","72311653","17","32007590"
"chr5","40306605","40306890","chr6","72308573","72308843","28","32001968"
"chr5","40319096","40319381","chr6","72297034","72297314","23","31977938"
"chr5","40353043","40353352","chr6","72261637","72261933","33","31908594"
"chr5","40355778","40356083","chr1","8665723","8666021","52","31690055"
"chr5","40364634","40364920","chr6","72243889","72244174","34","31879255"
"chr5","40372260","40372519","chr6","72236173","72236426","38","31863913"
"chr5","40373106","40373373","chr6","125991585","125991862","61","85618479"
"chr5","40385293","40385552","chr6","72228730","72228976","33","31843437"
"chr5","40392088","40392393","chr6","72221737","72222038","35","31829649"
"chr5","40393655","40393916","chr6","72220198","72220462","21","31826543"
"chr5","40396096","40396467","chr14","70576619","70576993","92","30180523"
"chr5","40397320","40397389","chr6","72216649","72216718","4","31819329"
"chr5","40405359","40405644","chr1","52796524","52796820","65","12391165"
"chr5","40427371","40427459","chr7","55835492","55835577","22","15408121"
"chr5","40447676","40447976","chr6","72160982","72161304","64","31713306"
"chr5","40452444","40452556","chr6","72156471","72156580","11","31704027"
"chr5","40452863","40453055","chr6","72155976","72156164","24","31703113"
"chr5","40475747","40476053","chr1","195801657","195801957","74","155325910"
"chr5","40487746","40488058","chr6","72123208","72123519","22","31635462"
"chr5","40502797","40503057","chr6","72106273","72106537","18","31603476"
"chr5","40516683","40516955","chr6","72090583","72090845","31","31573900"
"chr5","40519708","40519951","chr6","72086801","72087037","30","31567093"
"chr5","40529331","40529545","chr6","72077529","72077751","19","31548198"
"chr5","40531868","40532155","chr6","72075037","72075322","19","31543169"
"chr5","40532972","40533225","chr6","72073930","72074210","45","31540958"
"chr5","40586873","40587050","chr6","72020796","72020989","22","31433923"
"chr5","40587349","40587470","chr6","72020363","72020485","9","31433014"
"chr5","40592534","40592902","chr16","25564712","25565047","94","15027822"
"chr5","40629951","40630256","chr6","71970578","71970888","38","31340627"
"chr5","40633757","40634048","chr7","140588016","140588306","52","99954259"
"chr5","40678524","40678685","chr6","71931951","71932127","21","31253427"
"chr5","40713752","40713956","chr6","71896225","71896461","46","31182473"
"chr5","40754960","40755258","chr6","71860885","71861186","19","31105925"
"chr5","40846887","40847009","chr6","71780058","71780173","18","30933171"
"chr5","40886019","40886318","chr6","71739431","71739729","18","30853412"
"chr5","40928078","40928380","chr6","71694175","71694472","32","30766097"
"chr5","40957154","40957373","chr1","64716831","64717063","57","23759677"
"chr5","40958266","40958536","chr6","71656666","71656938","10","30698400"
"chr5","40995899","40996200","chr6","71565434","71565731","17","30569535"
"chr5","41008311","41008438","chr6","71551810","71551944","10","30543499"
"chr5","41039186","41039446","chr4","157119863","157120146","42","116080677"
"chr5","41061952","41062075","chr6","71498416","71498539","7","30436464"
"chr5","41070672","41070852","chr6","71489405","71489585","10","30418733"
"chr5","41077109","41077415","chr6","71480023","71480323","32","30402914"
"chr5","41193789","41194077","chr6","71360967","71361257","21","30167178"
"chr5","41217576","41217689","chr17","25131519","25131635","24","16086057"
"chr5","41252988","41253163","chr6","71308250","71308415","35","30055262"
"chr5","41253429","41253558","chr6","71307848","71307971","15","30054419"
"chr5","41255705","41255812","chr9","30920701","30920807","23","10335004"
"chr5","41280246","41280472","chr3","116444016","116444218","61","75163770"
"chr5","41304173","41304460","chr6","71258606","71258892","18","29954433"
"chr5","41318989","41319297","chr6","71243053","71243365","31","29924064"
"chr5","41321138","41321258","chr6","71241096","71241216","7","29919958"
"chr5","41340370","41340660","chr6","71221452","71221744","18","29881082"
"chr5","41364239","41364553","chr6","71193688","71194006","27","29829449"
"chr5","41491772","41492052","chr7","112993514","112993795","53","71501742"
"chr5","41539454","41539756","chr6","71013809","71014110","30","29474355"
"chr5","41617251","41617536","chr1","155141171","155141450","62","113523920"
"chr5","41648983","41649097","chr6","70911696","70911808","10","29262713"
"chr5","41650414","41650708","chr6","70910127","70910419","20","29259713"
"chr5","41652496","41652639","chr6","70908186","70908329","7","29255690"
"chr5","41749448","41749742","chr6","70816040","70816316","43","29066592"
"chr5","41847463","41847743","chr6","70715409","70715687","26","28867946"
"chr5","41848836","41849118","chr6","70714050","70714334","28","28865214"
"chr5","41851542","41851869","chr6","70711350","70711651","36","28859808"
"chr5","42113133","42113421","chr6","70441047","70441347","22","28327914"
"chr5","42162205","42162463","chr6","70392920","70393197","36","28230715"
"chr5","42163194","42163316","chr6","70392075","70392195","8","28228881"
"chr5","42225783","42226061","chr6","70328597","70328878","29","28102814"
"chr5","42293927","42294235","chr6","70254892","70255214","45","27960965"
"chr5","42325444","42325747","chr6","70225568","70225880","24","27900124"
"chr5","42334662","42334973","chr6","70216364","70216678","20","27881702"
"chr5","42369800","42369934","chr11","54678543","54678677","25","12308743"
"chr5","42370231","42370395","chr19","5593755","5593916","31","36776476"
"chr5","42373889","42374012","chr3","36373230","36373353","17","6000659"
"chr5","42374333","42374517","chr2","92036336","92036508","33","49662003"
"chr5","42399605","42399733","chr6","70140636","70140764","9","27741031"
"chr5","42400287","42400505","chr6","70139855","70140072","14","27739568"
"chr5","42418423","42418522","chr18","8385273","8385372","28","34033150"
"chr5","42433420","42433667","chr6","70098326","70098573","17","27664906"
"chr5","42440880","42441155","chr6","70090256","70090534","24","27649376"
"chr5","42441747","42442047","chr15","43687639","43687935","52","1245892"
"chr5","42455618","42455837","chr3","42318438","42318645","52","137180"
"chr5","42483732","42483849","chr10","82577110","82577226","14","40093378"
"chr5","42507275","42507421","chr9","21947955","21948099","25","20559320"
"chr5","42556500","42556803","chr6","69963832","69964137","24","27407332"
"chr5","42571610","42571896","chr6","69948904","69949215","39","27377294"
"chr5","42597448","42597728","chr6","69920908","69921188","23","27323460"
"chr5","42625458","42625816","chr5","41239409","41239728","85","1386049"
"chr5","42740190","42740454","chr6","69735638","69735906","15","26995448"
"chr5","42765591","42765903","chr6","69710399","69710704","33","26944808"
"chr5","42802483","42802742","chr6","69672547","69672812","36","26870064"
"chr5","42854437","42854725","chr6","69618219","69618513","29","26763782"
"chr5","42864209","42864515","chr6","69601952","69602268","36","26737743"
"chr5","42865973","42866276","chr6","69600187","69600495","20","26734214"
"chr5","42891210","42891522","chr6","69578406","69578718","23","26687196"
"chr5","42911818","42911942","chr6","58120152","58120275","15","15208334"
"chr5","42911984","42912293","chr3","123986268","123986570","64","81074284"
"chr5","42913814","42914168","chr6","69554942","69555294","24","26641128"
"chr5","42914376","42914493","chr6","69554307","69554424","10","26639931"
"chr5","42914793","42914830","chr16","72124145","72124164","18","29209352"
"chr5","42915130","42915302","chr6","69553538","69553717","16","26638408"
"chr5","42948556","42948675","chr6","69480429","69480553","18","26531873"
"chr5","42950915","42951214","chr6","69477897","69478210","43","26526982"
"chr5","42954691","42954998","chr6","130557095","130557398","65","87602404"
"chr5","42955241","42955542","chr6","69473194","69473492","21","26517953"
"chr5","42991240","42991523","chr6","69444922","69445206","18","26453682"
"chr5","43035562","43035675","chr6","69396367","69396479","16","26360805"
"chr5","43048006","43048274","chr6","69384520","69384790","13","26336514"
"chr5","43061323","43061566","chr6","69369102","69369352","24","26307779"
"chr5","43086744","43086955","chr3","165295251","165295467","46","122208507"
"chr5","43121615","43121916","chr6","69307303","69307604","17","26185688"
"chr5","43123158","43123300","chr6","69305907","69306065","22","26182749"
"chr5","43123590","43123859","chr6","69305372","69305652","29","26181782"
"chr5","43156477","43156555","chr1","205131237","205131314","14","161974760"
"chr5","43179920","43180225","chr6","69248683","69248971","46","26068763"
"chr5","43294355","43294656","chr6","69131832","69132133","18","25837477"
"chr5","43395731","43395910","chr3","34573368","34573553","38","8822363"
"chr5","43396203","43396346","chr1","142183123","142183260","31","98786920"
"chr5","43439924","43440027","chr3","55162427","55162527","21","11722503"
"chr5","43441832","43442121","chr7","140588016","140588306","67","97146184"
"chr5","43534661","43534870","chrX","48222572","48222783","54","4687911"
"chr5","43553726","43553973","chr6","38879936","38880189","66","4673790"
"chr5","43570051","43570350","chr6","68847800","68848100","34","25277749"
"chr5","43577341","43577642","chr6","68840561","68840862","38","25263220"
"chr5","43631629","43631749","chr6","68786985","68787097","17","25155356"
"chr5","43668478","43668593","chr2","202498707","202498823","19","158830229"
"chr5","43669848","43670113","chr6","68740414","68740651","46","25070566"
"chr5","43671256","43671474","chr6","68739030","68739237","21","25067774"
"chr5","43680942","43681259","chr6","68729223","68729536","22","25048281"
"chr5","43766296","43766553","chr6","68643616","68643866","29","24877320"
"chr5","43767066","43767202","chr3","13748640","13748772","35","30018426"
"chr5","43782050","43782362","chr6","68626578","68626883","24","24844528"
"chr5","43787065","43787210","chr1","195821665","195821810","26","152034600"
"chr5","43787522","43787703","chr2","94566650","94566828","38","50779128"
"chr5","43867814","43868092","chr6","68535507","68535785","23","24667693"
"chr5","44049900","44050196","chr6","68346679","68346985","28","24296779"
"chr5","44053286","44053555","chr6","68342978","68343250","23","24289692"
"chr5","44058670","44058905","chr6","68337631","68337880","33","24278961"
"chr5","44170833","44171109","chr6","68276625","68276901","25","24105792"
"chr5","44174997","44175206","chr3","93515202","93515421","43","49340205"
"chr5","44202307","44202412","chr1","185090107","185090203","26","140887800"
"chr5","44206201","44206463","chr12","97216564","97216810","70","53010363"
"chr5","44225429","44225722","chr6","68226727","68227036","32","24001298"
"chr5","44232082","44232336","chr9","10783384","10783632","54","33448698"
"chr5","44234028","44234321","chr6","68218110","68218405","29","23984082"
"chr5","44276087","44276381","chr6","68182569","68182865","23","23906482"
"chr5","44278100","44278268","chr14","118293462","118293624","41","74015362"
"chr5","44280869","44281063","chr6","68177624","68177819","7","23896755"
"chr5","44311273","44311454","chr6","68146972","68147145","13","23835699"
"chr5","44324064","44324193","chr6","68132907","68133036","3","23808843"
"chr5","44342545","44342661","chr6","68112734","68112840","13","23770189"
"chr5","44345586","44345890","chr17","61670006","61670294","51","17324420"
"chr5","44361146","44361401","chr5","39115536","39115780","55","5245610"
"chr5","44364319","44364630","chr6","68097646","68097973","41","23733327"
"chr5","44371558","44371798","chr6","68090078","68090316","13","23718520"
"chr5","44373709","44373995","chr6","170346051","170346348","68","125972342"
"chr5","44374356","44374633","chr15","83999297","83999580","71","39624941"
"chr5","44388261","44388544","chr6","68073577","68073860","18","23685316"
"chr5","44394467","44394553","chr3","158873113","158873201","22","114478646"
"chr5","44403993","44404108","chr1","148386664","148386780","15","103982671"
"chr5","44418390","44418693","chr6","68044875","68045155","48","23626485"
"chr5","44422533","44422824","chr6","68040713","68041029","46","23618180"
"chr5","44442933","44443245","chr6","68016592","68016887","53","23573659"
"chr5","44447952","44448074","chr6","68011408","68011532","5","23563456"
"chr5","44450663","44450963","chr6","68008587","68008880","26","23557924"
"chr5","44456550","44456727","chr6","68002367","68002537","14","23545817"
"chr5","44478925","44479240","chr6","67978688","67979002","42","23499763"
"chr5","44484957","44485111","chr11","13579411","13579559","31","30905546"
"chr5","44487407","44487673","chr3","78030810","78031080","64","33543403"
"chr5","44488435","44488726","chr6","67966712","67967003","15","23478277"
"chr5","45851638","45851941","chr6","67951531","67951817","50","22099893"
"chr5","45862342","45862571","chrX","8697309","8697538","45","37165033"
"chr5","45876992","45877186","chr19","34071897","34072092","60","11805095"
"chr5","45888254","45888474","chr6","67915660","67915876","13","22027406"
"chr5","45900614","45900893","chr2","54551296","54551587","33","8650682"
"chr5","45901337","45901495","chr6","67895176","67895339","18","21993839"
"chr5","45901810","45901955","chr6","67894728","67894873","11","21992918"
"chr5","45911907","45912039","chr6","67888368","67888500","10","21976461"
"chr5","45922818","45923106","chr6","67878514","67878804","11","21955696"
"chr5","45927431","45927734","chr6","67873207","67873510","25","21945776"
"chr5","45928733","45929023","chr3","124267629","124267922","57","78338896"
"chr5","45942242","45942546","chr6","67860227","67860534","24","21917985"
"chr5","45942844","45943125","chr6","67859644","67859932","18","21916800"
"chr5","45944695","45944999","chr20","2321526","2321817","53","43623169"
"chr5","45945007","45945098","chr3","42599838","42599928","11","3345169"
"chr5","45956672","45956788","chr6","67896830","67896941","14","21940158"
"chr5","45965335","45965641","chr6","67834103","67834400","32","21868768"
"chr5","45978792","45979109","chr6","67822962","67823258","55","21844170"
"chr5","45979646","45979954","chr6","67821768","67822083","25","21842122"
"chr5","45989061","45989192","chr6","67810732","67810861","10","21821671"
"chr5","45997839","45997955","chr6","67800805","67800920","7","21802966"
"chr5","46002233","46002537","chr6","67796207","67796485","41","21793974"
"chr5","46034824","46035072","chr8","92687825","92688073","54","46653001"
"chr5","46037128","46037189","chr6","67757521","67757589","8","21720393"
"chr5","46037605","46037708","chr20","2869504","2869597","30","43168101"
"chr5","46051594","46051896","chr6","67742487","67742790","29","21690893"
"chr5","46074220","46074524","chr6","67721365","67721679","29","21647145"
"chr5","46088359","46088667","chr6","67707011","67707320","23","21618652"
"chr5","46090560","46090825","chr6","67704548","67704814","23","21613988"
"chr5","46099351","46099638","chr6","67650761","67651051","23","21551410"
"chr5","46114386","46114517","chr6","67810732","67810861","10","21696346"
"chr5","46117529","46117833","chr3","41604589","41604891","54","4512940"
"chr5","46132242","46132429","chr6","67614451","67614639","19","21482209"
"chr5","46132723","46132857","chr6","67614008","67614143","15","21481285"
"chr5","46140575","46140681","chr9","13956681","13956783","22","32183894"
"chr5","46140972","46141162","chr6","67603718","67603884","33","21462746"
"chr5","46144084","46144294","chr6","67600530","67600774","43","21456446"
"chr5","46146875","46146998","chr6","67595761","67595884","6","21448886"
"chr5","46151872","46152186","chrX","15099734","15100040","59","31052138"
"chr5","46169168","46169305","chr4","35579957","35580092","18","10589211"
"chr5","46181230","46181525","chr6","67561394","67561681","31","21380164"
"chr5","46183289","46183549","chr6","67559373","67559646","27","21376084"
"chr5","46184960","46185249","chr6","67557328","67557627","27","21372368"
"chr5","46189717","46189974","chr6","67552110","67552373","22","21362393"
"chr5","46194079","46194380","chr6","67547671","67547970","19","21353592"
"chr5","46199086","46199367","chr20","69521507","69521801","58","23322421"
"chr5","46212870","46213146","chr6","67527107","67527375","30","21314237"
"chr5","46218030","46218320","chr6","67519644","67519936","17","21301614"
"chr5","46244700","46244988","chr6","67491304","67491594","19","21246604"
"chr5","46245621","46245903","chr6","67490380","67490659","14","21244759"
"chr5","46252936","46252954","chr2","188170636","188170655","3","141917700"
"chr5","46253274","46253454","chr6","67480932","67481096","26","21227658"
"chr5","46253749","46253827","chr6","67480260","67480337","4","21226511"
"chr5","46254901","46255094","chr6","67476516","67476706","18","21221615"
"chr5","46256860","46257095","chr6","67474372","67474603","20","21217512"
"chr5","46288999","46289105","chr6","67440065","67440185","20","21151066"
"chr5","46300366","46300497","chr6","67419902","67420026","21","21119536"
"chr5","46316983","46317291","chr6","67397980","67398278","27","21080997"
"chr5","46318244","46318379","chr19","43762358","43762492","28","2555886"
"chr5","46318676","46318837","chr3","126621167","126621327","32","80302491"
"chr5","46330147","46330280","chr3","81907699","81907832","24","35577552"
"chr5","46348109","46348395","chr6","67366884","67367170","33","21018775"
"chr5","46351010","46351195","chr5","165397239","165397411","48","119046229"
"chr5","46352112","46352404","chr6","67361933","67362228","14","21009821"
"chr5","46366084","46366379","chr6","67344077","67344396","46","20977993"
"chr5","46377709","46377908","chr6","67335047","67335230","40","20957338"
"chr5","46379044","46379311","chr1","10904976","10905255","67","35474068"
"chr5","46380009","46380146","chr6","67332575","67332712","9","20952566"
"chr5","46385899","46386016","chr6","67327265","67327387","9","20941366"
"chr5","46388038","46388159","chr13","46512186","46512305","16","124148"
"chr5","46388287","46388569","chr6","176228945","176229232","61","129840658"
"chr5","46391483","46391763","chr3","36540292","36540572","73","9851191"
"chr5","46411172","46411300","chr19","12212993","12213123","24","34198179"
"chr5","46413528","46413652","chr14","56759997","56760121","15","10346469"
"chr5","46415092","46415288","chr6","67303922","67304099","26","20888830"
"chr5","46420795","46421042","chr3","165224084","165224336","55","118803289"
"chr5","46425238","46425545","chr6","67291610","67291917","20","20866372"
"chr5","46434398","46434692","chr4","114837795","114838073","65","68403397"
"chr5","46439420","46439687","chr14","93616508","93616773","60","47177088"
"chr5","46456080","46456251","chr6","67254236","67254402","10","20798156"
"chr5","46458612","46458818","chr6","67251677","67251893","22","20793065"
"chr5","46473246","46473545","chr6","67235912","67236227","32","20762666"
"chr5","46516469","46516769","chr6","67189233","67189534","21","20672764"
"chr5","46519889","46520167","chr1","45754430","45754712","65","765459"
"chr5","46538490","46538793","chr6","67166681","67166993","32","20628191"
"chr5","46560503","46560804","chr6","67143353","67143675","45","20582850"
"chr5","46575922","46576219","chr10","70947259","70947566","53","24371337"
"chr5","46601155","46601214","chr2","1463539","1463599","15","45137616"
"chr5","46601231","46601356","chr11","122666448","122666573","15","76065217"
"chr5","46616423","46616722","chr6","67089093","67089396","26","20472670"
"chr5","46929791","46930101","chr6","66784500","66784797","40","19854709"
"chr5","47020946","47021229","chr6","66688934","66689217","17","19667988"
"chr5","47101300","47101605","chr6","66604688","66604993","13","19503388"
"chr5","47142406","47142627","chr6","66563170","66563394","14","19420764"
"chr5","47147961","47148133","chr6","66557528","66557699","9","19409567"
"chr5","47249629","47249904","chr6","66452742","66453013","32","19203113"
"chr5","47294974","47295284","chr6","66408024","66408330","27","19113050"
"chr5","47358554","47358692","chr2","203169966","203170091","31","155811412"
"chr5","47359005","47359187","chr15","50715278","50715460","41","3356273"
"chr5","47390490","47390597","chr5","1889927","1890031","11","45500563"
"chr5","47392166","47392322","chr7","80140173","80140333","29","32748007"
"chr5","47451461","47451585","chr6","66255112","66255236","5","18803651"
"chr5","47480925","47481037","chr6","66233511","66233627","20","18752586"
"chr5","47485475","47485565","chr6","66228061","66228151","6","18742586"
"chr5","47536202","47536316","chr19","12616527","12616642","18","34919675"
"chr5","47541609","47541989","chr14","70576619","70576993","105","23035010"
"chr5","47561180","47561478","chr6","66149192","66149498","30","18588012"
"chr5","47848798","47849083","chr13","43681726","43682012","61","4167072"
"chr5","48118973","48119245","chr6","69305372","69305652","58","21186399"
"chr5","48287016","48287291","chr12","83006376","83006658","62","34719360"
"chr5","48297256","48297562","chr6","65455739","65456018","45","17158483"
"chr5","48313003","48313229","chr6","65439954","65440193","34","17126951"
"chr5","48338892","48339176","chr6","65419293","65419563","48","17080401"
"chr5","48393949","48394250","chr1","31594185","31594487","65","16799764"
"chr5","48505500","48505755","chr6","65253862","65254124","18","16748362"
"chr5","48518846","48519131","chr6","65240601","65240894","25","16721755"
"chr5","48572879","48573159","chr6","65185132","65185412","21","16612253"
"chr5","48576918","48577201","chr6","65181530","65181809","17","16604612"
"chr5","48707558","48707853","chr6","65047633","65047927","14","16340075"
"chr5","48951314","48951600","chr3","36897369","36897664","57","12053945"
"chr5","48953929","48954045","chr6","64806762","64806878","12","15852833"
"chr5","49009104","49009404","chr6","64746878","64747188","26","15737774"
"chr5","49033051","49033309","chr6","64723105","64723363","19","15690054"
"chr5","49077540","49077833","chr6","64679557","64679841","28","15602017"
"chr5","49107954","49108248","chr6","64649033","64649326","23","15541079"
"chr5","49137982","49138286","chr6","64625334","64625633","30","15487352"
"chr5","49270932","49271207","chr6","64489349","64489643","36","15218417"
"chr5","49311265","49311555","chr15","29472469","29472762","53","19838796"
"chr5","49352341","49352641","chr6","64410061","64410366","28","15057720"
"chr5","49358292","49358422","chr6","64404283","64404413","9","15045991"
"chr5","49365723","49366020","chr6","64396682","64396979","39","15030959"
"chr5","49373652","49373797","chr6","64389246","64389391","9","15015594"
"chr5","49429178","49429440","chr6","64333694","64333953","24","14904516"
"chr5","49438222","49438521","chr6","64309390","64309687","25","14871168"
"chr5","49451078","49451365","chr6","64296222","64296486","48","14845144"
"chr5","49584942","49585063","chr6","64266097","64266202","19","14681155"
"chr5","49595870","49596163","chr6","64255484","64255778","21","14659614"
"chr5","49601709","49601829","chr16","23266280","23266408","38","26335429"
"chr5","49601859","49601981","chr7","111886785","111886905","21","62284926"
"chr5","49602068","49602246","chr19","5010399","5010579","48","44591669"
"chr5","49605023","49605149","chr4","171202515","171202637","17","121597492"
"chr5","49624404","49624702","chr6","64233352","64233630","31","14608948"
"chr5","49633515","49633817","chr6","64223819","64224129","39","14590304"
"chr5","49638756","49639059","chr6","64212798","64213112","43","14574042"
"chr5","49653621","49653826","chr6","64197951","64198148","22","14544330"
"chr5","49665216","49665534","chr6","64188311","64188630","39","14523095"
"chr5","49681044","49681339","chr6","64170541","64170835","17","14489497"
"chr5","49693551","49693735","chr13","47508388","47508574","38","2185163"
"chr5","49696808","49697092","chr6","64152749","64153021","33","14455941"
"chr5","49729479","49729784","chr6","64120868","64121170","23","14391389"
"chr5","49732410","49732703","chr6","64117915","64118210","20","14385505"
"chr5","49746343","49746467","chr6","64103366","64103490","7","14357023"
"chr5","49752728","49752993","chr6","64096854","64097126","26","14344126"
"chr5","49772414","49772741","chr1","92171743","92172039","74","42399329"
"chr5","49773274","49773583","chr6","147432797","147433108","64","97659523"
"chr5","49787715","49787964","chrX","148305511","148305763","52","98517796"
"chr5","49790744","49790835","chr1","125506105","125506195","21","75715361"
"chr5","49797760","49798073","chr6","64049872","64050161","43","14252112"
"chr5","49801731","49802008","chr3","175882376","175882650","70","126080645"
"chr5","49802133","49802381","chr8","92687825","92688073","51","42885692"
"chr5","49805233","49805529","chr6","64029446","64029753","29","14224213"
"chr5","49809415","49809732","chr6","64025483","64025800","25","14216068"
"chr5","49849489","49849779","chr6","63985783","63986077","36","14136294"
"chr5","49875119","49875354","chr9","99448116","99448346","48","49572997"
"chr5","49900931","49901225","chr6","63933230","63933523","20","14032299"
"chr5","49903505","49903796","chr6","63930718","63931009","21","14027213"
"chr5","49904943","49905065","chr6","63929454","63929576","7","14024511"
"chr5","49933039","49933329","chr6","63902173","63902458","24","13969134"
"chr5","49956860","49957179","chr6","137838156","137838473","64","87881296"
"chr5","50001417","50001706","chr6","63831029","63831307","26","13829612"
"chr5","50010015","50010265","chr6","63822549","63822798","16","13812534"
"chr5","50018403","50018612","chr6","63811596","63811777","40","13793193"
"chr5","50019529","50019846","chr6","63810368","63810669","35","13790839"
"chr5","50020877","50021007","chr6","63809178","63809298","21","13788301"
"chr5","50021589","50021884","chr6","63808297","63808582","43","13786708"
"chr5","50040125","50040365","chr6","63789598","63789844","18","13749473"
"chr5","50065431","50065586","chr2","203979349","203979507","37","153913918"
"chr5","50065892","50066032","chr20","29019238","29019383","26","21046654"
"chr5","50077166","50077460","chr6","63751741","63752032","19","13674575"
"chr5","50079542","50079833","chr6","63749473","63749774","35","13669931"
"chr5","50129461","50129600","chr6","63692808","63692947","8","13563347"
"chr5","50137607","50137910","chr6","63686212","63686514","24","13548605"
"chr5","50150448","50150755","chr6","63662396","63662705","14","13511948"
"chr5","50156026","50156169","chr5","97114497","97114620","35","46958471"
"chr5","50169186","50169242","chr6","32209322","32209376","16","17959864"
"chr5","50170516","50170627","chr3","36910901","36911011","34","13259615"
"chr5","50184967","50185089","chr6","63629156","63629278","7","13444189"
"chr5","50254339","50254632","chr6","63553303","63553613","34","13298964"
"chr5","50285399","50285569","chr9","7029404","7029573","39","43255995"
"chr5","50354844","50355118","chr1","13605985","13606264","55","36748859"
"chr5","50365087","50365376","chr6","63439690","63439988","29","13074603"
"chr5","50422606","50422888","chr6","63381541","63381822","17","12958935"
"chr5","50445590","50445877","chr6","63357835","63358127","26","12912245"
"chr5","50521886","50522195","chr1","94546171","94546474","55","44024285"
"chr5","50565329","50565637","chr6","63248748","63249060","27","12683419"
"chr5","50572059","50572177","chr15","6939814","6939933","21","43632245"
"chr5","50599368","50599573","chr19","42426407","42426603","34","8172961"
"chr5","50670593","50670853","chr6","63143699","63143962","19","12473106"
"chr5","50710702","50711024","chr6","63103535","63103849","29","12392833"
"chr5","50790803","50791087","chr6","63015133","63015405","28","12224330"
"chr5","50899659","50899952","chr6","62917553","62917849","20","12017894"
"chr5","50922784","50923051","chr6","62894964","62895242","32","11972180"
"chr5","50926463","50926759","chr6","62891175","62891436","52","11964712"
"chr5","50996279","50996473","chr6","62821023","62821204","27","11824744"
"chr5","50996850","50996953","chr6","62820543","62820646","3","11823693"
"chr5","51044848","51044981","chr6","62765681","62765812","12","11720833"
"chr5","51059904","51060191","chr6","62750726","62751022","25","11690822"
"chr5","51105145","51105446","chr6","62700733","62701031","34","11595588"
"chr5","51133715","51133933","chr7","127063719","127063934","50","75930004"
"chr5","51197926","51198229","chr11","117954914","117955214","68","66756988"
"chr5","51293682","51293925","chr7","49378464","49378703","54","1915218"
"chr5","51312588","51312882","chr6","62495959","62496247","41","11183371"
"chr5","51375074","51375199","chr6","62419740","62419862","12","11044666"
"chr5","51404539","51404773","chr4","33679870","33680118","66","17724669"
"chr5","51420920","51421223","chr12","19505062","19505360","63","31915858"
"chr5","51427654","51427944","chr6","62363642","62363932","19","10935988"
"chr5","51455083","51455403","chr6","62338054","62338374","18","10882971"
"chr5","51613189","51613478","chr6","62194860","62195165","48","10581671"
"chr5","51727663","51727990","chr6","62070741","62071035","62","10343078"
"chr5","51783590","51783697","chr2","57949950","57950058","31","6166360"
"chr5","51783743","51783897","chr11","3089756","3089899","44","48693987"
"chr5","51828175","51828456","chr6","61913564","61913868","46","10085389"
"chr5","51976076","51976318","chr6","61728075","61728310","31","9751999"
"chr5","52009031","52009340","chr2","122664478","122664783","59","70655447"
"chr5","52093341","52093624","chr6","61621179","61621469","32","9527838"
"chr5","52176936","52177222","chr6","61468745","61469034","19","9291809"
"chr5","52192065","52192352","chr6","61453816","61454113","20","9261751"
"chr5","52668905","52669190","chr6","60916742","60917012","51","8247837"
"chr5","52676351","52676659","chr6","60908176","60908475","37","8231825"
"chr5","52766750","52767039","chr6","60802916","60803202","26","8036166"
"chr5","52831312","52831603","chr6","60739356","60739685","59","7908044"
"chr5","52888412","52888619","chr6","60689355","60689561","20","7800943"
"chr5","52897995","52898133","chr8","30030491","30030626","25","22867504"
"chr5","52898442","52898597","chr7","53405319","53405470","30","506877"
"chr5","52898736","52899007","chr14","56171846","56172114","55","3273110"
"chr5","52957526","52957806","chr6","60619239","60619526","19","7661713"
"chr5","53029819","53030115","chr6","60544781","60545062","59","7514962"
"chr5","53054783","53055088","chr6","60518526","60518833","25","7463743"
"chr5","53086661","53086883","chr19","39508144","39508357","62","13578517"
"chr5","53087389","53087535","chr6","60480295","60480441","8","7392906"
"chr5","53087846","53087989","chr6","60479832","60479984","19","7391986"
"chr5","53108592","53108861","chr6","60461950","60462218","23","7353358"
"chr5","53116871","53117154","chr6","60453215","60453498","19","7336344"
"chr5","53138626","53138907","chr20","68282066","68282348","58","15143440"
"chr5","53141648","53141938","chr7","81730787","81731078","66","28589139"
"chr5","53153520","53153823","chr12","11730535","11730844","63","41422985"
"chr5","53171136","53171418","chr6","60394718","60394983","25","7223582"
"chr5","53175682","53175973","chr6","60389550","60389841","20","7213868"
"chr5","53181688","53181957","chr6","60383760","60384021","24","7202072"
"chr5","53186187","53186386","chr10","85040491","85040692","44","31854304"
"chr5","53190295","53190604","chr6","60374969","60375268","31","7184674"
"chr5","53203678","53203936","chr6","60363425","60363680","21","7159747"
"chr5","53208443","53208663","chr20","26028650","26028871","46","27179793"
"chr5","53214282","53214574","chr15","110722653","110722939","72","57508371"
"chr5","53219011","53219299","chr6","60344480","60344781","32","7125469"
"chr5","53238134","53238258","chr6","60325943","60326074","14","7087809"
"chr5","53238265","53238558","chr6","60325647","60325940","26","7087382"
"chr5","53256030","53256239","chr6","60308516","60308718","19","7052486"
"chr5","53256614","53256887","chr6","60307871","60308145","19","7051257"
"chr5","53264251","53264527","chr6","60300053","60300328","28","7035802"
"chr5","53267196","53267479","chr6","60297128","60297405","25","7029932"
"chr5","53296521","53296812","chr6","60266825","60267135","41","6970304"
"chr5","53300268","53300542","chr6","60263012","60263295","34","6962744"
"chr5","53323913","53324203","chr6","60239164","60239417","49","6915251"
"chr5","53324297","53324580","chr6","60238786","60239070","19","6914489"
"chr5","53382859","53383067","chr6","60186148","60186346","25","6803289"
"chr5","53383808","53384108","chr7","36331166","36331462","54","17052642"
"chr5","53397783","53398068","chr6","60170764","60171060","24","6772981"
"chr5","53433451","53433729","chr6","60127051","60127323","20","6693600"
"chr5","53454309","53454619","chr6","60109411","60109721","22","6655102"
"chr5","53457194","53457505","chr6","60106645","60106978","49","6649451"
"chr5","53482847","53483139","chr6","60080760","60081045","19","6597913"
"chr5","53517282","53517572","chr6","60039338","60039616","25","6522056"
"chr5","53740486","53740719","chr6","59810888","59811123","25","6070402"
"chr5","54056023","54056328","chr6","59484578","59484885","27","5428555"
"chr5","54057360","54057671","chr3","123903117","123903425","65","69845757"
"chr5","54059819","54059940","chr6","59480600","59480720","8","5420781"
"chr5","54072520","54072752","chr2","51041029","51041254","66","3031491"
"chr5","54084969","54085244","chr6","59454091","59454366","18","5369122"
"chr5","54212299","54212595","chr6","59324963","59325250","49","5112664"
"chr5","54213187","54213481","chr6","59324070","59324362","38","5110883"
"chr5","54253635","54253835","chr10","17041385","17041582","34","37212250"
"chr5","54261654","54261963","chr6","59276361","59276672","29","5014707"
"chr5","54270619","54270910","chr6","59267738","59268031","23","4997119"
"chr5","54271204","54271498","chr6","59267150","59267444","21","4995946"
"chr5","54328375","54328653","chr6","59205578","59205856","21","4877203"
"chr5","54332669","54332958","chr6","59201265","59201556","25","4868596"
"chr5","54334131","54334437","chr11","108648988","108649295","63","54314857"
"chr5","54334499","54334727","chr15","106725050","106725273","58","52390551"
"chr5","54354601","54354719","chr2","99335925","99336042","21","44981324"
"chr5","54354745","54354903","chr16","61633928","61634086","31","7279183"
"chr5","54361341","54361498","chr6","59171972","59172142","25","4810631"
"chr5","54361806","54361929","chr6","59171542","59171660","10","4809736"
"chr5","54365882","54366197","chr6","59167212","59167523","27","4801330"
"chr5","54381605","54381948","chr6","59151606","59151965","40","4770001"
"chr5","54386421","54386714","chr6","59146221","59146526","38","4759800"
"chr5","54402302","54402591","chr6","59131342","59131630","15","4729040"
"chr5","54472209","54472517","chr6","59060779","59061085","22","4588570"
"chr5","54480919","54481108","chr19","5653378","5653561","40","48827541"
"chr5","54481376","54481511","chr2","203172934","203173060","30","148691558"
"chr5","54520314","54520604","chr6","59015189","59015479","21","4494875"
"chr5","54551729","54552043","chr6","58975892","58976208","25","4424163"
"chr5","54583616","54583873","chr6","58945249","58945492","24","4361633"
"chr5","54592184","54592309","chr1","156177310","156177433","24","101585126"
"chr5","54633763","54634088","chr6","58897604","58897916","26","4263841"
"chr5","54660208","54660499","chr6","6301868","6302166","65","48358340"
"chr5","54707444","54707749","chr8","51532421","51532722","57","3175023"
"chr5","54709462","54709743","chr6","58824312","58824594","18","4114850"
"chr5","54754100","54754397","chr6","50577377","50577673","18","4176723"
"chr5","54781311","54781491","chrX","63599804","63599994","45","8818493"
"chr5","54782686","54782806","chr6","50565412","50565532","5","4217274"
"chr5","54790903","54791084","chr6","50557314","50557488","14","4233589"
"chr5","54793105","54793397","chr6","50554735","50555022","18","4238370"
"chr5","54805527","54805837","chr6","50542327","50542616","40","4263200"
"chr5","54839625","54839915","chr6","50502814","50503112","27","4336811"
"chr5","54902717","54902827","chr6","50440274","50440384","13","4462443"
"chr5","54930380","54930657","chr7","96729510","96729798","75","41799130"
"chr5","54932770","54933021","chr6","50409006","50409256","20","4523764"
"chr5","54965992","54966214","chr2","50329372","50329593","54","4636620"
"chr5","55034475","55034752","chr6","50304376","50304658","26","4730099"
"chr5","55051637","55051888","chr6","50267365","50267618","12","4784272"
"chr5","55072642","55072909","chr1","5819632","5819900","64","49253010"
"chr5","55145712","55146017","chr6","50171517","50171814","39","4974195"
"chr5","55174021","55174333","chr6","50141847","50142120","66","5032174"
"chr5","55240796","55240971","chr16","74403178","74403342","42","19162382"
"chr5","55285420","55285705","chr6","50023188","50023486","33","5262232"
"chr5","55510472","55510787","chr6","49793063","49793378","24","5717409"
"chr5","55733044","55733345","chr13","104243011","104243306","64","48509967"
"chr5","55871037","55871336","chr6","49434586","49434884","24","6436451"
"chr5","55921468","55921740","chr6","49385513","49385786","30","6535955"
"chr5","55947762","55947966","chr5","2023599","2023790","44","53924163"
"chr5","56070408","56070629","chr6","49240049","49240274","22","6830359"
"chr5","56202367","56202618","chr6","49105106","49105356","14","7097261"
"chr5","56223267","56223545","chr6","49084265","49084558","37","7139002"
"chr5","56296634","56296909","chr6","49010200","49010478","44","7286434"
"chr5","56392097","56392393","chr6","48913361","48913643","31","7478736"
"chr5","56394769","56395029","chr2","136677280","136677549","68","80282511"
"chr5","56437244","56437543","chr6","48862805","48863114","32","7574439"
"chr5","56441925","56442057","chr6","48858247","48858379","4","7583678"
"chr5","56462120","56462327","chr6","48838796","48838987","40","7623324"
"chr5","56474095","56474374","chr6","48827011","48827292","14","7647084"
"chr5","56484208","56484349","chr6","48817482","48817598","27","7666726"
"chr5","56524727","56524997","chr6","48775832","48776097","20","7748895"
"chr5","56546131","56546437","chr6","48754388","48754697","23","7791743"
"chr5","56557326","56557637","chr6","48744176","48744453","55","7813150"
"chr5","56565051","56565310","chr6","5625440","5625688","65","50939611"
"chr5","56638251","56638567","chr6","48668424","48668734","21","7969827"
"chr5","56721004","56721128","chr6","48579896","48580020","7","8141108"
"chr5","56735226","56735533","chr6","48567796","48568104","39","8167430"
"chr5","56815311","56815609","chr6","48475245","48475562","36","8340066"
"chr5","56938191","56938491","chr6","48344422","48344731","36","8593769"
"chr5","57065898","57066015","chr6","48214411","48214525","19","8851487"
"chr5","57113899","57114113","chr6","48180985","48181206","36","8932914"
"chr5","57115869","57116043","chr6","48179058","48179233","12","8936811"
"chr5","57133369","57133684","chr6","48162057","48162372","19","8971312"
"chr5","57133696","57133819","chr6","48161922","48162045","11","8971774"
"chr5","57189215","57189490","chr6","48098688","48098963","40","9090527"
"chr5","57196652","57196931","chr6","48091219","48091507","43","9105433"
"chr5","57237344","57237458","chr13","46512186","46512305","18","10725158"
"chr5","57247344","57247658","chr6","48035991","48036296","38","9211353"
"chr5","57275780","57276069","chr6","48011382","48011679","29","9264398"
"chr5","57322298","57322375","chr6","47965239","47965316","6","9357059"
"chr5","57379880","57380185","chr6","47914409","47914721","28","9465471"
"chr5","57716269","57716568","chr6","47591520","47591820","19","10124749"
"chr5","57735576","57735861","chr6","47572955","47573248","32","10162621"
"chr5","57757242","57757547","chr6","47547686","47547982","29","10209556"
"chr5","57919536","57919821","chr6","58739207","58739488","45","819671"
"chr5","58247277","58247369","chr6","58389081","58389172","7","141804"
"chr5","58276396","58276684","chr6","58357964","58358251","30","81568"
"chr5","58279089","58279322","chr6","58355314","58355547","15","76225"
"chr5","58279422","58279727","chr14","66461558","66461851","65","8182136"
"chr5","58295153","58295468","chr6","58345195","58345511","23","50042"
"chr5","58342101","58342382","chr6","58297940","58298215","24","44161"
"chr5","58344156","58344418","chr11","32824995","32825253","60","25519161"
"chr5","58360464","58360586","chr6","58279160","58279282","4","81304"
"chr5","58389608","58389880","chr6","58249554","58249835","22","140054"
"chr5","58393645","58393935","chr6","58245365","58245670","35","148280"
"chr5","58396063","58396192","chr7","16781339","16781468","20","41614724"
"chr5","58397360","58397648","chr6","58242002","58242294","35","155358"
"chr5","58403041","58403162","chr6","58236855","58236965","17","166186"
"chr5","58405296","58405379","chr6","58234695","58234775","7","170601"
"chr5","58413114","58413283","chr6","58227535","58227704","13","185579"
"chr5","58413578","58413678","chr6","58227126","58227229","3","186452"
"chr5","58430569","58430811","chr6","58208972","58209222","23","221597"
"chr5","58431614","58431922","chr7","117182322","117182628","67","58750708"
"chr5","58441340","58441463","chr6","58198048","58198174","18","243292"
"chr5","58450704","58450978","chr1","161210396","161210672","69","102759692"
"chr5","58451170","58451443","chr6","58189793","58190070","19","261377"
"chr5","58456228","58456515","chr6","58187066","58187340","34","269162"
"chr5","58472675","58472796","chr13","43376362","43376486","19","15096313"
"chr5","58478874","58479100","chr6","58160911","58161173","54","317963"
"chr5","58479394","58479452","chr6","58160559","58160625","10","318835"
"chr5","58500058","58500353","chr4","71200248","71200539","53","12700190"
"chr5","58502448","58502752","chr13","96945466","96945763","57","38443018"
"chr5","58504696","58504808","chr6","58131496","58131601","14","373200"
"chr5","58511316","58511434","chr7","130249121","130249241","26","71737805"
"chr5","58515570","58515851","chr6","58120288","58120593","34","395282"
"chr5","58515864","58515987","chr6","58120152","58120275","5","395712"
"chr5","58519665","58519939","chr6","58116228","58116509","26","403437"
"chr5","58521023","58521314","chr6","58114582","58114878","23","406441"
"chr5","58528333","58528492","chr5","80309807","80309962","39","21781474"
"chr5","58532571","58532830","chr6","58101174","58101431","13","431397"
"chr5","58565267","58565397","chrX","12403505","12403640","23","46161762"
"chr5","58570081","58570207","chr6","58058405","58058534","10","511676"
"chr5","58574609","58574909","chr9","128228335","128228636","65","69653726"
"chr5","58580225","58580522","chr6","58047673","58047975","28","532552"
"chr5","58581868","58582180","chr6","58046006","58046318","19","535862"
"chr5","58630845","58630975","chr6","57992798","57992929","6","638047"
"chr5","58643501","58643624","chr2","165531071","165531193","16","106887570"
"chr5","58696729","58697025","chr6","57924287","57924583","19","772442"
"chr5","58704941","58705227","chr6","57916117","57916403","14","788824"
"chr5","58728384","58728513","chr4","114936919","114937049","17","56208535"
"chr5","58750674","58750963","chr1","191690399","191690678","60","132939725"
"chr5","58754667","58754971","chr10","81908379","81908683","58","23153712"
"chr5","58758536","58758820","chr6","57864118","57864385","27","894418"
"chr5","58775311","58775587","chr5","150176450","150176736","61","91401139"
"chr5","58830517","58830825","chr6","57793521","57793806","50","1036996"
"chr5","59026886","59027142","chr3","39780463","39780719","59","19246423"
"chr5","59070736","59071031","chr6","57552715","57553010","27","1518021"
"chr5","59104138","59104420","chr6","57517125","57517406","15","1587013"
"chr5","59214191","59214488","chr6","57413159","57413459","18","1801032"
"chr5","59231146","59231358","chr16","31100169","31100379","46","28130977"
"chr5","59352322","59352613","chr6","57269451","57269743","17","2082871"
"chr5","59355470","59355742","chr6","57265357","57265666","62","2090113"
"chr5","59450148","59450226","chr6","57169709","57169787","3","2280439"
"chr5","59484287","59484567","chr6","57133273","57133552","26","2351014"
"chr5","59510820","59511023","chr6","57107190","57107406","23","2403630"
"chr5","59535024","59535325","chr6","57075519","57075842","40","2459505"
"chr5","59539794","59540092","chr6","57069949","57070248","21","2469845"
"chr5","59543150","59543441","chr6","57066312","57066609","15","2476838"
"chr5","59557749","59557957","chr3","64798344","64798549","56","5240595"
"chr5","59561655","59561813","chr6","57046484","57046635","15","2515171"
"chr5","59567787","59568084","chr17","11251715","11252011","51","48316072"
"chr5","59572959","59573253","chr6","57034380","57034633","56","2538579"
"chr5","59575204","59575475","chr6","57032148","57032420","14","2543056"
"chr5","59591541","59591723","chr6","57016453","57016606","36","2575088"
"chr5","59592006","59592137","chr6","57015999","57016132","13","2576007"
"chr5","59612796","59612998","chr10","20780100","20780302","40","38832696"
"chr5","59613748","59613861","chr2","107613237","107613354","21","47999489"
"chr5","59628803","59629097","chr9","108803591","108803880","58","49174788"
"chr5","59640437","59640663","chr6","56971223","56971475","37","2669214"
"chr5","59649295","59649573","chr6","56914438","56914696","38","2734857"
"chr5","59656718","59656926","chr9","7205731","7205929","54","52450987"
"chr5","59666688","59666813","chr1","40596416","40596539","22","19070272"
"chr5","59675271","59675532","chr6","56889483","56889745","23","2785788"
"chr5","59682781","59683050","chr6","56881962","56882234","15","2800819"
"chr5","59691884","59692152","chr6","56872912","56873180","19","2818972"
"chr5","59712538","59712743","chr6","56851729","56851946","30","2860809"
"chr5","59714646","59714931","chr6","56849530","56849822","37","2865116"
"chr5","59718999","59719290","chr6","56845248","56845540","18","2873751"
"chr5","59760680","59760939","chr6","56806404","56806661","23","2954276"
"chr5","59768484","59768612","chr6","56798738","56798856","17","2969746"
"chr5","59789705","59789943","chr6","56776977","56777217","29","3012728"
"chr5","59803021","59803145","chr6","56763863","56763987","6","3039158"
"chr5","59849964","59850261","chr6","56724683","56724984","31","3125281"
"chr5","59853530","59853815","chr2","79867873","79868159","56","20014343"
"chr5","59860588","59860870","chr6","56713533","56713807","26","3147055"
"chr5","59871578","59871704","chr6","56703097","56703217","10","3168481"
"chr5","59874579","59874877","chr6","56699225","56699521","22","3175354"
"chr5","59889853","59890105","chr6","56683181","56683434","26","3206672"
"chr5","59912431","59912677","chrX","40343416","40343660","55","19569015"
"chr5","59912678","59912787","chr1","192596603","192596713","17","132683925"
"chr5","59921992","59922274","chr17","54072119","54072406","48","5849873"
"chr5","59922619","59922905","chr6","56650228","56650503","30","3272391"
"chr5","59935002","59935310","chr6","56640833","56641143","20","3294169"
"chr5","59941275","59941525","chr6","56634848","56635098","21","3306427"
"chr5","59944288","59944603","chr6","56631690","56631992","24","3312598"
"chr5","59945909","59946203","chr7","4300419","4300706","46","55645490"
"chr5","59949500","59949800","chr6","56626473","56626776","34","3323027"
"chr5","59952257","59952481","chr14","9611892","9612110","48","50340365"
"chr5","59955981","59956087","chr6","56620079","56620187","7","3335902"
"chr5","59963892","59964153","chr6","56612417","56612670","49","3351475"
"chr5","59991825","59992115","chr6","56583467","56583753","32","3408358"
"chr5","60026670","60026969","chr6","56546340","56546631","26","3480330"
"chr5","60038440","60038749","chr11","1681484","1681802","72","58356956"
"chr5","60048544","60048852","chr6","56519380","56519686","29","3529164"
"chr5","60091010","60091130","chr3","41083650","41083777","23","19007360"
"chr5","60104217","60104478","chr1","64982098","64982383","43","4877881"
"chr5","60138959","60139264","chr6","17055189","17055493","59","43083770"
"chr5","60147849","60147967","chr3","47446311","47446428","14","12701538"
"chr5","60155809","60156104","chr6","56415197","56415490","21","3740612"
"chr5","60160190","60160398","chr16","50336285","50336494","43","9823905"
"chr5","60219675","60219989","chrX","9079091","9079400","67","51140584"
"chr5","60220775","60221075","chr1","22392281","22392567","70","37828494"
"chr5","60226301","60226617","chr6","56347111","56347419","38","3879190"
"chr5","60254827","60255146","chr6","56310881","56311194","21","3943946"
"chr5","60269135","60269444","chr6","56298970","56299272","28","3970165"
"chr5","60299408","60299681","chr6","56272633","56272904","14","4026775"
"chr5","60367514","60367710","chr6","56196358","56196554","13","4171156"
"chr5","60378076","60378360","chr6","56184493","56184780","31","4193583"
"chr5","60383852","60384081","chr6","56178120","56178352","16","4205732"
"chr5","60385590","60385871","chr6","56176046","56176330","28","4209544"
"chr5","60393639","60393889","chr6","56167398","56167626","43","4226241"
"chr5","60411807","60412095","chr6","56149440","56149733","28","4262367"
"chr5","60451238","60451568","chr20","22527807","22528136","76","37923431"
"chr5","60464451","60464654","chr6","56095484","56095688","12","4368967"
"chr5","60480254","60480544","chr6","56078741","56079030","16","4401513"
"chr5","60556499","60556760","chr4","115129767","115130025","51","54573268"
"chr5","60580299","60580592","chr6","55992123","55992416","27","4588176"
"chr5","60621245","60621536","chr6","55944757","55945030","41","4676488"
"chr5","60726383","60726669","chr6","55846718","55847002","32","4879665"
"chr5","60812700","60812877","chr6","55758193","55758359","21","5054507"
"chr5","60942792","60942981","chr6","55630470","55630651","26","5312322"
"chr5","60989008","60989124","chr6","55585943","55586057","15","5403065"
"chr5","61033069","61033337","chr6","136981423","136981690","62","75948354"
"chr5","61038276","61038362","chr11","49586469","49586557","13","11451807"
"chr5","61056408","61056727","chr15","84858906","84859223","66","23802498"
"chr5","61057807","61058059","chr6","55507763","55508006","46","5550044"
"chr5","61062541","61062843","chr6","55503245","55503544","23","5559296"
"chr5","61082230","61082503","chr6","55488668","55488941","21","5593562"
"chr5","61086149","61086453","chr12","120705770","120706089","70","59619621"
"chr5","61125883","61126169","chrX","123574210","123574485","58","62448327"
"chr5","61137711","61138028","chrX","48014954","48015278","71","13122757"
"chr5","61149121","61149163","chr1","62095384","62095431","15","946263"
"chr5","61150258","61150338","chr2","159145447","159145525","21","97995189"
"chr5","61150631","61150739","chr9","100211242","100211350","28","39060611"
"chr5","61178759","61179024","chr6","55395809","55396076","21","5782950"
"chr5","61180802","61181043","chr6","55395092","55395358","46","5785710"
"chr5","61181083","61181200","chr6","55394940","55395052","12","5786143"
"chr5","61192380","61192655","chr1","35572808","35573075","66","25619572"
"chr5","61202595","61202873","chr1","109965830","109966104","62","48763235"
"chr5","61270106","61270445","chr6","55312740","55313069","47","5957366"
"chr5","61300926","61301230","chr2","160551205","160551504","55","99250279"
"chr5","61302299","61302598","chr6","55280088","55280398","27","6022211"
"chr5","61324175","61324447","chr6","55258611","55258897","44","6065564"
"chr5","61373131","61373426","chr6","55208559","55208869","34","6164572"
"chr5","61460839","61461145","chr6","55116598","55116894","24","6344241"
"chr5","61476286","61476575","chr6","55100887","55101176","17","6375399"
"chr5","61605045","61605249","chr14","67069127","67069326","51","5464082"
"chr5","61612871","61613127","chr6","54962235","54962502","34","6650636"
"chr5","61614073","61614363","chr6","54961004","54961297","32","6653069"
"chr5","61618657","61618816","chr6","54956351","54956509","9","6662306"
"chr5","61619146","61619280","chr6","54955878","54956012","7","6663268"
"chr5","61619795","61620107","chr6","54955074","54955381","28","6664721"
"chr5","61653474","61653598","chr3","57790746","57790867","19","3862728"
"chr5","61660134","61660304","chr15","8429087","8429254","33","53231047"
"chr5","61660332","61660346","chr16","10807250","10807262","2","50853082"
"chr5","61660630","61660781","chr6","132642897","132643047","28","70982267"
"chr5","61668890","61669188","chr6","54902394","54902689","33","6766496"
"chr5","61677644","61677809","chr6","54896624","54896780","29","6781020"
"chr5","61678112","61678166","chr6","54896280","54896334","6","6781832"
"chr5","61701036","61701169","chr15","50566021","50566155","21","11135015"
"chr5","61725439","61725744","chr1","188627840","188628135","68","126902401"
"chr5","61725766","61726058","chr6","54844938","54845216","34","6880828"
"chr5","61737958","61738257","chr6","54833136","54833434","19","6904822"
"chr5","61758339","61758637","chr6","54811727","54812028","40","6946612"
"chr5","61812026","61812121","chr9","87007160","87007252","13","25195134"
"chr5","61813591","61813622","chr5","55395637","55395664","7","6417954"
"chr5","61827037","61827325","chr1","19518491","19518784","60","42308546"
"chr5","61901188","61901386","chr6","54664776","54664977","16","7236412"
"chr5","61925884","61925998","chr6","54640273","54640389","7","7285611"
"chr5","62002219","62002521","chr6","54565517","54565832","30","7436702"
"chr5","62024476","62024747","chr14","49696634","49696902","68","12327842"
"chr5","62075166","62075478","chr9","128201896","128202202","66","66126730"
"chr5","62075783","62076079","chr6","54492269","54492577","36","7583514"
"chr5","62149924","62150262","chr19","14618763","14619084","78","47531161"
"chr5","62201057","62201375","chr6","54371205","54371525","26","7829852"
"chr5","62206296","62206551","chr6","54365908","54366165","23","7840388"
"chr5","62268767","62269065","chr6","54292640","54292937","23","7976127"
"chr5","62304027","62304295","chr6","54256619","54256890","16","8047408"
"chr5","62416181","62416473","chr6","54138391","54138670","35","8277790"
"chr5","62525444","62525722","chr11","109186448","109186735","57","46661004"
"chr5","62584178","62584459","chr6","53960356","53960636","14","8623822"
"chr5","62620907","62621209","chr6","53925837","53926144","32","8695070"
"chr5","62626183","62626436","chr6","53920611","53920864","12","8705572"
"chr5","62647227","62647426","chr12","98603527","98603705","51","35956300"
"chr5","62664097","62664381","chr6","53882113","53882407","34","8781984"
"chr5","63200851","63201096","chr6","53345283","53345528","12","9855568"
"chr5","63215431","63215653","chr6","53327466","53327690","20","9887965"
"chr5","63251924","63252138","chr7","54769257","54769470","46","8482667"
"chr5","63268716","63269032","chr6","53272317","53272621","29","9996399"
"chr5","63392057","63392137","chr2","49688248","49688337","26","13703809"
"chr5","63396921","63397249","chr6","53139290","53139619","60","10257631"
"chr5","63532777","63533049","chr9","54470311","54470606","71","9062466"
"chr5","63590543","63590824","chr3","124049597","124049892","65","60459054"
"chr5","63671528","63671653","chr6","52757887","52758016","14","10913641"
"chr5","63734644","63734935","chr6","52688263","52688562","27","11046381"
"chr5","63783473","63783775","chr6","52641425","52641718","42","11142048"
"chr5","63797486","63797776","chr6","52626378","52626654","46","11171108"
"chr5","64147311","64147596","chr15","12046987","12047286","67","52100324"
"chr5","64278042","64278346","chr6","52122788","52123092","35","12155254"
"chr5","64282622","64282904","chr6","52118207","52118504","39","12164415"
"chr5","64285527","64285819","chr6","52115244","52115537","35","12170283"
"chr5","64325175","64325397","chr6","52078341","52078563","20","12246834"
"chr5","64640344","64640509","chr6","51749246","51749401","22","12891098"
"chr5","64738582","64738857","chr6","51656994","51657267","23","13081588"
"chr5","64743985","64744265","chr6","51651511","51651790","19","13092474"
"chr5","64750648","64750954","chr6","51644917","51645215","40","13105731"
"chr5","64896459","64896560","chr6","51500235","51500345","13","13396224"
"chr5","64899374","64899654","chr6","51496832","51497127","35","13402542"
"chr5","64930999","64931316","chr6","51464766","51465058","42","13466233"
"chr5","64936168","64936361","chr6","51455530","51455709","27","13480638"
"chr5","64942304","64942594","chr6","51448739","51449013","31","13493565"
"chr5","64952404","64952648","chr8","22085064","22085297","70","42867340"
"chr5","64954899","64954955","chr7","52435062","52435115","16","12519837"
"chr5","64977501","64977787","chr6","51413690","51413963","41","13563811"
"chr5","64981051","64981343","chr16","52940276","52940575","59","12040775"
"chr5","65024054","65024212","chr6","51359691","51359860","23","13664363"
"chr5","65031656","65031823","chr1","220512643","220512805","47","155480987"
"chr5","65057368","65057672","chr13","89488893","89489197","66","24431525"
"chr5","65060358","65060641","chr6","51326208","51326490","28","13734150"
"chr5","65083246","65083555","chr19","3500436","3500734","67","61582810"
"chr5","65115758","65116040","chr6","51273189","51273494","37","13842569"
"chr5","65231939","65232240","chr6","51099435","51099748","36","14132504"
"chr5","65250516","65250791","chr6","51074668","51074943","29","14175848"
"chr5","65262296","65262490","chr6","51053073","51053282","30","14209223"
"chr5","65288856","65289076","chr5","3113813","3114037","56","62175043"
"chr5","65301521","65301742","chr6","51030163","51030375","20","14271358"
"chr5","65334123","65334406","chr6","50994896","50995145","51","14339227"
"chr5","69523963","69524085","chr4","105553931","105554054","17","36029968"
"chr5","69662360","69662632","chr6","46829000","46829274","25","22833360"
"chr5","69684217","69684228","chr2","159752579","159752589","2","90068362"
"chr5","69684283","69684552","chr6","46813054","46813350","46","22871229"
"chr5","69702729","69702998","chr6","46786608","46786876","28","22916121"
"chr5","69745900","69746028","chr6","46726078","46726205","8","23019822"
"chr5","69777899","69778181","chr6","46680811","46681091","26","23097088"
"chr5","69823632","69823899","chr6","46614010","46614280","19","23209622"
"chr5","69848870","69849134","chr6","46594761","46595024","20","23254109"
"chr5","69855723","69856001","chr3","7179800","7180082","68","62675923"
"chr5","70014028","70014311","chr6","46442257","46442527","28","23571771"
"chr5","70033221","70033520","chr6","46422693","46422992","18","23610528"
"chr5","70163799","70164147","chr6","46302228","46302583","39","23861571"
"chr5","70365027","70365341","chr6","46038743","46039055","22","24326284"
"chr5","70508449","70508636","chr6","45874184","45874367","13","24634265"
"chr5","70559125","70559397","chr6","45826381","45826646","39","24732744"
"chr5","70614430","70614682","chr6","45769952","45770201","16","24844478"
"chr5","70693050","70693335","chr6","45702087","45702409","64","24990963"
"chr5","70881894","70882200","chr15","43687639","43687935","54","27194255"
"chr5","70893027","70893227","chr6","45492856","45493066","27","25400171"
"chr5","70930953","70931065","chr6","45444172","45444284","9","25486781"
"chr5","71048241","71048540","chr20","26132723","26133020","63","44915518"
"chr5","71087620","71087771","chr16","10109340","10109491","30","60978280"
"chr5","71089934","71090206","chr6","45281598","45281865","20","25808336"
"chr5","71095625","71095887","chr4","53264435","53264710","63","17831190"
"chr5","71592513","71592598","chr6","44623113","44623198","8","26969400"
"chr5","71622044","71622253","chr6","44595994","44596205","21","27026050"
"chr5","71820962","71821231","chr6","44373930","44374191","26","27447032"
"chr5","71830120","71830210","chr6","44357923","44358013","4","27472197"
"chr5","71880123","71880420","chr6","44308813","44309080","49","27571310"
"chr5","71913608","71913914","chr6","44279097","44279400","22","27634511"
"chr5","71925836","71926126","chr6","44267293","44267572","37","27658543"
"chr5","71936056","71936369","chr6","44258386","44258689","37","27677670"
"chr5","71942326","71942634","chr6","44252739","44253041","22","27689587"
"chr5","71945736","71946044","chr6","44249671","44249953","40","27696065"
"chr5","71964691","71964994","chr6","44228259","44228560","17","27736432"
"chr5","71967682","71967969","chr6","44225298","44225606","34","27742384"
"chr5","71970983","71971296","chr7","131691373","131691686","51","59720390"
"chr5","71972796","71973097","chr6","44219968","44220274","26","27752828"
"chr5","71988076","71988225","chr2","192894506","192894650","37","120906430"
"chr5","71988269","71988375","chr19","13318940","13319038","23","58669329"
"chr5","71998751","71998958","chr6","44194922","44195129","8","27803829"
"chr5","72008189","72008485","chr15","49826638","49826928","64","22181551"
"chr5","72024836","72025151","chr6","44172491","44172800","32","27852345"
"chr5","72037167","72037449","chr6","44161374","44161656","21","27875793"
"chr5","72043475","72043740","chr11","116532846","116533107","55","44489371"
"chr5","72044294","72044610","chr7","116518734","116519041","62","44474440"
"chr5","72046775","72047071","chr6","140245720","140246015","54","68198945"
"chr5","72067816","72067861","chr6","44130132","44130177","4","27937684"
"chr5","72068173","72068336","chr6","44129658","44129834","29","27938515"
"chr5","72136341","72136473","chr1","8744078","8744207","22","63392263"
"chr5","72170521","72170817","chr6","44036982","44037272","24","28133539"
"chr5","72197425","72197704","chrX","147476237","147476516","56","75278812"
"chr5","72221877","72222151","chr4","37321555","37321842","59","34900322"
"chr5","72230865","72231178","chr6","43976484","43976797","30","28254381"
"chr5","72255859","72255981","chr1","15925158","15925270","25","56330701"
"chr5","72274232","72274535","chr6","43923441","43923739","19","28350791"
"chr5","72297749","72297903","chr13","65549303","65549453","37","6748446"
"chr5","72301614","72301838","chr6","43895991","43896212","24","28405623"
"chr5","72322345","72322443","chr1","31679435","31679534","17","40642910"
"chr5","72325667","72325791","chr3","50115979","50116103","21","22209688"
"chr5","72336946","72337231","chr7","28923349","28923634","64","43413597"
"chr5","72377221","72377536","chr6","43674779","43675091","75","28702442"
"chr5","72386224","72386402","chr6","43732483","43732664","15","28653741"
"chr5","72386447","72386562","chr6","43732330","43732444","9","28654117"
"chr5","72395502","72395804","chr6","43723816","43724124","28","28671686"
"chr5","72396528","72396808","chr6","43722799","43723096","44","28673729"
"chr5","72420064","72420365","chr6","43801618","43801932","68","28618446"
"chr5","72424153","72424280","chr19","41505532","41505657","27","30918621"
"chr5","72425358","72425667","chr6","43686032","43686337","51","28739326"
"chr5","72453292","72453607","chr6","43687051","43687371","31","28766241"
"chr5","72454306","72454611","chr6","43686032","43686337","29","28768274"
"chr5","72465849","72466160","chr6","43674779","43675091","22","28791070"
"chr5","72467566","72467867","chr16","21430282","21430584","78","51037284"
"chr5","72472923","72473092","chr18","23621103","23621276","38","48851820"
"chr5","72473415","72473540","chr7","45670692","45670817","29","26802723"
"chr5","72481806","72482114","chr6","43659135","43659452","35","28822671"
"chr5","72489473","72489545","chr6","43657928","43658000","5","28831545"
"chr5","72538374","72538658","chr6","43596936","43597223","25","28941438"
"chr5","72583810","72583925","chr2","180652903","180653017","21","108069093"
"chr5","72704663","72704954","chr6","43432243","43432542","31","29272420"
"chr5","72859953","72860241","chr6","43214818","43215094","29","29645135"
"chr5","73120339","73120639","chr6","42961427","42961734","31","30158912"
"chr5","73155534","73155773","chr7","49378464","49378703","59","23777070"
"chr5","73159342","73159612","chr6","42865532","42865805","24","30293810"
"chr5","73339113","73339324","chr6","42676796","42677002","17","30662317"
"chr5","73484436","73484566","chr3","48085056","48085181","33","25399380"
"chr5","73508776","73509061","chr3","43111551","43111841","55","30397225"
"chr5","73527508","73527771","chr6","42505354","42505624","30","31022154"
"chr5","73544620","73544919","chr6","42489216","42489510","22","31055404"
"chr5","73639564","73639691","chr1","44177093","44177224","22","29462471"
"chr5","73687680","73687932","chr3","47322453","47322711","56","26365227"
"chr5","73711652","73711927","chr15","48250296","48250575","63","25461356"
"chr5","74131005","74131311","chr6","41897968","41898260","34","32233037"
"chr5","74286264","74286563","chr6","41726009","41726292","34","32560255"
"chr5","74310088","74310211","chr13","25546692","25546816","16","48763396"
"chr5","74440909","74441212","chr6","41563417","41563734","52","32877492"
"chr5","74515843","74515991","chr6","41480793","41480942","11","33035050"
"chr5","74516278","74516447","chr6","41480340","41480494","32","33035938"
"chr5","74527131","74527431","chr6","41469384","41469693","26","33057747"
"chr5","74534602","74534900","chr6","41460936","41461248","27","33073666"
"chr5","74554919","74555095","chr10","29091374","29091549","42","45463545"
"chr5","74565502","74565628","chr1","211231687","211231814","20","136666185"
"chr5","74576384","74576634","chr6","41413408","41413665","35","33162976"
"chr5","74588258","74588487","chr6","41400646","41400875","19","33187612"
"chr5","74589097","74589389","chr6","41399732","41400032","27","33189365"
"chr5","74597721","74597834","chr1","42795934","42796051","20","31801787"
"chr5","74620658","74620936","chr6","41366028","41366298","24","33254630"
"chr5","74623753","74623980","chr6","41363179","41363410","22","33260574"
"chr5","74654414","74654697","chr6","41331206","41331484","34","33323208"
"chr5","74658853","74659180","chr6","41326688","41327014","23","33332165"
"chr5","74693226","74693497","chr6","41291245","41291498","35","33401981"
"chr5","74758087","74758398","chr6","41231893","41232177","52","33526194"
"chr5","74995926","74996219","chr6","40991971","40992259","30","34003955"
"chr5","75070734","75071022","chr6","40917697","40917990","25","34153037"
"chr5","75100086","75100357","chr6","40878394","40878667","21","34221692"
"chr5","75115667","75115967","chr3","36458013","36458312","57","38657654"
"chr5","75156823","75157129","chr8","101745971","101746276","73","26589148"
"chr5","75190319","75190614","chr6","40767152","40767447","21","34423167"
"chr5","75193079","75193241","chr6","40764203","40764365","13","34428876"
"chr5","75219071","75219368","chr9","63095691","63095976","64","12123380"
"chr5","75430903","75431149","chr6","40473022","40473308","59","34957881"
"chr5","75509019","75509227","chr6","40392757","40392965","17","35116262"
"chr5","75669344","75669655","chr19","43725051","43725358","62","31944293"
"chr5","75754938","75755231","chr6","40156720","40157016","17","35598218"
"chr5","75765512","75765751","chr6","40138365","40138619","39","35627147"
"chr5","75917349","75917650","chr6","39987451","39987752","30","35929898"
"chr5","76146545","76146837","chr6","39758648","39758923","50","36387897"
"chr5","76193578","76193892","chr6","39714940","39715248","29","36478638"
"chr5","76201680","76201994","chr6","39706478","39706792","27","36495202"
"chr5","76219508","76219814","chr6","39688785","39689097","26","36530723"
"chr5","76314899","76315214","chr6","39588413","39588726","14","36726486"
"chr5","76317279","76317469","chr13","75616065","75616265","54","701214"
"chr5","76325378","76325496","chr6","39578111","39578228","3","36747267"
"chr5","76333004","76333170","chr2","122083177","122083340","37","45750173"
"chr5","76333203","76333319","chr4","48524252","48524371","23","27808951"
"chr5","76365715","76366037","chr6","39540248","39540578","26","36825467"
"chr5","76553778","76554070","chr6","39352933","39353225","13","37200845"
"chr5","76609972","76610276","chr6","39299075","39299379","21","37310897"
"chr5","76638132","76638394","chr6","39269254","39269520","22","37368878"
"chr5","76751652","76751965","chr6","39151364","39151653","44","37600288"
"chr5","76827549","76827700","chr16","57325453","57325607","35","19502096"
"chr5","76950562","76950832","chr11","7508963","7509219","55","69441599"
"chr5","77014213","77014437","chr3","79858554","79858774","51","2844341"
"chr5","77016260","77016562","chr10","85013948","85014259","67","7997688"
"chr5","77043579","77043852","chr3","2302914","2303193","60","74740665"
"chr5","77081755","77082079","chrX","72038150","72038461","69","5043605"
"chr5","77177003","77177287","chr2","184143766","184144059","61","106966763"
"chr5","77187802","77188094","chr6","38739164","38739466","45","38448638"
"chr5","77354174","77354297","chr6","38575115","38575225","18","38779059"
"chr5","77376134","77376450","chr6","38554277","38554586","21","38821857"
"chr5","77385938","77386266","chr6","38543147","38543456","36","38842791"
"chr5","77549855","77550166","chr6","38382135","38382439","23","39167720"
"chr5","77743565","77743674","chr7","68599953","68600068","25","9143612"
"chr5","77784526","77784805","chr6","38151066","38151344","18","39633460"
"chr5","77823553","77823681","chr6","38106500","38106629","9","39717053"
"chr5","77823995","77824167","chr6","38106053","38106219","17","39717942"
"chr5","77835198","77835410","chr6","38094316","38094524","13","39740882"
"chr5","77849506","77849659","chr4","130581688","130581842","32","52732182"
"chr5","77895782","77896075","chr6","38031406","38031694","22","39864376"
"chr5","77900031","77900227","chr6","38027175","38027371","11","39872856"
"chr5","77900561","77900639","chr6","38026753","38026834","8","39873808"
"chr5","78238192","78238447","chrX","27008422","27008679","68","51229770"
"chr5","78238680","78238798","chr7","40819207","40819325","21","37419473"
"chr5","78245830","78245953","chr6","37924695","37924821","15","40321135"
"chr5","78253070","78253383","chr19","3500436","3500734","82","74752634"
"chr5","78255828","78256092","chr6","149863748","149864022","57","71607920"
"chr5","78261884","78262165","chr6","37908311","37908592","17","40353573"
"chr5","78282247","78282410","chr13","10014489","10014647","35","68267758"
"chr5","78282411","78282503","chr16","55473900","55473994","19","22808511"
"chr5","78286704","78286996","chr1","163060011","163060308","67","84773307"
"chr5","78294306","78294596","chr1","155141171","155141450","64","76846865"
"chr5","78311864","78312181","chr9","98807840","98808149","76","20495976"
"chr5","78317824","78318024","chr11","62687672","62687867","42","15630152"
"chr5","78331735","78331857","chr15","110025773","110025895","18","31694038"
"chr5","78333765","78334036","chr6","37723908","37724175","21","40609857"
"chr5","78345126","78345409","chr6","37711204","37711490","29","40633922"
"chr5","78348618","78348796","chr6","37705927","37706108","20","40642691"
"chr5","78349107","78349235","chr6","37705489","37705617","7","40643618"
"chr5","78363176","78363391","chr6","37691256","37691454","44","40671920"
"chr5","78395964","78396034","chr6","37662606","37662681","7","40733358"
"chr5","78396660","78396746","chr6","37661913","37661999","10","40734747"
"chr5","78418964","78419297","chr6","37636048","37636349","57","40782916"
"chr5","78472845","78473138","chr6","37573017","37573319","25","40899828"
"chr5","78473272","78473561","chr4","37321555","37321842","71","41151717"
"chr5","78479670","78479965","chr6","37565553","37565852","16","40914117"
"chr5","78486646","78486934","chr6","37558509","37558797","20","40928137"
"chr5","78498452","78498745","chr6","37544308","37544614","30","40954144"
"chr5","78498947","78499177","chr6","37543854","37544097","29","40955093"
"chr5","78526332","78526611","chr6","37511403","37511729","60","41014929"
"chr5","78527329","78527600","chr6","37510426","37510721","46","41016903"
"chr5","78573633","78573933","chr6","37464009","37464314","26","41109624"
"chr5","78576719","78576835","chr3","55571720","55571831","18","23004999"
"chr5","78590998","78591269","chr6","37445958","37446235","16","41145040"
"chr5","78612831","78613126","chr6","37422061","37422366","31","41190770"
"chr5","78618308","78618593","chr6","37416576","37416872","37","41201732"
"chr5","78624569","78624769","chr6","37410796","37411001","15","41213773"
"chr5","78626242","78626548","chr6","37409023","37409330","15","41217219"
"chr5","78644611","78644916","chr6","37390853","37391136","45","41253758"
"chr5","78662096","78662225","chr6","37373767","37373899","10","41288329"
"chr5","78783216","78783517","chr6","37244832","37245122","36","41538384"
"chr5","78791178","78791462","chr6","37235902","37236191","13","41555276"
"chr5","78898588","78898881","chr6","37116726","37117022","31","41781862"
"chr5","78915303","78915595","chr6","37100839","37101138","26","41814464"
"chr5","78925339","78925618","chr6","37091281","37091590","38","41834058"
"chr5","78959283","78959564","chr6","37061221","37061457","53","41898062"
"chr5","79161478","79161783","chr6","36849119","36849424","19","42312359"
"chr5","79163157","79163274","chr6","36847343","36847460","4","42315814"
"chr5","79263632","79263921","chr6","36727634","36727936","38","42535998"
"chr5","79271856","79272169","chr6","36719306","36719615","20","42552550"
"chr5","79374355","79374658","chr6","36616636","36616939","27","42757719"
"chr5","79548882","79549172","chr6","36443019","36443324","37","43105863"
"chr5","79553851","79554148","chr6","36438173","36438471","18","43115678"
"chr5","79665305","79665461","chr6","36326449","36326596","15","43338856"
"chr5","79665779","79665909","chr6","36326006","36326134","11","43339773"
"chr5","79671144","79671448","chr6","36319305","36319605","22","43351839"
"chr5","79713984","79714281","chr6","36277805","36278101","24","43436179"
"chr5","79827755","79828044","chr6","36159522","36159813","16","43668233"
"chr5","79835773","79836073","chr6","36146799","36147091","23","43688974"
"chr5","79896760","79897053","chr3","41284848","41285148","60","38611912"
"chr5","79947423","79947649","chr6","36043334","36043560","15","43904089"
"chr5","80185654","80185967","chr6","35818751","35819070","25","44366903"
"chr5","80193016","80193317","chr6","35811040","35811351","27","44381976"
"chr5","80214046","80214328","chr11","43979020","43979288","64","36235026"
"chr5","80280541","80280650","chr13","107302068","107302177","18","27021527"
"chr5","80293843","80294046","chr6","35703004","35703207","20","44590839"
"chr5","80336153","80336460","chr6","35660336","35660643","26","44675817"
"chr5","80356083","80356383","chr6","35639100","35639400","21","44716983"
"chr5","80685251","80685547","chr1","123440775","123441073","55","42755524"
"chr5","80713152","80713436","chr6","35283057","35283327","29","45430095"
"chr5","80731425","80731696","chr6","35264910","35265191","31","45466515"
"chr5","80777791","80778035","chr6","35221369","35221605","48","45556422"
"chr5","80797887","80798016","chr6","35200385","35200514","7","45597502"
"chr5","80803885","80804174","chr10","14885475","14885764","69","65918410"
"chr5","80824819","80825090","chr6","35173436","35173715","24","45651383"
"chr5","80847911","80848164","chr12","89554861","89555117","56","8706950"
"chr5","80871085","80871182","chr6","35128266","35128362","3","45742819"
"chr5","80911762","80912061","chr2","69411442","69411755","58","11500320"
"chr5","80923338","80923451","chr6","35075572","35075687","8","45847766"
"chr5","80935905","80936027","chr6","35062914","35063035","8","45872991"
"chr5","80953400","80953711","chr6","35046065","35046372","28","45907335"
"chr5","80973692","80973992","chr6","35025991","35026298","31","45947701"
"chr5","80990207","80990485","chr6","35009588","35009866","18","45980619"
"chr5","81001094","81001361","chr11","109829142","109829412","71","28828048"
"chr5","81019344","81019620","chr6","34980471","34980755","37","46038873"
"chr5","81028722","81028850","chr15","77775444","77775575","16","3253278"
"chr5","81034784","81035102","chr6","34964470","34964777","36","46070314"
"chr5","81143669","81143788","chr6","34845105","34845220","13","46298564"
"chr5","81719714","81719892","chr6","34700934","34701105","17","47018780"
"chr5","81734356","81734690","chr6","34685379","34685687","48","47048977"
"chr5","81743819","81744077","chr6","34673672","34673941","27","47070147"
"chr5","81772285","81772466","chr1","211765737","211765916","46","129993452"
"chr5","81776899","81777057","chr10","33814560","33814720","36","47962339"
"chr5","81785786","81786079","chr6","34629765","34630066","28","47156021"
"chr5","81821091","81821390","chr3","38363753","38364051","56","43457338"
"chr5","81831081","81831210","chr6","34577311","34577438","11","47253770"
"chr5","81861508","81861812","chr6","34546074","34546375","32","47315434"
"chr5","81864155","81864464","chr3","40073763","40074063","67","41790392"
"chr5","81889017","81889300","chr13","25090593","25090872","53","56798424"
"chr5","81898671","81898985","chr6","34510183","34510526","59","47388488"
"chr5","81949870","81950224","chr6","34452147","34452453","75","47497723"
"chr5","82160489","82160768","chr6","34246583","34246862","15","47913906"
"chr5","82165169","82165457","chr6","34241863","34242149","28","47923306"
"chr5","82205460","82205776","chr6","34201623","34201921","35","48003837"
"chr5","82219370","82219672","chr6","34191158","34191463","34","48028212"
"chr5","82235755","82236037","chr6","34174570","34174846","26","48061185"
"chr5","82254685","82254789","chr3","111301920","111302026","17","29047235"
"chr5","82255729","82255987","chr6","34146345","34146602","21","48109384"
"chr5","82256896","82257206","chr6","34145134","34145438","36","48111762"
"chr5","82266763","82266940","chr6","34127909","34128083","18","48138854"
"chr5","82311940","82312249","chr6","34086492","34086800","31","48225448"
"chr5","82318107","82318401","chr6","34080380","34080687","25","48237727"
"chr5","82344787","82345041","chr2","98301563","98301800","75","15956776"
"chr5","82480558","82480796","chr6","33932195","33932437","29","48548363"
"chr5","82481136","82481194","chr6","33931797","33931855","6","48549339"
"chr5","82633636","82633811","chr6","33769065","33769241","11","48864571"
"chr5","82633815","82634092","chr6","33768770","33769053","45","48865045"
"chr5","82656798","82657099","chr6","33741776","33742099","48","48915022"
"chr5","82698093","82698381","chr6","14560486","14560767","64","68137607"
"chr5","82702383","82702687","chr6","33693418","33693725","27","49008965"
"chr5","82781548","82781718","chr19","5981666","5981828","32","76799882"
"chr5","82975836","82975999","chr6","33408606","33408767","19","49567230"
"chr5","83064644","83064942","chr1","188627840","188628135","61","105563196"
"chr5","83079365","83079716","chr10","35924196","35924490","105","47155169"
"chr5","83101926","83102232","chr6","33277957","33278260","29","49823969"
"chr5","83126898","83127176","chr6","33253289","33253567","30","49873609"
"chr5","83127445","83127573","chr6","33252905","33253031","18","49874540"
"chr5","83167729","83168004","chr3","13105019","13105290","57","70062710"
"chr5","83168639","83168783","chr6","33216344","33216487","8","49952295"
"chr5","83170897","83171212","chr6","33213370","33213680","38","49957527"
"chr5","83198784","83199084","chr6","33188597","33188889","47","50010187"
"chr5","83220678","83220976","chr6","33160698","33161001","41","50059980"
"chr5","83246086","83246431","chr13","62657226","62657550","83","20588860"
"chr5","83265237","83265543","chr6","33115366","33115677","26","50149871"
"chr5","83285322","83285599","chr6","33094490","33094767","30","50190832"
"chr5","83288247","83288552","chr6","33091528","33091848","36","50196719"
"chr5","83295506","83295812","chr6","33084481","33084794","30","50211025"
"chr5","83307672","83307966","chr5","153555649","153555943","60","70247977"
"chr5","83328813","83328935","chr1","59512774","59512897","24","23816039"
"chr5","83346745","83347024","chr6","33034223","33034507","20","50312522"
"chr5","83351709","83352027","chr16","56479316","56479590","96","26872393"
"chr5","83356466","83356695","chr6","33025306","33025537","14","50331160"
"chr5","83363999","83364301","chr6","33017541","33017845","28","50346458"
"chr5","83383157","83383433","chr1","9748365","9748654","58","73634792"
"chr5","83400769","83401070","chr6","32980196","32980488","29","50420573"
"chr5","83437741","83438046","chr5","127213017","127213310","68","43775276"
"chr5","83443737","83444025","chr1","155141171","155141450","65","71697434"
"chr5","83459784","83460055","chr6","32921766","32922035","21","50538018"
"chr5","83463188","83463489","chr6","32917549","32917818","51","50545639"
"chr5","83498662","83498970","chr6","32876979","32877286","19","50621683"
"chr5","83546607","83546903","chr6","32827983","32828279","26","50718624"
"chr5","83555673","83555950","chr9","96174447","96174719","62","12618774"
"chr5","83569213","83569498","chr6","32805868","32806151","39","50763345"
"chr5","83573172","83573443","chr6","32801618","32801898","25","50771554"
"chr5","83603903","83604200","chrX","53873075","53873371","52","29730828"
"chr5","83608400","83608513","chr1","154907271","154907388","22","71298871"
"chr5","83610095","83610182","chr7","74967210","74967296","13","8642885"
"chr5","83627585","83627846","chr6","32749330","32749595","28","50878255"
"chr5","83643794","83643950","chr6","32733600","32733755","16","50910194"
"chr5","83667259","83667534","chr6","32709237","32709514","14","50958022"
"chr5","83671893","83672174","chr3","39968575","39968860","55","43703318"
"chr5","83706156","83706458","chr6","32668480","32668783","18","51037676"
"chr5","83713544","83713660","chr14","9262393","9262510","14","74451151"
"chr5","83714966","83715279","chr6","32659676","32659993","43","51055290"
"chr5","83761867","83762142","chr6","32611334","32611607","18","51150533"
"chr5","83774890","83775200","chr6","32595824","32596131","51","51179066"
"chr5","83795561","83795847","chr6","32574338","32574641","37","51221223"
"chr5","83801972","83802256","chr17","21445729","21446007","67","62356243"
"chr5","83824706","83824984","chr6","32546266","32546549","20","51278440"
"chr5","83848433","83848668","chr6","32525082","32525281","45","51323351"
"chr5","83855497","83855798","chr6","32516815","32517111","31","51338682"
"chr5","83880760","83880967","chr13","37923251","37923447","53","45957509"
"chr5","83881339","83881451","chr1","192596603","192596713","25","108715264"
"chr5","83891879","83892187","chr6","32473858","32474160","19","51418021"
"chr5","83907788","83907923","chr6","32456559","32456697","13","51451229"
"chr5","83916562","83916853","chr6","32447377","32447682","50","51469185"
"chr5","83917263","83917580","chr6","32446708","32447020","28","51470555"
"chr5","83934499","83934782","chr6","32429274","32429557","21","51505225"
"chr5","83962836","83963139","chr6","32402966","32403248","35","51559870"
"chr5","84012095","84012383","chr6","32346171","32346456","43","51665924"
"chr5","84023369","84023665","chr6","32334234","32334540","29","51689135"
"chr5","84040635","84040914","chr1","109829297","109829579","57","25788662"
"chr5","84049824","84050121","chr6","32308893","32309173","44","51740931"
"chr5","84058199","84058477","chr6","32300911","32301181","30","51757288"
"chr5","84085423","84085717","chr6","32273380","32273681","32","51812043"
"chr5","84095068","84095371","chr6","32263333","32263614","41","51831735"
"chr5","84096095","84096347","chr6","32262392","32262650","24","51833703"
"chr5","84097992","84098215","chr6","32260525","32260739","22","51837467"
"chr5","84105280","84105507","chr6","32253343","32253572","15","51851937"
"chr5","84108730","84109014","chr6","32249269","32249559","27","51859461"
"chr5","84147278","84147332","chr6","32209322","32209376","2","51937956"
"chr5","84147922","84148001","chr6","32208650","32208729","5","51939272"
"chr5","84178773","84179026","chr19","46056786","46057045","63","38121987"
"chr5","84181887","84182166","chr6","32174077","32174356","22","52007810"
"chr5","84189740","84189963","chr6","32166318","32166542","16","52023422"
"chr5","84209008","84209312","chr6","32146710","32147012","29","52062298"
"chr5","84211930","84212230","chr6","32143813","32144107","26","52068117"
"chr5","84233224","84233509","chr16","6571800","6572090","64","77661424"
"chr5","84249022","84249319","chr2","84913076","84913368","53","664054"
"chr5","84264256","84264455","chr5","170126727","170126918","47","85862471"
"chr5","84265795","84266081","chr6","32086884","32087171","18","52178911"
"chr5","84273920","84274205","chr6","32078460","32078738","24","52195460"
"chr5","84276994","84277042","chr13","87327185","87327230","7","3050191"
"chr5","84282264","84282543","chr6","32069988","32070288","44","52212276"
"chr5","84305150","84305405","chr6","32040803","32041062","19","52264347"
"chr5","84367433","84367742","chr6","31981750","31982044","41","52385683"
"chr5","84372892","84373197","chr6","77260247","77260553","61","7112645"
"chr5","84383865","84383967","chr5","7607448","7607546","15","76776417"
"chr5","84422234","84422529","chr6","31927008","31927304","21","52495226"
"chr5","84572960","84573259","chr6","31769586","31769885","18","52803374"
"chr5","84736588","84736873","chr6","31606619","31606904","24","53129969"
"chr5","84780595","84780863","chr14","67868986","67869257","46","16911609"
"chr5","84835983","84836295","chr6","31506996","31507323","33","53328987"
"chr5","84885658","84885953","chr6","31452491","31452789","32","53433167"
"chr5","84934016","84934322","chr6","31404267","31404564","26","53529749"
"chr5","84954817","84954989","chr3","37880884","37881056","38","47073933"
"chr5","84997865","84997982","chr6","31337581","31337702","12","53660284"
"chr5","85042959","85043233","chr1","191690399","191690678","60","106647440"
"chr5","85138101","85138293","chr10","70626682","70626872","53","14511419"
"chr5","85141781","85142000","chr2","54125294","54125509","51","31016487"
"chr5","85196507","85196789","chr6","31126326","31126606","26","54070181"
"chr5","85208291","85208589","chr6","31114455","31114751","31","54093836"
"chr5","85297976","85298283","chr6","30980879","30981173","41","54317097"
"chr5","85479306","85479584","chr6","30803660","30803915","48","54675646"
"chr5","85590492","85590782","chr3","157063792","157064084","65","71473300"
"chr5","85640137","85640420","chr6","30646030","30646256","70","54994107"
"chr5","85658507","85658804","chr6","30627567","30627856","31","55030940"
"chr5","85792930","85793207","chr20","3615799","3616074","73","82177131"
"chr5","85826465","85826675","chr6","30459541","30459749","18","55366924"
"chr5","85827721","85828026","chr6","30458178","30458482","61","55369543"
"chr5","86211063","86211365","chr6","30063251","30063510","65","56147812"
"chr5","86216538","86216841","chr6","30057596","30057889","31","56158942"
"chr5","86477261","86477375","chrX","23672574","23672681","28","62804687"
"chr5","86517873","86518152","chr6","29962791","29963061","33","56555082"
"chr5","86651106","86651284","chr1","161689226","161689400","36","75038120"
"chr5","86704165","86704460","chr6","29778917","29779224","43","56925248"
"chr5","86763975","86764042","chr10","47022375","47022442","2","39741600"
"chr5","86905599","86905915","chr6","29578736","29579035","33","57326863"
"chr5","86921308","86921623","chr3","161503080","161503385","72","74581772"
"chr5","87163292","87163464","chr2","68681845","68682003","49","18481447"
"chr5","87193651","87193775","chr2","107844001","107844127","30","20650350"
"chr5","87193802","87193977","chr6","29268041","29268221","21","57925761"
"chr5","87227935","87228164","chr6","29235174","29235398","18","57992761"
"chr5","87243241","87243521","chr6","29220096","29220366","25","58023145"
"chr5","87516622","87516870","chr6","175550363","175550616","27","88033741"
"chr5","87532697","87532999","chr6","175536389","175536700","24","88003692"
"chr5","87597926","87598208","chr6","175468235","175468547","52","87870309"
"chr5","87618779","87619102","chr6","28977466","28977799","40","58641313"
"chr5","87637419","87637709","chr10","15460316","15460612","61","72177103"
"chr5","87771504","87771625","chr7","135010833","135010953","25","47239329"
"chr5","87771928","87772102","chr6","28829221","28829400","17","58942707"
"chr5","87821940","87822100","chr6","28780527","28780689","12","59041413"
"chr5","87876877","87877129","chr6","28725447","28725691","27","59151430"
"chr5","88014313","88014579","chr6","28560398","28560666","23","59453915"
"chr5","88248103","88248227","chr6","28397897","28398021","7","59850206"
"chr5","88279028","88279212","chr8","101986052","101986235","40","13707024"
"chr5","88492701","88493015","chr6","28160372","28160694","31","60332329"
"chr5","88667512","88667789","chr6","27980265","27980509","54","60687247"
"chr5","88712642","88712759","chr3","165390639","165390763","26","76677997"
"chr5","88762302","88762586","chr17","82351709","82352000","55","6410593"
"chr5","88773900","88774213","chr6","27880141","27880444","27","60893759"
"chr5","88826797","88827089","chr6","27827626","27827915","16","60999171"
"chr5","88980451","88980744","chr7","140100928","140101221","64","51120477"
"chr5","89194662","89194966","chr6","27342336","27342645","43","61852326"
"chr5","89311311","89311571","chr6","27207460","27207714","32","62103851"
"chr5","89325769","89325964","chr6","27191656","27191858","26","62134113"
"chr5","89327799","89328090","chr3","155558904","155559194","67","66231105"
"chr5","89432234","89432520","chr6","27040194","27040478","34","62392040"
"chr5","89614343","89614650","chr6","26837462","26837769","24","62776881"
"chr5","89819671","89819989","chr6","26623968","26624279","36","63195703"
"chr5","89892468","89892587","chr6","26550245","26550364","7","63342223"
"chr5","89973643","89973940","chr6","26455268","26455545","53","63518375"
"chr5","90047163","90047480","chr6","26388271","26388590","47","63658892"
"chr5","90061346","90061636","chr6","26373203","26373458","54","63688143"
"chr5","90083358","90083655","chr6","26348759","26349070","48","63734599"
"chr5","90162482","90162715","chr6","26269262","26269511","32","63893220"
"chr5","90332258","90332538","chr6","26094812","26095088","22","64237446"
"chr5","90602950","90603234","chr6","25831896","25832174","37","64771054"
"chr5","90734068","90734298","chr6","25692187","25692409","29","65041881"
"chr5","90802415","90802706","chr6","25626423","25626712","33","65175992"
"chr5","90848077","90848352","chr6","25578920","25579198","20","65269157"
"chr5","90901495","90901719","chr6","25528337","25528560","15","65373158"
"chr5","90982558","90982859","chr7","135134012","135134318","78","44151454"
"chr5","90998962","90999244","chr20","73501250","73501520","73","17497712"
"chr5","91017433","91017729","chr6","25408622","25408927","56","65608811"
"chr5","91151994","91152102","chr6","25267141","25267249","3","65884853"
"chr5","91197706","91197835","chr3","13641352","13641484","23","77556354"
"chr5","91232871","91233020","chr6","25190363","25190512","6","66042508"
"chr5","91312433","91312558","chr6","25103843","25103970","14","66208590"
"chr5","91319467","91319760","chr6","25095911","25096206","26","66223556"
"chr5","91338422","91338719","chrX","54010187","54010486","54","37328235"
"chr5","91541299","91541613","chr18","1158360","1158673","59","90382939"
"chr5","91558949","91559216","chr6","24856342","24856608","27","66702607"
"chr5","91769665","91769978","chr5","77530081","77530388","82","14239584"
"chr5","91947037","91947324","chr4","36568205","36568495","32","55378832"
"chr5","91956451","91956701","chr6","24400609","24400855","26","67555842"
"chr5","91988161","91988278","chr7","154055978","154056093","27","62067817"
"chr5","92029603","92029907","chr6","24351123","24351428","30","67678480"
"chr5","92123245","92123541","chr6","24287125","24287421","23","67836120"
"chr5","92238938","92239128","chr20","42076331","42076518","43","50162607"
"chr5","92306699","92307003","chr6","24099065","24099370","27","68207634"
"chr5","92398993","92399260","chr4","36233462","36233730","62","56165531"
"chr5","92410640","92410909","chr10","23906319","23906587","65","68504321"
"chr5","92419128","92419401","chr1","166267323","166267607","65","73848195"
"chr5","92423413","92423687","chr6","23989810","23990075","46","68433603"
"chr5","92694495","92694799","chr7","165716105","165716404","70","73021610"
"chr5","92730985","92731262","chr6","23674887","23675159","34","69056098"
"chr5","92735745","92736046","chr6","23670353","23670645","48","69065392"
"chr5","92876855","92877119","chr6","23527368","23527633","18","69349487"
"chr5","92891985","92892267","chr6","23512834","23513104","53","69379151"
"chr5","92895163","92895497","chr6","23509629","23509959","37","69385534"
"chr5","93099353","93099645","chr6","23295731","23296018","28","69803622"
"chr5","93129186","93129239","chr6","23269427","23269480","10","69859759"
"chr5","93129619","93129855","chr6","23268810","23269046","20","69860809"
"chr5","93215525","93215726","chr6","23183113","23183334","36","70032412"
"chr5","93248613","93248828","chr3","93515202","93515421","47","266589"
"chr5","93359046","93359377","chr6","23025904","23026217","35","70333142"
"chr5","93422527","93422820","chr17","28144471","28144754","71","65278056"
"chr5","93424128","93424226","chr6","64033415","64033511","20","29390713"
"chr5","93437410","93437692","chr6","22943859","22944158","54","70493551"
"chr5","93442479","93442768","chr6","22938875","22939165","22","70503604"
"chr5","93459525","93459831","chr6","22920601","22920904","33","70538924"
"chr5","93527475","93527778","chr1","20670902","20671205","75","72856573"
"chr5","94112403","94112518","chr6","22310797","22310914","7","71801606"
"chr5","94114558","94114583","chr4","64327537","64327560","4","29787021"
"chr5","94114620","94114915","chr7","41076474","41076773","68","53038146"
"chr5","94404839","94405105","chr6","22014347","22014609","17","72390492"
"chr5","94791266","94791560","chr6","21698854","21699159","33","73092412"
"chr5","94944908","94945184","chr5","97351750","97352028","67","2406842"
"chr5","95005958","95006259","chr1","205564982","205565285","71","110559024"
"chr5","95671156","95671242","chr6","20753583","20753667","11","74917573"
"chr5","95678439","95678523","chr6","20753583","20753667","9","74924856"
"chr5","95737586","95737868","chr6","20692424","20692704","19","75045162"
"chr5","95859429","95859704","chr6","20558115","20558390","23","75301314"
"chr5","95911257","95911586","chr6","20503736","20504043","39","75407521"
"chr5","96038542","96038764","chrX","64511739","64511958","44","31526803"
"chr5","96115001","96115293","chr6","20305488","20305782","29","75809513"
"chr5","96117121","96117275","chr6","20303484","20303637","15","75813637"
"chr5","96145524","96145844","chr6","20269393","20269691","55","75876131"
"chr5","96523043","96523220","chr6","19898740","19898904","28","76624303"
"chr5","96788124","96788418","chr2","34936794","34937075","67","61851330"
"chr5","96867439","96867547","chr3","153384376","153384492","33","56516937"
"chr5","96891663","96891919","chr6","19514209","19514477","40","77377454"
"chr5","96907681","96907866","chr11","28028835","28029019","51","68878846"
"chr5","96971642","96971949","chr6","19431519","19431831","35","77540123"
"chr5","96988694","96988852","chr6","19414489","19414640","22","77574205"
"chr5","97028497","97028778","chr6","19367433","19367714","19","77661064"
"chr5","97045715","97045992","chr6","19345132","19345400","33","77700583"
"chr5","97135989","97136209","chr6","19246352","19246565","20","77889637"
"chr5","97218786","97219014","chr6","19164487","19164712","18","78054299"
"chr5","97235454","97235739","chr6","19142830","19143118","35","78092624"
"chr5","97262162","97262484","chr6","19107925","19108246","45","78154237"
"chr5","97368894","97369173","chr6","19022107","19022376","29","78346787"
"chr5","97394412","97394696","chr6","18996614","18996872","41","78397798"
"chr5","97437882","97438010","chr6","18957921","18958048","9","78479961"
"chr5","97529232","97529338","chr6","93630790","93630896","6","3898442"
"chr5","97569473","97569791","chr6","93673670","93673980","34","3895803"
"chr5","97576783","97577092","chr15","30781687","30781994","65","66795096"
"chr5","97583722","97583920","chr6","93685246","93685444","16","3898476"
"chr5","97618014","97618296","chr6","93718489","93718796","46","3899525"
"chr5","97661753","97662040","chr6","93762272","93762584","49","3899481"
"chr5","97687420","97687537","chr6","93789148","93789265","6","3898272"
"chr5","97726792","97727079","chr6","93829982","93830270","11","3896810"
"chr5","97740990","97741298","chr6","93844301","93844615","23","3896689"
"chr5","97744700","97744988","chr6","93848004","93848303","40","3896696"
"chr5","97771983","97772242","chr6","93878957","93879241","40","3893026"
"chr5","97788312","97788602","chr6","93895479","93895782","34","3892833"
"chr5","97796488","97796784","chr6","93903704","93904005","19","3892784"
"chr5","97810428","97810728","chr6","93918185","93918479","29","3892243"
"chr5","97831325","97831610","chr6","93939302","93939588","15","3892023"
"chr5","97832405","97832551","chr6","122098582","122098725","28","24266177"
"chr5","97860676","97860970","chr6","93974419","93974720","27","3886257"
"chr5","97906945","97907261","chr6","94018490","94018809","29","3888455"
"chr5","97935202","97935518","chr6","94051083","94051399","19","3884119"
"chr5","98008877","98009187","chr6","94123240","94123553","22","3885637"
"chr5","98016289","98016525","chr7","113573364","113573598","55","15557075"
"chr5","98040157","98040441","chr6","94154112","94154378","38","3886045"
"chr5","98079540","98079766","chr16","72431500","72431726","57","25648040"
"chr5","98084628","98084844","chr2","108165262","108165473","65","10080634"
"chr5","98085210","98085283","chr5","4406822","4406896","17","93678388"
"chr5","98093097","98093219","chr6","94210591","94210714","4","3882506"
"chr5","98116900","98117200","chr6","94234262","94234557","28","3882638"
"chr5","98154553","98154678","chr6","94279542","94279667","10","3875011"
"chr5","98293935","98294234","chr6","94400482","94400796","63","3893453"
"chr5","98408872","98409159","chr3","124286205","124286493","62","25877333"
"chr5","98496122","98496410","chr6","170625527","170625818","62","72129405"
"chr5","98519197","98519320","chrX","8847363","8847482","28","89671834"
"chr5","98519362","98519528","chr4","160825138","160825301","29","62305776"
"chr5","98523107","98523265","chr19","8026553","8026714","28","90496554"
"chr5","98523305","98523420","chr6","94637125","94637241","7","3886180"
"chr5","98532021","98532332","chr6","94645088","94645403","22","3886933"
"chr5","98605199","98605487","chr6","94703557","94703841","23","3901642"
"chr5","98645081","98645205","chr6","94737791","94737913","13","3907290"
"chr5","98802614","98802832","chr3","165223698","165223916","55","66421084"
"chr5","98878443","98878743","chr11","117366311","117366614","55","18487868"
"chr5","98936068","98936315","chr6","95024648","95024904","23","3911420"
"chr5","98990283","98990560","chr15","51154580","51154851","66","47835703"
"chr5","99008620","99008934","chr7","55925566","55925867","65","43083054"
"chr5","99103248","99103534","chr6","95144522","95144808","17","3958726"
"chr5","99162663","99162967","chr6","95197455","95197753","27","3965208"
"chr5","99237956","99238247","chr1","30761063","30761352","67","68476893"
"chr5","99406284","99406391","chr2","44780939","44781041","18","54625345"
"chr5","99412545","99412592","chr6","95484280","95484327","4","3928265"
"chr5","99492305","99492416","chr6","95563974","95564085","9","3928331"
"chr5","99492751","99492916","chr3","39035232","39035395","34","60457519"
"chr5","99508194","99508502","chr6","95577260","95577547","57","3930934"
"chr5","99517840","99518147","chr7","17746177","17746476","76","81771663"
"chr5","99525704","99525999","chr6","95594451","95594746","18","3931253"
"chr5","99583201","99583484","chr16","847576","847858","68","98735625"
"chr5","99595273","99595394","chr6","95669060","95669186","12","3926213"
"chr5","99657871","99658207","chr14","110139067","110139393","88","10481196"
"chr5","99670941","99671229","chr6","95739969","95740249","28","3930972"
"chr5","99674719","99675022","chr1","7183552","7183862","74","92491167"
"chr5","99675178","99675460","chr6","95743040","95743307","32","3932138"
"chr5","99676506","99676703","chr4","35502171","35502360","57","64174335"
"chr5","99678596","99678880","chr6","95746477","95746763","20","3932119"
"chr5","99697133","99697251","chr6","95769995","95770122","16","3927138"
"chr5","99697641","99697751","chr6","95770507","95770617","10","3927134"
"chr5","99729019","99729311","chr6","95806283","95806567","35","3922736"
"chr5","99737448","99737730","chr6","95814671","95814954","22","3922777"
"chr5","99741480","99741777","chr16","1095250","1095541","60","98646230"
"chr5","99748600","99748913","chr6","95826263","95826558","36","3922337"
"chr5","99777034","99777325","chr6","95856259","95856562","35","3920775"
"chr5","99787854","99788154","chr6","95867426","95867718","26","3920428"
"chr5","99801272","99801357","chr19","32703576","32703654","21","67097696"
"chr5","99814821","99814938","chrX","8701186","8701303","16","91113635"
"chr5","99817780","99817958","chr6","95896317","95896495","12","3921463"
"chr5","99825068","99825192","chr6","95902605","95902729","7","3922463"
"chr5","99836339","99836504","chr15","26917780","26917925","40","72918559"
"chr5","99841472","99841786","chr6","95919481","95919795","26","3921991"
"chr5","99859963","99860248","chr1","109829297","109829579","53","9969334"
"chr5","99884902","99885030","chr6","96015918","96016042","8","3868984"
"chr5","99887302","99887591","chr6","96018278","96018560","26","3869024"
"chr5","99888881","99889151","chr17","80641181","80641464","59","19247700"
"chr5","99893689","99893997","chr6","96025316","96025624","27","3868373"
"chr5","99936817","99937092","chr6","96060183","96060464","58","3876634"
"chr5","99959985","99960277","chr6","96096936","96097227","24","3863049"
"chr5","100142558","100142712","chr3","124791642","124791791","26","24649084"
"chr5","100153512","100153823","chr6","96324139","96324438","58","3829373"
"chr5","100158507","100158784","chr6","96326198","96326487","36","3832309"
"chr5","100256411","100256700","chr2","195662970","195663256","78","95406559"
"chr5","100544723","100544963","chr6","96849839","96850078","16","3694884"
"chr5","100597672","100597958","chr6","96903606","96903889","26","3694066"
"chr5","100649609","100649892","chr5","139756441","139756723","61","39106832"
"chr5","100727294","100727372","chr6","97089516","97089593","4","3637778"
"chr5","100727412","100727563","chr8","28214239","28214399","44","72513173"
"chr5","100763623","100763931","chr6","97133687","97134001","33","3629936"
"chr5","100838595","100838712","chr6","97222064","97222180","8","3616531"
"chr5","100850194","100850488","chr6","97230605","97230923","44","3619589"
"chr5","100864309","100864638","chr16","40343325","40343637","84","60520984"
"chr5","101016574","101016694","chr3","50217666","50217787","15","50798908"
"chr5","101016971","101017168","chr3","50164640","50164821","35","50852331"
"chr5","101146906","101147195","chr1","112397911","112398207","69","11251005"
"chr5","101474888","101475005","chr6","97599301","97599418","7","3875587"
"chr5","101542642","101542855","chr6","97698614","97698828","20","3844028"
"chr5","101671144","101671270","chr7","121189628","121189753","30","19518484"
"chr5","101671305","101671427","chr3","157449830","157449952","15","55778525"
"chr5","101809494","101809791","chr1","182642228","182642528","56","80832734"
"chr5","101825060","101825191","chr6","97992029","97992157","13","3833031"
"chr5","101969768","101970079","chr6","98136577","98136880","27","3833191"
"chr5","102413352","102413639","chr6","98709560","98709844","30","3703792"
"chr5","102508229","102508507","chr6","98801243","98801523","23","3706986"
"chr5","102545689","102545987","chr6","98840039","98840336","28","3705650"
"chr5","102592055","102592339","chr6","98868035","98868317","35","3724020"
"chr5","102600620","102600914","chr6","98879705","98879996","32","3720915"
"chr5","102753192","102753483","chr6","98971862","98972147","24","3781330"
"chr5","102848879","102849132","chr11","50418617","50418873","48","52430262"
"chr5","103027521","103027744","chr20","26028650","26028871","60","76998871"
"chr5","103048680","103048957","chr6","99257524","99257769","50","3791156"
"chr5","103055320","103055431","chr14","112107327","112107436","35","9052007"
"chr5","103225049","103225266","chr6","99430993","99431210","18","3794056"
"chr5","103225298","103225314","chr6","139134554","139134569","3","35909256"
"chr5","103272753","103272913","chr2","140183141","140183302","35","36910388"
"chr5","103310567","103310789","chr6","99534739","99534961","20","3775828"
"chr5","103362165","103362468","chr6","99586933","99587226","29","3775232"
"chr5","103422419","103422663","chr6","99648673","99648926","27","3773746"
"chr5","103437986","103438110","chr7","113641019","113641138","23","10203033"
"chr5","103507048","103507360","chr6","99733990","99734300","30","3773058"
"chr5","103700954","103701256","chr3","55187824","55188134","61","48513130"
"chr5","103806933","103807225","chr6","100029278","100029573","35","3777655"
"chr5","103852093","103852329","chr6","100075243","100075479","19","3776850"
"chr5","103893408","103893674","chr6","100115987","100116249","21","3777421"
"chr5","103924118","103924402","chr6","100146443","100146727","15","3777675"
"chr5","103926650","103926947","chr6","100149016","100149307","23","3777634"
"chr5","104028313","104028602","chr6","100250180","100250478","25","3778133"
"chr5","104045193","104045481","chr6","100267046","100267337","16","3778147"
"chr5","104148295","104148616","chr6","100418373","100418684","27","3729922"
"chr5","104154131","104154388","chr6","100424238","100424495","17","3729893"
"chr5","104156044","104156323","chr6","100426110","100426415","47","3729934"
"chr5","104198837","104199080","chr1","166115739","166115999","68","61916902"
"chr5","104217933","104218243","chr6","100482034","100482344","27","3735899"
"chr5","104304772","104305072","chr6","100571163","100571470","31","3733609"
"chr5","104323260","104323554","chr6","100589944","100590242","22","3733316"
"chr5","104361111","104361374","chr6","100627764","100628027","16","3733347"
"chr5","104445409","104445698","chr6","100710297","100710584","20","3735112"
"chr5","104575111","104575410","chr6","100839754","100840041","27","3735357"
"chr5","104737110","104737400","chr6","101009716","101009997","44","3727394"
"chr5","104870523","104870672","chr6","101159834","101159992","18","3710689"
"chr5","104951192","104951483","chr6","101241413","101241704","28","3709779"
"chr5","105056057","105056349","chr6","101336636","101336926","31","3719421"
"chr5","105147484","105147777","chr2","98980263","98980557","63","6167221"
"chr5","105253878","105254184","chr6","101524791","101525098","54","3729087"
"chr5","105486284","105486509","chr2","51041029","51041254","48","54445255"
"chr5","105587441","105587704","chr1","191690399","191690678","54","86102958"
"chr5","105684213","105684506","chr6","101962223","101962531","39","3721990"
"chr5","105834417","105834694","chr6","102119351","102119650","65","3715066"
"chr5","105875909","105876067","chr6","102168098","102168253","16","3707811"
"chr5","105994041","105994262","chr6","102286707","102286930","20","3707334"
"chr5","105996745","105997047","chr6","102289396","102289671","43","3707349"
"chr5","106016604","106016826","chr6","102317410","102317643","25","3699194"
"chr5","106162553","106162827","chr6","102466675","102466950","23","3695878"
"chr5","106169064","106169194","chr6","102475097","102475244","26","3693967"
"chr5","106293980","106294103","chr4","114690448","114690572","20","8396468"
"chr5","106325332","106325660","chr6","102631046","102631370","45","3694286"
"chr5","106449865","106450125","chr6","102767280","102767575","49","3682585"
"chr5","106571258","106571570","chrX","100630173","100630473","89","5941085"
"chr5","106648782","106649083","chr2","56487045","56487341","84","50161737"
"chr5","106710544","106710842","chr6","103024948","103025252","30","3685596"
"chr5","106757478","106757760","chr6","103082525","103082796","30","3674953"
"chr5","106850304","106850428","chr6","103176009","103176143","17","3674295"
"chr5","107052538","107052759","chr6","103294884","103295124","52","3757654"
"chr5","107061925","107062223","chr6","103304311","103304608","22","3757614"
"chr5","107162568","107162692","chr6","103406744","103406861","14","3755824"
"chr5","107167508","107167669","chr8","102707098","102707255","51","4460410"
"chr5","107181549","107181828","chr7","112991409","112991688","63","5809860"
"chr5","107383021","107383307","chr6","103640354","103640636","26","3742667"
"chr5","107636464","107636567","chrX","112088395","112088499","21","4451931"
"chr5","107637365","107637575","chr3","66577928","66578124","45","41059437"
"chr5","107745818","107745868","chr6","104012142","104012188","10","3733676"
"chr5","107746179","107746389","chr6","104012498","104012709","16","3733681"
"chr5","108046805","108047094","chr6","104324098","104324390","21","3722707"
"chr5","108075337","108075475","chr6","104351522","104351659","6","3723815"
"chr5","108193594","108193893","chr6","104416660","104416958","22","3776934"
"chr5","108238153","108238451","chr6","104471910","104472210","25","3766243"
"chr5","108252285","108252597","chr2","105342245","105342550","60","2910040"
"chr5","108294970","108295260","chr6","104529826","104530149","57","3765144"
"chr5","108428799","108429103","chr6","104673766","104674069","25","3755033"
"chr5","108490831","108491065","chr18","40167740","40167958","58","68323091"
"chr5","108554402","108554692","chr6","104799856","104800143","25","3754546"
"chr5","108556638","108556929","chr6","104802085","104802368","25","3754553"
"chr5","108687911","108688075","chr5","3061274","3061440","36","105626637"
"chr5","108688119","108688242","chr15","50564804","50564930","23","58123315"
"chr5","108694276","108694572","chr6","104939341","104939638","20","3754935"
"chr5","108735260","108735549","chr6","104980935","104981223","14","3754325"
"chr5","108739683","108740001","chr6","104985397","104985724","38","3754286"
"chr5","108849050","108849337","chr6","105095214","105095497","25","3753836"
"chr5","108969963","108970083","chr6","105237237","105237357","4","3732726"
"chr5","108997527","108997836","chr6","105142168","105142470","57","3855359"
"chr5","109069652","109069890","chr6","105345093","105345338","24","3724559"
"chr5","109116574","109116855","chr3","148208225","148208513","63","39091651"
"chr5","109211882","109212189","chr6","105487924","105488201","52","3723958"
"chr5","109292571","109292797","chr7","95536462","95536686","48","13756109"
"chr5","109319439","109319573","chr13","10456707","10456838","22","98862732"
"chr5","109322319","109322544","chrX","9102166","9102385","45","100220153"
"chr5","109376244","109376531","chr6","105649096","105649407","63","3727148"
"chr5","109376960","109377256","chr6","105649852","105650141","29","3727108"
"chr5","109479323","109479626","chr6","105833440","105833742","23","3645883"
"chr5","109521495","109521783","chr6","105874930","105875222","17","3646565"
"chr5","109547709","109548005","chr6","105900865","105901160","11","3646844"
"chr5","109563853","109563942","chr6","105918420","105918509","3","3645433"
"chr5","109565838","109566132","chr4","150280581","150280886","62","40714743"
"chr5","109593305","109593597","chr6","105960317","105960634","40","3632988"
"chr5","109594328","109594644","chr6","105961363","105961684","26","3632965"
"chr5","109596012","109596296","chr6","105963033","105963310","38","3632979"
"chr5","109607329","109607623","chr6","105974591","105974858","70","3632738"
"chr5","109619921","109620196","chr9","7951605","7951888","60","101668316"
"chr5","109679513","109679802","chr6","106042480","106042784","36","3637033"
"chr5","109699400","109699663","chr6","106061934","106062197","16","3637466"
"chr5","109708366","109708605","chr6","106070662","106070896","38","3637704"
"chr5","109726514","109726803","chr6","106076479","106076777","29","3650035"
"chr5","109798774","109798884","chr6","106150921","106151030","7","3647853"
"chr5","109803258","109803543","chr6","106155135","106155428","21","3648123"
"chr5","109805625","109805916","chr6","106157504","106157811","39","3648121"
"chr5","109810313","109810598","chr6","106162263","106162548","18","3648050"
"chr5","109822679","109822813","chr6","106176433","106176574","17","3646246"
"chr5","109829272","109829564","chr6","106182946","106183231","29","3646326"
"chr5","109849886","109850206","chr6","106203770","106204081","31","3646116"
"chr5","109854236","109854431","chr18","47435094","47435281","48","62419142"
"chr5","109883338","109883639","chr3","46923714","46924027","57","62959624"
"chr5","109920943","109921237","chr19","3500436","3500734","64","106420507"
"chr5","109932580","109932879","chr6","106284925","106285223","17","3647655"
"chr5","109934145","109934424","chr6","106286822","106287104","23","3647323"
"chr5","109943695","109943787","chr6","106300982","106301074","7","3642713"
"chr5","109956680","109956860","chr6","106314198","106314386","15","3642482"
"chr5","109967017","109967319","chr6","106324680","106324984","26","3642337"
"chr5","109982651","109982712","chr6","106342696","106342756","6","3639955"
"chr5","110011973","110012126","chr15","50819032","50819177","37","59192941"
"chr5","110067273","110067568","chr6","106422354","106422649","23","3644919"
"chr5","110108778","110109087","chr6","106466082","106466382","31","3642696"
"chr5","110166900","110167191","chr6","106520213","106520509","34","3646687"
"chr5","110218627","110218914","chr8","97851606","97851891","78","12367021"
"chr5","110467389","110467667","chr6","106804218","106804496","25","3663171"
"chr5","110512944","110513247","chr6","106852850","106853160","28","3660094"
"chr5","110585345","110585635","chr6","106931257","106931578","48","3654088"
"chr5","110588500","110588807","chr5","78697170","78697484","59","31891330"
"chr5","110661730","110662003","chr6","106995397","106995671","19","3666333"
"chr5","110675645","110675944","chr6","107009057","107009357","28","3666588"
"chr5","110731142","110731235","chr18","12849349","12849442","18","97881793"
"chr5","110756871","110757171","chr5","61613725","61614027","64","49143146"
"chr5","110846309","110846608","chr6","107182095","107182400","23","3664214"
"chr5","110898877","110899157","chr6","107229626","107229907","24","3669251"
"chr5","110907127","110907433","chr6","107241607","107241917","25","3665520"
"chr5","110927687","110927975","chr6","107257432","107257715","17","3670255"
"chr5","110939008","110939284","chr6","107266451","107266728","21","3672557"
"chr5","111041083","111041333","chr6","107370365","107370642","51","3670718"
"chr5","111078162","111078449","chr4","118383604","118383891","60","7305442"
"chr5","111489738","111489980","chr1","69947558","69947799","58","41542180"
"chr5","111666516","111666774","chr7","67330922","67331174","62","44335594"
"chr5","111676292","111676586","chr1","25819298","25819590","64","85856994"
"chr5","111690835","111691123","chr2","174954121","174954416","72","63263286"
"chr5","111834169","111834473","chr8","37312363","37312671","73","74521806"
"chr5","112344395","112344668","chr6","108642706","108642981","25","3701689"
"chr5","112363877","112364141","chr6","108661291","108661557","21","3702586"
"chr5","112420346","112420473","chr6","108719892","108720006","16","3700454"
"chr5","112460261","112460533","chr10","77425876","77426160","59","35034385"
"chr5","112580339","112580531","chr6","108838157","108838317","39","3742182"
"chr5","112580816","112580957","chr6","108838603","108838742","11","3742213"
"chr5","112608105","112608400","chr6","108863919","108864203","24","3744186"
"chr5","112614286","112614575","chr6","108870066","108870353","21","3744220"
"chr5","112641602","112641906","chr6","108897035","108897337","22","3744567"
"chr5","112662110","112662414","chr6","108917527","108917851","34","3744583"
"chr5","112685642","112685716","chr6","108941878","108941952","6","3743764"
"chr5","112696378","112696508","chr3","124943079","124943201","35","12246701"
"chr5","112847587","112847900","chr6","109101080","109101388","30","3746507"
"chr5","112949911","112950218","chr6","109202762","109203069","22","3747149"
"chr5","112955862","112956127","chr6","109208716","109208998","38","3747146"
"chr5","113061951","113062201","chr6","109309278","109309538","29","3752673"
"chr5","113366033","113366154","chr6","109603649","109603768","6","3762384"
"chr5","113394620","113394924","chr6","109632200","109632509","29","3762420"
"chr5","113396821","113397187","chr8","23000386","23000729","90","90396435"
"chr5","113432422","113432696","chr6","109668776","109669075","56","3763646"
"chr5","113437827","113438104","chr6","109674236","109674524","51","3763591"
"chr5","113444308","113444430","chr19","5643612","5643733","22","107800696"
"chr5","113491958","113492252","chr6","109727682","109727977","27","3764276"
"chr5","113493527","113493826","chr6","109729244","109729541","21","3764283"
"chr5","113569946","113570229","chr6","109802967","109803242","21","3766979"
"chr5","113643347","113643598","chr6","109864516","109864778","27","3778831"
"chr5","113643615","113643929","chr6","109864806","109865098","45","3778809"
"chr5","113652987","113653225","chr6","109874388","109874629","17","3778599"
"chr5","113665443","113665754","chr6","109887862","109888193","48","3777581"
"chr5","113711507","113711703","chr19","11318940","11319138","53","102392567"
"chr5","113723548","113723785","chr6","109973407","109973652","28","3750141"
"chr5","113784117","113784410","chr6","110036406","110036699","19","3747711"
"chr5","113804146","113804456","chr6","110059214","110059519","26","3744932"
"chr5","113806875","113807001","chr6","110061924","110062049","6","3744951"
"chr5","113807019","113807330","chr6","110062067","110062390","31","3744952"
"chr5","113823771","113823892","chr1","200289163","200289285","13","86465392"
"chr5","113846325","113846631","chr6","110102090","110102404","31","3744235"
"chr5","113869763","113870037","chr6","110125651","110125918","36","3744112"
"chr5","113910386","113910594","chr6","110168819","110169041","27","3741567"
"chr5","113968302","113968560","chr6","110230542","110230806","17","3737760"
"chr5","113972014","113972266","chr6","110236256","110236516","25","3735758"
"chr5","113984829","113985107","chr6","110249059","110249324","31","3735770"
"chr5","114011975","114012189","chr7","33789485","33789705","59","80222490"
"chr5","114021900","114022190","chr6","110287371","110287659","27","3734529"
"chr5","114037309","114037605","chr20","36425190","36425487","51","77612119"
"chr5","114043165","114043279","chr6","110308032","110308145","6","3735133"
"chr5","114047750","114048052","chr6","110312506","110312813","28","3735244"
"chr5","114051800","114052004","chr6","110316913","110317106","28","3734887"
"chr5","114062515","114062876","chr6","110327950","110328287","39","3734565"
"chr5","114065534","114065610","chr16","22181186","22181263","19","91884348"
"chr5","114067239","114067495","chr6","110332427","110332684","24","3734812"
"chr5","114075868","114076000","chr16","76091900","76092026","39","37983968"
"chr5","114078637","114078724","chr5","184221556","184221643","15","70142919"
"chr5","114124988","114125275","chr8","68710606","68710894","61","45414382"
"chr5","114132538","114132809","chr9","63247751","63248014","63","50884787"
"chr5","114143915","114144086","chr6","110405580","110405752","10","3738335"
"chr5","114145517","114145812","chr11","112260222","112260515","65","1885295"
"chr5","114158750","114158899","chr6","110419647","110419802","21","3739103"
"chr5","114159211","114159373","chr6","110420097","110420266","21","3739114"
"chr5","114168919","114169034","chr5","24916403","24916528","34","89252516"
"chr5","114169336","114169495","chr4","7901563","7901710","50","106267773"
"chr5","114246666","114246966","chr16","44906291","44906595","50","69340375"
"chr5","114256487","114256705","chr1","6273895","6274107","51","107982592"
"chr5","114267258","114267555","chr6","110522521","110522808","45","3744737"
"chr5","114330222","114330514","chr6","110586758","110587044","27","3743464"
"chr5","114356944","114357242","chr6","110613648","110613925","43","3743296"
"chr5","114470345","114470558","chr6","110729664","110729858","27","3740681"
"chr5","114487139","114487437","chr6","110748381","110748682","27","3738758"
"chr5","114518276","114518518","chr6","110783937","110784180","19","3734339"
"chr5","114529087","114529387","chr6","110794870","110795151","28","3734217"
"chr5","114553717","114554018","chr6","110819554","110819855","32","3734163"
"chr5","114567458","114567782","chr6","110833245","110833574","25","3734213"
"chr5","114578636","114578959","chr6","110853309","110853629","31","3725327"
"chr5","114613652","114613888","chr6","110887501","110887733","14","3726151"
"chr5","114620546","114620807","chr6","110892716","110892953","35","3727830"
"chr5","114632768","114633074","chr6","110899288","110899590","21","3733480"
"chr5","114699413","114699685","chr6","110971472","110971743","22","3727941"
"chr5","114704859","114705178","chr6","110976948","110977248","36","3727911"
"chr5","114708024","114708071","chrX","4619774","4619827","12","110088250"
"chr5","114716673","114716981","chr6","110988642","110988938","31","3728031"
"chr5","114743610","114743906","chr6","111016627","111016921","17","3726983"
"chr5","114754779","114755083","chrX","62675988","62676296","62","52078791"
"chr5","114789065","114789344","chr5","50906466","50906744","70","63882599"
"chr5","114803688","114803979","chr6","111067464","111067774","40","3736224"
"chr5","114805717","114805922","chr6","111069570","111069778","39","3736147"
"chr5","114821704","114821950","chr6","111085662","111085908","23","3736042"
"chr5","114830008","114830350","chr6","111093931","111094226","73","3736077"
"chr5","114950265","114950557","chr1","160420782","160421068","58","45470517"
"chr5","114950759","114951008","chr12","100707064","100707314","64","14243695"
"chr5","114952838","114953124","chr6","111200701","111200985","14","3752137"
"chr5","114982554","114982841","chr6","111229867","111230159","22","3752687"
"chr5","115134978","115135274","chr6","111374580","111374871","26","3760398"
"chr5","115152685","115152838","chr20","52092383","52092531","31","63060302"
"chr5","115371497","115371679","chr3","129669679","129669864","33","14298182"
"chr5","115537267","115537569","chr6","111777454","111777742","34","3759813"
"chr5","115579155","115579444","chr6","111825758","111826029","38","3753397"
"chr5","115880228","115880522","chr15","30379429","30379726","60","85500799"
"chr5","116189125","116189425","chr6","112450074","112450371","25","3739051"
"chr5","116200160","116200460","chr6","112474435","112474733","31","3725725"
"chr5","116220053","116220185","chr6","112491606","112491728","17","3728447"
"chr5","116240862","116241145","chr6","112513872","112514149","25","3726990"
"chr5","116246339","116246629","chr6","112519301","112519589","44","3727038"
"chr5","116340967","116341288","chr6","112624887","112625198","44","3716080"
"chr5","116350371","116350528","chr6","112634956","112635113","11","3715415"
"chr5","116394422","116394594","chr12","59016380","59016547","28","57378042"
"chr5","116422933","116423218","chr6","112718761","112719044","20","3704172"
"chr5","116442802","116443106","chr6","112735677","112735991","32","3707125"
"chr5","116463496","116463791","chr6","112757248","112757552","50","3706248"
"chr5","116662615","116662915","chr6","112968287","112968569","37","3694328"
"chr5","116670681","116670920","chr3","7384228","7384487","62","109286453"
"chr5","116702647","116702945","chr15","43687639","43687935","48","73015008"
"chr5","116743599","116743854","chr6","113048778","113049035","18","3694821"
"chr5","116906297","116906492","chr6","113264830","113265025","24","3641467"
"chr5","116920546","116920840","chr16","68521550","68521840","66","48398996"
"chr5","116940751","116940951","chr6","113298719","113298920","8","3642032"
"chr5","116946722","116947019","chr6","113304702","113304994","22","3642020"
"chr5","116981191","116981280","chr1","16674594","16674681","20","100306597"
"chr5","117006544","117006886","chr6","113365254","113365589","44","3641290"
"chr5","117049429","117049550","chr5","169923818","169923941","18","52874389"
"chr5","117059925","117060220","chr6","113417235","113417548","31","3642690"
"chr5","117101553","117101620","chr9","22911872","22911942","20","94189681"
"chr5","117101670","117101873","chr7","20198891","20199096","37","96902779"
"chr5","117215155","117215456","chr6","113621718","113621998","50","3593437"
"chr5","117219816","117220118","chr6","113625735","113626037","18","3594081"
"chr5","117271249","117271555","chr1","211353988","211354282","72","94082739"
"chr5","117441049","117441171","chr1","90182553","90182674","23","27258496"
"chr5","117441198","117441360","chr13","97087144","97087305","32","20354054"
"chr5","117558252","117558546","chr6","114060132","114060422","32","3498120"
"chr5","117559814","117560108","chr6","114061663","114061957","25","3498151"
"chr5","117690389","117690665","chr11","34412609","34412876","59","83277780"
"chr5","117701638","117701921","chr6","114207908","114208199","21","3493730"
"chr5","117915223","117915510","chr11","117366311","117366614","55","548912"
"chr5","117926584","117926708","chr7","18158315","18158439","22","99768269"
"chr5","117951038","117951325","chr6","114456734","114457007","34","3494304"
"chr5","117965032","117965321","chr6","114470602","114470896","14","3494430"
"chr5","117971812","117972101","chr6","114478727","114479010","13","3493085"
"chr5","117998733","117999046","chr6","77260247","77260553","65","40738486"
"chr5","118034836","118035131","chr6","114550848","114551156","42","3483988"
"chr5","118043724","118044002","chr6","114559431","114559708","23","3484293"
"chr5","118061407","118061711","chr6","114577413","114577713","27","3483994"
"chr5","118105537","118105847","chr6","114622207","114622528","33","3483330"
"chr5","118201028","118201320","chr6","114716143","114716416","47","3484885"
"chr5","118283966","118284164","chr6","114795088","114795286","15","3488878"
"chr5","118316571","118316885","chr1","183896767","183897077","66","65580196"
"chr5","118395222","118395530","chr9","46514461","46514766","33","71880761"
"chr5","118513882","118514006","chr6","115089565","115089688","10","3424317"
"chr5","118560457","118560751","chr6","115135856","115136155","30","3424601"
"chr5","118578578","118578804","chr6","115160227","115160444","34","3418351"
"chr5","118674667","118674945","chr6","115249986","115250265","36","3424681"
"chr5","118693607","118693799","chr6","115256116","115256313","18","3437491"
"chr5","118874757","118874828","chr12","89653426","89653499","20","29221331"
"chr5","118893596","118893801","chr6","115453742","115453948","16","3439854"
"chr5","118918114","118918364","chr6","115477743","115478000","28","3440371"
"chr5","119000800","119000990","chr6","115548587","115548792","21","3452213"
"chr5","119126275","119126475","chr6","115682118","115682329","26","3444157"
"chr5","119181821","119182111","chr7","112993514","112993795","76","6188307"
"chr5","119302135","119302287","chr3","119090696","119090843","11","211439"
"chr5","119435586","119435933","chr6","115984756","115985072","47","3450830"
"chr5","119580724","119581005","chr9","97285073","97285369","71","22295651"
"chr5","119622945","119623060","chr6","116160077","116160192","10","3462868"
"chr5","119679668","119679948","chr6","116218599","116218879","19","3461069"
"chr5","119755638","119755921","chr6","116300928","116301212","19","3454710"
"chr5","119837421","119837715","chr5","139756441","139756723","59","19919020"
"chr5","119863445","119863742","chr6","116408159","116408466","26","3455286"
"chr5","119973863","119974149","chr10","66769236","66769520","60","53204627"
"chr5","119987042","119987148","chr6","56503130","56503239","21","63483912"
"chr5","119991004","119991269","chr16","29359046","29359287","49","90631958"
"chr5","119992701","119993010","chr12","81368031","81368325","60","38624670"
"chr5","120079654","120079955","chr6","116689456","116689725","51","3390198"
"chr5","120094601","120094830","chr13","11480162","11480403","57","108614439"
"chr5","120094866","120094981","chr6","116706763","116706878","10","3388103"
"chr5","120100970","120101100","chr6","116711778","116711908","12","3389192"
"chr5","120101250","120101544","chr6","116712059","116712362","26","3389191"
"chr5","120163399","120163569","chr8","99217675","99217845","30","20945724"
"chr5","120163872","120164152","chr6","116777710","116777990","17","3386162"
"chr5","120175240","120175536","chr6","176458169","176458462","56","56282929"
"chr5","120177458","120177621","chr3","126621167","126621327","38","6443709"
"chr5","120204205","120204501","chr8","71415791","71416092","58","48788414"
"chr5","120205467","120205745","chr6","116822243","116822540","44","3383224"
"chr5","120209495","120209775","chr10","31573027","31573311","69","88636468"
"chr5","120212114","120212400","chr1","10904976","10905255","50","109307138"
"chr5","120221020","120221092","chr4","128816789","128816860","11","8595769"
"chr5","120235370","120235563","chr6","116850365","116850558","10","3385005"
"chr5","120240347","120240645","chr6","116855265","116855560","24","3385082"
"chr5","120249141","120249422","chr6","116863748","116864053","43","3385393"
"chr5","120257619","120257917","chr6","116870730","116871023","23","3386889"
"chr5","120260433","120260701","chr6","116873275","116873543","23","3387158"
"chr5","120264925","120265226","chr6","116877498","116877809","31","3387427"
"chr5","120281028","120281160","chr2","90813351","90813480","23","29467677"
"chr5","120315720","120316010","chr6","116920807","116921100","22","3394913"
"chr5","120320779","120321074","chr6","116925838","116926137","24","3394941"
"chr5","120349233","120349551","chr6","116954717","116955028","26","3394516"
"chr5","120389154","120389278","chr11","113337897","113338020","15","7051257"
"chr5","120403052","120403243","chr6","117001165","117001355","14","3401887"
"chr5","120411272","120411482","chr5","152953935","152954134","53","32542663"
"chr5","120484499","120484811","chr6","117080557","117080869","28","3403942"
"chr5","120489600","120489890","chr3","40810394","40810684","58","79679206"
"chr5","120492548","120492721","chr1","34392581","34392752","42","86099967"
"chr5","120498386","120498516","chr6","117094876","117095006","10","3403510"
"chr5","120539762","120540023","chr6","117136866","117137148","37","3402896"
"chr5","120552411","120552707","chr6","117149261","117149560","19","3403150"
"chr5","120637394","120637691","chr6","117215981","117216252","49","3421413"
"chr5","120649425","120649734","chr6","117227602","117227896","32","3421823"
"chr5","120653895","120654147","chr5","9176993","9177243","51","111476902"
"chr5","120711342","120711619","chr6","117290633","117290901","25","3420709"
"chr5","120792474","120792760","chr6","117358632","117358914","21","3433842"
"chr5","120804338","120804653","chr6","117376832","117377125","46","3427506"
"chr5","120838141","120838318","chr6","161718689","161718864","46","40880548"
"chr5","120858727","120859009","chr6","117428984","117429262","23","3429743"
"chr5","120892509","120892818","chr6","117458070","117458382","38","3434439"
"chr5","121047407","121047711","chr6","117609282","117609580","20","3438125"
"chr5","121053734","121053852","chr6","117615769","117615887","10","3437965"
"chr5","121232116","121232400","chr6","117809709","117809998","47","3422407"
"chr5","121253394","121253531","chr6","117830983","117831120","10","3422411"
"chr5","121308209","121308482","chr6","117879792","117880071","41","3428417"
"chr5","121381638","121381954","chr6","117981062","117981377","26","3400576"
"chr5","121467040","121467315","chr6","118054607","118054874","24","3412433"
"chr5","121646895","121647195","chr6","118236074","118236377","27","3410821"
"chr5","121653049","121653311","chr6","118242206","118242474","21","3410843"
"chr5","121671874","121671957","chr6","118255680","118255763","5","3416194"
"chr5","121721567","121721680","chr6","118311861","118311974","12","3409706"
"chr5","121783313","121783605","chr12","65018083","65018379","67","56765230"
"chr5","121909288","121909556","chr6","118484112","118484380","21","3425176"
"chr5","122001971","122002289","chr7","55925566","55925867","70","66076405"
"chr5","122026870","122027128","chr4","98966475","98966720","73","23060395"
"chr5","122190952","122191248","chr6","118759459","118759748","28","3431493"
"chr5","122271431","122271556","chr2","6753772","6753904","25","115517659"
"chr5","122341838","122342152","chr6","118873777","118874089","27","3468061"
"chr5","122356365","122356653","chr6","118896987","118897272","32","3459378"
"chr5","122376978","122377261","chr6","118933599","118933880","21","3443379"
"chr5","122509828","122509904","chr1","62339725","62339800","23","60170103"
"chr5","122509945","122510087","chrX","112880102","112880252","28","9629843"
"chr5","122660811","122661116","chr6","119219237","119219530","38","3441574"
"chr5","123022632","123022901","chr6","119570215","119570490","23","3452417"
"chr5","123110669","123110944","chr6","119659194","119659492","57","3451475"
"chr5","123133984","123134138","chr1","163892122","163892272","28","40758138"
"chr5","123206453","123206758","chr6","119754805","119755105","37","3451648"
"chr5","123226460","123226567","chr6","119770912","119771029","12","3455548"
"chr5","123227868","123228153","chr6","119772335","119772620","19","3455533"
"chr5","123341576","123341875","chr6","119884745","119885047","25","3456831"
"chr5","123361307","123361559","chr16","38904209","38904474","61","84457098"
"chr5","123510670","123510895","chr6","120051109","120051335","22","3459561"
"chr5","123517662","123517786","chr6","120058594","120058719","14","3459068"
"chr5","123521014","123521338","chr6","120061938","120062227","47","3459076"
"chr5","123528747","123529026","chr6","120069372","120069669","39","3459375"
"chr5","123535934","123536231","chr6","120076831","120077128","33","3459103"
"chr5","123580391","123580688","chr6","120114908","120115204","20","3465483"
"chr5","123661570","123661656","chr1","140851072","140851152","16","17189502"
"chr5","123694550","123694856","chr1","201898185","201898489","62","78203635"
"chr5","123698456","123698728","chr2","84155954","84156223","62","39542502"
"chr5","123751699","123751974","chr1","15477611","15477890","68","108274088"
"chr5","123808324","123808521","chr3","129669679","129669864","50","5861355"
"chr5","123860397","123860707","chr3","64199068","64199370","73","59661329"
"chr5","123879732","123880037","chr15","108938913","108939226","64","14940819"
"chr5","123888076","123888191","chr1","163806622","163806737","26","39918546"
"chr5","123892980","123893253","chr15","92592014","92592274","75","31300966"
"chr5","123920803","123921099","chr7","162408794","162409084","66","38487991"
"chr5","123935883","123936014","chr1","109570884","109571013","21","14364999"
"chr5","123956352","123956481","chr20","17902700","17902831","20","106053652"
"chr5","123967719","123968003","chr6","120171627","120171914","27","3796092"
"chr5","124025267","124025389","chr6","120234392","120234514","17","3790875"
"chr5","124030998","124031288","chr6","120241402","120241692","14","3789596"
"chr5","124050377","124050666","chr6","120261493","120261793","59","3788884"
"chr5","124053675","124053943","chr6","120264734","120265027","48","3788941"
"chr5","124055342","124055639","chr6","120266440","120266723","39","3788902"
"chr5","124071961","124072174","chr2","47656293","47656502","44","76415668"
"chr5","124072425","124072735","chr6","120288145","120288453","23","3784280"
"chr5","124087639","124087933","chr6","120298632","120298901","38","3789007"
"chr5","124093175","124093307","chr6","120304173","120304301","13","3789002"
"chr5","124095332","124095653","chr6","120306277","120306597","29","3789055"
"chr5","124155531","124155743","chr6","120421276","120421468","31","3734255"
"chr5","124194580","124194848","chr1","117762535","117762801","54","6432045"
"chr5","124217500","124217632","chr15","46514123","46514257","21","77703377"
"chr5","124238125","124238433","chr6","120505242","120505541","25","3732883"
"chr5","124242319","124242473","chr6","120509300","120509450","18","3733019"
"chr5","124242793","124242949","chr6","120509775","120509933","13","3733018"
"chr5","124292129","124292299","chr6","120560577","120560745","12","3731552"
"chr5","124520323","124520507","chr6","120776317","120776506","12","3744006"
"chr5","124545380","124545675","chr1","211353988","211354282","48","86808608"
"chr5","124562512","124562797","chr6","120818274","120818562","22","3744238"
"chr5","124567792","124568072","chr6","120823253","120823533","18","3744539"
"chr5","124666305","124666606","chr6","120918959","120919263","30","3747346"
"chr5","124695221","124695527","chr6","120948647","120948946","26","3746574"
"chr5","124709047","124709159","chr6","120961553","120961665","8","3747494"
"chr5","124780612","124780775","chr6","121032982","121033144","16","3747630"
"chr5","124788954","124789162","chr6","121041254","121041458","20","3747700"
"chr5","124862743","124862863","chr6","121108942","121109064","11","3753801"
"chr5","124865526","124865810","chr15","15963917","15964199","61","108901609"
"chr5","124967359","124967630","chr6","121213301","121213567","40","3754058"
"chr5","125027276","125027550","chr6","121263774","121264045","23","3763502"
"chr5","125224981","125225275","chr6","121477178","121477475","20","3747803"
"chr5","125262970","125263275","chr6","121519469","121519770","20","3743501"
"chr5","125289301","125289575","chr6","121545664","121545946","26","3743637"
"chr5","125443124","125443434","chr6","121688761","121689084","46","3754363"
"chr5","125444263","125444525","chr6","121689942","121690186","50","3754321"
"chr5","125453673","125453950","chr6","121699349","121699626","28","3754324"
"chr5","125464869","125465164","chr6","121710814","121711123","39","3754055"
"chr5","125482761","125482947","chr10","85079615","85079798","44","40403146"
"chr5","125579674","125579822","chr6","121805704","121805865","18","3773970"
"chr5","125603561","125603871","chr2","165008183","165008489","69","39404622"
"chr5","125604094","125604393","chr3","13860882","13861183","59","111743212"
"chr5","125632359","125632664","chr1","52901994","52902296","58","72730365"
"chr5","125712891","125713158","chr9","8186206","8186458","67","117526685"
"chr5","125729537","125729828","chr2","179871828","179872125","62","54142291"
"chr5","125733271","125733455","chr6","121992765","121992948","13","3740506"
"chr5","125747576","125747881","chr14","104459582","104459884","50","21287994"
"chr5","125767820","125768117","chr6","122027839","122028137","14","3739981"
"chr5","125780443","125780741","chr6","122040311","122040607","27","3740132"
"chr5","125792746","125792919","chr7","114050953","114051125","33","11741793"
"chr5","125792947","125793063","chr7","55226235","55226351","24","70566712"
"chr5","125821071","125821204","chr8","71179092","71179225","19","54641979"
"chr5","125841430","125841726","chr6","122101413","122101709","15","3740017"
"chr5","125857741","125857997","chr6","122118053","122118274","49","3739688"
"chr5","125870222","125870512","chr19","16281072","16281365","62","109589150"
"chr5","125919801","125919923","chr9","118133574","118133699","20","7786227"
"chr5","125920222","125920391","chr6","122180260","122180416","25","3739962"
"chr5","125927372","125927668","chr6","122188025","122188319","16","3739347"
"chr5","125945249","125945466","chr6","122205200","122205406","23","3740049"
"chr5","125947127","125947374","chr6","122207101","122207348","12","3740026"
"chr5","125972807","125973105","chr6","122233796","122234094","13","3739011"
"chr5","125980650","125980967","chr6","122241412","122241727","29","3739238"
"chr5","126032079","126032337","chr6","122293151","122293420","31","3738928"
"chr5","126043782","126044008","chr6","122305368","122305590","26","3738414"
"chr5","126090172","126090410","chr15","32749360","32749589","61","93340812"
"chr5","126095674","126095846","chr6","122355663","122355838","14","3740011"
"chr5","126096194","126096326","chr6","122356158","122356288","15","3740036"
"chr5","126108015","126108124","chr6","122369359","122369486","26","3738656"
"chr5","126111551","126111857","chr6","122372916","122373221","24","3738635"
"chr5","126120109","126120432","chr6","122381346","122381675","34","3738763"
"chr5","126164635","126164807","chr6","122421932","122422102","9","3742703"
"chr5","126165114","126165246","chr6","122422409","122422543","11","3742705"
"chr5","126312569","126312745","chr19","39878357","39878534","34","86434212"
"chr5","126406474","126406585","chr6","122659853","122659963","9","3746621"
"chr5","126463589","126463878","chr18","57530574","57530864","65","68933015"
"chr5","126528575","126528873","chr6","122839786","122840088","25","3688789"
"chr5","126542082","126542199","chr5","38429193","38429310","18","88112889"
"chr5","126561999","126562320","chr6","122872783","122873087","48","3689216"
"chr5","126968933","126969056","chr6","123282486","123282608","6","3686447"
"chr5","127056926","127057213","chr6","123365021","123365304","29","3691905"
"chr5","127063091","127063386","chr6","123371219","123371513","31","3691872"
"chr5","127382067","127382245","chr5","39688759","39688932","35","87693308"
"chr5","127402114","127402383","chr6","123796259","123796573","66","3605855"
"chr5","127573611","127573856","chr5","9176993","9177243","52","118396618"
"chr5","127612836","127613109","chr6","123998761","123999061","38","3614075"
"chr5","127647705","127647805","chr6","124030144","124030244","5","3617561"
"chr5","127661240","127661504","chr6","124044439","124044702","14","3616801"
"chr5","127697625","127697945","chr6","124088464","124088784","22","3609161"
"chr5","127708542","127708862","chr6","124098152","124098467","27","3610390"
"chr5","127718130","127718417","chr6","124111832","124112127","36","3606298"
"chr5","127723451","127723691","chr7","135737445","135737682","54","8013994"
"chr5","127726336","127726513","chr6","124120497","124120674","9","3605839"
"chr5","127728042","127728346","chr6","124122193","124122480","41","3605849"
"chr5","127738996","127739285","chr6","124135853","124136116","43","3603143"
"chr5","127751556","127751617","chr15","87975462","87975525","16","39776094"
"chr5","127754374","127754667","chr6","124150489","124150785","23","3603885"
"chr5","127757245","127757358","chr13","46512186","46512305","21","81245059"
"chr5","127797384","127797680","chr6","124191464","124191754","33","3605920"
"chr5","127811309","127811584","chr6","124206901","124207179","28","3604408"
"chr5","127882320","127882610","chr1","15217279","15217568","54","112665041"
"chr5","127887505","127887788","chr9","123745173","123745449","62","4142332"
"chr5","127919791","127919915","chr6","124345319","124345444","8","3574472"
"chr5","127978697","127978998","chr6","124401242","124401550","33","3577455"
"chr5","128128917","128129211","chr6","124535807","124536105","15","3593110"
"chr5","128163203","128163440","chr6","124569903","124570145","21","3593300"
"chr5","128314108","128314401","chr6","124715209","124715513","29","3598899"
"chr5","128338573","128338841","chr6","124738441","124738711","24","3600132"
"chr5","128351849","128352143","chr6","124751816","124752119","27","3600033"
"chr5","128358560","128358834","chr6","124758540","124758813","8","3600020"
"chr5","128402973","128403229","chr20","65752644","65752894","62","62650329"
"chr5","128565760","128566056","chr6","125033859","125034165","33","3531901"
"chr5","128567325","128567450","chr6","149952527","149952659","18","21385202"
"chr5","128682204","128682331","chrX","149090034","149090162","32","20407830"
"chr5","128701172","128701467","chr6","125166765","125167065","22","3534407"
"chr5","128701552","128701888","chr6","125167158","125167493","39","3534394"
"chr5","128706282","128706599","chr6","125171852","125172162","26","3534430"
"chr5","128738513","128738733","chr6","125199714","125199937","21","3538799"
"chr5","128759594","128759846","chr6","125217668","125217918","24","3541926"
"chr5","128789672","128789962","chr6","125247697","125247987","31","3541975"
"chr5","128794688","128794803","chr6","125252603","125252718","12","3542085"
"chr5","128794842","128795011","chr6","125252744","125252920","18","3542098"
"chr5","128970359","128970471","chr20","15772920","15773032","19","113197439"
"chr5","128970916","128971083","chr7","130056903","130057064","42","1085987"
"chr5","129067826","129068047","chr5","92576982","92577206","54","36490844"
"chr5","129073886","129074009","chr6","125551275","125551398","9","3522611"
"chr5","129121835","129122121","chr6","125599898","125600184","30","3521937"
"chr5","129127616","129127919","chr6","125605361","125605664","30","3522255"
"chr5","129150381","129150538","chr4","130581688","130581842","34","1431307"
"chr5","129150582","129150696","chr11","62288594","62288710","24","66861988"
"chr5","129363468","129363604","chr19","50326892","50327017","33","79036576"
"chr5","129370330","129370600","chr6","125843977","125844249","29","3526353"
"chr5","129384097","129384377","chr14","32702557","32702842","54","96681540"
"chr5","129387478","129387787","chr6","125868188","125868507","41","3519290"
"chr5","129439399","129439691","chr6","125920835","125921130","25","3518564"
"chr5","129497873","129498158","chrX","108208239","108208529","64","21289634"
"chr5","129516979","129517241","chr6","125991585","125991862","38","3525394"
"chr5","129521572","129521869","chr17","54072119","54072406","62","75449453"
"chr5","129529355","129529464","chr6","126004109","126004226","19","3525246"
"chr5","129546386","129546659","chr6","126021379","126021663","36","3525007"
"chr5","129553448","129553756","chr6","126028431","126028745","25","3525017"
"chr5","129656963","129657230","chr6","126128635","126128899","34","3528328"
"chr5","129857712","129857940","chr6","126337521","126337756","26","3520191"
"chr5","129928961","129929271","chr6","126413583","126413874","47","3515378"
"chr5","129983107","129983402","chr6","69305372","69305652","60","60677735"
"chr5","129987331","129987638","chr6","126468957","126469284","41","3518374"
"chr5","130080288","130080403","chr6","126567985","126568100","6","3512303"
"chr5","130111565","130111867","chr6","147497028","147497329","59","17385463"
"chr5","130161786","130162099","chr19","4771576","4771890","69","125390210"
"chr5","130173663","130173965","chr6","126648442","126648763","42","3525221"
"chr5","130258751","130258988","chr6","126735363","126735601","18","3523388"
"chr5","130584048","130584287","chr6","127028526","127028770","22","3555522"
"chr5","130588082","130588377","chr6","127032628","127032925","40","3555454"
"chr5","130610576","130610830","chr6","127056429","127056685","24","3554147"
"chr5","130646742","130646913","chr6","127091317","127091475","21","3555425"
"chr5","130654095","130654396","chr6","127098667","127098974","22","3555428"
"chr5","130745455","130745736","chr6","127193883","127194150","28","3551572"
"chr5","131448795","131449095","chr5","139756441","139756723","64","8307646"
"chr5","131527190","131527456","chr6","127557980","127558250","43","3969210"
"chr5","131544773","131545054","chr6","127577336","127577621","22","3967437"
"chr5","131586752","131587023","chr3","64700297","64700569","70","66886455"
"chr5","131625323","131625613","chr6","127655524","127655819","16","3969799"
"chr5","131628048","131628329","chr6","127658222","127658504","19","3969826"
"chr5","131747361","131747674","chr6","127778368","127778672","27","3968993"
"chr5","131766111","131766408","chr6","127800077","127800362","34","3966034"
"chr5","131834302","131834589","chr6","127934490","127934779","18","3899812"
"chr5","131933728","131933972","chr6","128022230","128022492","36","3911498"
"chr5","131955739","131955857","chr6","128047097","128047214","5","3908642"
"chr5","132282725","132283017","chr6","128373631","128373911","43","3909094"
"chr5","132310025","132310295","chr6","128402583","128402849","30","3907442"
"chr5","132585529","132585836","chrX","135850352","135850659","21","3264823"
"chr5","132651851","132652137","chr6","128750969","128751251","17","3900882"
"chr5","132660850","132661090","chr6","128761467","128761739","41","3899383"
"chr5","132677224","132677499","chr6","128788551","128788827","18","3888673"
"chr5","132705559","132705788","chr6","128815680","128815904","19","3889879"
"chr5","132709366","132709496","chr6","128819492","128819622","15","3889874"
"chr5","132770852","132771127","chr6","128883128","128883404","21","3887724"
"chr5","132775723","132775919","chr6","72020796","72020989","41","60754927"
"chr5","132776210","132776335","chr5","52056310","52056438","20","80719900"
"chr5","132780495","132780620","chr6","128891599","128891719","16","3888896"
"chr5","132808344","132808654","chr6","128916893","128917200","28","3891451"
"chr5","132810065","132810376","chr7","164722657","164722964","57","31912592"
"chr5","132824576","132824778","chr14","66911348","66911552","40","65913228"
"chr5","132833851","132834172","chr6","128942944","128943266","39","3890907"
"chr5","132885240","132885545","chr6","128996254","128996560","26","3888986"
"chr5","132918160","132918461","chr6","129023436","129023744","29","3894724"
"chr5","132947616","132947907","chr6","129045271","129045577","45","3902345"
"chr5","132961270","132961564","chr6","129061647","129061938","19","3899623"
"chr5","132997761","132997893","chr6","129096220","129096352","9","3901541"
"chr5","133002947","133003233","chr6","129101326","129101622","25","3901621"
"chr5","133013349","133013616","chr6","129111326","129111609","43","3902023"
"chr5","133022450","133022752","chr6","129120640","129120919","44","3901810"
"chr5","133028560","133028849","chr5","86867827","86868121","53","46160733"
"chr5","133040147","133040393","chr6","129138968","129139225","22","3901179"
"chr5","133060205","133060501","chr6","129158904","129159197","27","3901301"
"chr5","133076774","133077055","chr6","129175779","129176060","15","3900995"
"chr5","133079239","133079522","chr6","129178330","129178614","13","3900909"
"chr5","133100329","133100599","chr6","129200695","129200978","35","3899634"
"chr5","133135218","133135347","chr13","30654242","30654371","25","102480976"
"chr5","133142581","133142793","chr6","129247935","129248150","12","3894646"
"chr5","133153233","133153534","chr3","130448018","130448321","77","2705215"
"chr5","133157145","133157440","chr6","161557509","161557798","50","28400364"
"chr5","133161964","133162254","chr6","129268202","129268490","27","3893762"
"chr5","133202494","133202744","chrX","112276995","112277237","50","20925499"
"chr5","133205684","133205868","chr9","54281281","54281462","39","78924403"
"chr5","133223092","133223370","chr6","129325898","129326191","32","3897194"
"chr5","133241812","133242089","chr6","129344630","129344922","59","3897182"
"chr5","133246410","133246691","chr6","129349274","129349584","50","3897136"
"chr5","133252693","133252960","chr6","129361627","129361904","26","3891066"
"chr5","133290522","133290733","chr19","10445328","10445544","53","122845194"
"chr5","133317911","133318067","chr6","129425251","129425404","14","3892660"
"chr5","133353181","133353475","chr6","129466088","129466380","20","3887093"
"chr5","133362256","133362541","chr6","129475027","129475313","27","3887229"
"chr5","133369226","133369531","chr6","129482292","129482600","22","3886934"
"chr5","133371899","133372206","chr6","129485741","129486028","38","3886158"
"chr5","133385317","133385460","chr6","129499108","129499250","12","3886209"
"chr5","133385751","133385903","chr6","129499544","129499701","11","3886207"
"chr5","133416486","133416782","chr6","129530826","129531119","20","3885660"
"chr5","133418570","133418859","chr6","129532886","129533178","13","3885684"
"chr5","133419578","133419731","chr6","129533900","129534048","19","3885678"
"chr5","133450465","133450759","chr6","129568540","129568835","22","3881925"
"chr5","133466139","133466441","chr6","129582566","129582828","60","3883573"
"chr5","133508391","133508694","chr6","129622384","129622686","27","3886007"
"chr5","133508923","133509047","chr6","129622915","129623039","5","3886008"
"chr5","133533784","133534080","chr6","129648216","129648490","49","3885568"
"chr5","133549199","133549515","chr11","95107716","95107999","76","38441483"
"chr5","133554381","133554675","chr10","13786018","13786298","64","119768363"
"chr5","133631794","133631973","chr10","69555978","69556156","40","64075816"
"chr5","133671092","133671382","chr6","129779934","129780218","29","3891158"
"chr5","133753079","133753378","chr6","129860145","129860432","28","3892934"
"chr5","133786479","133786594","chr7","41223626","41223741","16","92562853"
"chr5","133830426","133830728","chr9","98245565","98245863","60","35584861"
"chr5","133831522","133831824","chr1","134667514","134667809","55","835992"
"chr5","133863244","133863542","chr3","124267629","124267922","52","9595615"
"chr5","133883275","133883533","chr6","129989780","129990014","44","3893495"
"chr5","133909396","133909684","chr11","108911962","108912248","58","24997434"
"chr5","133941371","133941548","chr6","130048482","130048639","28","3892889"
"chr5","133941624","133941761","chr6","130048742","130048878","2","3892882"
"chr5","134025944","134026239","chr6","130128619","130128913","22","3897325"
"chr5","134039564","134039847","chr6","130143596","130143893","28","3895968"
"chr5","134116646","134116942","chr6","130221240","130221560","39","3895406"
"chr5","134117109","134117396","chr6","130221728","130222012","26","3895381"
"chr5","134164441","134164751","chr6","130270045","130270354","23","3894396"
"chr5","134184173","134184460","chr6","130290158","130290433","23","3894015"
"chr5","134191365","134191648","chr15","43687639","43687935","50","90503726"
"chr5","134213097","134213365","chr6","130317955","130318211","19","3895142"
"chr5","134225390","134225598","chr10","16790120","16790329","43","117435270"
"chr5","134233623","134233900","chr6","130343807","130344086","17","3889816"
"chr5","134297737","134297856","chr6","130414062","130414181","6","3883675"
"chr5","134308164","134308480","chr6","130422992","130423312","41","3885172"
"chr5","134311287","134311561","chr5","66790804","66791082","67","67520483"
"chr5","134361111","134361401","chr6","130477419","130477710","18","3883692"
"chr5","134373801","134374098","chr6","130490623","130490900","44","3883178"
"chr5","134387822","134387942","chr6","130505035","130505157","10","3882787"
"chr5","134410893","134411016","chr6","130527307","130527429","9","3883586"
"chr5","134470966","134471262","chr14","7051780","7052083","59","127419186"
"chr5","134483079","134483209","chr6","130602655","130602785","6","3880424"
"chr5","134488536","134488827","chr6","130608195","130608486","17","3880341"
"chr5","134489628","134489907","chr6","130609240","130609513","29","3880388"
"chr5","134495161","134495428","chr6","130618477","130618764","41","3876684"
"chr5","134496577","134496848","chr1","220573268","220573541","62","86076691"
"chr5","134499196","134499479","chr6","130621500","130621770","50","3877696"
"chr5","134501966","134502270","chr6","130624865","130625164","29","3877101"
"chr5","134522812","134523095","chr6","130649499","130649802","36","3873313"
"chr5","134525923","134526209","chr6","130653025","130653314","34","3872898"
"chr5","134534186","134534405","chr6","130663125","130663345","11","3871061"
"chr5","134552795","134553074","chr7","98315911","98316195","58","36236884"
"chr5","134570262","134570381","chr6","130692262","130692381","4","3878000"
"chr5","134571437","134571542","chr6","130693746","130693861","18","3877691"
"chr5","134585112","134585409","chr6","130705616","130705910","35","3879496"
"chr5","134587806","134587939","chr6","130711101","130711234","5","3876705"
"chr5","134588231","134588393","chr6","130711525","130711691","17","3876706"
"chr5","134600107","134600356","chr6","130722269","130722487","56","3877838"
"chr5","134613760","134613836","chr6","130736923","130736999","2","3876837"
"chr5","134615659","134615840","chr6","130737711","130737888","23","3877948"
"chr5","134620444","134620762","chr4","159090526","159090826","66","24470082"
"chr5","134625204","134625481","chr6","130747442","130747712","36","3877762"
"chr5","134637091","134637404","chr6","130759341","130759652","48","3877750"
"chr5","134698602","134698869","chrX","113906906","113907171","57","20791696"
"chr5","134719965","134720104","chr6","130847459","130847582","23","3872506"
"chr5","134720405","134720565","chr6","130847873","130848036","12","3872532"
"chr5","134730093","134730239","chr15","2473781","2473922","40","132256312"
"chr5","134730556","134730695","chr3","39468559","39468698","26","95261997"
"chr5","134733136","134733418","chr6","130865667","130865950","15","3867469"
"chr5","134741201","134741383","chr8","25350058","25350236","42","109391143"
"chr5","134755081","134755352","chr6","130882725","130882996","22","3872356"
"chr5","134760151","134760458","chr6","130887766","130888078","32","3872385"
"chr5","134812351","134812650","chr6","130939998","130940303","25","3872353"
"chr5","135098923","135099226","chr16","18006865","18007167","60","117092058"
"chr5","135108800","135109070","chr6","131240746","131241048","42","3868054"
"chr5","135417696","135417979","chr6","131550357","131550636","23","3867339"
"chr5","135444961","135445265","chr7","51523943","51524235","66","83921018"
"chr5","135495340","135495572","chr6","131629545","131629777","13","3865795"
"chr5","135532229","135532519","chr6","131667918","131668221","34","3864311"
"chr5","135581925","135582191","chr6","131720618","131720893","26","3861307"
"chr5","135589058","135589328","chr6","78756571","78756823","63","56832487"
"chr5","135591402","135591708","chr1","31332132","31332443","64","104259270"
"chr5","135602645","135602869","chr16","59699906","59700133","43","75902739"
"chr5","135605337","135605450","chr6","131741766","131741879","7","3863571"
"chr5","135650992","135651317","chr6","131785697","131786003","36","3865295"
"chr5","135655794","135656101","chr11","117366311","117366614","54","18289483"
"chr5","135675054","135675255","chr16","74866256","74866452","37","60808798"
"chr5","135691229","135691528","chr6","131826577","131826877","20","3864652"
"chr5","135718999","135719118","chr6","131856171","131856294","17","3862828"
"chr5","135728238","135728375","chr20","54825831","54825959","33","80902407"
"chr5","135728971","135729126","chr10","92151646","92151800","29","43577325"
"chr5","135758979","135759177","chr6","131893178","131893363","21","3865801"
"chr5","135760199","135760498","chr6","131894366","131894676","28","3865833"
"chr5","135761759","135762015","chr7","50245459","50245719","70","85516300"
"chr5","135796902","135797217","chr6","131931443","131931758","26","3865459"
"chr5","135798761","135799055","chr6","131933484","131933789","28","3865277"
"chr5","135823232","135823506","chr6","131961952","131962228","22","3861280"
"chr5","135832672","135832966","chr1","15217279","15217568","59","120615393"
"chr5","135842922","135843152","chr6","131982553","131982776","28","3860369"
"chr5","135847881","135848168","chr6","131997237","131997532","41","3850644"
"chr5","135851239","135851350","chr6","132000720","132000834","11","3850519"
"chr5","135858762","135859012","chr15","83752479","83752725","48","52106283"
"chr5","135859040","135859318","chr6","132011315","132011598","24","3847725"
"chr5","135869237","135869538","chr2","56803979","56804276","66","79065258"
"chr5","135871364","135871516","chr17","92516729","92516881","41","43354635"
"chr5","135882850","135883141","chr6","132033490","132033782","11","3849360"
"chr5","135901859","135901974","chr6","132055622","132055738","10","3846237"
"chr5","135905155","135905490","chr6","132059257","132059589","18","3845898"
"chr5","135912367","135912649","chr6","132068673","132068961","22","3843694"
"chr5","135928823","135929043","chr4","87659306","87659521","44","48269517"
"chr5","135935115","135935428","chr10","85876409","85876710","73","50058706"
"chr5","135936038","135936326","chr6","132091442","132091729","27","3844596"
"chr5","135944758","135945053","chr6","132102125","132102420","14","3842633"
"chr5","135951425","135951710","chr6","132109257","132109544","19","3842168"
"chr5","135957233","135957530","chr6","132114884","132115188","25","3842349"
"chr5","135967798","135968096","chr6","105142168","105142470","54","30825630"
"chr5","135968476","135968682","chr13","62475074","62475295","49","73493402"
"chr5","135975732","135976016","chr1","43902169","43902461","50","92073563"
"chr5","135976589","135976819","chr6","132128704","132128934","20","3847885"
"chr5","135983117","135983402","chr6","132134301","132134588","14","3848816"
"chr5","136005334","136005521","chr19","39878357","39878534","40","96126977"
"chr5","136008002","136008125","chr6","132160187","132160309","5","3847815"
"chr5","136010148","136010413","chr14","68590922","68591186","52","67419226"
"chr5","136018068","136018236","chr9","7941831","7941997","30","128076237"
"chr5","136018526","136018631","chr6","132170814","132170920","6","3847712"
"chr5","136032148","136032426","chr6","132185717","132185999","16","3846431"
"chr5","136038605","136038888","chr6","132192519","132192801","20","3846086"
"chr5","136063763","136064047","chr6","132224039","132224329","29","3839724"
"chr5","136068381","136068696","chr6","132228869","132229185","20","3839512"
"chr5","136070020","136070109","chr12","43283820","43283911","15","92786200"
"chr5","136085886","136086168","chr10","52048534","52048819","55","84037352"
"chr5","136105388","136105664","chr6","132267130","132267394","28","3838258"
"chr5","136126247","136126530","chr6","132289161","132289445","21","3837086"
"chr5","136148365","136148642","chr3","164530139","164530408","68","28381774"
"chr5","136161329","136161604","chr6","132325967","132326246","17","3835362"
"chr5","136161881","136162005","chr6","132326523","132326647","5","3835358"
"chr5","136170850","136171132","chr3","54481480","54481765","57","81689370"
"chr5","136179827","136180055","chr6","132350146","132350385","35","3829681"
"chr5","136184927","136185224","chr6","132354837","132355140","39","3830090"
"chr5","136186405","136186696","chr6","132357109","132357402","17","3829296"
"chr5","136188282","136188570","chr6","132359008","132359302","21","3829274"
"chr5","136191674","136191794","chr6","132362087","132362209","6","3829587"
"chr5","136195540","136195620","chr19","51999241","51999323","23","84196299"
"chr5","136195648","136195812","chr19","16400696","16400865","33","119794952"
"chr5","136196725","136196923","chr6","132366759","132366961","20","3829966"
"chr5","136197217","136197359","chr6","132367249","132367384","15","3829968"
"chr5","136202399","136202691","chr1","195966885","195967183","58","59764486"
"chr5","136205904","136206027","chr6","132374465","132374590","5","3831439"
"chr5","136206288","136206298","chr3","42787293","42787303","4","93418995"
"chr5","136206334","136206467","chr17","54442955","54443088","23","81763379"
"chr5","136206692","136206994","chr20","28109999","28110300","60","108096693"
"chr5","136209216","136209485","chr6","132377729","132377996","24","3831487"
"chr5","136212554","136212884","chr6","132381382","132381719","28","3831172"
"chr5","136213006","136213130","chr6","132381838","132381956","20","3831168"
"chr5","136226186","136226402","chr15","68355893","68356110","55","67870293"
"chr5","136227572","136227724","chr16","10109340","10109491","35","126118232"
"chr5","136228000","136228097","chr4","15278126","15278223","22","120949874"
"chr5","136228594","136228871","chr6","132399195","132399473","19","3829399"
"chr5","136232057","136232358","chr3","154993304","154993599","54","18761247"
"chr5","136234460","136234747","chr6","132405254","132405545","17","3829206"
"chr5","136239705","136239992","chr6","132410795","132411078","20","3828910"
"chr5","136244428","136244682","chr6","132415262","132415516","12","3829166"
"chr5","136246402","136246718","chr6","132417059","132417352","49","3829343"
"chr5","136248744","136249051","chr16","51250741","51251057","57","84998003"
"chr5","136252971","136253260","chr6","132423382","132423671","14","3829589"
"chr5","136254975","136255181","chr6","132425644","132425862","26","3829331"
"chr5","136255466","136255612","chr6","132426166","132426314","8","3829300"
"chr5","136273195","136273340","chr6","132448196","132448332","14","3824999"
"chr5","136273622","136273788","chr6","132449227","132449376","31","3824395"
"chr5","136280459","136280552","chr19","53557165","53557256","24","82723294"
"chr5","136284444","136284757","chr1","211353988","211354282","65","75069544"
"chr5","136305593","136305884","chr1","20767068","20767351","72","115538525"
"chr5","136310886","136311178","chr15","26072924","26073215","59","110237962"
"chr5","136313669","136313960","chr6","132486775","132487074","33","3826894"
"chr5","136332892","136333207","chr1","123654708","123654992","84","12678184"
"chr5","136346187","136346471","chr6","132520861","132521147","19","3825326"
"chr5","136349074","136349353","chr11","13363839","13364105","74","122985235"
"chr5","136358696","136358995","chr6","132534093","132534408","39","3824603"
"chr5","136380502","136380805","chr6","132555233","132555527","22","3825269"
"chr5","136383478","136383605","chr6","132557931","132558060","9","3825547"
"chr5","136385380","136385671","chr6","132560105","132560401","29","3825275"
"chr5","136389185","136389468","chr6","132567351","132567625","21","3821834"
"chr5","136405013","136405266","chr6","132584238","132584491","26","3820775"
"chr5","136405280","136405605","chrX","71726697","71727007","83","64678583"
"chr5","136405916","136406098","chr3","159424290","159424479","46","23018374"
"chr5","136406134","136406150","chr7","137476579","137476595","3","1070445"
"chr5","136406397","136406531","chr19","13837786","13837919","24","122568611"
"chr5","136408057","136408203","chr7","43947697","43947840","29","92460360"
"chr5","136452128","136452412","chr6","132629385","132629669","12","3822743"
"chr5","136457313","136457600","chr6","68750302","68750588","65","67707011"
"chr5","136465647","136465813","chr15","103023676","103023833","33","33441971"
"chr5","136466143","136466432","chr6","132639944","132640234","19","3826199"
"chr5","136468618","136468792","chr6","132642426","132642600","15","3826192"
"chr5","136469079","136469231","chr6","132642897","132643047","11","3826182"
"chr5","136488860","136489167","chr1","182642228","182642528","64","46153368"
"chr5","136490313","136490599","chr6","132665134","132665420","21","3825179"
"chr5","136507596","136507766","chr6","132683975","132684152","13","3823621"
"chr5","136511817","136511979","chr10","27406902","27407056","35","109104915"
"chr5","136516201","136516499","chr6","132694344","132694636","19","3821857"
"chr5","136521763","136522036","chr6","132700142","132700421","26","3821621"
"chr5","136678781","136679087","chr6","132857909","132858217","24","3820872"
"chr5","136766605","136766838","chr7","45221269","45221486","64","91545336"
"chr5","136885729","136886053","chr6","133066352","133066650","55","3819377"
"chr5","136998241","136998553","chr3","64615785","64616099","67","72382456"
"chr5","137050922","137051152","chr14","66911348","66911552","63","70139574"
"chr5","137116277","137116581","chr1","94580284","94580588","61","42535993"
"chr5","137280928","137281217","chr6","133491807","133492094","16","3789121"
"chr5","137342203","137342494","chr6","133522016","133522285","38","3820187"
"chr5","137437505","137437812","chr6","133616599","133616906","23","3820906"
"chr5","137633382","137633684","chr6","133812634","133812939","32","3820748"
"chr5","137636776","137637078","chr6","133816046","133816347","28","3820730"
"chr5","137641119","137641328","chr6","133820400","133820611","19","3820719"
"chr5","137695611","137695823","chr6","133873819","133874015","26","3821792"
"chr5","137948498","137948810","chr6","134117882","134118171","42","3830616"
"chr5","138063075","138063348","chr1","129543506","129543782","56","8519569"
"chr5","138256468","138256615","chr6","134470917","134471065","9","3785551"
"chr5","138376788","138377094","chr6","134570768","134571088","33","3806020"
"chr5","138432307","138432622","chr6","134626921","134627199","60","3805386"
"chr5","138440050","138440241","chr9","60473538","60473710","47","77966512"
"chr5","138453479","138453770","chr6","134643941","134644234","22","3809538"
"chr5","138565148","138565265","chr6","134752617","134752734","9","3812531"
"chr5","138569201","138569330","chr7","128153226","128153353","16","10415975"
"chr5","138683700","138684013","chr6","134870801","134871115","23","3812899"
"chr5","138885184","138885454","chr6","135073016","135073266","40","3812168"
"chr5","138953971","138954267","chr6","135136806","135137101","19","3817165"
"chr5","139005225","139005529","chr6","135188382","135188692","39","3816843"
"chr5","139051402","139051711","chr6","135235368","135235664","33","3816034"
"chr5","139096162","139096428","chr6","135271793","135272063","32","3824369"
"chr5","139240090","139240205","chr20","71250545","71250655","30","67989545"
"chr5","139268313","139268617","chr2","84913076","84913368","57","54355237"
"chr5","139314581","139314722","chr6","135483624","135483755","12","3830957"
"chr5","139317877","139318200","chr1","216172516","216172841","71","76854639"
"chr5","139322001","139322212","chr6","135500987","135501196","15","3821014"
"chr5","139347578","139347855","chr6","135525652","135525950","36","3821926"
"chr5","139355045","139355335","chr6","135539624","135539913","16","3815421"
"chr5","139371024","139371211","chr6","135557038","135557231","15","3813986"
"chr5","139371360","139371584","chr6","135557372","135557597","20","3813988"
"chr5","139390296","139390603","chr6","135576725","135577035","23","3813571"
"chr5","139419301","139419602","chr6","135606116","135606419","23","3813185"
"chr5","139420328","139420634","chr6","135607303","135607606","21","3813025"
"chr5","139452034","139452155","chr6","135636864","135636981","5","3815170"
"chr5","139465667","139465970","chr3","161503080","161503385","66","22037413"
"chr5","139470772","139470868","chr8","38806459","38806555","22","100664313"
"chr5","139471739","139471989","chr6","135656150","135656426","39","3815589"
"chr5","139474676","139474972","chr6","135659105","135659400","24","3815571"
"chr5","139490838","139491127","chr6","135675462","135675751","20","3815376"
"chr5","139512872","139513172","chr13","27963158","27963457","56","111549714"
"chr5","139516677","139516790","chr3","127146489","127146603","18","12370188"
"chr5","139532764","139532890","chr4","86791505","86791631","18","52741259"
"chr5","139545237","139545510","chr6","135724570","135724866","44","3820667"
"chr5","139549275","139549417","chr1","36716841","36716980","32","102832434"
"chr5","139552530","139552814","chr5","51322379","51322663","50","88230151"
"chr5","139557291","139557594","chr14","63858277","63858583","60","75699014"
"chr5","139563929","139564175","chr7","61127662","61127921","65","78436267"
"chr5","139565401","139565652","chr6","135747025","135747278","13","3818376"
"chr5","139566187","139566482","chr6","135747626","135747936","34","3818561"
"chr5","139572075","139572384","chr6","135753611","135753919","19","3818464"
"chr5","139599922","139600204","chr6","135791477","135791755","13","3808445"
"chr5","139605898","139606144","chr16","39245643","39245870","51","100360255"
"chr5","139610935","139611241","chr9","109164176","109164476","52","30446759"
"chr5","139625492","139625615","chr19","28758218","28758342","11","110867274"
"chr5","139627476","139627773","chr19","28756057","28756343","50","110871419"
"chr5","139632972","139633269","chr6","135827330","135827638","23","3805642"
"chr5","139634235","139634471","chr6","135829533","135829780","27","3804702"
"chr5","139637615","139637906","chr6","135833833","135834126","16","3803782"
"chr5","139638001","139638302","chr6","135834221","135834524","15","3803780"
"chr5","139638459","139638657","chr19","19081721","19081916","46","120556738"
"chr5","139639745","139640043","chr9","98245565","98245863","61","41394180"
"chr5","139641007","139641290","chr6","135837498","135837781","19","3803509"
"chr5","139659341","139659417","chr6","135858320","135858396","3","3801021"
"chr5","139660592","139660890","chr2","84913076","84913368","58","54747516"
"chr5","139667233","139667494","chr6","135867538","135867799","13","3799695"
"chr5","139674344","139674464","chr6","135874529","135874653","11","3799815"
"chr5","139685504","139685709","chr6","135885721","135885934","19","3799783"
"chr5","139687377","139687425","chr12","34502965","34503015","9","105184412"
"chr5","139701041","139701334","chr14","122733616","122733911","58","16967425"
"chr5","139704705","139705001","chr6","135909192","135909466","42","3795513"
"chr5","139706658","139706879","chr6","135910403","135910645","30","3796255"
"chr5","139711368","139711496","chr3","41303396","41303525","27","98407972"
"chr5","139720839","139721117","chr7","123438224","123438511","72","16282615"
"chr5","139726424","139726681","chr6","135935253","135935557","56","3791171"
"chr5","139728138","139728340","chr6","135936519","135936721","8","3791619"
"chr5","139738811","139738872","chr7","144679979","144680049","19","4941168"
"chr5","139739167","139739340","chr9","25013308","25013473","38","114725859"
"chr5","139745735","139746044","chr6","135955603","135955897","54","3790132"
"chr5","139755384","139755555","chr6","135962101","135962268","15","3793283"
"chr5","139755868","139755965","chr6","135962569","135962666","9","3793299"
"chr5","139770910","139771165","chr6","135980278","135980539","23","3790632"
"chr5","139772573","139772860","chr6","135981920","135982220","28","3790653"
"chr5","139789796","139790085","chr6","135998782","135999086","31","3791014"
"chr5","139813483","139813672","chr3","48070686","48070883","37","91742797"
"chr5","139814729","139815008","chr6","136026742","136027021","19","3787987"
"chr5","139826300","139826513","chr6","136038920","136039160","34","3787380"
"chr5","139842019","139842325","chr6","136055188","136055488","25","3786831"
"chr5","139847942","139848221","chr6","136060702","136060995","39","3787240"
"chr5","139869687","139869856","chr6","136083426","136083584","38","3786261"
"chr5","139879354","139879672","chr6","136092691","136093028","44","3786663"
"chr5","139884594","139884891","chr14","122733616","122733911","54","17150978"
"chr5","139890809","139891062","chr6","136105334","136105587","10","3785475"
"chr5","139905208","139905475","chr6","136119435","136119703","16","3785773"
"chr5","139906571","139906693","chr6","136120786","136120910","17","3785785"
"chr5","139907993","139908137","chr6","136122566","136122708","8","3785427"
"chr5","139908446","139908613","chr6","136123013","136123168","21","3785433"
"chr5","139911563","139911848","chr3","7092558","7092844","52","132819005"
"chr5","139913009","139913318","chr6","136126982","136127288","28","3786027"
"chr5","139917122","139917412","chr6","136131850","136132133","30","3785272"
"chr5","139920693","139920817","chr6","136135700","136135822","4","3784993"
"chr5","139926687","139926970","chr6","136140477","136140767","30","3786210"
"chr5","139927165","139927299","chr6","136140962","136141096","2","3786203"
"chr5","139945038","139945180","chr8","21621594","21621739","32","118323444"
"chr5","139990963","139991260","chr19","15562519","15562818","60","124428444"
"chr5","140009302","140009601","chr6","136228512","136228811","31","3780790"
"chr5","140038573","140038850","chr6","136259388","136259618","67","3779185"
"chr5","140086673","140086978","chr6","136309713","136310020","19","3776960"
"chr5","140088668","140088792","chr3","39130288","39130412","18","100958380"
"chr5","140111637","140111912","chr6","136334144","136334419","12","3777493"
"chr5","140124527","140124812","chr1","110194418","110194687","63","29930109"
"chr5","140151067","140151344","chr6","136375841","136376120","19","3775226"
"chr5","140154125","140154241","chr14","8294861","8294977","15","131859264"
"chr5","140164980","140165256","chr6","136390382","136390660","36","3774598"
"chr5","140171754","140172036","chr6","136396417","136396704","23","3775337"
"chr5","140184809","140185031","chr6","136411271","136411491","10","3773538"
"chr5","140202162","140202447","chr6","136423874","136424180","44","3778288"
"chr5","140205646","140205994","chr6","136427176","136427513","46","3778470"
"chr5","140215895","140216021","chr19","3199820","3199949","21","137016075"
"chr5","140216722","140217029","chr6","136438748","136439053","20","3777974"
"chr5","140226769","140226902","chr1","128086244","128086378","15","12140525"
"chr5","140228094","140228195","chr3","13711275","13711376","13","126516819"
"chr5","140256320","140256623","chr6","136476815","136477095","40","3779505"
"chr5","140265398","140265691","chr6","136486559","136486818","60","3778839"
"chr5","140307988","140308187","chr7","161499804","161499998","50","21191816"
"chr5","140308387","140308681","chr6","136528130","136528399","46","3780257"
"chr5","140322839","140323065","chr6","136542239","136542462","29","3780600"
"chr5","140331208","140331467","chr6","136550557","136550777","51","3780651"
"chr5","140357649","140357734","chr5","168852971","168853053","12","28495322"
"chr5","140360817","140361126","chr11","46246424","46246728","68","94114393"
"chr5","140361974","140362093","chr6","136581954","136582071","9","3780020"
"chr5","140362617","140362912","chr2","160551205","160551504","54","20188588"
"chr5","140405640","140405839","chr6","136626357","136626601","54","3779283"
"chr5","140412219","140412509","chr6","136632954","136633229","61","3779265"
"chr5","140414787","140415076","chr6","136635784","136636077","27","3779003"
"chr5","140420342","140420550","chr6","136641329","136641535","7","3779013"
"chr5","140507950","140508070","chr6","136728604","136728728","10","3779346"
"chr5","140514687","140514800","chr6","136730175","136730287","5","3784512"
"chr5","140515223","140515498","chr10","87029863","87030136","62","53485360"
"chr5","140532645","140532931","chr2","75624656","75624948","61","64907989"
"chr5","140533191","140533314","chr6","139300949","139301067","31","1232242"
"chr5","140533623","140533781","chr6","136749053","136749193","34","3784570"
"chr5","140545883","140546138","chr6","136761617","136761873","13","3784266"
"chr5","140548202","140548495","chr6","136763929","136764230","31","3784273"
"chr5","140557147","140557439","chr6","136772553","136772840","17","3784594"
"chr5","140571274","140571607","chr6","136785918","136786256","24","3785356"
"chr5","140576353","140576649","chr6","136791301","136791597","17","3785052"
"chr5","140591794","140592080","chr6","136806351","136806644","35","3785443"
"chr5","140617482","140617637","chr6","112634956","112635113","42","27982526"
"chr5","140624772","140624902","chr13","87095059","87095190","18","53529713"
"chr5","140629252","140629525","chr6","136842729","136842996","31","3786523"
"chr5","140630911","140631149","chr6","136844397","136844634","25","3786514"
"chr5","140642498","140642789","chr6","136855431","136855736","31","3787067"
"chr5","140647328","140647643","chr6","136860809","136861098","42","3786519"
"chr5","140667227","140667484","chr6","136883498","136883754","23","3783729"
"chr5","140678110","140678407","chr6","136895709","136896000","28","3782401"
"chr5","140682708","140683017","chr6","136900571","136900861","46","3782137"
"chr5","140689805","140689875","chr4","128816789","128816860","15","11873016"
"chr5","140694160","140694451","chr6","136912131","136912434","32","3782029"
"chr5","140717335","140717630","chr6","136939884","136940177","29","3777451"
"chr5","140718586","140718912","chr6","136940902","136941237","36","3777684"
"chr5","140719057","140719167","chr6","136941734","136941844","5","3777323"
"chr5","140719276","140719558","chr6","37344828","37345112","67","103374448"
"chr5","140724657","140725024","chrX","74652859","74653211","91","66071798"
"chr5","140734385","140734608","chr3","38839947","38840148","49","101894438"
"chr5","140751238","140751511","chr6","136984093","136984367","13","3767145"
"chr5","140773081","140773397","chr6","129530826","129531119","88","11242255"
"chr5","140781388","140781500","chr17","24340390","24340506","18","116440998"
"chr5","140787997","140788268","chr6","137024981","137025285","57","3763016"
"chr5","140830254","140830542","chr6","137068983","137069272","25","3761271"
"chr5","140844894","140845117","chr6","137084158","137084385","12","3760736"
"chr5","140916953","140917252","chr6","137200255","137200553","19","3716698"
"chr5","140918006","140918292","chr6","137201312","137201581","37","3716694"
"chr5","140920445","140920566","chr6","137203728","137203851","10","3716717"
"chr5","140923183","140923487","chr6","137206964","137207273","17","3716219"
"chr5","140926016","140926178","chr3","126621167","126621327","30","14304849"
"chr5","140927866","140928167","chr6","137212710","137213022","37","3715156"
"chr5","140929627","140929934","chr15","108652079","108652384","66","32277548"
"chr5","140936958","140937236","chr6","137221836","137222127","45","3715122"
"chr5","140942256","140942512","chr6","137228652","137228912","33","3713604"
"chr5","140950387","140950640","chr6","137236005","137236245","32","3714382"
"chr5","140956013","140956257","chr6","137241244","137241477","22","3714769"
"chr5","140959022","140959334","chr3","133314498","133314804","60","7644524"
"chr5","140961755","140962054","chr6","137249097","137249387","25","3712658"
"chr5","140992764","140992974","chr11","23440646","23440857","42","117552118"
"chr5","141010296","141010586","chr1","5267149","5267433","66","135743147"
"chr5","141011434","141011684","chr6","137292214","137292456","21","3719220"
"chr5","141045319","141045503","chr6","137321723","137321910","11","3723596"
"chr5","141063424","141063703","chr17","80451626","80451910","67","60611798"
"chr5","141066136","141066411","chr6","137348158","137348436","23","3717978"
"chr5","141067723","141067746","chr3","44179748","44179769","10","96887975"
"chr5","141068009","141068109","chr9","40472755","40472846","28","100595254"
"chr5","141068380","141068554","chr3","47065508","47065682","51","94002872"
"chr5","141069604","141069876","chr7","53269840","53270105","80","87799764"
"chr5","141076757","141076920","chr10","35599622","35599787","32","105477135"
"chr5","141081298","141081584","chr6","137365056","137365339","24","3716242"
"chr5","141092044","141092330","chr7","82212126","82212416","60","58879918"
"chr5","141095524","141095828","chr6","137378966","137379259","34","3716558"
"chr5","141109303","141109600","chr6","137392323","137392617","38","3716980"
"chr5","141112704","141112977","chr7","158402641","158402866","82","17289937"
"chr5","141182482","141182748","chr6","137467980","137468252","45","3714502"
"chr5","141192094","141192197","chr6","137478648","137478751","8","3713446"
"chr5","141215082","141215332","chr6","137502623","137502878","20","3712459"
"chr5","141237866","141238163","chr6","137525557","137525853","22","3712309"
"chr5","141240257","141240484","chr4","127794161","127794374","63","13446096"
"chr5","141247920","141247931","chr2","139350862","139350874","2","1897058"
"chr5","141248241","141248456","chr3","79858554","79858774","46","61389687"
"chr5","141259154","141259417","chr6","137546393","137546646","25","3712761"
"chr5","141303757","141304060","chr6","137592150","137592459","35","3711607"
"chr5","141319752","141320067","chr6","137609189","137609511","35","3710563"
"chr5","141424030","141424323","chr6","137715471","137715768","26","3708559"
"chr5","141480820","141481130","chr6","137770786","137771096","16","3710034"
"chr5","141486671","141486966","chr6","137777322","137777607","40","3709349"
"chr5","141554550","141554873","chr10","33357023","33357350","104","108197527"
"chr5","141568850","141569168","chr6","137861773","137862082","29","3707077"
"chr5","141662965","141663236","chr16","24886270","24886545","55","116776695"
"chr5","141665489","141665699","chr6","137961184","137961394","14","3704305"
"chr5","141665783","141665896","chrX","101584108","101584224","23","40081675"
"chr5","141672048","141672358","chr6","137967529","137967815","38","3704519"
"chr5","141688119","141688405","chr6","137983323","137983603","26","3704796"
"chr5","141708360","141708665","chr1","51367931","51368230","60","90340429"
"chr5","141708747","141709046","chr2","160551205","160551504","54","18842458"
"chr5","141739393","141739452","chr6","138032046","138032105","1","3707347"
"chr5","141748583","141748889","chr6","138041378","138041684","26","3707205"
"chr5","141753030","141753335","chr6","138045740","138046045","20","3707290"
"chr5","141765613","141765929","chr3","132351538","132351859","59","9414075"
"chr5","141790914","141791202","chr6","138088121","138088412","20","3702793"
"chr5","141791879","141792012","chr6","138089114","138089249","6","3702765"
"chr5","141792704","141792882","chr20","25790723","25790891","45","116001981"
"chr5","141802864","141802989","chr6","138099640","138099765","9","3703224"
"chr5","141809313","141809580","chr6","138105720","138106002","30","3703593"
"chr5","141812700","141813018","chr6","138109120","138109417","36","3703580"
"chr5","141837588","141837894","chr6","138135118","138135418","38","3702470"
"chr5","141852914","141853171","chr6","138150091","138150350","17","3702823"
"chr5","141861757","141861773","chr13","87326836","87326849","5","54534921"
"chr5","141863183","141863484","chr6","138161576","138161878","17","3701607"
"chr5","141864787","141865110","chr6","138163171","138163484","38","3701616"
"chr5","141865617","141865967","chr6","138163997","138164352","28","3701620"
"chr5","141879196","141879507","chr6","139778709","139779007","52","2100487"
"chr5","141907681","141907994","chr6","138209799","138210109","36","3697882"
"chr5","141909102","141909284","chr6","138211262","138211436","18","3697840"
"chr5","141913098","141913403","chr6","138215770","138216088","30","3697328"
"chr5","141927364","141927561","chr6","138230052","138230248","12","3697312"
"chr5","141930957","141931027","chr20","10972571","10972642","10","130958386"
"chr5","141933502","141933706","chr6","138236673","138236877","16","3696829"
"chr5","141945708","141946015","chr6","138243862","138244168","19","3701846"
"chr5","141957438","141957660","chr6","138255490","138255703","19","3701948"
"chr5","141972107","141972353","chr6","138270340","138270574","25","3701767"
"chr5","141977217","141977293","chr2","181053562","181053633","15","39076345"
"chr5","141989135","141989250","chr6","138288021","138288136","3","3701114"
"chr5","142003696","142003829","chr16","39379692","39379819","18","102624004"
"chr5","142069155","142069358","chr1","34916004","34916198","53","107153151"
"chr5","142087509","142087713","chr6","138384224","138384432","15","3703285"
"chr5","142091217","142091410","chr6","138389399","138389597","12","3701818"
"chr5","142091708","142091833","chr6","138389915","138390039","5","3701793"
"chr5","142097614","142097911","chr3","13411522","13411814","64","128686092"
"chr5","142105166","142105285","chr15","104360931","104361048","11","37744235"
"chr5","142144457","142144655","chr6","138429847","138430044","12","3714610"
"chr5","142162720","142162838","chr6","138449164","138449282","4","3713556"
"chr5","142175610","142175731","chr16","57734667","57734789","21","84440943"
"chr5","142190274","142190399","chr6","138476509","138476639","14","3713765"
"chr5","142198130","142198261","chr6","138484581","138484712","7","3713549"
"chr5","142198598","142198732","chr6","138477508","138477643","20","3721090"
"chr5","142204982","142205126","chr6","138484581","138484712","21","3720401"
"chr5","142205425","142205575","chr6","138485028","138485168","31","3720397"
"chr5","142217988","142218120","chr7","45689838","45689967","19","96528150"
"chr5","142222271","142222558","chr6","138500643","138500931","16","3721628"
"chr5","142242893","142243192","chr6","138535517","138535829","34","3707376"
"chr5","142249136","142249265","chr11","88980531","88980661","19","53268605"
"chr5","142259583","142259894","chr1","44230646","44230948","60","98028937"
"chr5","142293230","142293515","chr6","138584249","138584534","17","3708981"
"chr5","142304022","142304310","chr6","138595786","138596074","32","3708236"
"chr5","142317251","142317564","chr6","138608851","138609160","40","3708400"
"chr5","142318403","142318660","chr6","138609804","138610060","25","3708599"
"chr5","142339764","142339888","chr19","16516188","16516311","22","125823576"
"chr5","142339935","142340158","chr3","3881369","3881580","64","138458566"
"chr5","142344656","142344780","chr6","138635841","138635962","13","3708815"
"chr5","142352084","142352322","chr6","138643240","138643473","24","3708844"
"chr5","142402972","142403219","chr6","138690896","138691125","36","3712076"
"chr5","142423456","142423466","chrX","126111300","126111310","2","16312156"
"chr5","142423495","142423766","chr6","138710434","138710734","48","3713061"
"chr5","142451428","142451655","chr6","138738558","138738773","32","3712870"
"chr5","142479589","142479701","chr5","147515401","147515512","21","5035812"
"chr5","142480064","142480253","chr6","138765011","138765205","27","3715053"
"chr5","142488197","142488497","chr6","138773860","138774156","30","3714337"
"chr5","142491725","142491848","chr6","138778019","138778141","5","3713706"
"chr5","142501378","142501681","chr6","138787666","138787980","36","3713712"
"chr5","142512732","142513054","chr6","138799302","138799611","27","3713430"
"chr5","142526863","142527149","chr2","106961626","106961923","63","35565237"
"chr5","142546710","142546784","chr12","114665945","114666020","17","27880765"
"chr5","142585810","142586094","chr6","138874837","138875119","18","3710973"
"chr5","142594308","142594590","chr6","138880014","138880302","27","3714294"
"chr5","142595709","142596013","chr11","78355848","78356152","48","64239861"
"chr5","142603941","142604268","chr3","123570746","123571070","62","19033195"
"chr5","142682742","142682863","chr6","138966643","138966767","11","3716099"
"chr5","142695289","142695464","chr13","73995519","73995698","28","68699770"
"chr5","142695505","142695538","chr1","134248153","134248180","8","8447352"
"chr5","142720358","142720666","chr6","139002549","139002857","27","3717809"
"chr5","142739058","142739162","chr10","21005183","21005283","17","121733875"
"chr5","142755789","142756071","chr1","6293664","6293944","52","136462125"
"chr5","142759890","142760037","chr1","67590107","67590252","27","75169783"
"chr5","142760335","142760437","chr7","51585793","51585890","29","91174542"
"chr5","142771147","142771351","chr16","54638113","54638322","39","88133034"
"chr5","142852201","142852489","chr6","139134252","139134518","61","3717949"
"chr5","142866186","142866383","chr12","105115619","105115812","43","37750567"
"chr5","142880971","142881210","chr12","58959254","58959494","74","83921717"
"chr5","142886500","142886747","chr6","139168605","139168879","41","3717895"
"chr5","142928176","142928503","chr6","139215226","139215535","36","3712950"
"chr5","142933773","142934061","chr6","139221076","139221359","28","3712697"
"chr5","142939766","142940057","chr6","139226834","139227135","27","3712932"
"chr5","142945876","142946190","chr6","139232594","139232888","41","3713282"
"chr5","142954936","142955214","chr6","139242352","139242623","22","3712584"
"chr5","143006441","143006732","chr6","139294542","139294860","40","3711899"
"chr5","143011162","143011383","chr19","18303366","18303591","41","124707796"
"chr5","143083680","143083795","chr6","139383516","139383625","10","3700164"
"chr5","143109083","143109374","chr6","139410752","139411046","8","3698331"
"chr5","143147106","143147377","chr3","39159304","39159586","50","103987802"
"chr5","143157756","143158049","chr6","139463141","139463440","22","3694615"
"chr5","143247129","143247424","chr6","139553834","139554125","24","3693295"
"chr5","143262123","143262426","chr6","139568658","139568957","18","3693465"
"chr5","143284388","143284677","chr6","139592974","139593287","37","3691414"
"chr5","143300174","143300321","chr11","105301908","105302057","28","37998266"
"chr5","143304048","143304361","chr4","17925503","17925807","66","125378545"
"chr5","143443513","143443796","chr6","139759292","139759574","16","3684221"
"chr5","143451809","143452107","chr6","139767455","139767753","20","3684354"
"chr5","143462548","143462835","chr6","139778709","139779007","35","3683839"
"chr5","143465771","143466105","chr6","139782537","139782845","48","3683234"
"chr5","143472123","143472412","chr6","139789230","139789517","14","3682893"
"chr5","143492757","143493083","chr6","139810685","139810997","30","3682072"
"chr5","143516368","143516693","chr2","56830368","56830679","74","86686000"
"chr5","143522594","143522790","chrX","63060349","63060546","38","80462245"
"chr5","143532580","143532874","chr5","188544103","188544392","58","45011523"
"chr5","143541795","143541976","chr6","139860172","139860362","20","3681623"
"chr5","143572495","143572759","chr6","139894847","139895155","63","3677648"
"chr5","143594346","143594621","chr6","139919555","139919827","24","3674791"
"chr5","143599513","143599615","chr7","164775126","164775218","25","21175613"
"chr5","143610589","143610890","chr6","139937278","139937575","23","3673311"
"chr5","143642687","143643007","chr1","183896767","183897077","59","40254080"
"chr5","143662114","143662246","chr6","139988871","139989003","9","3673243"
"chr5","143681112","143681376","chrX","149122851","149123109","51","5441739"
"chr5","143682109","143682200","chr1","23471532","23471627","27","120210577"
"chr5","143701647","143701953","chr6","140026187","140026464","41","3675460"
"chr5","143706810","143707108","chr6","140031392","140031687","10","3675418"
"chr5","143708984","143709207","chr7","40459630","40459877","62","103249354"
"chr5","143721939","143722183","chr7","138589300","138589547","51","5132639"
"chr5","143738200","143738511","chr6","140059731","140060013","50","3678469"
"chr5","143739004","143739307","chr6","140060852","140061140","29","3678152"
"chr5","143741415","143741614","chr6","140063266","140063459","14","3678149"
"chr5","143743648","143743929","chr13","10443034","10443317","51","133300614"
"chr5","143767548","143767846","chr7","63605108","63605403","58","80162440"
"chr5","143773318","143773630","chr6","140096165","140096490","30","3677153"
"chr5","143800719","143800975","chr3","36424130","36424381","49","107376589"
"chr5","143805796","143806097","chr6","140128245","140128544","15","3677551"
"chr5","143833536","143833737","chr16","66796945","66797143","52","77036591"
"chr5","143834411","143834682","chr6","140160967","140161244","33","3673444"
"chr5","143859327","143859521","chr10","90471441","90471634","45","53387886"
"chr5","143866901","143867193","chr6","140195314","140195584","34","3671587"
"chr5","143878132","143878426","chr6","140206795","140207096","25","3671337"
"chr5","143894056","143894214","chr9","57629418","57629573","31","86264638"
"chr5","143894520","143894623","chr1","125493296","125493388","32","18401224"
"chr5","143912730","143913018","chr6","140245720","140246015","18","3667010"
"chr5","143925839","143926124","chr6","140260794","140261085","25","3665045"
"chr5","143958346","143958614","chr7","116661654","116661930","66","27296692"
"chr5","144017151","144017466","chr6","140357746","140358068","35","3659405"
"chr5","144019799","144020113","chr6","140360380","140360663","48","3659419"
"chr5","144060398","144060697","chr6","140404322","140404614","41","3656076"
"chr5","144087304","144087471","chr6","140418534","140418709","10","3668770"
"chr5","144087773","144087920","chr6","140419013","140419155","15","3668760"
"chr5","144130028","144130305","chr6","140462891","140463186","33","3667137"
"chr5","144174576","144174882","chr6","140508004","140508283","59","3666572"
"chr5","144206865","144207197","chr6","140540388","140540710","28","3666477"
"chr5","144232717","144232841","chr1","144486514","144486647","27","253797"
"chr5","144240169","144240303","chr6","140573674","140573808","9","3666495"
"chr5","144250018","144250276","chr1","52254039","52254298","83","91995979"
"chr5","144250317","144250568","chr6","140583973","140584224","15","3666344"
"chr5","144276153","144276282","chr5","24916403","24916528","37","119359750"
"chr5","144276535","144276733","chr1","140578472","140578663","52","3698063"
"chr5","144279691","144279990","chr6","140614157","140614463","28","3665534"
"chr5","144339550","144339828","chr5","140153210","140153489","50","4186340"
"chr5","144420334","144420636","chr6","140751901","140752207","14","3668433"
"chr5","144461126","144461472","chr6","140795573","140795878","79","3665553"
"chr5","144483997","144484080","chr6","140818813","140818896","9","3665184"
"chr5","144539753","144540044","chr6","140877928","140878210","33","3661825"
"chr5","144587296","144587597","chr6","140924118","140924419","17","3663178"
"chr5","144608133","144608448","chr6","140944955","140945239","52","3663178"
"chr5","144624217","144624518","chr6","140960993","140961297","22","3663224"
"chr5","144636841","144636923","chr6","140973819","140973901","11","3663022"
"chr5","144735821","144736117","chr6","141073719","141074006","43","3662102"
"chr5","144746423","144746654","chr1","8008407","8008640","47","136738016"
"chr5","144771178","144771468","chr6","141109763","141110056","16","3661415"
"chr5","144774647","144774923","chr6","141113349","141113625","25","3661298"
"chr5","144826283","144826587","chr6","141166136","141166440","15","3660147"
"chr5","144839563","144839858","chr6","141179646","141179933","33","3659917"
"chr5","144903205","144903508","chr6","141240640","141240948","27","3662565"
"chr5","144920455","144920578","chr1","62783685","62783810","16","82136770"
"chr5","144934212","144934294","chr6","141271553","141271631","6","3662659"
"chr5","144997130","144997422","chr6","141335494","141335823","59","3661636"
"chr5","145056423","145056589","chr20","21940845","21941005","39","123115578"
"chr5","145119802","145120088","chr6","141463069","141463341","32","3656733"
"chr5","145237217","145237522","chr6","141579342","141579648","17","3657875"
"chr5","145255219","145255335","chr6","141600666","141600780","10","3654553"
"chr5","145391529","145391765","chr8","67666315","67666557","55","77725214"
"chr5","145420524","145420823","chr6","141758437","141758736","20","3662087"
"chr5","145454657","145454761","chr8","96949211","96949317","13","48505446"
"chr5","145605107","145605374","chr6","141938078","141938351","23","3667029"
"chr5","145619016","145619314","chr6","141952047","141952349","32","3666969"
"chr5","145654633","145654936","chr6","141994654","141994955","18","3659979"
"chr5","145708778","145709073","chr6","142047694","142047964","39","3661084"
"chr5","145718514","145718800","chr1","15477611","15477890","62","130240903"
"chr5","145811075","145811389","chr16","38454878","38455193","68","107356197"
"chr5","145948598","145948884","chr2","69678536","69678808","76","76270062"
"chr5","146177092","146177199","chr1","20201040","20201149","24","125976052"
"chr5","146177245","146177392","chr11","78750688","78750823","51","67426557"
"chr5","146243960","146244273","chr6","142647824","142648152","36","3596136"
"chr5","146344725","146345008","chr6","142743377","142743640","39","3601348"
"chr5","146433258","146433530","chr6","142868852","142869140","76","3564406"
"chr5","146438499","146438765","chr6","142874141","142874403","24","3564358"
"chr5","146459028","146459312","chr6","142900898","142901206","45","3558130"
"chr5","146504320","146504606","chr6","142944241","142944516","29","3560079"
"chr5","146508956","146509126","chr6","142952810","142952981","14","3556146"
"chr5","146509170","146509286","chr6","142953038","142953153","10","3556132"
"chr5","146597257","146597503","chr15","18291594","18291841","63","128305663"
"chr5","146653772","146654068","chr8","125828478","125828772","71","20825294"
"chr5","146724984","146725276","chr6","143193857","143194143","23","3531127"
"chr5","146740712","146740977","chr9","32042924","32043200","62","114697788"
"chr5","146762167","146762457","chr6","143230838","143231142","40","3531329"
"chr5","146795053","146795328","chr6","143343978","143344268","30","3451075"
"chr5","146960871","146961169","chr11","118040872","118041169","59","28919999"
"chr5","146963059","146963284","chr19","45490756","45490976","50","101472303"
"chr5","147158731","147159022","chr6","143697361","143697660","28","3461370"
"chr5","147197984","147198243","chr6","143763546","143763815","35","3434438"
"chr5","147226855","147227075","chr12","100306628","100306841","47","46920227"
"chr5","147234781","147235044","chr6","143802595","143802850","39","3432186"
"chr5","147273185","147273489","chr6","143842278","143842582","20","3430907"
"chr5","147275892","147276152","chr6","143844974","143845226","47","3430918"
"chr5","147281449","147281771","chr1","213490464","213490762","77","66209015"
"chr5","147301863","147302158","chr6","143871372","143871655","36","3430491"
"chr5","147351738","147351953","chr6","143922169","143922392","15","3429569"
"chr5","147366653","147366959","chr6","143930981","143931270","28","3435672"
"chr5","147376402","147376696","chr6","143941055","143941346","29","3435347"
"chr5","147395640","147395948","chr1","39092983","39093291","49","108302657"
"chr5","147409053","147409201","chr6","143971411","143971559","12","3437642"
"chr5","147424820","147424974","chr10","27406902","27407056","28","120017918"
"chr5","147433817","147433973","chr7","84537557","84537711","27","62896260"
"chr5","147449102","147449393","chr6","144017468","144017757","25","3431634"
"chr5","147510731","147511024","chr3","40783093","40783379","61","106727638"
"chr5","147571452","147571685","chr1","37150916","37151134","66","110420536"
"chr5","147595382","147595687","chr6","144169346","144169670","41","3426036"
"chr5","147603937","147604061","chr6","144176940","144177063","11","3426997"
"chr5","147657096","147657401","chr2","139523227","139523524","63","8133869"
"chr5","147660998","147661287","chr15","43687639","43687935","56","103973359"
"chr5","147682460","147682590","chr6","144264725","144264855","2","3417735"
"chr5","147691136","147691455","chr6","144273711","144274027","20","3417425"
"chr5","147707356","147707650","chr6","144290626","144290925","26","3416730"
"chr5","147730557","147730836","chr6","144315524","144315811","38","3415033"
"chr5","147815562","147815804","chr12","7260567","7260806","54","140554995"
"chr5","147820618","147820936","chr6","144410903","144411215","32","3409715"
"chr5","147839692","147839994","chr6","144431240","144431543","33","3408452"
"chr5","147865194","147865386","chr6","144457259","144457446","15","3407935"
"chr5","147868020","147868286","chr6","144460326","144460587","35","3407694"
"chr5","147937757","147938043","chr6","144530347","144530634","23","3407410"
"chr5","147948415","147948689","chr6","144540918","144541197","24","3407497"
"chr5","147957580","147957759","chr6","144550408","144550592","16","3407172"
"chr5","147977887","147978202","chr8","10857705","10858010","76","137120182"
"chr5","147992723","147992870","chr6","144586622","144586774","17","3406101"
"chr5","147995556","147995855","chr6","144590373","144590675","23","3405183"
"chr5","148028682","148028808","chr1","117811669","117811797","22","30217013"
"chr5","148187877","148188169","chrX","13287297","13287589","51","134900580"
"chr5","148218020","148218299","chr6","144828937","144829210","17","3389083"
"chr5","148573853","148574041","chr6","145186644","145186835","25","3387209"
"chr5","148604033","148604179","chrX","21259264","21259411","33","127344769"
"chr5","148604233","148604394","chr1","121466425","121466572","42","27137808"
"chr5","148661296","148661605","chr6","145256536","145256845","21","3404760"
"chr5","148671544","148671866","chr6","145272669","145272985","42","3398875"
"chr5","148729799","148730087","chr1","129543506","129543782","60","19186293"
"chr5","148764362","148764614","chr6","145365675","145365929","16","3398687"
"chr5","148771163","148771491","chr6","145372335","145372654","26","3398828"
"chr5","148776073","148776296","chr6","145376462","145376667","30","3399611"
"chr5","148777910","148778211","chr6","145378194","145378497","45","3399716"
"chr5","148811426","148811577","chr7","83975810","83975960","29","64835616"
"chr5","148822135","148822416","chr5","140153210","140153489","60","8668925"
"chr5","148833334","148833610","chr6","145435677","145435962","44","3397657"
"chr5","148923469","148923779","chr6","145527732","145528040","29","3395737"
"chr5","148952665","148952971","chr6","145557180","145557496","34","3395485"
"chr5","148999645","148999923","chr6","145598007","145598298","34","3401638"
"chr5","149001507","149001784","chr6","145599887","145600163","17","3401620"
"chr5","149042874","149043176","chr6","145631142","145631439","28","3411732"
"chr5","149148999","149149115","chr11","123766898","123767015","21","25382101"
"chr5","149149141","149149297","chr6","56108880","56109036","41","93040261"
"chr5","149249855","149250143","chr6","145834997","145835288","26","3414858"
"chr5","149263454","149263763","chr2","160551205","160551504","64","11287751"
"chr5","149352954","149353259","chr6","145937333","145937637","14","3415621"
"chr5","149433839","149434146","chr9","35488681","35488984","67","113945158"
"chr5","149536719","149537011","chr6","146122280","146122558","31","3414439"
"chr5","149550006","149550318","chr6","146134701","146135010","26","3415305"
"chr5","149565326","149565628","chr6","146151191","146151509","37","3414135"
"chr5","149566708","149566983","chr6","146152597","146152875","22","3414111"
"chr5","149611021","149611302","chr19","6071867","6072144","68","143539154"
"chr5","149631287","149631413","chr6","146226021","146226147","9","3405266"
"chr5","149835981","149836236","chr6","146532102","146532360","15","3303879"
"chr5","149859881","149860191","chr3","47567768","47568083","59","102292113"
"chr5","149958621","149958888","chr6","146645898","146646196","53","3312723"
"chr5","150135332","150135614","chr6","146809084","146809389","50","3326248"
"chr5","150206424","150206676","chr6","146881701","146881942","20","3324723"
"chr5","150217244","150217538","chr6","146893162","146893457","18","3324082"
"chr5","150279862","150280173","chr6","146957135","146957468","47","3322727"
"chr5","150350125","150350400","chr6","147026536","147026812","19","3323589"
"chr5","150386483","150386625","chr6","147066247","147066387","24","3320236"
"chr5","150538387","150538690","chr6","147215562","147215830","53","3322825"
"chr5","150700383","150700697","chr6","147388080","147388400","27","3312303"
"chr5","150745750","150746048","chr6","147432797","147433108","39","3312953"
"chr5","150812271","150812562","chr6","147497028","147497329","29","3315243"
"chr5","150824125","150824435","chr6","147508766","147509077","23","3315359"
"chr5","150855126","150855461","chr6","147540676","147541022","26","3314450"
"chr5","150867350","150867529","chr6","147553175","147553361","21","3314175"
"chr5","150880602","150880867","chr6","147567542","147567805","21","3313060"
"chr5","150903374","150903585","chr19","5642965","5643188","44","145260409"
"chr5","150916003","150916313","chr6","147604578","147604875","33","3311425"
"chr5","150937241","150937557","chr6","147626345","147626669","37","3310896"
"chr5","150961041","150961342","chr6","147651087","147651385","32","3309954"
"chr5","150973793","150974011","chr6","147664285","147664539","45","3309508"
"chr5","150990201","150990320","chr7","40819207","40819325","15","110170994"
"chr5","151002214","151002425","chr13","75616065","75616265","43","75386149"
"chr5","151005632","151005920","chr6","147702970","147703255","23","3302662"
"chr5","151022919","151023176","chr6","147720521","147720773","15","3302398"
"chr5","151023310","151023463","chr6","147720913","147721066","11","3302397"
"chr5","151023788","151023933","chr6","147721380","147721528","12","3302408"
"chr5","151029103","151029410","chr7","115167246","115167549","55","35861857"
"chr5","151048996","151049228","chr6","147745733","147745972","27","3303263"
"chr5","151078848","151078869","chr20","58195842","58195860","3","92883006"
"chr5","151078907","151079178","chr12","70180559","70180840","65","80898348"
"chr5","151093804","151094079","chr10","2309705","2309984","35","148784099"
"chr5","151105157","151105452","chr6","147800916","147801225","30","3304241"
"chr5","151117739","151118060","chr6","147814363","147814699","51","3303376"
"chr5","151128826","151129134","chr6","147825506","147825804","29","3303320"
"chr5","151130376","151130662","chr6","147827084","147827370","24","3303292"
"chr5","151141527","151141688","chr14","110458224","110458363","43","40683303"
"chr5","151150006","151150193","chr6","147847687","147847871","15","3302319"
"chr5","151154877","151155089","chr6","147852631","147852845","27","3302246"
"chr5","151193954","151194240","chr6","147890960","147891251","18","3302994"
"chr5","151201559","151201801","chr6","147897022","147897288","47","3304537"
"chr5","151260063","151260377","chr6","147957138","147957457","20","3302925"
"chr5","151289758","151290071","chr3","36458013","36458312","61","114831745"
"chr5","151294895","151295192","chr6","147992052","147992350","24","3302843"
"chr5","151301281","151301528","chr6","147998510","147998758","13","3302771"
"chr5","151306771","151307071","chr11","48283444","48283741","60","103023327"
"chr5","151307626","151307796","chr6","148005318","148005488","13","3302308"
"chr5","151315193","151315473","chr6","148012636","148012916","10","3302557"
"chr5","151323259","151323549","chr4","81211894","81212176","68","70111365"
"chr5","151342944","151343169","chr6","148041681","148041898","23","3301263"
"chr5","151343307","151343489","chr6","68146972","68147145","47","83196335"
"chr5","151349809","151350130","chr11","109549897","109550213","68","41799912"
"chr5","151351253","151351385","chr6","148050287","148050417","10","3300966"
"chr5","151364141","151364422","chr1","210815178","210815463","64","59451037"
"chr5","151386157","151386452","chr6","148081247","148081510","53","3304910"
"chr5","151387029","151387337","chr6","148082090","148082399","18","3304939"
"chr5","151388594","151388902","chr17","80429135","80429431","65","70959459"
"chr5","151400348","151400648","chr6","148097362","148097663","22","3302986"
"chr5","151403998","151404292","chr6","148107239","148107535","24","3296759"
"chr5","151414443","151414735","chr6","148117017","148117310","18","3297426"
"chr5","151433237","151433547","chr6","148136132","148136424","30","3297105"
"chr5","151434413","151434546","chr6","148137632","148137766","22","3296781"
"chr5","151449523","151449583","chr6","148152458","148152523","9","3297065"
"chr5","151459162","151459456","chr6","148162216","148162519","38","3296946"
"chr5","151471077","151471307","chr17","9934054","9934270","65","141537023"
"chr5","151485353","151485659","chr6","148188534","148188842","29","3296819"
"chr5","151535268","151535570","chr6","148240519","148240825","19","3294749"
"chr5","151628528","151628582","chr6","148333498","148333552","5","3295030"
"chr5","151644268","151644459","chr6","148349423","148349611","13","3294845"
"chr5","151698692","151698908","chr9","15256531","15256742","43","136442161"
"chr5","151751888","151752165","chr7","96360852","96361138","61","55391036"
"chr5","151777610","151777919","chr6","148482177","148482490","17","3295433"
"chr5","151789772","151790072","chr6","148494608","148494896","33","3295164"
"chr5","151795181","151795395","chr6","148498698","148498901","21","3296483"
"chr5","151799388","151799510","chr10","41702681","41702806","22","110096707"
"chr5","151844901","151845216","chr6","148547219","148547532","20","3297682"
"chr5","151845507","151845803","chr6","148547826","148548138","51","3297681"
"chr5","151850820","151851118","chr19","16469674","16469960","56","135381146"
"chr5","151871109","151871390","chr6","148570076","148570357","42","3301033"
"chr5","151871421","151871713","chr9","60942413","60942712","61","90929008"
"chr5","151895809","151896107","chr6","148593360","148593661","20","3302449"
"chr5","151945415","151945699","chr6","148645394","148645698","39","3300021"
"chr5","151962004","151962302","chr6","148663044","148663337","36","3298960"
"chr5","151977531","151977807","chr6","148676877","148677175","37","3300654"
"chr5","151989769","151990058","chr6","148689664","148689955","20","3300105"
"chr5","151996825","151996980","chr8","21621594","21621739","36","130375231"
"chr5","152009064","152009385","chr6","148709491","148709816","22","3299573"
"chr5","152137348","152137464","chr6","148862063","148862167","19","3275285"
"chr5","152143693","152143979","chr6","148868380","148868675","24","3275313"
"chr5","152151104","152151400","chr6","148876888","148877167","31","3274216"
"chr5","152170339","152170409","chr4","133170908","133170975","16","18999431"
"chr5","152170425","152170722","chr6","148896618","148896916","19","3273807"
"chr5","152223178","152223473","chr6","148940174","148940462","34","3283004"
"chr5","152234256","152234379","chr12","14732091","14732215","13","137502165"
"chr5","152401554","152401841","chr7","140100928","140101221","58","12300626"
"chr5","152470853","152471143","chr6","149129998","149130277","30","3340855"
"chr5","152473549","152473800","chr6","149132685","149132953","28","3340864"
"chr5","152480100","152480443","chr6","149139269","149139617","28","3340831"
"chr5","152503102","152503397","chr6","149162600","149162888","35","3340502"
"chr5","152527091","152527374","chr6","149186397","149186706","46","3340694"
"chr5","152541040","152541288","chr3","38924006","38924243","52","113617034"
"chr5","152547550","152547716","chr15","8429087","8429254","29","144118463"
"chr5","152548021","152548155","chr1","115755726","115755862","18","36792295"
"chr5","152559466","152559788","chr8","33501347","33501642","74","119058119"
"chr5","152569901","152570024","chr6","149230334","149230458","5","3339567"
"chr5","152596956","152597206","chr6","149259319","149259555","33","3337637"
"chr5","152620397","152620701","chr6","149288359","149288668","31","3332038"
"chr5","152630665","152630948","chr10","73168012","73168297","57","79462653"
"chr5","152652653","152652864","chr6","149321163","149321374","11","3331490"
"chr5","152655612","152655924","chr18","47705875","47706187","70","104949737"
"chr5","152682201","152682349","chr6","149350561","149350711","9","3331640"
"chr5","152688878","152689163","chr6","149357569","149357848","22","3331309"
"chr5","152693966","152694198","chr6","149362641","149362852","33","3331325"
"chr5","152714057","152714341","chr6","149381947","149382250","35","3332110"
"chr5","152719067","152719363","chr15","43687639","43687935","56","109031428"
"chr5","152759356","152759671","chr6","149431931","149432234","39","3327425"
"chr5","152766431","152766740","chr1","63901451","63901764","58","88864980"
"chr5","152786271","152786540","chr6","149465094","149465358","18","3321177"
"chr5","152796988","152797254","chr6","149487067","149487333","16","3309921"
"chr5","152800118","152800406","chr6","149490304","149490593","46","3309814"
"chr5","152800632","152800732","chr3","50263754","50263847","16","102536878"
"chr5","152825926","152826218","chr1","211215809","211216098","50","58389883"
"chr5","152847278","152847575","chr6","149535730","149536032","32","3311548"
"chr5","152866554","152866734","chr8","115743565","115743748","46","37122989"
"chr5","152973558","152973718","chr19","8026553","8026714","30","144947005"
"chr5","153006156","153006455","chr6","149698108","149698410","15","3308048"
"chr5","153016515","153016813","chr6","149708466","149708766","13","3308049"
"chr5","153072145","153072322","chr1","218816649","218816824","38","65744504"
"chr5","153075899","153076188","chr6","149770063","149770349","29","3305836"
"chr5","153078703","153079007","chr1","217163416","217163724","59","64084713"
"chr5","153081134","153081307","chr3","39345035","39345208","41","113736099"
"chr5","153143009","153143286","chr6","149837857","149838141","28","3305152"
"chr5","153145791","153146066","chr16","49265995","49266270","54","103879796"
"chr5","153157407","153157714","chr6","149852364","149852643","52","3305043"
"chr5","153162908","153163207","chr6","149857685","149857981","16","3305223"
"chr5","153168664","153168936","chr6","149863748","149864022","26","3304916"
"chr5","153187823","153188106","chr15","44867117","44867414","64","108320706"
"chr5","153210081","153210319","chr6","149911947","149912185","8","3298134"
"chr5","153213935","153214173","chr6","149916439","149916700","37","3297496"
"chr5","153224650","153224937","chr6","149927143","149927392","48","3297507"
"chr5","153234876","153235183","chr6","149937313","149937616","27","3297563"
"chr5","153250150","153250280","chr6","149952527","149952659","6","3297623"
"chr5","153300911","153301187","chr6","150003008","150003298","34","3297903"
"chr5","153431927","153432216","chr6","150123038","150123331","18","3308889"
"chr5","153503008","153503095","chr6","150192308","150192395","8","3310700"
"chr5","153596024","153596283","chr6","150280814","150281070","51","3315210"
"chr5","153877303","153877596","chr6","150576153","150576447","20","3301150"
"chr5","153997008","153997280","chr4","36576469","36576742","61","117420539"
"chr5","154089682","154089890","chr5","170126727","170126918","55","16037045"
"chr5","154250562","154250788","chr6","150923591","150923818","15","3326971"
"chr5","154262745","154263025","chr6","150935570","150935823","33","3327175"
"chr5","154459721","154460030","chr9","5743881","5744173","71","148715840"
"chr5","154463330","154463625","chr2","109967146","109967434","59","44496184"
"chr5","154571132","154571425","chr6","151225577","151225870","13","3345555"
"chr5","154661112","154661425","chr6","151323511","151323811","34","3337601"
"chr5","154801579","154801826","chr6","151453019","151453266","16","3348560"
"chr5","154941117","154941241","chr6","151587407","151587531","11","3353710"
"chr5","154976119","154976424","chr6","151617326","151617603","51","3358793"
"chr5","155008673","155008985","chr1","141947831","141948139","70","13060842"
"chr5","155035730","155035847","chr17","420062","420179","17","154615668"
"chr5","155437181","155437309","chr6","152134962","152135090","9","3302219"
"chr5","155455080","155455348","chr6","152153256","152153524","13","3301824"
"chr5","155456976","155457132","chr7","156147211","156147375","43","690235"
"chr5","155457158","155457272","chr3","169780374","169780491","21","14323216"
"chr5","155473641","155473763","chr6","152170708","152170830","5","3302933"
"chr5","155473983","155474272","chr7","12860432","12860689","90","142613551"
"chr5","155505411","155505716","chr6","152203832","152204140","36","3301579"
"chr5","155547854","155548179","chr6","152246749","152247065","28","3301105"
"chr5","155586581","155586902","chr6","152287361","152287690","36","3299220"
"chr5","155612215","155612462","chr6","152315033","152315311","39","3297182"
"chr5","155623951","155624257","chr6","152326382","152326692","43","3297569"
"chr5","155642829","155642952","chr6","152345592","152345716","8","3297237"
"chr5","155665056","155665338","chr6","152364177","152364460","15","3300879"
"chr5","155667318","155667445","chr6","152366421","152366549","9","3300897"
"chr5","155679306","155679457","chr18","48189873","48190014","34","107489433"
"chr5","155682816","155683131","chr6","152382306","152382624","34","3300510"
"chr5","155699427","155699726","chr2","84913076","84913368","52","70786351"
"chr5","155704617","155704921","chr6","152405265","152405569","21","3299352"
"chr5","155747418","155747708","chr6","152448755","152449060","39","3298663"
"chr5","155793377","155793667","chr6","152495100","152495389","15","3298277"
"chr5","155793847","155794162","chr4","31751916","31752223","63","124041931"
"chr5","155821677","155821968","chr11","63273330","63273621","55","92548347"
"chr5","155824815","155825120","chr6","152526258","152526567","17","3298557"
"chr5","155855489","155855753","chr6","152558246","152558524","52","3297243"
"chr5","155892886","155893201","chr6","152593796","152594093","48","3299090"
"chr5","155898498","155898811","chr19","45535685","45535989","57","110362813"
"chr5","155933237","155933533","chr6","152634274","152634574","21","3298963"
"chr5","155949035","155949338","chr6","152650669","152650972","15","3298366"
"chr5","155953300","155953593","chr1","135785522","135785813","60","20167778"
"chr5","155953720","155954040","chr6","152655921","152656230","37","3297799"
"chr5","155967578","155967729","chr6","152670227","152670378","8","3297351"
"chr5","155967970","155967984","chr1","151180306","151180319","2","4787664"
"chr5","155972109","155972370","chr6","152674779","152675039","12","3297330"
"chr5","155981258","155981532","chr6","152684463","152684723","30","3296795"
"chr5","155995776","155995880","chr8","96949211","96949317","19","59046565"
"chr5","156012398","156012682","chr6","152717674","152717981","44","3294724"
"chr5","156018536","156018844","chr14","69384104","69384414","62","86634432"
"chr5","156068881","156069033","chr6","152763641","152763800","17","3305240"
"chr5","156069333","156069405","chr13","62631342","62631410","19","93437991"
"chr5","156085762","156085883","chr6","152785787","152785907","11","3299975"
"chr5","156087797","156087894","chr6","152789654","152789751","7","3298143"
"chr5","156092659","156092871","chr6","152795201","152795407","16","3297458"
"chr5","156092881","156093097","chr6","152795417","152795633","9","3297464"
"chr5","156093976","156094291","chr6","152796615","152796919","30","3297361"
"chr5","156097299","156097504","chrX","144039638","144039831","49","12057661"
"chr5","156117376","156117673","chr6","152821689","152821995","23","3295687"
"chr5","156119885","156120192","chr6","168379811","168380119","58","12259926"
"chr5","156124457","156124559","chr6","152829741","152829854","21","3294716"
"chr5","156124851","156125024","chr6","152830147","152830324","36","3294704"
"chr5","156132794","156132926","chr6","152838736","152838868","6","3294058"
"chr5","156135328","156135513","chrX","123944773","123944954","41","32190555"
"chr5","156135812","156135947","chr15","81869644","81869781","22","74266168"
"chr5","156138965","156139088","chr7","31804546","31804669","15","124334419"
"chr5","156139313","156139430","chr9","15099335","15099449","18","141039978"
"chr5","156145767","156145885","chr10","49362098","49362218","22","106783669"
"chr5","156146938","156147211","chr11","121652854","121653138","68","34494084"
"chr5","156152217","156152365","chr6","152858918","152859059","19","3293299"
"chr5","156163039","156163281","chr6","175123572","175123817","54","18960533"
"chr5","156206221","156206539","chr6","152914205","152914520","28","3292016"
"chr5","156220760","156220899","chr6","152927973","152928115","8","3292787"
"chr5","156221192","156221381","chr6","152928420","152928584","40","3292772"
"chr5","156223914","156224008","chr11","98464243","98464335","12","57759671"
"chr5","156226649","156226944","chr6","152934465","152934762","22","3292184"
"chr5","156227382","156227688","chr6","152935187","152935493","30","3292195"
"chr5","156238800","156239002","chr3","42390097","42390302","54","113848703"
"chr5","156242968","156243060","chr6","152949527","152949619","13","3293441"
"chr5","156243357","156243535","chr6","152949922","152950104","31","3293435"
"chr5","156244606","156244765","chr6","152951173","152951314","29","3293433"
"chr5","156246090","156246385","chr6","152952917","152953210","24","3293173"
"chr5","156250484","156250789","chr20","42042273","42042584","59","114208211"
"chr5","156252257","156252546","chr14","69165770","69166057","56","87086487"
"chr5","156268475","156268842","chr19","34456555","34456865","120","121811920"
"chr5","156284010","156284106","chr3","165339814","165339909","18","9055804"
"chr5","156287965","156288206","chr6","152998254","152998503","28","3289711"
"chr5","156307913","156308150","chr6","153018519","153018756","12","3289394"
"chr5","156313610","156313735","chr20","59259652","59259778","20","97053958"
"chr5","156314031","156314346","chr6","153024695","153024998","34","3289336"
"chr5","156325327","156325621","chr6","153036392","153036685","19","3288935"
"chr5","156340764","156341019","chr6","153050291","153050560","32","3290473"
"chr5","156341330","156341590","chr6","153050772","153051042","39","3290558"
"chr5","156344490","156344606","chr6","153053946","153054062","7","3290544"
"chr5","156359081","156359377","chr6","153067913","153068202","23","3291168"
"chr5","156386571","156386834","chr6","153096710","153096987","34","3289861"
"chr5","156399706","156399892","chr6","153110581","153110780","32","3289125"
"chr5","156400201","156400314","chr3","47446311","47446428","22","108953890"
"chr5","156420843","156421036","chr7","68802196","68802386","35","87618647"
"chr5","156450792","156450941","chr6","153173248","153173389","13","3277544"
"chr5","156451253","156451396","chr6","153173695","153173837","16","3277558"
"chr5","156462882","156463161","chr6","153183841","153184120","17","3279041"
"chr5","156497123","156497307","chrX","148597346","148597520","44","7899777"
"chr5","156507136","156507434","chr6","153227421","153227729","36","3279715"
"chr5","156559362","156559642","chr6","153272452","153272737","22","3286910"
"chr5","156626506","156626795","chr12","85477150","85477435","55","71149356"
"chr5","156696827","156696945","chr1","31118551","31118669","17","125578276"
"chr5","156696973","156697165","chr1","221300631","221300813","39","64603658"
"chr5","156703239","156703549","chr6","153409707","153410032","31","3293532"
"chr5","156728366","156728634","chr6","153435833","153436109","30","3292533"
"chr5","156897169","156897463","chr6","153612341","153612639","26","3284828"
"chr5","157014116","157014389","chr19","35299256","35299528","46","121714860"
"chr5","157141743","157142026","chr2","53429175","53429471","69","103712568"
"chr5","157153939","157154218","chr6","153916265","153916554","22","3237674"
"chr5","157162266","157162390","chr6","153924716","153924841","8","3237550"
"chr5","157207168","157207463","chr6","153964885","153965178","15","3242283"
"chr5","157251152","157251416","chr6","154014469","154014733","31","3236683"
"chr5","157321406","157321699","chr6","154093898","154094204","42","3227508"
"chr5","157321702","157321842","chr5","86792095","86792234","31","70529607"
"chr5","157405321","157405627","chr6","154180606","154180909","26","3224715"
"chr5","157414856","157415190","chr13","65734242","65734569","78","91680614"
"chr5","157432470","157432781","chr6","154208450","154208737","35","3224020"
"chr5","157479846","157480084","chr1","68432275","68432502","58","89047571"
"chr5","157518628","157518938","chr19","23790078","23790382","73","133728550"
"chr5","157527076","157527347","chr6","154305065","154305366","58","3222011"
"chr5","157629350","157629637","chr6","154410328","154410636","42","3219022"
"chr5","157645940","157646219","chr6","154426784","154427063","14","3219156"
"chr5","157648270","157648555","chr6","154429107","154429382","28","3219163"
"chr5","157685313","157685442","chr19","2146008","2146139","24","155539305"
"chr5","157736274","157736585","chr6","154519887","154520167","55","3216387"
"chr5","157857554","157857851","chr6","154644965","154645265","33","3212589"
"chr5","157891863","157892139","chr6","154679876","154680155","19","3211987"
"chr5","157963207","157963513","chr6","154750407","154750715","31","3212800"
"chr5","158024425","158024710","chr3","123351694","123351976","59","34672731"
"chr5","158080842","158081151","chr6","154859919","154860222","31","3220923"
"chr5","158191334","158191593","chr16","70731230","70731480","65","87460104"
"chr5","158212843","158213157","chr6","117080557","117080869","58","41132286"
"chr5","158218618","158218817","chr6","154990940","154991139","10","3227678"
"chr5","158232478","158232757","chr6","155004747","155005055","40","3227731"
"chr5","158251844","158252116","chr10","35823235","35823508","70","122428609"
"chr5","158253433","158253739","chr5","51350304","51350607","61","106903129"
"chr5","158270958","158271255","chr6","155041089","155041388","50","3229869"
"chr5","158274281","158274563","chrX","111904330","111904595","64","46369951"
"chr5","158290730","158291019","chr6","155060958","155061254","33","3229772"
"chr5","158297325","158297551","chr9","62480277","62480505","52","95817048"
"chr5","158309888","158310083","chr4","159921811","159922007","42","1611923"
"chr5","158365239","158365546","chr12","46521649","46521955","64","111843590"
"chr5","158381829","158382116","chr6","155152246","155152529","49","3229583"
"chr5","158383701","158383824","chr9","23175282","23175405","20","135208419"
"chr5","158435073","158435307","chr6","155204055","155204266","52","3231018"
"chr5","158436435","158436613","chr2","50498150","50498324","36","107938285"
"chr5","158443065","158443368","chr6","155213609","155213914","17","3229456"
"chr5","158449814","158449974","chr6","155220080","155220231","31","3229734"
"chr5","158450913","158451111","chr10","51092450","51092635","51","107358463"
"chr5","158451426","158451713","chr6","155223449","155223735","27","3227977"
"chr5","158454853","158455040","chr6","155226905","155227093","7","3227948"
"chr5","158455728","158456036","chr3","42590480","42590780","63","115865248"
"chr5","159109764","159110011","chr6","155240562","155240812","17","3869202"
"chr5","159111958","159112121","chr4","108510252","108510420","43","50601706"
"chr5","159112383","159112488","chr6","155243175","155243280","2","3869208"
"chr5","159115828","159116129","chr4","123481512","123481809","69","35634316"
"chr5","159118595","159118704","chr6","155248066","155248174","5","3870529"
"chr5","159119008","159119314","chr6","155248487","155248805","32","3870521"
"chr5","159139071","159139152","chr19","14404599","14404685","15","144734472"
"chr5","159139160","159139283","chr12","56669575","56669705","21","102469585"
"chr5","159146764","159147090","chr9","13117729","13118036","74","146029035"
"chr5","159147433","159147563","chr3","36373230","36373353","24","122774203"
"chr5","159148136","159148270","chr15","46514123","46514257","29","112634013"
"chr5","159148838","159149131","chr6","155279093","155279397","29","3869745"
"chr5","159152468","159152740","chr6","155284219","155284492","25","3868249"
"chr5","159157247","159157539","chr6","155288367","155288661","33","3868880"
"chr5","159170541","159170681","chr6","158299413","158299550","36","871128"
"chr5","159176030","159176259","chr7","140051837","140052059","64","19124193"
"chr5","159191220","159191393","chr2","134840996","134841164","49","24350224"
"chr5","159193698","159193966","chr6","155325818","155326101","33","3867880"
"chr5","159216042","159216317","chr6","155348708","155348981","27","3867334"
"chr5","159236220","159236500","chr13","25090593","25090872","51","134145627"
"chr5","159241052","159241351","chr6","155374008","155374306","23","3867044"
"chr5","159247812","159248113","chr6","155380767","155381077","43","3867045"
"chr5","159255227","159255405","chrX","52447863","52448045","46","106807364"
"chr5","159265035","159265308","chr7","96759809","96760089","51","62505226"
"chr5","159287691","159287984","chr7","140100928","140101221","58","19186763"
"chr5","159310498","159310786","chr6","155445720","155446012","24","3864778"
"chr5","159328144","159328440","chr6","155463785","155464082","23","3864359"
"chr5","159355268","159355514","chr6","155491487","155491735","24","3863781"
"chr5","159363888","159364184","chr6","155500138","155500433","24","3863750"
"chr5","159479901","159480033","chr3","13641352","13641484","23","145838549"
"chr5","159483171","159483452","chr6","155619351","155619632","29","3863820"
"chr5","159492713","159492826","chr3","41881824","41881939","24","117610889"
"chr5","159586619","159586921","chr6","155724325","155724645","34","3862294"
"chr5","159618096","159618386","chr6","155753804","155754096","22","3864292"
"chr5","159698648","159698961","chr6","155856001","155856326","30","3842647"
"chr5","159700540","159700811","chr6","155858026","155858290","21","3842514"
"chr5","159702205","159702389","chr7","49400931","49401117","41","110301274"
"chr5","159703357","159703450","chr6","155861024","155861117","2","3842333"
"chr5","159736298","159736595","chr6","155898867","155899157","26","3837431"
"chr5","159778823","159779118","chr6","155941463","155941762","27","3837360"
"chr5","159804806","159805110","chr6","155968371","155968675","32","3836435"
"chr5","159827470","159827691","chr4","5848622","5848836","49","153978848"
"chr5","159862531","159862817","chr6","156023839","156024115","30","3838692"
"chr5","159872088","159872304","chr6","156034099","156034309","34","3837989"
"chr5","159887190","159887413","chr10","22491132","22491355","43","137396058"
"chr5","159889001","159889310","chr6","71258606","71258892","78","88630395"
"chr5","159917139","159917433","chr6","156056380","156056671","21","3860759"
"chr5","159928575","159928886","chr15","100706419","100706722","51","59222156"
"chr5","159959961","159960265","chr6","156103934","156104265","54","3856027"
"chr5","159969208","159969524","chr3","78003637","78003946","69","81965571"
"chr5","159974136","159974417","chr6","156115712","156116003","26","3858424"
"chr5","160014151","160014334","chr6","156155574","156155747","20","3858577"
"chr5","160032235","160032547","chr6","156171171","156171470","26","3861064"
"chr5","160048029","160048142","chr6","156185594","156185707","4","3862435"
"chr5","160058353","160058652","chr6","156194525","156194823","37","3863828"
"chr5","160070558","160070783","chr6","156207087","156207318","24","3863471"
"chr5","160101783","160102064","chr2","83884719","83885008","51","76217064"
"chr5","160179910","160180198","chr6","156324363","156324642","31","3855547"
"chr5","160253639","160253955","chr6","156391845","156392152","40","3861794"
"chr5","160329538","160329825","chr6","156466840","156467144","41","3862698"
"chr5","160331361","160331657","chr6","156468693","156468976","34","3862668"
"chr5","160560181","160560433","chr20","26603164","26603412","53","133957017"
"chr5","160634932","160635239","chr6","156784999","156785295","29","3849933"
"chr5","160673365","160673676","chr7","166332667","166332976","62","5659302"
"chr5","160740890","160741183","chr6","156893553","156893814","53","3847337"
"chr5","160753631","160753940","chr1","195896967","195897270","55","35143336"
"chr5","160811457","160811740","chr6","156966446","156966748","42","3845011"
"chr5","160826398","160826684","chr6","156981786","156982078","25","3844612"
"chr5","160913707","160913888","chr4","82310492","82310666","39","78603215"
"chr5","160913922","160914036","chr3","185153995","185154110","20","24240073"
"chr5","160960521","160960646","chr6","157123487","157123609","7","3837034"
"chr5","161090205","161090481","chr6","157255365","157255625","38","3834840"
"chr5","161178956","161179239","chr6","157343364","157343643","21","3835592"
"chr5","161198736","161199026","chr6","157363244","157363546","31","3835492"
"chr5","161207078","161207311","chr15","18291594","18291841","63","142915484"
"chr5","161230528","161230822","chr6","157395613","157395920","40","3834915"
"chr5","161247720","161248000","chr6","157413582","157413865","17","3834138"
"chr5","161253575","161253870","chr6","157419451","157419745","19","3834124"
"chr5","161260064","161260356","chr6","157426622","157426914","13","3833442"
"chr5","161279837","161280134","chr6","157446314","157446600","33","3833523"
"chr5","161323819","161324030","chr6","157490329","157490537","24","3833490"
"chr5","161329606","161329923","chr6","157496108","157496412","32","3833498"
"chr5","161355757","161355996","chr6","157521743","157521991","26","3834014"
"chr5","161362556","161362846","chr6","157528407","157528699","22","3834149"
"chr5","161363401","161363684","chr6","157529249","157529541","29","3834152"
"chr5","161430542","161430814","chr6","157581215","157581490","21","3849327"
"chr5","161448296","161448602","chr6","157603997","157604276","41","3844299"
"chr5","161475136","161475253","chr3","127146489","127146603","19","34328647"
"chr5","161525312","161525599","chr16","61203222","61203518","52","100322090"
"chr5","161543394","161543608","chr6","157696924","157697140","23","3846470"
"chr5","161543645","161543818","chr2","94721597","94721769","49","66822048"
"chr5","161613387","161613682","chr16","39964733","39965029","56","121648654"
"chr5","161829308","161829401","chr6","158021642","158021744","14","3807666"
"chr5","161939128","161939434","chr6","158127527","158127836","39","3811601"
"chr5","161975690","161975822","chr17","54442955","54443088","20","107532735"
"chr5","161986012","161986136","chr6","158174532","158174656","6","3811480"
"chr5","161993103","161993350","chr6","158181889","158182145","24","3811214"
"chr5","161997987","161998289","chr6","158186477","158186781","27","3811510"
"chr5","162006709","162006931","chr17","13758751","13758979","44","148247958"
"chr5","162010072","162010380","chr6","158199131","158199436","28","3810941"
"chr5","162011343","162011641","chr6","158200399","158200693","48","3810944"
"chr5","162014614","162014932","chr6","158204971","158205254","60","3809643"
"chr5","162030085","162030311","chr6","158221294","158221514","32","3808791"
"chr5","162047316","162047626","chr4","87195421","87195705","82","74851895"
"chr5","162052627","162052688","chr11","1265582","1265641","13","160787045"
"chr5","162061675","162061971","chr6","158251688","158251979","21","3809987"
"chr5","162063769","162064076","chr6","158253776","158254067","46","3809993"
"chr5","162070580","162070850","chr6","158260647","158260911","21","3809933"
"chr5","162074115","162074391","chr6","158264187","158264467","30","3809928"
"chr5","162077511","162077826","chr6","158267893","158268194","28","3809618"
"chr5","162093523","162093816","chr7","53371492","53371783","75","108722031"
"chr5","162094400","162094696","chr6","158286395","158286689","21","3808005"
"chr5","162096466","162096775","chr6","158288460","158288768","14","3808006"
"chr5","162104279","162104537","chr6","136105334","136105587","60","25998945"
"chr5","162107927","162108066","chr6","158299413","158299550","10","3808514"
"chr5","162111429","162111689","chr6","158303898","158304176","41","3807531"
"chr5","162118217","162118356","chr9","90818616","90818745","28","71299601"
"chr5","162118646","162118823","chr10","65990511","65990675","47","96128135"
"chr5","162121328","162121408","chr6","158320441","158320522","4","3800887"
"chr5","162153125","162153266","chr6","158348507","158348652","15","3804618"
"chr5","162153565","162153734","chr6","158348950","158349107","21","3804615"
"chr5","162160320","162160616","chr6","158355166","158355427","52","3805154"
"chr5","162174993","162175305","chr6","158367446","158367750","34","3807547"
"chr5","162180886","162181179","chr6","158373542","158373855","46","3807344"
"chr5","162213754","162214045","chr6","158403909","158404201","14","3809845"
"chr5","162214237","162214347","chr6","158404393","158404507","16","3809844"
"chr5","162214651","162214820","chr10","60358379","60358547","55","101856272"
"chr5","162219844","162220131","chr1","30761063","30761352","55","131458781"
"chr5","162223662","162223922","chr5","50874362","50874620","61","111349300"
"chr5","162223952","162224169","chr6","158414830","158415071","43","3809122"
"chr5","162228506","162228818","chr6","158420097","158420413","43","3808409"
"chr5","162286140","162286442","chr6","158478167","158478482","33","3807973"
"chr5","162296766","162297047","chr19","30007363","30007647","52","132289403"
"chr5","162305127","162305234","chr6","158496243","158496350","7","3808884"
"chr5","162320612","162320736","chr13","10752574","10752698","20","151568038"
"chr5","162320785","162320930","chr8","21621594","21621739","27","140699191"
"chr5","162401439","162401616","chr2","50437228","50437395","38","111964211"
"chr5","162405729","162406017","chr6","158515462","158515737","47","3890267"
"chr5","162418690","162418810","chr16","62782027","62782148","21","99636663"
"chr5","162419101","162419277","chr2","50498150","50498324","34","111920951"
"chr5","162421241","162421542","chr6","158531299","158531602","28","3889942"
"chr5","162431737","162432024","chr6","158543106","158543390","26","3888631"
"chr5","162436047","162436352","chr6","158547416","158547724","20","3888631"
"chr5","162450925","162451034","chr6","158562629","158562736","10","3888296"
"chr5","162475166","162475454","chr6","158587855","158588145","25","3887311"
"chr5","162536697","162536971","chr6","158654891","158655162","27","3881806"
"chr5","162541259","162541551","chr6","158659516","158659801","33","3881743"
"chr5","162787071","162787312","chr5","41538867","41539116","62","121248204"
"chr5","162958401","162958529","chr6","159087552","159087679","11","3870849"
"chr5","162983352","162983618","chr6","159119519","159119787","18","3863833"
"chr5","163034258","163034548","chr6","159172285","159172552","44","3861973"
"chr5","163038206","163038334","chr6","35200385","35200514","19","127837821"
"chr5","163178080","163178387","chr6","159317334","159317657","30","3860746"
"chr5","163294089","163294380","chr6","159429865","159430156","17","3864224"
"chr5","163331271","163331352","chr10","79884891","79884968","18","83446380"
"chr5","163345902","163346166","chr6","159468142","159468412","26","3877760"
"chr5","163422933","163423219","chr6","159549550","159549835","26","3873383"
"chr5","163447953","163448123","chr6","159574836","159575006","11","3873117"
"chr5","163532457","163532726","chr6","159660877","159661128","34","3871580"
"chr5","163539854","163540133","chr6","159668861","159669159","35","3870993"
"chr5","163702610","163702721","chr6","159823416","159823529","10","3879194"
"chr5","163702758","163702951","chr6","159823574","159823757","25","3879184"
"chr5","163859303","163859563","chr4","82215167","82215422","61","81644136"
"chr5","163864312","163864613","chr6","160031511","160031805","24","3832801"
"chr5","163958150","163958451","chr1","140828330","140828620","73","23129820"
"chr5","164010467","164010612","chr6","160191690","160191834","14","3818777"
"chr5","164069372","164069648","chr6","160247182","160247464","29","3822190"
"chr5","164113683","164113985","chr6","160294702","160295004","34","3818981"
"chr5","164121842","164122142","chr1","14475918","14476225","65","149645924"
"chr5","164128348","164128652","chr6","160311702","160312010","23","3816646"
"chr5","164133661","164133839","chr7","98393098","98393274","35","65740563"
"chr5","164244352","164244619","chr6","160425604","160425876","31","3818748"
"chr5","164283275","164283550","chr18","20659105","20659381","79","143624170"
"chr5","164284970","164285269","chr14","5220051","5220343","73","159064919"
"chr5","164460031","164460144","chr15","13536055","13536169","21","150923976"
"chr5","164507583","164507852","chr6","160708787","160709062","30","3798796"
"chr5","164541623","164541912","chr6","160732718","160733004","24","3808905"
"chr5","164570390","164570533","chr14","19589994","19590140","33","144980396"
"chr5","164640378","164640647","chr6","160825489","160825758","21","3814889"
"chr5","164798390","164798565","chr12","87917476","87917649","32","76880914"
"chr5","164798596","164798709","chr11","78863129","78863241","21","85935467"
"chr5","164822821","164823142","chr6","160988985","160989275","57","3833836"
"chr5","165066583","165066889","chr6","161221343","161221653","24","3845240"
"chr5","165259468","165259795","chr6","161403186","161403530","38","3856282"
"chr5","165358013","165358295","chr6","161412205","161412490","18","3945808"
"chr5","165370440","165370733","chr6","161418671","161418966","30","3951769"
"chr5","165450555","165450819","chr7","47711933","47712196","62","117738622"
"chr5","165458971","165459139","chr10","7848501","7848659","41","157610470"
"chr5","165459203","165459317","chr11","78863129","78863241","22","86596074"
"chr5","165478916","165479228","chr6","6301868","6302166","63","159177048"
"chr5","165537897","165538191","chr15","43687639","43687935","53","121850258"
"chr5","165570558","165570822","chr4","105270096","105270380","34","60300462"
"chr5","165576805","165576927","chr9","41126160","41126284","23","124450645"
"chr5","165600746","165601036","chr6","161512751","161513063","42","4087995"
"chr5","165632976","165633271","chr6","161548094","161548376","26","4084882"
"chr5","165645839","165645953","chr6","161562285","161562399","10","4083554"
"chr5","165668890","165669184","chr1","128738134","128738426","56","36930756"
"chr5","165754419","165754768","chr6","161673114","161673455","25","4081305"
"chr5","165828211","165828485","chr6","161747006","161747268","26","4081205"
"chr5","166029664","166029970","chr6","161936743","161937034","36","4092921"
"chr5","166092943","166093229","chr6","162068119","162068437","49","4024824"
"chr5","166097345","166097639","chr9","110786043","110786351","67","55311302"
"chr5","166098452","166098757","chr6","162073608","162073921","37","4024844"
"chr5","166234642","166234935","chr3","102993860","102994153","62","63240782"
"chr5","166267172","166267481","chr6","162247431","162247741","33","4019741"
"chr5","166286219","166286519","chrX","113948127","113948423","59","52338092"
"chr5","166341721","166342022","chr6","162323063","162323363","33","4018658"
"chr5","166395367","166395643","chr6","162379056","162379334","29","4016311"
"chr5","166596843","166597158","chr7","116685051","116685354","77","49911792"
"chr5","166720917","166721205","chr6","162698780","162699035","59","4022137"
"chr5","166772450","166772584","chr14","92300940","92301058","39","74471510"
"chr5","166773149","166773473","chr6","162750618","162750934","28","4022531"
"chr5","166787867","166788122","chr6","162765230","162765503","37","4022637"
"chr5","166814492","166814770","chr6","162792863","162793146","22","4021629"
"chr5","166860723","166860851","chr6","162835360","162835479","20","4025363"
"chr5","166988752","166989027","chr6","162960553","162960803","44","4028199"
"chr5","167607399","167607707","chr6","163566077","163566385","18","4041322"
"chr5","167608358","167608664","chr1","130290313","130290608","76","37318045"
"chr5","167613451","167613757","chr6","163572101","163572403","27","4041350"
"chr5","167676949","167677236","chr8","39165024","39165322","69","128511925"
"chr5","167730336","167730630","chr6","163698654","163698987","52","4031682"
"chr5","167783455","167783777","chr6","163756681","163756999","31","4026774"
"chr5","167784772","167785004","chr3","13343257","13343484","54","154441515"
"chr5","167864893","167865194","chr6","163883488","163883795","28","3981405"
"chr5","167919343","167919640","chr15","68562568","68562844","83","99356775"
"chr5","167946041","167946157","chr9","34836886","34837001","19","133109155"
"chr5","167946188","167946370","chr6","155422776","155422949","44","12523412"
"chr5","167957212","167957507","chr6","163975702","163976017","54","3981510"
"chr5","167989766","167990043","chr6","164013536","164013819","27","3976230"
"chr5","168210931","168211268","chr6","164292181","164292505","59","3918750"
"chr5","168291915","168292030","chr17","11435428","11435543","28","156856487"
"chr5","168446227","168446353","chr6","164537400","164537526","7","3908827"
"chr5","168469307","168469605","chr1","211353988","211354282","56","42884681"
"chr5","168545426","168545718","chr6","164642893","164643198","30","3902533"
"chr5","168561262","168561581","chr6","164658954","164659262","29","3902308"
"chr5","168595759","168596056","chr6","164694566","164694872","26","3901193"
"chr5","168599398","168599697","chr6","164698202","164698507","22","3901196"
"chr5","168639065","168639330","chr6","164733088","164733352","17","3905977"
"chr5","168797443","168797725","chr6","164893066","164893348","19","3904377"
"chr5","168902037","168902364","chr6","164995993","164996324","30","3906044"
"chr5","168915684","168915967","chr6","165009716","165010000","22","3905968"
"chr5","168921243","168921439","chr4","35502171","35502360","47","133419072"
"chr5","168922127","168922431","chr6","165014844","165015148","22","3907283"
"chr5","168934213","168934505","chr6","165025521","165025804","25","3908692"
"chr5","168972011","168972314","chr6","165061692","165061985","38","3910319"
"chr5","168974530","168974845","chr1","35595269","35595576","65","133379261"
"chr5","169125734","169125879","chr15","27361388","27361527","25","141764346"
"chr5","169194252","169194572","chr6","165282576","165282849","70","3911676"
"chr5","169298897","169299168","chr6","165392534","165392783","37","3906363"
"chr5","169481508","169481795","chr6","165572911","165573200","26","3908597"
"chr5","169626538","169626703","chr6","165723499","165723667","25","3903039"
"chr5","169666766","169667092","chr6","165764051","165764394","46","3902715"
"chr5","169736809","169737103","chr6","165834193","165834486","17","3902616"
"chr5","169861464","169861758","chr6","165958816","165959138","47","3902648"
"chr5","169875838","169876103","chr6","165973611","165973885","26","3902227"
"chr5","169881507","169881685","chr3","5152601","5152765","45","164728906"
"chr5","169882051","169882166","chr2","66546751","66546869","23","103335300"
"chr5","169979869","169980154","chr6","166077036","166077322","47","3902833"
"chr5","170037549","170037672","chr2","44878801","44878925","22","125158748"
"chr5","170059560","170059793","chr6","166156927","166157131","47","3902633"
"chr5","170070643","170070933","chr3","43681527","43681817","51","126389116"
"chr5","170141109","170141416","chr6","166239175","166239492","31","3901934"
"chr5","170164301","170164643","chr6","166261408","166261745","31","3902893"
"chr5","170173127","170173250","chr6","166269878","166270001","8","3903249"
"chr5","170181836","170181970","chr6","166278598","166278732","8","3903238"
"chr5","170290249","170290543","chr6","166395542","166395832","25","3894707"
"chr5","170342901","170343183","chr6","166448830","166449117","23","3894071"
"chr5","170378822","170379003","chr6","166484693","166484869","17","3894129"
"chr5","170381171","170381453","chr7","92871748","92872031","62","77509423"
"chr5","170431406","170431706","chr1","8607280","8607568","69","161824126"
"chr5","170497479","170497636","chr6","166601582","166601738","10","3895897"
"chr5","170537263","170537542","chr6","166641722","166642006","30","3895541"
"chr5","170556993","170557283","chr6","166661381","166661674","27","3895612"
"chr5","170561116","170561383","chr6","166665448","166665716","26","3895668"
"chr5","170571623","170571734","chr6","166676075","166676193","12","3895548"
"chr5","170586534","170586828","chr6","166688570","166688861","28","3897964"
"chr5","170615893","170616084","chr6","166728992","166729210","37","3886901"
"chr5","170619397","170619688","chr6","166732238","166732533","24","3887159"
"chr5","170626213","170626328","chr6","166739585","166739702","9","3886628"
"chr5","170632741","170632868","chr13","87095059","87095190","19","83537682"
"chr5","170634142","170634430","chr11","94827758","94828035","72","75806384"
"chr5","170657129","170657419","chr6","166774649","166774950","35","3882480"
"chr5","170661951","170662222","chr6","166779542","166779812","23","3882409"
"chr5","170669965","170670241","chr20","59570950","59571230","52","111099015"
"chr5","170688503","170688771","chr6","166806973","166807213","38","3881530"
"chr5","170694219","170694509","chr6","166813049","166813343","21","3881170"
"chr5","170697460","170697703","chr11","95436211","95436458","52","75261249"
"chr5","170699369","170699657","chr6","166818979","166819237","51","3880390"
"chr5","170707036","170707210","chr6","166829173","166829352","25","3877863"
"chr5","170710385","170710506","chr7","26669104","26669210","42","144041281"
"chr5","170711141","170711195","chr10","33357354","33357404","15","137353787"
"chr5","170711300","170711603","chr6","166833436","166833751","28","3877864"
"chr5","170713349","170713631","chr6","166835807","166836089","11","3877542"
"chr5","170741632","170741760","chrX","39718800","39718921","39","131022832"
"chr5","170743139","170743424","chr6","166869810","166870095","15","3873329"
"chr5","170748013","170748278","chr1","41991200","41991466","52","128756813"
"chr5","170750444","170750749","chr6","166877168","166877473","17","3873276"
"chr5","170751365","170751643","chr19","3193316","3193596","51","167558049"
"chr5","170752258","170752381","chr6","166879295","166879421","5","3872963"
"chr5","170753204","170753330","chr6","166880236","166880363","10","3872968"
"chr5","170754624","170754930","chr6","166881647","166881952","16","3872977"
"chr5","170767240","170767354","chr6","166894432","166894535","18","3872808"
"chr5","170888085","170888395","chr1","212231998","212232288","73","41343913"
"chr5","170924572","170924890","chr6","167063010","167063323","26","3861562"
"chr5","170954681","170955019","chr6","167093229","167093564","18","3861452"
"chr5","171124373","171124649","chr16","70146711","70146978","56","100977662"
"chr5","171141076","171141352","chr6","167280860","167281142","24","3860216"
"chr5","171265379","171265671","chr6","167406485","167406777","16","3858894"
"chr5","171292233","171292548","chr6","167431599","167431911","33","3860634"
"chr5","171387556","171387855","chr6","167528182","167528468","28","3859374"
"chr5","171481923","171482227","chr6","167622621","167622928","16","3859302"
"chr5","171554085","171554399","chr4","2185273","2185588","72","169368812"
"chr5","171570623","171570929","chr6","167714718","167715024","20","3855905"
"chr5","171588126","171588435","chr6","167732138","167732442","24","3855988"
"chr5","171596966","171597258","chr6","167741262","167741573","34","3855704"
"chr5","171654466","171654745","chr6","167796801","167797072","32","3857665"
"chr5","171694766","171695068","chr10","15460316","15460612","58","156234450"
"chr5","171809089","171809383","chr6","167958241","167958532","23","3850848"
"chr5","171809928","171809980","chr6","167959065","167959123","13","3850863"
"chr5","171819141","171819443","chr6","167968433","167968734","40","3850708"
"chr5","171900733","171901008","chr6","168048460","168048731","24","3852273"
"chr5","171924347","171924639","chr9","98661850","98662144","53","73262497"
"chr5","171929637","171929944","chr2","201476670","201476965","75","29547033"
"chr5","171944041","171944324","chr6","168091712","168092010","36","3852329"
"chr5","171984606","171984902","chr6","168123961","168124255","23","3860645"
"chr5","171994326","171994618","chr6","168134055","168134341","30","3860271"
"chr5","172381726","172382026","chr6","168521232","168521522","32","3860494"
"chr5","172416793","172417107","chr8","27389291","27389607","67","145027502"
"chr5","172475341","172475638","chr6","168615826","168616124","29","3859515"
"chr5","172497279","172497564","chr6","168637035","168637324","20","3860244"
"chr5","172519124","172519414","chr6","168657616","168657891","39","3861508"
"chr5","172564217","172564487","chr6","168702567","168702839","17","3861650"
"chr5","172586819","172587119","chr6","168722409","168722716","52","3864410"
"chr5","172652137","172652399","chr6","168789690","168789957","22","3862447"
"chr5","172687409","172687558","chr19","4608442","4608593","31","168078967"
"chr5","172727301","172727624","chr6","168865691","168866010","26","3861610"
"chr5","172739226","172739529","chr6","168876876","168877189","36","3862350"
"chr5","172792892","172793175","chr6","168932048","168932316","28","3860844"
"chr5","172821282","172821409","chr19","12212993","12213123","22","160608289"
"chr5","172826092","172826387","chr7","55925566","55925867","61","116900526"
"chr5","172864409","172864713","chr6","169000867","169001156","44","3863542"
"chr5","172941398","172941689","chr14","104989359","104989670","65","67952039"
"chr5","173101908","173102209","chr6","169224643","169224944","18","3877265"
"chr5","173148740","173148948","chr6","169274286","169274494","14","3874454"
"chr5","173162692","173162975","chr6","169292069","169292361","35","3870623"
"chr5","173218407","173218727","chr4","36484206","36484512","72","136734201"
"chr5","173221413","173221712","chrX","46805715","46806015","62","126415698"
"chr5","173227614","173227902","chr6","169345574","169345863","20","3882040"
"chr5","173245871","173246174","chr6","169375873","169376189","42","3869998"
"chr5","173333519","173333843","chr6","169479085","169479424","38","3854434"
"chr5","173380632","173380783","chr6","169525376","169525499","32","3855256"
"chr5","173391989","173392273","chr15","46260241","46260530","59","127131748"
"chr5","173428526","173428643","chr6","169573950","169574067","4","3854576"
"chr5","173444761","173445040","chr6","169588972","169589284","49","3855789"
"chr5","173466517","173466638","chr6","169609649","169609768","8","3856868"
"chr5","173486313","173486419","chr3","36413314","36413422","29","137072999"
"chr5","173496414","173496484","chrX","108610699","108610764","20","64885715"
"chr5","173504693","173504859","chr9","15628977","15629142","34","157875716"
"chr5","173568824","173569100","chrX","103046997","103047266","59","70521827"
"chr5","173570042","173570329","chr6","169718805","169719093","23","3851237"
"chr5","173621271","173621579","chr6","169769751","169770060","23","3851520"
"chr5","173658255","173658556","chr6","169805075","169805375","30","3853180"
"chr5","173685829","173686126","chr6","169829828","169830133","26","3856001"
"chr5","173999789","174000000","chr13","30070965","30071173","41","143928824"
"chr5","174020336","174020527","chrX","47720394","47720573","45","126299942"
"chr5","174082858","174083027","chr6","170058579","170058742","21","4024279"
"chr5","174114774","174114898","chr6","170091761","170091892","12","4023013"
"chr5","174137551","174137789","chr6","170115160","170115396","23","4022391"
"chr5","174141239","174141376","chr3","164984791","164984918","35","9156448"
"chr5","174141440","174141616","chr2","109008566","109008731","46","65132874"
"chr5","174145154","174145439","chr6","170121984","170122268","9","4023170"
"chr5","174166038","174166315","chr6","170140895","170141174","19","4025143"
"chr5","174183320","174183628","chr9","19129541","19129838","95","155053779"
"chr5","174184626","174184907","chr6","170155464","170155738","22","4029162"
"chr5","174198735","174199020","chr14","35724096","35724377","60","138474639"
"chr5","174201889","174202187","chr6","170173525","170173826","25","4028364"
"chr5","174215180","174215488","chr13","10079690","10079997","54","164135490"
"chr5","174249811","174249932","chr6","170220418","170220539","10","4029393"
"chr5","174249933","174250235","chr6","170220540","170220838","23","4029393"
"chr5","174250236","174250418","chr6","170220839","170221013","26","4029397"
"chr5","174267819","174268035","chr4","16586300","16586522","37","157681519"
"chr5","174276625","174276927","chr6","170247097","170247401","27","4029528"
"chr5","174291126","174291406","chr6","170261842","170262138","31","4029284"
"chr5","174341250","174341411","chr19","5593755","5593916","33","168747495"
"chr5","174343139","174343294","chr3","42889922","42890080","38","131453217"
"chr5","174346144","174346382","chr6","170319430","170319667","20","4026714"
"chr5","174372914","174373205","chr6","170346051","170346348","27","4026863"
"chr5","174388585","174388708","chr6","170362971","170363103","16","4025614"
"chr5","174459107","174459403","chr6","170438696","170439000","43","4020411"
"chr5","174488149","174488448","chr6","170495406","170495710","21","3992743"
"chr5","174523700","174523846","chr1","45133887","45134026","35","129389813"
"chr5","174523882","174523918","chr3","164879589","164879624","7","9644293"
"chr5","174531042","174531129","chr7","168675550","168675639","22","5855492"
"chr5","174533874","174534172","chr6","170539983","170540288","36","3993891"
"chr5","174556402","174556475","chr16","59125566","59125642","11","115430836"
"chr5","174556522","174556820","chr6","170563396","170563695","26","3993126"
"chr5","174557559","174557685","chr6","170564437","170564547","21","3993122"
"chr5","174567605","174567894","chr6","170572978","170573266","19","3994627"
"chr5","174598756","174599060","chr7","143414521","143414830","58","31184235"
"chr5","174615214","174615504","chr6","170625527","170625818","14","3989687"
"chr5","174617628","174617910","chr6","170627950","170628236","26","3989678"
"chr5","174618708","174618953","chr17","12095411","12095650","50","162523297"
"chr5","174625517","174625814","chr6","170636468","170636760","19","3989049"
"chr5","174645592","174645879","chr6","170656687","170656969","29","3988905"
"chr5","174655430","174655553","chr6","170666909","170667032","4","3988521"
"chr5","174681748","174682025","chr6","170689927","170690209","22","3991821"
"chr5","174682354","174682619","chr6","170690561","170690856","43","3991793"
"chr5","174692944","174693246","chr6","170702163","170702470","37","3990781"
"chr5","174701037","174701335","chr6","170710144","170710429","32","3990893"
"chr5","174723555","174723857","chr6","170732421","170732720","21","3991134"
"chr5","174760267","174760354","chr1","20183520","20183607","18","154576747"
"chr5","174766847","174767138","chr6","170778996","170779288","26","3987851"
"chr5","174828421","174828559","chr6","170841620","170841760","11","3986801"
"chr5","174928854","174928963","chr20","18946283","18946392","18","155982571"
"chr5","174928992","174929135","chr3","163992888","163993032","25","10936104"
"chr5","174970296","174970427","chr15","92614353","92614489","22","82355943"
"chr5","174970737","174970914","chr6","170986890","170987066","9","3983847"
"chr5","175025844","175025929","chr6","171043136","171043219","3","3982708"
"chr5","175043752","175044042","chr6","171060116","171060400","23","3983636"
"chr5","175048143","175048434","chr6","171065508","171065785","29","3982635"
"chr5","175057083","175057383","chr6","171075210","171075519","24","3981873"
"chr5","175075564","175075828","chr6","171097542","171097828","39","3978022"
"chr5","175102617","175102734","chrX","8701186","8701303","16","166401431"
"chr5","175103278","175103563","chr6","171126157","171126434","38","3977121"
"chr5","175139198","175139458","chr6","171165674","171165936","17","3973524"
"chr5","175147809","175148095","chr10","52855349","52855652","70","122292460"
"chr5","175148661","175148970","chr6","171175470","171175787","31","3973191"
"chr5","175164262","175164566","chr6","171190749","171191064","30","3973513"
"chr5","175200625","175200932","chr6","171227154","171227461","25","3973471"
"chr5","175223315","175223448","chr6","171250860","171250993","7","3972455"
"chr5","175228876","175229169","chr10","66771950","66772239","58","108456926"
"chr5","175233756","175234044","chr6","171261170","171261455","15","3972586"
"chr5","175235202","175235498","chr6","171262621","171262922","28","3972581"
"chr5","175243010","175243219","chr8","105388423","105388621","43","69854587"
"chr5","175244443","175244739","chr6","171271252","171271555","25","3973191"
"chr5","175249971","175250260","chr6","171276558","171276855","20","3973413"
"chr5","175251326","175251614","chr6","171277938","171278226","25","3973388"
"chr5","175252446","175252738","chr6","171278724","171279015","18","3973722"
"chr5","175258267","175258546","chr6","171285515","171285794","14","3972752"
"chr5","175265621","175265736","chr6","171292748","171292863","4","3972873"
"chr5","175274230","175274538","chr6","171301336","171301653","26","3972894"
"chr5","175281780","175282073","chr6","171308537","171308830","20","3973243"
"chr5","175288761","175289055","chr6","171314470","171314758","34","3974291"
"chr5","175295507","175295751","chr7","29137742","29137982","65","146157765"
"chr5","175312169","175312434","chr6","171336994","171337274","30","3975175"
"chr5","175334640","175334800","chr10","27406902","27407056","30","147927738"
"chr5","175335107","175335242","chr6","171363081","171363226","20","3972026"
"chr5","175374084","175374217","chr6","171407245","171407383","11","3966839"
"chr5","175380974","175381091","chr9","60104592","60104710","9","115276382"
"chr5","175450787","175451092","chr6","171481584","171481890","26","3969203"
"chr5","175454734","175455038","chr6","171485194","171485499","29","3969540"
"chr5","175475719","175475802","chr5","2000506","2000587","16","173475213"
"chr5","175481645","175481908","chr2","71850046","71850313","58","103631599"
"chr5","175484967","175485077","chr6","171511586","171511696","11","3973381"
"chr5","175485123","175485288","chr6","171511742","171511926","29","3973381"
"chr5","175514116","175514357","chr6","171541389","171541634","17","3972727"
"chr5","175514771","175514888","chr6","171542041","171542158","8","3972730"
"chr5","175515661","175515977","chr6","171542943","171543255","26","3972718"
"chr5","175519741","175519863","chr3","156434833","156434957","17","19084908"
"chr5","175520654","175520931","chr6","171548508","171548788","23","3972146"
"chr5","175523965","175524163","chr6","171554835","171555034","23","3969130"
"chr5","175531677","175531957","chr6","171563039","171563321","18","3968638"
"chr5","175559732","175559842","chr6","139383516","139383625","20","36176216"
"chr5","175600976","175601096","chr6","171633151","171633269","9","3967825"
"chr5","175606048","175606344","chr6","171638204","171638489","26","3967844"
"chr5","175611963","175612291","chr6","171644187","171644507","50","3967776"
"chr5","175612370","175612652","chr6","171644581","171644876","45","3967789"
"chr5","175612773","175612902","chr6","171645003","171645132","9","3967770"
"chr5","175620780","175620902","chr6","171653020","171653144","5","3967760"
"chr5","175627213","175627365","chr6","171659453","171659601","19","3967760"
"chr5","175627651","175627786","chr6","171659906","171660045","13","3967745"
"chr5","175632932","175633225","chr16","66916875","66917169","48","108716057"
"chr5","175636805","175637121","chr6","171667065","171667364","34","3969740"
"chr5","175673080","175673207","chr15","5822382","5822514","21","169850698"
"chr5","175688380","175688679","chr11","8098665","8098958","62","167589715"
"chr5","175754488","175754723","chr7","49378464","49378703","45","126376024"
"chr5","175800486","175800609","chr6","171836665","171836788","12","3963821"
"chr5","175936301","175936599","chrX","18434636","18434931","53","157501665"
"chr5","176039225","176039503","chr6","172076233","172076482","43","3962992"
"chr5","176049697","176049999","chr6","172086652","172086955","31","3963045"
"chr5","176083540","176083800","chr6","172122089","172122350","19","3961451"
"chr5","176210546","176210674","chr6","172249687","172249815","9","3960859"
"chr5","176211903","176212097","chr6","172252298","172252482","14","3959605"
"chr5","176247073","176247391","chr6","172287871","172288183","35","3959202"
"chr5","176258430","176258482","chr6","135999952","136000000","12","40258478"
"chr5","176298548","176298837","chr6","172334517","172334809","25","3964031"
"chr5","176313581","176313881","chr11","48401419","48401716","56","127912162"
"chr5","176331131","176331432","chr6","172367649","172367951","35","3963482"
"chr5","176333253","176333552","chr6","172369741","172370023","33","3963512"
"chr5","176382587","176382852","chr6","172419932","172420216","47","3962655"
"chr5","176426750","176427003","chr6","172475365","172475612","27","3951385"
"chr5","176448794","176449090","chr3","123900618","123900920","66","52548176"
"chr5","176487188","176487480","chr9","98661850","98662144","49","77825338"
"chr5","176508965","176509252","chr6","172559404","172559696","26","3949561"
"chr5","176641001","176641130","chr1","144486514","144486647","21","32154487"
"chr5","176694719","176695013","chr11","112582920","112583198","72","64111799"
"chr5","176703801","176704102","chr17","24307072","24307369","56","152396729"
"chr5","176779849","176780158","chr6","172836479","172836773","35","3943370"
"chr5","176783993","176784298","chr11","970811","971107","65","175813182"
"chr5","176796588","176796712","chr12","29276732","29276857","24","147519856"
"chr5","176915249","176915513","chr6","172971633","172971901","19","3943616"
"chr5","176926795","176927052","chr6","172982623","172982875","18","3944172"
"chr5","176946201","176946318","chr4","116585293","116585408","26","60360908"
"chr5","176946328","176946552","chr6","173002770","173002985","24","3943558"
"chr5","176946980","176947137","chr1","138345950","138346105","33","38601030"
"chr5","176949049","176949180","chr6","173005400","173005529","14","3943649"
"chr5","176955852","176956144","chr6","173013958","173014256","29","3941894"
"chr5","176958175","176958480","chr6","173015988","173016284","30","3942187"
"chr5","177005514","177005647","chr1","14179041","14179172","24","162826473"
"chr5","177049293","177049586","chr6","173104427","173104709","26","3944866"
"chr5","177101313","177101575","chr17","21445729","21446007","71","155655584"
"chr5","177219480","177219609","chr6","173299702","173299834","10","3919778"
"chr5","177224033","177224322","chr6","173304888","173305193","38","3919145"
"chr5","177257965","177258156","chr6","173338807","173339013","30","3919158"
"chr5","177288028","177288315","chr6","173406171","173406453","40","3881857"
"chr5","177349312","177349617","chr6","173462866","173463155","35","3886446"
"chr5","177362948","177363233","chr6","173477009","173477303","36","3885939"
"chr5","177422928","177423222","chr1","76211787","76212081","64","101211141"
"chr5","177577527","177577815","chr6","173699636","173699916","26","3877891"
"chr5","177602180","177602453","chr6","173725393","173725640","45","3876787"
"chr5","177712110","177712434","chr6","173830870","173831199","23","3881240"
"chr5","177738327","177738650","chr6","173857022","173857328","42","3881305"
"chr5","177772202","177772506","chr6","173890254","173890558","16","3881948"
"chr5","177807062","177807170","chr17","81628308","81628414","20","96178754"
"chr5","177807818","177808025","chr2","150567599","150567793","44","27240219"
"chr5","177864140","177864437","chr6","173983061","173983353","35","3881079"
"chr5","177922315","177922614","chr6","174045105","174045413","37","3877210"
"chr5","177952091","177952409","chr2","143070309","143070614","60","34881782"
"chr5","177989096","177989388","chr6","174108249","174108540","45","3880847"
"chr5","178021025","178021276","chr6","174140759","174141025","34","3880266"
"chr5","178022948","178023209","chr6","174142855","174143137","50","3880093"
"chr5","178032260","178032554","chr6","174152187","174152478","32","3880073"
"chr5","178111398","178111689","chr6","174232528","174232824","27","3878870"
"chr5","178135448","178135691","chr6","174256737","174257002","44","3878711"
"chr5","178212035","178212321","chr4","36614519","36614808","58","141597516"
"chr5","178263429","178263777","chr20","50933065","50933393","83","127330364"
"chr5","178275362","178275657","chr6","174439284","174439572","38","3836078"
"chr5","178671813","178672123","chr6","174755566","174755866","27","3916247"
"chr5","178673020","178673317","chr6","174756779","174757072","17","3916241"
"chr5","178679621","178679907","chrX","148477454","148477728","29","30202167"
"chr5","178681204","178681509","chr6","174762430","174762708","41","3918774"
"chr5","178689496","178689620","chr6","174771128","174771252","2","3918368"
"chr5","178705975","178706255","chr6","174784716","174784976","30","3921259"
"chr5","178768074","178768203","chr6","174854302","174854430","13","3913772"
"chr5","178776764","178777023","chr6","174864299","174864555","26","3912465"
"chr5","178817083","178817218","chr11","121219101","121219227","33","57597982"
"chr5","178824835","178825103","chr11","105174292","105174563","52","73650543"
"chr5","178838970","178839101","chr10","84860896","84861024","18","93978074"
"chr5","178882849","178883047","chr6","174975590","174975801","53","3907259"
"chr5","178892166","178892325","chr7","21009240","21009397","37","157882926"
"chr5","178934024","178934319","chr6","175032863","175033157","25","3901161"
"chr5","178948840","178948980","chr6","175048791","175048932","10","3900049"
"chr5","178972612","178972674","chr6","175071805","175071867","9","3900807"
"chr5","178973626","178973921","chr6","175072843","175073138","48","3900783"
"chr5","178975946","178976247","chr6","175075166","175075468","18","3900780"
"chr5","178983546","178983792","chr6","175082529","175082771","10","3901017"
"chr5","179001434","179001818","chr6","175100368","175100754","45","3901066"
"chr5","179007840","179008141","chr6","175107302","175107603","21","3900538"
"chr5","179009240","179009355","chr3","38756780","38756896","21","140252460"
"chr5","179009387","179009564","chrX","113173870","113174044","33","65835517"
"chr5","179027557","179027805","chr6","175123572","175123817","24","3903985"
"chr5","179037969","179038269","chr2","160551205","160551504","50","18486764"
"chr5","179088724","179089031","chr6","175186367","175186665","22","3902357"
"chr5","179107979","179108109","chr6","175246773","175246891","21","3861206"
"chr5","179125343","179125614","chr6","175264278","175264549","14","3861065"
"chr5","179126924","179127242","chr6","175265853","175266169","26","3861071"
"chr5","179302077","179302377","chr6","175445928","175446233","29","3856149"
"chr5","179340876","179341163","chr6","175586954","175587240","25","3753922"
"chr5","179342135","179342415","chr6","175588207","175588489","20","3753928"
"chr5","179343267","179343589","chr6","175589340","175589657","36","3753927"
"chr5","179348009","179348260","chr6","175594360","175594615","17","3753649"
"chr5","179348750","179349029","chr5","40762070","40762343","69","138586680"
"chr5","179353020","179353240","chr6","175597690","175597898","28","3755330"
"chr5","179353386","179353530","chr16","40227398","40227521","38","139125988"
"chr5","179353789","179353955","chr6","175598463","175598629","6","3755326"
"chr5","179360001","179360222","chr3","165295251","165295467","52","14064750"
"chr5","179366384","179366654","chr6","175608863","175609153","52","3757521"
"chr5","179378421","179378751","chr6","175621157","175621510","46","3757264"
"chr5","179379999","179380257","chr6","175626475","175626706","35","3753524"
"chr5","179385205","179385492","chr6","175629810","175630092","27","3755395"
"chr5","179395204","179395477","chr6","175639976","175640263","59","3755228"
"chr5","179401676","179401971","chr6","175648685","175648980","21","3752991"
"chr5","179431464","179431670","chr6","175678989","175679189","25","3752475"
"chr5","179468316","179468594","chr6","175726569","175726846","17","3741747"
"chr5","179477927","179478295","chr1","15735055","15735377","116","163742872"
"chr5","179485235","179485390","chr5","140176397","140176549","40","39308838"
"chr5","179506173","179506461","chr6","175769027","175769316","18","3737146"
"chr5","179512974","179513215","chr6","175775810","175776040","29","3737164"
"chr5","179527344","179527623","chr6","175792256","175792548","30","3735088"
"chr5","179531527","179531839","chr6","175797983","175798279","43","3733544"
"chr5","179555064","179555351","chr1","191690399","191690678","59","12135335"
"chr5","179556288","179556508","chr6","175822359","175822612","60","3733929"
"chr5","179563688","179564023","chr6","175834791","175835091","44","3728897"
"chr5","179573027","179573120","chr15","86623730","86623813","24","92949297"
"chr5","179596447","179596729","chr5","165714831","165715111","56","13881616"
"chr5","179606073","179606360","chr15","8986778","8987055","66","170619295"
"chr5","179610266","179610551","chr6","175883893","175884180","27","3726373"
"chr5","179622804","179622929","chr13","87095059","87095190","23","92527745"
"chr5","179644773","179644972","chr6","175919776","175919971","16","3724997"
"chr5","179707945","179708251","chr6","175980386","175980693","40","3727559"
"chr5","179720204","179720514","chr15","40689741","40690052","57","139030463"
"chr5","179724353","179724610","chr6","176006247","176006529","39","3718106"
"chr5","179744781","179745043","chr6","176033710","176033969","19","3711071"
"chr5","179756687","179756974","chr6","176046223","176046519","28","3710464"
"chr5","179758645","179758740","chr6","176048213","176048309","10","3710432"
"chr5","179759044","179759241","chr6","176048617","176048814","16","3710427"
"chr5","179760011","179760135","chr6","64065434","64065559","17","115694577"
"chr5","179783150","179783426","chr6","176074993","176075280","24","3708157"
"chr5","179848778","179849079","chr6","176142939","176143213","42","3705839"
"chr5","179880811","179880943","chr13","70830779","70830910","17","109050032"
"chr5","179896662","179896952","chr6","176191002","176191305","29","3705660"
"chr5","179912570","179912844","chr6","176207541","176207847","50","3705029"
"chr5","179920059","179920351","chr6","176215617","176215901","18","3704442"
"chr5","179920354","179920668","chr15","94614650","94614958","73","85305704"
"chr5","179932966","179933267","chr6","176225696","176225998","31","3707270"
"chr5","179934122","179934406","chr6","176228945","176229232","28","3705177"
"chr5","179949731","179950017","chr6","176251945","176252234","24","3697786"
"chr5","179987953","179988255","chr6","174756779","174757072","19","5231174"
"chr5","180489541","180489806","chr19","8275534","8275802","65","172214007"
"chr5","180495714","180496001","chr6","176547520","176547795","28","3948194"
"chr5","180496458","180496764","chr6","176548260","176548567","30","3948198"
"chr5","180500200","180500470","chr6","176553503","176553787","42","3946697"
"chr5","180566930","180567221","chr6","176632093","176632396","25","3934837"
"chr5","180571707","180571897","chr3","157608781","157608963","51","22962926"
"chr5","180576235","180576573","chr6","176645151","176645486","29","3931084"
"chr5","180610325","180610457","chr10","2158834","2158966","18","178451491"
"chr5","180649111","180649324","chr6","176717360","176717573","19","3931751"
"chr5","180677062","180677381","chr6","176745618","176745925","32","3931444"
"chr5","180677837","180678045","chr6","176746414","176746626","23","3931423"
"chr5","180801821","180802109","chrX","2053857","2054151","66","178747964"
"chr5","180840806","180841130","chr6","176917249","176917521","67","3923557"
"chr5","180918228","180918547","chr6","177002013","177002332","42","3916215"
"chr5","180996516","180996799","chr6","177083006","177083293","21","3913510"
"chr5","181029576","181029689","chr14","70071051","70071162","21","110958525"
"chr5","181062716","181062984","chr6","177149914","177150198","34","3912802"
"chr5","181094599","181094898","chr6","177179844","177180140","30","3914755"
"chr5","181133535","181133747","chr6","177231862","177232078","17","3901673"
"chr5","181193509","181193813","chr6","36719306","36719615","59","144474203"
"chr5","181198813","181198967","chr7","80140173","80140333","29","101058640"
"chr5","181199262","181199406","chr3","5152152","5152298","27","176047110"
"chr5","181210771","181210894","chr11","125270722","125270848","19","55940049"
"chr5","181211188","181211385","chr11","125270220","125270417","23","55940968"
"chr5","181220636","181220931","chr4","81996234","81996529","58","99224402"
"chr5","181223738","181224016","chr6","177383613","177383884","27","3840125"
"chr5","181258638","181258761","chr6","179399147","179399271","18","1859491"
"chr5","181263779","181263976","chr19","14293262","14293454","54","166970517"
"chr5","181273226","181273492","chr6","177428395","177428664","23","3844831"
"chr5","181275196","181275492","chr1","10227902","10228202","55","171047294"
"chr5","181312022","181312148","chr6","177465625","177465751","9","3846397"
"chr5","181343710","181344043","chr2","57200150","57200469","81","124143560"
"chr5","181351778","181352080","chr8","129078136","129078437","56","52273642"
"chr5","181438377","181438673","chr6","177561252","177561546","31","3877125"
"chr5","181491139","181491417","chr6","177621010","177621297","22","3870129"
"chr5","181498002","181498299","chr6","177627216","177627514","21","3870786"
"chr5","181515056","181515345","chr6","177639966","177640254","12","3875090"
"chr5","181519634","181519781","chr16","1119774","1119913","29","180399860"
"chr5","181577024","181577138","chr6","177702297","177702411","8","3874727"
"chr5","181733178","181733460","chr6","177924891","177925190","35","3808287"
"chr5","181735427","181735690","chr6","177927175","177927437","21","3808252"
"chr5","181792580","181792864","chr6","177984742","177985022","34","3807838"
"chr5","181801121","181801434","chr16","68650242","68650548","68","113150879"
"chr5","181826055","181826378","chr2","85064705","85065029","66","96761350"
"chr5","181913564","181913897","chr6","147432797","147433108","83","34480767"
"chr5","181916395","181916529","chr6","178106752","178106893","24","3809643"
"chr5","181916826","181916958","chr6","178107208","178107341","8","3809618"
"chr5","181921382","181921493","chr1","207476913","207477027","16","25555531"
"chr5","181937968","181938247","chr6","178128419","178128666","56","3809549"
"chr5","181950949","181951237","chr6","176458169","176458462","21","5492780"
"chr5","181953456","181953579","chr9","107933148","107933272","23","74020308"
"chr5","181966067","181966209","chr7","40138208","40138349","31","141827859"
"chr5","182010083","182010383","chr6","178193231","178193518","29","3816852"
"chr5","182015295","182015517","chr6","178198727","178198951","10","3816568"
"chr5","182035386","182035438","chr9","63573559","63573612","4","118461827"
"chr5","182059978","182060152","chr9","63600757","63600919","19","118459221"
"chr5","182064574","182064791","chr6","178308093","178308309","32","3756481"
"chr5","182066354","182066485","chr8","71179092","71179225","25","110887262"
"chr5","182068731","182068925","chr3","47015232","47015392","64","135053499"
"chr5","182135379","182135503","chr1","18100775","18100899","18","164034604"
"chr5","182136670","182136800","chr1","109570884","109571013","23","72565786"
"chr5","182141566","182141645","chr5","4406822","4406896","13","177734744"
"chr5","182141951","182142080","chr7","28999315","28999444","19","153142636"
"chr5","182148863","182149068","chr6","178327373","178327575","11","3821490"
"chr5","182160727","182160824","chr6","178338962","178339062","10","3821765"
"chr5","182165127","182165438","chr1","53872477","53872791","71","128292650"
"chr5","182174463","182174526","chr1","51114102","51114163","15","131060361"
"chr5","182179201","182179492","chr6","178357753","178358051","49","3821448"
"chr5","182181605","182181883","chr6","178360224","178360525","51","3821381"
"chr5","182192240","182192387","chr6","178373119","178373266","9","3819121"
"chr5","182203726","182203913","chr6","178386064","178386251","8","3817662"
"chr5","182219514","182219798","chr6","178405057","178405344","35","3814457"
"chr5","182244144","182244391","chr6","178439024","178439265","26","3805120"
"chr5","182245989","182246006","chr3","36694768","36694783","5","145551221"
"chr5","182246295","182246454","chr9","31949106","31949249","39","150297189"
"chr5","182246455","182246755","chr1","53550509","53550803","53","128695946"
"chr5","182246756","182246786","chr3","126655182","126655212","7","55591574"
"chr5","182248711","182248982","chr6","178444960","178445219","32","3803751"
"chr5","182255207","182255478","chr6","178451505","178451757","35","3803702"
"chr5","182343262","182343413","chr6","178529181","178529332","10","3814081"
"chr5","182452534","182452704","chr6","178635503","178635680","17","3817031"
"chr5","182458520","182458650","chr6","178641311","178641427","22","3817209"
"chr5","182515229","182515529","chr6","178693467","178693757","47","3821762"
"chr5","182525507","182525800","chr6","178704158","178704440","35","3821349"
"chr5","182531866","182532161","chr6","178711109","178711412","24","3820757"
"chr5","182547602","182547661","chr6","178727387","178727446","5","3820215"
"chr5","182547937","182548106","chr6","178727722","178727889","12","3820215"
"chr5","182562924","182563236","chr6","178743923","178744225","29","3819001"
"chr5","182567858","182568158","chr6","178749825","178750122","43","3818033"
"chr5","182589382","182589656","chr6","178771122","178771396","26","3818260"
"chr5","182591673","182591984","chr15","5230578","5230886","57","177361095"
"chr5","182804267","182804564","chr6","178966828","178967109","28","3837439"
"chr5","182818331","182818631","chr6","178981046","178981332","46","3837285"
"chr5","182871770","182871924","chr10","36090027","36090178","33","146781743"
"chr5","182872225","182872285","chr6","140219179","140219240","17","42653046"
"chr5","182928981","182929260","chr6","179149844","179150123","14","3779137"
"chr5","182939590","182939854","chr6","179154659","179154925","24","3784931"
"chr5","182968025","182968224","chr10","27229920","27230113","49","155738105"
"chr5","182968970","182969073","chr6","179186943","179187044","9","3782027"
"chr5","182983537","182983662","chr6","179198279","179198403","8","3785258"
"chr5","182986792","182986924","chr1","128086244","128086378","21","54900548"
"chr5","182992145","182992444","chr19","35633077","35633377","51","147359068"
"chr5","183026138","183026378","chr5","93877879","93878104","65","89148259"
"chr5","183044273","183044566","chr3","183694819","183695107","59","650546"
"chr5","183046967","183047280","chrX","135002357","135002680","68","48044610"
"chr5","183056605","183056905","chr6","179267910","179268215","29","3788695"
"chr5","183062605","183062729","chr6","179278475","179278605","10","3784130"
"chr5","183083227","183083522","chr6","179298986","179299282","21","3784241"
"chr5","183084227","183084513","chr6","179300600","179300877","32","3783627"
"chr5","183095221","183095347","chr6","179310855","179310981","6","3784366"
"chr5","183104571","183104663","chr6","179320771","179320863","8","3783800"
"chr5","183104664","183104971","chr6","179320864","179321166","33","3783800"
"chr5","183104972","183105110","chr6","179321167","179321305","6","3783805"
"chr5","183118236","183118522","chr6","179333395","179333663","42","3784841"
"chr5","183190249","183190550","chr6","179397782","179398084","26","3792467"
"chr5","183195618","183195741","chr12","49987499","49987623","17","133208119"
"chr5","183282362","183282655","chr3","124267629","124267922","56","59014733"
"chr5","183455529","183455637","chr3","175746925","175747036","20","7708604"
"chr5","183455719","183455930","chr6","179680828","179681010","36","3774891"
"chr5","183484125","183484386","chr5","168601042","168601304","66","14883083"
"chr5","183531445","183531685","chr6","179749192","179749444","30","3782253"
"chr5","183543761","183543987","chr6","179778678","179778873","44","3765083"
"chr5","183555076","183555205","chr6","179796678","179796799","11","3758398"
"chr5","183557941","183558211","chr6","179799851","179800155","53","3758090"
"chr5","183560946","183561247","chr6","179804174","179804476","17","3756772"
"chr5","183563303","183563427","chr6","179806811","179806932","9","3756492"
"chr5","183566132","183566423","chr6","179809707","179810000","21","3756425"
"chr5","183570720","183571007","chr6","179814297","179814602","50","3756423"
"chr5","183595971","183596198","chr6","179846321","179846562","50","3749650"
"chr5","183606477","183606721","chr6","179835209","179835459","25","3771268"
"chr5","183612751","183613044","chr6","179828524","179828824","35","3784227"
"chr5","183613046","183613177","chr19","12812292","12812422","30","170800754"
"chr5","183617007","183617310","chr6","179882526","179882825","26","3734481"
"chr5","183618474","183618773","chr6","179884554","179884845","25","3733920"
"chr5","183633735","183634013","chr6","179902199","179902486","31","3731536"
"chr5","183648701","183648996","chr6","179928595","179928894","18","3720106"
"chr5","183660000","183660311","chr1","207818583","207818892","65","24158583"
"chr5","183679264","183679543","chr6","179963504","179963782","16","3715760"
"chr5","183703866","183704132","chr6","179989842","179990106","32","3714024"
"chr6","3801083","3801161","chr10","79441944","79442013","24","75640861"
"chr6","13893467","13893765","chr4","13956851","13957156","40","63384"
"chr6","18087925","18088220","chr4","18283199","18283482","32","195274"
"chr6","35258133","35258429","chr4","35459543","35459847","33","201410"
"chr6","35782544","35782837","chr4","36031212","36031504","22","248668"
"chr6","46268317","46268626","chr3","43652365","43652670","61","2615952"
"chr6","103546745","103546987","chr4","100496219","100496460","15","3050526"
"chr6","106168296","106168591","chr4","105833499","105833790","56","334797"
"chr6","114687884","114688176","chr4","155136083","155136376","13","40448199"
"chr6","157417470","157417673","chr13","75616065","75616265","40","81801405"
"chr6","209756","210039","chr4","113197","113486","35","96559"
"chr6","213875","214109","chr4","117336","117569","20","96539"
"chr6","343889","344161","chr4","252302","252571","30","91587"
"chr6","424216","424338","chr4","333362","333489","12","90854"
"chr6","445285","445515","chr4","354546","354783","24","90739"
"chr6","482343","482508","chr19","8026553","8026714","40","7544210"
"chr6","599617","599921","chr4","513127","513429","22","86490"
"chr6","633912","634192","chr20","28132467","28132746","64","27498555"
"chr6","670948","671121","chr4","581858","582029","23","89090"
"chr6","671202","671496","chr4","582100","582403","35","89102"
"chr6","806651","806765","chr4","723293","723407","8","83358"
"chr6","844591","844868","chr4","763347","763624","24","81244"
"chr6","914446","914738","chr4","842590","842884","25","71856"
"chr6","952796","953011","chr4","879205","879423","14","73591"
"chr6","985857","986055","chr4","918435","918630","20","67422"
"chr6","997362","997472","chr4","928212","928322","5","69150"
"chr6","1011335","1011618","chr13","93973412","93973700","55","92962077"
"chr6","1012738","1012832","chr3","165339814","165339909","14","164327076"
"chr6","1050568","1050859","chr4","984335","984625","27","66233"
"chr6","1069824","1070117","chr4","1004704","1004994","30","65120"
"chr6","1155502","1155782","chr4","1093892","1094207","48","61610"
"chr6","1204912","1205206","chr4","1145756","1146052","24","59156"
"chr6","1260700","1260988","chr4","1201417","1201705","21","59283"
"chr6","1283619","1283934","chr4","1225331","1225640","31","58288"
"chr6","1298313","1298600","chr4","1241665","1241957","25","56648"
"chr6","1304363","1304656","chr4","1247746","1248048","37","56617"
"chr6","1334548","1334769","chr7","67935717","67935941","39","66601169"
"chr6","1349166","1349462","chr4","1294654","1294954","35","54512"
"chr6","1355202","1355271","chr4","1300646","1300715","5","54556"
"chr6","1429035","1429238","chr4","1371592","1371793","23","57443"
"chr6","1444456","1444750","chr4","1388065","1388365","26","56391"
"chr6","1476877","1476993","chr4","1420218","1420339","10","56659"
"chr6","1484147","1484409","chr4","1427386","1427651","19","56761"
"chr6","1485032","1485323","chr4","1428306","1428596","28","56726"
"chr6","1488037","1488344","chr9","13128562","13128862","62","11640525"
"chr6","1500671","1500976","chr1","154261716","154262030","63","152761045"
"chr6","1522111","1522413","chr4","1468385","1468693","17","53726"
"chr6","1526478","1526787","chr15","29615590","29615889","60","28089112"
"chr6","1568303","1568599","chr4","1515265","1515565","39","53038"
"chr6","1683581","1683867","chr4","1641143","1641425","26","42438"
"chr6","1710176","1710453","chr4","1668910","1669196","28","41266"
"chr6","1716612","1716892","chr4","1675581","1675863","27","41031"
"chr6","1811077","1811373","chr4","1773623","1773928","33","37454"
"chr6","1813865","1814165","chr4","1776465","1776767","32","37400"
"chr6","1821634","1821799","chr17","25969784","25969954","38","24148150"
"chr6","1821845","1821914","chrUn_NW_014806600v1","312","373","11","1821533"
"chr6","1884120","1884253","chr4","1842123","1842256","6","41997"
"chr6","1890368","1890661","chr4","1848360","1848652","23","42008"
"chr6","1940545","1940849","chr4","1897943","1898258","36","42602"
"chr6","1946021","1946326","chr4","1903335","1903656","42","42686"
"chr6","1978030","1978325","chr4","1940806","1941098","24","37224"
"chr6","2007376","2007510","chr3","124779313","124779446","22","122771937"
"chr6","2058234","2058406","chr4","2017308","2017461","28","40926"
"chr6","2069271","2069570","chr4","2028227","2028525","16","41044"
"chr6","2103134","2103434","chr4","2062562","2062870","23","40572"
"chr6","2170950","2171193","chr4","2127633","2127894","36","43317"
"chr6","2176709","2176999","chr4","2133692","2134002","54","43017"
"chr6","2192823","2193128","chr4","2149940","2150218","40","42883"
"chr6","2227157","2227462","chr4","2185273","2185588","26","41884"
"chr6","2227560","2227865","chr4","2185682","2185992","24","41878"
"chr6","2266825","2266930","chr4","2221205","2221309","5","45620"
"chr6","2267296","2267485","chr4","2221672","2221859","10","45624"
"chr6","2341624","2341922","chr4","2343126","2343409","33","1502"
"chr6","2348332","2348624","chr4","2347084","2347382","27","1248"
"chr6","2350939","2351042","chr15","102380912","102381010","22","100029973"
"chr6","2351109","2351355","chr10","61695759","61696020","59","59344650"
"chr6","2374366","2374647","chrX","112227503","112227781","58","109853137"
"chr6","2403967","2404263","chr4","2398820","2399115","19","5147"
"chr6","2427056","2427285","chr4","2421154","2421381","21","5902"
"chr6","2427669","2427714","chr3","142522068","142522117","10","140094399"
"chr6","2427716","2427873","chr1","153250707","153250848","30","150822991"
"chr6","2428354","2428681","chr4","154254682","154255002","78","151826328"
"chr6","2521459","2521730","chr4","2519086","2519378","44","2373"
"chr6","2539568","2539872","chr4","2540951","2541250","22","1383"
"chr6","2594943","2595254","chr11","106806097","106806403","53","104211154"
"chr6","2651262","2651578","chr4","2656064","2656412","47","4802"
"chr6","2672927","2673231","chr4","2678476","2678788","37","5549"
"chr6","2689849","2689983","chr4","2694854","2694984","21","5005"
"chr6","2732888","2733193","chr4","2738164","2738467","22","5276"
"chr6","2740908","2741207","chr2","4746499","4746796","57","2005591"
"chr6","2755636","2755924","chr4","2754627","2754914","24","1009"
"chr6","2770605","2770831","chr4","2770014","2770242","14","591"
"chr6","2791086","2791361","chr4","2787026","2787296","24","4060"
"chr6","2822367","2822650","chr4","2820307","2820578","28","2060"
"chr6","2844265","2844567","chr4","2840586","2840897","38","3679"
"chr6","2879184","2879404","chr4","2874844","2875064","12","4340"
"chr6","2879683","2879768","chr4","2875346","2875431","7","4337"
"chr6","2887525","2887647","chr3","41600891","41601015","19","38713366"
"chr6","2892427","2892587","chr7","81869322","81869481","40","78976895"
"chr6","2930435","2930606","chrX","66216938","66217110","38","63286503"
"chr6","2948043","2948165","chr4","2942922","2943039","15","5121"
"chr6","2949721","2949996","chr4","2944331","2944622","31","5390"
"chr6","2956879","2957167","chr4","2951779","2952070","28","5100"
"chr6","2958816","2959110","chr4","2953720","2954017","25","5096"
"chr6","2962391","2962699","chr4","2957366","2957678","34","5025"
"chr6","2972821","2973087","chr13","25090593","25090872","54","22117772"
"chr6","2975749","2976040","chr9","23116704","23116994","59","20140955"
"chr6","3025406","3025678","chr1","53433239","53433522","66","50407833"
"chr6","3028526","3028811","chr1","155141171","155141450","62","152112645"
"chr6","3031623","3031889","chr4","11454724","11454998","62","8423101"
"chr6","3046967","3047211","chr4","3026534","3026770","32","20433"
"chr6","3082313","3082625","chr6","116877498","116877809","64","113795185"
"chr6","3271417","3271710","chr4","3147744","3148041","33","123673"
"chr6","3274559","3274859","chr18","28647220","28647521","52","25372661"
"chr6","3278698","3278993","chr4","3155502","3155784","32","123196"
"chr6","3344308","3344556","chr14","106331776","106332024","51","102987468"
"chr6","3364417","3364723","chr4","3241327","3241630","39","123090"
"chr6","3423934","3424239","chr4","3304923","3305229","18","119011"
"chr6","3477277","3477573","chr7","140100928","140101221","53","136623651"
"chr6","3570069","3570357","chr4","3450915","3451203","26","119154"
"chr6","3598195","3598368","chr4","3490493","3490687","33","107702"
"chr6","3625946","3626246","chr4","3519207","3519516","48","106739"
"chr6","3644042","3644261","chr4","3538258","3538479","18","105784"
"chr6","3662177","3662469","chr4","3557520","3557810","18","104657"
"chr6","3721313","3721605","chr4","3605165","3605457","25","116148"
"chr6","3742736","3743003","chr4","3623632","3623904","25","119104"
"chr6","3814837","3815005","chr19","8026553","8026714","31","4211716"
"chr6","3837899","3838160","chr4","3762128","3762404","32","75771"
"chr6","3842625","3842905","chr17","28543733","28543999","65","24701108"
"chr6","3899512","3899803","chr4","3826862","3827158","31","72650"
"chr6","3961574","3961653","chr2","181176233","181176313","16","177214659"
"chr6","3965254","3965563","chr20","42042273","42042584","56","38077019"
"chr6","3980370","3980636","chr4","3918292","3918558","19","62078"
"chr6","4009178","4009301","chrX","117458160","117458281","16","113448982"
"chr6","4010313","4010482","chr4","3951164","3951329","18","59149"
"chr6","4037947","4038151","chr4","3979151","3979345","19","58796"
"chr6","4051967","4052282","chr4","3992826","3993134","40","59141"
"chr6","4081253","4081475","chr4","4022341","4022571","27","58912"
"chr6","4108896","4109184","chr4","4051362","4051669","33","57534"
"chr6","4110908","4111219","chr4","4053386","4053698","24","57522"
"chr6","4119463","4119686","chr4","4061020","4061243","23","58443"
"chr6","4144446","4144486","chrX","15971031","15971069","8","11826585"
"chr6","4226603","4226866","chr4","4173471","4173752","33","53132"
"chr6","4233019","4233291","chr4","4179778","4180037","31","53241"
"chr6","4260773","4261030","chr4","4204729","4204990","16","56044"
"chr6","4291868","4292159","chr4","4235278","4235567","15","56590"
"chr6","4293091","4293248","chr9","6115363","6115528","57","1822272"
"chr6","4404184","4404425","chr4","4344949","4345202","28","59235"
"chr6","4472349","4472570","chr4","4420500","4420719","26","51849"
"chr6","4485413","4485720","chr4","4433911","4434212","33","51502"
"chr6","4520149","4520444","chr4","4467851","4468145","19","52298"
"chr6","4557815","4557911","chr4","4510802","4510897","9","47013"
"chr6","4586606","4586861","chr4","4538651","4538922","26","47955"
"chr6","4599442","4599738","chr4","4549966","4550271","31","49476"
"chr6","4604848","4604940","chr17","31168328","31168410","25","26563480"
"chr6","4605644","4605875","chr20","29246987","29247224","60","24641343"
"chr6","4612808","4612939","chr9","8054611","8054743","21","3441803"
"chr6","4631762","4632058","chr4","4583058","4583342","31","48704"
"chr6","4651696","4651810","chr5","24916403","24916528","37","20264707"
"chr6","4652442","4652490","chr19","10815716","10815764","8","6163274"
"chr6","4656016","4656300","chr4","4608229","4608527","35","47787"
"chr6","4694546","4694844","chr4","4662326","4662613","34","32220"
"chr6","4702951","4703184","chr4","4651771","4652001","23","51180"
"chr6","4704277","4704575","chr4","4650399","4650694","22","53878"
"chr6","4719264","4719493","chr4","4635418","4635647","21","83846"
"chr6","4733303","4733612","chr4","4690084","4690395","36","43219"
"chr6","4734429","4734622","chr1","40056357","40056566","51","35321928"
"chr6","4738947","4739241","chr4","4696874","4697136","60","42073"
"chr6","4739342","4739624","chr4","4697260","4697561","39","42082"
"chr6","4743671","4743897","chr19","37601265","37601475","65","32857594"
"chr6","4747644","4747767","chrX","128431081","128431216","28","123683437"
"chr6","4754153","4754449","chr4","4711118","4711435","50","43035"
"chr6","4765825","4766116","chr4","4724544","4724839","21","41281"
"chr6","4766571","4766869","chr2","84913076","84913368","64","80146505"
"chr6","4769848","4769937","chr4","4728892","4728983","7","40956"
"chr6","4771811","4771935","chr4","4730642","4730764","6","41169"
"chr6","4823595","4823884","chr4","4837822","4838118","29","14227"
"chr6","4874091","4874392","chr4","4882118","4882423","31","8027"
"chr6","4876594","4876769","chr4","4885134","4885310","14","8540"
"chr6","4918807","4918996","chr8","10442765","10442951","51","5523958"
"chr6","4919252","4919421","chr3","63876628","63876793","32","58957376"
"chr6","4955872","4955986","chr4","4963562","4963677","3","7690"
"chr6","4984523","4984810","chr4","4995105","4995395","21","10582"
"chr6","5001003","5001060","chr4","5010381","5010438","2","9378"
"chr6","5002232","5002404","chr4","5011638","5011813","15","9406"
"chr6","5011437","5011714","chr4","5021010","5021283","44","9573"
"chr6","5025540","5025843","chr15","50250330","50250644","77","45224790"
"chr6","5029164","5029457","chr14","122733616","122733911","50","117704452"
"chr6","5045224","5045502","chr4","5085405","5085685","17","40181"
"chr6","5049921","5050205","chr4","5090084","5090369","16","40163"
"chr6","5058540","5058731","chr4","5103472","5103654","27","44932"
"chr6","5066703","5067001","chr4","5111660","5111930","64","44957"
"chr6","5070826","5070964","chr4","5116073","5116193","25","45247"
"chr6","5076402","5076694","chrX","19565039","19565340","52","14488637"
"chr6","5077702","5078017","chr4","5123121","5123426","55","45419"
"chr6","5078457","5078618","chr4","5123874","5124035","9","45417"
"chr6","5080735","5081104","chr8","23000386","23000729","103","17919651"
"chr6","5083231","5083357","chr4","5128746","5128878","14","45515"
"chr6","5089247","5089537","chr9","99101491","99101790","59","94012244"
"chr6","5112664","5112979","chr4","5159237","5159552","21","46573"
"chr6","5114674","5114967","chr4","5161275","5161569","19","46601"
"chr6","5120323","5120591","chr4","5167080","5167337","35","46757"
"chr6","5174995","5175288","chr4","5221001","5221300","23","46006"
"chr6","5206838","5207151","chr1","39515746","39516064","75","34308908"
"chr6","5236746","5237038","chr1","17258340","17258637","72","12021594"
"chr6","5239672","5239959","chr4","5286899","5287176","32","47227"
"chr6","5292827","5293110","chr4","5341609","5341902","27","48782"
"chr6","5308725","5309017","chr7","140588016","140588306","56","135279291"
"chr6","5309619","5309773","chr1","15677456","15677613","43","10367837"
"chr6","5368987","5369160","chr4","5428457","5428626","10","59470"
"chr6","5436294","5436594","chr4","5497248","5497569","44","60954"
"chr6","5448628","5448937","chr4","5509725","5510034","28","61097"
"chr6","5496763","5497074","chr4","5558862","5559173","24","62099"
"chr6","5616559","5616854","chr4","5679093","5679364","38","62534"
"chr6","5639518","5639795","chr18","85390","85674","60","5554128"
"chr6","5678873","5679180","chr11","115571388","115571689","62","109892515"
"chr6","5713204","5713503","chr4","5769451","5769759","34","56247"
"chr6","5727161","5727414","chr4","5783364","5783616","15","56203"
"chr6","5739300","5739600","chr4","5795978","5796275","26","56678"
"chr6","5756476","5756774","chr4","5813203","5813477","43","56727"
"chr6","5781753","5782009","chr4","5838038","5838286","33","56285"
"chr6","5792308","5792514","chr4","5848622","5848836","16","56314"
"chr6","5998541","5998831","chr15","43687639","43687935","48","37689098"
"chr6","6003301","6003596","chr7","63202758","63203051","58","57199457"
"chr6","6039170","6039228","chr13","89684910","89684972","16","83645740"
"chr6","6227331","6227619","chr4","6264720","6264998","29","37389"
"chr6","6242815","6242844","chr11","56678296","56678322","6","50435481"
"chr6","6242888","6243165","chr4","6274276","6274573","38","31388"
"chr6","6283378","6283656","chr4","6314148","6314429","21","30770"
"chr6","6372023","6372289","chr4","6393501","6393811","60","21478"
"chr6","6464443","6464649","chr17","1715783","1715974","48","4748660"
"chr6","6552187","6552302","chr4","6570277","6570401","13","18090"
"chr6","6570396","6570657","chr3","157398559","157398837","64","150828163"
"chr6","6599684","6599868","chr11","94346059","94346241","49","87746375"
"chr6","6602350","6602660","chr4","6622037","6622343","32","19687"
"chr6","6662177","6662484","chr4","6678531","6678836","25","16354"
"chr6","6735193","6735398","chr4","6757590","6757792","14","22397"
"chr6","6743328","6743627","chr4","6766241","6766529","37","22913"
"chr6","6779720","6780014","chr2","83884719","83885008","55","77104999"
"chr6","6785687","6785990","chr4","6809366","6809670","37","23679"
"chr6","6836662","6836962","chr12","59222204","59222491","65","52385542"
"chr6","6844567","6844688","chr4","6876732","6876856","11","32165"
"chr6","6972879","6973027","chr4","6913972","6914121","12","58907"
"chr6","6987249","6987375","chr4","6929990","6930116","7","57259"
"chr6","6988112","6988222","chr8","139890471","139890585","22","132902359"
"chr6","7004626","7004881","chr4","6949676","6949920","31","54950"
"chr6","7014072","7014343","chr4","6959324","6959591","14","54748"
"chr6","7040500","7040622","chr4","6988605","6988727","7","51895"
"chr6","7043634","7043925","chr4","6991947","6992257","30","51687"
"chr6","7051048","7051303","chr11","50418617","50418873","58","43367569"
"chr6","7056893","7057055","chr4","7005952","7006114","16","50941"
"chr6","7057101","7057215","chr4","7006142","7006256","2","50959"
"chr6","7082345","7082651","chr4","7033228","7033532","14","49117"
"chr6","7085400","7085673","chr4","7039847","7040114","24","45553"
"chr6","7097727","7098016","chr3","127162429","127162726","70","120064702"
"chr6","7100244","7100376","chr10","30449663","30449796","22","23349419"
"chr6","7100627","7100781","chr12","21323547","21323703","27","14222920"
"chr6","7101821","7102137","chr4","7059300","7059606","30","42521"
"chr6","7103392","7103680","chr4","7060551","7060840","25","42841"
"chr6","7116322","7116607","chr4","7074396","7074681","16","41926"
"chr6","7116609","7116923","chr4","7074687","7074993","24","41922"
"chr6","7143162","7143456","chr4","7105213","7105513","35","37949"
"chr6","7149841","7150146","chr4","7111325","7111614","38","38516"
"chr6","7153154","7153268","chr4","7114618","7114732","4","38536"
"chr6","7157823","7158131","chr4","7119268","7119572","28","38555"
"chr6","7166195","7166315","chr4","7127396","7127510","15","38799"
"chr6","7201879","7202164","chr4","7164581","7164866","14","37298"
"chr6","7237157","7237239","chr4","7199953","7200034","8","37204"
"chr6","7237499","7237609","chr4","35754582","35754698","22","28517083"
"chr6","7277174","7277466","chr15","34234250","34234544","56","26957076"
"chr6","7277640","7277760","chr2","169133199","169133321","25","161855559"
"chr6","7283204","7283340","chr15","32071444","32071573","24","24788240"
"chr6","7327647","7327910","chr6","155858026","155858290","48","148530379"
"chr6","7331556","7331842","chr4","7299629","7299919","30","31927"
"chr6","7333081","7333384","chr4","7301150","7301442","23","31931"
"chr6","7356710","7356983","chr4","7325052","7325334","31","31658"
"chr6","7402386","7402684","chr4","7370065","7370366","29","32321"
"chr6","7442001","7442284","chr4","7407268","7407552","14","34733"
"chr6","7452801","7453088","chr4","7416869","7417171","37","35932"
"chr6","7462188","7462484","chr4","7426849","7427145","25","35339"
"chr6","7465044","7465324","chr4","7429627","7429931","50","35417"
"chr6","7476885","7477182","chr4","7441408","7441706","14","35477"
"chr6","7479252","7479541","chr4","7443821","7444115","23","35431"
"chr6","7521349","7521610","chr4","7488270","7488529","12","33079"
"chr6","7534413","7534686","chr4","7502159","7502417","45","32254"
"chr6","7543300","7543619","chrX","133624148","133624458","76","126080848"
"chr6","7555166","7555466","chr4","7521127","7521427","25","34039"
"chr6","7561970","7562259","chr15","43687639","43687935","61","36125669"
"chr6","7565662","7565922","chr4","7530238","7530504","16","35424"
"chr6","7574872","7574975","chr9","6051471","6051572","15","1523401"
"chr6","7575304","7575442","chr9","53307741","53307876","23","45732437"
"chr6","7577602","7577882","chr4","19154114","19154403","62","11576512"
"chr6","7583968","7584233","chr4","7548753","7549018","19","35215"
"chr6","7594640","7594905","chr4","7559473","7559757","42","35167"
"chr6","7605900","7606176","chr4","7571519","7571793","19","34381"
"chr6","7609701","7609965","chr4","7575359","7575618","35","34342"
"chr6","7614059","7614358","chr4","7579823","7580131","30","34236"
"chr6","7618908","7619206","chr15","43687639","43687935","49","36068731"
"chr6","7641179","7641477","chr6","58017234","58017530","57","50376055"
"chr6","7670455","7670773","chr19","6352387","6352699","60","1318068"
"chr6","7677548","7677837","chr4","7623815","7624121","39","53733"
"chr6","7681379","7681658","chr16","49265995","49266270","67","41584616"
"chr6","7744035","7744286","chr4","7707494","7707767","39","36541"
"chr6","7786114","7786423","chr15","40824036","40824354","57","33037922"
"chr6","7791058","7791442","chr4","7755264","7755614","61","35794"
"chr6","7808421","7808540","chr4","7772603","7772725","10","35818"
"chr6","7810303","7810611","chr4","7774485","7774802","25","35818"
"chr6","7815320","7815577","chr1","212936990","212937240","63","205121670"
"chr6","7862400","7862687","chr4","7826425","7826722","32","35975"
"chr6","7866251","7866524","chr4","7830299","7830598","45","35952"
"chr6","7886983","7887299","chr4","7851032","7851349","11","35951"
"chr6","7897298","7897423","chr2","160936509","160936632","33","153039211"
"chr6","7915281","7915552","chrX","103046997","103047266","66","95131716"
"chr6","7929501","7929796","chr4","7897231","7897527","18","32270"
"chr6","7933845","7933978","chr2","95373365","95373485","39","87439520"
"chr6","7934158","7934482","chr4","7901884","7902207","47","32274"
"chr6","7942245","7942363","chr4","163702625","163702740","24","155760380"
"chr6","7950258","7950550","chr4","7917791","7918087","24","32467"
"chr6","7993141","7993435","chr15","14616084","14616383","61","6622943"
"chr6","7994804","7995111","chr19","32609986","32610294","65","24615182"
"chr6","7995723","7996003","chr4","7963213","7963491","36","32510"
"chr6","8016017","8016280","chr4","7983674","7983960","48","32343"
"chr6","8029200","8029523","chr4","7996745","7997059","31","32455"
"chr6","8073181","8073467","chr4","8036227","8036509","20","36954"
"chr6","8114586","8114891","chr4","8078905","8079209","16","35681"
"chr6","8127492","8127615","chr4","8092490","8092613","9","35002"
"chr6","8245407","8245718","chr1","218103299","218103607","62","209857892"
"chr6","8294776","8295086","chr4","8272108","8272427","29","22668"
"chr6","8334832","8335083","chr7","107719390","107719638","58","99384558"
"chr6","8339970","8340247","chr4","110252102","110252381","50","101912132"
"chr6","8340413","8340643","chr4","8318369","8318599","14","22044"
"chr6","8362505","8362808","chr4","8340718","8341035","37","21787"
"chr6","8362818","8363113","chr4","8341044","8341342","28","21774"
"chr6","8441360","8441642","chr4","8417665","8417975","47","23695"
"chr6","8476233","8476371","chr4","8454178","8454295","27","22055"
"chr6","8476397","8476573","chr4","8454525","8454703","17","21872"
"chr6","8518516","8518834","chr4","8494684","8495005","27","23832"
"chr6","8553550","8553669","chr3","101090196","101090312","16","92536646"
"chr6","8553714","8553892","chr10","74803071","74803247","29","66249357"
"chr6","8660315","8660616","chr4","8646799","8647097","27","13516"
"chr6","8697732","8698033","chr4","8684577","8684878","21","13155"
"chr6","8765010","8765294","chr4","8756980","8757245","37","8030"
"chr6","8892087","8892368","chr4","8921930","8922191","40","29843"
"chr6","8968858","8969188","chr4","8995432","8995765","24","26574"
"chr6","9042063","9042369","chr4","9080623","9080911","32","38560"
"chr6","9130955","9131187","chr4","9183979","9184205","20","53024"
"chr6","9269145","9269421","chr4","9320073","9320341","38","50928"
"chr6","9380876","9381148","chr4","9431126","9431385","31","50250"
"chr6","9392051","9392316","chr4","9442185","9442465","31","50134"
"chr6","9475905","9476174","chr4","9541876","9542150","21","65971"
"chr6","9686481","9686650","chr4","9742797","9742963","18","56316"
"chr6","9834870","9835151","chr3","36540292","36540572","63","26705422"
"chr6","9876783","9877070","chr4","9920389","9920679","18","43606"
"chr6","10052386","10052657","chr4","10082612","10082874","25","30226"
"chr6","10065665","10065948","chr4","10096980","10097288","40","31315"
"chr6","10119110","10119405","chr16","48456337","48456634","16","38337227"
"chr6","10192250","10192539","chr7","140588016","140588306","53","130395766"
"chr6","10224533","10224841","chrX","100630173","100630473","76","90405640"
"chr6","10229446","10229744","chr4","10252772","10253078","31","23326"
"chr6","10250884","10251001","chr16","72571018","72571135","13","62320134"
"chr6","10295198","10295516","chr4","10319955","10320257","44","24757"
"chr6","10305211","10305515","chr4","10328544","10328856","42","23333"
"chr6","10333696","10333981","chr4","10361384","10361672","26","27688"
"chr6","10368826","10369112","chr4","10396368","10396670","34","27542"
"chr6","10436734","10437030","chr4","10466850","10467138","29","30116"
"chr6","10466355","10466643","chr4","10498177","10498470","11","31822"
"chr6","10468087","10468452","chr11","116153623","116153945","115","105685536"
"chr6","10474573","10474871","chr4","10505453","10505751","26","30880"
"chr6","10482889","10483085","chr4","10513889","10514086","29","31000"
"chr6","10484399","10484675","chr5","111656789","111657070","68","101172390"
"chr6","10484709","10484923","chr4","10515955","10516179","25","31246"
"chr6","10493628","10493929","chr10","60861008","60861308","58","50367380"
"chr6","10554142","10554441","chr4","10590175","10590474","20","36033"
"chr6","10578980","10579266","chr4","10613679","10613973","24","34699"
"chr6","10579533","10579856","chr4","10614262","10614590","26","34729"
"chr6","10584473","10584644","chr4","10620248","10620428","24","35775"
"chr6","10648156","10648273","chr4","10699232","10699349","8","51076"
"chr6","10678778","10679067","chr14","69165770","69166057","55","58486992"
"chr6","10697301","10697419","chr13","100812951","100813068","17","90115650"
"chr6","10697452","10697620","chr20","9229716","9229878","41","1467736"
"chr6","10712011","10712312","chr4","10758695","10758989","22","46684"
"chr6","10726820","10727053","chr4","10775384","10775610","23","48564"
"chr6","10740782","10740949","chr4","10788509","10788676","6","47727"
"chr6","10740967","10741251","chr4","10788712","10788992","36","47745"
"chr6","10752786","10753069","chr4","10800314","10800612","64","47528"
"chr6","10763130","10763328","chr3","38954995","38955184","33","28191865"
"chr6","10766247","10766521","chr4","10826315","10826596","30","60068"
"chr6","10793842","10793973","chr4","10861295","10861422","8","67453"
"chr6","10801621","10801911","chr4","10869034","10869321","28","67413"
"chr6","10814387","10814594","chr4","10882577","10882779","27","68190"
"chr6","10834923","10835002","chr4","10902455","10902535","7","67532"
"chr6","10851469","10851766","chr4","10916373","10916670","26","64904"
"chr6","10863015","10863261","chr20","41332824","41333057","51","30469809"
"chr6","10877200","10877483","chr4","10947890","10948176","41","70690"
"chr6","10934322","10934536","chr4","11010867","11011085","16","76545"
"chr6","10946492","10946708","chr4","11022650","11022859","28","76158"
"chr6","10949364","10949651","chr4","11025542","11025822","24","76178"
"chr6","11016881","11017167","chr4","11098699","11098986","18","81818"
"chr6","11045784","11046014","chr4","11126497","11126725","22","80713"
"chr6","11074076","11074377","chr4","11154280","11154581","14","80204"
"chr6","11074779","11075065","chrX","65717613","65717893","54","54642834"
"chr6","11196432","11196638","chr10","26689716","26689920","49","15493284"
"chr6","11236494","11236626","chr7","137998780","137998910","22","126762286"
"chr6","11257727","11258029","chr4","11339018","11339298","44","81291"
"chr6","11289226","11289528","chr4","11371771","11372063","33","82545"
"chr6","11370770","11371044","chr4","11454724","11454998","14","83954"
"chr6","11385305","11385604","chr4","11471027","11471324","30","85722"
"chr6","11605186","11605350","chr6","175694658","175694821","45","164089472"
"chr6","11679884","11680188","chr4","11788981","11789267","34","109097"
"chr6","11701025","11701163","chr8","25776540","25776678","27","14075515"
"chr6","11751042","11751285","chr4","11862374","11862624","27","111332"
"chr6","11831762","11832068","chr4","11942065","11942387","40","110303"
"chr6","11915758","11916103","chr13","48472329","48472646","54","36556571"
"chr6","11942630","11942940","chr4","12052468","12052779","24","109838"
"chr6","12031655","12031970","chr4","12141630","12141918","47","109975"
"chr6","12060184","12060491","chr3","43652365","43652670","54","31592181"
"chr6","12094992","12095284","chr4","12207851","12208144","29","112859"
"chr6","12106559","12106905","chr4","12220669","12220964","69","114110"
"chr6","12303924","12304080","chr12","100722750","100722913","39","88418826"
"chr6","12304113","12304232","chr13","81607337","81607453","28","69303224"
"chr6","12328345","12328629","chr4","12358742","12359024","19","30397"
"chr6","12371405","12371540","chr8","71179092","71179225","18","58807687"
"chr6","12378484","12378605","chr4","12407494","12407616","12","29010"
"chr6","12397603","12397912","chr4","12420465","12420773","18","22862"
"chr6","12413958","12414078","chr20","29233168","29233288","22","16819210"
"chr6","12414106","12414263","chr6","158348950","158349107","27","145934844"
"chr6","12419789","12420085","chr12","3354245","3354541","49","9065544"
"chr6","12431783","12432106","chr2","105342245","105342550","72","92910462"
"chr6","12493178","12493490","chr4","12520142","12520459","51","26964"
"chr6","12509867","12510154","chr15","43687639","43687935","52","31177772"
"chr6","12518062","12518371","chr4","12541860","12542166","17","23798"
"chr6","12528049","12528359","chrX","16320386","16320684","63","3792337"
"chr6","12565547","12565827","chr4","12588031","12588311","22","22484"
"chr6","12681339","12681629","chr1","109633507","109633794","64","96952168"
"chr6","12738652","12738865","chr10","69775147","69775350","48","57036495"
"chr6","12743876","12744028","chr4","12774451","12774607","13","30575"
"chr6","12744350","12744479","chr4","12774928","12775066","24","30578"
"chr6","12776980","12777290","chr4","12801919","12802229","23","24939"
"chr6","12785432","12785719","chr4","12810375","12810668","34","24943"
"chr6","12795390","12795669","chr4","12820412","12820695","22","25022"
"chr6","12836540","12836857","chr4","12858414","12858725","29","21874"
"chr6","12881882","12882191","chr4","12899856","12900147","47","17974"
"chr6","12884589","12884930","chr15","68073888","68074208","89","55189299"
"chr6","12889571","12889894","chr4","12906904","12907210","65","17333"
"chr6","12903826","12904036","chr4","12921625","12921837","22","17799"
"chr6","12917688","12917794","chr4","12936097","12936202","6","18409"
"chr6","12927605","12927890","chr4","12946201","12946481","25","18596"
"chr6","12932150","12932459","chr4","12950704","12951018","56","18554"
"chr6","12941692","12941988","chr2","134217641","134217927","64","121275949"
"chr6","12943652","12943948","chr19","35633077","35633377","64","22689425"
"chr6","12948361","12948654","chr17","11251715","11252011","57","1696646"
"chr6","12949491","12949749","chr11","50418617","50418873","59","37469126"
"chr6","13002897","13003204","chr4","13026933","13027245","22","24036"
"chr6","13027246","13027551","chr4","13051636","13051974","51","24390"
"chr6","13034116","13034286","chr2","150423472","150423642","41","137389356"
"chr6","13044717","13045027","chr4","13069066","13069372","31","24349"
"chr6","13046319","13046641","chr4","13070640","13070949","41","24321"
"chr6","13060702","13060949","chr4","13085099","13085345","14","24397"
"chr6","13075214","13075519","chr4","13100439","13100745","28","25225"
"chr6","13119619","13119899","chr4","13144821","13145117","36","25202"
"chr6","13157400","13157704","chr4","13183388","13183688","36","25988"
"chr6","13164180","13164485","chr17","7032433","7032735","68","6131747"
"chr6","13235070","13235345","chr16","31429780","31430074","64","18194710"
"chr6","13258623","13258897","chr4","13287414","13287688","19","28791"
"chr6","13265976","13266281","chr3","127162429","127162726","59","113896453"
"chr6","13283552","13283844","chr4","13313268","13313556","41","29716"
"chr6","13321000","13321276","chr4","13333869","13334139","23","12869"
"chr6","13322371","13322597","chr4","13335218","13335444","16","12847"
"chr6","13343143","13343439","chr4","13356153","13356448","13","13010"
"chr6","13396223","13396481","chr4","13407447","13407700","26","11224"
"chr6","13412528","13412811","chr4","13424073","13424345","33","11545"
"chr6","13437668","13437873","chr8","92417384","92417591","53","78979716"
"chr6","13470494","13470740","chr4","13481555","13481830","43","11061"
"chr6","13483288","13483601","chr4","13495298","13495598","30","12010"
"chr6","13554000","13554270","chr4","13566924","13567200","31","12924"
"chr6","13570547","13570794","chr4","13585903","13586151","21","15356"
"chr6","13583507","13583817","chr6","94051083","94051399","59","80467576"
"chr6","13583870","13584041","chr4","13599371","13599535","13","15501"
"chr6","13584336","13584479","chr4","13599823","13599974","14","15487"
"chr6","13587098","13587373","chr4","13602602","13602877","19","15504"
"chr6","13610319","13610448","chr4","13627649","13627769","21","17330"
"chr6","13611714","13611876","chr4","13629108","13629270","8","17394"
"chr6","13612171","13612318","chr4","13629576","13629724","5","17405"
"chr6","13642074","13642383","chr4","13657717","13658024","13","15643"
"chr6","13649333","13649627","chr4","13665102","13665404","34","15769"
"chr6","13665812","13666092","chr4","13681799","13682071","25","15987"
"chr6","13697021","13697289","chr4","13713916","13714189","28","16895"
"chr6","13705997","13706294","chr4","13724857","13725153","44","18860"
"chr6","13708720","13708916","chr4","13727290","13727512","40","18570"
"chr6","13722568","13722731","chr6","149774815","149774965","40","136052247"
"chr6","13722768","13722891","chr16","24790183","24790306","17","11067415"
"chr6","13773243","13773505","chr4","13788641","13788905","15","15398"
"chr6","13782094","13782380","chr2","84913076","84913368","58","71130982"
"chr6","13809144","13809436","chr4","13868729","13868997","45","59585"
"chr6","13812723","13813016","chr4","13872148","13872443","22","59425"
"chr6","13826158","13826457","chr3","124003157","124003450","59","110176999"
"chr6","13904506","13904811","chr4","13968879","13969156","62","64373"
"chr6","13934005","13934275","chr4","13997036","13997291","34","63031"
"chr6","13934799","13935098","chr4","13997820","13998103","31","63021"
"chr6","13935153","13935270","chr4","13998167","13998284","3","63014"
"chr6","13993390","13993506","chr4","14059311","14059427","10","65921"
"chr6","13997790","13997905","chr4","14063555","14063661","13","65765"
"chr6","14003650","14003865","chr4","14069566","14069777","21","65916"
"chr6","14022186","14022496","chr4","14088177","14088483","27","65991"
"chr6","14031539","14031776","chr20","33668679","33668914","43","19637140"
"chr6","14034736","14035011","chr8","38766447","38766718","60","24731711"
"chr6","14072906","14073209","chr11","4124146","4124432","81","9948760"
"chr6","14097522","14097846","chr4","14160604","14160925","21","63082"
"chr6","14098906","14099193","chr3","78238853","78239153","72","64139947"
"chr6","14147104","14147385","chr4","14208536","14208824","28","61432"
"chr6","14169625","14169744","chr4","14229882","14230000","10","60257"
"chr6","14174218","14174342","chr4","14234468","14234592","12","60250"
"chr6","14276966","14277269","chr4","14337050","14337353","15","60084"
"chr6","14343522","14343827","chr4","14401643","14401959","33","58121"
"chr6","14357284","14357600","chr4","14414907","14415230","31","57623"
"chr6","14370407","14370692","chr4","14427956","14428242","19","57549"
"chr6","14400988","14401287","chr4","14455130","14455429","24","54142"
"chr6","14463641","14463922","chr4","14517994","14518275","19","54353"
"chr6","14530880","14531150","chr4","14579880","14580132","40","49000"
"chr6","14578491","14578809","chr4","14628939","14629257","54","50448"
"chr6","14647839","14648161","chr4","14699091","14699383","59","51252"
"chr6","14664157","14664417","chr4","14715817","14716081","17","51660"
"chr6","14666949","14667235","chr4","14718607","14718895","25","51658"
"chr6","14724206","14724497","chr4","14769980","14770277","35","45774"
"chr6","14827744","14828054","chr4","14868132","14868442","23","40388"
"chr6","14916747","14917039","chr3","124267629","124267922","49","109350882"
"chr6","14941280","14941561","chr4","14984359","14984656","58","43079"
"chr6","14944205","14944507","chr4","14987166","14987477","26","42961"
"chr6","14972375","14972519","chr7","2704009","2704157","29","12268366"
"chr6","14972545","14972661","chr1","148386664","148386780","16","133414119"
"chr6","14978949","14979125","chr7","127089124","127089289","52","112110175"
"chr6","14982814","14983106","chr4","15028218","15028502","23","45404"
"chr6","15029430","15029721","chr4","15075453","15075755","23","46023"
"chr6","15039377","15039539","chr4","15085348","15085526","28","45971"
"chr6","15050733","15051038","chr4","15096791","15097094","21","46058"
"chr6","15053351","15053531","chr4","15099445","15099622","19","46094"
"chr6","15078035","15078249","chr16","10949277","10949479","58","4128758"
"chr6","15080302","15080597","chr4","15126776","15127078","32","46474"
"chr6","15106988","15107097","chr4","15154963","15155072","6","47975"
"chr6","15126928","15127207","chr4","15174550","15174799","55","47622"
"chr6","15146646","15146936","chr4","15192582","15192862","38","45936"
"chr6","15154182","15154457","chr4","15200604","15200869","21","46422"
"chr6","15158154","15158453","chr4","15207613","15207904","29","49459"
"chr6","15177289","15177389","chr1","31679435","31679534","18","16502146"
"chr6","15185289","15185489","chr4","15238178","15238377","32","52889"
"chr6","15194967","15195251","chr9","8094577","8094848","70","7100390"
"chr6","15196261","15196395","chr4","15254542","15254665","19","58281"
"chr6","15196429","15196743","chr4","36484206","36484512","63","21287777"
"chr6","15200630","15200930","chr11","48283444","48283741","49","33082814"
"chr6","15219869","15220163","chr4","15283789","15284084","36","63920"
"chr6","15224102","15224405","chr4","15289639","15289942","25","65537"
"chr6","15249278","15249567","chr4","15316213","15316502","23","66935"
"chr6","15252168","15252479","chr4","15319339","15319645","23","67171"
"chr6","15300918","15301170","chr15","7709806","7710058","58","7591112"
"chr6","15311572","15311882","chr4","15378338","15378635","38","66766"
"chr6","15331177","15331301","chr3","32881354","32881478","18","17550177"
"chr6","15336053","15336334","chrX","30235373","30235651","59","14899320"
"chr6","15338814","15338948","chr4","15404975","15405129","35","66161"
"chr6","15352482","15352756","chr1","136405051","136405325","60","121052569"
"chr6","15360794","15361093","chr4","15424676","15424974","15","63882"
"chr6","15379611","15379880","chr4","15447770","15448054","27","68159"
"chr6","15379940","15380047","chr12","3097090","3097197","18","12282850"
"chr6","15395220","15395516","chr4","15463237","15463534","22","68017"
"chr6","15421721","15422024","chr2","83931327","83931616","65","68509606"
"chr6","15449606","15449816","chr19","46467689","46467901","42","31018083"
"chr6","15451847","15451996","chr19","11208319","11208465","33","4243528"
"chr6","15452283","15452423","chr4","15518316","15518456","4","66033"
"chr6","15453470","15453785","chr19","5342477","5342796","70","10110993"
"chr6","15456070","15456249","chr4","15521570","15521747","7","65500"
"chr6","15456546","15456670","chr4","15522384","15522504","13","65838"
"chr6","15489644","15489989","chr4","15557388","15557744","41","67744"
"chr6","15510793","15511085","chr3","127162429","127162726","66","111651636"
"chr6","15512514","15512813","chr4","15579232","15579531","21","66718"
"chr6","15608634","15608814","chr4","15678353","15678535","16","69719"
"chr6","15632938","15633128","chr11","116486356","116486535","48","100853418"
"chr6","15646615","15646926","chr4","15716412","15716717","28","69797"
"chr6","15668094","15668419","chr4","15736531","15736866","38","68437"
"chr6","15673788","15673950","chr4","15742559","15742731","26","68771"
"chr6","15683878","15684164","chr4","15754981","15755264","19","71103"
"chr6","15734435","15734694","chr4","15808582","15808814","47","74147"
"chr6","15747909","15748201","chr4","15822486","15822783","34","74577"
"chr6","15771354","15771469","chr4","15844745","15844860","7","73391"
"chr6","15785732","15786007","chr4","15858894","15859211","54","73162"
"chr6","15804422","15804716","chr4","15878840","15879135","18","74418"
"chr6","15825863","15825935","chr8","137088383","137088450","19","121262520"
"chr6","15875968","15876258","chr3","124267629","124267922","53","108391661"
"chr6","15879217","15879512","chr4","15958075","15958363","19","78858"
"chr6","15918822","15919134","chr4","15997777","15998088","24","78955"
"chr6","16002358","16002467","chr4","16076523","16076630","7","74165"
"chr6","16007682","16007956","chr1","191690399","191690678","53","175682717"
"chr6","16028969","16029275","chr4","16099718","16100027","22","70749"
"chr6","16071663","16071836","chr4","21593914","21594091","38","5522251"
"chr6","16071868","16071986","chr15","29268875","29268992","19","13197007"
"chr6","16078796","16079152","chr4","16148356","16148655","78","69560"
"chr6","16108784","16109081","chr4","16181695","16182000","31","72911"
"chr6","16126760","16127060","chr4","16207791","16208095","31","81031"
"chr6","16157681","16158004","chr16","41765989","41766294","73","25608308"
"chr6","16198120","16198405","chr4","16285466","16285743","29","87346"
"chr6","16218506","16218792","chr4","16305349","16305633","32","86843"
"chr6","16257121","16257408","chr3","13411522","13411814","53","2845599"
"chr6","16308239","16308552","chr9","22887796","22888110","64","6579557"
"chr6","16401411","16401698","chr4","16486579","16486878","60","85168"
"chr6","16431248","16431426","chr4","16552355","16552517","27","121107"
"chr6","16443407","16443672","chr4","16561320","16561590","21","117913"
"chr6","16485974","16486095","chr4","16604883","16605004","10","118909"
"chr6","16491270","16491386","chrX","40491044","40491160","15","23999774"
"chr6","16518605","16518899","chr4","16636270","16636560","30","117665"
"chr6","16529170","16529473","chr4","16646920","16647209","51","117750"
"chr6","16535841","16536153","chr4","16653572","16653895","23","117731"
"chr6","16544315","16544617","chr4","16661983","16662294","23","117668"
"chr6","16550197","16550313","chrX","41627824","41627940","15","25077627"
"chr6","16570489","16570791","chr4","16687964","16688252","34","117475"
"chr6","16591274","16591432","chr10","83673575","83673740","31","67082301"
"chr6","16591465","16591587","chr15","46151444","46151568","14","29559979"
"chr6","16612936","16613159","chrX","51567105","51567331","46","34954169"
"chr6","16620914","16621115","chr4","16740447","16740653","19","119533"
"chr6","16636604","16636904","chr4","16756682","16756985","24","120078"
"chr6","16667094","16667224","chr4","16785572","16785702","9","118478"
"chr6","16690297","16690410","chr4","16808966","16809075","10","118669"
"chr6","16742786","16742909","chr13","95288408","95288530","14","78545622"
"chr6","16777843","16778142","chr4","16896238","16896551","34","118395"
"chr6","16791107","16791390","chr4","16909484","16909764","25","118377"
"chr6","16804332","16804646","chr4","16922885","16923199","29","118553"
"chr6","16810055","16810216","chr4","16928667","16928834","22","118612"
"chr6","16810492","16810630","chr4","16929132","16929268","12","118640"
"chr6","16815476","16815775","chr4","16934003","16934302","22","118527"
"chr6","16824042","16824348","chr4","16944971","16945284","20","120929"
"chr6","16825312","16825635","chr4","16946254","16946550","39","120942"
"chr6","16829864","16830155","chr4","16951096","16951393","26","121232"
"chr6","16832332","16832650","chr4","16953276","16953568","49","120944"
"chr6","16863554","16863844","chr4","16984570","16984868","27","121016"
"chr6","16912696","16912897","chr11","25723384","25723583","47","8810688"
"chr6","16938225","16938527","chr4","17058013","17058295","38","119788"
"chr6","16950028","16950331","chr4","17070258","17070556","21","120230"
"chr6","16996295","16996479","chr4","17116262","17116429","43","119967"
"chr6","16996791","16996921","chr4","17116744","17116874","8","119953"
"chr6","17031098","17031389","chr7","166454192","166454486","57","149423094"
"chr6","17045067","17045369","chr4","17166179","17166455","39","121112"
"chr6","17086931","17087211","chr4","17209355","17209628","24","122424"
"chr6","17111820","17112097","chr4","17228629","17228902","18","116809"
"chr6","17231197","17231464","chr3","39023062","39023328","68","21791865"
"chr6","17255386","17255673","chr11","131260074","131260355","48","114004688"
"chr6","17301705","17301981","chr4","17416669","17416956","30","114964"
"chr6","17343799","17343930","chr9","28772222","28772353","27","11428423"
"chr6","17377570","17377855","chr4","17492766","17493059","25","115196"
"chr6","17382418","17382543","chr4","17497567","17497692","5","115149"
"chr6","17387276","17387591","chr4","17502579","17502908","33","115303"
"chr6","17414459","17414624","chr3","13731495","13731662","30","3682964"
"chr6","17414938","17415072","chr10","8237746","8237873","23","9177192"
"chr6","17429309","17429622","chr4","17539391","17539702","19","110082"
"chr6","17448267","17448577","chr4","17558745","17559048","37","110478"
"chr6","17458658","17458958","chr4","17569963","17570261","11","111305"
"chr6","17460092","17460204","chr4","17571310","17571412","15","111218"
"chr6","17473166","17473457","chr4","17588063","17588357","22","114897"
"chr6","17531318","17531594","chr4","17651017","17651292","24","119699"
"chr6","17548523","17548786","chr4","17718583","17718819","43","170060"
"chr6","17563353","17563535","chr19","28356007","28356185","39","10792654"
"chr6","17564423","17564716","chr4","17735448","17735746","38","171025"
"chr6","17567955","17568225","chr4","17739361","17739648","36","171406"
"chr6","17597778","17598083","chr4","17795714","17795988","61","197936"
"chr6","17621489","17621657","chr5","173468103","173468270","34","155846614"
"chr6","17630905","17631203","chr4","17831638","17831942","30","200733"
"chr6","17655475","17655592","chr4","17855388","17855504","7","199913"
"chr6","17655885","17656137","chr4","17856108","17856362","16","200223"
"chr6","17659894","17659983","chr14","10500954","10501039","21","7158940"
"chr6","17700285","17700537","chr1","125879776","125880027","60","108179491"
"chr6","17718172","17718497","chr4","17919068","17919387","32","200896"
"chr6","17724398","17724700","chr4","17925503","17925807","23","201105"
"chr6","17742385","17742649","chr4","17944803","17945069","11","202418"
"chr6","17750705","17750971","chr4","17952050","17952329","37","201345"
"chr6","17801384","17801679","chr4","18000907","18001211","24","199523"
"chr6","17851345","17851624","chr4","18049902","18050161","39","198557"
"chr6","17855877","17856173","chr4","18054524","18054821","29","198647"
"chr6","17858791","17858921","chr4","18057477","18057607","6","198686"
"chr6","17859219","17859394","chr4","18057919","18058092","22","198700"
"chr6","17861623","17861910","chr4","18060317","18060593","22","198694"
"chr6","17862396","17862650","chr1","221596168","221596410","63","203733772"
"chr6","17873849","17874126","chr4","18072268","18072549","32","198419"
"chr6","17876290","17876556","chr11","120713751","120714015","73","102837461"
"chr6","17882852","17883151","chr9","98661850","98662144","52","80778998"
"chr6","17889191","17889483","chr4","18087753","18088038","15","198562"
"chr6","17892443","17892640","chr4","18092580","18092777","11","200137"
"chr6","17921410","17921712","chr4","18124661","18124965","20","203251"
"chr6","17928736","17928990","chr4","18130906","18131150","25","202170"
"chr6","17929938","17930222","chr1","191690399","191690678","45","173760461"
"chr6","17935707","17935850","chr4","18138489","18138623","24","202782"
"chr6","17978302","17978523","chr4","18169857","18170088","30","191555"
"chr6","17981754","17981830","chr4","18173870","18173946","3","192116"
"chr6","17987305","17987593","chr4","18180317","18180603","40","193012"
"chr6","17989835","17990141","chr4","18182803","18183106","38","192968"
"chr6","17991410","17991635","chr4","18184632","18184863","19","193222"
"chr6","17993063","17993344","chr4","18186272","18186580","39","193209"
"chr6","17995817","17996114","chr4","18189029","18189317","28","193212"
"chr6","18002982","18003277","chr15","34234250","34234544","59","16231268"
"chr6","18008123","18008286","chr19","50717889","50718050","31","32709766"
"chr6","18008591","18008666","chr19","32035662","32035735","19","14027071"
"chr6","18011243","18011559","chr4","18205267","18205579","29","194024"
"chr6","18015276","18015408","chr4","114936919","114937049","16","96921643"
"chr6","18026572","18026693","chr4","157306373","157306498","17","139279801"
"chr6","18032809","18033110","chr4","18226081","18226400","36","193272"
"chr6","18047346","18047640","chr15","43687639","43687935","49","25640293"
"chr6","18051750","18051877","chr19","40007059","40007188","22","21955309"
"chr6","18055239","18055362","chr4","18249022","18249145","10","193783"
"chr6","18060656","18060918","chr4","18254729","18254989","20","194073"
"chr6","18069410","18069692","chr4","18263425","18263709","20","194015"
"chr6","18084790","18085095","chr4","18280063","18280371","23","195273"
"chr6","18095568","18095734","chr1","183849921","183850089","35","165754353"
"chr6","18095760","18095905","chrX","44637418","44637555","25","26541658"
"chr6","18096456","18096717","chr4","18291688","18291957","28","195232"
"chr6","18103638","18103931","chr4","18298988","18299281","11","195350"
"chr6","18113121","18113416","chr4","18308168","18308465","19","195047"
"chr6","18133690","18133839","chr4","156301284","156301430","38","138167594"
"chr6","18134132","18134273","chr11","122202942","122203078","30","104068810"
"chr6","18142126","18142172","chr5","84348962","84349008","14","66206836"
"chr6","18142484","18142628","chr4","3009835","3009974","23","15132649"
"chr6","18158390","18158702","chr4","18357570","18357855","51","199180"
"chr6","18200840","18200954","chr4","18400293","18400406","8","199453"
"chr6","18209392","18209658","chr3","42360413","42360669","54","24151021"
"chr6","18214100","18214266","chr4","18410524","18410685","20","196424"
"chr6","18215067","18215366","chr4","18411525","18411822","21","196458"
"chr6","18223130","18223421","chr9","32319127","32319417","70","14095997"
"chr6","18234115","18234408","chr4","18428436","18428730","34","194321"
"chr6","18239454","18239598","chr4","18434865","18435013","18","195411"
"chr6","18251476","18251739","chr4","18448870","18449169","55","197394"
"chr6","18265830","18265877","chr4","18462466","18462519","11","196636"
"chr6","18266231","18266360","chr14","15705786","15705903","27","2560445"
"chr6","18308850","18309133","chr4","18506088","18506361","27","197238"
"chr6","18316378","18316625","chr4","18514959","18515237","40","198581"
"chr6","18323662","18323944","chr4","18522252","18522544","23","198590"
"chr6","18327823","18328094","chr4","18525744","18526014","18","197921"
"chr6","18351150","18351429","chr4","18548625","18548891","30","197475"
"chr6","18351519","18351676","chr4","18548987","18549144","10","197468"
"chr6","18353850","18354071","chr4","18551314","18551535","12","197464"
"chr6","18366824","18367149","chr4","18564300","18564600","48","197476"
"chr6","18368033","18368319","chr4","18565498","18565787","21","197465"
"chr6","18377872","18377996","chr2","165531071","165531193","17","147153199"
"chr6","18379499","18379754","chr4","1743024","1743290","59","16636475"
"chr6","18384531","18384823","chr4","18578785","18579097","42","194254"
"chr6","18403849","18404135","chr2","102426463","102426750","64","84022614"
"chr6","18412050","18412360","chr4","18606401","18606694","34","194351"
"chr6","18412429","18412718","chr4","18606756","18607056","38","194327"
"chr6","18419829","18420128","chr4","18625089","18625378","45","205260"
"chr6","18437344","18437467","chr2","44878801","44878925","17","26441457"
"chr6","18442331","18442452","chr4","18644059","18644180","8","201728"
"chr6","18445453","18445634","chr4","18647200","18647379","9","201747"
"chr6","18453847","18454152","chr4","18656257","18656562","30","202410"
"chr6","18455341","18455611","chr4","18657763","18658033","12","202422"
"chr6","18475758","18476025","chr4","18678681","18678943","25","202923"
"chr6","18495618","18495938","chr4","18700021","18700331","37","204403"
"chr6","18496423","18496547","chr4","18700855","18700979","8","204432"
"chr6","18501004","18501261","chr1","5819632","5819900","59","12681372"
"chr6","18502906","18503155","chr4","18705449","18705700","27","202543"
"chr6","18506429","18506721","chr4","18708639","18708942","25","202210"
"chr6","18522376","18522682","chr4","18725096","18725402","21","202720"
"chr6","18528882","18529111","chr4","18731572","18731793","27","202690"
"chr6","18537050","18537252","chr4","18740074","18740282","15","203024"
"chr6","18550054","18550321","chr4","18754303","18754591","42","204249"
"chr6","18552133","18552418","chr4","18756395","18756680","15","204262"
"chr6","18575169","18575467","chr4","18777977","18778277","27","202808"
"chr6","18576167","18576491","chr4","36332518","36332829","74","17756351"
"chr6","18577059","18577304","chr4","18778622","18778871","14","201563"
"chr6","18628911","18629208","chr8","53907597","53907887","54","35278686"
"chr6","18630463","18630776","chr4","18830694","18831025","34","200231"
"chr6","18637137","18637429","chr4","18837022","18837327","28","199885"
"chr6","18698449","18698679","chr20","27667647","27667870","52","8969198"
"chr6","18759395","18759693","chr4","18967713","18968021","25","208318"
"chr6","18759826","18760090","chr4","18968151","18968415","31","208325"
"chr6","18769053","18769167","chr4","18980879","18980993","8","211826"
"chr6","18769235","18769410","chr4","18981038","18981218","18","211803"
"chr6","18910552","18910805","chr4","19129698","19129951","16","219146"
"chr6","18939408","18939695","chr4","19154114","19154403","17","214706"
"chr6","18995339","18995624","chr4","19204888","19205173","17","209549"
"chr6","19014879","19015163","chr4","19224391","19224685","32","209512"
"chr6","19017439","19017649","chr4","19226967","19227178","13","209528"
"chr6","19110834","19111092","chr3","180242810","180243067","59","161131976"
"chr6","19220175","19220474","chr4","19436761","19437064","15","216586"
"chr6","19253387","19253510","chr5","150516607","150516733","24","131263220"
"chr6","19257003","19257314","chr4","19474086","19474393","36","217083"
"chr6","19285230","19285511","chr4","19502739","19503059","60","217509"
"chr6","19289630","19289812","chr16","71336101","71336263","47","52046471"
"chr6","19289842","19289958","chr7","41223626","41223741","19","21933784"
"chr6","19292122","19292378","chr1","12413004","12413263","63","6879118"
"chr6","19380064","19380374","chr4","19594185","19594468","38","214121"
"chr6","19615691","19615994","chr4","19824338","19824622","40","208647"
"chr6","19738370","19738665","chr2","72923747","72924047","60","53185377"
"chr6","19812990","19813102","chr4","20019096","20019213","15","206106"
"chr6","19865488","19865770","chrX","131593064","131593345","49","111727576"
"chr6","19932490","19932799","chr4","20132455","20132719","58","199965"
"chr6","19956263","19956558","chr4","20156508","20156805","37","200245"
"chr6","19976603","19976876","chr4","20178398","20178669","33","201795"
"chr6","20028184","20028494","chr4","20229548","20229866","30","201364"
"chr6","20105591","20105893","chr4","20306448","20306745","24","200857"
"chr6","20198081","20198372","chr4","20403205","20403513","39","205124"
"chr6","20222685","20222974","chr4","20425798","20426101","36","203113"
"chr6","20229139","20229445","chr4","20432202","20432505","23","203063"
"chr6","20236460","20236762","chr4","20439620","20439901","48","203160"
"chr6","20284732","20285005","chr4","20487641","20487938","48","202909"
"chr6","20314261","20314594","chr4","20517123","20517422","50","202862"
"chr6","20341357","20341665","chr4","20546040","20546311","57","204683"
"chr6","20350429","20350560","chr4","12603325","12603455","22","7747104"
"chr6","20350658","20350949","chr4","20555307","20555599","37","204649"
"chr6","20359674","20359956","chr3","123351694","123351976","56","102992020"
"chr6","20360618","20360885","chrX","134994896","134995166","58","114634278"
"chr6","20379239","20379541","chr4","20582693","20582996","13","203454"
"chr6","20390002","20390100","chr9","60206806","60206906","24","39816804"
"chr6","20395918","20396088","chr4","13629108","13629270","37","6766810"
"chr6","20397732","20398017","chr4","20603128","20603421","25","205396"
"chr6","20398549","20398721","chr4","20603949","20604112","19","205400"
"chr6","20399818","20400123","chr4","20605870","20606185","34","206052"
"chr6","20405197","20405372","chr4","58130431","58130605","48","37725234"
"chr6","20405447","20405601","chr6","125857818","125857973","29","105452371"
"chr6","20425848","20426142","chr4","20630431","20630726","23","204583"
"chr6","20431206","20431329","chr4","20635995","20636118","8","204789"
"chr6","20435969","20436279","chr16","60539735","60540048","65","40103766"
"chr6","20462977","20463271","chr3","42646508","42646797","65","22183531"
"chr6","20478591","20478893","chr4","20679508","20679811","31","200917"
"chr6","20498768","20498897","chr4","20696111","20696240","17","197343"
"chr6","20498906","20499186","chr4","20696249","20696555","55","197343"
"chr6","20503320","20503427","chr4","20700969","20701076","5","197649"
"chr6","20523495","20523783","chr4","20721461","20721744","29","197966"
"chr6","20539489","20539800","chr4","20736906","20737213","32","197417"
"chr6","20543774","20543907","chr7","41811868","41811992","25","21268094"
"chr6","20544211","20544364","chr18","53524035","53524190","33","32979824"
"chr6","20563620","20563936","chr4","20755841","20756136","50","192221"
"chr6","20566816","20566939","chr4","20759005","20759128","7","192189"
"chr6","20609060","20609356","chr4","20805732","20806028","14","196672"
"chr6","20611751","20612046","chr10","29106667","29106964","60","8494916"
"chr6","20635026","20635371","chr20","18335389","18335705","99","2299637"
"chr6","20635416","20635539","chr4","20831133","20831256","5","195717"
"chr6","20644496","20644774","chr4","20840264","20840545","23","195768"
"chr6","20649230","20649349","chr4","20844964","20845082","10","195734"
"chr6","20661767","20662042","chr4","20857444","20857720","16","195677"
"chr6","20667086","20667382","chr4","20862780","20863074","35","195694"
"chr6","20682532","20682728","chr1","34916004","34916198","48","14233472"
"chr6","20687427","20687709","chr4","20882587","20882869","18","195160"
"chr6","20698121","20698325","chr4","20893978","20894184","12","195857"
"chr6","20700008","20700297","chr4","20895857","20896150","40","195849"
"chr6","20701049","20701332","chr4","20897652","20897933","31","196603"
"chr6","20738259","20738411","chr9","72272836","72272988","28","51534577"
"chr6","20738707","20738849","chr6","122098582","122098725","26","101359875"
"chr6","20757959","20758260","chr4","20956325","20956625","13","198366"
"chr6","20781448","20781523","chr4","20979517","20979592","5","198069"
"chr6","20828934","20829245","chr4","21032685","21033002","26","203751"
"chr6","20848982","20849295","chr4","21054864","21055173","19","205882"
"chr6","20884454","20884666","chr4","21091299","21091534","33","206845"
"chr6","20924463","20924816","chr20","12336086","12336398","112","8588377"
"chr6","20934664","20934960","chr4","21138545","21138837","39","203881"
"chr6","20952810","20953115","chr4","21157567","21157874","21","204757"
"chr6","20965337","20965466","chr3","36373230","36373353","18","15407893"
"chr6","21007704","21007928","chr4","21212658","21212865","31","204954"
"chr6","21024023","21024329","chr4","21228811","21229115","24","204788"
"chr6","21025730","21026002","chr19","41804540","41804820","57","20778810"
"chr6","21062722","21062906","chr3","38240090","38240274","38","17177368"
"chr6","21090400","21090694","chr4","21292765","21293064","23","202365"
"chr6","21141322","21141599","chr4","21343397","21343686","31","202075"
"chr6","21151026","21151337","chr16","31792687","31793003","60","10641661"
"chr6","21164055","21164357","chr14","69158704","69158997","59","47994649"
"chr6","21168455","21168756","chr7","45639425","45639731","59","24470970"
"chr6","21228135","21228450","chr4","21429769","21430090","40","201634"
"chr6","21228510","21228637","chr4","21430155","21430281","12","201645"
"chr6","21242400","21242698","chr9","60942413","60942712","52","39700013"
"chr6","21269218","21269529","chr4","21469051","21469360","30","199833"
"chr6","21288768","21288896","chr15","46151444","46151568","21","24862676"
"chr6","21289171","21289364","chr4","21488736","21488930","15","199565"
"chr6","21314773","21315074","chr19","35633077","35633377","61","14318304"
"chr6","21320964","21321173","chr4","21521960","21522165","17","200996"
"chr6","21337877","21338195","chr6","35639100","35639400","75","14301223"
"chr6","21347687","21347994","chr4","21549627","21549934","26","201940"
"chr6","21349004","21349321","chr4","21550962","21551280","25","201958"
"chr6","21367669","21367969","chr4","21569924","21570226","49","202255"
"chr6","21377814","21377985","chr18","9795354","9795521","34","11582460"
"chr6","21378295","21378396","chr4","21580651","21580752","7","202356"
"chr6","21381799","21382077","chr4","21583849","21584140","35","202050"
"chr6","21386316","21386622","chr4","21588393","21588697","18","202077"
"chr6","21391858","21392030","chr4","21593914","21594091","16","202056"
"chr6","21392343","21392467","chr4","21594388","21594511","9","202045"
"chr6","21406522","21406835","chr4","21608604","21608882","54","202082"
"chr6","21487862","21488173","chr3","155755051","155755351","74","134267189"
"chr6","21523596","21523901","chr4","21728590","21728897","22","204994"
"chr6","21550197","21550478","chr4","21751585","21751864","17","201388"
"chr6","21623942","21624230","chr4","21824617","21824904","34","200675"
"chr6","21663627","21663722","chr4","21863828","21863923","5","200201"
"chr6","21679758","21680071","chr4","21881025","21881340","27","201267"
"chr6","21680267","21680493","chr4","26130678","26130915","49","4450411"
"chr6","21682652","21682949","chr4","21883921","21884216","22","201269"
"chr6","21687676","21687951","chr4","21889577","21889858","34","201901"
"chr6","21723688","21723892","chr12","58010404","58010590","59","36286716"
"chr6","21725675","21725777","chr9","32334641","32334745","23","10608966"
"chr6","21793774","21794083","chr4","17925503","17925807","67","3868271"
"chr6","21796578","21796882","chr3","36458013","36458312","51","14661435"
"chr6","21850739","21850878","chr4","22093435","22093574","5","242696"
"chr6","21853623","21853942","chr4","22095958","22096280","22","242335"
"chr6","21947132","21947240","chr4","22189467","22189578","9","242335"
"chr6","21963584","21963885","chr4","22206709","22207011","21","243125"
"chr6","21965252","21965573","chr4","22208289","22208592","46","243037"
"chr6","21967257","21967551","chr1","136549718","136550007","66","114582461"
"chr6","21979948","21980079","chr20","33815177","33815312","24","11835229"
"chr6","21980389","21980596","chr10","72645899","72646114","49","50665510"
"chr6","21999551","21999842","chr1","135785522","135785813","53","113785971"
"chr6","22007432","22007752","chr4","22250876","22251192","29","243444"
"chr6","22017737","22017964","chr4","22261793","22262028","21","244056"
"chr6","22022763","22023052","chr4","22266860","22267133","49","244097"
"chr6","22026293","22026458","chr6","120560577","120560745","35","98534284"
"chr6","22065442","22065740","chr4","22315401","22315697","27","249959"
"chr6","22088578","22088850","chr7","41627655","41627925","63","19539077"
"chr6","22099874","22100183","chr4","22355483","22355775","38","255609"
"chr6","22103682","22103958","chr4","22359200","22359469","32","255518"
"chr6","22115589","22115868","chr4","22372174","22372453","26","256585"
"chr6","22123933","22124220","chr15","26577968","26578254","60","4454035"
"chr6","22137524","22137832","chr11","48401419","48401716","69","26263895"
"chr6","22169428","22169738","chr18","8963391","8963701","59","13206037"
"chr6","22185745","22186044","chr4","22439431","22439726","27","253686"
"chr6","22187543","22187844","chr4","22441221","22441531","27","253678"
"chr6","22188851","22189058","chr4","22442551","22442759","14","253700"
"chr6","22196465","22196757","chr4","22450221","22450527","40","253756"
"chr6","22227613","22227929","chr4","22481981","22482279","42","254368"
"chr6","22259817","22260131","chr4","22514973","22515291","38","255156"
"chr6","22376794","22377093","chr1","67019962","67020252","77","44643168"
"chr6","22482052","22482358","chr3","123903117","123903425","69","101421065"
"chr6","22604053","22604183","chr4","22850490","22850616","12","246437"
"chr6","22647426","22647712","chr4","22892669","22892951","27","245243"
"chr6","22719318","22719609","chr4","22964133","22964412","31","244815"
"chr6","22765898","22766189","chr4","23010652","23010946","26","244754"
"chr6","22887667","22887952","chr4","23145242","23145527","28","257575"
"chr6","22906001","22906299","chr19","45495569","45495860","60","22589568"
"chr6","22987377","22987557","chr2","50498150","50498324","40","27510773"
"chr6","22987858","22987993","chr1","19463202","19463334","25","3524656"
"chr6","23183350","23183641","chr4","23454254","23454543","18","270904"
"chr6","23199100","23199370","chr4","23479069","23479339","12","279969"
"chr6","23542022","23542355","chr12","114200366","114200702","79","90658344"
"chr6","23772109","23772393","chr4","24106219","24106476","44","334110"
"chr6","23967446","23967746","chr3","124267629","124267922","63","100300183"
"chr6","24032266","24032400","chr9","22648313","22648444","28","1383953"
"chr6","24131648","24131950","chr4","24478317","24478605","44","346669"
"chr6","24156236","24156510","chr4","24500314","24500600","34","344078"
"chr6","24308987","24309199","chr4","24641070","24641284","28","332083"
"chr6","24338955","24339248","chr15","29472469","29472762","64","5133514"
"chr6","24392921","24393232","chr4","24730882","24731191","31","337961"
"chr6","24438493","24438782","chr10","6682930","6683225","63","17755563"
"chr6","24441906","24442197","chr4","24823813","24824106","18","381907"
"chr6","24476131","24476463","chr4","24857029","24857364","24","380898"
"chr6","24486645","24486955","chr4","24868124","24868422","28","381479"
"chr6","24520344","24520708","chr4","24901875","24902229","44","381531"
"chr6","24544304","24544598","chrX","15099734","15100040","63","9444570"
"chr6","24556183","24556471","chr4","24936749","24937055","37","380566"
"chr6","24566728","24566859","chr4","24945912","24946029","23","379184"
"chr6","24604906","24605051","chr8","21621594","21621739","25","2983312"
"chr6","24605356","24605492","chr4","36461417","36461550","18","11856061"
"chr6","24608865","24609112","chr4","127794161","127794374","80","103185296"
"chr6","24610909","24611031","chr4","24986214","24986339","14","375305"
"chr6","24624727","24625027","chr2","195639631","195639930","56","171014904"
"chr6","24633202","24633470","chr4","25009650","25009923","29","376448"
"chr6","24639444","24639773","chr4","25015903","25016200","47","376459"
"chr6","24669536","24669718","chrX","10693698","10693868","37","13975838"
"chr6","24670019","24670165","chr15","39583219","39583360","35","14913200"
"chr6","24691428","24691549","chr4","25053510","25053627","7","362082"
"chr6","24691831","24692004","chr4","25054261","25054417","24","362430"
"chr6","24707031","24707244","chr4","25069853","25070048","33","362822"
"chr6","24725977","24726234","chr4","25089113","25089369","21","363136"
"chr6","24736990","24737121","chr4","25099847","25099971","15","362857"
"chr6","24737188","24737487","chr4","25100040","25100340","22","362852"
"chr6","24761453","24761749","chr4","25124933","25125229","15","363480"
"chr6","24764021","24764103","chr10","72452712","72452785","27","47688691"
"chr6","24787708","24787997","chr4","25151660","25151958","28","363952"
"chr6","24810902","24811165","chr4","25177504","25177756","28","366602"
"chr6","24817513","24817739","chr1","23942951","23943176","42","874562"
"chr6","24854914","24855186","chr1","51707788","51708061","55","26852874"
"chr6","24858406","24858699","chr4","25221043","25221338","22","362637"
"chr6","24862816","24863069","chr4","25225475","25225729","20","362659"
"chr6","24868622","24868726","chr4","25231778","25231881","7","363156"
"chr6","24873112","24873375","chr4","25236294","25236558","55","363182"
"chr6","24878530","24878811","chr4","25241701","25241979","16","363171"
"chr6","24880892","24881188","chr4","25244376","25244682","26","363484"
"chr6","24904127","24904406","chr4","25151660","25151958","56","247533"
"chr6","24914640","24914754","chr11","48300483","48300599","25","23385843"
"chr6","24917173","24917507","chr4","25280404","25280739","20","363231"
"chr6","24929816","24930113","chr4","25293871","25294168","19","364055"
"chr6","24939184","24939498","chr4","25301830","25302097","64","362646"
"chr6","24947669","24947957","chr4","25315986","25316276","21","368317"
"chr6","24956516","24956779","chr4","25324770","25325066","52","368254"
"chr6","24963318","24963432","chr3","1838435","1838551","14","23124883"
"chr6","24969517","24969800","chr4","25341104","25341387","15","371587"
"chr6","24971823","24972120","chr4","25343423","25343734","31","371600"
"chr6","24975078","24975394","chr4","25346691","25346997","31","371613"
"chr6","24979045","24979277","chr4","25353285","25353461","67","374240"
"chr6","25002859","25003145","chr4","25372361","25372650","27","369502"
"chr6","25018687","25018980","chr5","51350304","51350607","63","26331617"
"chr6","25035304","25035444","chr4","25405890","25406024","15","370586"
"chr6","25036960","25037334","chr4","25407548","25407922","52","370588"
"chr6","25053584","25053879","chr4","25424556","25424849","19","370972"
"chr6","25092766","25093057","chr4","25521621","25521904","26","428855"
"chr6","25166330","25166627","chr4","25599002","25599299","21","432672"
"chr6","25195740","25196031","chr4","25630901","25631158","45","435161"
"chr6","25205636","25205923","chr4","25640764","25641042","32","435128"
"chr6","25238608","25238691","chr4","25675653","25675736","4","437045"
"chr6","25242506","25242785","chr9","22449965","22450238","72","2792541"
"chr6","25307563","25307700","chr4","25744316","25744468","25","436753"
"chr6","25307996","25308184","chr4","25744765","25744935","31","436769"
"chr6","25351506","25351798","chr4","25775496","25775802","39","423990"
"chr6","25409545","25409670","chr4","157306373","157306498","21","131896828"
"chr6","25410653","25410959","chr14","63858277","63858583","61","38447624"
"chr6","25411045","25411244","chr3","170242210","170242417","48","144831165"
"chr6","25414878","25415189","chr4","25834054","25834368","34","419176"
"chr6","25428441","25428619","chr4","25846836","25846984","37","418395"
"chr6","25429509","25429793","chr4","25847869","25848159","26","418360"
"chr6","25434562","25434850","chr4","25853575","25853863","19","419013"
"chr6","25452680","25452986","chr4","25871937","25872262","42","419257"
"chr6","25479298","25479588","chr4","25899093","25899378","26","419795"
"chr6","25479718","25480009","chr4","25899507","25899813","37","419789"
"chr6","25485304","25485583","chr4","25905987","25906271","24","420683"
"chr6","25516153","25516463","chr4","25936964","25937266","43","420811"
"chr6","25517365","25517682","chr4","25938161","25938491","29","420796"
"chr6","25550324","25550631","chr4","25971964","25972252","51","421640"
"chr6","25551962","25552256","chr4","25973586","25973882","18","421624"
"chr6","25555158","25555388","chr16","12815462","12815681","67","12739696"
"chr6","25573828","25574108","chr4","25996309","25996591","22","422481"
"chr6","25602622","25602822","chr4","26024801","26024989","24","422179"
"chr6","25638866","25639080","chr4","26058383","26058618","33","419517"
"chr6","25675604","25675912","chr5","185678151","185678451","56","160002547"
"chr6","25683793","25684060","chr4","26106646","26106914","20","422853"
"chr6","25687464","25687762","chr4","26109995","26110289","26","422531"
"chr6","25707144","25707403","chr4","26130678","26130915","33","423534"
"chr6","25744705","25745022","chr4","26169162","26169473","26","424457"
"chr6","25764608","25764907","chr4","26188115","26188405","41","423507"
"chr6","25776793","25777078","chr4","26200598","26200881","18","423805"
"chr6","25886092","25886373","chr6","102289396","102289671","95","76403304"
"chr6","26324323","26324590","chr4","26425612","26425879","15","101289"
"chr6","26347846","26348152","chr4","26447569","26447873","32","99723"
"chr6","26393229","26393523","chr4","26484377","26484690","38","91148"
"chr6","26428782","26429047","chrX","97266338","97266600","74","70837556"
"chr6","26432171","26432483","chr4","26522979","26523274","44","90808"
"chr6","26459007","26459293","chr4","26553676","26553965","22","94669"
"chr6","26467739","26468026","chr4","26562273","26562582","48","94534"
"chr6","26469611","26469767","chr4","26564104","26564250","21","94493"
"chr6","26506839","26507106","chr4","26600213","26600483","24","93374"
"chr6","26554133","26554258","chr13","68498721","68498844","19","41944588"
"chr6","26554758","26554922","chr10","24896367","24896525","38","1658391"
"chr6","26563170","26563448","chr4","26655882","26656160","25","92712"
"chr6","26592282","26592560","chr4","26685219","26685499","32","92937"
"chr6","26602018","26602229","chr4","26693676","26693893","18","91658"
"chr6","26603169","26603454","chr4","26694856","26695145","21","91687"
"chr6","26710646","26710884","chr2","45774273","45774509","77","19063627"
"chr6","26747032","26747111","chr4","26831940","26832022","9","84908"
"chr6","26755602","26755784","chr4","26840111","26840294","5","84509"
"chr6","26757333","26757661","chr4","26842150","26842477","32","84817"
"chr6","26768875","26769092","chr4","26854491","26854723","21","85616"
"chr6","26796023","26796294","chr7","92752384","92752673","59","65956361"
"chr6","26802310","26802468","chr4","26885068","26885231","15","82758"
"chr6","26808118","26808202","chr13","97120069","97120146","16","70311951"
"chr6","26817589","26817858","chr4","26898878","26899144","22","81289"
"chr6","26838984","26839269","chr4","26925731","26926002","36","86747"
"chr6","26851920","26852043","chr4","26946386","26946509","13","94466"
"chr6","26874867","26875174","chr4","26995380","26995689","30","120513"
"chr6","26916116","26916315","chr5","126644167","126644368","49","99728051"
"chr6","26977418","26977641","chr4","27114666","27114890","13","137248"
"chr6","26995146","26995411","chr4","27133366","27133630","15","138220"
"chr6","27010010","27010192","chr6","60308516","60308718","60","33298506"
"chr6","27019202","27019492","chr4","27158448","27158745","22","139246"
"chr6","27020168","27020394","chr4","27159420","27159651","18","139252"
"chr6","27048500","27048811","chr4","27191661","27191993","41","143161"
"chr6","27054160","27054419","chr3","77411224","77411434","81","50357064"
"chr6","27091014","27091303","chr4","27230513","27230786","29","139499"
"chr6","27095270","27095404","chr9","8054611","8054743","22","19040659"
"chr6","27109612","27109919","chr4","27246093","27246392","18","136481"
"chr6","27121880","27122161","chr2","168590623","168590911","64","141468743"
"chr6","27550532","27550670","chr3","43335006","43335143","22","15784474"
"chr6","27563218","27563543","chr4","27473201","27473514","33","90017"
"chr6","27612553","27612875","chr4","27522792","27523117","25","89761"
"chr6","27617797","27618050","chr4","27526095","27526347","17","91702"
"chr6","27651045","27651286","chr4","27559174","27559439","34","91871"
"chr6","27661571","27661883","chr2","181136731","181137034","70","153475160"
"chr6","27740530","27740693","chr4","27646328","27646491","8","94202"
"chr6","27889995","27890103","chr18","14524158","14524259","27","13365837"
"chr6","27891554","27891675","chr7","139774721","139774844","25","111883167"
"chr6","27931665","27931878","chr20","35094996","35095206","43","7163331"
"chr6","27952346","27952599","chr4","27840413","27840668","19","111933"
"chr6","27959461","27959758","chr4","27847521","27847817","28","111940"
"chr6","27969844","27970101","chr4","27858009","27858266","12","111835"
"chr6","28000659","28000804","chrX","69318009","69318138","33","41317350"
"chr6","28028669","28028791","chr4","27921378","27921500","6","107291"
"chr6","28041504","28041621","chr4","27932549","27932666","6","108955"
"chr6","28051070","28051218","chr4","27941963","27942094","26","109107"
"chr6","28088676","28088907","chr4","27982914","27983145","10","105762"
"chr6","28109738","28109972","chr13","10372867","10373095","73","17736871"
"chr6","28129648","28129946","chr13","64763833","64764129","59","36634185"
"chr6","28135240","28135538","chr4","28034158","28034449","47","101082"
"chr6","28144850","28145115","chr8","28714982","28715247","60","570132"
"chr6","28146150","28146267","chr4","28045501","28045618","4","100649"
"chr6","28150704","28150975","chr4","28050106","28050376","11","100598"
"chr6","28181069","28181227","chr13","107197048","107197208","38","79015979"
"chr6","28207321","28207526","chr14","53454483","53454680","46","25247162"
"chr6","28208426","28208753","chr4","28098831","28099164","32","109595"
"chr6","28213741","28213933","chr16","68429406","68429593","44","40215665"
"chr6","28224595","28224882","chr17","11790238","11790522","51","16434357"
"chr6","28247100","28247347","chr11","9143976","9144241","75","19103124"
"chr6","28254056","28254099","chr19","47415628","47415670","6","19161572"
"chr6","28280901","28281124","chr10","20780100","20780302","52","7500801"
"chr6","28319764","28320063","chr4","28227350","28227646","33","92414"
"chr6","28361301","28361385","chr4","28268612","28268691","8","92689"
"chr6","28442813","28443087","chr4","28360070","28360352","29","82743"
"chr6","28479210","28479530","chr8","101745971","101746276","60","73266761"
"chr6","28484239","28484523","chr3","131531467","131531753","48","103047228"
"chr6","28545469","28545739","chr4","28400101","28400372","19","145368"
"chr6","28596961","28597182","chr4","28467893","28468116","11","129068"
"chr6","28598044","28598337","chr4","28468978","28469251","50","129066"
"chr6","28607206","28607524","chr4","28478650","28478955","41","128556"
"chr6","28627136","28627393","chr4","28498955","28499211","11","128181"
"chr6","28634832","28635129","chr4","28506661","28506960","27","128171"
"chr6","28661013","28661118","chr4","28532488","28532594","6","128525"
"chr6","28661585","28661879","chr4","28533063","28533357","28","128522"
"chr6","28663749","28664057","chr4","28535492","28535785","49","128257"
"chr6","28699151","28699413","chr4","28625000","28625265","24","74151"
"chr6","28709150","28709440","chr4","28635357","28635645","23","73793"
"chr6","28748583","28748892","chr4","28691767","28692075","27","56816"
"chr6","28749352","28749620","chr4","28692517","28692807","32","56835"
"chr6","28761990","28762269","chr4","28704359","28704639","19","57631"
"chr6","28765989","28766117","chr4","28708631","28708754","12","57358"
"chr6","28767031","28767150","chr4","28709664","28709775","12","57367"
"chr6","28776819","28777064","chr4","28717400","28717648","27","59419"
"chr6","28815935","28816227","chr1","155141171","155141450","70","126325236"
"chr6","28816641","28816784","chr1","194894728","194894873","41","166078087"
"chr6","28842380","28842675","chr10","66771950","66772239","61","37929570"
"chr6","28856503","28856803","chr4","28798966","28799266","16","57537"
"chr6","28874428","28874637","chr1","58348505","58348709","43","29474077"
"chr6","28890622","28890934","chr1","44230646","44230948","63","15340024"
"chr6","28891931","28892228","chr4","28836201","28836478","34","55730"
"chr6","28896106","28896215","chr2","43752839","43752949","17","14856733"
"chr6","28980878","28981160","chr4","28929840","28930128","38","51038"
"chr6","29017404","29017711","chr1","8665723","8666021","63","20351681"
"chr6","29040623","29040754","chr4","28986983","28987102","29","53640"
"chr6","29041042","29041187","chr4","28987372","28987517","10","53670"
"chr6","29103408","29103705","chr4","29048487","29048785","24","54921"
"chr6","29191481","29191790","chr4","29129018","29129328","24","62463"
"chr6","29192187","29192571","chr17","62698995","62699360","108","33506808"
"chr6","29262283","29262505","chr1","161021354","161021558","66","131759071"
"chr6","29298021","29298159","chr4","29280781","29280918","19","17240"
"chr6","29364306","29364532","chr4","29341883","29342115","22","22423"
"chr6","29369439","29369746","chr20","28651476","28651780","51","717963"
"chr6","29371280","29371564","chr4","29348057","29348349","29","23223"
"chr6","29374679","29374773","chr4","29350724","29350818","5","23955"
"chr6","29379376","29379630","chr4","29355538","29355800","47","23838"
"chr6","29388114","29388262","chr4","29364426","29364574","11","23688"
"chr6","29516189","29516419","chr19","36579690","36579918","49","7063501"
"chr6","29808059","29808243","chr5","170126727","170126918","51","140318668"
"chr6","29870092","29870292","chr4","29890990","29891190","8","20898"
"chr6","30055022","30055279","chr20","2219038","2219312","71","27835984"
"chr6","30179939","30180245","chr4","30174560","30174872","26","5379"
"chr6","30210586","30210723","chr1","38658193","38658337","35","8447607"
"chr6","30219008","30219133","chr1","200289163","200289285","23","170070155"
"chr6","30268239","30268331","chr4","30644663","30644754","6","376424"
"chr6","30284582","30284870","chr4","30388332","30388623","26","103750"
"chr6","30299099","30299278","chr20","69978149","69978321","49","39679050"
"chr6","30349187","30349287","chr4","30234015","30234114","10","115172"
"chr6","30369938","30370232","chr4","30541768","30542062","30","171830"
"chr6","30385176","30385461","chr7","125864609","125864899","69","95479433"
"chr6","30420600","30420671","chr4","30580160","30580231","6","159560"
"chr6","30429320","30429615","chr10","15460316","15460612","74","14969004"
"chr6","30449633","30449927","chr4","30674789","30675085","30","225156"
"chr6","30470811","30471087","chr4","30703370","30703641","23","232559"
"chr6","30489256","30489550","chr4","30739691","30740012","50","250435"
"chr6","30496163","30496474","chr4","30748332","30748656","23","252169"
"chr6","30535400","30535521","chr4","30788875","30788998","12","253475"
"chr6","30588854","30589196","chr4","30840910","30841245","26","252056"
"chr6","30630745","30631013","chr4","30892159","30892420","26","261414"
"chr6","30665063","30665355","chr4","30926685","30926964","34","261622"
"chr6","30668640","30668754","chr8","37707041","37707158","20","7038401"
"chr6","30888961","30889072","chr4","30948175","30948284","8","59214"
"chr6","30946062","30946340","chr4","31019834","31020094","39","73772"
"chr6","30986332","30986454","chr4","31060551","31060674","13","74219"
"chr6","31061846","31061959","chr4","31128820","31128929","12","66974"
"chr6","31123710","31123834","chr1","18100775","18100899","17","13022935"
"chr6","31142137","31142266","chr1","1765944","1766075","27","29376193"
"chr6","31143624","31143802","chr4","31229430","31229607","8","85806"
"chr6","31144141","31144423","chr4","31229957","31230241","18","85816"
"chr6","31165219","31165509","chr4","31252292","31252572","40","87073"
"chr6","31180729","31181012","chr4","31267702","31267984","15","86973"
"chr6","31185859","31186136","chr2","100542029","100542318","58","69356170"
"chr6","31187493","31187776","chr7","51037550","51037833","74","19850057"
"chr6","31189132","31189417","chr12","77658291","77658572","61","46469159"
"chr6","31207293","31207422","chr1","8744078","8744207","21","22463215"
"chr6","31254651","31254952","chr4","31340691","31340986","31","86040"
"chr6","31286105","31286313","chr4","31375078","31375286","16","88973"
"chr6","31286360","31286682","chr4","31375486","31375795","38","89126"
"chr6","31322700","31323013","chr4","31411575","31411886","33","88875"
"chr6","31324910","31325039","chr4","31413842","31413972","6","88932"
"chr6","31328570","31328882","chr4","31417514","31417816","30","88944"
"chr6","31336052","31336318","chr4","31425931","31426210","36","89879"
"chr6","31365159","31365471","chr4","31451325","31451636","16","86166"
"chr6","31371635","31371971","chr4","31458687","31458980","59","87052"
"chr6","31391360","31391652","chr5","22397555","22397847","51","8993805"
"chr6","31404203","31404321","chr9","28855801","28855913","26","2548402"
"chr6","31404455","31404746","chr10","82091838","82092132","56","50687383"
"chr6","31423734","31423930","chr3","142303558","142303762","52","110879824"
"chr6","31426078","31426360","chr9","23259198","23259486","64","8166880"
"chr6","31427741","31427937","chr4","31513303","31513506","18","85562"
"chr6","31434629","31434709","chr15","2509536","2509615","22","28925093"
"chr6","31447745","31448016","chr4","31534435","31534707","15","86690"
"chr6","31450501","31450780","chr4","31537206","31537495","32","86705"
"chr6","31453596","31453717","chr7","113641019","113641138","21","82187423"
"chr6","31453744","31453903","chrX","13233270","13233431","38","18220474"
"chr6","31475094","31475357","chr4","31558097","31558401","62","83003"
"chr6","31484453","31484572","chr9","28096081","28096201","20","3388372"
"chr6","31490229","31490372","chr4","31570270","31570423","24","80041"
"chr6","31490676","31490818","chr4","31570725","31570871","11","80049"
"chr6","31514706","31514991","chr13","61219461","61219734","68","29704755"
"chr6","31558727","31559025","chr4","31638034","31638308","53","79307"
"chr6","31600850","31601100","chr4","31679349","31679598","19","78499"
"chr6","31608057","31608172","chr4","31686598","31686713","6","78541"
"chr6","31612248","31612559","chr1","116556867","116557170","64","84944619"
"chr6","31660229","31660516","chr4","31733840","31734135","27","73611"
"chr6","31661329","31661625","chr4","31734941","31735225","37","73612"
"chr6","31662834","31663128","chr4","31736440","31736741","22","73606"
"chr6","31674930","31675142","chr14","119045156","119045364","39","87370226"
"chr6","31681450","31681704","chr4","31757722","31757979","22","76272"
"chr6","31692940","31693244","chr19","45495569","45495860","66","13802629"
"chr6","31716071","31716369","chr4","31791618","31791926","36","75547"
"chr6","31718355","31718479","chr11","122666448","122666573","16","90948093"
"chr6","31743460","31743730","chrX","64917002","64917275","58","33173542"
"chr6","31746318","31746611","chr8","53967863","53968152","55","22221545"
"chr6","31752474","31752727","chr14","69195287","69195551","71","37442813"
"chr6","31767295","31767581","chr4","31840223","31840516","24","72928"
"chr6","31781614","31781911","chr4","31855251","31855539","28","73637"
"chr6","31793675","31793834","chr20","37141875","37142025","40","5348200"
"chr6","31794452","31794607","chr7","62834996","62835145","30","31040544"
"chr6","31917263","31917385","chr1","205464254","205464380","18","173546991"
"chr6","31925124","31925415","chr4","32013611","32013906","38","88487"
"chr6","31959207","31959339","chr4","31960705","31960843","19","1498"
"chr6","32005815","32006121","chr4","32013611","32013906","47","7796"
"chr6","32036964","32037109","chr1","11243495","11243630","31","20793469"
"chr6","32037141","32037304","chr4","32249961","32250130","33","212820"
"chr6","32043125","32043283","chr4","32255923","32256092","16","212798"
"chr6","32082817","32083113","chr4","32390712","32391009","36","307895"
"chr6","32094591","32094856","chr14","18202630","18202901","57","13891961"
"chr6","32104691","32104993","chr1","142286262","142286555","59","110181571"
"chr6","32136027","32136314","chr4","32444495","32444773","25","308468"
"chr6","32146225","32146515","chr4","32454463","32454752","17","308238"
"chr6","32147505","32147661","chr19","38808762","38808897","45","6661257"
"chr6","32147952","32147983","chr11","111898297","111898323","7","79750345"
"chr6","32148276","32148434","chr14","10577896","10578055","28","21570380"
"chr6","32148798","32149019","chr4","32457794","32458016","16","308996"
"chr6","32149871","32150179","chr4","32458873","32459186","35","309002"
"chr6","32177247","32177531","chr4","32492105","32492396","56","314858"
"chr6","32204709","32204988","chr4","32521257","32521547","32","316548"
"chr6","32245989","32246279","chr19","2356197","2356485","54","29889792"
"chr6","32266747","32267050","chr6","58047673","58047975","63","25780926"
"chr6","32316889","32317010","chr4","32636487","32636608","7","319598"
"chr6","32331946","32332063","chr4","32651734","32651851","3","319788"
"chr6","32347185","32347299","chr8","78631750","78631866","22","46284565"
"chr6","32348808","32348941","chr13","20881825","20881947","28","11466983"
"chr6","32349252","32349337","chr16","48109817","48109901","18","15760565"
"chr6","32378710","32378993","chr4","32701986","32702268","22","323276"
"chr6","32384488","32384779","chr4","32707525","32707800","35","323037"
"chr6","32396243","32396534","chr4","32725467","32725760","21","329224"
"chr6","32404856","32405141","chr4","32732434","32732715","17","327578"
"chr6","32418540","32418860","chr16","11545677","11545975","74","20872863"
"chr6","32422284","32422566","chr4","32750826","32751117","48","328542"
"chr6","32425973","32426191","chr4","32756315","32756533","17","330342"
"chr6","32435047","32435248","chr4","32765022","32765223","17","329975"
"chr6","32442990","32443274","chr4","32772979","32773262","18","329989"
"chr6","32454490","32454788","chr4","32785578","32785865","30","331088"
"chr6","32486889","32487024","chr4","32825824","32825965","20","338935"
"chr6","32489791","32489871","chr4","32829844","32829924","6","340053"
"chr6","32523486","32523778","chr4","32863399","32863676","33","339913"
"chr6","32538946","32539076","chr11","50179416","50179546","23","17640470"
"chr6","32579632","32579763","chr4","32897542","32897672","13","317910"
"chr6","32594121","32594404","chr4","32912927","32913197","28","318806"
"chr6","32611759","32612051","chr4","32930690","32931005","37","318931"
"chr6","32629197","32629489","chr4","32948601","32948895","15","319404"
"chr6","32632507","32632807","chr1","93452484","93452781","54","60819977"
"chr6","32662512","32662722","chr12","115132434","115132646","44","82469922"
"chr6","32664646","32664921","chr4","32981554","32981854","39","316908"
"chr6","32740423","32740616","chr3","41270686","41270884","56","8530263"
"chr6","32758711","32758929","chr4","33075925","33076149","17","317214"
"chr6","32827372","32827656","chr4","33153611","33153894","19","326239"
"chr6","32828055","32828358","chr4","33154282","33154595","28","326227"
"chr6","32857901","32858212","chr4","33188807","33189111","29","330906"
"chr6","32872139","32872346","chr9","83183096","83183302","36","50310957"
"chr6","32892122","32892413","chr5","63356316","63356602","54","30464194"
"chr6","32909717","32910026","chrX","6632047","6632339","71","26277670"
"chr6","32927786","32928076","chr4","33249195","33249478","32","321409"
"chr6","32990705","32990793","chr5","109387299","109387388","15","76396594"
"chr6","33331925","33332230","chr11","109624796","109625101","51","76292871"
"chr6","33340506","33340799","chr7","112217845","112218135","72","78877339"
"chr6","33453712","33454025","chr10","32184869","32185181","60","1268843"
"chr6","33475450","33475742","chr20","28618222","28618522","58","4857228"
"chr6","33503004","33503282","chr5","79226767","79227051","66","45723763"
"chr6","33545086","33545402","chr4","33676202","33676491","49","131116"
"chr6","33548769","33549017","chr4","33679870","33680118","16","131101"
"chr6","33576498","33576791","chr4","16953276","16953568","52","16623222"
"chr6","33682601","33682838","chr4","33833375","33833598","31","150774"
"chr6","33683424","33683719","chr4","33834204","33834490","25","150780"
"chr6","33690556","33690869","chr4","33841334","33841643","23","150778"
"chr6","33718684","33718997","chr4","33863024","33863333","16","144340"
"chr6","33783123","33783246","chrX","21055458","21055581","18","12727665"
"chr6","33829512","33829810","chr14","19766056","19766336","67","14063456"
"chr6","33846594","33846794","chr4","34003475","34003675","27","156881"
"chr6","33847094","33847119","chr16","41419029","41419053","6","7571935"
"chr6","33906998","33907119","chr4","34064296","34064403","21","157298"
"chr6","33911515","33911809","chr4","34068825","34069121","16","157310"
"chr6","33912450","33912631","chr4","34069764","34069931","24","157314"
"chr6","33919821","33920110","chr4","34076826","34077122","23","157005"
"chr6","33943580","33943894","chr4","34101305","34101616","32","157725"
"chr6","33951904","33952194","chr4","34110005","34110289","27","158101"
"chr6","34046078","34046379","chr4","34212370","34212669","24","166292"
"chr6","34171962","34172098","chrX","52807641","52807772","26","18635679"
"chr6","34172387","34172583","chr4","34336445","34336640","17","164058"
"chr6","34178152","34178445","chr4","34342595","34342886","24","164443"
"chr6","34180691","34180814","chr4","86004105","86004229","18","51823414"
"chr6","34183090","34183387","chr2","188426626","188426924","66","154243536"
"chr6","34189267","34189574","chr4","34359721","34360018","33","170454"
"chr6","34190612","34190875","chr7","96863166","96863444","59","62672554"
"chr6","34192657","34192939","chr2","109967146","109967434","64","75774489"
"chr6","34198337","34198619","chr4","34370110","34370394","13","171773"
"chr6","34212422","34212712","chr15","43687639","43687935","50","9475217"
"chr6","34222030","34222169","chr1","153250707","153250848","26","119028677"
"chr6","34233000","34233299","chr4","34408794","34409093","24","175794"
"chr6","34237580","34237851","chr4","34411990","34412259","25","174410"
"chr6","34243148","34243414","chr4","34422492","34422760","23","179344"
"chr6","34244690","34244993","chr4","34424054","34424370","34","179364"
"chr6","34249710","34249899","chr4","34426427","34426616","17","176717"
"chr6","34264314","34264439","chr9","88623111","88623229","32","54358797"
"chr6","34283388","34283674","chr11","124404546","124404835","57","90121158"
"chr6","34337617","34337747","chr10","84802957","84803087","19","50465340"
"chr6","34486875","34487173","chr4","34669181","34669487","25","182306"
"chr6","34643970","34644185","chr17","5229611","5229823","45","29414359"
"chr6","34644186","34644472","chr5","165714831","165715111","54","131070645"
"chr6","34651072","34651262","chr11","89782161","89782358","44","55131089"
"chr6","34655196","34655425","chr4","34829421","34829653","20","174225"
"chr6","34660925","34661047","chr10","77419179","77419302","17","42758254"
"chr6","34682325","34682621","chr4","34856953","34857263","31","174628"
"chr6","34785008","34785285","chr4","34960916","34961186","28","175908"
"chr6","34788108","34788389","chr4","34963980","34964264","17","175872"
"chr6","34832506","34832811","chr4","35010434","35010736","19","177928"
"chr6","34835135","34835438","chr4","35013160","35013455","29","178025"
"chr6","34888024","34888334","chr4","35065884","35066193","24","177860"
"chr6","34896136","34896207","chr4","35073800","35073871","4","177664"
"chr6","34896252","34896330","chr4","35073917","35073997","9","177665"
"chr6","34896576","34896760","chr4","35074256","35074418","33","177680"
"chr6","34931024","34931322","chr4","35117358","35117664","36","186334"
"chr6","34936308","34936602","chr15","43687639","43687935","62","8751331"
"chr6","34942488","34942721","chrX","51567105","51567331","51","16624617"
"chr6","34967566","34967688","chr13","23996527","23996648","20","10971039"
"chr6","34968780","34969041","chr4","35159062","35159314","25","190282"
"chr6","34972148","34972338","chr4","35164141","35164327","22","191993"
"chr6","34972622","34972757","chr9","108921037","108921177","21","73948415"
"chr6","34979702","34979985","chr4","35173435","35173716","21","193733"
"chr6","34982339","34982636","chr4","35176409","35176707","40","194070"
"chr6","34987158","34987277","chr4","35182670","35182788","13","195512"
"chr6","34996325","34996607","chr4","35196998","35197230","66","200673"
"chr6","35002977","35003208","chr4","35201512","35201746","22","198535"
"chr6","35005752","35006027","chr4","35204945","35205207","40","199193"
"chr6","35018051","35018362","chr4","35219482","35219793","23","201431"
"chr6","35031728","35032015","chr4","35235302","35235588","20","203574"
"chr6","35033013","35033248","chr4","35236619","35236853","10","203606"
"chr6","35046460","35046794","chr10","14790910","14791231","74","20255550"
"chr6","35048237","35048539","chr11","107411569","107411871","64","72363332"
"chr6","35049797","35049906","chr20","28617375","28617483","16","6432422"
"chr6","35051245","35051536","chr11","125201626","125201907","58","90150381"
"chr6","35055455","35055669","chr19","18897557","18897775","38","16157898"
"chr6","35070958","35071082","chr4","35278717","35278854","17","207759"
"chr6","35071955","35072137","chr12","120299595","120299774","45","85227640"
"chr6","35072687","35072902","chr14","66911348","66911552","35","31838661"
"chr6","35074547","35074838","chr11","970811","971107","47","34103736"
"chr6","35082953","35083030","chr10","89492793","89492874","12","54409840"
"chr6","35085990","35086143","chr15","100773356","100773508","38","65687366"
"chr6","35119000","35119282","chr4","35324884","35325151","39","205884"
"chr6","35136155","35136352","chr4","35340032","35340251","39","203877"
"chr6","35145952","35146263","chr4","35349873","35350183","31","203921"
"chr6","35159879","35160175","chr4","35364900","35365194","26","205021"
"chr6","35170384","35170614","chr4","35371407","35371635","29","201023"
"chr6","35171493","35171789","chr4","35372944","35373241","62","201451"
"chr6","35223324","35223456","chr4","35427704","35427836","5","204380"
"chr6","35231264","35231541","chr4","35435978","35436267","24","204714"
"chr6","35235539","35235820","chr4","35440299","35440583","40","204760"
"chr6","35242129","35242444","chr4","35444612","35444927","15","202483"
"chr6","35244313","35244428","chr4","35446490","35446606","9","202177"
"chr6","35247180","35247485","chrX","101668164","101668460","67","66420984"
"chr6","35260155","35260254","chr9","60206806","60206906","19","24946651"
"chr6","35274392","35274670","chr3","55442160","55442439","62","20167768"
"chr6","35286791","35287063","chr4","35489056","35489326","21","202265"
"chr6","35292433","35292732","chr4","35494978","35495281","21","202545"
"chr6","35299613","35299802","chr4","35502171","35502360","5","202558"
"chr6","35301955","35302233","chr15","14646159","14646430","68","20655796"
"chr6","35311316","35311617","chr4","35514924","35515233","32","203608"
"chr6","35318816","35319089","chrX","53491463","53491737","73","18172647"
"chr6","35328625","35328932","chr4","35532353","35532679","44","203728"
"chr6","35328983","35329263","chr4","35532728","35533007","22","203745"
"chr6","35330792","35331005","chr4","35534853","35535072","33","204061"
"chr6","35331273","35331411","chr4","35535337","35535475","8","204064"
"chr6","35331435","35331552","chr4","35535513","35535630","6","204078"
"chr6","35347989","35348191","chr4","35553781","35553994","25","205792"
"chr6","35348349","35348464","chr7","133183554","133183670","24","97835205"
"chr6","35357287","35357586","chr20","28651476","28651780","58","6705811"
"chr6","35363804","35364103","chr4","35572088","35572389","24","208284"
"chr6","35364481","35364715","chr4","35572709","35572955","23","208228"
"chr6","35370843","35370978","chr4","35579957","35580092","3","209114"
"chr6","35372379","35372683","chr4","35581315","35581628","26","208936"
"chr6","35389751","35390036","chr4","35597473","35597759","22","207722"
"chr6","35390351","35390615","chr4","35598107","35598329","57","207756"
"chr6","35400126","35400426","chr4","35607594","35607894","25","207468"
"chr6","35407510","35407710","chr11","116400951","116401155","49","80993441"
"chr6","35408002","35408108","chr9","12494184","12494282","25","22913818"
"chr6","35414119","35414401","chr4","35630847","35631125","20","216728"
"chr6","35419621","35419880","chr16","45788271","45788537","68","10368650"
"chr6","35438709","35438826","chr1","15003529","15003646","22","20435180"
"chr6","35447993","35448261","chr4","35659780","35660042","23","211787"
"chr6","35448680","35448762","chr4","35660547","35660631","19","211867"
"chr6","35449992","35450326","chr3","127889632","127889949","71","92439640"
"chr6","35474645","35474919","chrX","65072501","65072782","70","29597856"
"chr6","35478483","35478784","chr4","35692118","35692417","16","213635"
"chr6","35485311","35485611","chr4","35698791","35699091","21","213480"
"chr6","35488132","35488428","chr9","5743881","5744173","57","29744251"
"chr6","35496429","35496706","chr4","35711401","35711680","17","214972"
"chr6","35509701","35509989","chr11","92015643","92015927","62","56505942"
"chr6","35527594","35527765","chr4","35739922","35740080","30","212328"
"chr6","35536833","35537106","chr8","30788106","30788363","30","4748727"
"chr6","35538044","35538178","chr4","35750698","35750810","29","212654"
"chr6","35541414","35541530","chr4","35754582","35754698","6","213168"
"chr6","35544421","35544568","chr4","35757581","35757728","9","213160"
"chr6","35544882","35545028","chr4","35758044","35758195","13","213162"
"chr6","35554910","35554960","chr4","35768747","35768798","2","213837"
"chr6","35555265","35555374","chr4","35769102","35769211","6","213837"
"chr6","35568556","35568807","chr16","12028532","12028779","51","23540024"
"chr6","35578466","35578764","chr4","35793378","35793675","23","214912"
"chr6","35579984","35580257","chr4","35794889","35795165","23","214905"
"chr6","35593344","35593631","chr3","9506822","9507112","54","26086522"
"chr6","35600923","35601202","chr4","35816441","35816717","29","215518"
"chr6","35625325","35625629","chr6","147432797","147433108","60","111807472"
"chr6","35628636","35628947","chr4","35841904","35842238","46","213268"
"chr6","35663984","35664114","chr6","17252977","17253107","19","18411007"
"chr6","35667429","35667711","chr4","35872861","35873147","25","205432"
"chr6","35669178","35669364","chr4","35912608","35912794","14","243430"
"chr6","35672478","35672787","chr15","30925939","30926245","58","4746539"
"chr6","35711201","35711333","chr4","35955326","35955458","7","244125"
"chr6","35711642","35711793","chr4","35955773","35955913","29","244131"
"chr6","35754061","35754312","chr20","26603164","26603412","53","9150897"
"chr6","35762190","35762500","chr4","36009630","36009940","19","247440"
"chr6","35782103","35782320","chr20","40659296","40659518","56","4877193"
"chr6","35791920","35792215","chr4","36040779","36041085","27","248859"
"chr6","35816062","35816360","chr4","36064987","36065292","26","248925"
"chr6","35835271","35835467","chr16","60900979","60901169","44","25065708"
"chr6","35845117","35845423","chr4","36094117","36094424","21","249000"
"chr6","35881090","35881397","chr4","36129942","36130246","20","248852"
"chr6","35919941","35920027","chr4","36168638","36168716","13","248697"
"chr6","35930292","35930609","chr3","43652365","43652670","56","7722073"
"chr6","35930644","35930956","chr9","110786043","110786351","75","74855399"
"chr6","35938166","35938469","chr4","36185965","36186254","34","247799"
"chr6","35939964","35940269","chr4","36187754","36188044","31","247790"
"chr6","35958325","35958628","chr4","36206160","36206465","21","247835"
"chr6","35960397","35960686","chr4","36208545","36208838","27","248148"
"chr6","36006479","36006563","chr13","63704104","63704189","20","27697625"
"chr6","36008421","36008730","chr4","36264091","36264389","33","255670"
"chr6","36008735","36009040","chr4","36264390","36264697","26","255655"
"chr6","36018172","36018310","chr19","2291690","2291824","24","33726482"
"chr6","36032020","36032318","chr4","36287544","36287857","42","255524"
"chr6","36070799","36071058","chr4","36327038","36327285","52","256239"
"chr6","36075901","36076198","chr4","36332518","36332829","36","256617"
"chr6","36086253","36086372","chr4","36343469","36343585","10","257216"
"chr6","36086700","36086876","chr4","36343878","36344054","13","257178"
"chr6","36131475","36131786","chr13","37831904","37832211","73","1700429"
"chr6","36136261","36136396","chr1","128086244","128086378","28","91949983"
"chr6","36178015","36178142","chr1","200289163","200289285","22","164111148"
"chr6","36184933","36185244","chr4","36445145","36445449","18","260212"
"chr6","36187225","36187513","chr4","36447438","36447727","13","260213"
"chr6","36302173","36302443","chr4","36451130","36451413","42","148957"
"chr6","36306269","36306394","chr5","14863431","14863555","19","21442838"
"chr6","36311664","36311959","chr4","36461126","36461416","21","149462"
"chr6","36314569","36314811","chr2","45945040","45945260","69","9630471"
"chr6","36319029","36319297","chr4","36468534","36468800","21","149505"
"chr6","36319649","36319778","chr7","16781339","16781468","23","19538310"
"chr6","36320819","36321121","chr4","36470308","36470624","40","149489"
"chr6","36321989","36322290","chr4","36471480","36471783","17","149491"
"chr6","36323576","36323867","chr4","36472055","36472346","24","148479"
"chr6","36332713","36333010","chr4","103730788","103731088","50","67398075"
"chr6","36335288","36335590","chr4","36484206","36484512","28","148918"
"chr6","36340681","36340959","chr4","36489831","36490104","25","149150"
"chr6","36343216","36343418","chr4","36492344","36492547","16","149128"
"chr6","36354381","36354677","chr7","34165668","34165962","51","2188713"
"chr6","36358636","36358909","chr4","36508025","36508297","21","149389"
"chr6","36368555","36368852","chr4","36517902","36518201","16","149347"
"chr6","36371777","36372027","chr19","44045514","44045769","59","7673737"
"chr6","36372945","36373243","chr4","36522059","36522334","37","149114"
"chr6","36382855","36383153","chr4","36533453","36533746","32","150598"
"chr6","36384970","36385251","chr4","36535552","36535816","57","150582"
"chr6","36402783","36403082","chr4","36553947","36554246","21","151164"
"chr6","36405339","36405645","chr4","36556512","36556821","22","151173"
"chr6","36406660","36406904","chr4","36557844","36558088","7","151184"
"chr6","36412598","36412913","chr5","185678151","185678451","66","149265553"
"chr6","36417336","36417620","chr19","42145426","42145711","16","5728090"
"chr6","36425562","36425691","chr5","26138308","26138430","20","10287254"
"chr6","36437678","36437974","chr4","36591267","36591564","17","153589"
"chr6","36443201","36443489","chr4","36596727","36597011","26","153526"
"chr6","36444546","36444846","chr4","36598427","36598734","25","153881"
"chr6","36449163","36449488","chr13","93941838","93942156","77","57492675"
"chr6","36458010","36458314","chr4","36612099","36612404","21","154089"
"chr6","36460192","36460479","chr4","36614519","36614808","21","154327"
"chr6","36465164","36465473","chr11","113220012","113220319","47","76754848"
"chr6","36479877","36480178","chr14","32365508","32365805","73","4114369"
"chr6","36520083","36520173","chr4","36681621","36681713","8","161538"
"chr6","36533108","36533469","chr3","34684963","34685313","99","1848145"
"chr6","36554232","36554531","chr15","43687639","43687935","58","7133407"
"chr6","36571840","36571965","chr4","36735326","36735443","10","163486"
"chr6","36625528","36625688","chr4","36790099","36790252","15","164571"
"chr6","36674499","36674795","chr4","36841092","36841377","26","166593"
"chr6","36691431","36691726","chr4","36858977","36859286","46","167546"
"chr6","36700550","36700678","chr4","36866815","36866943","10","166265"
"chr6","36724926","36725094","chr4","36891755","36891933","19","166829"
"chr6","36754292","36754591","chr4","36920986","36921271","47","166694"
"chr6","36756543","36756709","chr17","3933207","3933362","36","32823336"
"chr6","36792519","36792649","chr4","36960164","36960294","6","167645"
"chr6","36805243","36805363","chr18","15009527","15009644","17","21795716"
"chr6","36819260","36819525","chr4","36986213","36986481","20","166953"
"chr6","36873561","36873730","chrX","127210448","127210613","26","90336887"
"chr6","36894802","36895064","chr4","37063971","37064250","52","169169"
"chr6","36906533","36906767","chr4","37075974","37076203","13","169441"
"chr6","36917561","36917764","chr11","74880915","74881119","41","37963354"
"chr6","36925339","36925587","chr4","37094068","37094315","15","168729"
"chr6","36928407","36928713","chr4","37097148","37097463","25","168741"
"chr6","36943564","36943834","chr4","37112559","37112811","36","168995"
"chr6","36945764","36945988","chr4","37114887","37115122","29","169123"
"chr6","36992228","36992504","chr1","5267149","5267433","59","31725079"
"chr6","37000488","37000798","chr4","37169821","37170127","21","169333"
"chr6","37012761","37013052","chr4","37183671","37183962","26","170910"
"chr6","37018994","37019288","chr4","37190272","37190571","27","171278"
"chr6","37036584","37036882","chr4","37209134","37209417","49","172550"
"chr6","37045288","37045487","chr13","30070965","30071173","34","6974323"
"chr6","37045626","37045932","chr4","37218228","37218537","37","172602"
"chr6","37047277","37047555","chr4","37219880","37220160","17","172603"
"chr6","37067437","37067527","chr4","37239766","37239856","6","172329"
"chr6","37077018","37077320","chr4","37249167","37249492","41","172149"
"chr6","37137001","37137300","chr4","37306270","37306577","35","169269"
"chr6","37142777","37143074","chr4","37311914","37312208","26","169137"
"chr6","37149663","37149806","chr4","37318771","37318914","9","169108"
"chr6","37152362","37152681","chr4","37321555","37321842","51","169193"
"chr6","37155338","37155577","chr4","37324782","37325054","43","169444"
"chr6","37158901","37159198","chr4","37327919","37328230","35","169018"
"chr6","37166878","37167158","chr4","37335593","37335858","40","168715"
"chr6","37169016","37169300","chr4","37337833","37338123","22","168817"
"chr6","37173414","37173747","chr18","1158360","1158673","71","36015054"
"chr6","37201290","37201513","chr4","37370941","37371146","25","169651"
"chr6","37212953","37213242","chr4","37382868","37383161","27","169915"
"chr6","37218475","37218572","chr4","156570539","156570638","33","119352064"
"chr6","37219750","37219942","chr4","37387728","37387922","28","167978"
"chr6","37220257","37220363","chr6","139383516","139383625","13","102163259"
"chr6","37227729","37228032","chr2","72923747","72924047","53","35696018"
"chr6","37244832","37245123","chr4","37411537","37411834","28","166705"
"chr6","37262222","37262512","chr4","37429557","37429837","36","167335"
"chr6","37294997","37295289","chr4","37463373","37463674","32","168376"
"chr6","37310724","37310993","chr4","37480156","37480452","45","169432"
"chr6","37320574","37320864","chr4","37490477","37490770","24","169903"
"chr6","37332707","37333030","chr4","37500435","37500733","45","167728"
"chr6","37347124","37347176","chr6","174934448","174934498","13","137587324"
"chr6","37347567","37347860","chr2","83884719","83885008","59","46537152"
"chr6","37360161","37360419","chr4","37528733","37529010","39","168572"
"chr6","37364825","37365039","chr4","37534283","37534494","38","169458"
"chr6","37373750","37374038","chr4","37548580","37548866","33","174830"
"chr6","37388491","37388787","chr4","37563063","37563352","35","174572"
"chr6","37404151","37404358","chr4","37578194","37578417","35","174043"
"chr6","37458557","37458858","chr4","37634902","37635203","18","176345"
"chr6","37464021","37464318","chr15","29615590","29615889","60","7848431"
"chr6","37491431","37491717","chr2","134217641","134217927","65","96726210"
"chr6","37507188","37507477","chr4","37683802","37684095","19","176614"
"chr6","37520043","37520308","chrX","112227503","112227781","52","74707460"
"chr6","37530887","37531227","chr4","37708335","37708656","44","177448"
"chr6","37541536","37541853","chr1","10227902","10228202","67","27313634"
"chr6","37587197","37587507","chr4","37761866","37762179","17","174669"
"chr6","37591855","37592186","chr4","37766544","37766880","39","174689"
"chr6","37605069","37605175","chr8","96949211","96949317","12","59344142"
"chr6","37615269","37615383","chr4","37789955","37790064","10","174686"
"chr6","37645298","37645582","chr4","37821148","37821441","38","175850"
"chr6","37678778","37679064","chr5","177582544","177582820","52","139903766"
"chr6","37690526","37690809","chr19","29145761","29146064","72","8544765"
"chr6","37716579","37716857","chr4","37887526","37887825","39","170947"
"chr6","37723019","37723276","chr4","37893991","37894248","13","170972"
"chr6","37731186","37731445","chr4","37901982","37902243","20","170796"
"chr6","37753487","37753756","chr4","37924622","37924895","19","171135"
"chr6","37796618","37796915","chr15","68340687","68340988","54","30544069"
"chr6","37799446","37799653","chr4","37973454","37973661","34","174008"
"chr6","37800829","37801141","chr4","37975857","37976163","29","175028"
"chr6","37803643","37803955","chr4","37977720","37978039","36","174077"
"chr6","37809973","37810284","chr2","69414639","69414948","56","31604666"
"chr6","37827614","37827944","chr4","38002799","38003089","97","175185"
"chr6","37837149","37837182","chr4","38012955","38012988","3","175806"
"chr6","37837492","37837648","chr4","38013300","38013448","22","175808"
"chr6","37837958","37838030","chr1","212593750","212593822","13","174755792"
"chr6","37844974","37845169","chr4","38021340","38021544","43","176366"
"chr6","37845482","37845570","chr1","135487429","135487514","22","97641947"
"chr6","37851703","37852002","chr4","38028758","38029046","24","177055"
"chr6","37855603","37855861","chr4","38032662","38032935","28","177059"
"chr6","37881057","37881351","chr20","53919616","53919913","66","16038559"
"chr6","37901327","37901493","chr3","159381635","159381793","40","121480308"
"chr6","37901782","37901897","chr4","38084816","38084931","10","183034"
"chr6","37907982","37908241","chr19","27327147","27327403","58","10580835"
"chr6","37909647","37909802","chr12","10885359","10885528","38","27024288"
"chr6","37910093","37910247","chr16","7344598","7344746","38","30565495"
"chr6","37911664","37911951","chr11","116871765","116872049","79","78960101"
"chr6","37929884","37930037","chr4","38112001","38112164","21","182117"
"chr6","37932836","37932965","chr4","38115536","38115663","10","182700"
"chr6","37946095","37946405","chr4","38129123","38129428","29","183028"
"chr6","37957399","37957700","chr4","31751916","31752223","52","6205483"
"chr6","37962206","37962395","chr4","38152280","38152460","27","190074"
"chr6","37962689","37962824","chr4","38152761","38152897","8","190072"
"chr6","37979818","37979947","chr3","21291522","21291642","34","16688296"
"chr6","37980252","37980329","chr2","159145447","159145525","26","121165195"
"chr6","37980609","37980730","chr9","251118","251236","25","37729491"
"chr6","38014729","38014842","chr4","38207028","38207138","13","192299"
"chr6","38022308","38022595","chr4","38215557","38215855","33","193249"
"chr6","38032920","38033217","chr4","38225415","38225722","30","192495"
"chr6","38043780","38044083","chr4","38235772","38236081","29","191992"
"chr6","38049995","38050300","chr1","52166007","52166310","61","14116012"
"chr6","38068165","38068463","chr15","43687639","43687935","50","5619474"
"chr6","38078204","38078437","chr16","42021784","42022005","46","3943580"
"chr6","38143408","38143688","chr4","38343365","38343647","21","199957"
"chr6","38151159","38151439","chr4","38351863","38352156","32","200704"
"chr6","38151452","38151576","chr4","38352171","38352293","7","200719"
"chr6","38159441","38159706","chr10","17764363","17764641","64","20395078"
"chr6","38205914","38206221","chr4","38411381","38411687","24","205467"
"chr6","38289233","38289536","chr4","38495324","38495633","33","206091"
"chr6","38299503","38299808","chr4","38505586","38505894","19","206083"
"chr6","38374546","38374725","chr4","38580911","38581066","33","206365"
"chr6","38375025","38375137","chr4","38581380","38581494","13","206355"
"chr6","38397370","38397587","chr4","38604145","38604363","8","206775"
"chr6","38419126","38419455","chr4","38626386","38626702","71","207260"
"chr6","38428969","38429253","chr4","38635751","38636036","20","206782"
"chr6","38444084","38444376","chr9","60004253","60004546","59","21560169"
"chr6","38460452","38460763","chr19","11240796","11241062","92","27219656"
"chr6","38461290","38461606","chr4","38667253","38667571","22","205963"
"chr6","38465975","38466196","chr18","13561102","13561321","40","24904873"
"chr6","38475296","38475466","chr4","38681501","38681671","9","206205"
"chr6","38488018","38488331","chr4","38694509","38694823","32","206491"
"chr6","38515995","38516225","chr4","38726034","38726274","32","210039"
"chr6","38528828","38529134","chr4","38738617","38738923","25","209789"
"chr6","38551262","38551533","chr20","29357836","29358099","49","9193426"
"chr6","38559464","38559774","chr4","38770065","38770377","19","210601"
"chr6","38560604","38560809","chr4","38771213","38771418","11","210609"
"chr6","38616243","38616564","chr2","103711991","103712294","78","65095748"
"chr6","38619809","38619915","chr4","38833554","38833657","22","213745"
"chr6","38623316","38623614","chr4","38837416","38837708","38","214100"
"chr6","38623959","38624108","chr4","38838049","38838208","19","214090"
"chr6","38636423","38636725","chr4","38850897","38851189","34","214474"
"chr6","38678573","38678847","chr2","91205890","91206181","70","52527317"
"chr6","38684452","38684568","chr4","37280607","37280724","14","1403845"
"chr6","38725555","38725847","chr4","38935085","38935396","47","209530"
"chr6","38728244","38728525","chr7","165756552","165756845","62","127028308"
"chr6","38728698","38728783","chr9","123682701","123682783","21","84954003"
"chr6","38784891","38785012","chr4","38998193","38998315","9","213302"
"chr6","38791487","38791604","chr4","39004776","39004889","12","213289"
"chr6","38798220","38798387","chr4","39011980","39012139","16","213760"
"chr6","38798439","38798552","chr4","39012179","39012290","8","213740"
"chr6","38815146","38815343","chr4","39029847","39030045","20","214701"
"chr6","38817440","38817656","chr1","114320499","114320718","56","75503059"
"chr6","38851648","38851941","chr4","39064967","39065249","36","213319"
"chr6","38862123","38862377","chr3","180242810","180243067","51","141380687"
"chr6","38875616","38875949","chr4","39089747","39090076","23","214131"
"chr6","38886770","38887059","chr4","39100027","39100315","28","213257"
"chr6","38903642","38903910","chr4","39116761","39117055","42","213119"
"chr6","38910934","38911272","chrX","8819724","8820030","97","30091210"
"chr6","38977119","38977416","chr4","39196460","39196757","18","219341"
"chr6","38991396","38991664","chrX","52715681","52715941","73","13724285"
"chr6","38999152","38999422","chr4","39224432","39224721","37","225280"
"chr6","39004291","39004495","chr4","39229690","39229892","24","225399"
"chr6","39006742","39007055","chr4","39232473","39232789","32","225731"
"chr6","39007134","39007393","chr4","39232799","39233084","35","225665"
"chr6","39009329","39009592","chr4","39235110","39235378","10","225781"
"chr6","39010842","39011130","chr14","33689709","33689997","62","5321133"
"chr6","39033081","39033324","chr4","39257481","39257726","12","224400"
"chr6","39077351","39077628","chr4","39295778","39296043","21","218427"
"chr6","39102133","39102399","chr4","39322672","39322936","16","220539"
"chr6","39114125","39114409","chr4","39335226","39335516","16","221101"
"chr6","39116130","39116435","chr4","39337245","39337534","29","221115"
"chr6","39118307","39118616","chr4","39339485","39339797","26","221178"
"chr6","39126361","39126637","chr4","39348197","39348472","28","221836"
"chr6","39133393","39133707","chr4","39355148","39355460","19","221755"
"chr6","39149303","39149549","chr4","39371327","39371570","18","222024"
"chr6","39156960","39157230","chr4","39379212","39379492","23","222252"
"chr6","39162268","39162574","chr4","39384864","39385170","20","222596"
"chr6","39176729","39176833","chr4","39400012","39400116","7","223283"
"chr6","39177231","39177512","chr4","39400859","39401140","21","223628"
"chr6","39191714","39192007","chr4","39406616","39406915","25","214902"
"chr6","39202943","39203229","chr4","39422933","39423228","37","219990"
"chr6","39216021","39216317","chr4","39438348","39438637","26","222327"
"chr6","39229053","39229132","chrX","48371432","48371514","18","9142379"
"chr6","39232499","39232610","chr3","41881824","41881939","14","2649325"
"chr6","39248957","39249143","chr4","39470014","39470200","19","221057"
"chr6","39250164","39250393","chr4","39471205","39471430","10","221041"
"chr6","39281486","39281804","chr4","39503432","39503761","35","221946"
"chr6","39299468","39299590","chr4","39520339","39520473","18","220871"
"chr6","39299902","39300049","chr4","39520801","39520945","10","220899"
"chr6","39345569","39345877","chr4","39566921","39567228","22","221352"
"chr6","39359652","39359795","chr4","39580676","39580819","9","221024"
"chr6","39361768","39362055","chr4","39582787","39583066","26","221019"
"chr6","39365963","39366160","chrX","15957200","15957396","43","23408763"
"chr6","39366690","39366711","chr17","73461202","73461223","2","34094512"
"chr6","39416877","39417180","chr4","39639914","39640216","22","223037"
"chr6","39426771","39427085","chr4","39647322","39647629","29","220551"
"chr6","39430021","39430304","chr4","39650925","39651206","20","220904"
"chr6","39436257","39436529","chr4","39657323","39657595","13","221066"
"chr6","39437922","39438281","chr4","39658981","39659335","35","221059"
"chr6","39438316","39438609","chr4","39659370","39659657","21","221054"
"chr6","39442724","39442961","chr4","39663417","39663653","17","220693"
"chr6","39487552","39487846","chr4","39711972","39712247","42","224420"
"chr6","39504582","39504890","chr4","39728852","39729159","25","224270"
"chr6","39540098","39540372","chr4","39759524","39759777","42","219426"
"chr6","39544877","39545005","chr4","39764208","39764337","9","219331"
"chr6","39644056","39644355","chr19","40926811","40927106","58","1282755"
"chr6","39657134","39657418","chr4","39875915","39876196","30","218781"
"chr6","39665969","39666251","chr4","39885360","39885625","36","219391"
"chr6","39892947","39893246","chr4","40112862","40113161","27","219915"
"chr6","39922922","39923200","chr4","40145755","40146029","27","222833"
"chr6","40141283","40141331","chr3","142522068","142522117","2","102380785"
"chr6","40153242","40153564","chr3","132351538","132351859","74","92198296"
"chr6","40157845","40158010","chr3","142537862","142538027","8","102380017"
"chr6","40159140","40159502","chr3","34684963","34685313","107","5474177"
"chr6","40162684","40162970","chr7","113150637","113150924","54","72987953"
"chr6","40232184","40232513","chr4","40275415","40275732","68","43231"
"chr6","40249073","40249406","chr6","134870801","134871115","74","94621728"
"chr6","40274927","40275208","chr4","40318305","40318594","41","43378"
"chr6","40304645","40304943","chr4","40347703","40348015","23","43058"
"chr6","40540595","40540900","chr9","32628108","32628415","81","7912487"
"chr6","40580054","40580296","chr4","40638110","40638349","20","58056"
"chr6","40580738","40581061","chr19","43210585","43210888","74","2629847"
"chr6","40602587","40602745","chr4","40658003","40658162","9","55416"
"chr6","40610915","40611115","chr3","35440483","35440667","49","5170432"
"chr6","40681431","40681732","chr4","40729795","40730089","39","48364"
"chr6","40785297","40785605","chr4","40833495","40833798","36","48198"
"chr6","41150641","41150955","chr4","41216171","41216464","35","65530"
"chr6","41204948","41205143","chr4","41269561","41269755","20","64613"
"chr6","41351740","41352053","chr4","41415869","41416187","24","64129"
"chr6","41370875","41371179","chr4","41432596","41432909","30","61721"
"chr6","41391552","41391830","chr4","41453101","41453398","37","61549"
"chr6","41593113","41593409","chr4","41656668","41656978","42","63555"
"chr6","41706986","41707267","chr4","41770389","41770698","51","63403"
"chr6","41953137","41953440","chr4","42007286","42007590","17","54149"
"chr6","42000639","42000944","chr4","42068352","42068648","37","67713"
"chr6","42055311","42055607","chr4","42128110","42128419","41","72799"
"chr6","42166083","42166385","chr4","42240124","42240426","14","74041"
"chr6","42172279","42172339","chr4","42246606","42246666","2","74327"
"chr6","42173764","42174060","chr4","42248076","42248364","20","74312"
"chr6","42206368","42206658","chr1","24338438","24338725","53","17867930"
"chr6","42238797","42238958","chr4","42314702","42314857","18","75905"
"chr6","42263364","42263616","chr4","42339907","42340160","20","76543"
"chr6","42265263","42265524","chr1","42143576","42143839","65","121687"
"chr6","42280983","42281269","chr4","42357631","42357949","53","76648"
"chr6","42286453","42286572","chr6","161562285","161562399","23","119275832"
"chr6","42296412","42296712","chr7","167194217","167194515","55","124897805"
"chr6","42371680","42371907","chr1","45544948","45545172","45","3173268"
"chr6","42377992","42378167","chr4","42455407","42455570","23","77415"
"chr6","42423868","42424049","chr20","22732411","22732579","34","19691457"
"chr6","42434116","42434399","chr4","42512623","42512903","21","78507"
"chr6","42524295","42524448","chr4","42599071","42599234","16","74776"
"chr6","42551817","42552113","chr1","54205293","54205591","56","11653476"
"chr6","42571779","42572071","chr4","42644691","42644984","17","72912"
"chr6","42600306","42600580","chr4","42673723","42673997","20","73417"
"chr6","42642198","42642381","chr19","10394013","10394205","46","32248185"
"chr6","42643119","42643239","chr4","34365187","34365304","20","8277932"
"chr6","42653002","42653123","chr4","42728759","42728875","18","75757"
"chr6","42680066","42680199","chr4","42757180","42757311","6","77114"
"chr6","42686648","42686944","chr4","42763726","42764002","33","77078"
"chr6","42689771","42689855","chr4","42766835","42766919","5","77064"
"chr6","42691208","42691309","chr17","87177427","87177522","24","44486219"
"chr6","42724220","42724517","chr4","42797711","42798009","14","73491"
"chr6","42735301","42735500","chr14","7606422","7606620","51","35128879"
"chr6","42735794","42735921","chr14","70221854","70221971","24","27486060"
"chr6","42757171","42757382","chr3","128728563","128728790","55","85971392"
"chr6","42757699","42757739","chr1","31044600","31044641","6","11713099"
"chr6","42765738","42765850","chr4","42842238","42842352","10","76500"
"chr6","42765853","42766060","chr4","42842355","42842557","18","76502"
"chr6","42785778","42786077","chr2","160551205","160551504","58","117765427"
"chr6","42800799","42801061","chr4","42882125","42882394","25","81326"
"chr6","42801597","42801911","chr4","42882558","42882858","56","80961"
"chr6","42808433","42808607","chr4","42889756","42889936","17","81323"
"chr6","42808912","42809050","chr4","42890234","42890372","10","81322"
"chr6","42829736","42829945","chr4","42911085","42911296","9","81349"
"chr6","42838757","42839029","chr6","124044439","124044702","69","81205682"
"chr6","42845355","42845636","chr18","39207065","39207355","58","3638290"
"chr6","42849108","42849306","chr3","38839947","38840148","43","4009161"
"chr6","42877330","42877445","chr4","42977658","42977775","9","100328"
"chr6","42886900","42887009","chr4","42986042","42986151","10","99142"
"chr6","42887303","42887489","chr4","42986441","42986626","12","99138"
"chr6","42892438","42892717","chr4","42991572","42991874","33","99134"
"chr6","42895623","42895752","chr4","42994812","42994941","6","99189"
"chr6","42911067","42911389","chr4","43008746","43009046","39","97679"
"chr6","42914190","42914480","chr1","22392281","22392567","63","20521909"
"chr6","42946290","42946422","chr4","43046317","43046451","10","100027"
"chr6","42967757","42968060","chr4","43067967","43068263","33","100210"
"chr6","42985834","42986013","chr4","43084899","43085080","20","99065"
"chr6","43018424","43018700","chr4","43118285","43118558","16","99861"
"chr6","43076921","43077169","chr1","40235127","40235368","53","2841794"
"chr6","43093569","43093866","chr4","43201129","43201428","18","107560"
"chr6","43106491","43106819","chr4","43216507","43216829","32","110016"
"chr6","43107791","43108073","chr4","43217980","43218284","37","110189"
"chr6","43129314","43129590","chr4","43240178","43240456","22","110864"
"chr6","43154364","43154631","chr4","43265261","43265528","16","110897"
"chr6","43157225","43157451","chr4","43268117","43268363","30","110892"
"chr6","43185722","43185865","chr19","37216513","37216651","31","5969209"
"chr6","43186169","43186275","chr8","38214751","38214853","32","4971418"
"chr6","43204631","43204924","chr4","43313323","43313604","26","108692"
"chr6","43266095","43266386","chr4","43375407","43375701","33","109312"
"chr6","43270292","43270503","chr4","43379664","43379855","29","109372"
"chr6","43297339","43297630","chr4","43408012","43408304","19","110673"
"chr6","43299836","43300171","chr4","43410503","43410843","22","110667"
"chr6","43314476","43314749","chr4","43425440","43425746","46","110964"
"chr6","43321129","43321421","chr4","43431965","43432256","26","110836"
"chr6","43342217","43342509","chr3","46919507","46919804","61","3577290"
"chr6","43346881","43347001","chr4","43460067","43460187","13","113186"
"chr6","43379643","43379941","chr4","43495258","43495563","37","115615"
"chr6","43405313","43405591","chr1","11251860","11252129","56","32153453"
"chr6","43407602","43407799","chr2","53269651","53269834","48","9862049"
"chr6","43416857","43417163","chr4","43531534","43531851","61","114677"
"chr6","43438537","43438826","chr1","122104598","122104888","52","78666061"
"chr6","43447134","43447429","chr4","43562609","43562911","23","115475"
"chr6","43473460","43473761","chr4","43588967","43589272","17","115507"
"chr6","43474088","43474334","chr4","43589581","43589856","48","115493"
"chr6","43485749","43486004","chr3","36587520","36587775","61","6898229"
"chr6","43501728","43502004","chr1","37126383","37126644","70","6375345"
"chr6","43509758","43510074","chr4","43624427","43624705","52","114669"
"chr6","43549276","43549556","chr4","43666270","43666550","18","116994"
"chr6","43556765","43556990","chr4","43673851","43674075","17","117086"
"chr6","43585312","43585583","chr6","137204798","137205056","55","93619486"
"chr6","43587298","43587466","chr4","40658003","40658162","48","2929295"
"chr6","43588595","43588916","chr4","43701227","43701546","24","112632"
"chr6","43597976","43598051","chr7","651487","651564","15","42946489"
"chr6","43602399","43602514","chr8","91925230","91925347","15","48322831"
"chr6","43608320","43608661","chr12","120705770","120706089","73","77097450"
"chr6","43615157","43615208","chr20","15700514","15700570","9","27914643"
"chr6","43638218","43638365","chr18","70047695","70047842","21","26409477"
"chr6","43638652","43638668","chr1","50498351","50498368","8","6859699"
"chr6","43638972","43639108","chr20","56251419","56251543","17","12612447"
"chr6","43640682","43640983","chr5","86867827","86868121","59","43227145"
"chr6","43665862","43666139","chr4","43782145","43782424","21","116283"
"chr6","43677674","43677967","chr4","43794422","43794716","24","116748"
"chr6","43679771","43679871","chr4","43795759","43795851","10","115988"
"chr6","43687133","43687413","chr4","43803708","43803988","16","116575"
"chr6","43689994","43690117","chr4","43806316","43806440","8","116322"
"chr6","43697383","43697643","chr4","43813747","43814004","22","116364"
"chr6","43701140","43701416","chr4","43819355","43819630","26","118215"
"chr6","43702526","43702739","chr4","43820399","43820612","14","117873"
"chr6","43713134","43713441","chr4","43831279","43831575","29","118145"
"chr6","43740273","43740586","chr3","21279895","21280200","61","22460378"
"chr6","43743185","43743353","chr1","218816649","218816824","40","175073464"
"chr6","43755097","43755387","chr4","43879415","43879692","25","124318"
"chr6","43787902","43788196","chr4","43914632","43914923","20","126730"
"chr6","43833443","43833720","chr4","43959218","43959508","38","125775"
"chr6","43879961","43880270","chr4","44009886","44010178","40","129925"
"chr6","43892130","43892443","chr4","44021884","44022174","48","129754"
"chr6","43943811","43943934","chr8","22115443","22115570","28","21828368"
"chr6","43950907","43951124","chr4","44080095","44080313","16","129188"
"chr6","43965927","43966155","chr8","22085064","22085297","56","21880863"
"chr6","43974212","43974506","chr4","107240930","107241233","54","63266718"
"chr6","43979001","43979278","chr4","44110011","44110289","17","131010"
"chr6","43992764","43993064","chr4","44125360","44125661","23","132596"
"chr6","43994792","43995050","chr3","180242810","180243067","49","136248018"
"chr6","43997602","43997925","chr4","44129369","44129683","33","131767"
"chr6","43998756","43999006","chr4","44130596","44130804","64","131840"
"chr6","44010250","44010529","chr2","68173712","68173989","52","24163462"
"chr6","44022559","44022853","chr12","112422945","112423240","64","68400386"
"chr6","44024215","44024503","chr4","44155927","44156235","40","131712"
"chr6","44039572","44039845","chr4","44172365","44172656","41","132793"
"chr6","44039911","44040039","chr4","44172702","44172828","9","132791"
"chr6","44040343","44040493","chr4","44173120","44173286","28","132777"
"chr6","44042200","44042489","chr5","80475344","80475637","54","36433144"
"chr6","44052268","44052425","chr4","44184315","44184468","18","132047"
"chr6","44052719","44052856","chr7","68600385","68600519","30","24547666"
"chr6","44087917","44088043","chr4","44220646","44220775","13","132729"
"chr6","44104502","44104737","chr4","44238547","44238783","23","134045"
"chr6","44113505","44113788","chr4","44249195","44249484","28","135690"
"chr6","44115631","44115799","chr4","44251915","44252119","47","136284"
"chr6","44116095","44116214","chr4","44252420","44252538","13","136325"
"chr6","44120932","44121056","chr1","200289163","200289285","16","156168231"
"chr6","44205268","44205599","chr4","44380096","44380413","29","174828"
"chr6","44206442","44206716","chr4","44381259","44381521","25","174817"
"chr6","44208419","44208700","chr4","44382856","44383124","43","174437"
"chr6","44210066","44210359","chr4","44384834","44385131","23","174768"
"chr6","44211218","44211552","chr9","12347192","12347511","87","31864026"
"chr6","44250045","44250327","chr4","44426328","44426614","30","176283"
"chr6","44258814","44259106","chr4","44436568","44436860","22","177754"
"chr6","44261620","44261765","chr4","44439345","44439491","8","177725"
"chr6","44261776","44262077","chr4","44439502","44439801","23","177726"
"chr6","44262555","44262843","chr4","44440545","44440840","30","177990"
"chr6","44271466","44271682","chr5","56540327","56540546","40","12268861"
"chr6","44309888","44310000","chr8","96949211","96949317","17","52639323"
"chr6","44354926","44355277","chr4","44537230","44537583","26","182304"
"chr6","44367018","44367337","chr4","44550570","44550889","16","183552"
"chr6","44419882","44420188","chr4","44604656","44604973","31","184774"
"chr6","44445635","44445944","chr4","44629637","44629940","42","184002"
"chr6","44447130","44447421","chr4","44631100","44631381","35","183970"
"chr6","44450954","44451197","chr4","44635396","44635665","34","184442"
"chr6","44453645","44453916","chr4","44638685","44638980","45","185040"
"chr6","44462455","44462753","chr4","44650330","44650552","88","187875"
"chr6","44469579","44469789","chr4","44657493","44657728","36","187914"
"chr6","44472815","44473076","chr11","123624521","123624780","77","79151706"
"chr6","44482923","44483088","chr3","126621167","126621327","24","82138244"
"chr6","44483348","44483476","chr4","44670034","44670164","14","186686"
"chr6","44485352","44485588","chr4","44672007","44672242","15","186655"
"chr6","44526266","44526450","chr10","31228290","31228480","42","13297976"
"chr6","44549881","44550180","chr4","44738918","44739218","16","189037"
"chr6","44571444","44571461","chr8","9819296","9819310","3","34752148"
"chr6","44571488","44571634","chr8","31559018","31559164","36","13012470"
"chr6","44571934","44572081","chr4","44762182","44762328","16","190248"
"chr6","44606203","44606446","chr3","126794297","126794543","46","82188094"
"chr6","44609620","44609927","chr12","63553793","63554094","56","18944173"
"chr6","44628519","44628766","chr4","44868945","44869196","17","240426"
"chr6","44692657","44692923","chr4","44932907","44933170","18","240250"
"chr6","44702918","44703050","chr19","33727543","33727676","23","10975375"
"chr6","44707130","44707434","chr4","44952754","44953054","19","245624"
"chr6","44717205","44717489","chr3","124267629","124267922","57","79550424"
"chr6","44783069","44783370","chr4","45029972","45030280","32","246903"
"chr6","44862595","44862866","chr4","45107925","45108219","40","245330"
"chr6","44881299","44881557","chr10","86793713","86793974","59","41912414"
"chr6","44901397","44901687","chr2","95262701","95262998","60","50361304"
"chr6","44916033","44916172","chr4","45160774","45160912","10","244741"
"chr6","44963692","44963805","chr4","45209268","45209381","11","245576"
"chr6","44966652","44966898","chr4","45212220","45212464","22","245568"
"chr6","44967154","44967288","chr6","38241059","38241193","21","6726095"
"chr6","44967876","44968175","chr4","45213438","45213733","48","245562"
"chr6","44999229","44999404","chr18","20753376","20753553","45","24245853"
"chr6","44999433","44999543","chr1","20201040","20201149","22","24798393"
"chr6","45005280","45005446","chr20","21685848","21686018","40","23319432"
"chr6","45024182","45024465","chr4","45272124","45272406","20","247942"
"chr6","45026020","45026317","chr4","45273967","45274260","28","247947"
"chr6","45045161","45045398","chr7","68638390","68638612","56","23593229"
"chr6","45048955","45049258","chr4","45298220","45298515","25","249265"
"chr6","45050241","45050547","chr4","45299148","45299456","23","248907"
"chr6","45059826","45060119","chr4","45310258","45310549","26","250432"
"chr6","45068452","45068618","chr4","45319980","45320144","12","251528"
"chr6","45089879","45090185","chr4","45337981","45338284","30","248102"
"chr6","45090447","45090720","chr14","65586411","65586685","79","20495964"
"chr6","45092336","45092603","chr8","29321410","29321692","66","15770926"
"chr6","45093449","45093690","chr7","49378464","49378703","51","4285015"
"chr6","45177301","45177612","chr4","45425496","45425803","28","248195"
"chr6","45195083","45195175","chr2","184439175","184439260","23","139244092"
"chr6","45203407","45203698","chr4","45451424","45451704","35","248017"
"chr6","45225133","45225431","chr20","28651476","28651780","59","16573657"
"chr6","45232803","45233067","chr12","82412741","82413001","59","37179938"
"chr6","45237691","45237990","chr6","68750302","68750588","66","23512611"
"chr6","45238884","45238993","chr4","45486465","45486574","7","247581"
"chr6","45249131","45249441","chr4","45496998","45497306","18","247867"
"chr6","45262580","45262863","chr4","45510126","45510419","24","247546"
"chr6","45271991","45272276","chr4","45519255","45519559","34","247264"
"chr6","45277292","45277567","chr4","45524865","45525140","23","247573"
"chr6","45291561","45291861","chr4","45546161","45546472","27","254600"
"chr6","45292518","45292640","chr4","45547070","45547192","12","254552"
"chr6","45332034","45332122","chr4","45586026","45586119","9","253992"
"chr6","45333080","45333204","chr4","45587065","45587189","9","253985"
"chr6","45337863","45338147","chr4","45592207","45592504","41","254344"
"chr6","45339764","45340066","chr10","70947259","70947566","67","25607495"
"chr6","45421416","45421719","chr4","45677423","45677722","28","256007"
"chr6","45426374","45426628","chr4","45682359","45682623","29","255985"
"chr6","45444100","45444392","chr4","45700600","45700889","28","256500"
"chr6","45472361","45472647","chr4","45718537","45718807","34","246176"
"chr6","45476933","45477211","chr4","45721736","45722018","32","244803"
"chr6","45479097","45479372","chr4","45723907","45724192","33","244810"
"chr6","45496295","45496457","chr7","125567568","125567723","59","80071273"
"chr6","45668965","45669205","chrX","48756183","48756428","56","3087218"
"chr6","45680107","45680415","chr4","45914887","45915201","21","234780"
"chr6","45694760","45695045","chr4","45929634","45929915","35","234874"
"chr6","45697486","45697761","chr4","45932280","45932569","46","234794"
"chr6","45698829","45699118","chr4","45933635","45933923","16","234806"
"chr6","45790922","45791223","chr4","46022757","46023056","34","231835"
"chr6","45852329","45852622","chr3","40919794","40920108","90","4932535"
"chr6","45855583","45855702","chr10","73131386","73131503","23","27275803"
"chr6","45855785","45855953","chr8","38485023","38485195","35","7370762"
"chr6","45878913","45879208","chr6","78143135","78143436","53","32264222"
"chr6","45925921","45926187","chr4","46162530","46162793","37","236609"
"chr6","45943643","45943953","chr4","46181861","46182166","27","238218"
"chr6","46023956","46024194","chrX","23907809","23908047","59","22116147"
"chr6","46027700","46027985","chr4","46281298","46281580","23","253598"
"chr6","46076136","46076404","chr4","46323923","46324191","24","247787"
"chr6","46087981","46088072","chr4","46336560","46336655","10","248579"
"chr6","46088353","46088510","chr4","46336931","46337091","16","248578"
"chr6","46105392","46105679","chr4","46352661","46352949","22","247269"
"chr6","46116899","46117194","chr4","46364420","46364722","36","247521"
"chr6","46151220","46151513","chr4","46392586","46392879","23","241366"
"chr6","46218415","46218710","chr4","46456996","46457291","16","238581"
"chr6","46242527","46242831","chr4","46481151","46481454","16","238624"
"chr6","46263405","46263690","chr4","46501774","46502057","27","238369"
"chr6","46272890","46273204","chr16","58313322","58313631","67","12040432"
"chr6","46303967","46304272","chr4","46530335","46530658","41","226368"
"chr6","46378044","46378332","chr4","46604994","46605283","17","226950"
"chr6","46428495","46428764","chr4","46700657","46700926","12","272162"
"chr6","46432329","46432630","chr4","46704474","46704783","30","272145"
"chr6","46440686","46440939","chr4","46712703","46712951","32","272017"
"chr6","46543757","46544046","chr4","46815833","46816125","24","272076"
"chr6","46594262","46594526","chr4","46863698","46863987","33","269436"
"chr6","46929146","46929262","chr14","31928471","31928586","19","15000675"
"chr6","46929288","46929466","chr6","67624317","67624495","36","20695029"
"chr6","47020823","47021105","chrX","113690093","113690380","65","66669270"
"chr6","47137191","47137480","chr4","104017221","104017514","62","56880030"
"chr6","47185198","47185295","chr19","50750460","50750554","16","3565262"
"chr6","47315236","47315537","chr4","47556931","47557248","35","241695"
"chr6","47465315","47465599","chr4","47702711","47702988","24","237396"
"chr6","47471139","47471387","chr4","47708609","47708881","36","237470"
"chr6","47477329","47477488","chr4","47715089","47715236","19","237760"
"chr6","47490367","47490677","chr4","47728284","47728595","23","237917"
"chr6","47505272","47505584","chr4","47742042","47742342","31","236770"
"chr6","47511394","47511682","chr4","47748449","47748737","20","237055"
"chr6","47731353","47731626","chr4","47971399","47971679","30","240046"
"chr6","47757887","47758016","chr11","50179416","50179546","17","2421529"
"chr6","47760204","47760513","chr4","48000004","48000318","60","239800"
"chr6","47791540","47791837","chr4","48032040","48032313","55","240500"
"chr6","47869131","47869422","chr4","48108794","48109086","22","239663"
"chr6","47930326","47930620","chr4","48169482","48169794","39","239156"
"chr6","47957715","47957941","chr20","20842445","20842684","65","27115270"
"chr6","47998980","47999295","chr4","48240789","48241102","32","241809"
"chr6","48041280","48041569","chr4","48280543","48280852","42","239263"
"chr6","48146580","48146847","chr3","13980772","13981038","67","34165808"
"chr6","48155720","48156032","chr4","48386406","48386700","38","230686"
"chr6","48175802","48175931","chr4","48402611","48402742","8","226809"
"chr6","48175990","48176300","chr4","48402803","48403106","29","226813"
"chr6","48197133","48197424","chr4","48424897","48425190","22","227764"
"chr6","48226204","48226489","chr4","48455608","48455900","27","229404"
"chr6","48240884","48241142","chr3","38404877","38405140","61","9836007"
"chr6","48256537","48256760","chr4","48485843","48486081","43","229306"
"chr6","48260500","48260727","chr4","48489502","48489728","22","229002"
"chr6","48260856","48261164","chr4","48489857","48490163","36","229001"
"chr6","48263669","48263912","chr4","48492693","48492920","28","229024"
"chr6","48297078","48297199","chr4","48524252","48524371","6","227174"
"chr6","48302909","48303077","chr8","32078857","32079017","45","16224052"
"chr6","48311518","48311824","chr7","156977987","156978291","61","108666469"
"chr6","48316153","48316458","chr4","48543829","48544139","36","227676"
"chr6","48333351","48333645","chr18","36205933","36206221","66","12127418"
"chr6","48340116","48340363","chr4","48567430","48567681","23","227314"
"chr6","48341432","48341740","chr4","48569078","48569394","27","227646"
"chr6","48343789","48344054","chr1","154707307","154707583","64","106363518"
"chr6","48406160","48406457","chr4","36484206","36484512","65","11921954"
"chr6","48425402","48425695","chr4","48656176","48656469","31","230774"
"chr6","48439013","48439314","chr4","48669860","48670163","30","230847"
"chr6","48449785","48450101","chr4","48680614","48680926","34","230829"
"chr6","48463965","48464277","chr4","48695997","48696301","16","232032"
"chr6","48501602","48501897","chr4","48738513","48738822","31","236911"
"chr6","48626065","48626367","chr16","52106549","52106857","64","3480484"
"chr6","48769018","48769303","chr4","49007061","49007366","40","238043"
"chr6","48795731","48796028","chr4","49034477","49034763","34","238746"
"chr6","48980717","48981010","chr4","49218362","49218661","29","237645"
"chr6","48988669","48988941","chr4","49226858","49227127","17","238189"
"chr6","49053217","49053502","chr1","109829297","109829579","55","60776080"
"chr6","49387031","49387336","chr4","49630401","49630695","31","243370"
"chr6","49408003","49408130","chr4","25099847","25099971","27","24308156"
"chr6","49575778","49575906","chr4","49811688","49811810","19","235910"
"chr6","49664050","49664350","chr4","49891419","49891722","32","227369"
"chr6","49676917","49677219","chr4","49905043","49905330","39","228126"
"chr6","49692578","49692861","chr4","49922955","49923229","25","230377"
"chr6","49692876","49693170","chr4","49923247","49923539","22","230371"
"chr6","49696093","49696221","chr4","49926460","49926586","12","230367"
"chr6","49910632","49910905","chr4","50130389","50130704","59","219757"
"chr6","49946532","49946753","chr2","69607089","69607299","50","19660557"
"chr6","49957543","49957840","chr16","57827840","57828140","66","7870297"
"chr6","50008024","50008293","chr4","50216145","50216427","38","208121"
"chr6","50022516","50022647","chr2","165531071","165531193","22","115508555"
"chr6","50083250","50083544","chr4","50277592","50277885","27","194342"
"chr6","50089564","50089865","chr3","50349339","50349621","101","259775"
"chr6","50194982","50195268","chr4","50387524","50387808","51","192542"
"chr6","50345797","50346060","chr10","26768717","26768984","59","23577080"
"chr6","50347959","50348121","chr3","49992810","49992973","32","355149"
"chr6","50370027","50370153","chr1","205464254","205464380","18","155094227"
"chr6","50413313","50413612","chr4","50594380","50594676","26","181067"
"chr6","50423725","50424011","chr20","33500619","33500904","68","16923106"
"chr6","50437953","50438059","chr4","50609996","50610104","24","172043"
"chr6","50513096","50513180","chr17","47040050","47040131","16","3473046"
"chr6","50576731","50577051","chr4","50768080","50768360","66","191349"
"chr6","50670076","50670383","chr4","50853170","50853497","43","183094"
"chr6","50983366","50983628","chr4","51172101","51172399","54","188735"
"chr6","50999315","50999616","chr4","51187873","51188174","31","188558"
"chr6","51191000","51191156","chr4","51376149","51376301","15","185149"
"chr6","51254187","51254454","chr4","51440362","51440635","28","186175"
"chr6","51296956","51297256","chr4","51483537","51483832","27","186581"
"chr6","51326450","51326691","chr11","75270851","75271089","64","23944401"
"chr6","51339589","51339898","chr4","51529605","51529901","35","190016"
"chr6","51354295","51354603","chr4","51544217","51544525","23","189922"
"chr6","51394346","51394630","chr4","51583092","51583393","34","188746"
"chr6","51493678","51493970","chr4","51676006","51676296","23","182328"
"chr6","51497160","51497425","chr4","51679816","51680107","48","182656"
"chr6","51500964","51501245","chr4","51683643","51683905","32","182679"
"chr6","51602930","51603115","chr2","22534822","22535005","41","29068108"
"chr6","51604497","51604672","chr4","51791132","51791304","28","186635"
"chr6","51614513","51614765","chr4","51801264","51801515","10","186751"
"chr6","51625485","51625793","chr4","51811910","51812200","47","186425"
"chr6","51630002","51630288","chr6","170625527","170625818","55","118995525"
"chr6","51684365","51684650","chr4","51869937","51870222","15","185572"
"chr6","51689080","51689192","chr4","51874979","51875091","7","185899"
"chr6","51747796","51748089","chr4","51924612","51924897","31","176816"
"chr6","51772119","51772415","chr4","51948783","51949081","25","176664"
"chr6","51805972","51806242","chr4","51982817","51983116","45","176845"
"chr6","51855709","51855999","chr4","52026163","52026432","37","170454"
"chr6","51924000","51924291","chr4","52092323","52092621","39","168323"
"chr6","52048336","52048632","chr4","52207796","52208090","33","159460"
"chr6","52444835","52445008","chr5","165017863","165018037","39","112573028"
"chr6","52455699","52456011","chr9","106607385","106607691","71","54151686"
"chr6","52556876","52557189","chr4","52712680","52712993","24","155804"
"chr6","52568654","52568768","chr4","52724493","52724607","9","155839"
"chr6","52578948","52579238","chr14","35840140","35840420","62","16738808"
"chr6","52668844","52669152","chr4","52824948","52825255","28","156104"
"chr6","52710947","52711048","chr4","52867595","52867695","10","156648"
"chr6","52823519","52823829","chr4","52974697","52975008","20","151178"
"chr6","52879713","52879999","chr4","53030914","53031207","21","151201"
"chr6","52931167","52931469","chr4","53075449","53075768","38","144282"
"chr6","52967901","52968138","chr4","53111339","53111581","20","143438"
"chr6","52983862","52984147","chr1","155141171","155141450","62","102157309"
"chr6","53027493","53027767","chr4","53172611","53172893","47","145118"
"chr6","53040442","53040728","chr4","53186033","53186319","20","145591"
"chr6","53047806","53048116","chr4","53193710","53194011","31","145904"
"chr6","53055938","53056095","chr4","53199657","53199808","11","143719"
"chr6","53056131","53056252","chr4","53199857","53199979","6","143726"
"chr6","53073125","53073416","chr2","72592847","72593136","55","19519722"
"chr6","53079764","53080044","chr4","53224669","53224950","18","144905"
"chr6","53085920","53086046","chr4","53231731","53231858","13","145811"
"chr6","53094956","53095252","chr4","53240492","53240792","54","145536"
"chr6","53101931","53102227","chr4","53247818","53248113","14","145887"
"chr6","53110030","53110304","chr4","53257547","53257822","32","147517"
"chr6","53122885","53123195","chr4","53274897","53275208","38","152012"
"chr6","53129638","53129928","chr4","53281813","53282107","27","152175"
"chr6","53169273","53169558","chr4","53326305","53326595","19","157032"
"chr6","53171713","53172008","chr4","53329027","53329287","49","157314"
"chr6","53212910","53213210","chr4","53417560","53417865","26","204650"
"chr6","53271525","53271830","chr4","53477847","53478155","17","206322"
"chr6","53300688","53300957","chr4","53508864","53509150","44","208176"
"chr6","53311782","53312071","chr4","53520054","53520343","17","208272"
"chr6","53442347","53442644","chr4","53651151","53651452","19","208804"
"chr6","53460526","53460806","chr4","53667553","53667848","31","207027"
"chr6","53475734","53476040","chr4","53679721","53680023","25","203987"
"chr6","53483899","53484043","chr4","53688350","53688505","20","204451"
"chr6","53562748","53562970","chr3","150879509","150879729","63","97316761"
"chr6","53604569","53604866","chr4","53783691","53783985","30","179122"
"chr6","54099425","54099741","chr3","35052808","35053125","63","19046617"
"chr6","54164547","54164844","chr4","53891211","53891507","18","273336"
"chr6","54183510","54183717","chr14","66911348","66911552","56","12727838"
"chr6","54213365","54213640","chr4","53939257","53939522","25","274108"
"chr6","54240922","54241218","chr11","26295789","26296087","70","27945133"
"chr6","54271447","54271746","chrX","147369436","147369734","57","93097989"
"chr6","54279962","54280233","chr1","155141171","155141450","70","100861209"
"chr6","54283584","54283736","chr4","54013155","54013313","16","270429"
"chr6","54289503","54289798","chr4","54019058","54019373","36","270445"
"chr6","54292292","54292581","chr4","54021892","54022172","49","270400"
"chr6","54311147","54311382","chr4","54041436","54041671","14","269711"
"chr6","54334470","54334778","chr4","159090526","159090826","67","104756056"
"chr6","54336869","54337150","chr4","54067766","54068044","25","269103"
"chr6","54351002","54351313","chr4","54081952","54082263","18","269050"
"chr6","54356358","54356539","chr5","174758600","174758778","64","120402242"
"chr6","54357709","54357830","chr3","157449830","157449952","18","103092121"
"chr6","54370372","54370668","chr20","26858843","26859139","68","27511529"
"chr6","54375352","54375643","chr13","25733339","25733643","56","28642013"
"chr6","54380561","54380777","chr4","54113251","54113461","45","267310"
"chr6","54395781","54395916","chr3","121632762","121632897","23","67236981"
"chr6","54418586","54418872","chr11","63430667","63430952","59","9012081"
"chr6","54419856","54420140","chr5","184090450","184090735","53","129670594"
"chr6","54462481","54462610","chr1","117811669","117811797","16","63349188"
"chr6","54476458","54476761","chr4","54213324","54213623","25","263134"
"chr6","54501502","54501789","chr4","54238484","54238781","23","263018"
"chr6","54519415","54519702","chr4","54253811","54254089","25","265604"
"chr6","54675620","54675927","chr13","45006370","45006675","60","9669250"
"chr6","54685017","54685185","chr18","14130253","14130415","38","40554764"
"chr6","54761829","54761912","chr3","7380073","7380155","22","47381756"
"chr6","54762588","54762705","chr17","420062","420179","12","54342526"
"chr6","54806145","54806356","chr4","54542586","54542798","11","263559"
"chr6","54817411","54817591","chr4","54554222","54554405","13","263189"
"chr6","54831701","54831971","chr3","39358673","39358948","59","15473028"
"chr6","54983691","54983991","chr4","54729073","54729356","41","254618"
"chr6","55041707","55041858","chr4","54786252","54786407","14","255455"
"chr6","55059565","55059856","chrX","19763323","19763616","57","35296242"
"chr6","55093045","55093317","chr4","54838946","54839234","31","254099"
"chr6","55126095","55126324","chr4","54872729","54872963","20","253366"
"chr6","55144122","55144254","chr3","38686954","38687086","19","16457168"
"chr6","55195690","55196005","chr4","54986506","54986820","40","209184"
"chr6","55290057","55290378","chrX","59815962","59816277","64","4525905"
"chr6","55429273","55429571","chr4","55274013","55274323","43","155260"
"chr6","55506448","55506759","chr4","55350380","55350687","24","156068"
"chr6","55699503","55699844","chr5","77761125","77761437","86","22061622"
"chr6","55768127","55768419","chr4","55602220","55602509","21","165907"
"chr6","55781498","55781787","chr7","71549523","71549809","52","15768025"
"chr6","55796638","55796939","chrX","101668164","101668460","71","45871526"
"chr6","55828513","55828792","chr4","55660592","55660868","18","167921"
"chr6","56001322","56001634","chr4","55843449","55843736","43","157873"
"chr6","56003615","56003938","chr4","55845871","55846156","61","157744"
"chr6","56278891","56279219","chr4","56113498","56113813","70","165393"
"chr6","56351087","56351295","chr4","56178236","56178444","19","172851"
"chr6","56396661","56396978","chr4","56223232","56223552","24","173429"
"chr6","56415848","56416094","chr4","56242146","56242383","24","173702"
"chr6","56576213","56576504","chr4","56395229","56395511","26","180984"
"chr6","56855688","56855958","chr4","56675146","56675405","24","180542"
"chr6","56931221","56931493","chr4","56738701","56738971","21","192520"
"chr6","57023323","57023604","chr4","56829473","56829766","32","193850"
"chr6","57079183","57079305","chr4","56885346","56885472","9","193837"
"chr6","57405699","57405991","chr11","118040872","118041169","73","60635173"
"chr6","57532232","57532530","chr7","50799934","50800222","61","6732298"
"chr6","57556252","57556536","chr4","57349917","57350201","15","206335"
"chr6","57686512","57686721","chr4","57490796","57491004","21","195716"
"chr6","57766603","57766841","chr4","57569731","57569955","43","196872"
"chr6","57768731","57769037","chr4","57571831","57572142","26","196900"
"chr6","57857146","57857231","chr4","57653291","57653374","6","203855"
"chr6","57866508","57866782","chr4","57663142","57663416","21","203366"
"chr6","57868654","57868946","chr20","69197985","69198281","56","11329331"
"chr6","57934893","57935200","chr4","57740171","57740469","32","194722"
"chr6","57980580","57980889","chr7","167498832","167499147","57","109518252"
"chr6","57999070","57999342","chr4","57803756","57804026","16","195314"
"chr6","58034876","58035154","chr4","57841621","57841902","16","193255"
"chr6","58044857","58045166","chr4","57852433","57852753","32","192424"
"chr6","58062468","58062762","chr4","57864874","57865171","22","197594"
"chr6","58076660","58076867","chr4","57878510","57878720","23","198150"
"chr6","58085032","58085332","chr4","57886269","57886564","23","198763"
"chr6","58100295","58100586","chr4","57901841","57902136","21","198454"
"chr6","58128225","58128502","chr4","57930296","57930589","34","197929"
"chr6","58132718","58133031","chr16","48847811","48848122","64","9284907"
"chr6","58154223","58154517","chr4","57957342","57957642","27","196881"
"chr6","58158016","58158322","chr4","57962513","57962828","31","195503"
"chr6","58167346","58167639","chr4","57971870","57972164","19","195476"
"chr6","58167672","58167971","chr4","57972178","57972491","43","195494"
"chr6","58173610","58173926","chr4","57978776","57979093","25","194834"
"chr6","58197191","58197403","chr4","58002861","58003073","11","194330"
"chr6","58213236","58213414","chr1","34794671","34794845","51","23418565"
"chr6","58218438","58218537","chr4","44669677","44669775","17","13548761"
"chr6","58225532","58225661","chr4","58028379","58028495","22","197153"
"chr6","58245870","58246130","chr3","166823723","166823967","57","108577853"
"chr6","58250147","58250267","chr1","139862049","139862167","21","81611902"
"chr6","58254947","58255160","chr14","66911348","66911552","38","8656401"
"chr6","58276902","58277199","chr4","58084676","58084974","22","192226"
"chr6","58304079","58304360","chr4","58112213","58112488","39","191866"
"chr6","58321522","58321696","chr4","58130431","58130605","7","191091"
"chr6","58328795","58329071","chr4","58138804","58139069","27","189991"
"chr6","58338469","58338589","chr4","58148401","58148524","10","190068"
"chr6","58380400","58380674","chr4","58191816","58192093","19","188584"
"chr6","58386216","58386390","chr9","23416072","23416242","45","34970144"
"chr6","58386427","58386542","chr3","64873136","64873250","16","6486709"
"chr6","58399608","58399928","chr4","58210655","58210964","35","188953"
"chr6","58401039","58401354","chr4","58212097","58212395","39","188942"
"chr6","58455949","58456034","chr4","58264760","58264843","9","191189"
"chr6","58500698","58500989","chr4","58294658","58294948","22","206040"
"chr6","58512277","58512563","chr4","58305700","58305991","26","206577"
"chr6","58522949","58523116","chr20","42893660","42893842","42","15629289"
"chr6","58535569","58535732","chr4","108510252","108510420","36","49974683"
"chr6","64484895","64485025","chr4","59426394","59426510","18","5058501"
"chr6","64532720","64532991","chr4","59471998","59472268","21","5060722"
"chr6","64536102","64536413","chr4","59475346","59475657","23","5060756"
"chr6","64867631","64867947","chr4","59787404","59787716","20","5080227"
"chr6","64882686","64882760","chr1","66663122","66663196","16","1780436"
"chr6","64884154","64884431","chr5","168811181","168811467","67","103927027"
"chr6","64991273","64991608","chr2","54477146","54477449","87","10514127"
"chr6","65019064","65019355","chr4","59928816","59929099","39","5090248"
"chr6","65053931","65054206","chr4","59962661","59962916","47","5091270"
"chr6","65273252","65273440","chr3","159424290","159424479","12","94151038"
"chr6","65514179","65514487","chr4","60424617","60424911","37","5089562"
"chr6","65572086","65572343","chr8","48756908","48757164","71","16815178"
"chr6","65728604","65728892","chr4","60669976","60670245","38","5058628"
"chr6","66006618","66006931","chr4","60901414","60901720","31","5105204"
"chr6","66056404","66056725","chr4","60943265","60943568","42","5113139"
"chr6","66140223","66140491","chr11","122316451","122316715","57","56176228"
"chr6","66237845","66238119","chr4","61233566","61233855","43","5004279"
"chr6","66252408","66252674","chr4","61248155","61248434","24","5004253"
"chr6","66311163","66311417","chr3","126284406","126284664","59","59973243"
"chr6","66356062","66356338","chr19","12955961","12956226","74","53400101"
"chr6","66356932","66357198","chr6","135980278","135980539","58","69623346"
"chr6","66366177","66366472","chr4","61341728","61342015","22","5024449"
"chr6","66379879","66380163","chr4","61357915","61358197","24","5021964"
"chr6","66381212","66381502","chr4","61359612","61359910","24","5021600"
"chr6","66417408","66417517","chr4","61400150","61400252","13","5017258"
"chr6","66424182","66424406","chr4","61406711","61406936","8","5017471"
"chr6","66442090","66442267","chr4","61425777","61425954","12","5016313"
"chr6","66523723","66523942","chr4","61507234","61507443","20","5016489"
"chr6","66564897","66565182","chr11","28864325","28864608","67","37700572"
"chr6","66607597","66607714","chr4","61591383","61591500","6","5016214"
"chr6","66655183","66655485","chr4","61645505","61645808","17","5009678"
"chr6","67091987","67092072","chr10","40874887","40874970","16","26217100"
"chr6","67345217","67345526","chr16","52106549","52106857","77","15238668"
"chr6","67380888","67381011","chr4","6988605","6988727","20","60392283"
"chr6","67440583","67440863","chr4","64327224","64327509","29","3113359"
"chr6","67444195","67444488","chr4","64334555","64334836","33","3109640"
"chr6","67464231","67464533","chr4","64355011","64355314","49","3109220"
"chr6","67464702","67464965","chr4","64355483","64355756","30","3109219"
"chr6","67564352","67564640","chr1","200620309","200620594","71","133055957"
"chr6","67610242","67610407","chr4","64541240","64541414","19","3069002"
"chr6","67638991","67639285","chr3","39030707","39030995","74","28608284"
"chr6","67730127","67730411","chr4","64648547","64648827","23","3081580"
"chr6","67800817","67801070","chr4","64746296","64746517","40","3054521"
"chr6","67828482","67828733","chr4","64774872","64775131","25","3053610"
"chr6","67849117","67849393","chrX","111121175","111121456","23","43272058"
"chr6","67911029","67911330","chr4","64856238","64856539","30","3054791"
"chr6","68008056","68008200","chr18","70047695","70047842","27","2039639"
"chr6","68136397","68136697","chr11","101302640","101302936","73","33166243"
"chr6","68206198","68206497","chr4","65138152","65138451","30","3068046"
"chr6","68438807","68439082","chr4","65437635","65437920","36","3001172"
"chr6","68546753","68546934","chr4","65549436","65549602","23","2997317"
"chr6","68568923","68569216","chr4","65577687","65577979","39","2991236"
"chr6","68616597","68616821","chr7","40111984","40112209","70","28504613"
"chr6","68740727","68740962","chr4","65730068","65730351","59","3010659"
"chr6","68744108","68744232","chr10","11185184","11185310","23","57558924"
"chr6","68839669","68839977","chr4","65824150","65824456","42","3015519"
"chr6","68851166","68851460","chr4","65833417","65833709","20","3017749"
"chr6","68864102","68864146","chr1","46197074","46197116","11","22667028"
"chr6","68999747","68999922","chrX","5313319","5313490","44","63686428"
"chr6","69089015","69089298","chr4","66044724","66044973","51","3044291"
"chr6","69128260","69128368","chr4","66085086","66085194","5","3043174"
"chr6","69144300","69144615","chr4","66104012","66104328","24","3040288"
"chr6","69238523","69238623","chr5","1889927","1890031","21","67348596"
"chr6","69323014","69323309","chr4","66290101","66290386","33","3032913"
"chr6","69338619","69338897","chr4","66302865","66303146","29","3035754"
"chr6","69458614","69458664","chr5","141212210","141212261","11","71753596"
"chr6","69458670","69458754","chr13","28430056","28430142","15","41028614"
"chr6","69462335","69462621","chr1","182642228","182642528","70","113179893"
"chr6","69645941","69646246","chr10","29222178","29222468","81","40423763"
"chr6","69831279","69831484","chr4","66839209","66839413","11","2992070"
"chr6","69922162","69922292","chr1","100904012","100904142","25","30981850"
"chr6","69922330","69922536","chr1","207599086","207599289","60","137676756"
"chr6","69954360","69954677","chr4","66964385","66964703","30","2989975"
"chr6","70052688","70052970","chr4","67059562","67059835","24","2993126"
"chr6","70099027","70099315","chr4","67102891","67103179","22","2996136"
"chr6","70124127","70124403","chr4","67127612","67127890","27","2996515"
"chr6","70247422","70247514","chr4","67251009","67251101","5","2996413"
"chr6","70343749","70344041","chr4","67344866","67345158","17","2998883"
"chr6","70495967","70496276","chr4","67497110","67497418","15","2998857"
"chr6","70610447","70610735","chr2","45832248","45832529","78","24778199"
"chr6","70648881","70649004","chr4","67638300","67638423","6","3010581"
"chr6","70680071","70680278","chr4","67668435","67668634","28","3011636"
"chr6","70902133","70902258","chr16","39379692","39379819","17","31522441"
"chr6","70914564","70914720","chr4","67904560","67904698","31","3010004"
"chr6","70986171","70986395","chr4","67981068","67981282","25","3005103"
"chr6","71052139","71052440","chr20","11370789","11371088","49","59681350"
"chr6","71173263","71173559","chr4","68160464","68160761","27","3012799"
"chr6","71223491","71223698","chr4","68205912","68206129","25","3017579"
"chr6","71229596","71229886","chr1","15477611","15477890","62","55751985"
"chr6","71347142","71347442","chr4","68334761","68335060","20","3012381"
"chr6","71384632","71384921","chr7","151199043","151199333","57","79814411"
"chr6","71401533","71401827","chr5","78248054","78248351","54","6846521"
"chr6","71596488","71596792","chr2","50942501","50942809","62","20653987"
"chr6","71598686","71598935","chr8","16758019","16758271","64","54840667"
"chr6","71614625","71614917","chr4","68583769","68584060","32","3030856"
"chr6","71627581","71627766","chr4","68597310","68597486","18","3030271"
"chr6","71688506","71688798","chr12","65551151","65551448","62","6137355"
"chr6","71691780","71692091","chr4","68662233","68662537","26","3029547"
"chr6","71695740","71696005","chr4","68666233","68666486","26","3029507"
"chr6","71766022","71766166","chr4","68734512","68734655","9","3031510"
"chr6","71766465","71766639","chr4","68734952","68735127","15","3031513"
"chr6","71772816","71772974","chr4","68742644","68742797","20","3030172"
"chr6","71773270","71773404","chr4","68743123","68743258","14","3030147"
"chr6","71790187","71790478","chr4","68762013","68762307","29","3028174"
"chr6","71797088","71797200","chr4","68769437","68769549","5","3027651"
"chr6","71808140","71808453","chr4","68780718","68781038","34","3027422"
"chr6","71817209","71817371","chr17","29269902","29270063","37","42547307"
"chr6","71840548","71840821","chr1","223979328","223979622","66","152138780"
"chr6","71910168","71910473","chr4","68876109","68876411","20","3034059"
"chr6","72030455","72030641","chr4","68996813","68997003","14","3033642"
"chr6","72053457","72053727","chr6","110794870","110795151","68","38741413"
"chr6","72062279","72062568","chr4","69014016","69014313","27","3048263"
"chr6","72064648","72064939","chr4","69016378","69016662","30","3048270"
"chr6","72147143","72147378","chr12","118086742","118086983","56","45939599"
"chr6","72352403","72352708","chr4","69298199","69298508","30","3054204"
"chr6","72548882","72548908","chr3","75678546","75678568","5","3129664"
"chr6","72548935","72549218","chr9","22680458","22680739","54","49868477"
"chr6","72990122","72990402","chr4","69925219","69925496","16","3064903"
"chr6","73000118","73000231","chrX","41627824","41627940","22","31372294"
"chr6","73106472","73106784","chr4","70045477","70045767","42","3060995"
"chr6","73192418","73192730","chr4","70121762","70122064","27","3070656"
"chr6","73196396","73196557","chrX","47256571","47256728","26","25939825"
"chr6","73196596","73196718","chr3","30213653","30213773","26","42982943"
"chr6","73200914","73201197","chr4","70130107","70130390","12","3070807"
"chr6","73358284","73358597","chr4","70267576","70267883","30","3090708"
"chr6","73358760","73359044","chr9","51433347","51433628","56","21925413"
"chr6","73370863","73371133","chr4","70280954","70281230","27","3089909"
"chr6","73397080","73397399","chr4","70307498","70307785","48","3089582"
"chr6","73464255","73464340","chr4","70378910","70378995","7","3085345"
"chr6","73532221","73532509","chr17","80429135","80429431","68","6896914"
"chr6","73570447","73570739","chr4","70477451","70477740","27","3092996"
"chr6","73637492","73637786","chr4","70548484","70548780","49","3089008"
"chr6","73705953","73706074","chr4","70615562","70615684","10","3090391"
"chr6","73707535","73707809","chr1","27567653","27567928","69","46139882"
"chr6","73731319","73731620","chr4","70637223","70637533","42","3094096"
"chr6","73755023","73755314","chr1","17386249","17386538","51","56368774"
"chr6","73765057","73765365","chr4","70669418","70669721","51","3095639"
"chr6","73818293","73818601","chr4","70720924","70721237","21","3097369"
"chr6","73827336","73827597","chr4","70730059","70730321","26","3097277"
"chr6","73849499","73849820","chr4","70752156","70752476","17","3097343"
"chr6","73898204","73898387","chr3","39811273","39811452","40","34086931"
"chr6","73898435","73898551","chr4","59426394","59426510","18","14472041"
"chr6","73926472","73926750","chr4","70826813","70827091","35","3099659"
"chr6","73954719","73954955","chr18","20495148","20495386","56","53459571"
"chr6","73980481","73980785","chr4","70879075","70879384","23","3101406"
"chr6","73985499","73985767","chr4","70884441","70884736","41","3101058"
"chr6","74073875","74074005","chr1","14222547","14222679","22","59851328"
"chr6","74085024","74085133","chr4","70982219","70982326","12","3102805"
"chr6","74087217","74087524","chr4","70984376","70984683","16","3102841"
"chr6","74102520","74102788","chr4","70995566","70995837","23","3106954"
"chr6","74113400","74113684","chr4","71006054","71006340","18","3107346"
"chr6","74133903","74134162","chr4","71025239","71025492","27","3108664"
"chr6","74161693","74161837","chr12","114314971","114315115","33","40153278"
"chr6","74233662","74233959","chr4","71124523","71124808","34","3109139"
"chr6","74280139","74280437","chr4","71177565","71177861","25","3102574"
"chr6","74282020","74282319","chr4","71179760","71180065","25","3102260"
"chr6","74302170","74302461","chr4","71200248","71200539","13","3101922"
"chr6","74338074","74338375","chr4","71236418","71236719","7","3101656"
"chr6","74344852","74345066","chr4","71245412","71245626","24","3099440"
"chr6","74351544","74351812","chr4","71254449","71254719","14","3097095"
"chr6","74354062","74354347","chr4","71256950","71257241","27","3097112"
"chr6","74361487","74361800","chr4","71264301","71264587","55","3097186"
"chr6","74368897","74369272","chr5","63745856","63746154","121","10623041"
"chr6","74370541","74370829","chr4","71290753","71291046","26","3079788"
"chr6","74374485","74374631","chr20","3711592","3711730","28","70662893"
"chr6","74374926","74375121","chr2","105547394","105547578","44","31172468"
"chr6","74380610","74380890","chr4","71284699","71284979","20","3095911"
"chr6","74382489","74382605","chr4","71286586","71286702","5","3095903"
"chr6","74386446","74386757","chr4","71290753","71291046","43","3095693"
"chr6","74390097","74390373","chrX","113690093","113690380","65","39299996"
"chr6","74399351","74399483","chr4","71303238","71303373","11","3096113"
"chr6","74413869","74414020","chr4","71317729","71317880","7","3096140"
"chr6","74416748","74417047","chr4","71321253","71321542","29","3095495"
"chr6","74438713","74438957","chr1","44703053","44703293","57","29735660"
"chr6","74450685","74450902","chr2","54125294","54125509","49","20325391"
"chr6","74461254","74461559","chr4","71356198","71356479","40","3105056"
"chr6","74473075","74473383","chr4","71370463","71370784","34","3102612"
"chr6","74474209","74474412","chr4","71371621","71371812","26","3102588"
"chr6","74488662","74488821","chr11","125874797","125874955","40","51386135"
"chr6","74492007","74492253","chr4","71387080","71387326","13","3104927"
"chr6","74494350","74494674","chr4","71390737","71391014","68","3103613"
"chr6","74501612","74501728","chr4","71399135","71399265","29","3102477"
"chr6","74510526","74510802","chr4","71408767","71409043","23","3101759"
"chr6","74519360","74519493","chr1","211346570","211346699","26","136827210"
"chr6","74551718","74551843","chr3","79317830","79317957","20","4766112"
"chr6","74560858","74561027","chr4","71464012","71464181","6","3096846"
"chr6","74561879","74562042","chr11","50679656","50679828","47","23882223"
"chr6","74589007","74589304","chr15","26032599","26032903","57","48556408"
"chr6","74592462","74592757","chr4","71497074","71497354","37","3095388"
"chr6","74593250","74593373","chr4","71497856","71497978","9","3095394"
"chr6","74600110","74600401","chr4","71504844","71505129","21","3095266"
"chr6","74609467","74609675","chr10","71004722","71004936","36","3604745"
"chr6","74614577","74614875","chr4","71517233","71517531","15","3097344"
"chr6","74615603","74615895","chr4","71518254","71518552","33","3097349"
"chr6","74624113","74624424","chr4","71529835","71530149","45","3094278"
"chr6","74642811","74643103","chr4","71549945","71550239","23","3092866"
"chr6","74643475","74643726","chr4","71550610","71550845","36","3092865"
"chr6","74646035","74646327","chr4","71553168","71553464","18","3092867"
"chr6","74658665","74658783","chr20","23813948","23814064","16","50844717"
"chr6","74662311","74662603","chr11","48283444","48283741","60","26378867"
"chr6","74667390","74667692","chr4","71581444","71581748","30","3085946"
"chr6","74679597","74679718","chr20","19039356","19039474","21","55640241"
"chr6","74695866","74696169","chr2","160551205","160551504","56","85855339"
"chr6","74702045","74702121","chr4","71610485","71610563","5","3091560"
"chr6","74702850","74702978","chr4","71611298","71611426","6","3091552"
"chr6","74715617","74715890","chr4","71625587","71625874","31","3090030"
"chr6","74718717","74719058","chr10","84715472","84715807","75","9996755"
"chr6","74727897","74728114","chr16","25942172","25942394","36","48785725"
"chr6","74752595","74752906","chr4","71666670","71666978","26","3085925"
"chr6","74763639","74763890","chr1","160886968","160887208","66","86123329"
"chr6","74781008","74781124","chr1","163650110","163650227","23","88869102"
"chr6","74783878","74784178","chr4","71695659","71695949","37","3088219"
"chr6","74790287","74790503","chr2","115699750","115699969","52","40909463"
"chr6","74818673","74818804","chr4","71730798","71730935","10","3087875"
"chr6","74829861","74830148","chr4","71739474","71739760","33","3090387"
"chr6","74866422","74866706","chr4","71783275","71783591","47","3083147"
"chr6","74925570","74925653","chr10","77869469","77869553","11","2943899"
"chr6","74927972","74928237","chr4","71847977","71848243","15","3079995"
"chr6","75498564","75498673","chr3","49281441","49281553","12","26217123"
"chr6","75644761","75645054","chr15","97219285","97219576","30","21574524"
"chr6","75809740","75810015","chr4","72660536","72660845","68","3149204"
"chr6","75841017","75841308","chr4","72696698","72697001","35","3144319"
"chr6","75925471","75925775","chr4","72867008","72867313","31","3058463"
"chr6","75940131","75940397","chr14","9095332","9095603","63","66844799"
"chr6","76125271","76125561","chr4","73103637","73103943","30","3021634"
"chr6","76232762","76233058","chr4","73203610","73203918","32","3029152"
"chr6","76242379","76242663","chr4","73213307","73213587","13","3029072"
"chr6","76353294","76353588","chr18","876743","877042","59","75476551"
"chr6","76355383","76355655","chr4","73331791","73332091","43","3023592"
"chr6","76411908","76412222","chr4","73389206","73389513","31","3022702"
"chr6","76428999","76429288","chr4","73406970","73407260","23","3022029"
"chr6","76455247","76455359","chr4","73435600","73435714","6","3019647"
"chr6","76507084","76507209","chr2","203172934","203173060","21","126665850"
"chr6","76537706","76537860","chr4","73519512","73519665","6","3018194"
"chr6","76581708","76582044","chr4","73563130","73563465","52","3018578"
"chr6","76582136","76582434","chr13","45006370","45006675","61","31575766"
"chr6","76627299","76627567","chr4","73607908","73608175","15","3019391"
"chr6","76673040","76673239","chr4","73657095","73657301","20","3015945"
"chr6","76741875","76742120","chr6","63789598","63789844","49","12952277"
"chr6","76747196","76747423","chr4","73728541","73728768","12","3018655"
"chr6","76754859","76755158","chr4","73737922","73738222","21","3016937"
"chr6","76771921","76772215","chr4","73755554","73755855","27","3016367"
"chr6","76788152","76788471","chr4","73773116","73773437","27","3015036"
"chr6","76793003","76793223","chr4","73778245","73778465","17","3014758"
"chr6","76808311","76808478","chr4","13629108","13629270","38","63179203"
"chr6","76815926","76816049","chr4","73801192","73801305","18","3014734"
"chr6","76822812","76822959","chr3","9755296","9755438","31","67067516"
"chr6","76823250","76823422","chr3","63876628","63876793","35","12946622"
"chr6","76824096","76824380","chr1","60460972","60461260","64","16363124"
"chr6","76826520","76826825","chr9","94346653","94346954","58","17520133"
"chr6","76837353","76837484","chr4","73819458","73819584","12","3017895"
"chr6","76841485","76841794","chr4","73822555","73822862","43","3018930"
"chr6","76842574","76842744","chr10","54416385","54416552","36","22426189"
"chr6","76857582","76857854","chr4","73839028","73839310","31","3018554"
"chr6","76872059","76872320","chr10","33146351","33146618","75","43725708"
"chr6","76872546","76872861","chr3","43652365","43652670","59","33220181"
"chr6","76872865","76873100","chr6","199309","199553","61","76673556"
"chr6","76881364","76881504","chr1","211231687","211231814","30","134350323"
"chr6","76896584","76896716","chr10","38386345","38386475","18","38510239"
"chr6","76899868","76900158","chr4","73883053","73883345","26","3016815"
"chr6","76910754","76910871","chr4","73902301","73902418","11","3008453"
"chr6","76911477","76911797","chr4","108614464","108614769","69","31702987"
"chr6","76916604","76916902","chr4","73908479","73908787","23","3008125"
"chr6","76921451","76921742","chr4","73913530","73913824","24","3007921"
"chr6","76926923","76927219","chr4","73919043","73919343","30","3007880"
"chr6","76937980","76938247","chr11","53028077","53028337","63","23909903"
"chr6","76953869","76954155","chr4","73946167","73946460","22","3007702"
"chr6","76965792","76966079","chr4","73958068","73958357","33","3007724"
"chr6","76967082","76967370","chr4","73959423","73959707","29","3007659"
"chr6","76968306","76968607","chr13","61974596","61974888","54","14993710"
"chr6","76979200","76979468","chr4","111395763","111396029","47","34416563"
"chr6","76998752","76999053","chr4","73993598","73993904","24","3005154"
"chr6","77106536","77106835","chr8","65091296","65091594","60","12015240"
"chr6","77139221","77139520","chr4","74121167","74121464","24","3018054"
"chr6","77293400","77293687","chr4","74267548","74267839","37","3025852"
"chr6","77305279","77305501","chr14","78422655","78422887","45","1117376"
"chr6","77323148","77323312","chr4","74300053","74300218","10","3023095"
"chr6","77325917","77326213","chr4","74302852","74303134","29","3023065"
"chr6","77721019","77721279","chr3","160153992","160154274","80","82432973"
"chr6","77832889","77833165","chr4","74860483","74860785","50","2972406"
"chr6","78070484","78070741","chr4","31679349","31679598","65","46391135"
"chr6","78430556","78430836","chr4","75444518","75444803","21","2986038"
"chr6","78441034","78441208","chr6","93531577","93531744","37","15090543"
"chr6","78527618","78527832","chr4","75553705","75553933","32","2973913"
"chr6","78562033","78562310","chr4","75586596","75586870","17","2975437"
"chr6","78698024","78698134","chr4","75729722","75729832","11","2968302"
"chr6","78902599","78902861","chr4","75916670","75916974","54","2985929"
"chr6","78945717","78945999","chr4","75954950","75955235","48","2990767"
"chr6","79098395","79098685","chr4","76099333","76099625","16","2999062"
"chr6","79563857","79564142","chr2","56900301","56900575","73","22663556"
"chr6","79598369","79598640","chr4","76617245","76617529","43","2981124"
"chr6","79614124","79614253","chr4","76634000","76634131","8","2980124"
"chr6","79646104","79646363","chr17","77517146","77517400","58","2128958"
"chr6","79995652","79995936","chr4","77087589","77087890","33","2908063"
"chr6","80019159","80019446","chr4","77114959","77115251","14","2904200"
"chr6","80024318","80024585","chr4","77120226","77120485","21","2904092"
"chr6","80112222","80112510","chr4","77197540","77197828","17","2914682"
"chr6","80145976","80146301","chr16","60539735","60540048","77","19606241"
"chr6","80189787","80190086","chr4","77281392","77281664","57","2908395"
"chr6","80307806","80308097","chr4","77399491","77399786","17","2908315"
"chr6","80600984","80601297","chr4","77666421","77666726","35","2934563"
"chr6","80602794","80603069","chr7","136152194","136152470","55","55549400"
"chr6","80645158","80645418","chr7","131571583","131571841","74","50926425"
"chr6","80717827","80718030","chr4","96189746","96189942","43","15471919"
"chr6","80746943","80747212","chr4","77807975","77808217","39","2938968"
"chr6","80840565","80840868","chr4","77910766","77911069","24","2929799"
"chr6","80857128","80857438","chr4","77925168","77925470","28","2931960"
"chr6","80875136","80875276","chr19","29931547","29931690","32","50943589"
"chr6","80908596","80908706","chr4","77980463","77980573","15","2928133"
"chr6","80913185","80913486","chr4","77985107","77985409","22","2928078"
"chr6","80926178","80926481","chr4","78000597","78000879","44","2925581"
"chr6","80968963","80969241","chr4","78047658","78047957","58","2921305"
"chr6","80999209","80999504","chr4","78077059","78077352","34","2922150"
"chr6","81040977","81041254","chr4","78132021","78132320","44","2908956"
"chr6","81068188","81068276","chr9","60115020","60115107","16","20953168"
"chr6","81078616","81078899","chr4","78167956","78168240","15","2910660"
"chr6","81103853","81104113","chr11","43546762","43547024","70","37557091"
"chr6","81132079","81132340","chr4","78215767","78216045","41","2916312"
"chr6","81134955","81135173","chr9","13842966","13843169","55","67291989"
"chr6","81171269","81171572","chr4","78254266","78254571","26","2917003"
"chr6","81199426","81199720","chr4","78283838","78284130","24","2915588"
"chr6","81214800","81214953","chr4","78298627","78298771","24","2916173"
"chr6","81223172","81223454","chr4","78301073","78301375","47","2922099"
"chr6","81251608","81251718","chr4","78322829","78322945","10","2928779"
"chr6","81252867","81253175","chr4","78324099","78324422","32","2928768"
"chr6","81260974","81261287","chr4","78332581","78332892","24","2928393"
"chr6","81308178","81308473","chr4","78377680","78377967","28","2930498"
"chr6","81337549","81337682","chr12","84189932","84190059","22","2852383"
"chr6","81338138","81338450","chr4","78405288","78405589","37","2932850"
"chr6","81613975","81614091","chr16","75455413","75455527","26","6158562"
"chr6","81838256","81838378","chr5","2631607","2631727","18","79206649"
"chr6","81893165","81893442","chr4","78938807","78939089","24","2954358"
"chr6","81913149","81913446","chr4","78959761","78960052","47","2953388"
"chr6","82040899","82041231","chr4","27191661","27191993","93","54849238"
"chr6","82104127","82104407","chr4","79135779","79136079","39","2968348"
"chr6","82226171","82226465","chr4","79261465","79261761","16","2964706"
"chr6","82234678","82234907","chr4","79273468","79273698","11","2961210"
"chr6","82292031","82292303","chr10","86872544","86872824","64","4580513"
"chr6","82325319","82325614","chr4","79362312","79362596","32","2963007"
"chr6","82378097","82378347","chr4","79420761","79421009","21","2957336"
"chr6","82385277","82385559","chr4","79427856","79428142","26","2957421"
"chr6","82435022","82435313","chr4","79476779","79477078","31","2958243"
"chr6","82726061","82726278","chr3","34570770","34570986","53","48155291"
"chr6","82775263","82775568","chr4","79795172","79795440","48","2980091"
"chr6","82821398","82821723","chr17","9587388","9587732","86","73234010"
"chr6","82846301","82846598","chr4","79873869","79874148","65","2972432"
"chr6","82968023","82968309","chr3","123699206","123699496","58","40731183"
"chr6","82968836","82969037","chr4","80000113","80000314","14","2968723"
"chr6","83024869","83025171","chr4","80060089","80060391","13","2964780"
"chr6","83192557","83192672","chr4","80231973","80232090","9","2960584"
"chr6","83240838","83240955","chr4","80281825","80281942","7","2959013"
"chr6","83277518","83277820","chr20","21525221","21525520","65","61752297"
"chr6","83336452","83336570","chr4","80374030","80374148","8","2962422"
"chr6","83340621","83340913","chr4","80378405","80378696","19","2962216"
"chr6","83350558","83350870","chr4","80389986","80390285","41","2960572"
"chr6","83356053","83356125","chr14","45835397","45835470","12","37520656"
"chr6","83363655","83363934","chr4","80403092","80403377","21","2960563"
"chr6","83508803","83509119","chr4","80537823","80538136","48","2970980"
"chr6","83554054","83554347","chr4","80582261","80582563","38","2971793"
"chr6","83590343","83590636","chr4","80611888","80612174","26","2978455"
"chr6","83627170","83627423","chr4","80646583","80646795","64","2980587"
"chr6","83747617","83747921","chr4","80757077","80757364","36","2990540"
"chr6","83764670","83764967","chr9","99101491","99101790","51","15336821"
"chr6","83865413","83865704","chr4","80875241","80875531","25","2990172"
"chr6","83888260","83888383","chr4","80892421","80892544","12","2995839"
"chr6","83998371","83998626","chr11","97165032","97165295","61","13166661"
"chr6","84008537","84008798","chr4","81013533","81013796","20","2995004"
"chr6","84138512","84138791","chr4","81139799","81140061","53","2998713"
"chr6","84155659","84155981","chr4","81162820","81163133","21","2992839"
"chr6","84157790","84158134","chr2","201476670","201476965","106","117318880"
"chr6","84192135","84192446","chr4","81198936","81199240","23","2993199"
"chr6","84205929","84206210","chr4","81211894","81212176","17","2994035"
"chr6","84230099","84230405","chr4","81236268","81236570","21","2993831"
"chr6","84267320","84267410","chr17","408764","408857","19","83858556"
"chr6","84269058","84269325","chr4","81278933","81279224","33","2990125"
"chr6","84281596","84281632","chr17","2268417","2268452","8","82013179"
"chr6","84326334","84326620","chr4","81337207","81337501","25","2989127"
"chr6","84400968","84401275","chr4","81412853","81413160","24","2988115"
"chr6","84499722","84499999","chr7","140100928","140101221","61","55601206"
"chr6","84507853","84508115","chr4","81518544","81518830","44","2989309"
"chr6","84514261","84514588","chr4","81525076","81525388","39","2989185"
"chr6","84581542","84581838","chr4","81608513","81608807","34","2973029"
"chr6","84599190","84599506","chr4","81627643","81627938","34","2971547"
"chr6","84631742","84632041","chr4","81659432","81659742","31","2972310"
"chr6","84635314","84635516","chr4","81663009","81663207","15","2972305"
"chr6","84643197","84643488","chr4","81670831","81671108","34","2972366"
"chr6","84651838","84652066","chr4","81679812","81680040","15","2972026"
"chr6","84666045","84666335","chr4","81686728","81687027","35","2979317"
"chr6","84674561","84674850","chr4","81698140","81698429","18","2976421"
"chr6","84690759","84690874","chr3","42098713","42098828","21","42592046"
"chr6","84691319","84691506","chr11","94346059","94346241","43","9654740"
"chr6","84722076","84722392","chr4","81737684","81737994","26","2984392"
"chr6","84725751","84726053","chr4","81741299","81741592","24","2984452"
"chr6","84726437","84726740","chr4","81742455","81742726","53","2983982"
"chr6","84731708","84731937","chr4","81747650","81747879","15","2984058"
"chr6","84749911","84750241","chr7","55750814","55751128","77","28999097"
"chr6","84879499","84879619","chr4","81902885","81903017","15","2976614"
"chr6","84979209","84979503","chr4","81996234","81996529","24","2982975"
"chr6","84990667","84990977","chr4","82007646","82007956","26","2983021"
"chr6","84996541","84996840","chr4","82013527","82013838","34","2983014"
"chr6","85037393","85037700","chr17","9722411","9722714","56","75314982"
"chr6","85044968","85045257","chr4","82061050","82061321","50","2983918"
"chr6","85051929","85052241","chr4","82068323","82068635","30","2983606"
"chr6","85061726","85062020","chr4","82078115","82078418","31","2983611"
"chr6","85178970","85179283","chr16","51884206","51884517","61","33294764"
"chr6","85189978","85190290","chr4","82214326","82214643","24","2975652"
"chr6","85204393","85204705","chr3","47567768","47568083","62","37636625"
"chr6","85290345","85290519","chr4","82310492","82310666","8","2979853"
"chr6","85309855","85310149","chr4","82328836","82329133","26","2981019"
"chr6","85372394","85372696","chr7","79607971","79608275","58","5764423"
"chr6","85389264","85389522","chr4","82413656","82413916","21","2975608"
"chr6","85434914","85435135","chr2","115699750","115699969","53","30264836"
"chr6","85469362","85469663","chr4","82489131","82489420","30","2980231"
"chr6","85546169","85546474","chr2","84913076","84913368","56","633093"
"chr6","85700924","85701161","chr4","82725902","82726139","12","2975022"
"chr6","85845363","85845666","chr4","82843455","82843761","27","3001908"
"chr6","85952595","85952885","chr4","82947857","82948146","17","3004738"
"chr6","86145360","86145667","chr4","83139092","83139399","14","3006268"
"chr6","86352619","86352930","chr4","83360233","83360575","48","2992386"
"chr6","86497417","86497533","chr4","83493280","83493396","4","3004137"
"chr6","86527123","86527380","chr4","83528174","83528427","31","2998949"
"chr6","86541579","86541883","chr4","83537563","83537866","33","3004016"
"chr6","86554570","86554867","chr4","83546537","83546850","39","3008033"
"chr6","86577803","86578083","chr2","50547191","50547469","50","36030612"
"chr6","86624981","86625096","chr11","62288594","62288710","15","24336387"
"chr6","86640458","86640745","chr4","83643472","83643777","35","2996986"
"chr6","86653420","86653593","chr6","68146972","68147145","33","18506448"
"chr6","86685143","86685381","chr20","18284497","18284736","58","68400646"
"chr6","86685654","86685709","chr9","33235949","33236001","10","53449705"
"chr6","86697404","86697701","chrX","19565039","19565340","57","67132365"
"chr6","86737426","86737730","chr7","112479798","112480099","61","25742372"
"chr6","86751316","86751517","chr4","83768294","83768454","49","2983022"
"chr6","86751797","86751914","chr4","83768815","83768922","19","2982982"
"chr6","86785978","86786274","chr4","83803243","83803539","26","2982735"
"chr6","86799135","86799225","chr4","83817538","83817628","9","2981597"
"chr6","86829782","86830090","chr4","83851603","83851922","27","2978179"
"chr6","86841210","86841494","chr4","83862009","83862292","15","2979201"
"chr6","86841663","86841945","chr4","83862462","83862739","25","2979201"
"chr6","86851478","86851757","chr4","83875014","83875290","24","2976464"
"chr6","86870904","86871016","chr6","158496243","158496350","25","71625339"
"chr6","86880926","86881049","chr18","47501570","47501691","15","39379356"
"chr6","86904432","86904707","chr8","114830410","114830689","71","27925978"
"chr6","86939616","86939725","chr4","83967291","83967402","6","2972325"
"chr6","86961176","86961481","chr7","137997762","137998063","71","51036586"
"chr6","86974537","86974824","chr1","43902169","43902461","58","43072368"
"chr6","86976918","86977207","chr4","84005941","84006229","27","2970977"
"chr6","87205426","87205586","chr4","84196801","84196961","11","3008625"
"chr6","87226652","87226943","chr4","84216341","84216629","18","3010311"
"chr6","87247499","87247781","chr3","75317105","75317392","77","11930394"
"chr6","87402731","87402839","chr4","84452973","84453081","7","2949758"
"chr6","87403034","87403309","chr4","84453274","84453553","24","2949760"
"chr6","87777030","87777319","chr3","38007843","38008141","70","49769187"
"chr6","87910863","87911005","chr4","84919225","84919376","23","2991638"
"chr6","88034118","88034406","chr4","85037668","85037931","44","2996450"
"chr6","88089590","88089898","chr4","85081661","85081969","29","3007929"
"chr6","88178493","88178772","chr4","85179274","85179554","29","2999219"
"chr6","88201143","88201452","chr4","85195917","85196237","27","3005226"
"chr6","88268728","88269046","chr4","85267343","85267652","36","3001385"
"chr6","88275257","88275368","chr9","57614307","57614418","17","30660950"
"chr6","88275397","88275542","chr10","25262259","25262399","32","63013138"
"chr6","88326765","88327055","chr4","85326782","85327043","52","2999983"
"chr6","88356447","88356719","chr4","85354416","85354675","40","3002031"
"chr6","88488317","88488609","chr4","85470920","85471221","57","3017397"
"chr6","88490217","88490483","chr4","85472785","85473051","14","3017432"
"chr6","88527336","88527583","chr4","85509028","85509266","26","3018308"
"chr6","88573215","88573483","chr4","85550534","85550800","29","3022681"
"chr6","88649341","88649634","chr7","42448673","42448965","59","46200668"
"chr6","88655671","88655910","chr13","25065646","25065889","56","63590025"
"chr6","88674377","88674500","chr13","25546692","25546816","18","63127685"
"chr6","88692627","88692921","chr4","85655173","85655464","30","3037454"
"chr6","88705883","88706166","chr4","85669496","85669788","24","3036387"
"chr6","88717919","88718179","chrX","112023236","112023510","63","23305317"
"chr6","88721887","88722015","chr4","85686732","85686843","24","3035155"
"chr6","88729371","88729481","chr11","52190456","52190565","14","36538915"
"chr6","88739121","88739417","chr4","85700294","85700585","31","3038827"
"chr6","88747119","88747437","chr4","85707654","85707972","25","3039465"
"chr6","88830983","88831101","chr1","84247852","84247968","21","4583131"
"chr6","88836045","88836306","chr4","85795086","85795345","32","3040959"
"chr6","88836608","88836636","chr16","24320477","24320506","5","64516131"
"chr6","88852574","88852886","chr4","85812225","85812522","35","3040349"
"chr6","88853269","88853375","chr1","9242634","9242735","31","79610635"
"chr6","88854114","88854405","chr4","85813738","85814039","21","3040376"
"chr6","88854507","88854631","chr4","85814141","85814263","8","3040366"
"chr6","88865877","88866158","chr4","85824833","85825105","61","3041044"
"chr6","88868971","88869248","chr6","67559373","67559646","58","21309598"
"chr6","88878896","88879207","chr4","34212370","34212669","65","54666526"
"chr6","88880187","88880512","chr17","28950611","28950924","68","59929576"
"chr6","88916189","88916317","chr4","85871285","85871413","16","3044904"
"chr6","88924888","88925206","chr4","85881552","85881876","32","3043336"
"chr6","88938187","88938408","chr4","85894851","85895072","12","3043336"
"chr6","89018901","89019076","chr6","68146972","68147145","41","20871929"
"chr6","89044208","89044332","chr4","86004105","86004229","7","3040103"
"chr6","89108092","89108229","chr4","86070210","86070347","5","3037882"
"chr6","89440569","89440761","chr4","86404894","86405096","29","3035675"
"chr6","89474616","89474881","chr17","30119772","30120053","62","59354844"
"chr6","89693651","89693855","chr4","86630750","86630954","21","3062901"
"chr6","89727284","89727606","chr4","86664757","86665075","35","3062527"
"chr6","89798908","89799181","chr4","86768926","86769213","31","3029982"
"chr6","89826998","89827122","chr1","53704936","53705059","17","36122062"
"chr6","89835323","89835626","chrX","19565039","19565340","62","70270284"
"chr6","89840763","89840886","chr4","86791505","86791631","8","3049258"
"chr6","89842021","89842319","chr4","86792394","86792671","39","3049627"
"chr6","89850637","89850909","chr4","116847501","116847783","63","26996864"
"chr6","89863525","89863816","chr4","86808594","86808885","18","3054931"
"chr6","89919072","89919278","chr13","30070965","30071173","35","59848107"
"chr6","89922759","89923052","chr4","86864512","86864811","31","3058247"
"chr6","89955167","89955283","chr4","86895449","86895567","7","3059718"
"chr6","89960579","89960875","chr4","86899583","86899885","18","3060996"
"chr6","89968178","89968300","chr4","86907212","86907336","14","3060966"
"chr6","90016493","90016609","chr4","86947348","86947465","10","3069145"
"chr6","90045409","90045716","chr5","185678151","185678451","53","95632742"
"chr6","90047333","90047555","chr8","98692888","98693091","61","8645555"
"chr6","90059730","90060031","chr6","36159522","36159813","68","53900208"
"chr6","90061700","90061982","chr4","86989290","86989579","30","3072410"
"chr6","90065123","90065422","chr4","86993043","86993332","29","3072080"
"chr6","90069197","90069499","chr4","86997115","86997443","45","3072082"
"chr6","90075406","90075712","chr4","87003493","87003800","20","3071913"
"chr6","90082084","90082370","chr4","87010247","87010525","23","3071837"
"chr6","90085486","90085780","chr2","177819785","177820076","57","87734299"
"chr6","90092326","90092597","chr17","54125848","54126115","59","35966478"
"chr6","90093597","90093915","chr4","87020256","87020554","46","3073341"
"chr6","90097456","90097736","chr4","87024109","87024393","37","3073347"
"chr6","90105803","90105962","chr19","8026553","8026714","31","82079250"
"chr6","90135187","90135327","chr4","87053483","87053602","27","3081704"
"chr6","90148992","90149298","chr1","22165380","22165696","61","67983612"
"chr6","90152876","90152993","chr1","50985719","50985834","19","39167157"
"chr6","90153402","90153650","chr20","22469804","22470042","65","67683598"
"chr6","90154415","90154695","chr11","125201626","125201907","46","35047211"
"chr6","90156146","90156449","chr7","166082955","166083260","57","75926809"
"chr6","90175338","90175635","chr4","87095823","87096119","22","3079515"
"chr6","90191902","90192198","chr3","93760286","93760571","58","3568384"
"chr6","90194948","90195203","chr4","87114858","87115121","33","3080090"
"chr6","90195287","90195564","chr4","87115220","87115522","44","3080067"
"chr6","90198133","90198254","chr8","51724778","51724902","24","38473355"
"chr6","90199366","90199653","chr4","87119684","87119969","21","3079682"
"chr6","90212277","90212410","chr7","92496085","92496217","12","2283808"
"chr6","90212709","90212896","chr7","92496510","92496699","14","2283801"
"chr6","90220175","90220477","chr4","87139247","87139552","18","3080928"
"chr6","90220519","90220824","chr11","48283444","48283741","61","41937075"
"chr6","90223479","90223774","chr4","87143309","87143609","30","3080170"
"chr6","90225623","90225910","chr4","87145458","87145727","36","3080165"
"chr6","90239162","90239277","chr4","87162153","87162272","16","3077009"
"chr6","90251090","90251406","chr3","123903117","123903425","65","33652027"
"chr6","90253063","90253352","chr2","84913076","84913368","54","5339987"
"chr6","90263378","90263720","chr14","52032075","52032402","77","38231303"
"chr6","90268457","90268767","chr4","87192215","87192541","38","3076242"
"chr6","90272929","90273226","chr4","87196712","87197014","30","3076217"
"chr6","90280876","90281175","chr19","2356197","2356485","56","87924679"
"chr6","90318263","90318572","chr4","87231574","87231884","17","3086689"
"chr6","90327022","90327329","chr4","87240963","87241251","34","3086059"
"chr6","90332358","90332641","chr4","87246286","87246560","28","3086072"
"chr6","90352262","90352581","chr4","87266507","87266829","25","3085755"
"chr6","90364897","90365100","chr13","75616065","75616265","40","14748832"
"chr6","90383175","90383469","chr4","87304688","87304984","18","3078487"
"chr6","90393523","90393810","chr4","87315018","87315282","36","3078505"
"chr6","90395081","90395323","chr4","87316556","87316797","16","3078525"
"chr6","90400066","90400232","chr4","87321517","87321668","28","3078549"
"chr6","90402566","90402898","chr4","87324039","87324354","31","3078527"
"chr6","90406193","90406475","chr4","87327613","87327894","21","3078580"
"chr6","90411703","90412001","chr4","87333067","87333363","20","3078636"
"chr6","90433240","90433534","chr4","87354538","87354836","30","3078702"
"chr6","90453787","90454065","chr4","87374375","87374653","42","3079412"
"chr6","90483635","90483942","chr4","87409636","87409959","35","3073999"
"chr6","90484261","90484563","chr6","10614451","10614747","53","79869810"
"chr6","90485646","90485923","chr4","87410606","87410854","42","3075040"
"chr6","90490119","90490367","chr4","87415019","87415249","34","3075100"
"chr6","90504499","90504629","chr4","87427571","87427697","11","3076928"
"chr6","90516341","90516383","chr4","87439028","87439070","2","3077313"
"chr6","90525082","90525360","chr4","87448328","87448622","36","3076754"
"chr6","90528611","90528903","chr1","128695684","128695966","77","38167073"
"chr6","90537493","90537787","chr5","86867827","86868121","53","3669666"
"chr6","90538587","90538899","chr4","87459565","87459874","31","3079022"
"chr6","90541374","90541669","chr4","87462657","87462957","25","3078717"
"chr6","90545895","90546152","chr4","87467358","87467616","21","3078537"
"chr6","90564443","90564799","chr4","87496070","87496380","95","3068373"
"chr6","90570106","90570399","chr4","87501482","87501769","23","3068624"
"chr6","90573123","90573398","chr8","27733644","27733916","64","62839479"
"chr6","90580833","90581056","chr4","87512079","87512302","12","3068754"
"chr6","90598033","90598306","chr4","87529284","87529557","11","3068749"
"chr6","90605665","90605896","chr3","78497450","78497684","54","12108215"
"chr6","90613617","90613927","chr4","87543220","87543512","34","3070397"
"chr6","90628640","90628934","chr4","87558431","87558741","43","3070209"
"chr6","90641561","90641870","chr4","87574082","87574386","22","3067479"
"chr6","90652631","90652915","chr4","87585027","87585313","20","3067604"
"chr6","90675713","90676024","chr4","87610217","87610522","34","3065496"
"chr6","90685595","90685862","chr4","87619343","87619608","24","3066252"
"chr6","90697921","90698196","chr4","87631735","87631981","43","3066186"
"chr6","90718167","90718434","chr2","99648006","99648286","51","8929839"
"chr6","90725694","90725909","chr4","87659306","87659521","5","3066388"
"chr6","90730315","90730535","chr11","12596620","12596836","42","78133695"
"chr6","90742841","90743149","chr4","87676448","87676756","29","3066393"
"chr6","90751765","90752078","chr4","87685319","87685625","39","3066446"
"chr6","90762150","90762279","chr4","87696165","87696297","9","3065985"
"chr6","90762575","90762773","chr4","87696593","87696790","23","3065982"
"chr6","90795834","90796124","chr4","87729836","87730109","33","3065998"
"chr6","90808745","90809027","chr4","87742498","87742785","25","3066247"
"chr6","90820723","90821074","chr4","83838346","83838672","82","6982377"
"chr6","90839578","90839851","chr4","87773518","87773790","13","3066060"
"chr6","90870122","90870423","chr3","124267629","124267922","64","33397507"
"chr6","90874841","90875135","chr1","122104598","122104888","55","31229757"
"chr6","90913600","90913872","chr3","46725621","46725892","57","44187979"
"chr6","90915153","90915277","chr5","15095854","15095976","20","75819299"
"chr6","90918471","90918742","chr4","87901042","87901309","43","3017429"
"chr6","90935218","90935342","chr2","202915204","202915338","31","111979986"
"chr6","90935548","90935570","chr16","72124145","72124164","3","18811403"
"chr6","90935866","90936007","chr1","8365831","8365960","37","82570035"
"chr6","90941671","90941794","chr2","160572509","160572632","17","69630838"
"chr6","90957736","90957832","chr4","87948662","87948758","5","3009074"
"chr6","90962803","90962932","chr4","87953125","87953250","12","3009678"
"chr6","90963225","90963255","chr4","87953529","87953558","3","3009696"
"chr6","90963571","90963722","chr4","87953871","87954019","23","3009700"
"chr6","90977749","90978053","chr13","24103078","24103389","49","66874671"
"chr6","90978431","90978532","chr11","114826230","114826331","25","23847799"
"chr6","90978837","90979009","chr2","109903981","109904151","37","18925144"
"chr6","91007281","91007598","chr4","87989712","87990034","25","3017569"
"chr6","91010679","91010983","chr4","87992867","87993157","33","3017812"
"chr6","91040716","91040984","chr4","88022137","88022445","54","3018579"
"chr6","91044085","91044397","chr4","88025226","88025507","49","3018859"
"chr6","91056229","91056458","chrX","8697309","8697538","45","82358920"
"chr6","91056998","91057067","chr7","37558740","37558807","15","53498258"
"chr6","91065473","91065747","chr4","88047162","88047465","51","3018311"
"chr6","91087432","91087549","chr4","88069909","88070025","5","3017523"
"chr6","91158319","91158625","chr4","88140143","88140430","36","3018176"
"chr6","91163253","91163380","chr19","7652130","7652250","41","83511123"
"chr6","91163653","91163797","chr20","27673789","27673919","27","63489864"
"chr6","91165532","91165781","chr4","88147349","88147596","24","3018183"
"chr6","91166308","91166621","chr4","88148578","88148884","43","3017730"
"chr6","91199584","91199851","chr4","88182983","88183253","20","3016601"
"chr6","91204783","91205082","chr4","88188270","88188563","21","3016513"
"chr6","91313714","91314029","chr4","88295551","88295866","19","3018163"
"chr6","91354194","91354484","chr2","76189917","76190204","74","15164277"
"chr6","91374619","91374912","chr4","88354146","88354442","23","3020473"
"chr6","91394971","91395224","chr4","88376110","88376363","18","3018861"
"chr6","91396872","91397165","chr4","103518320","103518630","64","12121448"
"chr6","91456191","91456479","chr4","88438162","88438443","38","3018029"
"chr6","91467976","91468271","chr4","88450638","88450930","23","3017338"
"chr6","91481962","91482272","chr1","8798660","8798961","60","82683302"
"chr6","91498671","91498970","chr4","88480421","88480705","36","3018250"
"chr6","91576467","91576740","chr4","88565155","88565430","18","3011312"
"chr6","91577642","91577766","chr4","88566408","88566528","11","3011234"
"chr6","91591436","91591737","chr14","57869118","57869420","63","33722318"
"chr6","91597627","91597900","chr4","88591773","88592037","34","3005854"
"chr6","91626970","91627266","chr4","88621282","88621586","51","3005688"
"chr6","91676454","91676577","chr4","88671427","88671552","8","3005027"
"chr6","91676665","91676955","chr4","88671641","88671931","24","3005024"
"chr6","91678341","91678650","chr4","88673331","88673647","25","3005010"
"chr6","91731001","91731124","chr13","92546093","92546218","16","815092"
"chr6","91787494","91787766","chr1","126161352","126161621","68","34373858"
"chr6","91791644","91791886","chr4","88783641","88783884","11","3008003"
"chr6","91832436","91832766","chr4","88819380","88819688","45","3013056"
"chr6","91997268","91997352","chr4","88983753","88983837","4","3013515"
"chr6","91997642","91997864","chr3","38839947","38840148","59","53157695"
"chr6","92025679","92025962","chr4","89012528","89012796","25","3013151"
"chr6","92131313","92131622","chr4","89114154","89114447","35","3017159"
"chr6","92358052","92358346","chr4","89339665","89339961","21","3018387"
"chr6","92425741","92426041","chr4","89408070","89408373","22","3017671"
"chr6","92427859","92428132","chr4","89410200","89410473","32","3017659"
"chr6","92469498","92469612","chrX","67425911","67426027","20","25043587"
"chr6","92469646","92469783","chr5","41120819","41120943","39","51348827"
"chr6","92588551","92588854","chr4","89574903","89575195","38","3013648"
"chr6","92612563","92612770","chr4","89602155","89602361","16","3010408"
"chr6","92840074","92840350","chr4","89837934","89838209","21","3002140"
"chr6","92846887","92847188","chr4","89844771","89845086","49","3002116"
"chr6","93000001","93000283","chr4","90004602","90004882","23","2995399"
"chr6","93056537","93056848","chr4","90058806","90059104","43","2997731"
"chr6","93230428","93230622","chr4","90238017","90238212","16","2992411"
"chr6","93612499","93612790","chr4","90629037","90629332","27","2983462"
"chr6","93621930","93622214","chr4","90639549","90639833","22","2982381"
"chr6","93851962","93852251","chr4","119244418","119244699","77","25392456"
"chr6","94015425","94015718","chr4","91056617","91056901","38","2958808"
"chr6","94015845","94016072","chr11","16806292","16806509","60","77209553"
"chr6","94028589","94028862","chr4","91074302","91074597","42","2954287"
"chr6","94037903","94038150","chr4","91083655","91083906","19","2954248"
"chr6","94053213","94053458","chr4","91099521","91099744","38","2953692"
"chr6","94115393","94115682","chr4","91156281","91156568","24","2959112"
"chr6","94165943","94166286","chr4","27191661","27191993","95","66974282"
"chr6","94185203","94185328","chr4","91216381","91216499","20","2968822"
"chr6","94235068","94235191","chr4","91266805","91266928","10","2968263"
"chr6","94247092","94247246","chr7","84537557","84537711","36","9709535"
"chr6","94252398","94252726","chr4","91284766","91285071","44","2967632"
"chr6","94459877","94460116","chr4","91489488","91489758","56","2970389"
"chr6","94524699","94524993","chr4","91555012","91555312","30","2969687"
"chr6","94532271","94532558","chr4","91562518","91562804","21","2969753"
"chr6","94960549","94960865","chr3","175827593","175827902","73","80867044"
"chr6","95017702","95017969","chr4","92057415","92057683","50","2960287"
"chr6","95030600","95030893","chr4","92068391","92068672","29","2962209"
"chr6","95089986","95090282","chr11","112558118","112558426","31","17468132"
"chr6","95139127","95139259","chr4","92219880","92220006","14","2919247"
"chr6","95144637","95144759","chr6","105272157","105272278","23","10127520"
"chr6","95229715","95229833","chr4","92307408","92307525","5","2922307"
"chr6","95338330","95338549","chr3","133262951","133263164","58","37924621"
"chr6","95338596","95338677","chr5","86821277","86821355","25","8517319"
"chr6","95550608","95550703","chr11","107116864","107116967","32","11566256"
"chr6","95618829","95619102","chrX","42417114","42417387","73","53201715"
"chr6","95726747","95727055","chr9","109164176","109164476","66","13437429"
"chr6","95759988","95760154","chr4","92900821","92900988","10","2859167"
"chr6","95797957","95798244","chr4","92939930","92940212","21","2858027"
"chr6","95850520","95850806","chr1","40170875","40171158","64","55679645"
"chr6","95856467","95856576","chr4","93001735","93001838","12","2854732"
"chr6","96857924","96858211","chr4","93418394","93418662","44","3439530"
"chr6","96897494","96897776","chr4","93458281","93458574","28","3439213"
"chr6","97044802","97044984","chr3","41137310","41137484","39","55907492"
"chr6","97087331","97087643","chr4","93664559","93664868","34","3422772"
"chr6","97231681","97231987","chr4","93816171","93816477","23","3415510"
"chr6","97409622","97409818","chr4","94042444","94042639","21","3367178"
"chr6","97534128","97534412","chr4","94171355","94171638","13","3362773"
"chr6","97622307","97622590","chr4","94269476","94269760","29","3352831"
"chr6","97622770","97623071","chr4","94269953","94270255","48","3352817"
"chr6","97717115","97717411","chr4","94374425","94374732","36","3342690"
"chr6","97779717","97780010","chr10","73497926","73498218","59","24281791"
"chr6","97803255","97803556","chr4","94496027","94496332","31","3307228"
"chr6","97821162","97821451","chr4","94514498","94514762","41","3306664"
"chr6","97831277","97831476","chr4","94523373","94523585","28","3307904"
"chr6","97840295","97840571","chr4","94533651","94533950","43","3306644"
"chr6","97982719","97982987","chr4","94685235","94685516","35","3297484"
"chr6","97993477","97993774","chr4","94694426","94694719","21","3299051"
"chr6","98006803","98006988","chr1","46757713","46757903","36","51249090"
"chr6","98042891","98043189","chr4","94753223","94753522","29","3289668"
"chr6","98114451","98114571","chr3","33235874","33235995","21","64878577"
"chr6","98124913","98125212","chr4","94834850","94835152","29","3290063"
"chr6","98174161","98174464","chr4","94879152","94879431","46","3295009"
"chr6","98227487","98227791","chr4","94948177","94948483","28","3279310"
"chr6","98238140","98238257","chr4","94958925","94959042","6","3279215"
"chr6","98328424","98328717","chr4","95047111","95047409","20","3281313"
"chr6","98381433","98381562","chr13","70830779","70830910","22","27550654"
"chr6","98419993","98420298","chr4","95135844","95136142","26","3284149"
"chr6","98449534","98449818","chr4","95165136","95165421","22","3284398"
"chr6","98463984","98464234","chr4","95191988","95192239","20","3271996"
"chr6","98500723","98501008","chr4","95228621","95228894","28","3272102"
"chr6","98549882","98550184","chr4","95275635","95275938","25","3274247"
"chr6","98564606","98564729","chr4","95296099","95296222","4","3268507"
"chr6","98584307","98584605","chr4","95321972","95322272","23","3262335"
"chr6","98652539","98652826","chr4","95394342","95394643","31","3258197"
"chr6","98724267","98724483","chr16","73992318","73992542","49","24731949"
"chr6","98754204","98754495","chr4","95482787","95483075","18","3271417"
"chr6","98823346","98823470","chr14","15705786","15705903","34","83117560"
"chr6","98932998","98933299","chr9","98661850","98662144","62","271148"
"chr6","98985124","98985423","chr4","95712088","95712366","38","3273036"
"chr6","98985907","98986181","chr4","95712854","95713129","21","3273053"
"chr6","99000099","99000390","chr4","95726764","95727059","25","3273335"
"chr6","99004145","99004427","chr5","139182915","139183194","52","40178770"
"chr6","99030775","99031079","chr4","95762969","95763254","34","3267806"
"chr6","99034784","99035069","chr3","7092558","7092844","53","91942226"
"chr6","99127049","99127309","chr4","95852615","95852894","34","3274434"
"chr6","99133838","99133948","chr3","133994127","133994239","30","34860289"
"chr6","99358248","99358526","chr4","96099971","96100247","23","3258277"
"chr6","99438013","99438291","chr4","96178314","96178596","20","3259699"
"chr6","99448946","99449134","chr4","96189746","96189942","26","3259200"
"chr6","99581561","99581676","chr4","96354996","96355110","5","3226565"
"chr6","99598018","99598306","chr11","32041993","32042279","72","67556025"
"chr6","99643762","99644041","chr4","96414429","96414721","36","3229333"
"chr6","99690396","99690706","chr5","80760617","80760930","60","18929779"
"chr6","100028133","100028422","chr3","165868043","165868332","72","65839910"
"chr6","100109044","100109276","chr14","52412007","52412236","54","47697037"
"chr6","100394386","100394670","chr4","97182902","97183177","25","3211484"
"chr6","100458871","100459025","chr9","72272836","72272988","30","28186035"
"chr6","100488058","100488349","chr4","97276073","97276380","32","3211985"
"chr6","100572747","100573010","chr4","97361121","97361388","16","3211626"
"chr6","100603828","100603951","chr4","97389877","97390000","7","3213951"
"chr6","100619330","100619613","chr4","97405295","97405569","20","3214035"
"chr6","100692486","100692781","chr1","191690399","191690678","60","90997913"
"chr6","100830345","100830555","chr4","97622534","97622741","21","3207811"
"chr6","100949711","100950003","chr4","97734915","97735207","28","3214796"
"chr6","100980313","100980591","chr1","223298026","223298313","54","122317713"
"chr6","101086563","101086703","chr4","97869340","97869486","19","3217223"
"chr6","101087005","101087056","chr8","139871406","139871438","28","38784401"
"chr6","101087348","101087494","chr4","97870082","97870228","14","3217266"
"chr6","101096466","101096501","chr4","97880530","97880565","3","3215936"
"chr6","101097086","101097407","chr4","97881154","97881464","22","3215932"
"chr6","101130291","101130602","chr4","97914461","97914738","63","3215830"
"chr6","101134860","101135094","chr1","222943933","222944161","46","121809073"
"chr6","101167595","101167884","chr4","97952178","97952482","32","3215417"
"chr6","101170324","101170574","chr4","33679870","33680118","51","67490454"
"chr6","101207896","101208182","chr4","97993368","97993667","31","3214528"
"chr6","101219532","101219651","chr4","98005050","98005168","12","3214482"
"chr6","101243189","101243344","chr3","7372899","7373059","44","93870290"
"chr6","101245237","101245553","chr11","117366311","117366614","64","16121074"
"chr6","101258777","101259085","chr4","98039667","98039957","37","3219110"
"chr6","101263016","101263128","chr4","98044082","98044194","11","3218934"
"chr6","101278528","101278851","chr4","98059623","98059951","22","3218905"
"chr6","101339799","101339984","chr4","98123180","98123366","8","3216619"
"chr6","101346882","101347165","chr4","98130125","98130398","35","3216757"
"chr6","101423662","101423875","chr4","98194686","98194901","18","3228976"
"chr6","101452039","101452325","chr4","98222117","98222413","26","3229922"
"chr6","101452416","101452571","chr16","54031136","54031283","47","47421280"
"chr6","101462024","101462308","chr4","98231637","98231913","26","3230387"
"chr6","101525331","101525642","chr4","98296776","98297087","26","3228555"
"chr6","101527009","101527078","chr8","125184987","125185058","18","23657978"
"chr6","101541770","101541878","chr4","98313915","98314020","10","3227855"
"chr6","101549390","101549547","chr4","98321244","98321407","24","3228146"
"chr6","101549836","101549978","chr4","98321702","98321842","15","3228134"
"chr6","101572709","101572990","chr4","98343579","98343874","51","3229130"
"chr6","101601951","101602263","chr4","98372991","98373313","33","3228960"
"chr6","101843061","101843358","chr4","98608234","98608552","47","3234827"
"chr6","101886267","101886597","chr4","98655382","98655744","66","3230885"
"chr6","101964767","101965071","chr9","82185425","82185714","83","19779342"
"chr6","101976096","101976299","chr4","98742473","98742681","24","3233623"
"chr6","101986326","101986647","chr4","98752706","98752998","41","3233620"
"chr6","102110414","102110705","chr4","98929093","98929395","44","3181321"
"chr6","102134290","102134579","chr4","98952702","98952996","19","3181588"
"chr6","102148098","102148344","chr4","98966475","98966720","15","3181623"
"chr6","102196733","102197019","chr4","99016168","99016453","23","3180565"
"chr6","102199518","102199812","chr4","99018938","99019232","26","3180580"
"chr6","102241125","102241399","chr4","99060142","99060423","23","3180983"
"chr6","102244125","102244417","chr4","99063375","99063670","34","3180750"
"chr6","102252732","102253009","chr19","53249067","53249335","63","49003665"
"chr6","102263756","102264027","chr4","99082187","99082464","32","3181569"
"chr6","102412780","102413069","chr4","99230053","99230357","60","3182727"
"chr6","102437057","102437355","chr4","99244693","99244963","42","3192364"
"chr6","102448587","102448858","chr4","99256256","99256535","23","3192331"
"chr6","102479774","102480074","chr1","190781513","190781814","67","88301739"
"chr6","102504265","102504554","chr4","99314830","99315118","22","3189435"
"chr6","102521391","102521688","chr4","99330986","99331295","31","3190405"
"chr6","102531295","102531580","chr4","99340865","99341150","15","3190430"
"chr6","102539372","102539655","chr4","99351770","99352067","28","3187602"
"chr6","102589672","102589934","chr4","99405238","99405461","51","3184434"
"chr6","102602179","102602484","chr4","99417696","99417979","35","3184483"
"chr6","102637238","102637538","chr4","99454633","99454929","20","3182605"
"chr6","102728548","102728683","chr11","64012516","64012648","26","38716032"
"chr6","102792969","102793260","chr4","99609230","99609519","21","3183739"
"chr6","102844925","102845214","chr19","14725447","14725737","60","88119478"
"chr6","102879432","102879627","chr4","99709249","99709458","38","3170183"
"chr6","103022826","103023137","chr4","99906867","99907142","53","3115959"
"chr6","103156853","103157041","chr10","31228290","31228480","46","71928563"
"chr6","103157073","103157189","chr20","59194786","59194896","19","43962287"
"chr6","103337478","103337810","chr3","137891231","137891557","76","34553753"
"chr6","103434050","103434297","chr16","19526439","19526686","57","83907611"
"chr6","103474057","103474308","chr4","100426724","100426966","26","3047333"
"chr6","103556997","103557273","chr4","100505324","100505594","23","3051673"
"chr6","103574376","103574654","chr5","93421300","93421584","78","10153076"
"chr6","103594065","103594282","chr2","44350896","44351113","53","59243169"
"chr6","103794283","103794406","chr4","100879692","100879808","18","2914591"
"chr6","103893789","103894060","chr11","43546762","43547024","85","60347027"
"chr6","103894824","103894942","chr4","100967603","100967724","12","2927221"
"chr6","104060480","104060764","chr4","101138773","101139054","30","2921707"
"chr6","104091162","104091467","chr4","101171475","101171770","30","2919687"
"chr6","104093137","104093453","chr4","101173435","101173749","19","2919702"
"chr6","104130222","104130609","chr4","101270448","101270796","78","2859774"
"chr6","104274292","104274537","chr19","3350946","3351183","59","100923346"
"chr6","104303809","104304114","chr4","101469717","101470023","32","2834092"
"chr6","104304404","104304716","chr4","101470334","101470626","45","2834070"
"chr6","104367972","104368243","chr4","101544814","101545115","48","2823158"
"chr6","104540841","104540949","chr4","101731340","101731458","16","2809501"
"chr6","104822119","104822419","chr19","3353989","3354279","74","101468130"
"chr6","104838848","104839106","chr4","102056067","102056326","27","2782781"
"chr6","104896611","104896910","chr4","102115285","102115597","35","2781326"
"chr6","105110802","105111094","chr3","123351694","123351976","61","18240892"
"chr6","105247280","105247405","chr4","102414491","102414616","23","2832789"
"chr6","105251146","105251344","chr4","102418647","102418845","19","2832499"
"chr6","105259686","105259808","chr4","102426753","102426875","10","2832933"
"chr6","105266665","105266783","chr13","46512186","46512305","20","58754479"
"chr6","105269810","105270102","chr4","102434905","102435196","21","2834905"
"chr6","105316553","105316846","chrX","46653986","46654280","61","58662567"
"chr6","105536485","105536708","chr4","102688312","102688540","20","2848173"
"chr6","105551783","105551932","chr4","44439345","44439491","33","61112438"
"chr6","105845496","105845792","chr4","106219841","106220140","27","374345"
"chr6","105929275","105929547","chr4","106072281","106072542","35","143006"
"chr6","105942771","105942913","chr15","2473781","2473922","35","103468990"
"chr6","105943213","105943348","chr10","82665652","82665774","37","23277561"
"chr6","106072376","106072630","chr11","94540063","94540302","64","11532313"
"chr6","106260437","106260718","chr4","105739937","105740218","16","520500"
"chr6","106277699","106277998","chr4","105723739","105724040","26","553960"
"chr6","106325825","106326117","chr4","105617758","105618052","24","708067"
"chr6","106341126","106341416","chr4","105602653","105602949","21","738473"
"chr6","106369034","106369327","chr4","105575600","105575889","28","793434"
"chr6","106383419","106383690","chr4","105561188","105561462","27","822231"
"chr6","106390625","106390748","chr4","105553931","105554054","4","836694"
"chr6","106403503","106403811","chr4","105540719","105541002","48","862784"
"chr6","106415662","106415791","chr6","67604226","67604355","22","38811436"
"chr6","106419610","106419871","chr4","105524195","105524462","33","895415"
"chr6","106461247","106461518","chr4","105483923","105484189","29","977324"
"chr6","106470423","106470731","chr4","105474830","105475150","28","995593"
"chr6","106498590","106498877","chr1","17739386","17739672","62","88759204"
"chr6","106504603","106504852","chr8","45404265","45404504","62","61100338"
"chr6","106514335","106514561","chr13","27645792","27646026","64","78868543"
"chr6","106524886","106525021","chr4","105416958","105417100","20","1107928"
"chr6","106525318","106525485","chr4","105416498","105416660","18","1108820"
"chr6","106533381","106533636","chr4","105407334","105407587","15","1126047"
"chr6","106540412","106540621","chr12","100306628","100306841","42","6233784"
"chr6","106583025","106583319","chr4","105362310","105362610","33","1220715"
"chr6","106622639","106622943","chr4","105320003","105320304","33","1302636"
"chr6","106628280","106628584","chr4","19436761","19437064","86","87191519"
"chr6","106656438","106656604","chr18","9795354","9795521","37","96861084"
"chr6","106656886","106657032","chrX","129770380","129770523","27","23113494"
"chr6","106657642","106657945","chr1","200620309","200620594","70","93962667"
"chr6","106672736","106673019","chr4","105270096","105270380","26","1402640"
"chr6","106674385","106674638","chr4","105268451","105268716","25","1405934"
"chr6","106682639","106682930","chr4","105260926","105261228","24","1421713"
"chr6","106688555","106688809","chr4","105254780","105255003","46","1433775"
"chr6","106697176","106697291","chr9","14916076","14916192","15","91781100"
"chr6","106703414","106703589","chr4","105240297","105240480","21","1463117"
"chr6","106703886","106704015","chr4","105239874","105240004","9","1464012"
"chr6","106773004","106773292","chr4","105175826","105176120","29","1597178"
"chr6","106777578","106777735","chr4","105171164","105171352","42","1606414"
"chr6","106782475","106782702","chr4","105165888","105166135","33","1616587"
"chr6","106819904","106820179","chr4","105129542","105129826","31","1690362"
"chr6","106831900","106832214","chr2","178119588","178119898","70","71287688"
"chr6","106838148","106838381","chr4","105112672","105112886","30","1725476"
"chr6","106883375","106883670","chr4","105070942","105071252","37","1812433"
"chr6","106888467","106888733","chr2","52918853","52919123","64","53969614"
"chr6","107098900","107099175","chr1","5819632","5819900","56","101279268"
"chr6","107137476","107137695","chr4","104797534","104797762","18","2339942"
"chr6","107140452","107140700","chr10","42137836","42138087","66","65002616"
"chr6","107178960","107179084","chr7","137736915","137737039","18","30557955"
"chr6","107232550","107232842","chr4","104703792","104704083","23","2528758"
"chr6","107291264","107291558","chr4","104637219","104637518","20","2654045"
"chr6","107359157","107359444","chr4","104572142","104572435","24","2787015"
"chr6","107422996","107423289","chr1","25629235","25629522","61","81793761"
"chr6","107453827","107453910","chr4","104483943","104484024","7","2969884"
"chr6","107465848","107466011","chr1","53482939","53483101","31","53982909"
"chr6","107605746","107606040","chr4","104331688","104331997","36","3274058"
"chr6","107628586","107628782","chrX","52447863","52448045","40","55180723"
"chr6","107632100","107632415","chr4","104302024","104302347","37","3330076"
"chr6","107650133","107650377","chr4","104283861","104284109","26","3366272"
"chr6","107650969","107651264","chr4","104282970","104283263","22","3367999"
"chr6","107709518","107709673","chr1","33300620","33300771","34","74408898"
"chr6","107709968","107710100","chr7","16781339","16781468","20","90928629"
"chr6","107711099","107711391","chr4","104155886","104156183","31","3555213"
"chr6","107720381","107720678","chr4","104145988","104146291","19","3574393"
"chr6","107722556","107722859","chr4","104143786","104144093","35","3578770"
"chr6","107735354","107735620","chr4","104131038","104131300","37","3604316"
"chr6","107797401","107797710","chr4","104068604","104068896","41","3728797"
"chr6","107818294","107818579","chr17","94771163","94771449","49","13047131"
"chr6","107844922","107845192","chr4","104021076","104021374","47","3823846"
"chr6","107848804","107849093","chr4","104017221","104017514","20","3831583"
"chr6","107852902","107853103","chr4","104013224","104013425","13","3839678"
"chr6","107853293","107853569","chr4","104012754","104013031","14","3840539"
"chr6","107858979","107859266","chr4","104007112","104007432","47","3851867"
"chr6","107891499","107891689","chr4","103973547","103973735","33","3917952"
"chr6","107913840","107914111","chr4","103949402","103949668","18","3964438"
"chr6","107944897","107945098","chr6","140123726","140123929","53","32178829"
"chr6","107970846","107971141","chr4","103895244","103895533","23","4075602"
"chr6","107972399","107972706","chr6","168379811","168380119","71","60407412"
"chr6","107983625","107983918","chr5","8246617","8246904","51","99737008"
"chr6","108021522","108021808","chr11","113035652","113035938","48","5014130"
"chr6","108022701","108022992","chr4","103812167","103812462","28","4210534"
"chr6","108060252","108060549","chr4","103773798","103774094","30","4286454"
"chr6","108061072","108061402","chr5","120722406","120722726","65","12661334"
"chr6","108065332","108065621","chr4","103769221","103769536","39","4296111"
"chr6","108085445","108085656","chr17","3590562","3590778","46","104494883"
"chr6","108085954","108086075","chr19","31848816","31848932","26","76237138"
"chr6","108087535","108087653","chr16","38853946","38854064","20","69233589"
"chr6","108087684","108087843","chr1","15677456","15677613","34","92410228"
"chr6","108103856","108104139","chr4","103730788","103731088","32","4373068"
"chr6","108114583","108114861","chr4","103721266","103721546","33","4393317"
"chr6","108129255","108129368","chr4","103707368","103707480","10","4421887"
"chr6","108147218","108147511","chr3","126787525","126787821","52","18640307"
"chr6","108171998","108172326","chr13","62657226","62657550","75","45514772"
"chr6","108204940","108205206","chr4","103622846","103623096","45","4582094"
"chr6","108206596","108206872","chr4","103620770","103621048","20","4585826"
"chr6","108249616","108249881","chr16","61600043","61600308","61","46649573"
"chr6","108282649","108282909","chr4","103545073","103545331","21","4737576"
"chr6","108295093","108295358","chr4","103532998","103533267","26","4762095"
"chr6","108310417","108310717","chr4","103518320","103518630","28","4792097"
"chr6","108330239","108330508","chr4","103499007","103499276","20","4831232"
"chr6","108339579","108339864","chr4","103490077","103490374","56","4849502"
"chr6","108355296","108355595","chr4","103474925","103475213","25","4880371"
"chr6","108387966","108388258","chr4","103443360","103443661","33","4944606"
"chr6","108411152","108411446","chr4","103419687","103419984","15","4991465"
"chr6","108440665","108440788","chr4","103389111","103389238","11","5051554"
"chr6","108441103","108441277","chr12","87917476","87917649","38","20523627"
"chr6","108443985","108444289","chr11","48401419","48401716","79","60042566"
"chr6","108445387","108445449","chr3","44338700","44338762","17","64106687"
"chr6","108446259","108446556","chr4","103383177","103383477","28","5063082"
"chr6","108462943","108463194","chr4","103365848","103366119","51","5097095"
"chr6","108511718","108511952","chr4","103325672","103325908","21","5186046"
"chr6","108524536","108524626","chr1","152109848","152109944","21","43585312"
"chr6","108535065","108535340","chr4","103302400","103302675","26","5232665"
"chr6","108535342","108535433","chr10","60734802","60734892","19","47800540"
"chr6","108567950","108568231","chr6","125991585","125991862","71","17423635"
"chr6","108578500","108578712","chr4","103267358","103267566","36","5311142"
"chr6","108612333","108612614","chr4","103236724","103237002","22","5375609"
"chr6","108622694","108623004","chr4","103226057","103226371","20","5396637"
"chr6","108628968","108629258","chrX","125989015","125989296","56","17360047"
"chr6","108641865","108642149","chr4","103204733","103205016","16","5437132"
"chr6","108685293","108685587","chr4","103154977","103155272","23","5530316"
"chr6","108696808","108697110","chr3","45751554","45751846","54","62945254"
"chr6","108725677","108725983","chr4","103122565","103122869","24","5603112"
"chr6","108764697","108764866","chrX","69682218","69682378","36","39082479"
"chr6","108776862","108776979","chr4","103078853","103078970","8","5698009"
"chr6","108778703","108779001","chr4","103076829","103077126","27","5701874"
"chr6","108784010","108784312","chr4","103070812","103071115","37","5713198"
"chr6","108785954","108786257","chr14","104459582","104459884","64","4326372"
"chr6","108798718","108799015","chr4","103055433","103055705","54","5743285"
"chr6","108835688","108835939","chr11","123534948","123535208","59","14699260"
"chr6","108838795","108839073","chrX","46714655","46714933","62","62124140"
"chr6","108850607","108850931","chr4","103011246","103011570","21","5839361"
"chr6","108869193","108869227","chr3","164879589","164879624","9","56010396"
"chr6","108869259","108869420","chr12","85591604","85591764","31","23277655"
"chr6","108881435","108881715","chr4","102978669","102978947","21","5902766"
"chr6","108912238","108912552","chr4","102943501","102943818","23","5968737"
"chr6","108935805","108936085","chr4","102919512","102919815","43","6016293"
"chr6","108951006","108951229","chr4","102903815","102904033","49","6047191"
"chr6","108954131","108954444","chr4","102900602","102900916","20","6053529"
"chr6","108966149","108966267","chr4","102887626","102887744","10","6078523"
"chr6","108967779","108967976","chr4","102885706","102885902","11","6082073"
"chr6","108969255","108969566","chr4","102884121","102884415","36","6085134"
"chr6","108980158","108980450","chr4","102872851","102873126","38","6107307"
"chr6","108991757","108992025","chr4","102859115","102859387","31","6132642"
"chr6","109012741","109013026","chr4","102837925","102838215","40","6174816"
"chr6","109028388","109028678","chr4","102822281","102822574","23","6206107"
"chr6","109074992","109075308","chr1","21474061","21474377","66","87600931"
"chr6","109091251","109091509","chr4","106443144","106443435","51","2648107"
"chr6","109106508","109106796","chr4","106458602","106458890","22","2647906"
"chr6","109112800","109113085","chr4","106465020","106465309","31","2647780"
"chr6","109121825","109122121","chr4","106474569","106474866","18","2647256"
"chr6","109127420","109127647","chr4","106479868","106480075","30","2647552"
"chr6","109128623","109128907","chr4","106481062","106481346","22","2647561"
"chr6","109146464","109146586","chr4","106500045","106500170","10","2646419"
"chr6","109226334","109226642","chr4","106580321","106580628","22","2646013"
"chr6","109240671","109240925","chr4","106594910","106595164","14","2645761"
"chr6","109291704","109291920","chr19","33928910","33929130","40","75362794"
"chr6","109293395","109293631","chr4","106649558","106649799","20","2643837"
"chr6","109347519","109347687","chr6","67480932","67481096","35","41866587"
"chr6","109347987","109348033","chr12","112435949","112435996","10","3087962"
"chr6","109359491","109359729","chr4","106718952","106719189","14","2640539"
"chr6","109439099","109439407","chr4","106798140","106798427","38","2640959"
"chr6","109482151","109482284","chr4","106843707","106843841","12","2638444"
"chr6","109508766","109509082","chr4","106870439","106870755","53","2638327"
"chr6","109512317","109512434","chr16","5118304","5118427","18","104394013"
"chr6","109517766","109517889","chr10","27663251","27663372","19","81854515"
"chr6","109520201","109520505","chr4","106882179","106882485","19","2638022"
"chr6","109533167","109533460","chr4","106895912","106896180","44","2637255"
"chr6","109561756","109561880","chr4","106923360","106923484","8","2638396"
"chr6","109569782","109570030","chr4","106932092","106932339","9","2637690"
"chr6","109576531","109576831","chr4","106939195","106939494","23","2637336"
"chr6","109589462","109589726","chr7","61127662","61127921","57","48461800"
"chr6","109589857","109590132","chr20","26230829","26231113","67","83359028"
"chr6","109596299","109596350","chr11","48332700","48332751","13","61263599"
"chr6","109604742","109605042","chr4","106967440","106967660","97","2637302"
"chr6","109638642","109638946","chr4","107004817","107005109","39","2633825"
"chr6","109639709","109639833","chr15","110025773","110025895","16","386064"
"chr6","109653558","109653864","chr4","159943718","159944024","19","50290160"
"chr6","109660862","109661171","chr4","159935674","159935988","41","50274812"
"chr6","109675677","109675881","chr4","159921811","159922007","33","50246134"
"chr6","109676138","109676263","chr4","159921440","159921570","10","50245302"
"chr6","109692555","109692814","chr4","159898406","159898657","20","50205851"
"chr6","109695147","109695439","chr4","159895782","159896078","33","50200635"
"chr6","109704886","109705001","chr4","159883676","159883785","10","50178790"
"chr6","109725135","109725296","chr1","53482939","53483101","29","56242196"
"chr6","109725345","109725459","chr19","26569249","26569356","26","83156096"
"chr6","109726166","109726456","chr14","107684465","107684767","66","2041701"
"chr6","109746947","109747242","chr4","159836567","159836866","17","50089620"
"chr6","109765988","109766301","chr4","159817546","159817844","49","50051558"
"chr6","109769190","109769392","chr7","20198891","20199096","38","89570299"
"chr6","109810625","109810788","chr10","65990511","65990675","27","43820114"
"chr6","109810820","109810936","chr16","46217401","46217516","21","63593419"
"chr6","109813265","109813434","chr4","159768804","159768973","3","49955539"
"chr6","109815355","109815647","chr4","159766411","159766698","23","49951056"
"chr6","109817512","109817722","chr13","74259914","74260120","59","35557598"
"chr6","109846820","109847127","chr20","23141129","23141416","75","86705691"
"chr6","109849426","109849665","chr4","159732854","159733087","18","49883428"
"chr6","109856621","109856929","chr4","159725498","159725813","28","49868877"
"chr6","109863570","109863875","chr1","129156247","129156555","56","19292677"
"chr6","109864423","109864470","chr13","19012667","19012707","13","90851756"
"chr6","109878516","109878800","chr4","159701865","159702152","28","49823349"
"chr6","109888317","109888635","chr4","159692072","159692374","39","49803755"
"chr6","109893558","109893644","chr13","106486241","106486330","31","3407317"
"chr6","109898776","109898891","chr7","154055978","154056093","18","44157202"
"chr6","109906824","109907123","chr4","159673951","159674255","20","49767127"
"chr6","109918237","109918547","chr4","159661831","159662108","54","49743594"
"chr6","109920133","109920423","chr4","159659944","159660233","36","49739811"
"chr6","109925313","109925438","chr4","159654244","159654371","16","49728931"
"chr6","109927960","109928248","chr1","192424636","192424923","64","82496676"
"chr6","109937035","109937334","chr5","185959761","185960065","74","76022726"
"chr6","109938182","109938316","chr15","41575081","41575216","22","68363101"
"chr6","109940164","109940474","chr4","159642919","159643227","24","49702755"
"chr6","109944733","109945033","chr4","159638018","159638330","26","49693285"
"chr6","109945493","109945568","chr4","159637115","159637190","2","49691622"
"chr6","109948122","109948251","chr19","10289505","10289631","22","99658617"
"chr6","109953242","109953343","chr4","159630699","159630806","11","49677457"
"chr6","109955128","109955316","chr19","39878357","39878534","50","70076771"
"chr6","109969982","109970268","chr4","159611902","159612189","15","49641920"
"chr6","109974077","109974401","chr4","159605029","159605358","22","49630952"
"chr6","109983378","109983694","chr4","159595085","159595411","23","49611707"
"chr6","109988443","109988574","chr4","159590169","159590300","4","49601726"
"chr6","109992475","109992757","chr4","159585989","159586293","41","49593514"
"chr6","109994099","109994387","chr4","159584425","159584720","27","49590326"
"chr6","109994939","109995062","chr4","159583751","159583872","10","49588812"
"chr6","109999393","109999681","chr10","82403814","82404102","51","27595579"
"chr6","110006852","110007110","chr3","39358673","39358948","62","70648179"
"chr6","110011086","110011379","chr20","24010200","24010492","49","86000886"
"chr6","110014604","110014900","chr4","159565684","159565981","15","49551080"
"chr6","110047192","110047466","chr4","159534789","159535073","21","49487597"
"chr6","110071765","110072068","chr4","159514834","159515140","31","49443069"
"chr6","110081326","110081605","chr4","159504395","159504678","26","49423069"
"chr6","110081643","110081672","chrX","48756129","48756153","7","61325514"
"chr6","110091364","110091613","chr4","159494081","159494322","20","49402717"
"chr6","110093599","110093809","chr4","159491761","159491971","8","49398162"
"chr6","110104670","110104937","chr4","148766314","148766587","52","38661644"
"chr6","110119614","110119921","chr4","159465454","159465754","29","49345840"
"chr6","110324277","110324526","chr4","159447552","159447806","18","49123275"
"chr6","110344582","110344868","chr14","78383925","78384200","64","31960657"
"chr6","110355659","110355974","chr4","159415451","159415768","20","49059792"
"chr6","110372621","110372895","chr4","159403614","159403872","39","49030993"
"chr6","110374539","110374616","chr4","159401896","159401971","8","49027357"
"chr6","110381194","110381368","chr15","8429087","8429254","32","101952107"
"chr6","110381650","110381807","chrX","19212518","19212664","27","91169132"
"chr6","110385891","110386154","chr4","159389895","159390150","26","49004004"
"chr6","110399104","110399343","chr4","159376773","159377009","16","48977669"
"chr6","110412635","110412765","chr4","159363419","159363554","10","48950784"
"chr6","110413061","110413210","chr4","159362971","159363120","17","48949910"
"chr6","110486344","110486651","chr4","159287379","159287692","34","48801035"
"chr6","110492971","110493291","chr4","159280732","159281043","43","48787761"
"chr6","110508172","110508473","chr4","17925503","17925807","56","92582669"
"chr6","110516953","110517242","chr18","36205933","36206221","61","74311020"
"chr6","110631331","110631642","chr1","39092983","39093291","59","71538348"
"chr6","110640304","110640602","chr4","159139103","159139403","20","48498799"
"chr6","110643502","110643804","chr4","159135639","159135942","22","48492137"
"chr6","110662188","110662471","chr4","159116014","159116297","24","48453826"
"chr6","110673259","110673613","chr4","159106496","159106788","83","48433237"
"chr6","110683165","110683460","chr4","159090526","159090826","32","48407361"
"chr6","110742998","110743291","chrX","130394514","130394787","62","19651516"
"chr6","110747302","110747601","chr4","159026339","159026639","25","48279037"
"chr6","110759662","110759967","chr17","80429135","80429431","58","30330527"
"chr6","110794128","110794258","chr4","158979093","158979223","6","48184965"
"chr6","110809590","110809880","chr4","158963515","158963811","26","48153925"
"chr6","110815898","110816196","chr4","158957250","158957554","35","48141352"
"chr6","110822928","110823216","chr4","158950289","158950572","24","48127361"
"chr6","110826221","110826360","chr4","158947199","158947338","9","48120978"
"chr6","110827729","110827840","chr4","158945738","158945848","6","48118009"
"chr6","110844425","110844706","chr4","158929200","158929482","15","48084775"
"chr6","110864607","110864908","chr4","158908949","158909242","33","48044342"
"chr6","110870862","110870980","chr8","101782819","101782936","15","9088043"
"chr6","110873986","110874267","chr4","158899590","158899871","15","48025604"
"chr6","110882514","110882799","chr4","158891053","158891353","29","48008539"
"chr6","110888609","110888884","chr4","158884575","158884858","18","47995966"
"chr6","110920723","110921032","chr17","31143753","31144060","62","79776970"
"chr6","110929354","110929574","chr4","158843620","158843847","28","47914266"
"chr6","110941983","110942290","chr4","158830784","158831080","26","47888801"
"chr6","110949671","110950011","chr4","158823239","158823585","38","47873568"
"chr6","111004526","111004834","chr4","158777781","158778082","22","47773255"
"chr6","111025943","111026229","chr4","158756458","158756741","21","47730515"
"chr6","111059001","111059287","chr4","158724876","158725162","21","47665875"
"chr6","111059325","111059348","chr1","166763118","166763140","7","55703793"
"chr6","111065046","111065354","chr4","158718773","158719065","34","47653727"
"chr6","111115855","111116147","chr4","158672708","158673003","26","47556853"
"chr6","111128368","111128675","chr4","158660668","158660976","10","47532300"
"chr6","111172137","111172438","chr4","158614701","158614992","24","47442564"
"chr6","111179722","111179952","chr4","158607093","158607317","23","47427371"
"chr6","111185229","111185511","chr3","124267629","124267922","56","13082400"
"chr6","111245018","111245318","chr4","158546963","158547279","36","47301945"
"chr6","111273117","111273243","chr4","158520972","158521093","11","47247855"
"chr6","111273536","111273672","chr4","158520544","158520680","17","47247008"
"chr6","111273678","111273961","chr4","158520253","158520538","24","47246575"
"chr6","111285686","111285814","chr4","158507862","158507992","9","47222176"
"chr6","111316188","111316352","chr4","158477010","158477173","9","47160822"
"chr6","111326275","111326577","chr4","158466352","158466651","30","47140077"
"chr6","111328652","111328961","chr9","95294315","95294615","59","16034337"
"chr6","111364351","111364631","chr4","158423696","158423977","15","47059345"
"chr6","111467311","111467557","chr19","48521960","48522205","57","62945351"
"chr6","111480293","111480602","chr4","158325754","158326065","24","46845461"
"chr6","111521460","111521767","chr13","70734060","70734368","62","40787400"
"chr6","111599332","111599632","chr4","158211817","158212117","21","46612485"
"chr6","111694637","111694942","chr15","2818281","2818589","59","108876356"
"chr6","111709215","111709512","chr16","57755205","57755500","59","53954010"
"chr6","111732039","111732238","chr9","1058030","1058231","44","110674009"
"chr6","111765456","111765756","chr7","42555917","42556220","66","69209539"
"chr6","111767916","111768049","chr4","158052419","158052550","13","46284503"
"chr6","111801087","111801344","chr3","7069581","7069837","67","104731506"
"chr6","111812127","111812421","chr4","158015184","158015458","46","46203057"
"chr6","111858152","111858443","chr4","157974443","157974727","28","46116291"
"chr6","111908604","111908909","chr4","157922965","157923278","28","46014361"
"chr6","111930202","111930456","chr7","21896989","21897235","65","90033213"
"chr6","112104655","112104895","chr4","157762259","157762496","24","45657604"
"chr6","112143664","112143676","chr19","37258940","37258951","1","74884724"
"chr6","112143760","112144059","chr4","157728211","157728485","43","45584451"
"chr6","112154007","112154324","chr4","157717721","157718040","29","45563714"
"chr6","112167811","112168063","chr4","157703994","157704246","20","45536183"
"chr6","112172847","112173074","chr6","174926415","174926638","43","62753568"
"chr6","112210270","112210565","chr4","157656017","157656322","33","45445747"
"chr6","112228214","112228329","chr7","52995495","52995612","19","59232719"
"chr6","112228640","112228761","chr4","157638629","157638760","21","45409989"
"chr6","112282493","112282794","chr4","157583547","157583859","33","45301054"
"chr6","112290294","112290596","chr4","157575558","157575861","49","45285264"
"chr6","112314788","112315052","chr4","157552280","157552557","31","45237492"
"chr6","112358955","112359285","chr4","157507410","157507738","23","45148455"
"chr6","112385527","112385639","chr4","157482678","157482790","8","45097151"
"chr6","112442077","112442412","chr7","84841819","84842127","70","27600258"
"chr6","112443915","112444219","chr1","195801657","195801957","57","83357742"
"chr6","112482056","112482254","chr13","107549131","107549307","46","4932925"
                                                                                                                                                                                                                                                                                                                                                                                                                                                                                                                                                                                                                                                                                                                                                                                                                                                                                                                                                                                                                                                                                                                                                                                                                                                                                                                                                                                                                                                                                                                                                                                                                                                                                                                                                                                                                                                                                                                                                                                                                                                                                                                                                                                                                                                                                                                                                                                                                                                                                                                                                                                                                                                                                                                                                                                                                                                                                                                                                                                                                                                                                                                                                                                                                                                                                                                                                                                                                                                                                                                                                                                                                                                                                                                                                                                                                                                                                                                                                                                                                                                                                      "chr6","112483269","112483383","chr4","157378017","157378131","15","44894748"
"chr6","112513322","112513650","chr4","157341390","157341707","33","44828068"
"chr6","112546915","112547040","chr4","157306373","157306498","7","44759458"
"chr6","112550988","112551269","chr4","157302458","157302735","17","44751470"
"chr6","112552156","112552456","chr4","157301296","157301608","33","44749140"
"chr6","112576247","112576547","chr4","157274336","157274636","21","44698089"
"chr6","112586410","112586528","chr20","20290877","20290993","21","92295533"
"chr6","112613495","112613808","chr4","157236015","157236323","41","44622520"
"chr6","112625044","112625157","chr11","113226186","113226302","16","601142"
"chr6","112626986","112627284","chr11","108722619","108722926","52","3904367"
"chr6","112630390","112630672","chr1","213458830","213459114","52","100828440"
"chr6","112637657","112637915","chr4","157204582","157204835","24","44566925"
"chr6","112645173","112645422","chr3","45867625","45867877","57","66777548"
"chr6","112652230","112652530","chr9","64183855","64184162","65","48468375"
"chr6","112664104","112664389","chr2","56795232","56795514","67","55868872"
"chr6","112671702","112671998","chr16","39964733","39965029","59","72706969"
"chr6","112673310","112673595","chr4","157174446","157174728","26","44501136"
"chr6","112679144","112679263","chr11","92649843","92649952","39","20029301"
"chr6","112697778","112698080","chr4","157144964","157145256","19","44447186"
"chr6","112701987","112702312","chr4","157133825","157134136","42","44431838"
"chr6","112733759","112734048","chr4","157119863","157120146","17","44386104"
"chr6","112734779","112735073","chr4","157118843","157119138","24","44384064"
"chr6","112744984","112745266","chr4","157102329","157102611","32","44357345"
"chr6","112770722","112770970","chr4","157076916","157077163","18","44306194"
"chr6","112805332","112805585","chr4","157034803","157035059","29","44229471"
"chr6","112809063","112809354","chr4","157031025","157031307","34","44221962"
"chr6","112819791","112820088","chr4","157020938","157021220","29","44201147"
"chr6","112820351","112820485","chr6","64065434","64065559","29","48754917"
"chr6","112820490","112820798","chr6","136423874","136424180","64","23603384"
"chr6","112831566","112831872","chr4","157010036","157010343","43","44178470"
"chr6","112832569","112832733","chrX","4723080","4723252","34","108109489"
"chr6","112836790","112836906","chr4","157000733","157000850","4","44163943"
"chr6","112837010","112837309","chr4","157000332","157000628","26","44163322"
"chr6","112841571","112841690","chr4","156996392","156996500","23","44154821"
"chr6","112841981","112842129","chr6","136749053","136749193","39","23907072"
"chr6","112849511","112849798","chr4","156986797","156987095","37","44137286"
"chr6","112850938","112851239","chr4","156985935","156986240","30","44134997"
"chr6","112858794","112859078","chr14","34847559","34847843","60","78011235"
"chr6","112882175","112882275","chr4","156949924","156950024","6","44067749"
"chr6","112883924","112884126","chr4","156948090","156948260","44","44064166"
"chr6","112886565","112886731","chr4","156945111","156945278","15","44058546"
"chr6","112886992","112887122","chr4","156944728","156944857","6","44057736"
"chr6","112889651","112889952","chr4","156942250","156942554","23","44052599"
"chr6","112894792","112895043","chr2","203613478","203613733","68","90718686"
"chr6","112909021","112909304","chr4","156924347","156924614","37","44015326"
"chr6","112912007","112912292","chr8","26631165","26631452","69","86280842"
"chr6","112916755","112917023","chr4","156918843","156919078","48","44002088"
"chr6","112935015","112935154","chr16","59464621","59464755","22","53470394"
"chr6","112941655","112941858","chr4","156891311","156891514","15","43949656"
"chr6","112966047","112966079","chr13","63237429","63237467","9","49728618"
"chr6","112966085","112966194","chr15","10591212","10591319","16","102374873"
"chr6","112975314","112975615","chr4","156856644","156856946","26","43881330"
"chr6","112990030","112990326","chr4","156841360","156841665","31","43851330"
"chr6","112992017","112992148","chr4","156839222","156839346","18","43847205"
"chr6","113001869","113002161","chr11","8098665","8098958","55","104903204"
"chr6","113021266","113021566","chr1","223979328","223979622","66","110958062"
"chr6","113024322","113024445","chr12","106932605","106932728","18","6091717"
"chr6","113026090","113026327","chr3","48388161","48388394","55","64637929"
"chr6","113039012","113039291","chr4","156795996","156796286","33","43756984"
"chr6","113052165","113052450","chrX","19405643","19405929","53","93646522"
"chr6","113055848","113055961","chr4","156778148","156778260","5","43722300"
"chr6","113060183","113060469","chr16","55700437","55700720","62","57359746"
"chr6","113080546","113080606","chr4","156753325","156753384","2","43672779"
"chr6","113080892","113081024","chr4","156752897","156753041","18","43672005"
"chr6","113086717","113087012","chr5","22397555","22397847","52","90689162"
"chr6","113100190","113100475","chr4","156732764","156733046","17","43632574"
"chr6","113108443","113108748","chr20","34527434","34527744","61","78581009"
"chr6","113114302","113114386","chr4","156718205","156718289","7","43603903"
"chr6","113121320","113121628","chr4","156710766","156711072","8","43589446"
"chr6","113126462","113126765","chr3","120550831","120551128","55","7424369"
"chr6","113133376","113133510","chr3","43002189","43002326","23","70131187"
"chr6","113144516","113144753","chr4","156690422","156690659","22","43545906"
"chr6","113156307","113156594","chr1","15871355","15871643","67","97284952"
"chr6","113158059","113158345","chr3","123699206","123699496","68","10541147"
"chr6","113187438","113187715","chr2","45901601","45901884","56","67285837"
"chr6","113187754","113187765","chr2","93568724","93568734","2","19619030"
"chr6","113196956","113197245","chr4","156647357","156647657","29","43450401"
"chr6","113202163","113202459","chr4","156640712","156641005","19","43438549"
"chr6","113232053","113232344","chr4","156611547","156611820","40","43379494"
"chr6","113241905","113242209","chr4","156601678","156601973","28","43359773"
"chr6","113244680","113244956","chr4","156598621","156598861","49","43353941"
"chr6","113258664","113258968","chr4","156584687","156584975","34","43326023"
"chr6","113275437","113275534","chr4","156570539","156570638","7","43295102"
"chr6","113275535","113275744","chr4","156570328","156570538","22","43294793"
"chr6","113281361","113281628","chr4","156564458","156564727","24","43283097"
"chr6","113286044","113286350","chr11","122164387","122164686","56","8878343"
"chr6","113321976","113322288","chr1","182642228","182642528","71","69320252"
"chr6","113332760","113333104","chr4","156510086","156510386","66","43177326"
"chr6","113334340","113334643","chr4","156508524","156508827","26","43174184"
"chr6","113381150","113381440","chr4","156461485","156461774","19","43080335"
"chr6","113385967","113386247","chr4","156456642","156456941","46","43070675"
"chr6","113393005","113393320","chr10","30337711","30338027","69","83055294"
"chr6","113403846","113404147","chr4","156438531","156438835","34","43034685"
"chr6","113430123","113430345","chr4","156412295","156412518","13","42982172"
"chr6","113438413","113438542","chr4","156403696","156403820","17","42965283"
"chr6","113438826","113439005","chr4","43754275","43754455","36","69684551"
"chr6","113462756","113463059","chr4","156377273","156377576","24","42914517"
"chr6","113479013","113479307","chr1","32090539","32090837","50","81388474"
"chr6","113480648","113480816","chr4","156359673","156359840","14","42879025"
"chr6","113481108","113481255","chr4","156359223","156359371","10","42878115"
"chr6","113483334","113483555","chr7","80671684","80671903","47","32811650"
"chr6","113491790","113492033","chr7","53990694","53990933","49","59501096"
"chr6","113528429","113528708","chr4","156314409","156314679","24","42785980"
"chr6","113537360","113537652","chr4","156304348","156304652","40","42766988"
"chr6","113540521","113540733","chr1","44433526","44433738","47","69106995"
"chr6","113542971","113543230","chr4","156298815","156299075","12","42755844"
"chr6","113551919","113552224","chr4","156289919","156290218","19","42738000"
"chr6","113739888","113740126","chr4","156107525","156107763","16","42367637"
"chr6","113763373","113763669","chr3","43395486","43395788","69","70367887"
"chr6","113800555","113800839","chr4","156050969","156051261","26","42250414"
"chr6","113877970","113878253","chr4","155972469","155972752","17","42094499"
"chr6","113959524","113959778","chr4","155885089","155885337","21","41925565"
"chr6","113985752","113985942","chr18","52085735","52085907","56","61900017"
"chr6","113995200","113995399","chr4","155851661","155851862","8","41856461"
"chr6","114181519","114181817","chr3","48912121","48912409","64","65269398"
"chr6","114227595","114227882","chr16","58025688","58025978","60","56201907"
"chr6","114302184","114302470","chr4","155531398","155531694","28","41229214"
"chr6","114325779","114326080","chr4","155506687","155506999","31","41180908"
"chr6","114419759","114420045","chr4","155401870","155402146","34","40982111"
"chr6","114531436","114531713","chrX","46651109","46651405","77","67880327"
"chr6","114695050","114695312","chr4","155128394","155128650","53","40433344"
"chr6","114772277","114772560","chr4","155054240","155054526","28","40281963"
"chr6","114953317","114953595","chr1","56899039","56899309","58","58054278"
"chr6","115246139","115246291","chr16","44166142","44166284","39","71079997"
"chr6","115246421","115246525","chr3","166885046","166885160","24","51638625"
"chr6","115293047","115293338","chr4","154492510","154492803","30","39199463"
"chr6","115341722","115341991","chr4","154445507","154445774","23","39103785"
"chr6","115343675","115343972","chr4","154443544","154443842","30","39099869"
"chr6","115425130","115425420","chr4","154368766","154369058","31","38943636"
"chr6","115428949","115429267","chr4","154364950","154365264","24","38936001"
"chr6","115438842","115439107","chr4","154354856","154355118","49","38916014"
"chr6","115483107","115483389","chr4","154309619","154309901","23","38826512"
"chr6","115488160","115488454","chr17","81465226","81465519","64","34022934"
"chr6","115492432","115492515","chr3","116979552","116979635","11","1487120"
"chr6","115495955","115496265","chr4","154296821","154297131","19","38800866"
"chr6","115500085","115500391","chr4","154292442","154292752","29","38792357"
"chr6","115521055","115521176","chr9","25733002","25733121","19","89788053"
"chr6","115523140","115523439","chr4","154269493","154269789","41","38746353"
"chr6","115537365","115537676","chr4","154254682","154255002","36","38717317"
"chr6","115546085","115546320","chr4","154245030","154245266","19","38698945"
"chr6","115550881","115550993","chr4","154240370","154240487","12","38689489"
"chr6","115551636","115551806","chrX","22690614","22690775","45","92861022"
"chr6","115567642","115567860","chr4","154222883","154223105","16","38655241"
"chr6","115579201","115579515","chr20","26813007","26813319","59","88766194"
"chr6","115580436","115580722","chr4","154209673","154209951","22","38629237"
"chr6","115583965","115584253","chr10","77425876","77426160","62","38158089"
"chr6","115592940","115593253","chr4","154197083","154197429","74","38604143"
"chr6","115597639","115597919","chrX","2793721","2793999","48","112803918"
"chr6","115606821","115607167","chr4","154182543","154182873","38","38575722"
"chr6","115618024","115618331","chr4","154171388","154171694","35","38553364"
"chr6","115628935","115629218","chr5","51218573","51218857","67","64410362"
"chr6","115639956","115640257","chrX","4034774","4035064","65","111605182"
"chr6","115641442","115641733","chr4","154149114","154149403","22","38507672"
"chr6","115646531","115646824","chr4","154145176","154145470","11","38498645"
"chr6","115673771","115674081","chr4","154116525","154116811","42","38442754"
"chr6","115761090","115761109","chr2","188170636","188170655","2","72409546"
"chr6","115761136","115761416","chr2","163445135","163445414","57","47683999"
"chr6","115799244","115799518","chr5","25258187","25258455","71","90541057"
"chr6","115806176","115806441","chr4","153978339","153978623","42","38172163"
"chr6","115806711","115806846","chr4","114936919","114937049","27","869792"
"chr6","115887208","115887384","chr4","153893354","153893538","16","38006146"
"chr6","115902920","115903084","chr4","153868757","153868913","22","37965837"
"chr6","115903402","115903447","chr4","153868411","153868456","0","37965009"
"chr6","115964920","115964978","chr2","129748244","129748293","12","13783324"
"chr6","115991748","115991860","chr4","153779294","153779401","13","37787546"
"chr6","115992171","115992366","chr4","153778827","153779024","12","37786656"
"chr6","116046960","116047182","chrX","41460673","41460897","58","74586287"
"chr6","116063347","116063471","chr13","9638870","9638993","24","106424477"
"chr6","116118649","116118982","chr8","37896966","37897278","75","78221683"
"chr6","116125804","116126103","chr4","153650061","153650351","27","37524257"
"chr6","116181574","116181674","chr15","25344931","25345032","24","90836643"
"chr6","116206092","116206384","chr4","153570970","153571276","31","37364878"
"chr6","116206575","116206878","chr4","153570484","153570787","22","37363909"
"chr6","116275328","116275622","chr4","153503771","153504075","45","37228443"
"chr6","116331611","116331656","chr6","179329613","179329658","12","62998002"
"chr6","116410020","116410295","chr4","153377556","153377837","30","36967536"
"chr6","116580718","116580829","chr11","7311479","7311588","19","109269239"
"chr6","116671574","116671885","chr1","35595269","35595576","56","81076305"
"chr6","116848376","116848435","chr4","152963362","152963421","4","36114986"
"chr6","117048891","117049196","chr4","152849752","152850056","34","35800861"
"chr6","117050439","117050621","chr4","152848324","152848514","20","35797885"
"chr6","117078575","117078704","chr4","152808776","152808895","18","35730201"
"chr6","117234751","117235033","chr4","152609353","152609608","48","35374602"
"chr6","117286486","117286795","chr3","42967128","42967429","62","74319358"
"chr6","117367543","117367673","chr13","25546692","25546816","21","91820851"
"chr6","117424824","117425125","chrX","18781652","18781959","59","98643172"
"chr6","117462233","117462533","chr4","159565684","159565981","71","42103451"
"chr6","117635895","117636184","chr4","152132292","152132581","19","34496397"
"chr6","117703095","117703217","chr13","6306760","6306883","21","111396335"
"chr6","117917533","117917839","chr4","151849040","151849375","55","33931507"
"chr6","117925747","117925960","chr4","151840330","151840549","16","33914583"
"chr6","118018130","118018214","chr4","151747483","151747569","13","33729353"
"chr6","118028193","118028469","chr4","151737064","151737356","33","33708871"
"chr6","118032299","118032525","chr4","151732706","151732946","24","33700407"
"chr6","118241876","118242151","chr1","114741175","114741451","68","3500701"
"chr6","118242274","118242578","chr7","63213738","63214044","48","55028536"
"chr6","118269441","118269772","chr7","55406353","55406635","95","62863088"
"chr6","118343036","118343293","chr7","3869452","3869694","56","114473584"
"chr6","118388203","118388364","chr6","72440552","72440709","36","45947651"
"chr6","118415292","118415582","chr4","151351669","151351957","23","32936377"
"chr6","118446205","118446342","chr4","151323934","151324061","19","32877729"
"chr6","118527920","118528206","chr4","151245831","151246116","26","32717911"
"chr6","118536085","118536405","chr4","151237204","151237529","28","32701119"
"chr6","118538912","118539083","chr4","151234543","151234714","12","32695631"
"chr6","118563181","118563476","chr4","151208888","151209182","22","32645707"
"chr6","118613200","118613483","chr4","151163740","151164021","47","32550540"
"chr6","118626697","118626821","chr4","151151267","151151385","9","32524570"
"chr6","118652433","118652691","chr4","151127096","151127354","10","32474663"
"chr6","118664821","118664943","chr14","109751120","109751242","17","8913701"
"chr6","118879457","118879770","chr4","150908934","150909247","22","32029477"
"chr6","118889718","118889994","chr4","150898866","150899144","16","32009148"
"chr6","118913105","118913413","chr4","150875404","150875697","55","31962299"
"chr6","118930558","118930670","chr4","150858333","150858453","19","31927775"
"chr6","118957525","118957803","chr7","136394001","136394278","64","17436476"
"chr6","119111544","119111826","chr4","150701520","150701806","24","31589976"
"chr6","119464183","119464470","chr4","150353664","150353960","32","30889481"
"chr6","119472279","119472559","chr4","150346874","150347151","24","30874595"
"chr6","119513617","119513915","chr4","150305236","150305521","50","30791619"
"chr6","119537345","119537617","chr4","150283357","150283605","44","30746012"
"chr6","119549985","119550099","chr4","150270231","150270348","11","30720246"
"chr6","119554006","119554196","chr15","24140020","24140208","45","95413986"
"chr6","119587753","119588023","chr4","150226708","150226971","24","30638955"
"chr6","119608476","119608585","chr4","150200658","150200766","9","30592182"
"chr6","119609325","119609541","chr4","150200024","150200223","32","30590699"
"chr6","119633620","119633903","chr4","150175193","150175476","18","30541573"
"chr6","119636449","119636683","chr9","115917326","115917547","62","3719123"
"chr6","119638941","119639234","chr4","150169148","150169436","21","30530207"
"chr6","119640589","119640872","chr4","150165896","150166163","38","30525307"
"chr6","119693611","119693897","chr4","150119368","150119648","20","30425757"
"chr6","119704579","119704664","chr4","150105168","150105257","9","30400589"
"chr6","119717513","119717817","chr4","150092538","150092802","56","30375025"
"chr6","119830398","119830687","chr4","149999371","149999659","17","30168973"
"chr6","119862525","119862814","chr4","149967265","149967548","50","30104740"
"chr6","119919855","119920094","chr4","149906721","149906968","23","29986866"
"chr6","119954260","119954553","chr4","149879476","149879759","28","29925216"
"chr6","119989216","119989510","chr14","56124109","56124398","44","63865107"
"chr6","120033865","120034169","chr11","117366311","117366614","55","2667554"
"chr6","120054742","120055018","chr4","149784887","149785164","15","29730145"
"chr6","120065608","120065899","chr4","149774190","149774465","30","29708582"
"chr6","120091933","120092225","chr2","160551205","160551504","57","40459272"
"chr6","120136458","120136594","chr7","51796125","51796255","26","68340333"
"chr6","120154733","120155001","chr4","149687412","149687683","27","29532679"
"chr6","120156089","120156387","chr4","149686064","149686366","20","29529975"
"chr6","120170150","120170435","chr4","149665569","149665851","29","29495419"
"chr6","120205067","120205335","chr4","149626761","149627029","16","29421694"
"chr6","120259998","120260123","chr1","38189930","38190077","40","82070068"
"chr6","120298846","120299140","chr4","149479804","149480100","30","29180958"
"chr6","120316522","120316827","chr4","149456280","149456574","70","29139758"
"chr6","120346034","120346327","chr4","149426544","149426840","19","29080510"
"chr6","120389964","120390260","chr4","149386443","149386775","64","28996479"
"chr6","120465213","120465517","chr4","149316134","149316443","39","28850921"
"chr6","120512959","120513255","chr4","149267834","149268126","24","28754875"
"chr6","120631035","120631300","chr4","149154204","149154509","57","28523169"
"chr6","120653343","120653632","chrX","18476168","18476453","50","102177175"
"chr6","120654522","120654604","chr4","149133091","149133173","4","28478569"
"chr6","120676393","120676612","chr4","149111651","149111878","25","28435258"
"chr6","120693496","120693770","chr3","123351694","123351976","61","2658198"
"chr6","120718491","120718795","chr4","149068400","149068696","28","28349909"
"chr6","120753599","120753918","chr4","149035883","149036199","22","28282284"
"chr6","120792240","120792516","chr4","149001557","149001826","32","28209317"
"chr6","120803180","120803467","chr4","148990591","148990873","30","28187411"
"chr6","120824947","120825232","chr4","148964346","148964620","33","28139399"
"chr6","120827481","120827788","chr1","36719992","36720294","58","84107489"
"chr6","120836290","120836601","chr12","20877027","20877327","70","99959263"
"chr6","120846146","120846442","chr16","68450975","68451269","66","52395171"
"chr6","120905048","120905337","chr4","148877124","148877418","31","27972076"
"chr6","120913962","120913993","chr2","94525820","94525851","7","26388142"
"chr6","120914025","120914149","chr1","128870903","128871024","25","7956878"
"chr6","120931379","120931679","chr4","148853454","148853746","25","27922075"
"chr6","120973144","120973313","chr4","148814711","148814866","30","27841567"
"chr6","120973327","120973624","chr4","148814397","148814697","16","27841070"
"chr6","120975216","120975309","chr1","139858773","139858866","17","18883557"
"chr6","121005258","121005565","chr4","148767848","148768156","21","27762590"
"chr6","121006805","121007066","chr4","148766314","148766587","41","27759509"
"chr6","121009137","121009408","chr4","148763650","148763898","50","27754513"
"chr6","121012196","121012502","chr4","148760411","148760717","14","27748215"
"chr6","121036501","121036632","chr4","148734908","148735060","39","27698407"
"chr6","121036902","121037040","chr4","148734506","148734645","11","27697604"
"chr6","121042969","121043274","chr4","148728251","148728547","33","27685282"
"chr6","121062504","121062637","chr4","148707791","148707925","7","27645287"
"chr6","121066791","121066918","chr16","39379692","39379819","21","81687099"
"chr6","121066962","121067107","chr12","21323547","21323703","35","99743415"
"chr6","121069368","121069483","chr17","25131519","25131635","17","95937849"
"chr6","121094105","121094255","chr6","87757586","87757731","32","33336519"
"chr6","121142184","121142455","chr8","129378620","129378892","57","8236436"
"chr6","121147449","121147775","chr4","148622202","148622531","43","27474753"
"chr6","121182280","121182575","chr4","148589383","148589690","26","27407103"
"chr6","121213298","121213589","chr4","148558818","148559108","25","27345520"
"chr6","121225409","121225544","chr10","30449663","30449796","26","90775746"
"chr6","121225858","121226032","chr9","23416072","23416242","40","97809786"
"chr6","121250863","121251157","chr4","148520883","148521158","36","27270020"
"chr6","121305535","121305809","chr11","63273330","63273621","65","58032205"
"chr6","121687520","121687640","chr13","65486709","65486830","22","56200811"
"chr6","121790973","121791271","chr4","147921388","147921686","15","26130415"
"chr6","121799138","121799448","chr4","147913254","147913550","28","26114116"
"chr6","121837100","121837397","chr4","147874868","147875167","25","26037768"
"chr6","121905043","121905326","chr4","147803309","147803569","57","25898266"
"chr6","122238138","122238430","chr19","43185849","43186137","62","79052289"
"chr6","122330263","122330360","chr4","37239766","37239856","25","85090497"
"chr6","122330421","122330540","chr11","74908271","74908389","17","47422150"
"chr6","122435854","122435975","chr4","147275170","147275288","10","24839316"
"chr6","122482837","122483117","chr4","147222509","147222789","24","24739672"
"chr6","122843979","122844267","chr10","69629356","69629644","69","53214623"
"chr6","122922135","122922355","chr15","8384710","8384936","61","114537425"
"chr6","122954777","122955063","chr4","146742155","146742443","30","23787378"
"chr6","123269424","123269707","chr4","146458532","146458815","14","23189108"
"chr6","123283507","123283790","chr4","146428601","146428887","21","23145094"
"chr6","123302727","123303032","chr4","146410167","146410457","49","23107440"
"chr6","123313066","123313364","chr2","72923747","72924047","61","50389319"
"chr6","123331075","123331212","chr4","146367913","146368050","11","23036838"
"chr6","123339356","123339487","chr3","50262642","50262767","20","73076714"
"chr6","123344879","123345068","chr4","146350818","146351015","19","23005939"
"chr6","123352186","123352309","chr4","146343468","146343590","6","22991282"
"chr6","123366806","123367116","chr4","146328197","146328502","33","22961391"
"chr6","123378625","123378889","chr4","146316313","146316573","17","22937688"
"chr6","123382643","123382952","chr4","146312986","146313303","32","22930343"
"chr6","123386713","123386959","chr3","13343257","13343484","55","110043456"
"chr6","123411838","123411984","chr4","146282467","146282611","8","22870629"
"chr6","123412294","123412596","chr4","146281688","146281957","60","22869394"
"chr6","123421911","123422097","chr4","146272024","146272210","11","22850113"
"chr6","123430181","123430429","chr4","146263583","146263831","16","22833402"
"chr6","123430847","123431150","chr4","146262865","146263170","19","22832018"
"chr6","123452376","123452660","chr4","146240625","146240924","35","22788249"
"chr6","123453461","123453749","chr4","146239527","146239836","46","22786066"
"chr6","123457164","123457448","chr4","146235151","146235451","44","22777987"
"chr6","123462710","123463008","chr4","146229923","146230233","24","22767213"
"chr6","123464146","123464276","chr19","14386135","14386267","22","109078011"
"chr6","123476147","123476205","chr8","56615182","56615241","14","66860965"
"chr6","123493971","123494264","chr4","146199260","146199546","24","22705289"
"chr6","123494731","123495020","chr4","146198497","146198780","27","22703766"
"chr6","123497497","123497807","chr2","70373349","70373648","60","53124148"
"chr6","123497951","123498213","chr3","46809765","46810027","75","76688186"
"chr6","123502054","123502218","chr4","146190113","146190289","33","22688059"
"chr6","123507299","123507593","chr4","146184718","146185018","23","22677419"
"chr6","123519220","123519341","chr4","146171488","146171606","14","22652268"
"chr6","123520632","123520964","chr7","156977987","156978291","71","33457355"
"chr6","123523999","123524216","chr4","146166583","146166795","25","22642584"
"chr6","123524470","123524594","chr4","146166199","146166323","7","22641729"
"chr6","123561311","123561478","chr4","146134198","146134367","15","22572887"
"chr6","123561828","123562049","chr3","35639309","35639528","41","87922519"
"chr6","123568396","123568487","chr4","146141043","146141123","13","22572647"
"chr6","123578839","123579133","chr4","146151690","146151977","38","22572851"
"chr6","123579249","123579536","chr4","146152102","146152399","27","22572853"
"chr6","123581199","123581487","chr4","146154090","146154387","34","22572891"
"chr6","123583241","123583491","chr4","30703370","30703641","65","92879871"
"chr6","123608008","123608278","chr4","146083321","146083629","58","22475313"
"chr6","123638287","123638591","chr4","146059267","146059546","44","22420980"
"chr6","123653820","123653902","chr5","185046850","185046932","21","61393030"
"chr6","123688324","123688636","chr2","107411533","107411833","63","16276791"
"chr6","123694519","123694836","chr10","10625974","10626278","71","113068545"
"chr6","123709741","123710058","chrX","64991673","64991978","73","58718068"
"chr6","123721637","123721928","chr2","163045985","163046280","64","39324348"
"chr6","123739510","123739807","chr11","8098665","8098958","68","115640845"
"chr6","123751266","123751565","chr4","145902228","145902518","29","22150962"
"chr6","123757355","123757625","chr4","145895816","145896118","46","22138461"
"chr6","123759815","123760126","chr4","145893346","145893657","27","22133531"
"chr6","123766317","123766611","chr4","145886836","145887116","32","22120519"
"chr6","123796619","123796949","chr4","145841897","145842209","44","22045278"
"chr6","123837243","123837548","chr2","184143766","184144059","69","60306523"
"chr6","123886410","123886678","chr20","34365974","34366236","74","89520436"
"chr6","123998611","123998692","chr4","145630304","145630385","7","21631693"
"chr6","124027799","124028087","chr4","145595893","145596179","23","21568094"
"chr6","124034963","124035274","chr4","145582201","145582512","30","21547238"
"chr6","124061781","124061966","chr4","145549898","145550085","11","21488117"
"chr6","124191432","124191728","chr1","62607497","62607792","57","61583935"
"chr6","124196396","124196635","chr4","145404737","145404998","37","21208341"
"chr6","124203268","124203571","chr4","145397658","145397957","27","21194390"
"chr6","124248006","124248311","chr4","145353591","145353889","27","21105585"
"chr6","124250246","124250542","chr5","42278676","42278963","60","81971570"
"chr6","124439196","124439495","chr4","145158646","145158942","18","20719450"
"chr6","124580421","124580552","chr4","145024264","145024395","9","20443843"
"chr6","124616201","124616463","chr4","144989636","144989903","24","20373435"
"chr6","124720677","124720962","chr4","144885439","144885721","30","20164762"
"chr6","124743690","124743880","chr4","144867732","144867918","13","20124042"
"chr6","124819737","124820007","chr4","144753430","144753669","47","19933693"
"chr6","124822647","124822919","chr4","144750805","144751079","29","19928158"
"chr6","124970731","124971011","chrX","125989015","125989296","49","1018284"
"chr6","125074186","125074480","chr4","144502262","144502583","50","19428076"
"chr6","125123732","125124030","chr10","60861008","60861308","62","64262724"
"chr6","125329735","125330001","chr4","144220766","144221029","22","18891031"
"chr6","125340291","125340576","chrX","19252603","19252887","59","106087688"
"chr6","125406051","125406235","chr4","144154430","144154613","13","18748379"
"chr6","125406548","125406669","chr4","144153993","144154114","17","18747445"
"chr6","125525891","125526163","chr17","80944041","80944326","65","44581850"
"chr6","125543937","125544246","chr4","144017839","144018122","42","18473902"
"chr6","125620244","125620521","chr1","155141171","155141450","70","29520927"
"chr6","125636176","125636456","chr4","143924800","143925079","21","18288624"
"chr6","125671247","125671529","chr12","61099578","61099857","58","64571669"
"chr6","125696029","125696303","chr4","143863858","143864154","47","18167829"
"chr6","125864383","125864669","chr5","81979852","81980138","67","43884531"
"chr6","125885645","125885824","chr17","28636147","28636328","56","97249498"
"chr6","125996610","125996843","chr4","143545916","143546150","13","17549306"
"chr6","126051404","126051705","chr4","143489477","143489778","17","17438073"
"chr6","126093725","126093847","chr16","34749367","34749491","21","91344358"
"chr6","126286832","126287126","chr4","143257373","143257677","25","16970541"
"chr6","126324383","126324669","chr4","143224475","143224762","22","16900092"
"chr6","126355342","126355648","chr4","143191212","143191517","20","16835870"
"chr6","126660914","126661181","chr4","142879165","142879428","22","16218251"
"chr6","126665728","126665848","chr4","142874184","142874305","7","16208456"
"chr6","126895735","126896004","chr4","142644597","142644867","13","15748862"
"chr6","127014935","127015229","chr3","127162429","127162726","59","147494"
"chr6","127017417","127017647","chr4","142521800","142522023","25","15504383"
"chr6","127039840","127040147","chr4","142501479","142501794","32","15461639"
"chr6","127041332","127041562","chr4","142500054","142500286","17","15458722"
"chr6","127065322","127065625","chr4","142481053","142481358","32","15415731"
"chr6","127072403","127072688","chr4","142473682","142473973","39","15401279"
"chr6","127076069","127076368","chr4","142470023","142470321","22","15393954"
"chr6","127137351","127137480","chr4","142408878","142409008","7","15271527"
"chr6","127172249","127172531","chr4","142381177","142381457","30","15208928"
"chr6","127225773","127226054","chr4","142313147","142313429","19","15087374"
"chr6","127268095","127268219","chr4","142269116","142269240","6","15001021"
"chr6","127277563","127277689","chr4","142259591","142259717","10","14982028"
"chr6","127489075","127489242","chr4","142052697","142052871","11","14563622"
"chr6","127489545","127489684","chr4","142052257","142052389","19","14562712"
"chr6","127613740","127613999","chr6","137204798","137205056","62","9591058"
"chr6","127725206","127725482","chr15","109742557","109742830","71","17982649"
"chr6","127730544","127730840","chr4","141817344","141817643","21","14086800"
"chr6","127740648","127740945","chr4","141806618","141806924","30","14065970"
"chr6","127760874","127761161","chr4","141785959","141786252","30","14025085"
"chr6","127768144","127768471","chr4","141778312","141778647","36","14010168"
"chr6","127867815","127868084","chr4","141678251","141678529","23","13810436"
"chr6","127893781","127893889","chr1","46048870","46048978","24","81844911"
"chr6","127915543","127915849","chr3","58245266","58245574","55","69670277"
"chr6","127964150","127964439","chr4","141573897","141574189","29","13609747"
"chr6","128195618","128195839","chr4","37640683","37640899","54","90554935"
"chr6","128237216","128237520","chr2","50830762","50831062","65","77406454"
"chr6","128542686","128542986","chr4","140971930","140972210","55","12429244"
"chr6","128721540","128721812","chr4","140797541","140797814","29","12076001"
"chr6","129229485","129229775","chr4","140291912","140292221","33","11062427"
"chr6","129377196","129377457","chr1","188873437","188873698","55","59496241"
"chr6","129394250","129394472","chr4","140101970","140102207","27","10707720"
"chr6","129449586","129449871","chr4","140041087","140041370","41","10591501"
"chr6","129623613","129623922","chr4","139867830","139868136","31","10244217"
"chr6","129874858","129875088","chr4","139560005","139560231","17","9685147"
"chr6","129877454","129877712","chr10","17391967","17392212","73","112485487"
"chr6","129955617","129955929","chr4","139478431","139478741","23","9522814"
"chr6","130026212","130026507","chr4","139405790","139406094","28","9379578"
"chr6","130100273","130100554","chrX","112227503","112227781","75","17872770"
"chr6","130101392","130101516","chr4","139330095","139330218","12","9228703"
"chr6","130143925","130144042","chr1","112501233","112501350","18","17642692"
"chr6","130144092","130144261","chr4","153868757","153868913","34","23724665"
"chr6","130208102","130208397","chr4","149426544","149426840","62","19218442"
"chr6","130310649","130310955","chr4","139075420","139075693","49","8764771"
"chr6","130325675","130325973","chr4","139060133","139060429","20","8734458"
"chr6","130336500","130336662","chr5","51605931","51606094","42","78730569"
"chr6","130361874","130362171","chr4","139023102","139023418","32","8661228"
"chr6","130407738","130407950","chr12","77029832","77030042","49","53377906"
"chr6","130430383","130430511","chr4","36960164","36960294","22","93470219"
"chr6","130430547","130430691","chr9","87610150","87610287","33","42820397"
"chr6","130453504","130453685","chr14","2892685","2892852","47","127560819"
"chr6","130516501","130516795","chr4","138863001","138863318","42","8346500"
"chr6","130591426","130591743","chr8","64687034","64687345","66","65904392"
"chr6","130603859","130603976","chr4","13998167","13998284","20","116605692"
"chr6","130743231","130743517","chr4","138629931","138630225","30","7886700"
"chr6","130776227","130776478","chr16","18189474","18189729","58","112586753"
"chr6","130799380","130799660","chr4","138573918","138574227","46","7774538"
"chr6","130839193","130839473","chr4","138540410","138540699","28","7701217"
"chr6","130850358","130850662","chr4","138529058","138529363","30","7678700"
"chr6","130879941","130880231","chr20","28618222","28618522","55","102261719"
"chr6","130917216","130917391","chr4","138462947","138463126","17","7545731"
"chr6","130932789","130933075","chr4","138446578","138446894","47","7513789"
"chr6","130995546","130995827","chr4","138381908","138382177","31","7386362"
"chr6","131199511","131199795","chr1","24154629","24154925","61","107044882"
"chr6","131230051","131230171","chr4","138160501","138160620","11","6930450"
"chr6","131256882","131257170","chr4","138132525","138132808","34","6875643"
"chr6","131290628","131290858","chr4","138099313","138099541","19","6808685"
"chr6","131316997","131317106","chr4","138072778","138072887","6","6755781"
"chr6","131336996","131337116","chr4","138052021","138052143","8","6715025"
"chr6","131341672","131341980","chr4","138046854","138047163","41","6705182"
"chr6","131376806","131377105","chr5","58374664","58374949","63","73002142"
"chr6","131398707","131399034","chr4","137994854","137995189","29","6596147"
"chr6","131492018","131492310","chr4","137903200","137903494","24","6411182"
"chr6","131509716","131510021","chr4","137885261","137885561","25","6375545"
"chr6","131541684","131541986","chr7","47672853","47673140","76","83868831"
"chr6","131547545","131547852","chr4","137846903","137847194","35","6299358"
"chr6","131553224","131553428","chr4","137840969","137841167","16","6287745"
"chr6","131570762","131571072","chr4","137822091","137822405","23","6251329"
"chr6","131616519","131616828","chr4","137775480","137775767","42","6158961"
"chr6","131645866","131645989","chr4","137746374","137746499","7","6100508"
"chr6","131662543","131662819","chr4","137729510","137729794","32","6066967"
"chr6","131674904","131675204","chr11","6522521","6522820","58","125152383"
"chr6","131681686","131681782","chr4","137709881","137709978","10","6028195"
"chr6","131686201","131686496","chr4","137705555","137705851","26","6019354"
"chr6","131690540","131690849","chr4","137701074","137701380","28","6010534"
"chr6","131715478","131715744","chr4","137680123","137680397","40","5964645"
"chr6","131727868","131728032","chr4","137667045","137667201","18","5939177"
"chr6","131748036","131748167","chr10","84802957","84803087","20","46945079"
"chr6","131798525","131798836","chr4","137588755","137589056","26","5790230"
"chr6","131806244","131806331","chr1","161702546","161702629","19","29896302"
"chr6","131807396","131807683","chr4","137579596","137579911","58","5772200"
"chr6","131821662","131821980","chr4","137564988","137565286","40","5743326"
"chr6","131834790","131834958","chr4","137551997","137552166","14","5717207"
"chr6","131896517","131896767","chr4","137490950","137491212","30","5594433"
"chr6","131902596","131902885","chr4","137484775","137485115","63","5582179"
"chr6","131906666","131906942","chr11","61495292","61495561","52","70411374"
"chr6","131936051","131936293","chr1","187209281","187209524","51","55273230"
"chr6","131936842","131937130","chr4","137448529","137448817","25","5511687"
"chr6","131966344","131966644","chr4","137419724","137420040","46","5453380"
"chr6","132061014","132061135","chr4","137324030","137324148","8","5263016"
"chr6","132073085","132073405","chr4","137311416","137311724","30","5238331"
"chr6","132102165","132102450","chr4","137288822","137289126","38","5186657"
"chr6","132116704","132117031","chr4","137273082","137273381","41","5156378"
"chr6","132341444","132341765","chr4","137047249","137047562","27","4705805"
"chr6","132463489","132463733","chr4","136915831","136916065","58","4452342"
"chr6","132566886","132567185","chr4","136811271","136811570","19","4244385"
"chr6","132571999","132572268","chr4","136806453","136806706","37","4234454"
"chr6","132636411","132636691","chr7","100651852","100652138","55","31984559"
"chr6","132650305","132650599","chr2","43036767","43037061","77","89613538"
"chr6","132651083","132651357","chr4","136726829","136727133","48","4075746"
"chr6","132654950","132655253","chr2","84402585","84402878","63","48252365"
"chr6","132691078","132691371","chr4","136685614","136685921","31","3994536"
"chr6","132745185","132745472","chr4","136634209","136634490","23","3889024"
"chr6","132753355","132753651","chr4","136624531","136624834","25","3871176"
"chr6","132878426","132878735","chr4","136497025","136497328","22","3618599"
"chr6","132895409","132895710","chr4","136480088","136480390","15","3584679"
"chr6","132928688","132928988","chr4","136447356","136447660","15","3518668"
"chr6","132953847","132954123","chr4","136420336","136420614","32","3466489"
"chr6","132976664","132976969","chr4","136396721","136397024","27","3420057"
"chr6","132987606","132987880","chr4","136384746","136385061","56","3397140"
"chr6","133011826","133012105","chr4","136368377","136368653","30","3356551"
"chr6","133013092","133013427","chr4","136367059","136367379","57","3353967"
"chr6","133021928","133022046","chr4","136360166","136360284","9","3338238"
"chr6","133053561","133053679","chr13","24665652","24665769","15","108387909"
"chr6","133062361","133062651","chr4","136326611","136326903","13","3264250"
"chr6","133063697","133064005","chr4","136324924","136325231","17","3261227"
"chr6","133079718","133079988","chr4","136306388","136306687","43","3226670"
"chr6","133114634","133114976","chr4","136261340","136261655","67","3146706"
"chr6","133163937","133164030","chr4","136217893","136217991","8","3053956"
"chr6","133193935","133194231","chr4","136185718","136186018","19","2991783"
"chr6","133242105","133242377","chr4","136146933","136147192","24","2904828"
"chr6","133264723","133264841","chr4","136129622","136129740","8","2864899"
"chr6","133274804","133275099","chr4","136116118","136116414","23","2841314"
"chr6","133305519","133305808","chr4","136084907","136085197","15","2779388"
"chr6","133337586","133337873","chr4","136055842","136056108","41","2718256"
"chr6","133360332","133360637","chr4","136032793","136033098","22","2672461"
"chr6","133386532","133386595","chr4","136006458","136006522","5","2619926"
"chr6","133387583","133387808","chr4","136005243","136005468","19","2617660"
"chr6","133467717","133468006","chr14","115049792","115050083","51","18417925"
"chr6","133527424","133527708","chr4","135867264","135867531","30","2339840"
"chr6","133539298","133539644","chr4","135850217","135850543","37","2310919"
"chr6","133547257","133547375","chr2","200989549","200989667","19","67442292"
"chr6","133549983","133550281","chr4","135839345","135839642","18","2289362"
"chr6","133557614","133557921","chr7","150795674","150795979","57","17238060"
"chr6","133560987","133561113","chr4","135825266","135825392","11","2264279"
"chr6","133561553","133561842","chr4","135824560","135824846","27","2263007"
"chr6","133584351","133584648","chr1","17699229","17699528","57","115885122"
"chr6","133668014","133668092","chr4","135717792","135717870","9","2049778"
"chr6","133684498","133684782","chr4","135701215","135701496","30","2016717"
"chr6","133685278","133685573","chr4","135700445","135700730","34","2015167"
"chr6","133708307","133708404","chr4","135677228","135677333","11","1968921"
"chr6","133740712","133740961","chr4","135643996","135644247","14","1903284"
"chr6","133757024","133757326","chr4","135590484","135590767","42","1833460"
"chr6","133772920","133773226","chr4","135574268","135574573","12","1801348"
"chr6","133797283","133797505","chr4","135554493","135554716","18","1757210"
"chr6","133813096","133813397","chr4","135538944","135539229","63","1725848"
"chr6","133852386","133852670","chr4","135498990","135499279","30","1646604"
"chr6","133867442","133867739","chr4","135483670","135483969","20","1616228"
"chr6","133957286","133957406","chr4","135395828","135395946","8","1438542"
"chr6","133962896","133963183","chr8","26019040","26019330","65","107943856"
"chr6","133984342","133984666","chr4","135370586","135370909","34","1386244"
"chr6","134122062","134122302","chr4","135218889","135219158","49","1096827"
"chr6","134174648","134174932","chr1","200620309","200620594","59","66445661"
"chr6","134244675","134244923","chr4","135095796","135096047","15","851121"
"chr6","134310379","134310674","chr20","28618222","28618522","52","105692157"
"chr6","134333714","134333845","chr4","135012256","135012398","18","678542"
"chr6","134392962","134393224","chr4","134953184","134953447","15","560222"
"chr6","134459597","134459875","chr3","46725621","46725892","55","87733976"
"chr6","134463184","134463456","chr4","134897097","134897381","35","433913"
"chr6","134579112","134579396","chr4","134768633","134768934","36","189521"
"chr6","134616717","134617000","chr4","134730176","134730471","33","113459"
"chr6","134661330","134661462","chr4","134682569","134682698","10","21239"
"chr6","134665500","134665763","chr4","134678612","134678868","20","13112"
"chr6","134685635","134685818","chr1","100802125","100802315","40","33883510"
"chr6","134753647","134753956","chr4","134589565","134589872","32","164082"
"chr6","134755818","134755950","chr6","178107208","178107341","26","43351390"
"chr6","134756251","134756405","chr16","30767425","30767572","33","103988826"
"chr6","134771371","134771485","chr3","50347916","50348033","21","84423455"
"chr6","134798017","134798309","chr4","134538977","134539266","23","259040"
"chr6","134929937","134930055","chr4","134407453","134407571","11","522484"
"chr6","134970925","134971228","chr4","134357814","134358090","59","613111"
"chr6","135041702","135041979","chr4","134284660","134284948","31","757042"
"chr6","135049871","135050171","chr4","134276581","134276876","27","773290"
"chr6","135078116","135078391","chr4","134247614","134247888","27","830502"
"chr6","135097231","135097543","chr4","134228795","134229108","31","868436"
"chr6","135367559","135367817","chr4","133962301","133962598","56","1405258"
"chr6","135406791","135407085","chrX","16320386","16320684","65","119086405"
"chr6","135514588","135514825","chr19","37244182","37244407","49","98270406"
"chr6","135529354","135529643","chr9","17890586","17890873","45","117638768"
"chr6","135558856","135559132","chr4","133762262","133762538","10","1796594"
"chr6","135566023","135566347","chr4","133754499","133754821","39","1811524"
"chr6","135570422","135570554","chr3","13641352","13641484","23","121929070"
"chr6","135585954","135586243","chr4","133733158","133733444","25","1852796"
"chr6","135626557","135626677","chr4","133680273","133680393","8","1946284"
"chr6","135667694","135667957","chr7","92808424","92808694","58","42859270"
"chr6","135683188","135683317","chr4","133622417","133622546","7","2060771"
"chr6","135744913","135745172","chr4","133561579","133561836","27","2183334"
"chr6","135746999","135747269","chr4","133559464","133559729","17","2187535"
"chr6","135836030","135836251","chr4","133444600","133444804","31","2391430"
"chr6","135951980","135952204","chr14","6862253","6862481","45","129089727"
"chr6","135977560","135977850","chr4","133301802","133302110","31","2675758"
"chr6","135990865","135991142","chr16","26744282","26744558","63","109246583"
"chr6","135992384","135992530","chr4","133281644","133281787","22","2710740"
"chr6","136009974","136010253","chr1","24418526","24418808","53","111591448"
"chr6","136027816","136028114","chr4","133248136","133248417","32","2779680"
"chr6","136063370","136063437","chr4","133170908","133170975","2","2892462"
"chr6","136063483","136063658","chr1","221826290","221826463","36","85762807"
"chr6","136089387","136089609","chr4","133141067","133141291","16","2948320"
"chr6","136092815","136092926","chr19","4445240","4445349","22","131647575"
"chr6","136093315","136093340","chr15","16818410","16818432","5","119274905"
"chr6","136093630","136093809","chr11","51724204","51724379","46","84369426"
"chr6","136114410","136114704","chr4","133116740","133117034","17","2997670"
"chr6","136125879","136126152","chr4","133105311","133105596","30","3020568"
"chr6","136127291","136127572","chr17","24207380","24207657","54","111919911"
"chr6","136129872","136130159","chr4","133104496","133104808","51","3025376"
"chr6","136137544","136137664","chr4","133097025","133097145","6","3040519"
"chr6","136142239","136142547","chr4","133092179","133092495","23","3050060"
"chr6","136143841","136144131","chr4","133090571","133090877","41","3053270"
"chr6","136152071","136152170","chr4","133077764","133077863","7","3074307"
"chr6","136152465","136152639","chr4","133077261","133077436","17","3075204"
"chr6","136158556","136158900","chr4","133071007","133071342","32","3087549"
"chr6","136163720","136164002","chr4","133065924","133066243","53","3097796"
"chr6","136185069","136185334","chr10","75713258","75713517","56","60471811"
"chr6","136190365","136190665","chr4","133038262","133038562","36","3152103"
"chr6","136196193","136196478","chr4","133032184","133032469","12","3164009"
"chr6","136197037","136197197","chr4","133031466","133031626","19","3165571"
"chr6","136206178","136206454","chr4","133022058","133022342","24","3184120"
"chr6","136208198","136208503","chr4","133019996","133020284","49","3188202"
"chr6","136257179","136257289","chr4","132971185","132971299","15","3285994"
"chr6","136258822","136259127","chr4","132969161","132969462","24","3289661"
"chr6","136271355","136271509","chr15","100773356","100773508","29","35497999"
"chr6","136281274","136281566","chr4","132945349","132945661","44","3335925"
"chr6","136292434","136292744","chr4","132933939","132934244","30","3358495"
"chr6","136326669","136326952","chr4","132897011","132897287","18","3429658"
"chr6","136337249","136337556","chr4","132884404","132884707","24","3452845"
"chr6","136345720","136346013","chr4","132875826","132876143","38","3469894"
"chr6","136353655","136353955","chr2","71005973","71006275","67","65347682"
"chr6","136440135","136440426","chr4","132771747","132772039","38","3668388"
"chr6","136448241","136448468","chr4","132762797","132762981","54","3685444"
"chr6","136525453","136525575","chr3","10002180","10002302","18","126523273"
"chr6","136618234","136618543","chr4","132598951","132599255","16","4019283"
"chr6","136622323","136622615","chr4","132594539","132594818","33","4027784"
"chr6","136650891","136650983","chr4","45723814","45723906","18","90927077"
"chr6","136690678","136690995","chr4","132526245","132526557","20","4164433"
"chr6","136697305","136697584","chr4","132520077","132520356","15","4177228"
"chr6","136734034","136734356","chr4","132484254","132484572","41","4249780"
"chr6","136772823","136773107","chr4","132444718","132445016","42","4328105"
"chr6","136778822","136778951","chr4","132438020","132438149","13","4340802"
"chr6","136785482","136785761","chr4","132431307","132431585","19","4354175"
"chr6","136810100","136810392","chr5","8246617","8246904","46","128563483"
"chr6","136817767","136818018","chr4","132399933","132400179","14","4417834"
"chr6","136824666","136824950","chr4","132392979","132393253","34","4431687"
"chr6","136831696","136831980","chr4","132385715","132386015","35","4445981"
"chr6","136860017","136860302","chr4","132355932","132356218","18","4504085"
"chr6","136879507","136879794","chr4","132336659","132336955","29","4542848"
"chr6","136938199","136938520","chr4","36470308","36470624","63","100467891"
"chr6","136999079","136999243","chr12","88971756","88971915","38","48027323"
"chr6","137026235","137026397","chrX","19571236","19571401","40","117454999"
"chr6","137026424","137026544","chr3","57790746","57790867","21","79235678"
"chr6","137042963","137043083","chr4","132163470","132163586","13","4879493"
"chr6","137057968","137058281","chr4","132147987","132148293","27","4909981"
"chr6","137081037","137081310","chr4","132125066","132125365","46","4955971"
"chr6","137101902","137102070","chr5","151024724","151024886","29","13922822"
"chr6","137104001","137104299","chr4","132103483","132103784","19","5000518"
"chr6","137104893","137105019","chr4","132102762","132102888","6","5002131"
"chr6","137111632","137111927","chr4","132095204","132095497","11","5016428"
"chr6","137128257","137128532","chr20","2954133","2954415","63","134174124"
"chr6","137132395","137132688","chr4","132074336","132074591","52","5058059"
"chr6","137134601","137134904","chr4","132072104","132072406","17","5062497"
"chr6","137138494","137138725","chr4","132067662","132067892","29","5070832"
"chr6","137169998","137170298","chr11","113884993","113885276","73","23285005"
"chr6","137186390","137186516","chr4","132017866","132017991","9","5168524"
"chr6","137189951","137190260","chr13","71248269","71248571","55","65941682"
"chr6","137214988","137215206","chr5","78578822","78579040","47","58636166"
"chr6","137246702","137246977","chr4","131960963","131961237","15","5285739"
"chr6","137279104","137279414","chr4","131925985","131926269","41","5353119"
"chr6","137282059","137282316","chr4","131922783","131923037","19","5359276"
"chr6","137355788","137356072","chr4","131840757","131841039","23","5515031"
"chr6","137449661","137449998","chr4","131705709","131706040","55","5743952"
"chr6","137486223","137486343","chr4","131671697","131671818","9","5814526"
"chr6","137504769","137505046","chr4","131653411","131653680","25","5851358"
"chr6","137662855","137663172","chr2","55964466","55964774","69","81698389"
"chr6","137678713","137678992","chr4","131469269","131469547","21","6209444"
"chr6","137814673","137814918","chr4","131328312","131328558","17","6486361"
"chr6","137904438","137904739","chr4","131241903","131242191","30","6662535"
"chr6","137922160","137922447","chr6","168134055","168134341","61","30211895"
"chr6","137964317","137964564","chr4","131185973","131186220","20","6778344"
"chr6","137978314","137978542","chr4","131171989","131172219","19","6806325"
"chr6","137980551","137980849","chr4","131169696","131169986","31","6810855"
"chr6","137992411","137992606","chr6","31721331","31721519","56","106271080"
"chr6","138010533","138010809","chr4","131140625","131140889","28","6869908"
"chr6","138039841","138040124","chr4","131112594","131112886","32","6927247"
"chr6","138051737","138051980","chr3","126182679","126182909","69","11869058"
"chr6","138052815","138053064","chr3","127193893","127194128","72","10858922"
"chr6","138057520","138057828","chr4","131095798","131096109","28","6961722"
"chr6","138062517","138062791","chr4","131090835","131091109","17","6971682"
"chr6","138073861","138074154","chr4","131078940","131079243","31","6994921"
"chr6","138084397","138084595","chr8","88328733","88328939","50","49755664"
"chr6","138097860","138098164","chr4","131054191","131054502","34","7043669"
"chr6","138164813","138165121","chr4","130988184","130988492","20","7176629"
"chr6","138169861","138170162","chr10","78240928","78241225","63","59928933"
"chr6","138170528","138170795","chr4","130981793","130982082","35","7188735"
"chr6","138173710","138173819","chr2","169096495","169096603","18","30922785"
"chr6","138190469","138190770","chr4","130955399","130955697","24","7235070"
"chr6","138196630","138196928","chr4","130949252","130949555","20","7247378"
"chr6","138200949","138201268","chr4","130944887","130945249","61","7256062"
"chr6","138206579","138206876","chr4","130939022","130939318","16","7267557"
"chr6","138235182","138235475","chr4","130910766","130911060","23","7324416"
"chr6","138264451","138264575","chr12","104708552","104708676","18","33555899"
"chr6","138285715","138286010","chr4","130857794","130858089","22","7427921"
"chr6","138305703","138306012","chr4","130837463","130837768","29","7468240"
"chr6","138318627","138318934","chr4","130825356","130825641","55","7493271"
"chr6","138327559","138327690","chr4","130816205","130816334","14","7511354"
"chr6","138333525","138333810","chr4","130810032","130810319","23","7523493"
"chr6","138335955","138336247","chr4","130807576","130807889","39","7528379"
"chr6","138371933","138372250","chr4","130770925","130771232","28","7601008"
"chr6","138387669","138387925","chr13","68955414","68955661","61","69432255"
"chr6","138404169","138404461","chr2","84913076","84913368","54","53491093"
"chr6","138404992","138405274","chr4","130737122","130737405","15","7667870"
"chr6","138409312","138409445","chr2","89063256","89063397","29","49346056"
"chr6","138410287","138410559","chr4","130732028","130732339","55","7678259"
"chr6","138412263","138412580","chr4","130730074","130730372","36","7682189"
"chr6","138425798","138426090","chr4","130716747","130717039","18","7709051"
"chr6","138434567","138434855","chr4","130706583","130706879","28","7727984"
"chr6","138477494","138477783","chr4","130663934","130664231","26","7813560"
"chr6","138485074","138485361","chr6","15150337","15150615","71","123334737"
"chr6","138494342","138494603","chr14","48496157","48496415","49","89998185"
"chr6","138533423","138533692","chr4","130607896","130608164","18","7925527"
"chr6","138538491","138538775","chr4","130602785","130603090","48","7935706"
"chr6","138554820","138555116","chr4","130586086","130586383","17","7968734"
"chr6","138556378","138556678","chr4","130584519","130584825","31","7971859"
"chr6","138559307","138559461","chr4","130581688","130581842","11","7977619"
"chr6","138570291","138570586","chr4","130570853","130571147","18","7999438"
"chr6","138572161","138572478","chr4","130568640","130568960","23","8003521"
"chr6","138582488","138582778","chr4","130558638","130558919","36","8023850"
"chr6","138586181","138586460","chr4","130554935","130555214","16","8031246"
"chr6","138596380","138596639","chr4","130545014","130545298","48","8051366"
"chr6","138614763","138614901","chr4","130520885","130521029","13","8093878"
"chr6","138631176","138631535","chr4","130503610","130503987","55","8127566"
"chr6","138638575","138638895","chr4","130495924","130496247","25","8142651"
"chr6","138650487","138650777","chr4","130483570","130483867","28","8166917"
"chr6","138654467","138654733","chr15","17758827","17759093","67","120895640"
"chr6","138657879","138658078","chr4","130476165","130476366","15","8181714"
"chr6","138659066","138659179","chr4","130475189","130475297","13","8183877"
"chr6","138659677","138659975","chr19","30737326","30737611","60","107922351"
"chr6","138674975","138675094","chr16","46274531","46274645","26","92400444"
"chr6","138675390","138675554","chr4","130459705","130459888","27","8215685"
"chr6","138690775","138691084","chr4","130443779","130444084","26","8246996"
"chr6","138750242","138750550","chr14","29928047","29928354","73","108822195"
"chr6","138776925","138777221","chr4","130355168","130355464","15","8421757"
"chr6","138788045","138788355","chr4","130343463","130343767","23","8444582"
"chr6","138792657","138792962","chr4","130339162","130339477","33","8453495"
"chr6","138799063","138799356","chr4","130331780","130332075","23","8467283"
"chr6","138819567","138819715","chr1","38658193","38658337","33","100161374"
"chr6","138821975","138822264","chr4","130308175","130308467","22","8513800"
"chr6","138830364","138830654","chr4","130299922","130300212","20","8530442"
"chr6","138857091","138857383","chr4","130271883","130272170","16","8585208"
"chr6","138879080","138879388","chr4","130249806","130250108","22","8629274"
"chr6","138887220","138887486","chr4","130241709","130241991","36","8645511"
"chr6","138891912","138892213","chr4","130236805","130237079","45","8655107"
"chr6","138901057","138901364","chr4","130227758","130228039","54","8673299"
"chr6","138945983","138946269","chr7","51523943","51524235","54","87422040"
"chr6","138995425","138995706","chr14","115049792","115050083","49","23945633"
"chr6","138998224","138998302","chr4","130149327","130149402","10","8848897"
"chr6","139077193","139077463","chr19","2507487","2507757","49","136569706"
"chr6","139083312","139083362","chr2","1463539","1463599","18","137619773"
"chr6","139088911","139089269","chr3","143007352","143007697","96","3918441"
"chr6","139134964","139135259","chr4","130015320","130015616","15","9119644"
"chr6","139200493","139200781","chr4","129950223","129950521","33","9250270"
"chr6","139234135","139234459","chr4","129921523","129921844","19","9312612"
"chr6","139276866","139277053","chr8","64731321","64731495","42","74545545"
"chr6","139277082","139277145","chr19","2468455","2468506","16","136808627"
"chr6","139350085","139350364","chr4","129789343","129789637","37","9560742"
"chr6","139376879","139377158","chr4","129761558","129761856","43","9615321"
"chr6","139440811","139441110","chr4","129698926","129699222","35","9741885"
"chr6","139501145","139501358","chr4","129639833","129640052","19","9861312"
"chr6","139537610","139537731","chr2","165531071","165531193","11","25993461"
"chr6","139581031","139581146","chr11","119817658","119817774","17","19763373"
"chr6","139589613","139589707","chr2","184439175","184439260","27","44849562"
"chr6","139650464","139650703","chr4","129487811","129488025","35","10162653"
"chr6","139693371","139693665","chr4","129445977","129446275","19","10247394"
"chr6","139696863","139697138","chr4","129442498","129442783","27","10254365"
"chr6","139722553","139722619","chr4","129415630","129415694","8","10306923"
"chr6","139749124","139749419","chr4","129388657","129388952","28","10360467"
"chr6","139771992","139772112","chr4","129365277","129365401","12","10406715"
"chr6","139803785","139804073","chr4","129330949","129331236","15","10472836"
"chr6","139840557","139840822","chr7","61127662","61127921","78","78712895"
"chr6","139865705","139865883","chr4","129269386","129269558","20","10596319"
"chr6","139911735","139912049","chr4","129239772","129240071","33","10671963"
"chr6","140042019","140042131","chr4","129110631","129110743","4","10931388"
"chr6","140121336","140121637","chr4","129028201","129028502","20","11093135"
"chr6","140147933","140148244","chr4","129001844","129002156","23","11146089"
"chr6","140161599","140161883","chr4","128988585","128988866","26","11173014"
"chr6","140171321","140171613","chr4","128978715","128979003","36","11192606"
"chr6","140204971","140205273","chr4","128940682","128940984","29","11264289"
"chr6","140226502","140226803","chr4","128911599","128911898","23","11314903"
"chr6","140227046","140227314","chr4","128911077","128911348","24","11315969"
"chr6","140229467","140229606","chr4","128908763","128908883","26","11320704"
"chr6","140233584","140233849","chr4","128903519","128903790","30","11330065"
"chr6","140237732","140237998","chr4","128899381","128899647","11","11338351"
"chr6","140251357","140251647","chr4","128885587","128885875","20","11365770"
"chr6","140254000","140254292","chr4","128882192","128882493","29","11371808"
"chr6","140257108","140257397","chr4","128879077","128879376","31","11378031"
"chr6","140295666","140295975","chrX","47014801","47015112","54","93280865"
"chr6","140317549","140317861","chr4","128818652","128818961","31","11498897"
"chr6","140319644","140319926","chr10","15460316","15460612","56","124859328"
"chr6","140344457","140344575","chr4","128792907","128793026","6","11551550"
"chr6","140345910","140346218","chr4","128791269","128791570","33","11554641"
"chr6","140356563","140356870","chr4","128780605","128780920","32","11575958"
"chr6","140363150","140363410","chr16","61600043","61600308","63","78763107"
"chr6","140365225","140365535","chr16","57042495","57042800","60","83322730"
"chr6","140367169","140367454","chr4","128768461","128768750","31","11598708"
"chr6","140373404","140373708","chr20","6079220","6079525","69","134294184"
"chr6","140377180","140377464","chr1","78041007","78041283","58","62336173"
"chr6","140384628","140384937","chr4","128749777","128750088","21","11634851"
"chr6","140400735","140401042","chr4","128733529","128733843","27","11667206"
"chr6","140425799","140426080","chr4","128708872","128709190","53","11716927"
"chr6","140427745","140428042","chr10","12521353","12521656","63","127906392"
"chr6","140437267","140437551","chr4","128697303","128697587","14","11739964"
"chr6","140441576","140441835","chr4","128692972","128693210","40","11748604"
"chr6","140445160","140445288","chr4","43806316","43806440","30","96638844"
"chr6","140445583","140445751","chr16","51549230","51549400","36","88896353"
"chr6","140472722","140473000","chr4","128664341","128664619","19","11808381"
"chr6","140476714","140476926","chr6","38094316","38094524","46","102382398"
"chr6","140507836","140508174","chr4","128630218","128630537","51","11877618"
"chr6","140508276","140508560","chr4","128629822","128630113","27","11878454"
"chr6","140517121","140517420","chr4","128620102","128620403","17","11897019"
"chr6","140533390","140533650","chr4","128605132","128605400","34","11928258"
"chr6","140558914","140559037","chr6","17252977","17253107","29","123305937"
"chr6","140564019","140564283","chr7","139613893","139614162","58","950126"
"chr6","140567504","140567776","chr4","128570302","128570576","24","11997202"
"chr6","140574466","140574753","chr3","13514020","13514308","55","127060446"
"chr6","140602454","140602732","chr4","128534300","128534581","17","12068154"
"chr6","140605227","140605433","chr4","128530923","128531124","25","12074304"
"chr6","140633480","140633774","chr4","128501765","128502073","33","12131715"
"chr6","140636618","140636898","chr11","109186448","109186735","49","31450170"
"chr6","140637764","140638056","chr4","128497417","128497706","29","12140347"
"chr6","140640505","140640616","chr4","128494876","128494978","16","12145629"
"chr6","140653729","140653998","chr4","128482719","128482984","23","12171010"
"chr6","140694796","140695101","chr4","128441800","128442103","29","12252996"
"chr6","140718119","140718408","chr4","128415397","128415686","20","12302722"
"chr6","140793089","140793377","chr4","128331988","128332300","37","12461101"
"chr6","140798069","140798355","chr4","128326747","128327056","51","12471322"
"chr6","140820053","140820247","chr4","128303111","128303306","17","12516942"
"chr6","140863322","140863617","chr4","128258198","128258492","18","12605124"
"chr6","140883859","140884029","chr3","41137310","41137484","27","99746549"
"chr6","140889521","140889791","chr4","53508864","53509150","76","87380657"
"chr6","140900683","140900823","chr2","93533856","93533996","24","47366827"
"chr6","140901116","140901286","chr9","114805629","114805807","38","26095487"
"chr6","140907951","140908238","chr4","128214282","128214568","24","12693669"
"chr6","140915221","140915495","chr4","128207469","128207757","28","12707752"
"chr6","140949299","140949593","chr12","116843201","116843495","58","24106098"
"chr6","141003022","141003251","chr4","128115207","128115436","15","12887815"
"chr6","141014116","141014310","chr4","128104125","128104299","32","12909991"
"chr6","141014638","141014770","chr4","128103667","128103799","3","12910971"
"chr6","141096925","141097233","chr3","43652365","43652670","59","97444560"
"chr6","141148948","141149238","chr4","127967588","127967881","14","13181360"
"chr6","141220467","141220773","chr17","11251715","11252011","64","129968752"
"chr6","141223555","141223687","chr4","127888286","127888420","11","13335269"
"chr6","141223984","141224164","chr4","127887797","127887983","18","13336187"
"chr6","141230403","141230580","chr5","165325417","165325590","31","24095014"
"chr6","141230876","141231007","chr20","23238356","23238485","23","117992520"
"chr6","141258323","141258610","chr4","127843795","127844087","29","13414528"
"chr6","141260495","141260765","chr4","127841648","127841930","33","13418847"
"chr6","141307673","141307889","chr4","127794161","127794374","12","13513512"
"chr6","141308006","141308016","chr12","115209732","115209743","4","26098274"
"chr6","141308325","141308382","chr1","154900689","154900751","15","13592364"
"chr6","141330059","141330357","chr4","127770963","127771268","36","13559096"
"chr6","141380416","141380715","chr4","127726355","127726645","31","13654061"
"chr6","141481477","141481756","chr4","127622075","127622359","24","13859402"
"chr6","141647457","141647735","chr3","124286205","124286493","65","17361252"
"chr6","141812685","141812979","chr4","127274183","127274497","41","14538502"
"chr6","141915810","141916133","chr14","32156694","32157021","83","109759116"
"chr6","142016035","142016321","chr4","127065713","127065996","20","14950322"
"chr6","142080107","142080394","chr12","58307556","58307837","68","83772551"
"chr6","142152720","142152863","chr20","26377453","26377601","37","115775267"
"chr6","142320897","142321187","chr4","126741137","126741430","24","15579760"
"chr6","142522697","142522820","chr4","126535565","126535681","12","15987132"
"chr6","142558037","142558338","chr19","35633077","35633377","56","106924960"
"chr6","142559093","142559367","chr16","47333848","47334123","70","95225245"
"chr6","142618961","142619284","chr4","126398163","126398478","27","16220798"
"chr6","142698194","142698460","chr10","28106869","28107144","72","114591325"
"chr6","142764227","142764349","chr4","126246941","126247063","6","16517286"
"chr6","142776366","142776657","chr3","157775048","157775350","73","14998682"
"chr6","142891698","142891981","chr5","78689579","78689868","59","64202119"
"chr6","142936373","142936481","chr4","126067994","126068104","7","16868379"
"chr6","142937907","142938105","chr3","66577928","66578124","47","76359979"
"chr6","142949995","142950137","chr4","126055964","126056099","14","16894031"
"chr6","142957141","142957485","chr6","93662967","93663295","87","49294174"
"chr6","142966805","142967121","chr1","61578298","61578613","66","81388507"
"chr6","142970809","142970937","chr4","126033789","126033909","16","16937020"
"chr6","143071644","143071917","chr4","125944927","125945205","34","17126717"
"chr6","143293796","143294086","chr4","125687833","125688137","36","17605963"
"chr6","143379326","143379635","chr18","6336977","6337277","65","137042349"
"chr6","143393092","143393392","chr4","125598808","125599098","42","17794284"
"chr6","143546056","143546301","chr1","11848351","11848596","58","131697705"
"chr6","143554184","143554494","chr4","125430030","125430330","34","18124154"
"chr6","143580080","143580381","chr4","125396371","125396681","31","18183709"
"chr6","143945655","143945754","chr1","25307420","25307520","24","118638235"
"chr6","143953620","143953714","chr4","125045975","125046069","5","18907645"
"chr6","143984444","143984731","chr4","125018412","125018690","38","18966032"
"chr6","143986366","143986631","chr4","125008980","125009244","15","18977386"
"chr6","144095876","144095996","chr4","124891705","124891825","5","19204171"
"chr6","144096215","144096512","chr4","124891191","124891497","39","19205024"
"chr6","144162099","144162396","chr16","11545677","11545975","64","132616422"
"chr6","144234151","144234450","chr4","124756722","124757011","31","19477429"
"chr6","144271057","144271348","chr4","124719460","124719756","34","19551597"
"chr6","144309253","144309568","chr4","124673495","124673786","55","19635758"
"chr6","144436347","144436473","chr4","124549664","124549792","10","19886683"
"chr6","144436785","144436905","chr4","124549226","124549358","22","19887559"
"chr6","144470370","144470692","chr4","124516671","124516939","67","19953699"
"chr6","144498334","144498653","chr4","124488965","124489287","32","20009369"
"chr6","144553182","144553475","chr4","124426299","124426569","45","20126883"
"chr6","144571220","144571517","chr4","124407722","124408023","31","20163498"
"chr6","145278880","145279155","chr4","124346282","124346564","28","20932598"
"chr6","145305445","145305737","chr4","124319044","124319345","30","20986401"
"chr6","145310704","145310797","chr14","112775846","112775935","21","32534858"
"chr6","145350959","145351210","chr4","124271913","124272144","38","21079046"
"chr6","145373793","145374091","chr4","124248545","124248841","22","21125248"
"chr6","145412100","145412383","chr4","124210370","124210651","23","21201730"
"chr6","145449046","145449345","chr4","124173944","124174249","34","21275102"
"chr6","145564173","145564193","chr4","32737341","32737358","4","112826832"
"chr6","145564230","145564513","chr4","124043437","124043720","26","21520793"
"chr6","145585181","145585477","chr4","124026206","124026500","19","21558975"
"chr6","145596904","145597193","chr4","124014746","124015038","24","21582158"
"chr6","145639623","145639920","chr4","123973411","123973697","32","21666212"
"chr6","145646037","145646338","chr4","123967214","123967523","27","21678823"
"chr6","145651455","145651572","chr4","123962315","123962432","8","21689140"
"chr6","145686408","145686755","chr4","123926900","123927264","41","21759508"
"chr6","145752089","145752396","chr4","123861094","123861401","18","21890995"
"chr6","145764015","145764271","chr4","123849223","123849486","12","21914792"
"chr6","145795883","145796100","chr13","33341364","33341596","69","112454519"
"chr6","145811435","145811733","chr11","43308087","43308379","67","102503348"
"chr6","145866823","145867124","chr4","123750708","123751013","35","22116115"
"chr6","145868523","145868815","chr4","123749028","123749313","25","22119495"
"chr6","145872822","145873129","chr4","123744739","123745047","20","22128083"
"chr6","145891157","145891460","chr4","123727109","123727413","36","22164048"
"chr6","145970775","145971030","chr13","73237673","73237929","64","72733102"
"chr6","146002458","146002759","chr4","123613120","123613424","27","22389338"
"chr6","146043251","146043549","chr4","123572241","123572541","22","22471010"
"chr6","146062490","146062712","chr4","123552985","123553206","14","22509505"
"chr6","146062740","146063048","chr4","123552651","123552944","43","22510089"
"chr6","146067891","146068110","chr4","123547624","123547852","26","22520267"
"chr6","146127609","146127922","chr4","123488560","123488850","49","22639049"
"chr6","146134593","146134891","chr4","123481512","123481809","31","22653081"
"chr6","146150989","146151285","chr4","123465346","123465647","19","22685643"
"chr6","146168693","146168920","chr4","123447665","123447894","24","22721028"
"chr6","146216536","146216831","chr4","123399830","123400132","32","22816706"
"chr6","146228915","146229231","chr4","123387704","123388014","19","22841211"
"chr6","146290833","146291134","chr4","123317583","123317885","19","22973250"
"chr6","146298033","146298339","chr4","123310633","123310908","53","22987400"
"chr6","146302350","146302645","chr4","123306301","123306607","37","22996049"
"chr6","146306265","146306517","chr4","123302162","123302425","24","23004103"
"chr6","146317356","146317634","chrX","30235373","30235651","51","116081983"
"chr6","146329603","146329894","chr4","123278786","123279078","18","23050817"
"chr6","146330046","146330171","chr4","123278509","123278634","7","23051537"
"chr6","146341043","146341314","chr4","123265569","123265839","17","23075474"
"chr6","146355471","146355752","chr5","145452372","145452661","69","903099"
"chr6","146376900","146377210","chr4","123190380","123190681","35","23186520"
"chr6","146378671","146378951","chr16","40168086","40168364","41","106210585"
"chr6","146399922","146400135","chr4","123166450","123166650","23","23233472"
"chr6","146417221","146417526","chr4","123150253","123150565","23","23266968"
"chr6","146430771","146431062","chr20","26132723","26133020","61","120298048"
"chr6","146433941","146434205","chr4","123140360","123140630","18","23293581"
"chr6","146521849","146522136","chr4","123057379","123057669","44","23464470"
"chr6","146532132","146532459","chr4","123043910","123044197","65","23488222"
"chr6","146545456","146545756","chr4","123037306","123037611","25","23508150"
"chr6","146551483","146551757","chrX","103046997","103047266","66","43504486"
"chr6","146577530","146577644","chr3","133994127","133994239","25","12583403"
"chr6","146577981","146578089","chr3","34746780","34746891","38","111831201"
"chr6","146592535","146592797","chr4","122987941","122988192","25","23604594"
"chr6","146592860","146592996","chr20","17705521","17705654","22","128887339"
"chr6","146631226","146631511","chr11","78656030","78656306","64","67975196"
"chr6","146650802","146650918","chr20","20290877","20290993","22","126359925"
"chr6","146665363","146665525","chr2","57098559","57098711","40","89566804"
"chr6","146665851","146666011","chr11","56432796","56432956","30","90233055"
"chr6","146724694","146724991","chr4","122851316","122851603","35","23873378"
"chr6","146738623","146738911","chr4","122837807","122838102","24","23900816"
"chr6","146779492","146779795","chr4","122798296","122798603","23","23981196"
"chr6","146817389","146817519","chr4","122761438","122761568","6","24055951"
"chr6","146846922","146847204","chr4","122731274","122731559","26","24115648"
"chr6","146854473","146854660","chr6","114196334","114196520","39","32658139"
"chr6","146854954","146855090","chr17","54286798","54286936","42","92568156"
"chr6","146877500","146877687","chr4","122702408","122702593","14","24175092"
"chr6","146877984","146878109","chr4","122701983","122702109","14","24176001"
"chr6","146882044","146882326","chr4","122697761","122698045","27","24184283"
"chr6","146892561","146892853","chr4","122684168","122684470","26","24208393"
"chr6","146953559","146953860","chr2","134217641","134217927","65","12735918"
"chr6","146977116","146977295","chr4","122599845","122600023","16","24377271"
"chr6","146977592","146977753","chr4","122599361","122599535","23","24378231"
"chr6","147037177","147037463","chr4","122540012","122540298","13","24497165"
"chr6","147140130","147140400","chr4","122438120","122438385","18","24702010"
"chr6","147219034","147219313","chr4","122350197","122350458","48","24868837"
"chr6","147222063","147222345","chr4","122347180","122347451","31","24874883"
"chr6","147244803","147244978","chr4","58130431","58130605","41","89114372"
"chr6","147254398","147254611","chr8","17522046","17522259","41","129732352"
"chr6","147266151","147266438","chr4","122303200","122303479","28","24962951"
"chr6","147356688","147357000","chr4","122205968","122206266","26","25150720"
"chr6","147385796","147385911","chr7","84115292","84115405","14","63270504"
"chr6","147584363","147584675","chr4","121976084","121976368","46","25608279"
"chr6","147639542","147639631","chr4","121925972","121926062","3","25713570"
"chr6","147705188","147705481","chr4","121859072","121859378","36","25846116"
"chr6","147909034","147909334","chr4","121585866","121586168","51","26323168"
"chr6","148125915","148126207","chr4","121320669","121320962","24","26805246"
"chr6","148153571","148153847","chr4","121292630","121292896","30","26860941"
"chr6","148309369","148309655","chr4","120998622","120998904","23","27310747"
"chr6","148332854","148333126","chr4","120968600","120968872","18","27364254"
"chr6","148347230","148347466","chr4","120954003","120954236","21","27393227"
"chr6","148400479","148400773","chr4","120836728","120837042","40","27563751"
"chr6","148435751","148435883","chr4","120797172","120797304","6","27638579"
"chr6","148436175","148436380","chr2","46865647","46865847","53","101570528"
"chr6","148608781","148609051","chr4","120623431","120623697","21","27985350"
"chr6","148784682","148784970","chr4","120451060","120451328","35","28333622"
"chr6","148788499","148788793","chr4","120446876","120447166","28","28341623"
"chr6","148949647","148949790","chr8","64765062","64765204","30","84184585"
"chr6","149088527","149088649","chr3","157449830","157449952","16","8361303"
"chr6","149146917","149147203","chr16","1110560","1110825","92","148036357"
"chr6","149178211","149178514","chr4","119979214","119979523","28","29198997"
"chr6","149222811","149223096","chr4","119926440","119926718","20","29296371"
"chr6","149245902","149246205","chr4","119902318","119902617","23","29343584"
"chr6","149265049","149265331","chr4","119880882","119881165","23","29384167"
"chr6","149484319","149484513","chr11","121193796","121193985","43","28290523"
"chr6","149576508","149576623","chr4","119553076","119553191","6","30023432"
"chr6","149597103","149597372","chr4","119530784","119531057","25","30066319"
"chr6","149620303","149620601","chr4","119506804","119507123","52","30113499"
"chr6","149622764","149622892","chr4","119504244","119504372","12","30118520"
"chr6","149625877","149626179","chr1","92247752","92248049","70","57378125"
"chr6","149659704","149659943","chr4","119459995","119460235","20","30199709"
"chr6","149708119","149708373","chr4","119412826","119413080","32","30295293"
"chr6","149733546","149733840","chr1","10227902","10228202","62","139505644"
"chr6","149770436","149770698","chr8","92687825","92688073","70","57082611"
"chr6","149787931","149788247","chr4","119326478","119326782","31","30461453"
"chr6","149867449","149867728","chr4","119244418","119244699","23","30623031"
"chr6","149891128","149891395","chr4","119221088","119221365","29","30670040"
"chr6","149929351","149929641","chr4","119183375","119183657","23","30745976"
"chr6","150023070","150023340","chr4","119098911","119099178","25","30924159"
"chr6","150125956","150126257","chr4","118936376","118936630","61","31189580"
"chr6","150214990","150215241","chr4","118848076","118848327","17","31366914"
"chr6","150326446","150326739","chr4","118730390","118730708","53","31596056"
"chr6","150375155","150375454","chr4","118677952","118678254","36","31697203"
"chr6","150389896","150390172","chr4","118659570","118659844","26","31730326"
"chr6","150402953","150403057","chr8","96949211","96949317","19","53453742"
"chr6","150665588","150665874","chr4","118383604","118383891","25","32281984"
"chr6","150694621","150694825","chr4","118359312","118359510","22","32335309"
"chr6","150695966","150696256","chr4","118357855","118358124","29","32338111"
"chr6","150717376","150717595","chr4","118329155","118329396","36","32388221"
"chr6","150735605","150735927","chr11","113220012","113220319","61","37515593"
"chr6","150751620","150751934","chr4","118293717","118294028","31","32457903"
"chr6","150785044","150785351","chr4","118260219","118260519","23","32524825"
"chr6","150787732","150787990","chr4","118257518","118257785","35","32530214"
"chr6","150794131","150794404","chr4","118250977","118251251","18","32543154"
"chr6","150848938","150849109","chr1","53482939","53483101","50","97365999"
"chr6","150854091","150854326","chr4","118187514","118187750","13","32666577"
"chr6","150861467","150861752","chr8","129433118","129433406","62","21428349"
"chr6","150873350","150873658","chr4","118166941","118167251","26","32706409"
"chr6","150874183","150874488","chr4","118166352","118166658","20","32707831"
"chr6","150928406","150928527","chr4","118115477","118115604","11","32812929"
"chr6","150954492","150954798","chr4","118087991","118088282","40","32866501"
"chr6","150959942","150960057","chr4","118082506","118082622","11","32877436"
"chr6","150967117","150967416","chr4","118074790","118075081","53","32892327"
"chr6","150983675","150983975","chr4","118058033","118058317","36","32925642"
"chr6","150993770","150994056","chr4","118047405","118047688","20","32946365"
"chr6","151020804","151021086","chr4","118020120","118020418","28","33000684"
"chr6","151069574","151069709","chr4","67904560","67904698","28","83165014"
"chr6","151093822","151094136","chr4","117941317","117941629","28","33152505"
"chr6","151096344","151096639","chr4","117938806","117939110","30","33157538"
"chr6","151204855","151205141","chr19","14478439","14478737","66","136726416"
"chr6","151223456","151223744","chr4","117794111","117794365","51","33429345"
"chr6","151238709","151239003","chr6","161557509","161557798","55","10318800"
"chr6","151360979","151361111","chr4","117660981","117661113","10","33699998"
"chr6","151426856","151427135","chr3","123351694","123351976","53","28075162"
"chr6","151508516","151508782","chr9","119091441","119091708","59","32417075"
"chr6","151549411","151549549","chr9","98800048","98800179","30","52749363"
"chr6","151549857","151550029","chr3","35498090","35498256","38","116051767"
"chr6","151596826","151596947","chr4","117434369","117434495","11","34162457"
"chr6","151676005","151676127","chr4","117354935","117355057","7","34321070"
"chr6","151686284","151686576","chr4","117344445","117344744","27","34341839"
"chr6","151689702","151690012","chr4","117340889","117341191","26","34348813"
"chr6","151772783","151772938","chr4","128771732","128771886","33","23001051"
"chr6","151788684","151788992","chr4","117240610","117240919","22","34548074"
"chr6","151823302","151823604","chr4","117205087","117205383","25","34618215"
"chr6","151824128","151824393","chr4","117204296","117204571","35","34619832"
"chr6","151850668","151850838","chr4","117173791","117173961","12","34676877"
"chr6","151860214","151860493","chr4","117164073","117164348","24","34696141"
"chr6","151861179","151861470","chr4","117163133","117163425","18","34698046"
"chr6","151945790","151946095","chr4","117078946","117079255","28","34866844"
"chr6","151946613","151946907","chr4","117078132","117078428","22","34868481"
"chr6","151986228","151986441","chr19","39028175","39028394","44","112958053"
"chr6","151992586","151992886","chr4","117034406","117034705","22","34958180"
"chr6","152008983","152009197","chr4","117017092","117017306","20","34991891"
"chr6","152017994","152018109","chrX","40491044","40491160","18","111526950"
"chr6","152023904","152024205","chr4","117003468","117003773","26","35020436"
"chr6","152052913","152053200","chr4","116973099","116973387","21","35079814"
"chr6","152057561","152057760","chr4","116969762","116969966","23","35087799"
"chr6","152063318","152063386","chr4","116963835","116963903","5","35099483"
"chr6","152093195","152093326","chr3","89906417","89906550","33","62186778"
"chr6","152101127","152101257","chr4","116919065","116919189","10","35182062"
"chr6","152109500","152109619","chr4","116910706","116910822","10","35198794"
"chr6","152122770","152123076","chr4","116897145","116897457","21","35225625"
"chr6","152123187","152123483","chr4","116896746","116897048","24","35226441"
"chr6","152138345","152138598","chr4","116880539","116880793","14","35257806"
"chr6","152158272","152158363","chr4","116851986","116852077","1","35306286"
"chr6","152158998","152159191","chr1","7188271","7188471","43","144970727"
"chr6","152161909","152162203","chr4","116847501","116847783","24","35314408"
"chr6","152186914","152187220","chr4","116820436","116820741","15","35366478"
"chr6","152190417","152190535","chr13","39016257","39016370","18","113174160"
"chr6","152192387","152192683","chr4","116814423","116814734","36","35377964"
"chr6","152219128","152219422","chr4","116787193","116787507","38","35431935"
"chr6","152228504","152228587","chr2","148733834","148733921","17","3494670"
"chr6","152229019","152229108","chr2","184439175","184439260","17","32210156"
"chr6","152233688","152233814","chr1","37064408","37064534","12","115169280"
"chr6","152253790","152253911","chr2","203169966","203170091","26","50916176"
"chr6","152289794","152290086","chr4","116712615","116712904","35","35577179"
"chr6","152295318","152295602","chr4","116708297","116708586","13","35587021"
"chr6","152298963","152299266","chr4","116705170","116705473","24","35593793"
"chr6","152304884","152305176","chr19","29108741","29109042","63","123196143"
"chr6","152315823","152316073","chr4","116686844","116687098","17","35628979"
"chr6","152317459","152317754","chr4","116685099","116685407","30","35632360"
"chr6","152323840","152324119","chr4","116678883","116679165","15","35644957"
"chr6","152366760","152367014","chr15","47855867","47856141","61","104510893"
"chr6","152382109","152382279","chr4","116617393","116617563","11","35764716"
"chr6","152390815","152391047","chr4","116605946","116606180","15","35784869"
"chr6","152409161","152409289","chr1","18100775","18100899","17","134308386"
"chr6","152414596","152414898","chr4","116581473","116581773","25","35833123"
"chr6","152485008","152485305","chr4","116409465","116409756","28","36075543"
"chr6","152513132","152513431","chr4","116254977","116255270","30","36258155"
"chr6","152524297","152524464","chr2","133477430","133477594","37","19046867"
"chr6","152560113","152560413","chr4","116427961","116428265","36","36132152"
"chr6","152581945","152582130","chr14","63770924","63771111","46","88811021"
"chr6","152631676","152631794","chr6","126567985","126568100","21","26063691"
"chr6","152735774","152736077","chr4","116093676","116093982","40","36642098"
"chr6","152752194","152752498","chr4","116076188","116076492","14","36676006"
"chr6","152775228","152775537","chr10","81908379","81908683","65","70866849"
"chr6","152778584","152778851","chr2","84155954","84156223","58","68622630"
"chr6","152800292","152800431","chr4","116028436","116028558","21","36771856"
"chr6","152806743","152807041","chr20","28618222","28618522","53","124188521"
"chr6","152833393","152833644","chr4","115997451","115997702","15","36835942"
"chr6","152843832","152844137","chr4","115986611","115986937","38","36857221"
"chr6","152857888","152858162","chr4","115934378","115934657","25","36923510"
"chr6","152881422","152881692","chr4","115910457","115910731","21","36970965"
"chr6","152920478","152920622","chr4","115873249","115873394","9","37047229"
"chr6","153000693","153001014","chr4","115794678","115795000","20","37206015"
"chr6","153004491","153004775","chr4","115790895","115791170","30","37213596"
"chr6","153056278","153056599","chr4","115735778","115736092","32","37320500"
"chr6","153076931","153077232","chr4","115713694","115713981","47","37363237"
"chr6","153087079","153087377","chr4","115703097","115703395","19","37383982"
"chr6","153116986","153117271","chr4","115672746","115673024","31","37444240"
"chr6","153137431","153137711","chr4","115651356","115651659","46","37486075"
"chr6","153196383","153196644","chr4","115592347","115592608","40","37604036"
"chr6","153229689","153229887","chr3","116444016","116444218","39","36785673"
"chr6","153247802","153248075","chr4","115542033","115542317","25","37705769"
"chr6","153257289","153257581","chr4","115532718","115533016","23","37724571"
"chr6","153274183","153274477","chr4","115515284","115515579","32","37758899"
"chr6","153278923","153279215","chr4","115510563","115510861","22","37768360"
"chr6","153345091","153345368","chr6","31966657","31966939","55","121378434"
"chr6","153363599","153363710","chr4","115425227","115425342","9","37938372"
"chr6","153392517","153392814","chr4","115398832","115399143","31","37993685"
"chr6","153421238","153421562","chr4","115369822","115370146","21","38051416"
"chr6","153427134","153427376","chr4","115364036","115364278","14","38063098"
"chr6","153432139","153432374","chr4","115359598","115359845","24","38072541"
"chr6","153496747","153497045","chr4","115294167","115294465","17","38202580"
"chr6","153499450","153499741","chr7","107293204","107293509","65","46206246"
"chr6","153543874","153544149","chr4","115246235","115246516","30","38297639"
"chr6","153546240","153546349","chr4","115244208","115244316","9","38302032"
"chr6","153551462","153551576","chr4","115238857","115238972","9","38312605"
"chr6","153555740","153556041","chr4","115234354","115234655","29","38321386"
"chr6","153591249","153591535","chr4","115199550","115199831","36","38391699"
"chr6","153599597","153599714","chr11","113373159","113373274","19","40226438"
"chr6","153625388","153625699","chr4","115169933","115170214","50","38455455"
"chr6","153626021","153626200","chr11","96990866","96991043","33","56635155"
"chr6","153634991","153635143","chr3","47558463","47558615","29","106076528"
"chr6","153635549","153635830","chr4","115160114","115160395","18","38475435"
"chr6","153637351","153637561","chr18","33731593","33731805","43","119905758"
"chr6","153680891","153681101","chr4","115100062","115100283","23","38580829"
"chr6","153712734","153713047","chr4","115068561","115068866","52","38644173"
"chr6","153713700","153713823","chr4","115067752","115067885","21","38645948"
"chr6","153747838","153748104","chr5","169051411","169051678","52","15303573"
"chr6","153753784","153753981","chr3","124118064","124118255","40","29635720"
"chr6","153755718","153755952","chr4","115022191","115022418","26","38733527"
"chr6","153762760","153763093","chr5","109278642","109278949","79","44484118"
"chr6","153763123","153763434","chr4","115013701","115013999","46","38749422"
"chr6","153765967","153766190","chr3","130672627","130672844","43","23093340"
"chr6","153779205","153779492","chr4","114997067","114997344","31","38782138"
"chr6","153788357","153788664","chr4","114987541","114987845","33","38800816"
"chr6","153798014","153798311","chr4","114978197","114978510","38","38819817"
"chr6","153815918","153816050","chr4","114959575","114959707","14","38856343"
"chr6","153828289","153828590","chr4","114947432","114947733","18","38880857"
"chr6","153836212","153836344","chr4","114936919","114937049","10","38899293"
"chr6","153845932","153846176","chr4","114927447","114927691","21","38918485"
"chr6","153849878","153850003","chr4","114923254","114923379","3","38926624"
"chr6","153874424","153874642","chr4","114897135","114897379","39","38977289"
"chr6","153875959","153876237","chr4","114895167","114895443","22","38980792"
"chr6","153908902","153909175","chr4","114856114","114856392","29","39052788"
"chr6","153928912","153929139","chr4","114835936","114836160","14","39092976"
"chr6","153957094","153957387","chr15","91214036","91214335","32","62743058"
"chr6","153980240","153980369","chr4","114781605","114781729","11","39198635"
"chr6","153987663","153987943","chr8","19700895","19701185","66","134286768"
"chr6","153994476","153994662","chr4","114765762","114765952","6","39228714"
"chr6","153997286","153997473","chr4","114762993","114763175","21","39234293"
"chr6","154005570","154005719","chr2","49676318","49676467","48","104329252"
"chr6","154018192","154018508","chr4","114742517","114742838","16","39275675"
"chr6","154053605","154053905","chr4","114697709","114698012","21","39355896"
"chr6","154057006","154057317","chr4","114694254","114694534","55","39362752"
"chr6","154060992","154061118","chr4","114690448","114690572","10","39370544"
"chr6","154067345","154067473","chr4","114683811","114683938","20","39383534"
"chr6","154085328","154085586","chr4","114660558","114660817","20","39424770"
"chr6","154183925","154184181","chr4","114560085","114560373","48","39623840"
"chr6","154195930","154196152","chr4","114548077","114548294","27","39647853"
"chr6","154302141","154302431","chr4","114443862","114444152","16","39858279"
"chr6","154340845","154341125","chr4","114406455","114406749","30","39934390"
"chr6","154351431","154351699","chr4","114395962","114396232","21","39955469"
"chr6","154379438","154379741","chr4","6937789","6938091","56","147441649"
"chr6","154386266","154386577","chr4","114363404","114363731","29","40022862"
"chr6","154592021","154592168","chr18","70047695","70047842","19","84544326"
"chr6","154647889","154648184","chr4","114106895","114107191","24","40540994"
"chr6","154665662","154665834","chr13","50621044","50621216","37","104044618"
"chr6","154706438","154706724","chr4","114047507","114047801","23","40658931"
"chr6","154741261","154741550","chr4","114011051","114011340","35","40730210"
"chr6","154742823","154743122","chr4","114009175","114009479","23","40733648"
"chr6","154755471","154755750","chr4","113995715","113995999","16","40759756"
"chr6","154768532","154768834","chrX","52397156","52397456","64","102371376"
"chr6","154780002","154780317","chr4","113971038","113971332","37","40808964"
"chr6","154842800","154843069","chr4","113910877","113911166","41","40931923"
"chr6","154918066","154918362","chr4","113828685","113828987","31","41089381"
"chr6","154940843","154941120","chr4","113805803","113806105","42","41135040"
"chr6","154943492","154943620","chr10","8073153","8073283","20","146870339"
"chr6","154946751","154947045","chr4","113800049","113800345","43","41146702"
"chr6","154973054","154973343","chr4","113773886","113774172","61","41199168"
"chr6","155066746","155067009","chr4","113633248","113633537","39","41433498"
"chr6","155097491","155097784","chr4","113601269","113601560","57","41496222"
"chr6","155104847","155105116","chr4","113594766","113595036","9","41510081"
"chr6","155111784","155112083","chr15","12106034","12106332","53","143005750"
"chr6","155123328","155123636","chr4","113576255","113576543","48","41547073"
"chr6","155191610","155191895","chr4","113507335","113507620","27","41684275"
"chr6","155232647","155232945","chr4","113464705","113465004","12","41767942"
"chr6","155284356","155284655","chr4","113411721","113412016","27","41872635"
"chr6","155317602","155317858","chr4","113374742","113374999","27","41942860"
"chr6","155330339","155330373","chr4","113362604","113362638","1","41967735"
"chr6","155380436","155380733","chr4","113319476","113319775","17","42060960"
"chr6","155536125","155536415","chr4","113154079","113154370","34","42382046"
"chr6","155547163","155547453","chr4","113143132","113143422","11","42404031"
"chr6","155564612","155564890","chr4","113126014","113126316","41","42438598"
"chr6","155654529","155654700","chr4","113035543","113035716","14","42618986"
"chr6","155790719","155791008","chr4","112874726","112875014","18","42915993"
"chr6","155793100","155793248","chr4","112873046","112873194","11","42920054"
"chr6","155793496","155793612","chr4","112872685","112872805","12","42920811"
"chr6","156252840","156253121","chr1","22392281","22392567","73","133860559"
"chr6","156284634","156284926","chr4","112338697","112338989","39","43945937"
"chr6","156382303","156382586","chr4","112237034","112237327","35","44145269"
"chr6","156493710","156493989","chr4","112128656","112128965","44","44365054"
"chr6","156540377","156540661","chr4","112081789","112082071","15","44458588"
"chr6","156606301","156606418","chr4","112004780","112004902","14","44601521"
"chr6","156660853","156661178","chr4","111948392","111948733","46","44712461"
"chr6","156679117","156679291","chr4","111930571","111930727","27","44748546"
"chr6","157075422","157075702","chr4","111867053","111867345","28","45208369"
"chr6","157080208","157080342","chr4","111862406","111862542","9","45217802"
"chr6","157099100","157099436","chr4","111842362","111842672","49","45256738"
"chr6","157102496","157102758","chr4","111839029","111839293","23","45263467"
"chr6","157106725","157107012","chr4","111834541","111834829","36","45272184"
"chr6","157110194","157110311","chr4","111831204","111831319","9","45278990"
"chr6","157112378","157112671","chr4","111828857","111829151","21","45283521"
"chr6","157120973","157121094","chr10","78321569","78321689","19","78799404"
"chr6","157128807","157129087","chr4","111811746","111812023","23","45317061"
"chr6","157140335","157140636","chr4","111798447","111798748","23","45341888"
"chr6","157143948","157144224","chr4","111792809","111793074","39","45351139"
"chr6","157153717","157154027","chr4","111783145","111783457","34","45370572"
"chr6","157169118","157169234","chr4","111767301","111767418","10","45401817"
"chr6","157169301","157169604","chr4","111766951","111767231","42","45402350"
"chr6","157170293","157170566","chr4","111765792","111766094","47","45404501"
"chr6","157179494","157179807","chr4","111754994","111755296","29","45424500"
"chr6","157182375","157182672","chr2","28530034","28530323","85","128652341"
"chr6","157190641","157190936","chr4","111743919","111744217","25","45446722"
"chr6","157212004","157212276","chr4","111720080","111720340","31","45491924"
"chr6","157218987","157219277","chr4","111710890","111711183","13","45508097"
"chr6","157225284","157225568","chr4","111704028","111704304","46","45521256"
"chr6","157233108","157233401","chr4","111694893","111695185","22","45538215"
"chr6","157248860","157249161","chr4","111678347","111678652","37","45570513"
"chr6","157252302","157252614","chr4","111674358","111674652","40","45577944"
"chr6","157253900","157254153","chr3","166823723","166823967","56","9569823"
"chr6","157271463","157271761","chr4","108655506","108655810","43","48615957"
"chr6","157311808","157312118","chr4","108614464","108614769","25","48697344"
"chr6","157315326","157315582","chr4","44381259","44381521","54","112934067"
"chr6","157317277","157317570","chr4","108611843","108612130","22","48705434"
"chr6","157326817","157327065","chr4","108601962","108602206","18","48724855"
"chr6","157339540","157339672","chr17","8231938","8232067","14","149107602"
"chr6","157349792","157350075","chr9","58809616","58809897","51","98540176"
"chr6","157373761","157374070","chr4","108554960","108555261","29","48818801"
"chr6","157405561","157405870","chr4","108523738","108524025","45","48881823"
"chr6","157465744","157466045","chr4","108460521","108460823","27","49005223"
"chr6","157544812","157544945","chr9","126247796","126247930","25","31297016"
"chr6","157545266","157545441","chr2","75488309","75488482","37","82056957"
"chr6","157613958","157614257","chr7","50441996","50442297","51","107171962"
"chr6","157670942","157671277","chr4","108252533","108252868","34","49418409"
"chr6","157672728","157673019","chr7","152260696","152260990","65","5412032"
"chr6","157676561","157676639","chr4","108247077","108247154","3","49429484"
"chr6","157770752","157771038","chr4","108155566","108155868","38","49615186"
"chr6","157775187","157775483","chr4","108151100","108151407","34","49624087"
"chr6","157793300","157793581","chr18","47369138","47369415","64","110424162"
"chr6","157819319","157819521","chr4","108106212","108106400","29","49713107"
"chr6","157826047","157826356","chr4","108099263","108099582","29","49726784"
"chr6","157912154","157912463","chr4","108010569","108010877","18","49901585"
"chr6","157915277","157915587","chr4","108007529","108007840","22","49907748"
"chr6","157916694","157916999","chr14","19971480","19971782","61","137945214"
"chr6","157923182","157923456","chr4","108000144","108000414","21","49923038"
"chr6","157929139","157929434","chr4","107993484","107993786","26","49935655"
"chr6","157969174","157969425","chr13","70892536","70892787","48","87076638"
"chr6","158018276","158018575","chr4","107903541","107903838","21","50114735"
"chr6","158041304","158041637","chr4","107879258","107879571","48","50162046"
"chr6","158061510","158061810","chr4","107858428","107858733","23","50203082"
"chr6","158071462","158071762","chr4","107844450","107844750","17","50227012"
"chr6","158075794","158075873","chr4","107839714","107839795","7","50236080"
"chr6","158086054","158086327","chr4","107827922","107828218","45","50258132"
"chr6","158091452","158091741","chr10","33170384","33170684","58","124921068"
"chr6","158100576","158100893","chr4","107812763","107813088","37","50287813"
"chr6","158105539","158105748","chr4","107807940","107808151","22","50297599"
"chr6","158109635","158109808","chr20","14319087","14319252","45","143790548"
"chr6","158121746","158121964","chr4","107791348","107791564","7","50330398"
"chr6","158147230","158147521","chr18","11757610","11757901","60","146389620"
"chr6","158192304","158192458","chr1","222101503","222101639","44","63909199"
"chr6","158192508","158192699","chr4","107744126","107744323","21","50448382"
"chr6","158201503","158201809","chr4","111668285","111668585","32","46533218"
"chr6","158210682","158210967","chr4","111650886","111651171","14","46559796"
"chr6","158218335","158218617","chr4","111643380","111643650","31","46574955"
"chr6","158221765","158222060","chr4","111639946","111640242","33","46581819"
"chr6","158236586","158236714","chr13","56773122","56773245","22","101463464"
"chr6","158277366","158277682","chr4","111583383","111583701","35","46693983"
"chr6","158285333","158285645","chr4","111575394","111575685","53","46709939"
"chr6","158316318","158316614","chr3","37043386","37043678","55","121272932"
"chr6","158328865","158328992","chr1","188875189","188875313","18","30546324"
"chr6","158329641","158329931","chr4","158423696","158423977","64","94055"
"chr6","158330754","158330974","chr4","111533521","111533744","23","46797233"
"chr6","158348262","158348398","chr3","43002189","43002326","24","115346073"
"chr6","158376370","158376640","chr4","111486180","111486447","24","46890190"
"chr6","158382999","158383315","chr11","109624796","109625101","63","48758203"
"chr6","158419098","158419399","chr4","111444370","111444671","40","46974728"
"chr6","158434644","158434943","chr4","111429142","111429447","41","47005502"
"chr6","158445794","158446074","chr4","111416725","111417020","35","47029069"
"chr6","158448411","158448753","chr4","111414711","111415049","17","47033700"
"chr6","158466776","158467040","chr4","111395763","111396029","20","47071013"
"chr6","158467210","158467536","chr4","111395264","111395602","31","47071946"
"chr6","158474168","158474307","chr4","111388932","111389075","23","47085236"
"chr6","158476153","158476445","chr4","111386608","111386900","19","47089545"
"chr6","158478356","158478628","chr4","111385275","111385541","26","47093081"
"chr6","158484120","158484422","chr4","111379521","111379834","24","47104599"
"chr6","158486979","158487280","chr4","111376954","111377258","19","47110025"
"chr6","158526197","158526398","chr4","111343057","111343280","35","47183140"
"chr6","158526401","158526485","chr3","41672460","41672544","19","116853941"
"chr6","158541353","158541661","chr4","111327320","111327616","26","47214033"
"chr6","158574389","158574678","chr4","111297710","111297994","27","47276679"
"chr6","158579232","158579404","chr4","111293000","111293165","14","47286232"
"chr6","158579710","158579841","chr4","111292564","111292695","10","47287146"
"chr6","158593312","158593633","chr4","111276161","111276478","28","47317151"
"chr6","158593641","158593933","chr4","111275848","111276143","24","47317793"
"chr6","158599698","158599988","chr20","22445913","22446203","54","136153785"
"chr6","158628606","158628910","chr4","111241804","111242110","28","47386802"
"chr6","158654140","158654439","chr4","111215724","111216023","20","47438416"
"chr6","158658229","158658352","chr4","111211757","111211874","9","47446472"
"chr6","158683375","158683533","chr4","111186017","111186178","16","47497358"
"chr6","158685272","158685384","chr4","111184206","111184321","7","47501066"
"chr6","158706342","158706588","chr7","50245459","50245719","72","108460883"
"chr6","158734379","158734677","chr4","111135422","111135724","17","47598957"
"chr6","158734702","158734834","chr2","42645372","42645505","28","116089330"
"chr6","158750057","158750261","chr4","111119446","111119650","15","47630611"
"chr6","158750571","158750710","chr4","111118994","111119132","13","47631577"
"chr6","158756288","158756423","chr4","111113016","111113152","11","47643272"
"chr6","158760007","158760294","chr12","3426748","3427040","56","155333259"
"chr6","158780936","158781231","chr4","111089087","111089380","37","47691849"
"chr6","158820454","158820705","chr8","100010905","100011161","49","58809549"
"chr6","158830106","158830221","chr4","111036807","111036921","4","47793299"
"chr6","158837476","158837784","chr4","111029040","111029348","18","47808436"
"chr6","158878817","158879116","chr4","110987383","110987677","30","47891434"
"chr6","158886205","158886497","chr2","42186421","42186720","76","116699784"
"chr6","158927153","158927421","chr4","110936541","110936802","27","47990612"
"chr6","158974369","158974657","chr4","110888143","110888432","19","48086226"
"chr6","158983691","158983974","chr4","110879159","110879435","36","48104532"
"chr6","158991806","158992122","chr4","110871181","110871484","38","48120625"
"chr6","158997165","158997469","chr15","100706419","100706722","56","58290746"
"chr6","159014792","159015084","chr4","110846640","110846936","28","48168152"
"chr6","159027606","159027726","chr4","6988605","6988727","15","152039001"
"chr6","159067769","159067882","chr4","110795700","110795813","4","48272069"
"chr6","159073576","159073871","chr1","138872834","138873119","56","20200742"
"chr6","159219353","159219535","chr13","89864860","89865034","38","69354493"
"chr6","159275718","159275971","chr4","110530139","110530409","46","48745579"
"chr6","159285664","159285976","chr4","110520461","110520768","33","48765203"
"chr6","159325592","159325905","chr4","110480234","110480546","20","48845358"
"chr6","159385413","159385695","chr1","115569595","115569878","58","43815818"
"chr6","159559572","159559860","chr4","110252102","110252381","27","49307470"
"chr6","159706897","159707212","chr4","110106107","110106420","32","49600790"
"chr6","159781300","159781599","chr4","110032071","110032369","34","49749229"
"chr6","159901744","159902009","chr20","29357836","29358099","56","130543908"
"chr6","159962464","159962757","chr9","115146364","115146659","64","44816100"
"chr6","160042362","160042478","chr4","109772865","109772991","17","50269497"
"chr6","160062857","160063165","chr4","109751176","109751479","22","50311681"
"chr6","160210675","160210987","chr4","109595114","109595446","47","50615561"
"chr6","160238216","160238337","chr4","109565486","109565607","9","50672730"
"chr6","160238629","160238689","chr1","130130491","130130554","14","30108138"
"chr6","160245427","160245553","chr19","52862045","52862167","20","107383382"
"chr6","160245847","160245999","chr14","13445151","13445298","43","146800696"
"chr6","160270912","160271034","chr9","82847515","82847637","20","77423397"
"chr6","160329128","160329434","chr4","109470335","109470650","33","50858793"
"chr6","160343305","160343571","chr4","109454507","109454770","27","50888798"
"chr6","160463905","160464028","chr4","109338469","109338589","13","51125436"
"chr6","160464323","160464524","chr4","109337931","109338158","38","51126392"
"chr6","160470297","160470620","chr4","109332362","109332636","79","51137935"
"chr6","160488096","160488402","chr4","109315418","109315727","26","51172678"
"chr6","160492048","160492328","chr4","109311333","109311607","30","51180715"
"chr6","160511560","160511868","chr4","109290103","109290402","23","51221457"
"chr6","160516010","160516294","chr4","109285200","109285505","57","51230810"
"chr6","160517551","160517753","chr4","109283730","109283930","14","51233821"
"chr6","160518300","160518574","chr4","109282834","109283110","20","51235466"
"chr6","160528232","160528532","chr4","109272671","109272968","15","51255561"
"chr6","160554304","160554406","chr4","109246044","109246152","12","51308260"
"chr6","160555326","160555615","chr4","109244839","109245125","22","51310487"
"chr6","160556219","160556490","chr4","109244008","109244264","32","51312211"
"chr6","160567701","160567954","chr4","109230628","109230872","34","51337073"
"chr6","160590392","160590610","chr4","109207623","109207836","25","51382769"
"chr6","160614532","160614841","chr4","109182751","109183069","31","51431781"
"chr6","160616102","160616401","chr4","109181188","109181487","22","51434914"
"chr6","160671837","160671964","chr4","109079158","109079293","17","51592679"
"chr6","160683258","160683405","chr4","109067091","109067234","7","51616167"
"chr6","160695099","160695232","chr4","109055245","109055378","30","51639854"
"chr6","160695526","160695687","chr4","109054767","109054931","20","51640759"
"chr6","160698610","160698905","chr6","69305372","69305652","54","91393238"
"chr6","160711734","160712035","chr4","109038946","109039255","39","51672788"
"chr6","160750746","160751066","chr3","42830758","42831066","67","117919988"
"chr6","160754003","160754190","chr4","108996236","108996430","26","51757767"
"chr6","160754490","160754621","chr4","108995809","108995940","14","51758681"
"chr6","160767973","160768079","chr4","108981870","108981982","12","51786103"
"chr6","160825930","160826226","chr4","108923047","108923357","31","51902883"
"chr6","160917887","160918120","chr4","108823410","108823638","18","52094477"
"chr6","160921903","160922206","chr4","108819719","108820028","24","52102184"
"chr6","160946097","160946387","chr19","18576338","18576627","55","142369759"
"chr6","160975802","160976085","chr4","108766001","108766304","37","52209801"
"chr6","160979080","160979376","chr4","108762751","108763050","14","52216329"
"chr6","161029655","161029926","chr4","108732863","108733133","27","52296792"
"chr6","161030225","161030253","chr4","108732531","108732559","0","52297694"
"chr6","161031358","161031641","chr4","108731146","108731431","18","52300212"
"chr6","161060551","161060824","chr4","108677944","108678229","28","52382607"
"chr6","161075859","161076149","chr4","108658922","108659221","29","52416937"
"chr6","161167508","161167612","chr18","656455","656563","25","160511053"
"chr6","161167909","161168091","chr3","947742","947920","42","160220167"
"chr6","161168182","161168449","chr4","107727616","107727858","45","53440566"
"chr6","161190827","161191137","chr3","126975901","126976192","70","34214926"
"chr6","161195646","161195874","chr4","107634259","107634483","41","53561387"
"chr6","161221997","161222303","chr4","107656330","107656626","36","53565667"
"chr6","161222748","161223047","chr4","107657214","107657512","37","53565534"
"chr6","161234035","161234348","chr12","101551391","101551692","70","59682644"
"chr6","161257809","161258000","chr4","107695580","107695774","17","53562229"
"chr6","161266632","161266958","chr4","107621160","107621464","32","53645472"
"chr6","161273933","161274230","chr4","107613577","107613871","22","53660356"
"chr6","161280526","161280823","chr4","107606917","107607211","17","53673609"
"chr6","161297114","161297420","chr19","4904245","4904549","59","156392869"
"chr6","161302101","161302362","chrX","40207120","40207389","62","121094981"
"chr6","161329724","161329986","chr4","107546513","107546774","22","53783211"
"chr6","161340040","161340200","chr4","107534626","107534785","12","53805414"
"chr6","161340487","161340627","chr4","107534196","107534336","7","53806291"
"chr6","161348360","161348637","chr4","107525837","107526108","21","53822523"
"chr6","161356107","161356386","chr4","107510819","107511099","14","53845288"
"chr6","161406704","161406986","chr4","107458058","107458344","24","53948646"
"chr6","161439127","161439422","chr16","72745130","72745429","58","88693997"
"chr6","161440367","161440653","chr17","94709982","94710268","59","66730385"
"chr6","161493564","161493738","chr4","107371830","107371999","15","54121734"
"chr6","161510249","161510512","chr4","107354266","107354537","32","54155983"
"chr6","161514996","161515283","chr4","107348887","107349181","26","54166109"
"chr6","161537889","161538160","chr4","107327372","107327642","29","54210517"
"chr6","161540436","161540731","chr4","107324652","107324932","32","54215784"
"chr6","161546079","161546373","chr4","107318746","107319040","13","54227333"
"chr6","161580801","161581084","chr14","115049792","115050083","61","46531009"
"chr6","161607218","161607302","chr4","107258700","107258773","17","54348518"
"chr6","161614512","161614730","chr4","107251431","107251639","22","54363081"
"chr6","161625883","161626177","chr4","107240930","107241233","37","54384953"
"chr6","161644592","161644685","chr7","97206538","97206633","16","64438054"
"chr6","161655299","161655551","chr4","107207187","107207434","25","54448112"
"chr6","161694293","161694590","chr3","79875711","79876007","64","81818582"
"chr6","161713683","161713950","chr4","107145084","107145347","20","54568599"
"chr6","161716360","161716673","chr9","5383804","5384109","68","156332556"
"chr6","161720306","161720566","chr9","87135713","87135987","65","74584593"
"chr6","161731640","161731920","chr19","11240796","11241062","68","150490844"
"chr6","161735697","161735986","chr4","107124953","107125252","22","54610744"
"chr6","161752389","161752504","chr4","107106477","107106592","4","54645912"
"chr6","161762707","161762997","chr3","43421255","43421545","58","118341452"
"chr6","161765070","161765367","chr14","47806807","47807099","50","113958263"
"chr6","161831558","161831682","chr2","165531071","165531193","19","3699513"
"chr6","161834964","161835014","chr8","29453241","29453295","13","132381723"
"chr6","161835066","161835228","chr4","159948685","159948844","27","1886381"
"chr6","161866847","161867130","chr4","159990032","159990327","31","1876815"
"chr6","161870270","161870551","chr1","67226741","67227023","69","94643529"
"chr6","161920241","161920526","chr4","160045135","160045424","24","1875106"
"chr6","161930297","161930592","chr4","160053751","160054049","21","1876546"
"chr6","161932871","161932988","chr3","10367416","10367533","16","151565455"
"chr6","161973721","161974015","chr4","160099080","160099372","28","1874641"
"chr6","162000586","162000696","chr1","22035651","22035760","13","139964935"
"chr6","162003341","162003622","chr4","160131790","160132090","32","1871551"
"chr6","162048415","162048702","chr4","160177067","160177357","21","1871348"
"chr6","162306992","162307282","chr4","160436943","160437259","45","1870049"
"chr6","162425098","162425316","chr1","10837818","10838024","46","151587280"
"chr6","162425317","162425535","chr2","43858147","43858372","54","118567170"
"chr6","162429523","162429829","chr4","160554225","160554523","48","1875298"
"chr6","162447985","162448284","chr4","160574527","160574810","31","1873458"
"chr6","162454156","162454445","chr5","8246617","8246904","54","154207539"
"chr6","162462830","162463144","chr3","165574375","165574668","83","3111545"
"chr6","162464728","162465045","chr7","125199067","125199377","64","37265661"
"chr6","162493244","162493415","chr2","204656325","204656478","48","42163081"
"chr6","162521593","162521783","chr4","160702920","160703137","33","1818673"
"chr6","162539035","162539344","chr4","160716805","160717104","29","1822230"
"chr6","162546063","162546359","chr20","72530835","72531131","64","90015228"
"chr6","162566960","162567254","chr4","160800762","160801056","17","1766198"
"chr6","162593604","162593878","chr4","160820517","160820786","25","1773087"
"chr6","162598063","162598224","chr4","160825138","160825301","12","1772925"
"chr6","162598819","162598930","chr4","160828773","160828886","5","1770046"
"chr6","162613151","162613470","chr4","160836886","160837197","23","1776265"
"chr6","162634729","162634827","chr4","160859738","160859836","8","1774991"
"chr6","162647133","162647319","chr4","160872565","160872755","12","1774568"
"chr6","162650959","162651265","chr4","160877048","160877348","45","1773911"
"chr6","162657804","162658083","chr4","160883463","160883750","26","1774341"
"chr6","162658990","162659184","chr4","160884483","160884683","21","1774507"
"chr6","162670930","162671097","chr4","160893596","160893766","15","1777334"
"chr6","162672136","162672413","chr4","160894818","160895108","32","1777318"
"chr6","162681483","162681785","chr4","160904256","160904589","52","1777227"
"chr6","162682827","162683054","chr4","160905624","160905850","21","1777203"
"chr6","162691075","162691369","chr4","160911030","160911317","28","1780045"
"chr6","162696014","162696310","chr4","160916065","160916359","34","1779949"
"chr6","162715994","162716287","chr4","160936606","160936893","25","1779388"
"chr6","162727800","162728088","chr4","160952240","160952531","20","1775560"
"chr6","162729103","162729435","chr4","160953530","160953848","47","1775573"
"chr6","162732172","162732438","chr4","160956408","160956685","38","1775764"
"chr6","162757754","162758044","chr4","160992247","160992510","47","1765507"
"chr6","162775408","162775516","chr4","161009401","161009496","19","1766007"
"chr6","162775598","162775756","chr8","21621594","21621739","33","141154004"
"chr6","162795801","162796071","chr4","161029378","161029662","34","1766423"
"chr6","162796133","162796335","chr11","94143371","94143566","51","68652762"
"chr6","162834312","162834437","chr4","161074269","161074396","11","1760043"
"chr6","162844667","162844971","chr3","125514119","125514427","55","37330548"
"chr6","162848207","162848407","chr4","161089191","161089387","7","1759016"
"chr6","162865346","162865633","chr4","161106314","161106602","43","1759032"
"chr6","162883197","162883323","chr4","161123655","161123777","18","1759542"
"chr6","162945251","162945535","chr4","161185420","161185702","27","1759831"
"chr6","162945536","162945777","chr4","161185703","161185959","28","1759833"
"chr6","162947292","162947586","chr4","161186868","161187178","41","1760424"
"chr6","162967691","162967804","chr4","161209042","161209155","5","1758649"
"chr6","163019431","163019711","chr4","161262795","161263081","24","1756636"
"chr6","163031430","163031724","chr4","161275109","161275401","25","1756321"
"chr6","163055204","163055502","chr4","161293057","161293363","34","1762147"
"chr6","163067690","163067876","chr19","7887117","7887299","44","155180573"
"chr6","163067902","163068018","chr14","8294861","8294977","15","154773041"
"chr6","163204836","163204969","chr4","161430168","161430295","16","1774668"
"chr6","163205000","163205165","chr16","74126740","74126899","38","89078260"
"chr6","163210585","163210737","chr15","48288811","48288960","28","114921774"
"chr6","163210765","163210887","chr20","10579552","10579665","30","152631213"
"chr6","163332027","163332141","chr10","53981377","53981493","17","109350650"
"chr6","163332199","163332348","chr3","33993052","33993200","29","129339147"
"chr6","163370102","163370383","chr9","57720841","57721119","64","105649261"
"chr6","163549718","163550005","chr19","7651153","7651428","69","155898565"
"chr6","163709100","163709278","chr4","161828819","161828991","18","1880281"
"chr6","163905718","163906047","chr4","161964432","161964746","32","1941286"
"chr6","163906226","163906523","chr4","161964925","161965224","30","1941301"
"chr6","163925047","163925386","chr4","161984448","161984789","33","1940599"
"chr6","163980691","163980997","chr12","104707014","104707315","65","59273677"
"chr6","164099052","164099355","chr4","162205715","162206028","62","1893337"
"chr6","164117343","164117465","chr4","162224643","162224765","7","1892700"
"chr6","164240240","164240507","chr12","11489799","11490053","63","152750441"
"chr6","164326909","164327197","chr4","162431654","162431934","32","1895255"
"chr6","164442394","164442678","chr4","162546372","162546679","42","1896022"
"chr6","164511599","164511896","chr4","162617777","162618078","30","1893822"
"chr6","164539171","164539445","chr4","162643248","162643557","50","1895923"
"chr6","164589428","164589524","chr18","47768871","47768969","22","116820557"
"chr6","164671735","164671951","chr4","162785873","162786089","14","1885862"
"chr6","164773709","164774001","chr4","162905758","162906047","36","1867951"
"chr6","164802973","164803226","chr18","5300540","5300786","49","159502433"
"chr6","164827136","164827431","chr20","10719806","10720100","62","154107330"
"chr6","164856252","164856369","chr4","162980673","162980789","16","1875579"
"chr6","164989535","164989825","chr4","163120165","163120458","24","1869370"
"chr6","165086555","165086728","chr2","61281692","61281857","38","103804863"
"chr6","165130245","165130525","chr4","163255616","163255932","61","1874629"
"chr6","165164963","165165279","chr9","63389601","63389918","68","101775362"
"chr6","165302483","165302713","chr19","37244182","37244407","49","128058301"
"chr6","165360138","165360436","chr4","163487753","163488058","28","1872385"
"chr6","165396328","165396629","chr16","40756777","40757075","62","124639551"
"chr6","165438753","165438893","chr4","163566710","163566841","19","1872043"
"chr6","165451995","165452267","chr4","163581405","163581658","47","1870590"
"chr6","165469935","165470060","chr4","163595465","163595589","6","1874470"
"chr6","165530629","165530913","chr4","163654391","163654676","21","1876238"
"chr6","165573489","165573622","chr4","163698888","163699018","8","1874601"
"chr6","165589476","165589740","chr11","1767086","1767360","64","163822390"
"chr6","165598777","165599088","chr1","14475918","14476225","58","151122859"
"chr6","165676604","165676909","chr4","104021076","104021374","53","61655528"
"chr6","165695146","165695422","chr1","210829425","210829705","58","45134279"
"chr6","165806878","165807165","chr4","163930829","163931118","23","1876049"
"chr6","165909043","165909326","chr4","164035879","164036167","27","1873164"
"chr6","165988581","165988888","chr4","164118665","164118961","38","1869916"
"chr6","166001537","166001746","chr16","54638113","54638322","38","111363424"
"chr6","166018948","166019105","chr4","164148965","164149122","13","1869983"
"chr6","166025561","166025847","chr11","122982514","122982798","56","43043047"
"chr6","166206442","166206731","chr3","123351694","123351976","53","42854748"
"chr6","166213858","166214155","chr4","164344586","164344884","16","1869272"
"chr6","166255785","166256094","chr4","164385843","164386145","29","1869942"
"chr6","166304110","166304410","chr4","164442272","164442569","27","1861838"
"chr6","166308148","166308445","chr4","164446542","164446860","42","1861606"
"chr6","166354746","166355027","chr6","171314470","171314758","63","4959724"
"chr6","166376096","166376344","chr9","88137275","88137525","64","78238821"
"chr6","166418253","166418515","chr4","164575632","164575889","23","1842621"
"chr6","166425505","166425805","chr4","164582882","164583179","22","1842623"
"chr6","166480530","166480800","chr4","164642197","164642466","21","1838333"
"chr6","166504869","166505165","chr4","164666844","164667138","30","1838025"
"chr6","166689695","166690007","chr4","164847269","164847596","35","1842426"
"chr6","166713632","166713929","chr19","23790078","23790382","64","142923554"
"chr6","166776613","166776921","chr4","164976766","164977066","46","1799847"
"chr6","166794138","166794432","chr4","164993985","164994285","51","1800153"
"chr6","166807859","166808167","chr4","165008148","165008427","47","1799711"
"chr6","166814064","166814368","chr4","165015064","165015345","57","1799000"
"chr6","166854124","166854390","chr4","165055639","165055906","19","1798485"
"chr6","166924138","166924433","chr10","80126474","80126771","67","86797664"
"chr6","166978714","166979019","chr4","165175720","165176031","42","1802994"
"chr6","166989390","166989682","chrX","146034557","146034846","59","20954833"
"chr6","167068333","167068530","chr4","165265118","165265307","18","1803215"
"chr6","167141190","167141481","chr4","165337200","165337510","35","1803990"
"chr6","167174171","167174458","chr4","165371993","165372280","37","1802178"
"chr6","167229617","167229929","chr4","165433447","165433759","14","1796170"
"chr6","167264230","167264516","chr4","165467594","165467879","16","1796636"
"chr6","167266729","167267010","chr17","76529417","76529697","53","90737312"
"chr6","167415140","167415424","chr2","108134181","108134458","73","59280959"
"chr6","167545502","167545797","chr4","165763145","165763440","35","1782357"
"chr6","167592670","167592961","chr4","165808611","165808851","61","1784059"
"chr6","167711357","167711651","chr4","165964437","165964736","31","1746920"
"chr6","168113476","168113780","chr13","71248269","71248571","56","96865207"
"chr6","168308352","168308657","chr4","166558180","166558475","29","1750172"
"chr6","168369223","168369515","chr4","166618815","166619124","36","1750408"
"chr6","168428610","168428919","chr4","166673783","166674096","31","1754827"
"chr6","168530864","168531158","chr4","166790549","166790834","31","1740315"
"chr6","168552424","168552514","chr4","166810249","166810349","14","1742175"
"chr6","168562904","168563203","chr4","166826769","166827064","30","1736135"
"chr6","168695440","168695739","chr4","166966054","166966357","31","1729386"
"chr6","168727082","168727269","chr4","166998298","166998484","20","1728784"
"chr6","168789630","168789752","chr4","167227092","167227214","7","1562538"
"chr6","168895070","168895369","chr4","167331101","167331403","22","1563969"
"chr6","168950482","168950779","chr3","124003157","124003450","55","44947325"
"chr6","168974091","168974399","chr4","167412061","167412335","48","1562030"
"chr6","168990154","168990397","chr4","167429138","167429383","23","1561016"
"chr6","169089345","169089465","chr5","112526981","112527104","17","56562364"
"chr6","169091488","169091772","chr4","167531791","167532054","35","1559697"
"chr6","169092975","169093275","chr4","167533354","167533666","56","1559621"
"chr6","169142113","169142386","chr4","167574946","167575219","23","1567167"
"chr6","169145862","169145975","chr4","167583762","167583875","7","1562100"
"chr6","169152523","169152667","chr4","157639029","157639171","29","11513494"
"chr6","169152976","169153127","chr19","10137363","10137516","40","159015613"
"chr6","169194820","169194966","chr12","56734952","56735077","43","112459868"
"chr6","169243253","169243532","chr4","167674494","167674773","17","1568759"
"chr6","169268922","169269186","chr4","167700719","167700970","34","1568203"
"chr6","169284897","169285114","chr4","167717038","167717256","9","1567859"
"chr6","169304880","169305183","chr4","167741687","167742003","28","1563193"
"chr6","169318935","169319214","chr4","167755361","167755644","12","1563574"
"chr6","169424240","169424527","chr2","160551205","160551504","59","8873035"
"chr6","169473040","169473349","chr4","36470308","36470624","58","133002732"
"chr6","169480511","169480650","chr2","49103685","49103821","28","120376826"
"chr6","169480963","169481048","chr10","60641694","60641772","20","108839269"
"chr6","169499785","169500000","chr12","110265560","110265769","49","59234225"
"chr6","169745399","169745678","chr4","168223778","168224067","34","1521621"
"chr6","169755509","169755726","chr4","168238344","168238562","19","1517165"
"chr6","169785262","169785531","chr4","168268417","168268696","30","1516845"
"chr6","169810454","169810744","chr4","168293902","168294195","25","1516552"
"chr6","169876258","169876549","chr4","168363440","168363703","45","1512818"
"chr6","169954769","169954981","chr4","168452278","168452499","26","1502491"
"chr6","169961997","169962290","chr4","168459561","168459858","23","1502436"
"chr6","170135967","170136247","chr4","168892724","168893007","22","1243243"
"chr6","170211608","170211871","chr4","168774162","168774427","17","1437446"
"chr6","170438865","170439190","chr4","168993761","168994090","36","1445104"
"chr6","170508663","170508829","chr4","169070848","169071014","10","1437815"
"chr6","170593769","170594060","chr2","109967146","109967434","61","60626623"
"chr6","170610081","170610364","chr4","169140203","169140476","29","1469878"
"chr6","170696207","170696479","chr4","169230061","169230328","31","1466146"
"chr6","170697794","170697901","chr9","29260197","29260303","19","141437597"
"chr6","170851576","170851693","chr4","169383506","169383623","8","1468070"
"chr6","170972237","170972535","chr2","72923747","72924047","50","98048490"
"chr6","171003574","171003862","chr4","169522910","169523194","21","1480664"
"chr6","171304839","171305127","chr4","169843485","169843781","40","1461354"
"chr6","171430948","171431272","chr4","169972465","169972788","23","1458483"
"chr6","171446597","171446878","chr4","169987819","169988100","23","1458778"
"chr6","171688220","171688507","chr4","170229258","170229543","25","1458962"
"chr6","171779622","171779917","chr4","170314912","170315196","37","1464710"
"chr6","171815763","171816067","chr4","170354150","170354469","37","1461613"
"chr6","172114244","172114542","chr2","69090007","69090310","67","103024237"
"chr6","172151305","172151427","chr4","171202515","171202637","6","948790"
"chr6","172198750","172198863","chr3","66577054","66577169","17","105621696"
"chr6","172198903","172199058","chr11","65665465","65665619","36","106533438"
"chr6","172327728","172327997","chr4","171420378","171420648","26","907350"
"chr6","172419433","172419712","chr4","171505670","171505956","18","913763"
"chr6","172465444","172465735","chr4","171551681","171551972","19","913763"
"chr6","172482885","172483194","chr19","18064212","18064515","69","154418673"
"chr6","172488025","172488345","chr4","171578098","171578407","34","909927"
"chr6","172828846","172829149","chr4","171720641","171720956","37","1108205"
"chr6","172872196","172872490","chr10","86087988","86088272","57","86784208"
"chr6","172874356","172874677","chr19","4771576","4771890","66","168102780"
"chr6","172974683","172974999","chr4","171869739","171870046","49","1104944"
"chr6","173194540","173194835","chr4","172564470","172564763","19","630070"
"chr6","173216290","173216567","chr4","172541156","172541434","20","675134"
"chr6","173350302","173350478","chr4","172401020","172401196","31","949282"
"chr6","173350796","173350939","chr4","172400559","172400703","17","950237"
"chr6","173377344","173377554","chr4","172374277","172374488","23","1003067"
"chr6","173380919","173381045","chr1","53826402","53826528","23","119554517"
"chr6","173513002","173513310","chr4","172258034","172258318","44","1254968"
"chr6","173557476","173557783","chr4","172216516","172216825","38","1340960"
"chr6","173581091","173581406","chr4","172191291","172191588","43","1389800"
"chr6","173598978","173599101","chr14","88735495","88735619","15","84863483"
"chr6","173613551","173613862","chr4","130271883","130272170","73","43341668"
"chr6","173635343","173635619","chr11","109722153","109722423","67","63913190"
"chr6","173761829","173762164","chr4","172026540","172026884","32","1735289"
"chr6","173798003","173798129","chr4","171982724","171982850","8","1815279"
"chr6","173806120","173806349","chr4","171974229","171974460","17","1831891"
"chr6","173811651","173811964","chr4","171967884","171968208","38","1843767"
"chr7","106954720","106954995","chr3","127008132","127008407","12","20053412"
"chr7","64749516","64749636","chr3","50181331","50181451","6","14568185"
"chr7","73924371","73924670","chr3","49383196","49383497","23","24541175"
"chr7","106037071","106037368","chr3","126032353","126032641","19","19995282"
"chr7","121896796","121897091","chr3","142873207","142873502","10","20976411"
"chr7","159645577","159645879","chr3","182688512","182688809","27","23042935"
"chr7","534542","534800","chr20","41475754","41476026","63","40941212"
"chr7","551733","551963","chr5","17114382","17114612","68","16562649"
"chr7","567493","567795","chrX","52397156","52397456","66","51829663"
"chr7","587409","587588","chr3","34071086","34071264","20","33483677"
"chr7","620143","620338","chr3","34108070","34108266","44","33487927"
"chr7","645752","646015","chr3","34137707","34137974","23","33491955"
"chr7","687353","687638","chr3","34185358","34185679","63","33498005"
"chr7","711024","711270","chr3","34212247","34212482","26","33501223"
"chr7","729683","729967","chr3","34229990","34230277","34","33500307"
"chr7","734379","734508","chr1","117811669","117811797","21","117077290"
"chr7","749308","749605","chr1","77944739","77945036","66","77195431"
"chr7","763810","764063","chr15","7539679","7539930","69","6775869"
"chr7","765041","765082","chr2","61642245","61642286","4","60877204"
"chr7","765126","765284","chr3","3851851","3852006","31","3086725"
"chr7","784001","784202","chr3","34295041","34295253","42","33511040"
"chr7","797394","797524","chr3","34308489","34308621","21","33511095"
"chr7","813269","813583","chr3","34327832","34328124","59","33514563"
"chr7","838581","838887","chr17","80429135","80429431","57","79590554"
"chr7","877094","877368","chr3","34379426","34379699","23","33502332"
"chr7","877591","877885","chr3","34379921","34380215","21","33502330"
"chr7","884012","884239","chr3","34386312","34386520","53","33502300"
"chr7","909507","909629","chr3","34414634","34414764","17","33505127"
"chr7","919749","920054","chr3","34425169","34425470","33","33505420"
"chr7","931489","931788","chr3","34437120","34437437","46","33505631"
"chr7","953239","953376","chr16","51275581","51275717","20","50322342"
"chr7","953377","953685","chr19","41238990","41239301","64","40285613"
"chr7","953686","953830","chrX","8417026","8417160","27","7463340"
"chr7","955128","955424","chr2","84913076","84913368","60","83957948"
"chr7","972770","973051","chr19","14819395","14819673","54","13846625"
"chr7","981862","982162","chr16","61602799","61603100","57","60620937"
"chr7","998291","998607","chr3","34549328","34549653","29","33551037"
"chr7","1001262","1001415","chr3","34552412","34552568","19","33551150"
"chr7","1001695","1001829","chr3","34552871","34553001","14","33551176"
"chr7","1005628","1005921","chr3","34556922","34557216","36","33551294"
"chr7","1017349","1017566","chr3","34570770","34570986","19","33553421"
"chr7","1021597","1021892","chr3","34575254","34575551","51","33553657"
"chr7","1029119","1029415","chr3","34581678","34581960","44","33552559"
"chr7","1041151","1041280","chr3","34596240","34596370","10","33555089"
"chr7","1041578","1041756","chr3","34596673","34596860","34","33555095"
"chr7","1079586","1079846","chr3","34632443","34632707","21","33552857"
"chr7","1086800","1087086","chr3","34640371","34640657","25","33553571"
"chr7","1088652","1088750","chr3","127004252","127004345","25","125915600"
"chr7","1123687","1123927","chr4","157703994","157704246","63","156580307"
"chr7","1127893","1127959","chr3","34678345","34678414","10","33550452"
"chr7","1157883","1158159","chr1","11251860","11252129","59","10093977"
"chr7","1177149","1177313","chr4","161962632","161962792","38","160785483"
"chr7","1186864","1186916","chr2","79990292","79990345","13","78803428"
"chr7","1199456","1199754","chr4","37761866","37762179","68","36562410"
"chr7","1284345","1284631","chr3","34833211","34833489","32","33548866"
"chr7","1290219","1290500","chr8","19223807","19224090","68","17933588"
"chr7","1299508","1299788","chr3","34849612","34849896","21","33550104"
"chr7","1322197","1322399","chr14","12138606","12138816","42","10816409"
"chr7","1330572","1330855","chr3","34883886","34884192","45","33553314"
"chr7","1340407","1340579","chr3","34894497","34894670","16","33554090"
"chr7","1341144","1341277","chr3","34895291","34895432","13","33554147"
"chr7","1352046","1352359","chr15","14616084","14616383","57","13264038"
"chr7","1398905","1399206","chr3","34947722","34948019","37","33548817"
"chr7","1407688","1408003","chr14","113670800","113671110","53","112263112"
"chr7","1419549","1419857","chr3","34970188","34970496","21","33550639"
"chr7","1483217","1483509","chr14","66461558","66461851","51","64978341"
"chr7","1498034","1498305","chr3","35043387","35043656","25","33545353"
"chr7","1499471","1499782","chr3","35044818","35045121","40","33545347"
"chr7","1500827","1500959","chr3","35046151","35046286","15","33545324"
"chr7","1508170","1508396","chr19","9098047","9098273","52","7589877"
"chr7","1509302","1509604","chr3","35052808","35053125","56","33543506"
"chr7","1512336","1512645","chrX","52832984","52833284","56","51320648"
"chr7","1512880","1513177","chr9","34672770","34673067","55","33159890"
"chr7","1536320","1536459","chr20","20567588","20567725","30","19031268"
"chr7","1552469","1552649","chrX","113691058","113691233","31","112138589"
"chr7","1552906","1552949","chr3","35095582","35095627","5","33542676"
"chr7","1553771","1554073","chr8","43045522","43045819","58","41491751"
"chr7","1555917","1556232","chr3","35099408","35099713","31","33543491"
"chr7","1567272","1567551","chr1","129543506","129543782","48","127976234"
"chr7","1571358","1571504","chr2","91910810","91910949","36","90339452"
"chr7","1629925","1630097","chr3","35172684","35172821","60","33542759"
"chr7","1630374","1630576","chr3","35173112","35173314","20","33542738"
"chr7","1657014","1657306","chr3","35198955","35199258","29","33541941"
"chr7","1672952","1673238","chr6","17609699","17609979","58","15936747"
"chr7","1682772","1683056","chr3","35227319","35227610","29","33544547"
"chr7","1683406","1683530","chr9","97270771","97270897","19","95587365"
"chr7","1705516","1705818","chr3","35250372","35250670","19","33544856"
"chr7","1718128","1718263","chr1","38658644","38658775","22","36940516"
"chr7","1718547","1718723","chr7","159041780","159041958","33","157323233"
"chr7","1719571","1719882","chr3","35264768","35265069","47","33545197"
"chr7","1731939","1732199","chr9","92155023","92155295","57","90423084"
"chr7","1742757","1742869","chr3","35288048","35288159","6","33545291"
"chr7","1744108","1744427","chr3","35290627","35290946","27","33546519"
"chr7","1749239","1749541","chr2","72592847","72593136","57","70843608"
"chr7","1757991","1758272","chrX","147476237","147476516","50","145718246"
"chr7","1759069","1759273","chr3","35304629","35304855","40","33545560"
"chr7","1766519","1766813","chr1","94918790","94919093","61","93152271"
"chr7","1774284","1774484","chr18","12824115","12824290","55","11049831"
"chr7","1775515","1775808","chr3","35321024","35321327","38","33545509"
"chr7","1794676","1794959","chr3","35342054","35342344","44","33547378"
"chr7","1798310","1798600","chr5","51322379","51322663","51","49524069"
"chr7","1823896","1824056","chr3","35373153","35373311","11","33549257"
"chr7","1824373","1824540","chr3","35373623","35373790","11","33549250"
"chr7","1830826","1831108","chr3","35380320","35380602","18","33549494"
"chr7","1853344","1853633","chr5","40417115","40417405","66","38563771"
"chr7","1872209","1872331","chr3","35423101","35423222","13","33550892"
"chr7","1884808","1884970","chr20","2838255","2838418","44","953447"
"chr7","1885269","1885408","chr1","128086244","128086378","26","126200975"
"chr7","1886711","1886887","chr3","35440483","35440667","25","33553772"
"chr7","1887179","1887313","chr8","45501471","45501602","26","43614292"
"chr7","1892296","1892553","chr3","35446532","35446789","22","33554236"
"chr7","1893248","1893544","chr3","35447169","35447469","35","33553921"
"chr7","1901659","1901965","chr8","11929335","11929648","77","10027676"
"chr7","1920708","1920807","chr3","35481328","35481429","11","33560620"
"chr7","1934825","1934973","chr6","38010664","38010811","26","36075839"
"chr7","1935287","1935450","chr3","35498568","35498726","20","33563281"
"chr7","1935825","1936120","chr2","160551205","160551504","64","158615380"
"chr7","1943191","1943499","chr3","35508280","35508588","22","33565089"
"chr7","1948906","1949171","chr3","35520466","35520732","23","33571560"
"chr7","1961949","1962247","chr20","22132698","22132991","61","20170749"
"chr7","1975136","1975422","chr3","35547600","35547903","47","33572464"
"chr7","1978396","1978561","chr20","42549364","42549524","32","40570968"
"chr7","1989480","1989792","chr3","35560272","35560581","37","33570792"
"chr7","1993260","1993517","chr20","58196063","58196320","57","56202803"
"chr7","2009928","2010226","chr3","35585944","35586252","39","33576016"
"chr7","2028037","2028331","chr3","35606272","35606574","33","33578235"
"chr7","2033557","2033775","chr3","35612491","35612715","26","33578934"
"chr7","2053977","2054251","chr3","35633655","35633939","46","33579678"
"chr7","2055414","2055706","chr14","66461558","66461851","51","64406144"
"chr7","2059446","2059732","chr10","26732652","26732933","59","24673206"
"chr7","2068036","2068354","chr3","35647793","35648114","25","33579757"
"chr7","2071011","2071293","chr3","35650760","35651064","40","33579749"
"chr7","2072935","2073140","chr3","35653114","35653319","12","33580179"
"chr7","2073264","2073541","chr3","35653443","35653729","29","33580179"
"chr7","2135321","2135612","chr3","35717499","35717789","34","33582178"
"chr7","2138511","2138725","chr11","110176270","110176479","41","108037759"
"chr7","2139021","2139116","chr3","126806420","126806512","18","124667399"
"chr7","2151463","2151744","chr13","25090593","25090872","41","22939130"
"chr7","2171050","2171324","chr1","123404772","123405065","61","121233722"
"chr7","2173288","2173585","chr3","35757297","35757593","18","33584009"
"chr7","2189707","2189995","chr3","35775873","35776146","52","33586166"
"chr7","2254500","2254661","chr7","80140173","80140333","27","77885673"
"chr7","2270339","2270647","chr3","35850269","35850575","35","33579930"
"chr7","2284710","2284987","chr8","127141157","127141438","65","124856447"
"chr7","2284990","2285121","chr3","156076755","156076895","43","153791765"
"chr7","2291078","2291243","chr1","45405979","45406141","34","43114901"
"chr7","2291278","2291392","chr3","125019580","125019695","26","122728302"
"chr7","2338820","2339001","chr3","35920219","35920400","18","33581399"
"chr7","2379379","2379696","chr3","35962405","35962715","32","33583026"
"chr7","2407751","2408036","chr3","35991885","35992171","48","33584134"
"chr7","2554015","2554307","chr5","185507365","185507665","58","182953350"
"chr7","2581167","2581443","chr3","36172001","36172290","39","33590834"
"chr7","2605698","2605829","chr1","109888864","109888999","26","107283166"
"chr7","2633054","2633351","chr17","80429135","80429431","51","77796081"
"chr7","2636672","2636974","chr3","36234447","36234751","40","33597775"
"chr7","2654139","2654456","chr19","43210585","43210888","58","40556446"
"chr7","2659942","2660222","chr3","36257500","36257790","47","33597558"
"chr7","2663585","2663809","chr3","36263529","36263743","24","33599944"
"chr7","2673266","2673391","chr3","36273955","36274080","11","33600689"
"chr7","2678079","2678279","chr3","36278617","36278818","16","33600538"
"chr7","2689259","2689581","chr3","36291295","36291617","30","33602036"
"chr7","2697636","2697751","chr20","27972568","27972682","12","25274932"
"chr7","2698387","2698602","chr14","9611892","9612110","45","6913505"
"chr7","2698932","2699225","chr5","22397555","22397847","58","19698623"
"chr7","2702334","2702605","chr3","36306364","36306657","51","33604030"
"chr7","2703735","2704022","chr4","37548580","37548866","67","34844845"
"chr7","2715064","2715251","chr3","36326284","36326469","17","33611220"
"chr7","2716922","2717092","chr3","36329290","36329452","20","33612368"
"chr7","2734417","2734492","chr3","36348838","36348913","5","33614421"
"chr7","2751287","2751430","chr1","153250707","153250848","28","150499420"
"chr7","2755589","2755880","chrX","112879162","112879463","68","110123573"
"chr7","2755944","2756224","chr11","4124146","4124432","54","1368202"
"chr7","2759104","2759437","chr3","36408549","36408832","70","33649445"
"chr7","2767244","2767502","chr3","36424130","36424381","14","33656886"
"chr7","2771079","2771393","chr3","36428264","36428572","26","33657185"
"chr7","2778786","2779096","chr3","36436389","36436680","35","33657603"
"chr7","2780681","2780951","chr3","36437809","36438073","14","33657128"
"chr7","2798978","2799159","chr19","7887117","7887299","31","5088139"
"chr7","2799453","2799581","chr10","8237746","8237873","20","5438293"
"chr7","2842349","2842601","chr3","36491756","36491992","52","33649407"
"chr7","2844440","2844739","chr3","36493801","36494101","23","33649361"
"chr7","2891309","2891488","chr3","36684318","36684493","13","33793009"
"chr7","2891733","2891850","chr3","36683901","36684020","10","33792168"
"chr7","2900788","2901079","chr17","80429135","80429431","58","77528347"
"chr7","2904665","2904931","chr4","44110011","44110289","71","41205346"
"chr7","2908009","2908304","chr3","36664170","36664468","26","33756161"
"chr7","2910348","2910482","chr19","28700049","28700184","27","25789701"
"chr7","2910797","2910970","chr14","64804258","64804431","33","61893461"
"chr7","2912950","2913259","chr3","36660689","36660983","52","33747739"
"chr7","2914477","2914759","chr3","36659422","36659722","60","33744945"
"chr7","2925368","2925634","chr1","186907121","186907386","43","183981753"
"chr7","2933575","2933860","chr3","36639593","36639881","22","33706018"
"chr7","2944522","2944807","chr3","36628838","36629113","37","33684316"
"chr7","2958215","2958340","chr3","36614910","36615044","18","33656695"
"chr7","2969955","2970079","chr3","36601902","36602026","9","33631947"
"chr7","2975279","2975562","chr3","36596803","36597094","38","33621524"
"chr7","2982271","2982537","chr3","36587520","36587775","33","33605249"
"chr7","3025178","3025301","chr5","139713162","139713279","25","136687984"
"chr7","3025632","3025903","chr3","36540292","36540572","51","33514660"
"chr7","3026444","3026570","chr13","54539496","54539622","31","51513052"
"chr7","3028510","3028629","chr3","36683901","36684020","7","33655391"
"chr7","3028869","3029048","chr3","36684318","36684493","13","33655449"
"chr7","3033966","3034307","chr3","36689993","36690289","77","33656027"
"chr7","3043092","3043315","chr3","36698334","36698563","24","33655242"
"chr7","3046253","3046412","chr4","161962632","161962792","33","158916379"
"chr7","3057138","3057408","chr3","36712128","36712396","33","33654990"
"chr7","3075597","3075916","chr3","36730973","36731267","49","33655376"
"chr7","3094057","3094249","chr1","46757713","46757903","43","43663656"
"chr7","3103967","3104279","chr3","36753601","36753907","53","33649634"
"chr7","3109681","3109920","chr3","36759667","36759907","15","33649986"
"chr7","3131759","3131802","chr4","153868411","153868456","10","150736652"
"chr7","3132087","3132249","chr12","75025941","75026102","39","71893854"
"chr7","3142951","3143264","chr16","19315104","19315419","68","16172153"
"chr7","3165114","3165338","chr3","36818704","36818937","29","33653590"
"chr7","3172918","3173212","chr3","36826466","36826765","25","33653548"
"chr7","3174753","3174998","chr3","36828242","36828482","26","33653489"
"chr7","3180947","3181279","chr3","36834697","36835022","48","33653750"
"chr7","3190493","3190779","chr3","36843669","36843958","26","33653176"
"chr7","3192768","3193070","chr3","36846050","36846354","32","33653282"
"chr7","3194586","3194850","chr3","36847910","36848175","17","33653324"
"chr7","3195614","3195739","chr9","107933148","107933272","19","104737534"
"chr7","3211580","3211862","chr3","36864315","36864600","25","33652735"
"chr7","3220956","3221248","chr3","36873010","36873304","21","33652054"
"chr7","3230277","3230458","chr3","36882558","36882738","21","33652281"
"chr7","3230764","3230902","chr3","36883046","36883185","15","33652282"
"chr7","3237211","3237353","chr19","16903685","16903832","30","13666474"
"chr7","3243935","3244242","chr3","36897369","36897664","33","33653434"
"chr7","3248438","3248716","chr3","36901941","36902229","27","33653503"
"chr7","3250914","3251228","chr3","36904507","36904821","44","33653593"
"chr7","3254713","3254964","chr3","36910344","36910596","21","33655631"
"chr7","3255271","3255382","chr3","36910901","36911011","11","33655630"
"chr7","3263563","3263851","chr3","36919248","36919541","23","33655685"
"chr7","3267288","3267409","chr13","56634295","56634413","19","53367007"
"chr7","3277453","3277566","chr1","15925158","15925270","25","12647705"
"chr7","3286090","3286410","chr3","43652365","43652670","64","40366275"
"chr7","3288689","3288990","chr3","36946066","36946368","28","33657377"
"chr7","3305179","3305495","chr3","36962930","36963243","23","33657751"
"chr7","3306836","3306932","chrX","89867784","89867880","19","86560948"
"chr7","3308436","3308726","chr3","36966193","36966499","42","33657757"
"chr7","3308749","3309021","chr3","36966503","36966795","43","33657754"
"chr7","3310691","3310972","chr3","36968479","36968761","17","33657788"
"chr7","3312388","3312680","chr3","36970174","36970471","30","33657786"
"chr7","3320557","3320838","chr3","36978245","36978536","34","33657688"
"chr7","3324656","3324933","chr3","36981436","36981714","13","33656780"
"chr7","3326784","3327077","chr3","36983584","36983879","17","33656800"
"chr7","3337472","3337771","chr2","84913076","84913368","51","81575604"
"chr7","3340880","3341161","chr12","114130342","114130631","57","110789462"
"chr7","3341188","3341212","chr3","2827691","2827711","7","513497"
"chr7","3351578","3351885","chr3","37007671","37007977","26","33656093"
"chr7","3351887","3352182","chr3","37007979","37008279","35","33656092"
"chr7","3357714","3358020","chr3","37013479","37013784","28","33655765"
"chr7","3364650","3364774","chr1","211231687","211231814","14","207867037"
"chr7","3368003","3368289","chr3","37023454","37023739","18","33655451"
"chr7","3374832","3375134","chr3","37030826","37031138","36","33655994"
"chr7","3384262","3384558","chr7","143441382","143441682","53","140057120"
"chr7","3385969","3386242","chr3","37042470","37042744","13","33656501"
"chr7","3388436","3388750","chr3","37044448","37044759","40","33656012"
"chr7","3397968","3398274","chr3","37054482","37054768","45","33656514"
"chr7","3400518","3400891","chr7","133540661","133541031","98","130140143"
"chr7","3403282","3403574","chr3","37059857","37060157","28","33656575"
"chr7","3417835","3418137","chr3","37073961","37074277","36","33656126"
"chr7","3431061","3431353","chr3","37087289","37087592","31","33656228"
"chr7","3441016","3441284","chr3","37097635","37097906","18","33656619"
"chr7","3441677","3441966","chr3","37098291","37098596","37","33656614"
"chr7","3451491","3451591","chr20","54254011","54254107","22","50802520"
"chr7","3462123","3462425","chr3","37119684","37119988","22","33657561"
"chr7","3488023","3488291","chr3","37181360","37181614","38","33693337"
"chr7","3504364","3504694","chr3","37198475","37198802","20","33694111"
"chr7","3505524","3505808","chr3","37199637","37199910","34","33694113"
"chr7","3519829","3520129","chr3","37214438","37214740","23","33694609"
"chr7","3529918","3530219","chr3","37228755","37229073","43","33698837"
"chr7","3531838","3532147","chr3","37230415","37230724","12","33698577"
"chr7","3536256","3536555","chr3","48991048","48991343","53","45454792"
"chr7","3540811","3541104","chr4","123481512","123481809","63","119940701"
"chr7","3550893","3551203","chr3","37250238","37250538","28","33699345"
"chr7","3556971","3557242","chr13","105368958","105369221","57","101811987"
"chr7","3559494","3559788","chr3","37258637","37258940","37","33699143"
"chr7","3559891","3560185","chr3","37259055","37259366","32","33699164"
"chr7","3585278","3585562","chr15","16974639","16974918","49","13389361"
"chr7","3593423","3593634","chr3","37292797","37293008","18","33699374"
"chr7","3602158","3602452","chr3","2422864","2423155","60","1179294"
"chr7","3604622","3604832","chr3","37304497","37304679","40","33699875"
"chr7","3605267","3605370","chr3","37305111","37305212","8","33699844"
"chr7","3612778","3612949","chr3","37312271","37312439","20","33699493"
"chr7","3612953","3613167","chr11","12596620","12596836","41","8983667"
"chr7","3622188","3622488","chr3","37321325","37321590","62","33699137"
"chr7","3627511","3627746","chr3","37326557","37326817","41","33699046"
"chr7","3630318","3630623","chr1","31594185","31594487","58","27963867"
"chr7","3660779","3661066","chr3","37375389","37375688","31","33714610"
"chr7","3676614","3676784","chr20","4062761","4062927","40","386147"
"chr7","3687664","3687975","chr4","36470308","36470624","65","32782644"
"chr7","3713456","3713743","chr3","37428104","37428382","28","33714648"
"chr7","3744240","3744506","chr3","37459218","37459503","42","33714978"
"chr7","3755145","3755434","chr3","37470994","37471285","17","33715849"
"chr7","3767966","3768251","chr3","37483742","37484024","18","33715776"
"chr7","3794664","3794948","chr3","37511685","37511966","30","33717021"
"chr7","3799596","3799866","chr3","37517102","37517390","44","33717506"
"chr7","3807964","3808277","chr3","37526455","37526774","38","33718491"
"chr7","3833731","3834033","chr3","37553022","37553325","53","33719291"
"chr7","3881883","3882043","chr3","37602067","37602233","24","33720184"
"chr7","3901467","3901773","chr11","117366311","117366614","66","113464844"
"chr7","3945385","3945698","chr3","37656981","37657298","20","33711596"
"chr7","3955451","3955763","chr2","95305588","95305893","69","91350137"
"chr7","3957872","3957915","chr1","135003777","135003817","8","131045905"
"chr7","3969365","3969643","chr3","37681160","37681436","18","33711795"
"chr7","3973763","3974070","chr3","37685433","37685748","36","33711670"
"chr7","4004702","4004921","chr18","20111807","20112035","58","16107105"
"chr7","4045081","4045379","chr3","37769211","37769503","45","33724130"
"chr7","4125015","4125303","chr3","37850827","37851111","24","33725812"
"chr7","4129901","4130199","chr3","124267629","124267922","56","120137728"
"chr7","4152221","4152520","chr3","37878936","37879234","40","33726715"
"chr7","4154081","4154365","chr2","163445135","163445414","50","159291054"
"chr7","4180985","4181291","chr3","37911013","37911318","27","33730028"
"chr7","4189073","4189363","chr3","37918050","37918338","25","33728977"
"chr7","4210136","4210423","chr3","37943192","37943479","24","33733056"
"chr7","4227918","4228187","chr3","37960123","37960409","38","33732205"
"chr7","4269288","4269546","chr10","68119189","68119444","58","63849901"
"chr7","4307375","4307507","chr3","38047404","38047534","14","33740029"
"chr7","4316258","4316559","chr3","38057048","38057373","36","33740790"
"chr7","4365822","4366121","chr3","38113455","38113750","19","33747633"
"chr7","4366618","4366919","chr3","38114276","38114562","45","33747658"
"chr7","4367320","4367620","chr11","116619581","116619868","70","112252261"
"chr7","4395924","4396197","chr3","38135803","38136085","30","33739879"
"chr7","4440281","4440583","chr16","68650242","68650548","64","64209961"
"chr7","4467195","4467444","chr3","38211008","38211256","19","33743813"
"chr7","4467445","4467572","chr9","22431159","22431284","23","17963714"
"chr7","4473710","4473979","chr3","38217328","38217618","40","33743618"
"chr7","4485674","4485957","chr3","38229786","38230079","28","33744112"
"chr7","4518116","4518421","chr3","38260546","38260872","48","33742430"
"chr7","4557769","4558078","chr3","38302165","38302455","31","33744396"
"chr7","4617148","4617197","chr19","45750803","45750852","5","41133655"
"chr7","4617708","4617852","chr2","63234991","63235138","27","58617283"
"chr7","4619439","4619702","chr3","38365074","38365365","47","33745635"
"chr7","4621663","4621956","chr3","38368117","38368409","17","33746454"
"chr7","4626802","4627045","chr3","38373337","38373580","20","33746535"
"chr7","4647982","4648308","chr3","38392887","38393198","38","33744905"
"chr7","4660536","4660785","chr3","38404877","38405140","30","33744341"
"chr7","4680872","4681138","chr3","38420312","38420577","30","33739440"
"chr7","4687814","4688099","chr3","38432368","38432654","15","33744554"
"chr7","4701374","4701667","chr1","211353988","211354282","52","206652614"
"chr7","4730071","4730369","chr3","38473803","38474119","44","33743732"
"chr7","4733349","4733639","chr3","38481751","38482054","28","33748402"
"chr7","4744090","4744337","chr3","38492040","38492288","18","33747950"
"chr7","4753252","4753354","chr6","93630790","93630896","13","88877538"
"chr7","4767016","4767311","chr3","38515938","38516231","24","33748922"
"chr7","4777795","4778068","chr3","38525275","38525548","20","33747480"
"chr7","4786203","4786485","chr3","38533910","38534198","39","33747707"
"chr7","4789533","4789816","chr3","38537260","38537552","21","33747727"
"chr7","4802746","4803080","chr3","38554163","38554513","61","33751417"
"chr7","4804106","4804265","chr3","38555544","38555717","26","33751438"
"chr7","4804558","4804693","chr3","38556032","38556167","4","33751474"
"chr7","4812015","4812262","chr3","38563254","38563493","24","33751239"
"chr7","4815107","4815416","chr3","38564797","38565106","21","33749690"
"chr7","4827409","4827526","chr3","38576727","38576844","10","33749318"
"chr7","4836636","4836901","chr3","38581390","38581656","16","33744754"
"chr7","4844378","4844489","chr19","8453661","8453766","24","3609283"
"chr7","4844776","4844952","chr11","109161155","109161329","34","104316379"
"chr7","4849303","4849543","chr1","160886968","160887208","50","156037665"
"chr7","4852051","4852164","chr3","55571720","55571831","16","50719669"
"chr7","4852356","4852659","chr7","83886733","83887035","59","79034377"
"chr7","4853595","4853787","chr3","38596907","38597098","19","33743312"
"chr7","4853792","4854082","chr3","38597104","38597403","26","33743312"
"chr7","4855544","4855838","chr16","68450975","68451269","45","63595431"
"chr7","4860974","4861256","chr3","38602755","38603028","32","33741781"
"chr7","4866257","4866563","chr3","38608021","38608316","51","33741764"
"chr7","4874898","4875146","chr3","38616710","38616959","18","33741812"
"chr7","4875927","4876134","chr1","10837818","10838024","41","5961891"
"chr7","4876896","4877127","chr3","38619151","38619377","29","33742255"
"chr7","4877639","4877917","chr3","38619899","38620186","20","33742260"
"chr7","4878973","4879222","chr3","38622058","38622306","23","33743085"
"chr7","4882075","4882370","chr20","54333740","54334033","55","49451665"
"chr7","4886010","4886138","chr3","38629154","38629280","14","33743144"
"chr7","4900460","4900762","chr3","38653159","38653459","15","33752699"
"chr7","4904723","4904866","chr6","122098582","122098725","25","117193859"
"chr7","4905178","4905328","chr6","125857818","125857973","27","120952640"
"chr7","4910496","4910792","chr3","38662779","38663097","42","33752283"
"chr7","4913836","4914112","chr3","38666460","38666739","21","33752624"
"chr7","4914528","4914809","chr3","38667156","38667455","38","33752628"
"chr7","4918307","4918588","chr3","38670620","38670901","16","33752313"
"chr7","4919716","4920019","chr3","38672003","38672300","29","33752287"
"chr7","4936720","4936848","chr3","38686954","38687086","13","33750234"
"chr7","4943869","4943979","chr6","56503130","56503239","14","51559261"
"chr7","4945348","4945507","chr3","38697348","38697502","13","33752000"
"chr7","4945856","4945978","chr1","54908386","54908509","19","49962530"
"chr7","4947707","4948005","chr3","38699752","38700052","24","33752045"
"chr7","4948813","4949110","chr3","38701547","38701840","30","33752734"
"chr7","4956517","4956627","chr3","38710874","38710984","14","33754357"
"chr7","4967204","4967496","chr3","38722455","38722752","26","33755251"
"chr7","4973567","4973818","chr4","133472201","133472436","66","128498634"
"chr7","4985396","4985663","chr3","38741165","38741452","33","33755769"
"chr7","4994086","4994222","chr11","122075585","122075711","25","117081499"
"chr7","4994564","4994744","chr11","7045224","7045395","34","2050660"
"chr7","4997367","4997437","chr7","37558740","37558807","15","32561373"
"chr7","4997802","4998100","chr4","36614519","36614808","55","31616717"
"chr7","5009644","5009907","chr3","38767414","38767673","37","33757770"
"chr7","5012341","5012639","chr3","38770695","38770986","51","33758354"
"chr7","5020385","5020690","chr3","38778544","38778842","49","33758159"
"chr7","5035769","5036066","chr3","38794223","38794517","25","33758454"
"chr7","5039814","5040088","chr3","38798288","38798595","51","33758474"
"chr7","5040911","5041194","chr3","38799390","38799688","31","33758479"
"chr7","5049186","5049449","chr3","38806774","38807029","23","33757588"
"chr7","5071137","5071444","chr3","38830576","38830868","33","33759439"
"chr7","5080484","5080771","chr2","160551205","160551504","52","155470721"
"chr7","5106641","5106772","chr3","38863610","38863741","9","33756969"
"chr7","5137780","5138066","chr3","38895066","38895336","34","33757286"
"chr7","5162298","5162578","chr3","38916623","38916906","27","33754325"
"chr7","5162992","5163306","chr3","38917330","38917654","35","33754338"
"chr7","5175126","5175430","chr3","38934767","38935033","55","33759641"
"chr7","5196321","5196616","chr3","38995347","38995648","30","33799026"
"chr7","5203475","5203783","chr3","39007741","39008023","50","33804266"
"chr7","5209231","5209501","chr3","39013527","39013788","25","33804296"
"chr7","5220517","5220760","chr3","181164775","181165008","55","175944258"
"chr7","5222266","5222478","chr3","39026986","39027204","21","33804720"
"chr7","5226002","5226291","chr3","39030707","39030995","39","33804705"
"chr7","5233796","5234100","chr3","39034924","39035210","39","33801128"
"chr7","5234104","5234270","chr3","39035232","39035395","12","33801128"
"chr7","5238616","5238897","chr3","39042030","39042311","16","33803414"
"chr7","5240013","5240113","chr3","39043437","39043537","8","33803424"
"chr7","5240908","5241147","chr19","10789324","10789570","65","5548416"
"chr7","5250292","5250573","chr3","39054015","39054294","23","33803723"
"chr7","5251960","5252248","chr3","39055730","39056018","21","33803770"
"chr7","5255803","5255908","chr3","39235495","39235615","20","33979692"
"chr7","5258364","5258653","chr3","39063483","39063755","50","33805119"
"chr7","5260371","5260649","chr3","39234610","39234883","43","33974239"
"chr7","5274841","5275130","chr3","39082998","39083254","50","33808157"
"chr7","5290557","5290838","chr13","70747803","70748083","25","65457246"
"chr7","5291956","5292049","chr13","70749226","70749319","3","65457270"
"chr7","5293073","5293357","chr13","70750687","70750975","29","65457614"
"chr7","5319587","5319808","chr16","25942172","25942394","45","20622585"
"chr7","5326294","5326416","chr5","147763649","147763770","20","142437355"
"chr7","5331495","5331753","chr3","39941228","39941484","12","34609733"
"chr7","5334185","5334380","chr5","2023599","2023790","38","3310586"
"chr7","5336939","5337055","chr12","9321040","9321157","14","3984101"
"chr7","5337492","5337781","chr3","39126287","39126576","18","33788795"
"chr7","5341516","5341645","chr3","39130288","39130412","11","33788772"
"chr7","5356647","5356945","chr13","86944769","86945076","68","81588122"
"chr7","5358168","5358434","chr3","39146723","39146984","20","33788555"
"chr7","5370125","5370415","chr3","39155778","39156048","49","33785653"
"chr7","5373469","5373757","chr3","39159304","39159586","21","33785835"
"chr7","5387881","5388115","chr1","131462203","131462437","57","126074322"
"chr7","5388470","5388762","chr4","159895782","159896078","66","154507312"
"chr7","5394189","5394484","chr1","67019962","67020252","50","61625773"
"chr7","5395693","5395990","chr17","9722411","9722714","58","4326718"
"chr7","5396775","5397064","chrX","19238064","19238349","56","13841289"
"chr7","5409342","5409629","chr3","39173622","39173891","40","33764280"
"chr7","5409655","5409777","chr18","30782581","30782704","20","25372926"
"chr7","5413405","5413700","chr3","39178597","39178884","23","33765192"
"chr7","5416709","5416988","chr3","39183603","39183884","25","33766894"
"chr7","5418940","5419115","chr19","28091011","28091179","44","22672071"
"chr7","5419418","5419553","chr19","36030380","36030518","27","30610962"
"chr7","5423493","5423591","chr3","39188764","39188863","8","33765271"
"chr7","5454737","5455022","chr3","39889024","39889309","17","34434287"
"chr7","5466491","5466797","chr3","39874144","39874454","29","34407653"
"chr7","5470730","5471029","chr3","39869906","39870212","30","34399176"
"chr7","5471794","5471917","chr3","39869003","39869123","15","34397209"
"chr7","5476100","5476422","chr3","39864174","39864496","23","34388074"
"chr7","5479481","5479758","chr3","39859884","39860161","28","34380403"
"chr7","5489597","5489861","chr3","39848972","39849238","23","34359375"
"chr7","5494318","5494609","chr19","43210585","43210888","58","37716267"
"chr7","5516083","5516366","chr3","39819449","39819727","21","34303366"
"chr7","5518810","5518901","chr3","175695621","175695717","20","170176811"
"chr7","5528430","5528717","chr3","39804175","39804480","33","34275745"
"chr7","5531342","5531638","chr3","39801590","39801891","21","34270248"
"chr7","5549623","5549762","chr8","96729325","96729462","30","91179702"
"chr7","5549802","5549928","chr3","39780288","39780421","18","34230486"
"chr7","5550235","5550328","chrX","53790985","53791067","19","48240750"
"chr7","5556882","5557009","chr3","39773268","39773395","9","34216386"
"chr7","5559906","5560193","chr3","39770117","39770401","19","34210211"
"chr7","5564833","5565108","chr3","39765651","39765938","28","34200818"
"chr7","5572799","5572959","chr3","39757246","39757405","18","34184447"
"chr7","5573694","5573994","chr3","39756201","39756503","34","34182507"
"chr7","5574994","5575266","chr3","39754627","39754908","40","34179633"
"chr7","5581277","5581567","chr3","39747115","39747406","17","34165838"
"chr7","5582390","5582673","chr6","170656687","170656969","61","165074297"
"chr7","5595146","5595425","chr3","39730313","39730605","35","34135167"
"chr7","5599209","5599510","chr3","39724555","39724852","39","34125346"
"chr7","5600614","5600902","chr3","39722855","39723141","26","34122241"
"chr7","5601128","5601419","chr3","39721355","39721647","24","34120227"
"chr7","5605591","5605886","chr3","39717065","39717370","22","34111474"
"chr7","5615620","5615747","chr3","39704699","39704825","11","34089079"
"chr7","5616057","5616232","chr7","92039014","92039198","40","86422957"
"chr7","5623943","5624197","chrX","52715681","52715941","65","47091738"
"chr7","5641790","5642097","chr3","39681342","39681655","41","34039552"
"chr7","5653740","5653902","chr3","39666538","39666700","20","34012798"
"chr7","5654212","5654344","chr3","39666086","39666225","13","34011874"
"chr7","5659796","5660086","chr7","116402325","116402622","62","110742529"
"chr7","5663370","5663494","chr3","39655958","39656082","7","33992588"
"chr7","5667322","5667493","chr3","39651898","39652068","23","33984576"
"chr7","5667794","5667942","chr3","39651439","39651587","13","33983645"
"chr7","5667943","5668247","chr3","39651144","39651438","36","33983201"
"chr7","5669275","5669525","chr3","39649853","39650099","27","33980578"
"chr7","5674026","5674316","chr3","39645915","39646191","56","33971889"
"chr7","5682812","5683110","chr3","39635239","39635535","26","33952427"
"chr7","5702910","5703193","chr3","39615709","39616001","35","33912799"
"chr7","5705026","5705312","chr3","39609957","39610249","22","33904931"
"chr7","5706644","5706940","chr3","39608322","39608620","27","33901678"
"chr7","5708973","5709220","chr3","39604302","39604547","25","33895329"
"chr7","5712223","5712492","chr3","39600993","39601282","37","33888770"
"chr7","5714059","5714325","chr19","8769535","8769798","52","3055476"
"chr7","5718468","5718751","chr3","39594872","39595177","37","33876404"
"chr7","5719879","5720176","chr3","39593707","39594025","42","33873828"
"chr7","5720187","5720291","chr4","15278126","15278223","22","9557939"
"chr7","5720591","5720626","chrX","144545810","144545847","7","138825219"
"chr7","5723976","5724138","chr20","2223929","2224097","29","3500047"
"chr7","5724441","5724551","chr2","21118754","21118847","29","15394313"
"chr7","5734294","5734590","chr3","39578226","39578524","25","33843932"
"chr7","5738602","5738899","chr3","39571415","39571697","52","33832813"
"chr7","5752969","5753264","chr3","39558526","39558837","38","33805557"
"chr7","5767365","5767573","chr14","66911348","66911552","38","61143983"
"chr7","5769901","5770215","chr1","35595269","35595576","60","29825368"
"chr7","5785936","5786235","chr3","39527137","39527448","28","33741201"
"chr7","5790054","5790157","chr5","1889927","1890031","22","3900127"
"chr7","5796932","5797064","chr3","39514532","39514664","12","33717600"
"chr7","5813759","5813977","chr19","33928910","33929130","43","28115151"
"chr7","5819358","5819578","chr2","89047385","89047606","47","83228027"
"chr7","5824802","5824859","chr20","747457","747506","12","5077345"
"chr7","5825166","5825316","chr19","17104693","17104839","38","11279527"
"chr7","5829545","5829843","chr15","43687639","43687935","56","37858094"
"chr7","5855439","5855648","chr7","20198891","20199096","45","14343452"
"chr7","5856104","5856196","chr6","175600238","175600324","28","169744134"
"chr7","5857381","5857695","chr10","32184869","32185181","59","26327488"
"chr7","5859598","5859882","chr3","39439804","39440088","22","33580206"
"chr7","5861050","5861365","chr16","41128419","41128750","129","35267369"
"chr7","5862637","5862735","chr3","39435487","39435581","14","33572850"
"chr7","5870643","5870930","chr3","39426636","39426930","40","33555993"
"chr7","5872629","5872928","chr3","39423664","39423960","27","33551035"
"chr7","5873764","5874080","chr18","6336977","6337277","63","463213"
"chr7","5900738","5900988","chr3","39392122","39392386","41","33491384"
"chr7","5901894","5902199","chr3","39390274","39390581","39","33488380"
"chr7","5927442","5927639","chr10","31228290","31228480","36","25300848"
"chr7","5933202","5933478","chr3","39358673","39358948","18","33425471"
"chr7","5945709","5945998","chr3","39344189","39344508","53","33398480"
"chr7","5969579","5969837","chr3","39319277","39319540","22","33349698"
"chr7","5980897","5981198","chr3","39307383","39307690","38","33326486"
"chr7","5998579","5998861","chr3","39082998","39083254","47","33084419"
"chr7","6025512","6025802","chr16","40461910","40462200","71","34436398"
"chr7","6035125","6035422","chr3","39253906","39254205","27","33218781"
"chr7","6036710","6037032","chr3","39251179","39251499","29","33214469"
"chr7","6045009","6045177","chr3","39246642","39246834","39","33201633"
"chr7","6052630","6052746","chr3","39235495","39235615","10","33182865"
"chr7","6053360","6053599","chr19","8254164","8254401","49","2200804"
"chr7","6057823","6057907","chr14","112775846","112775935","19","106718023"
"chr7","6059367","6059400","chr15","282885","282908","12","5776482"
"chr7","6061098","6061215","chr3","39059102","39059218","12","32998004"
"chr7","6065012","6065300","chr3","39055730","39056018","24","32990718"
"chr7","6078884","6079192","chr3","39211941","39212237","25","33133057"
"chr7","6080878","6081168","chr3","39209914","39210204","18","33129036"
"chr7","6085268","6085393","chr14","57623342","57623465","27","51538074"
"chr7","6099433","6099556","chr3","39187033","39187156","8","33087600"
"chr7","6100227","6100511","chr12","109768756","109769045","62","103668529"
"chr7","6102480","6102754","chr3","39183603","39183884","28","33081123"
"chr7","6107563","6107842","chr3","123333458","123333733","25","117225895"
"chr7","6111180","6111453","chr9","15329101","15329372","60","9217921"
"chr7","6112826","6113121","chr8","101995127","101995417","51","95882301"
"chr7","6114221","6114524","chr15","100706419","100706722","58","94592198"
"chr7","6122670","6122964","chrX","30604149","30604445","59","24481479"
"chr7","6124630","6124903","chrX","111904330","111904595","53","105779700"
"chr7","6125560","6125860","chr15","29615590","29615889","54","23490030"
"chr7","6127870","6127958","chr7","37130453","37130536","24","31002583"
"chr7","6128937","6129238","chr3","123311848","123312162","36","117182911"
"chr7","6130275","6130435","chr3","123310724","123310893","23","117180449"
"chr7","6130736","6130879","chr3","123310289","123310418","20","117179553"
"chr7","6132941","6133282","chr19","6953784","6954109","76","820843"
"chr7","6135305","6135589","chr3","40812366","40812642","26","34677061"
"chr7","6148064","6148206","chr3","40799241","40799383","9","34651177"
"chr7","6148502","6148650","chr3","42941233","42941386","34","36792731"
"chr7","6163109","6163313","chr11","52285558","52285750","48","46122449"
"chr7","6169551","6169848","chrX","19565039","19565340","48","13395488"
"chr7","6175871","6175956","chr3","40768727","40768809","13","34592856"
"chr7","6177949","6178240","chr3","40765739","40766013","46","34587790"
"chr7","6193487","6193773","chr3","40751173","40751454","29","34557686"
"chr7","6195999","6196200","chr3","40748510","40748716","20","34552511"
"chr7","6199482","6199608","chr3","40745071","40745197","9","34545589"
"chr7","6208019","6208327","chr3","40732491","40732787","31","34524472"
"chr7","6216724","6216840","chr3","50496453","50496566","13","44279729"
"chr7","6217131","6217298","chr3","50495989","50496154","14","44278858"
"chr7","6225297","6225603","chr3","40717851","40718181","37","34492554"
"chr7","6234456","6234752","chr1","35595269","35595576","51","29360813"
"chr7","6235654","6235972","chr3","40704672","40704990","23","34469018"
"chr7","6247504","6247687","chr15","9773064","9773248","41","3525560"
"chr7","6255302","6255593","chr3","40680935","40681233","23","34425633"
"chr7","6265886","6266162","chr2","89038413","89038675","68","82772527"
"chr7","6283527","6283819","chr3","40649647","40649932","40","34366120"
"chr7","6287407","6287715","chr2","178119588","178119898","56","171832181"
"chr7","6290024","6290312","chr3","40643531","40643820","15","34353507"
"chr7","6296452","6296569","chrX","144692053","144692170","14","138395601"
"chr7","6299071","6299222","chr3","40634980","40635132","15","34335909"
"chr7","6302781","6303071","chr13","19754334","19754619","59","13451553"
"chr7","6304469","6304593","chr3","40629190","40629313","11","34324721"
"chr7","6318862","6318999","chr4","3009835","3009974","25","3309027"
"chr7","6319308","6319486","chr5","48905984","48906154","41","42586676"
"chr7","6324047","6324372","chr3","40610050","40610368","49","34286003"
"chr7","6338845","6339121","chr3","40594446","40594723","21","34255601"
"chr7","6378565","6378720","chr3","40553591","40553752","15","34175026"
"chr7","6378736","6379007","chr3","40553305","40553574","24","34174569"
"chr7","6384256","6384567","chr3","40547422","40547730","34","34163166"
"chr7","6387991","6388318","chr3","40543734","40544029","57","34155743"
"chr7","6388424","6388716","chr3","40543313","40543605","25","34154889"
"chr7","6394143","6394453","chr3","40537463","40537767","31","34143320"
"chr7","6404876","6405162","chr3","40526070","40526340","43","34121194"
"chr7","6418039","6418292","chr3","40512229","40512480","19","34094190"
"chr7","6420875","6420963","chr3","40511111","40511199","5","34090236"
"chr7","6433008","6433301","chr3","40497938","40498240","34","34064930"
"chr7","6435723","6435991","chr3","40494960","40495225","20","34059237"
"chr7","6442714","6443003","chr3","40487098","40487359","54","34044384"
"chr7","6444288","6444605","chr3","40485501","40485818","34","34041213"
"chr7","6458028","6458298","chr9","97202195","97202453","55","90744167"
"chr7","6459168","6459507","chr3","40469778","40470117","18","34010610"
"chr7","6469041","6469306","chr3","40458848","40459148","56","33989807"
"chr7","6470036","6470292","chr3","40457851","40458117","31","33987815"
"chr7","6474001","6474310","chr3","40453678","40453970","46","33979677"
"chr7","6475593","6475717","chr3","40452289","40452406","12","33976696"
"chr7","6475782","6476082","chr3","40451909","40452181","50","33976127"
"chr7","6480294","6480456","chr3","40446698","40446854","26","33966404"
"chr7","6480490","6480594","chr10","20860209","20860308","19","14379719"
"chr7","6481516","6481683","chr12","87917476","87917649","32","81435960"
"chr7","6484839","6485073","chr4","36557844","36558088","61","30073005"
"chr7","6485622","6485922","chr3","40441263","40441541","42","33955641"
"chr7","6486763","6487055","chr3","40440114","40440418","44","33953351"
"chr7","6487421","6487538","chr3","40439627","40439743","7","33952206"
"chr7","6487745","6487868","chr3","40439298","40439421","10","33951553"
"chr7","6494703","6494821","chr3","40429970","40430086","22","33935267"
"chr7","6514280","6514433","chr7","164502678","164502823","27","157988398"
"chr7","6515269","6515570","chr3","40404225","40404512","37","33888956"
"chr7","6516934","6517064","chr6","17252977","17253107","21","10736043"
"chr7","6518531","6518648","chr3","40400514","40400624","16","33881983"
"chr7","6520075","6520175","chr3","64918355","64918455","25","58398280"
"chr7","6531805","6532067","chr3","40379279","40379567","42","33847474"
"chr7","6534107","6534304","chr2","95564771","95564965","39","89030664"
"chr7","6536313","6536535","chr3","40377741","40377963","20","33841428"
"chr7","6537522","6537821","chr3","40376446","40376745","16","33838924"
"chr7","6539451","6539575","chr3","40374365","40374489","12","33834914"
"chr7","6540180","6540288","chr19","50275174","50275283","15","43734994"
"chr7","6542809","6542970","chr3","40370310","40370470","16","33827501"
"chr7","6543270","6543284","chr16","43411142","43411152","4","36867872"
"chr7","6543347","6543421","chr2","15064250","15064322","15","8520903"
"chr7","6548190","6548379","chr3","40364883","40365071","29","33816693"
"chr7","6548683","6548813","chr3","40364448","40364578","10","33815765"
"chr7","6570404","6570658","chr3","47104622","47104882","63","40534218"
"chr7","6601053","6601338","chr3","40304437","40304720","33","33703384"
"chr7","6612549","6612866","chr3","40291751","40292075","65","33679202"
"chr7","6615284","6615581","chr3","40288905","40289201","19","33673621"
"chr7","6622518","6622722","chr3","40280617","40280820","17","33658099"
"chr7","6654204","6654328","chr3","40245568","40245691","10","33591364"
"chr7","6656784","6657101","chr3","40242777","40243091","25","33585993"
"chr7","6666412","6666584","chr6","140418534","140418709","32","133752122"
"chr7","6666615","6666730","chr3","123465350","123465465","20","116798735"
"chr7","6671677","6671929","chr3","40225796","40226047","26","33554119"
"chr7","6681832","6682021","chr3","129669679","129669864","41","122987847"
"chr7","6686116","6686352","chr3","40213311","40213569","43","33527195"
"chr7","6695955","6696236","chr3","40203581","40203861","24","33507626"
"chr7","6705926","6706003","chr10","79884891","79884968","13","73178965"
"chr7","6706306","6706448","chr3","44124652","44124790","29","37418346"
"chr7","6716913","6717166","chr11","7508963","7509219","42","792050"
"chr7","6724770","6724829","chr3","40170472","40170533","8","33445702"
"chr7","6726521","6726822","chr3","40168179","40168480","28","33441658"
"chr7","6726840","6727111","chr11","107497847","107498113","62","100771007"
"chr7","6731968","6732257","chr3","40162167","40162464","32","33430199"
"chr7","6733505","6733856","chr3","40160504","40160854","28","33426999"
"chr7","6734948","6735257","chr4","36484206","36484512","60","29749258"
"chr7","6737245","6737374","chr6","171645003","171645132","20","164907758"
"chr7","6737688","6737875","chr6","94973114","94973284","44","88235426"
"chr7","6739835","6740142","chr3","40153351","40153656","18","33413516"
"chr7","6743117","6743367","chr2","115284300","115284543","56","108541183"
"chr7","6746732","6746845","chr3","40145639","40145749","8","33398907"
"chr7","6747135","6747324","chr3","40145144","40145328","35","33398009"
"chr7","6749091","6749175","chr3","40143233","40143317","7","33394142"
"chr7","6756924","6757182","chr3","40131148","40131406","17","33374224"
"chr7","6758417","6758477","chr1","220765217","220765274","18","214006800"
"chr7","6766022","6766316","chr16","68450975","68451269","53","61684953"
"chr7","6768461","6768782","chr3","40121198","40121495","46","33352737"
"chr7","6769281","6769565","chr3","40120120","40120376","47","33350839"
"chr7","6771613","6771814","chr2","71125427","71125623","52","64353814"
"chr7","6789023","6789155","chr3","40099422","40099564","19","33310399"
"chr7","6799607","6799907","chr3","40080683","40080986","29","33281076"
"chr7","6807615","6807909","chr3","40069376","40069680","37","33261761"
"chr7","6819620","6819733","chr3","40057675","40057791","11","33238055"
"chr7","6821171","6821449","chr3","40055601","40055902","60","33234430"
"chr7","6828590","6828799","chrX","134453354","134453566","45","127624764"
"chr7","6855150","6855426","chr3","40022184","40022457","16","33167034"
"chr7","6859245","6859337","chr3","40017547","40017642","9","33158302"
"chr7","6875752","6875972","chr3","39995289","39995505","32","33119537"
"chr7","6908561","6908694","chr3","39107955","39108092","14","32199394"
"chr7","6915493","6915593","chrX","114248252","114248348","22","107332759"
"chr7","6926429","6926546","chr12","9321040","9321157","19","2394611"
"chr7","6926992","6927282","chr3","39126287","39126576","18","32199295"
"chr7","6931085","6931209","chr3","39130288","39130412","9","32199203"
"chr7","6946992","6947256","chr3","40835061","40835336","24","33888069"
"chr7","6949641","6949809","chr3","40854015","40854184","12","33904374"
"chr7","6949810","6950021","chr11","55409946","55410157","39","48460136"
"chr7","6951661","6951957","chr3","40839723","40840008","38","33888062"
"chr7","6953249","6953540","chr3","40857688","40857978","32","33904439"
"chr7","6956702","6956824","chr14","88735495","88735619","22","81778793"
"chr7","6958914","6959221","chr3","40872068","40872376","31","33913154"
"chr7","6961435","6961738","chr3","40866782","40867096","37","33905347"
"chr7","6963000","6963271","chr3","40868344","40868619","49","33905344"
"chr7","6963776","6963827","chr3","40869130","40869181","6","33905354"
"chr7","6963860","6964146","chr3","40869211","40869497","23","33905351"
"chr7","6969024","6969201","chr19","36121354","36121517","44","29152330"
"chr7","7005324","7005607","chr3","14140868","14141172","44","7135544"
"chr7","7120466","7120766","chr3","101763481","101763782","31","94643015"
"chr7","7153467","7153583","chr3","125019580","125019695","15","117866113"
"chr7","7185260","7185387","chr2","44878801","44878925","19","37693541"
"chr7","7191091","7191389","chr3","101678383","101678679","29","94487292"
"chr7","7341051","7341357","chr3","101514642","101514948","23","94173591"
"chr7","7356394","7356499","chr3","101499322","101499425","6","94142928"
"chr7","7370808","7370912","chr3","101482828","101482931","7","94112020"
"chr7","7416716","7417014","chr3","101434585","101434892","27","94017869"
"chr7","7431974","7432280","chr3","101419378","101419662","37","93987404"
"chr7","7437051","7437297","chr17","28673935","28674177","61","21236884"
"chr7","7451107","7451196","chr3","101395274","101395364","9","93944167"
"chr7","7571383","7571466","chr3","101262147","101262229","5","93690764"
"chr7","7580985","7581298","chr10","12355678","12355978","69","4774693"
"chr7","7585903","7586146","chr3","101247755","101247997","15","93661852"
"chr7","7593523","7593657","chr3","101240244","101240377","18","93646721"
"chr7","7705104","7705401","chr3","101134818","101135112","25","93429714"
"chr7","7712781","7713062","chr3","101127104","101127360","45","93414323"
"chr7","7715236","7715514","chr3","101124766","101125051","34","93409530"
"chr7","7718875","7719183","chr3","101121197","101121492","35","93402322"
"chr7","7751968","7752085","chr3","101090196","101090312","8","93338228"
"chr7","7774504","7774791","chr11","108516351","108516633","88","100741847"
"chr7","7776083","7776240","chr19","35574608","35574755","30","27798525"
"chr7","7776538","7776700","chr8","31187686","31187851","33","23411148"
"chr7","7821649","7821752","chr4","14099244","14099352","21","6277595"
"chr7","7853795","7854092","chr7","55925566","55925867","71","48071771"
"chr7","7854661","7854975","chr10","31897186","31897473","90","24042525"
"chr7","7878311","7878529","chr14","9611892","9612110","43","1733581"
"chr7","7923125","7923229","chr3","100881783","100881886","10","92958658"
"chr7","7962828","7963116","chr3","100842732","100843015","22","92879904"
"chr7","8005915","8006195","chr3","100797082","100797391","49","92791167"
"chr7","8028352","8028650","chrX","147369436","147369734","56","139341084"
"chr7","8030114","8030404","chr3","100773622","100773930","34","92743508"
"chr7","8058875","8059157","chr3","100741129","100741415","44","92682254"
"chr7","8062421","8062691","chr3","100737639","100737910","34","92675218"
"chr7","8073993","8074285","chr2","119923100","119923388","65","111849107"
"chr7","8138173","8138485","chr3","100653969","100654302","46","92515796"
"chr7","8198894","8199193","chr3","100588822","100589128","31","92389928"
"chr7","8208528","8208777","chr3","100579761","100580007","16","92371233"
"chr7","8249235","8249507","chr3","100536279","100536534","34","92287044"
"chr7","8302280","8302399","chr3","166844751","166844866","20","158542471"
"chr7","8306235","8306513","chr3","100478904","100479180","29","92172669"
"chr7","8312580","8312885","chr3","100471867","100472171","29","92159287"
"chr7","8334378","8334676","chr3","100450120","100450420","18","92115742"
"chr7","8350954","8351256","chr3","100433324","100433605","46","92082370"
"chr7","8355046","8355273","chr1","10581236","10581471","55","2226190"
"chr7","8397813","8398096","chr3","100387283","100387542","49","91989470"
"chr7","8424594","8424880","chr3","100360306","100360608","29","91935712"
"chr7","8426918","8427191","chr4","87529284","87529557","65","79102366"
"chr7","8471537","8471783","chr14","12977394","12977645","65","4505857"
"chr7","8488561","8488881","chr3","100294214","100294531","36","91805653"
"chr7","8628428","8628719","chr3","100147351","100147641","17","91518923"
"chr7","9073183","9073484","chr3","99609986","99610301","36","90536803"
"chr7","9088582","9088895","chr3","99590835","99591152","23","90502253"
"chr7","9100258","9100548","chr3","99578730","99579051","58","90478472"
"chr7","9163461","9163759","chr3","99508618","99508913","25","90345157"
"chr7","9291452","9291761","chr3","99367091","99367391","42","90075639"
"chr7","9368418","9368658","chr3","99264720","99264960","25","89896302"
"chr7","9500991","9501229","chr1","8008407","8008640","69","1492584"
"chr7","9538551","9538862","chrX","47948010","47948306","79","38409459"
"chr7","9566948","9567172","chr3","99066412","99066636","14","89499464"
"chr7","9580705","9580827","chr3","99052441","99052563","12","89471736"
"chr7","9674804","9675081","chr3","98948821","98949139","82","89274017"
"chr7","9734213","9734519","chr19","16906078","16906388","36","7171865"
"chr7","9771463","9771813","chr3","98858794","98859105","70","89087331"
"chr7","9820216","9820496","chr3","98811392","98811669","16","88991176"
"chr7","9926662","9926976","chr3","98713122","98713430","30","88786460"
"chr7","9972870","9973151","chr3","98667566","98667858","30","88694696"
"chr7","10002414","10002521","chr2","184296249","184296338","39","174293835"
"chr7","10060069","10060365","chr3","98578667","98578966","23","88518598"
"chr7","10075543","10075828","chr19","1630267","1630553","52","8445276"
"chr7","10084733","10085050","chr18","7946005","7946305","88","2138728"
"chr7","10141060","10141368","chr3","98497942","98498249","14","88356882"
"chr7","10456815","10457126","chr3","98156755","98157068","32","87699940"
"chr7","10489868","10490170","chr3","98121439","98121744","39","87631571"
"chr7","10761204","10761507","chr3","97853019","97853301","53","87091815"
"chr7","10816549","10816826","chr3","97802849","97803139","38","86986300"
"chr7","10902155","10902457","chr2","160551205","160551504","54","149649050"
"chr7","10909311","10909427","chr1","92690108","92690223","24","81780797"
"chr7","10923264","10923553","chr3","97690574","97690853","63","86767310"
"chr7","10929304","10929586","chrX","112227503","112227781","55","101298199"
"chr7","10957402","10957619","chr3","97657477","97657684","27","86700075"
"chr7","10984662","10984969","chr3","97631893","97632202","47","86647231"
"chr7","10988305","10988594","chr3","97628041","97628334","36","86639736"
"chr7","11029770","11030048","chr3","97588105","97588391","28","86558335"
"chr7","11030268","11030492","chr14","100845255","100845471","50","89814987"
"chr7","11049318","11049576","chr3","97568353","97568625","39","86519035"
"chr7","11058133","11058444","chr3","97559505","97559805","37","86501372"
"chr7","11073184","11073418","chr3","177751497","177751721","53","166678313"
"chr7","11085052","11085354","chr3","97532670","97532972","24","86447618"
"chr7","11154497","11154791","chr3","97463410","97463707","20","86308913"
"chr7","11181227","11181451","chr3","97434155","97434379","15","86252928"
"chr7","11181997","11182281","chr3","97433302","97433588","33","86251305"
"chr7","11359696","11359828","chr19","40426551","40426683","11","29066855"
"chr7","11431716","11432016","chr3","97168320","97168615","23","85736604"
"chr7","11631401","11631712","chr3","96951957","96952262","31","85320556"
"chr7","11751370","11751492","chr1","166753759","166753883","23","155002389"
"chr7","11764387","11764673","chr3","123351694","123351976","63","111587307"
"chr7","11792395","11792691","chr3","96782720","96783021","49","84990325"
"chr7","11808543","11808852","chr3","96766481","96766780","31","84957938"
"chr7","11838220","11838387","chr20","28881189","28881354","44","17042969"
"chr7","12084427","12084728","chr3","96494512","96494812","23","84410085"
"chr7","12122384","12122596","chr3","165223698","165223916","56","153101314"
"chr7","12176282","12176596","chr3","96388438","96388744","34","84212156"
"chr7","12318388","12318680","chr12","59222204","59222491","67","46903816"
"chr7","12484396","12484705","chr3","43652365","43652670","73","31167969"
"chr7","12526567","12526700","chr3","96031403","96031529","15","83504836"
"chr7","12589825","12590115","chr10","68216817","68217113","59","55626992"
"chr7","12754091","12754166","chr2","145388581","145388662","14","132634490"
"chr7","12768439","12768741","chr3","95740943","95741241","28","82972504"
"chr7","12843017","12843169","chr3","95659806","95659966","18","82816789"
"chr7","12843467","12843577","chr3","95659384","95659495","10","82815917"
"chr7","12890794","12891099","chr3","95610225","95610538","26","82719431"
"chr7","12892250","12892552","chr3","95608729","95609028","18","82716479"
"chr7","12896487","12896613","chr3","95604649","95604775","6","82708162"
"chr7","12922399","12922834","chr2","188526906","188527267","156","175604507"
"chr7","12978779","12978913","chr3","95512091","95512225","9","82533312"
"chr7","13040896","13041028","chr14","57724528","57724670","28","44683632"
"chr7","13104521","13104786","chr3","95372389","95372650","19","82267868"
"chr7","13132524","13132784","chr3","95349456","95349717","20","82216932"
"chr7","13139827","13140106","chr3","95343070","95343365","38","82203243"
"chr7","13294359","13294613","chr7","120675359","120675611","67","107381000"
"chr7","13538430","13538741","chr3","89338890","89339201","50","75800460"
"chr7","13551933","13552204","chr3","89352091","89352357","21","75800158"
"chr7","13622016","13622340","chr3","89429697","89430027","26","75807681"
"chr7","13631015","13631325","chr8","122344226","122344533","50","108713211"
"chr7","13915086","13915168","chr7","651487","651564","17","13263599"
"chr7","13976128","13976431","chr3","89790324","89790624","28","75814196"
"chr7","14069832","14070061","chr14","37987994","37988224","70","23918162"
"chr7","14092508","14092635","chr3","89906417","89906550","11","75813909"
"chr7","14113141","14113441","chr3","89927315","89927588","62","75814174"
"chr7","14247364","14247629","chr3","90071069","90071328","38","75823705"
"chr7","14327931","14328232","chr3","90147842","90148143","22","75819911"
"chr7","14346724","14346996","chr3","90168077","90168358","33","75821353"
"chr7","14490692","14491015","chr3","90325845","90326159","47","75835153"
"chr7","14518069","14518335","chr3","90353821","90354088","24","75835752"
"chr7","14545681","14545781","chr3","90380347","90380439","15","75834666"
"chr7","14546655","14546952","chr3","90381304","90381599","20","75834649"
"chr7","14771708","14771860","chr9","72272836","72272988","36","57501128"
"chr7","14778445","14778628","chr7","2419428","2419612","52","12359017"
"chr7","14833005","14833264","chr3","90683293","90683562","33","75850288"
"chr7","14836515","14836816","chr3","90687105","90687431","43","75850590"
"chr7","14908030","14908357","chr3","90759639","90759920","69","75851609"
"chr7","14960885","14961014","chr1","205464254","205464380","21","190503369"
"chr7","14981446","14981622","chr3","90829567","90829757","29","75848121"
"chr7","15003165","15003272","chr1","213086899","213087001","24","198083734"
"chr7","15015340","15015626","chr3","90864683","90864978","34","75849343"
"chr7","15022334","15022645","chr3","90872001","90872339","46","75849667"
"chr7","15519858","15520166","chr16","48464863","48465164","54","32945005"
"chr7","15601419","15601453","chr15","18232694","18232728","13","2631275"
"chr7","15601496","15601659","chr19","17893537","17893701","33","2292041"
"chr7","15685328","15685616","chr3","91587864","91588149","25","75902536"
"chr7","15688052","15688355","chr3","91590576","91590895","45","75902524"
"chr7","15758485","15758786","chr13","45006370","45006675","60","29247885"
"chr7","15786395","15786620","chr3","91695041","91695244","38","75908646"
"chr7","15870990","15871285","chr3","91777544","91777818","80","75906554"
"chr7","16232716","16232999","chrX","108129050","108129338","65","91896334"
"chr7","16260201","16260491","chr3","92164558","92164856","46","75904357"
"chr7","16301173","16301451","chr3","92206358","92206647","36","75905185"
"chr7","16329133","16329404","chr3","92236073","92236347","28","75906940"
"chr7","16530398","16530693","chr3","92444010","92444304","19","75913612"
"chr7","16622114","16622324","chr3","92581046","92581256","11","75958932"
"chr7","16648612","16648883","chr3","92607371","92607640","20","75958759"
"chr7","16669876","16670183","chr3","92628904","92629215","22","75959028"
"chr7","16679544","16679852","chr3","92638544","92638849","36","75959000"
"chr7","16699939","16700232","chr7","24872405","24872701","59","8172466"
"chr7","16706422","16706558","chr3","92665022","92665160","11","75958600"
"chr7","16706837","16707008","chr3","92665445","92665597","29","75958608"
"chr7","16722530","16722816","chr3","92680569","92680860","25","75958039"
"chr7","16725400","16725710","chr14","7051780","7052083","69","9673620"
"chr7","16733936","16734155","chr3","92691939","92692146","29","75958003"
"chr7","16742502","16742810","chr3","92701246","92701543","38","75958744"
"chr7","16744309","16744596","chr3","92703113","92703412","49","75958804"
"chr7","16842309","16842441","chr1","205464254","205464380","18","188621945"
"chr7","16914866","16915168","chrX","28173423","28173718","65","11258557"
"chr7","16917817","16918036","chr10","73195715","73195925","46","56277898"
"chr7","16954574","16954864","chr3","92917498","92917802","38","75962924"
"chr7","16984513","16984783","chr3","92949155","92949418","25","75964642"
"chr7","17071681","17071964","chr15","14032398","14032694","76","3039283"
"chr7","17131822","17132117","chr3","93098111","93098405","26","75966289"
"chr7","17230532","17230820","chr3","93191550","93191847","33","75961018"
"chr7","17266816","17266928","chr3","93225417","93225523","16","75958601"
"chr7","17296346","17296595","chr3","93255467","93255732","40","75959121"
"chr7","17382797","17383084","chr17","80944041","80944326","59","63561244"
"chr7","17409074","17409284","chr3","93397760","93397981","24","75988686"
"chr7","17488039","17488142","chr3","93473504","93473607","8","75985465"
"chr7","17528930","17529150","chr3","93515202","93515421","17","75986272"
"chr7","17574923","17575203","chr8","28331365","28331655","68","10756442"
"chr7","17668811","17668996","chr3","93702610","93702832","45","76033799"
"chr7","17674121","17674394","chr3","93707685","93707969","22","76033564"
"chr7","17684123","17684387","chr3","93717932","93718204","44","76033809"
"chr7","17687247","17687364","chr3","93721425","93721542","11","76034178"
"chr7","17700233","17700356","chr3","93735013","93735143","17","76034780"
"chr7","17708867","17709161","chr3","93743619","93743943","52","76034752"
"chr7","17739320","17739625","chr8","71415791","71416092","68","53676471"
"chr7","17817029","17817323","chr3","93843557","93843852","28","76026528"
"chr7","17836396","17836696","chr5","77659453","77659757","55","59823057"
"chr7","17931266","17931561","chr3","93957397","93957693","26","76026131"
"chr7","17940934","17941226","chr3","93967028","93967333","32","76026094"
"chr7","17958970","17959293","chr3","93985653","93985974","38","76026683"
"chr7","17960067","17960371","chr3","93986740","93987046","25","76026673"
"chr7","17979933","17980124","chr3","94005531","94005725","19","76025598"
"chr7","17997469","17997778","chr3","94022259","94022568","19","76024790"
"chr7","18028395","18028698","chr10","27747092","27747391","57","9718697"
"chr7","18036492","18036607","chr3","94065205","94065320","10","76028713"
"chr7","18071896","18072178","chr13","25090593","25090872","61","7018697"
"chr7","18077384","18077667","chr3","94108057","94108350","29","76030673"
"chr7","18112168","18112351","chr19","28356007","28356185","44","10243839"
"chr7","18141976","18142299","chr14","6219237","6219551","60","11922739"
"chr7","18160097","18160229","chr6","43559000","43559131","22","25398903"
"chr7","18175907","18176042","chr3","94207110","94207245","16","76031203"
"chr7","18176045","18176351","chr3","157401620","157401908","74","139225575"
"chr7","18184750","18185063","chr1","141677669","141677973","67","123492919"
"chr7","18237464","18237770","chr3","94271843","94272145","25","76034379"
"chr7","18246015","18246160","chr3","94282371","94282515","9","76036356"
"chr7","18249610","18249915","chr3","94286157","94286471","40","76036547"
"chr7","18404541","18404819","chr3","94443918","94444208","31","76039377"
"chr7","18434136","18434335","chr3","94473345","94473541","24","76039209"
"chr7","18444196","18444468","chr3","94483490","94483769","30","76039294"
"chr7","18488685","18488989","chr3","94528109","94528392","39","76039424"
"chr7","18503980","18504272","chr3","94543447","94543729","33","76039467"
"chr7","18557718","18557865","chr11","107200486","107200627","32","88642768"
"chr7","18564284","18564597","chr3","94602342","94602648","27","76038058"
"chr7","18684716","18684791","chr3","94722130","94722205","7","76037414"
"chr7","18695555","18695863","chr4","36470308","36470624","67","17774753"
"chr7","18719571","18719855","chr3","94756750","94757030","25","76037179"
"chr7","18749594","18749903","chr3","94787134","94787432","48","76037540"
"chr7","18899868","18900155","chr3","89268385","89268678","26","70368517"
"chr7","19128094","19128392","chr3","89053096","89053420","63","69925002"
"chr7","19157313","19157604","chr3","89024007","89024305","27","69866694"
"chr7","19495263","19495536","chr3","88701325","88701577","47","69206062"
"chr7","19697930","19698214","chr3","88492117","88492399","23","68794187"
"chr7","20056842","20057119","chr3","88149497","88149765","41","68092655"
"chr7","20093743","20094031","chr3","88126867","88127153","31","68033124"
"chr7","20109722","20110003","chr1","14035826","14036100","67","6073896"
"chr7","20136913","20136964","chr3","88089725","88089781","7","67952812"
"chr7","20139502","20139710","chr3","88086961","88087163","15","67947459"
"chr7","20163514","20163812","chr3","88059870","88060185","44","67896356"
"chr7","20465153","20465442","chr3","87749149","87749430","26","67283996"
"chr7","20472794","20473083","chr3","39889024","39889309","56","19416230"
"chr7","20685114","20685331","chr1","39606835","39607056","46","18921721"
"chr7","20810050","20810297","chr5","185737412","185737656","60","164927362"
"chr7","20810603","20810666","chr11","112122323","112122396","19","91311720"
"chr7","20834503","20834835","chr3","87377754","87378042","64","66543251"
"chr7","20840566","20840846","chr3","87372428","87372709","15","66531862"
"chr7","20862543","20862881","chr6","132253582","132253905","70","111391039"
"chr7","20869650","20869928","chr3","39159304","39159586","52","18289654"
"chr7","20947874","20948174","chr3","5453846","5454145","61","15494028"
"chr7","21005309","21005590","chr3","87208484","87208767","20","66203175"
"chr7","21066964","21067104","chr1","153250707","153250848","30","132183743"
"chr7","21067137","21067252","chr4","111829666","111829779","22","90762529"
"chr7","21106638","21106898","chr4","115898034","115898295","59","94791396"
"chr7","21116498","21116807","chr11","109505028","109505342","67","88388530"
"chr7","21174118","21174424","chr3","87048131","87048432","25","65874013"
"chr7","21272827","21272979","chr3","126621167","126621327","38","105348340"
"chr7","21273010","21273048","chr20","27069874","27069911","6","5796864"
"chr7","21352847","21353088","chr3","43340606","43340824","63","21987759"
"chr7","21364170","21364459","chr3","86870897","86871184","40","65506727"
"chr7","21382562","21382873","chr3","86854044","86854361","36","65471482"
"chr7","21393400","21393711","chr13","28869950","28870252","67","7476550"
"chr7","21430248","21430540","chr2","48622768","48623061","55","27192520"
"chr7","21469021","21469314","chr3","86769317","86769610","13","65300296"
"chr7","21469731","21470051","chr3","86768558","86768852","53","65298827"
"chr7","21486790","21486940","chr6","145629603","145629744","45","124142813"
"chr7","21487241","21487333","chr10","653845","653939","14","20833396"
"chr7","21518600","21518686","chr3","86718882","86718968","8","65200282"
"chr7","21526779","21526911","chr15","50987081","50987211","32","29460302"
"chr7","21560922","21561215","chr3","86677534","86677827","18","65116612"
"chr7","21610770","21611093","chr11","109732495","109732805","65","88121725"
"chr7","21633462","21633756","chr5","92944443","92944731","58","71310981"
"chr7","21661573","21661833","chr7","131398459","131398720","56","109736886"
"chr7","21669388","21669674","chr3","86567582","86567867","25","64898194"
"chr7","21743165","21743476","chr3","86492931","86493246","22","64749766"
"chr7","21813791","21814065","chr3","86416099","86416379","28","64602308"
"chr7","21873449","21873606","chr3","86349198","86349372","25","64475749"
"chr7","21892990","21893289","chr3","124267629","124267922","66","102374639"
"chr7","21915463","21915584","chr3","86307616","86307737","3","64392153"
"chr7","21923069","21923350","chrX","65751654","65751935","63","43828585"
"chr7","21936944","21937255","chr3","86287706","86288022","30","64350762"
"chr7","21950897","21951101","chr19","42290728","42290920","41","20339831"
"chr7","21969207","21969457","chr3","86257144","86257394","15","64287937"
"chr7","21972742","21972868","chr3","86253756","86253882","13","64281014"
"chr7","21974038","21974351","chr3","86251803","86252105","33","64277765"
"chr7","21977244","21977542","chr3","86248673","86248975","21","64271429"
"chr7","21982095","21982211","chr3","86243686","86243794","15","64261591"
"chr7","22004107","22004247","chr3","50473069","50473212","24","28468962"
"chr7","22004506","22004658","chr10","54250811","54250962","34","32246305"
"chr7","22032204","22032490","chr6","17609699","17609979","60","4422505"
"chr7","22035164","22035453","chr3","86190521","86190830","30","64155357"
"chr7","22079876","22080057","chr3","86145658","86145840","10","64065782"
"chr7","22149960","22150252","chr3","86077803","86078094","15","63927843"
"chr7","22161128","22161406","chr4","5085405","5085685","57","17075723"
"chr7","22263621","22263820","chr1","62187766","62187962","45","39924145"
"chr7","22263848","22263859","chr19","7777098","7777109","1","14486750"
"chr7","22325182","22325463","chr3","85897290","85897572","15","63572108"
"chr7","22354151","22354368","chr7","54769257","54769470","45","32415106"
"chr7","22433015","22433129","chr11","113226186","113226302","20","90793171"
"chr7","22433167","22433331","chrUn_NW_014806985v1","621","788","31","22432546"
"chr7","22473681","22473965","chr3","85754674","85754936","33","63280993"
"chr7","22868850","22869143","chr11","95107716","95107999","70","72238866"
"chr7","22875074","22875377","chr3","85707322","85707638","30","62832248"
"chr7","22880798","22881079","chr3","85701570","85701850","22","62820772"
"chr7","22925092","22925405","chr3","85656307","85656617","22","62731215"
"chr7","22937775","22938062","chr3","85643430","85643717","16","62705655"
"chr7","22975395","22975678","chr3","85605722","85606005","15","62630327"
"chr7","23071119","23071426","chr7","140100928","140101221","61","117029809"
"chr7","23085965","23086083","chr14","70221854","70221971","18","47135889"
"chr7","23086119","23086291","chr10","79442039","79442211","38","56355920"
"chr7","23093166","23093466","chr3","85489556","85489854","19","62396390"
"chr7","23117063","23117202","chr3","85465121","85465263","8","62348058"
"chr7","23119691","23119809","chr3","85462351","85462467","10","62342660"
"chr7","23172655","23172958","chr3","85419675","85419988","29","62247020"
"chr7","23187182","23187460","chr3","85404925","85405209","26","62217743"
"chr7","23198182","23198318","chr1","26561536","26561668","27","3363354"
"chr7","23202191","23202507","chr3","85388856","85389186","32","62186665"
"chr7","23204230","23204354","chr3","85386994","85387117","7","62182764"
"chr7","23229097","23229413","chr3","85363646","85363962","29","62134549"
"chr7","23249863","23249927","chr4","54637855","54637914","23","31387992"
"chr7","23272878","23273135","chr3","85323854","85324110","19","62050976"
"chr7","23282508","23282818","chr3","85313801","85314105","45","62031293"
"chr7","23296395","23296716","chr20","39509527","39509837","64","16213132"
"chr7","23348585","23348893","chr3","85239867","85240183","33","61891282"
"chr7","23354734","23354852","chr3","67301864","67301983","22","43947130"
"chr7","23362346","23362653","chr1","12681583","12681882","60","10680763"
"chr7","23398051","23398375","chr3","85187993","85188306","52","61789942"
"chr7","23412154","23412450","chr3","85174191","85174487","24","61762037"
"chr7","23413943","23414226","chr3","85172582","85172876","20","61758639"
"chr7","23437303","23437604","chr3","85148384","85148674","39","61711081"
"chr7","23450458","23450745","chr5","14901284","14901569","57","8549174"
"chr7","23451650","23451947","chr3","85132730","85133034","27","61681080"
"chr7","23468905","23469178","chr6","60394718","60394983","62","36925813"
"chr7","23481817","23482099","chr3","85103068","85103363","33","61621251"
"chr7","23491417","23491652","chr3","85094171","85094404","10","61602754"
"chr7","23519473","23519602","chr3","85050626","85050755","18","61531153"
"chr7","23533841","23534124","chr3","85036109","85036372","33","61502268"
"chr7","23535744","23536051","chr3","85033824","85034142","44","61498080"
"chr7","23538743","23539025","chr3","85031253","85031528","27","61492510"
"chr7","23566358","23566602","chr3","126091436","126091662","56","102525078"
"chr7","23590346","23590641","chr3","84926502","84926788","23","61336156"
"chr7","23606702","23606863","chr3","84909980","84910146","17","61303278"
"chr7","23607157","23607281","chr3","84909564","84909688","6","61302407"
"chr7","23628018","23628304","chr3","84893790","84894059","36","61265772"
"chr7","23655435","23655730","chr3","84865769","84866037","39","61210334"
"chr7","23655936","23656224","chr3","126975901","126976192","58","103319965"
"chr7","23667449","23667742","chr3","84853475","84853768","29","61186026"
"chr7","23682798","23683068","chr2","29298724","29298985","67","5615926"
"chr7","23689153","23689277","chr2","140163043","140163179","34","116473890"
"chr7","23712466","23712763","chr10","35934129","35934404","71","12221663"
"chr7","23724829","23725123","chr3","84789641","84789938","23","61064812"
"chr7","23726881","23726958","chr3","84787795","84787872","4","61060914"
"chr7","23730552","23730842","chr3","84784056","84784340","29","61053504"
"chr7","23733404","23733716","chr13","86944769","86945076","68","63211365"
"chr7","23734135","23734329","chr3","84781903","84782098","17","61047768"
"chr7","23734636","23734729","chr3","84781493","84781587","7","61046857"
"chr7","23768066","23768358","chr3","84747813","84748103","25","60979747"
"chr7","23777897","23778114","chr3","84736703","84736921","10","60958806"
"chr7","23778420","23778484","chr10","28579887","28579946","11","4801467"
"chr7","23793530","23793758","chr3","84723391","84723625","23","60929861"
"chr7","23796366","23796477","chr3","84720787","84720898","6","60924421"
"chr7","23799907","23800030","chr3","84717425","84717548","11","60917518"
"chr7","23800524","23800756","chr3","84717676","84717898","24","60917152"
"chr7","23820393","23820547","chr16","57325453","57325607","34","33505060"
"chr7","23820844","23820986","chr8","7813950","7814091","30","16006894"
"chr7","23821535","23821658","chr3","84696134","84696252","11","60874599"
"chr7","23829071","23829203","chr3","84688392","84688524","6","60859321"
"chr7","23829490","23829658","chr12","59016380","59016547","32","35186890"
"chr7","23834555","23834840","chr1","8981776","8982081","66","14852779"
"chr7","23839578","23839866","chr3","84679472","84679760","20","60839894"
"chr7","23843830","23843952","chr3","84675067","84675189","5","60831237"
"chr7","23847085","23847349","chr3","84629150","84629414","25","60782065"
"chr7","23852882","23853172","chr3","84623464","84623767","35","60770582"
"chr7","23859084","23859299","chr3","84616802","84617008","34","60757718"
"chr7","23864336","23864475","chr3","84612395","84612527","16","60748059"
"chr7","23867592","23867895","chr3","84608415","84608706","38","60740823"
"chr7","23868645","23868944","chr3","84606981","84607263","39","60738336"
"chr7","23870892","23871043","chr2","34841972","34842120","31","10971080"
"chr7","23881494","23881786","chr3","84595158","84595445","25","60713664"
"chr7","23888915","23889178","chr3","84586841","84587108","21","60697926"
"chr7","23893970","23894293","chr3","84582724","84583021","48","60688754"
"chr7","23910784","23910883","chr3","84568330","84568420","19","60657546"
"chr7","23911286","23911584","chr12","81368031","81368325","60","57456745"
"chr7","23930627","23930858","chr7","35727866","35728089","57","11797239"
"chr7","23976937","23977224","chr3","84501547","84501840","25","60524610"
"chr7","23979724","23980009","chr3","84498715","84499005","21","60518991"
"chr7","23997267","23997508","chr3","84476563","84476810","30","60479296"
"chr7","24004360","24004639","chr3","84469454","84469734","28","60465094"
"chr7","24013751","24014043","chr3","84460384","84460676","25","60446633"
"chr7","24058814","24059008","chr3","84386374","84386565","14","60327560"
"chr7","24223928","24224083","chr20","17807957","17808116","39","6415971"
"chr7","24301166","24301385","chr3","84182332","84182558","13","59881166"
"chr7","24352545","24352720","chr3","84128363","84128534","17","59775818"
"chr7","24457572","24457856","chr3","84035850","84036132","17","59578278"
"chr7","24458654","24458952","chr3","84034707","84035005","13","59576053"
"chr7","24461810","24462105","chr3","84031414","84031714","42","59569604"
"chr7","24597035","24597345","chr3","83897908","83898206","31","59300873"
"chr7","24644822","24644971","chr11","51046823","51046978","35","26402001"
"chr7","24668463","24668521","chr3","83821833","83821889","4","59153370"
"chr7","24794932","24795120","chr7","129682688","129682879","37","104887756"
"chr7","24823975","24824059","chr3","83665267","83665351","7","58841292"
"chr7","24857211","24857519","chr3","83632087","83632392","23","58774876"
"chr7","24867196","24867474","chr3","83624409","83624686","33","58757213"
"chr7","24888388","24888683","chr3","83603546","83603801","57","58715158"
"chr7","24947392","24947674","chr1","34883660","34883954","62","9936268"
"chr7","24991010","24991311","chr3","15122472","15122781","61","9868538"
"chr7","25031771","25032053","chr3","83470130","83470412","30","58438359"
"chr7","25063069","25063352","chr3","83438460","83438742","20","58375391"
"chr7","25094107","25094403","chr3","83408094","83408395","14","58313987"
"chr7","25103123","25103408","chr3","83398841","83399119","23","58295718"
"chr7","25118261","25118550","chr3","83382906","83383195","21","58264645"
"chr7","25233455","25233742","chr13","10443034","10443317","59","14790421"
"chr7","25246313","25246429","chr3","67301864","67301983","22","42055551"
"chr7","25318352","25318624","chr3","83182710","83182997","36","57864358"
"chr7","25422268","25422574","chr3","83064979","83065263","34","57642711"
"chr7","25483348","25483462","chr3","82978998","82979111","6","57495650"
"chr7","25501673","25501839","chr3","82959172","82959341","27","57457499"
"chr7","25501952","25502075","chr3","82959008","82959131","4","57457056"
"chr7","25638018","25638308","chr3","82822351","82822619","56","57184333"
"chr7","25746404","25746568","chrX","51594020","51594180","40","25847616"
"chr7","25758545","25758856","chr3","82705385","82705685","25","56946840"
"chr7","25797301","25797577","chr3","82665492","82665764","30","56868191"
"chr7","25948166","25948448","chr3","82513338","82513648","34","56565172"
"chr7","26045773","26046069","chr3","82423833","82424121","31","56378060"
"chr7","26063793","26064085","chr3","82399272","82399563","16","56335479"
"chr7","26223441","26223746","chr5","25460696","25460994","62","762745"
"chr7","26238759","26239036","chrX","71720904","71721181","57","45482145"
"chr7","26287504","26287808","chr3","82172887","82173186","43","55885383"
"chr7","26324930","26325229","chr3","82133170","82133468","23","55808240"
"chr7","26329471","26329774","chr3","82128617","82128940","47","55799146"
"chr7","26364579","26364855","chr13","105368958","105369221","73","79004379"
"chr7","26368848","26369157","chr3","82089048","82089366","32","55720200"
"chr7","26378994","26379147","chr3","82077811","82077976","18","55698817"
"chr7","26389550","26389708","chr3","82067092","82067250","8","55677542"
"chr7","26420701","26420904","chr3","82038632","82038835","4","55617931"
"chr7","26456974","26457266","chr3","82002471","82002768","27","55545497"
"chr7","26465571","26465815","chr3","81993621","81993857","21","55528050"
"chr7","26513941","26514232","chr19","30007363","30007647","51","3493422"
"chr7","26514327","26514544","chr3","81930626","81930831","21","55416299"
"chr7","26527166","26527297","chr3","81907699","81907832","10","55380533"
"chr7","26541793","26542055","chr3","81893696","81893946","38","55351903"
"chr7","26542247","26542361","chr3","81893373","81893487","9","55351126"
"chr7","26569634","26569925","chr3","81862800","81863091","17","55293166"
"chr7","26585001","26585299","chr3","81846070","81846368","30","55261069"
"chr7","26596857","26597033","chr15","397474","397648","51","26199383"
"chr7","26628116","26628402","chr3","81802869","81803160","27","55174753"
"chr7","26659225","26659518","chr3","81771447","81771751","34","55112222"
"chr7","26692254","26692489","chr3","81738919","81739149","20","55046665"
"chr7","26697719","26698034","chr3","81733327","81733642","22","55035608"
"chr7","26720584","26720893","chr3","81710548","81710859","20","54989964"
"chr7","26749004","26749117","chr3","81677587","81677699","11","54928583"
"chr7","26866857","26867144","chr3","81540957","81541244","20","54674100"
"chr7","26962208","26962492","chr3","81446387","81446666","31","54484179"
"chr7","26984482","26984829","chr3","81423796","81424140","62","54439314"
"chr7","26992675","26992944","chr3","81415283","81415553","18","54422608"
"chr7","27087526","27087818","chr3","126975901","126976192","64","99888375"
"chr7","27109076","27109376","chr19","39716089","39716392","59","12607013"
"chr7","27119960","27120212","chr3","81281244","81281484","30","54161284"
"chr7","27147822","27148134","chr3","81253854","81254159","27","54106032"
"chr7","27199070","27199373","chr3","81211388","81211707","53","54012318"
"chr7","27203144","27203373","chr3","81207739","81207975","33","54004595"
"chr7","27203425","27203677","chr3","81207409","81207692","51","54003984"
"chr7","27225847","27226014","chr10","29165372","29165533","37","1939525"
"chr7","27226319","27226458","chr3","81184908","81185046","11","53958589"
"chr7","27227695","27228001","chr3","81182703","81183001","25","53955008"
"chr7","27231842","27232077","chr3","81178615","81178851","18","53946773"
"chr7","27235092","27235216","chr3","81175778","81175902","8","53940686"
"chr7","27238803","27239067","chr1","186907121","186907386","51","159668318"
"chr7","27240776","27241079","chr3","81170234","81170541","33","53929458"
"chr7","27273556","27273863","chr3","81143854","81144163","21","53870298"
"chr7","27282851","27283140","chr3","43308110","43308398","50","16025259"
"chr7","27285284","27285595","chr3","81133644","81133954","25","53848360"
"chr7","27302360","27302639","chr3","81115439","81115719","16","53813079"
"chr7","27309749","27309894","chr3","47558463","47558615","27","20248714"
"chr7","27313622","27313841","chr3","81103754","81103966","15","53790132"
"chr7","27474336","27474547","chr1","123579325","123579536","51","96104989"
"chr7","27498056","27498371","chr3","80916496","80916797","52","53418440"
"chr7","27500421","27500707","chr9","36098591","36098870","70","8598170"
"chr7","27501222","27501539","chr3","80913385","80913699","12","53412163"
"chr7","27510196","27510468","chr16","74465929","74466208","59","46955733"
"chr7","27514205","27514495","chr3","80899825","80900128","22","53385620"
"chr7","27560446","27560745","chr3","80848438","80848736","18","53287992"
"chr7","27562510","27562814","chr3","80846394","80846687","26","53283884"
"chr7","27580713","27580956","chr3","80827766","80828007","17","53247053"
"chr7","27596943","27597227","chr3","80804610","80804896","22","53207667"
"chr7","27618564","27618848","chr1","38379932","38380206","70","10761368"
"chr7","27634503","27634798","chr11","131260074","131260355","65","103625571"
"chr7","27642217","27642509","chr3","80759231","80759526","14","53117014"
"chr7","27647479","27647768","chr3","80753926","80754223","22","53106447"
"chr7","27695817","27696125","chr3","80700862","80701162","29","53005045"
"chr7","27709054","27709344","chr3","80687380","80687669","21","52978326"
"chr7","27714098","27714411","chr3","80682321","80682630","28","52968223"
"chr7","27779970","27780285","chr3","80621736","80622050","22","52841766"
"chr7","27864218","27864413","chr3","80530335","80530531","7","52666117"
"chr7","27867345","27867654","chr3","80527146","80527443","43","52659801"
"chr7","27905756","27906053","chr3","80487968","80488265","24","52582212"
"chr7","27908760","27908883","chr3","80485207","80485330","8","52576447"
"chr7","27925485","27925800","chr3","80466117","80466427","25","52540632"
"chr7","27935845","27936138","chr3","80455614","80455892","30","52519769"
"chr7","27941315","27941401","chr15","68336561","68336642","20","40395246"
"chr7","27957362","27957527","chr3","80434289","80434451","14","52476927"
"chr7","27957827","27957982","chr3","80433853","80433997","13","52476026"
"chr7","27966660","27966962","chr3","80426811","80427080","46","52460151"
"chr7","28026469","28026655","chr11","15643899","15644092","39","12382570"
"chr7","28054951","28055130","chr3","80341131","80341322","42","52286180"
"chr7","28055421","28055510","chr3","80340749","80340838","4","52285328"
"chr7","28066051","28066341","chr3","80330153","80330441","25","52264102"
"chr7","28093437","28093766","chr3","80301512","80301854","35","52208075"
"chr7","28133601","28133904","chr3","80260673","80260943","54","52127072"
"chr7","28136277","28136377","chr3","80258168","80258268","4","52121891"
"chr7","28163753","28163877","chr3","80232065","80232190","9","52068312"
"chr7","28167434","28167725","chr3","80228250","80228550","23","52060816"
"chr7","28238752","28239049","chr3","80150468","80150768","25","51911716"
"chr7","28265202","28265506","chr3","80123806","80124110","24","51858604"
"chr7","28286776","28287071","chr3","80102217","80102513","23","51815441"
"chr7","28342294","28342596","chr2","46260060","46260367","61","17917766"
"chr7","28374782","28375068","chr3","80013309","80013603","23","51638527"
"chr7","28388030","28388402","chr8","96082722","96083053","93","67694692"
"chr7","28435067","28435278","chr3","79953904","79954121","17","51518837"
"chr7","28447601","28447861","chr3","79940675","79940941","25","51493074"
"chr7","28452804","28453097","chr3","39159304","39159586","57","10706500"
"chr7","28453644","28453931","chr3","79934421","79934708","17","51480777"
"chr7","28513849","28514138","chr3","79875711","79876007","26","51361862"
"chr7","28518487","28518761","chr3","79871133","79871407","21","51352646"
"chr7","28531077","28531314","chr3","79858554","79858774","27","51327477"
"chr7","28537374","28537517","chr3","42941233","42941386","33","14403859"
"chr7","28638401","28638691","chr1","109829297","109829579","47","81190896"
"chr7","28645099","28645396","chr3","79745142","79745444","30","51100043"
"chr7","28692566","28692875","chr1","24205502","24205806","49","4487064"
"chr7","28712318","28712574","chr3","79677636","79677884","35","50965318"
"chr7","28717055","28717344","chr3","79672868","79673161","27","50955813"
"chr7","28887465","28887763","chr3","79500858","79501162","37","50613393"
"chr7","28909864","28909930","chr19","435429","435491","11","28474435"
"chr7","28909982","28910263","chr3","79478323","79478598","20","50568341"
"chr7","28916719","28916918","chr16","8134323","8134512","50","20782396"
"chr7","28919464","28919771","chr3","79468860","79469170","31","50549396"
"chr7","28933589","28933869","chr3","79454695","79454991","37","50521106"
"chr7","28967386","28967660","chr3","79421692","79421984","36","50454306"
"chr7","28969602","28969911","chr3","79419453","79419750","32","50449851"
"chr7","28975240","28975522","chr3","79413805","79414085","20","50438565"
"chr7","29002760","29003046","chr3","79386596","79386898","36","50383836"
"chr7","29047277","29047504","chr3","44347707","44347928","54","15300430"
"chr7","29050148","29050397","chr3","79339436","79339701","35","50289288"
"chr7","29053717","29054025","chr3","79335784","79336092","21","50282067"
"chr7","29059293","29059582","chr3","79330179","79330494","46","50270886"
"chr7","29070062","29070372","chr18","45361942","45362253","76","16291880"
"chr7","29071866","29071984","chr3","79317830","79317957","17","50245964"
"chr7","29095181","29095438","chr3","79293394","79293665","28","50198213"
"chr7","29180259","29180511","chr19","18388828","18389090","60","10791431"
"chr7","29186558","29186837","chr3","79207153","79207432","14","50020595"
"chr7","29250879","29251194","chr3","79142734","79143061","46","49891855"
"chr7","29278872","29279182","chr3","79110051","79110370","26","49831179"
"chr7","29293267","29293564","chr3","79095660","79095976","40","49802393"
"chr7","29296436","29296751","chr3","79094465","79094774","32","49798029"
"chr7","29409371","29409512","chr3","78981619","78981761","6","49572248"
"chr7","29430516","29430809","chr3","78960664","78960961","27","49530148"
"chr7","29539167","29539457","chr3","78796685","78796991","31","49257518"
"chr7","29727338","29727614","chr9","62251791","62252079","59","32524453"
"chr7","29762958","29763219","chr3","78567246","78567499","21","48804288"
"chr7","29790458","29790773","chr3","78540537","78540871","46","48750079"
"chr7","29792221","29792337","chr3","78538987","78539101","7","48746766"
"chr7","29797307","29797596","chr3","78533754","78534032","31","48736447"
"chr7","29834231","29834532","chr1","15779911","15780207","65","14054320"
"chr7","29859037","29859329","chr3","78472484","78472756","46","48613447"
"chr7","30109833","30110100","chr16","21456395","21456661","40","8653438"
"chr7","30145994","30146260","chr16","21456395","21456661","43","8689599"
"chr7","30368709","30368931","chr5","1806448","1806669","76","28562261"
"chr7","30377707","30377977","chr16","21456395","21456661","38","8921312"
"chr7","30457569","30457829","chr3","78388668","78388929","13","47931099"
"chr7","30500374","30500682","chr12","105822157","105822448","65","75321783"
"chr7","30528085","30528367","chrX","112227503","112227781","60","81699418"
"chr7","30547145","30547452","chr3","78330736","78331049","39","47783591"
"chr7","30547462","30547742","chr3","78330442","78330726","21","47782980"
"chr7","30558600","30558913","chr3","78318797","78319113","32","47760197"
"chr7","30564042","30564180","chr10","63504110","63504264","37","32940068"
"chr7","30564211","30564328","chr15","26017861","26017984","23","4546350"
"chr7","30568996","30569288","chr3","78307965","78308253","28","47738969"
"chr7","30599714","30599991","chr1","191949331","191949612","58","161349617"
"chr7","30633211","30633494","chr3","78243396","78243678","18","47610185"
"chr7","30637741","30638040","chr3","78238853","78239153","22","47601112"
"chr7","30643474","30643691","chr10","73899940","73900146","53","43256466"
"chr7","30650331","30650639","chr3","78228691","78228999","14","47578360"
"chr7","30656917","30657216","chr3","78221773","78222092","37","47564856"
"chr7","30686321","30686617","chr3","78191352","78191658","35","47505031"
"chr7","30691472","30691758","chr3","78186186","78186502","45","47494714"
"chr7","30737550","30737842","chr3","78136961","78137253","11","47399411"
"chr7","30751988","30752284","chr3","78121711","78122009","22","47369723"
"chr7","30763461","30763577","chr3","78111249","78111366","6","47347788"
"chr7","30783145","30783213","chr3","78091570","78091637","2","47308425"
"chr7","30798169","30798464","chr3","78069462","78069755","33","47271293"
"chr7","30838680","30838953","chr3","78030810","78031080","9","47192130"
"chr7","30850559","30850868","chr3","78024430","78024758","39","47173871"
"chr7","30860297","30860642","chr19","6076181","6076523","85","24784116"
"chr7","30875250","30875553","chr3","78003637","78003946","28","47128387"
"chr7","30903611","30903744","chr3","77974244","77974374","9","47070633"
"chr7","30923340","30923593","chr3","77954451","77954701","36","47031111"
"chr7","30925556","30925866","chr3","77952167","77952492","31","47026611"
"chr7","30969877","30970170","chr3","77913375","77913661","29","46943498"
"chr7","30994080","30994369","chr3","77892303","77892596","17","46898223"
"chr7","31014600","31014902","chr2","97689754","97690052","57","66675154"
"chr7","31025397","31025527","chr19","17747669","17747796","26","13277728"
"chr7","31056241","31056520","chr3","77825831","77826117","21","46769590"
"chr7","31065232","31065440","chr3","77816943","77817151","13","46751711"
"chr7","31081150","31081330","chr3","77800969","77801151","36","46719819"
"chr7","31096450","31096716","chr3","77785321","77785579","40","46688871"
"chr7","31140721","31141005","chr3","77742136","77742413","32","46601415"
"chr7","31173486","31173646","chr3","77713253","77713411","20","46539767"
"chr7","31206327","31206511","chr3","77684034","77684225","14","46477707"
"chr7","31208881","31209150","chr3","77681382","77681676","45","46472501"
"chr7","31242064","31242356","chr3","77651216","77651507","21","46409152"
"chr7","31246471","31246772","chr3","77646786","77647086","21","46400315"
"chr7","31267157","31267469","chr11","114012591","114012896","75","82745434"
"chr7","31284777","31285027","chr3","77606466","77606759","58","46321689"
"chr7","31407413","31407714","chr3","77484102","77484391","26","46076689"
"chr7","31411986","31412230","chr9","15616888","15617136","50","15795098"
"chr7","31469025","31469298","chr3","77423625","77423892","28","45954600"
"chr7","31481529","31481737","chr3","77411224","77411434","21","45929695"
"chr7","31515400","31515700","chr3","77378416","77378719","21","45863016"
"chr7","31557564","31557785","chr6","149321163","149321374","59","117763599"
"chr7","31580719","31581017","chr3","77302254","77302555","27","45721535"
"chr7","31673472","31673766","chr3","77208439","77208745","35","45534967"
"chr7","31689155","31689481","chr3","77192634","77192952","37","45503479"
"chr7","31735548","31735706","chr3","77146479","77146627","18","45410931"
"chr7","31974486","31974788","chr3","5453846","5454145","59","26520640"
"chr7","31975535","31975840","chr3","76906287","76906597","31","44930752"
"chr7","31976819","31977120","chr3","76905023","76905302","40","44928204"
"chr7","32062242","32062472","chr3","76820942","76821178","21","44758700"
"chr7","32094922","32095229","chr3","76790137","76790443","18","44695215"
"chr7","32108468","32108643","chr1","209348544","209348704","43","177240076"
"chr7","32126542","32126854","chr3","76752792","76753087","37","44626250"
"chr7","32248970","32249191","chr3","76628892","76629127","42","44379922"
"chr7","32309318","32309439","chr3","76563748","76563878","19","44254430"
"chr7","32452221","32452512","chr3","76430464","76430760","38","43978243"
"chr7","32463139","32463299","chr13","16178998","16179162","33","16284141"
"chr7","32463325","32463439","chr1","137316785","137316901","21","104853460"
"chr7","32466969","32467257","chr3","76414983","76415278","24","43948014"
"chr7","32597551","32597673","chr13","56575597","56575724","25","23978046"
"chr7","32809590","32809886","chr3","76073947","76074251","25","43264357"
"chr7","32836652","32836978","chr3","76053113","76053442","32","43216461"
"chr7","32969533","32969786","chr3","75919275","75919525","18","42949742"
"chr7","32976492","32976797","chr12","82368766","82369074","60","49392274"
"chr7","33031509","33031809","chr3","75853186","75853485","49","42821677"
"chr7","33053430","33053707","chr3","39159304","39159586","57","6105874"
"chr7","33056628","33056920","chr3","75835786","75836078","28","42779158"
"chr7","33077025","33077333","chr3","75815969","75816269","20","42738944"
"chr7","33084322","33084581","chr3","75808380","75808641","19","42724058"
"chr7","33097698","33097974","chr3","75795073","75795353","21","42697375"
"chr7","33128625","33128851","chr2","45945040","45945260","55","12816415"
"chr7","33155900","33156060","chr5","190406348","190406502","20","157250448"
"chr7","33169392","33169688","chr3","75744687","75744990","33","42575295"
"chr7","33170505","33170620","chr3","75743777","75743892","7","42573272"
"chr7","33178731","33179042","chr3","75735580","75735892","19","42556849"
"chr7","33190356","33190549","chr3","75724014","75724199","19","42533658"
"chr7","33763125","33763414","chr3","75317105","75317392","16","41553980"
"chr7","33803851","33804130","chr2","22347554","22347828","54","11456297"
"chr7","33805799","33805972","chr6","110405580","110405752","43","76599781"
"chr7","33868617","33868780","chr3","75227314","75227481","14","41358697"
"chr7","33893163","33893453","chr3","75196904","75197186","26","41303741"
"chr7","33908121","33908234","chr3","75182151","75182261","11","41274030"
"chr7","33914624","33914697","chr3","75175885","75175958","6","41261261"
"chr7","33944344","33944463","chr3","75146831","75146949","7","41202487"
"chr7","33947228","33947508","chr3","75143694","75143981","41","41196466"
"chr7","33971310","33971600","chrX","66722523","66722806","70","32751213"
"chr7","33978121","33978321","chr3","75107672","75107879","23","41129551"
"chr7","33990981","33991272","chr3","75092935","75093225","23","41101954"
"chr7","33996460","33996750","chr3","75085515","75085821","31","41089055"
"chr7","34003843","34004111","chr3","75078142","75078413","24","41074299"
"chr7","34004427","34004719","chr3","75077543","75077831","22","41073116"
"chr7","34008576","34008757","chr11","50469033","50469219","31","16460457"
"chr7","34022362","34022669","chr3","75059181","75059488","13","41036819"
"chr7","34027513","34027724","chr20","35094996","35095206","42","1067483"
"chr7","34027735","34028018","chr20","42287996","42288283","41","8260261"
"chr7","34041220","34041509","chr3","75039269","75039559","25","40998049"
"chr7","34051265","34051623","chr3","75028651","75028954","74","40977386"
"chr7","34068004","34068303","chr1","186241137","186241432","54","152173133"
"chr7","34068712","34069013","chr3","75011834","75012134","16","40943122"
"chr7","34080111","34080390","chr3","75000997","75001293","34","40920886"
"chr7","34082245","34082405","chr17","29269902","29270063","37","4812343"
"chr7","34091119","34091422","chr3","127591199","127591495","58","93500080"
"chr7","34098809","34099120","chr3","74981624","74981932","24","40882815"
"chr7","34099958","34100152","chr3","74980640","74980834","11","40880682"
"chr7","34101438","34101751","chr3","74979043","74979353","29","40877605"
"chr7","34105561","34105688","chr3","74974711","74974828","18","40869150"
"chr7","34122576","34122895","chr3","74957196","74957493","46","40834620"
"chr7","34130452","34130748","chr17","80429135","80429431","54","46298683"
"chr7","34134196","34134482","chr3","74945806","74946044","59","40811610"
"chr7","34137023","34137167","chr4","44439345","44439491","30","10302322"
"chr7","34223503","34223791","chr3","74861557","74861850","29","40638054"
"chr7","34237985","34238253","chr3","74847129","74847408","22","40609144"
"chr7","34238496","34238789","chr3","74846577","74846881","41","40608081"
"chr7","34277223","34277502","chr3","74800226","74800508","20","40523003"
"chr7","34279480","34279783","chr3","74797872","74798175","25","40518392"
"chr7","34279936","34280221","chr3","74797432","74797719","19","40517496"
"chr7","34325008","34325293","chr3","74747718","74748009","33","40422710"
"chr7","34358179","34358474","chr3","74712206","74712498","43","40354027"
"chr7","34367841","34368149","chr20","28618222","28618522","60","5749619"
"chr7","34421113","34421246","chr3","43002189","43002326","21","8581076"
"chr7","34481994","34482289","chr3","74585620","74585925","23","40103626"
"chr7","34615860","34616154","chr3","74448668","74448968","25","39832808"
"chr7","34657074","34657373","chr3","74407282","74407578","25","39750208"
"chr7","34776157","34776453","chr11","117178442","117178731","56","82402285"
"chr7","34892828","34892959","chr4","42994812","42994941","30","8101984"
"chr7","34915705","34915832","chr7","45689838","45689967","17","10774133"
"chr7","35003199","35003457","chr3","74056876","74057127","27","39053677"
"chr7","35006582","35006871","chr3","74053446","74053735","12","39046864"
"chr7","35028284","35028550","chr3","74030396","74030690","40","39002112"
"chr7","35119558","35119819","chr3","73938723","73938987","22","38819165"
"chr7","35333848","35334149","chr14","63858277","63858583","69","28524429"
"chr7","35408003","35408275","chr4","107354266","107354537","70","71946263"
"chr7","35481265","35481559","chr2","164950526","164950804","69","129469261"
"chr7","35694836","35695154","chr3","73834716","73835027","30","38139880"
"chr7","35697006","35697310","chr3","73832547","73832847","29","38135541"
"chr7","35750617","35750905","chr3","73762744","73763023","32","38012127"
"chr7","35758802","35758910","chr12","123981990","123982098","22","88223188"
"chr7","35797428","35797695","chr3","73716909","73717176","22","37919481"
"chr7","35971718","35972009","chr3","73555894","73556185","16","37584176"
"chr7","35994732","35995041","chr3","73532239","73532551","41","37537507"
"chr7","36025452","36025709","chr4","71025239","71025492","73","34999787"
"chr7","36155620","36155929","chr3","73404138","73404444","29","37248518"
"chr7","36192668","36192973","chr3","73365821","73366123","27","37173153"
"chr7","36307719","36308024","chr3","73240236","73240534","22","36932517"
"chr7","36344973","36345285","chr1","26658212","26658527","66","9686761"
"chr7","36362467","36362767","chr3","127446837","127447136","57","91084370"
"chr7","36367498","36367808","chr3","73181785","73182113","45","36814287"
"chr7","36443901","36444185","chr3","73103677","73103961","15","36659776"
"chr7","36508219","36508523","chr3","73037181","73037495","30","36528962"
"chr7","36541834","36542145","chr3","73009701","73010013","20","36467867"
"chr7","36617593","36617854","chr3","72938081","72938344","22","36320488"
"chr7","36617908","36617933","chr1","169840048","169840072","3","133222140"
"chr7","36618318","36618615","chr2","160551205","160551504","60","123932887"
"chr7","36701465","36701783","chr3","72853695","72853999","28","36152230"
"chr7","36714370","36714625","chr3","72840657","72840932","37","36126287"
"chr7","36761945","36762229","chr3","72793584","72793867","28","36031639"
"chr7","36778630","36778857","chr3","123787783","123788028","40","87009153"
"chr7","36780493","36780813","chr3","123776523","123776844","59","86996030"
"chr7","36781673","36781816","chr3","50473069","50473212","12","13691396"
"chr7","36782122","36782284","chr3","50472595","50472766","19","13690473"
"chr7","36794901","36795020","chr16","50513255","50513373","20","13718354"
"chr7","36798929","36798982","chr1","16167485","16167544","8","20631444"
"chr7","36799274","36799423","chr3","72816818","72816959","15","36017544"
"chr7","36888787","36889087","chr3","72733077","72733377","24","35844290"
"chr7","36894517","36894542","chr9","63164489","63164513","3","26269972"
"chr7","36894578","36894838","chr19","36231106","36231366","53","663472"
"chr7","36901910","36902195","chr11","109188160","109188443","61","72286250"
"chr7","36941476","36941748","chr12","87749598","87749866","49","50808122"
"chr7","36963998","36964299","chr3","72651851","72652152","34","35687853"
"chr7","37019736","37019933","chr3","72593020","72593236","37","35573284"
"chr7","37033247","37033496","chr3","72579526","72579780","27","35546279"
"chr7","37059919","37060229","chr3","72552672","72552980","28","35492753"
"chr7","37138646","37138734","chr3","72469237","72469320","6","35330591"
"chr7","37139027","37139063","chr3","72468912","72468946","4","35329885"
"chr7","37164145","37164438","chrX","16345355","16345638","60","20818790"
"chr7","37180114","37180384","chr1","137772346","137772609","59","100592232"
"chr7","37190313","37190601","chr3","72420490","72420773","47","35230177"
"chr7","37195222","37195334","chr3","72415756","72415869","6","35220534"
"chr7","37204823","37205116","chr3","72405774","72406064","18","35200951"
"chr7","37223478","37223736","chr3","72386338","72386589","28","35162860"
"chr7","37225334","37225458","chr3","72384348","72384463","16","35159014"
"chr7","37225807","37226094","chr3","72383698","72383983","18","35157891"
"chr7","37237247","37237532","chr3","72371295","72371579","17","35134048"
"chr7","37249367","37249671","chr2","84220151","84220461","54","46970784"
"chr7","37283846","37284159","chr3","72324311","72324633","29","35040465"
"chr7","37307062","37307355","chr3","72300617","72300925","44","34993555"
"chr7","37313016","37313266","chr3","72294436","72294687","13","34981420"
"chr7","37329521","37329825","chr3","72278677","72278986","21","34949156"
"chr7","37351676","37351804","chr19","35838181","35838305","22","1513495"
"chr7","37383123","37383391","chr3","36424130","36424381","61","958993"
"chr7","37420244","37420550","chr3","72199527","72199824","36","34779283"
"chr7","37427085","37427418","chr3","72192286","72192656","57","34765201"
"chr7","37444831","37445110","chr3","72174690","72174970","18","34729859"
"chr7","37481630","37481764","chr3","72138231","72138365","9","34656601"
"chr7","37548308","37548601","chr3","72081907","72082204","29","34533599"
"chr7","37553492","37553547","chr3","72077881","72077936","4","34524389"
"chr7","37572414","37572615","chr3","72060549","72060752","21","34488135"
"chr7","37584145","37584446","chr3","72053176","72053477","22","34469031"
"chr7","37622249","37622314","chr1","21899512","21899574","17","15722737"
"chr7","37622347","37622485","chr14","19639556","19639695","34","17982791"
"chr7","37781138","37781409","chr16","21016739","21017008","73","16764399"
"chr7","37805050","37805214","chr3","71820843","71821005","13","34015793"
"chr7","37895329","37895526","chr3","71730348","71730553","18","33835019"
"chr7","37903104","37903410","chr9","115478933","115479238","58","77575829"
"chr7","38066723","38067007","chr3","71574213","71574496","28","33507490"
"chr7","38116767","38117077","chr3","71524571","71524880","11","33407804"
"chr7","38186903","38187197","chr3","71456773","71457067","16","33269870"
"chr7","38249968","38250239","chr3","71392624","71392882","30","33142656"
"chr7","38265675","38265975","chr3","71376033","71376336","24","33110358"
"chr7","38293147","38293441","chr3","71348583","71348871","25","33055436"
"chr7","38331853","38332148","chr3","71308862","71309147","31","32977009"
"chr7","38336044","38336342","chr3","71304663","71304964","17","32968619"
"chr7","38362290","38362601","chr7","45450102","45450409","64","7087812"
"chr7","38365509","38365801","chr3","71274811","71275104","43","32909302"
"chr7","38391371","38391668","chr3","71246353","71246654","27","32854982"
"chr7","38546585","38546875","chr3","71112047","71112327","31","32565462"
"chr7","38547130","38547372","chr3","71111538","71111778","18","32564408"
"chr7","38576308","38576572","chr16","39074593","39074856","53","498285"
"chr7","38579427","38579711","chr3","71082554","71082821","39","32503127"
"chr7","38718310","38718427","chr3","70939510","70939627","3","32221200"
"chr7","38832807","38833119","chr20","50502156","50502463","58","11669349"
"chr7","38838334","38838630","chr3","70763975","70764268","23","31925641"
"chr7","38933305","38933595","chr3","70658151","70658436","34","31724846"
"chr7","38941763","38941910","chr19","39962858","39963005","25","1021095"
"chr7","38950124","38950398","chr3","70641363","70641636","20","31691239"
"chr7","38968696","38968979","chr3","70622558","70622850","37","31653862"
"chr7","38970196","38970497","chr16","18006865","18007167","61","20963331"
"chr7","38981100","38981387","chr3","70610025","70610296","42","31628925"
"chr7","38998406","38998703","chr1","188627840","188628135","69","149629434"
"chr7","39051420","39051673","chr3","70538281","70538566","45","31486861"
"chr7","39073194","39073473","chr3","70517814","70518093","19","31444620"
"chr7","39152649","39152955","chr20","21051195","21051496","67","18101454"
"chr7","39255020","39255316","chr3","70359638","70359929","22","31104618"
"chr7","39259181","39259298","chr14","8294861","8294977","22","30964320"
"chr7","39316487","39316786","chr3","70298773","70299109","52","30982286"
"chr7","39420441","39420697","chr3","70194900","70195151","22","30774459"
"chr7","39443371","39443672","chr3","70172748","70173038","31","30729377"
"chr7","39471399","39471700","chr3","70148308","70148600","31","30676909"
"chr7","39472834","39472963","chr7","16781339","16781468","20","22691495"
"chr7","39522044","39522340","chr3","70097836","70098145","26","30575792"
"chr7","39524611","39524896","chr3","70095275","70095561","22","30570664"
"chr7","39562361","39562483","chr9","28429853","28429977","20","11132508"
"chr7","39623962","39624251","chr3","69984949","69985232","25","30360987"
"chr7","39646708","39646992","chr3","69962391","69962675","18","30315683"
"chr7","39679046","39679346","chr3","69931438","69931754","36","30252392"
"chr7","39758894","39759158","chr3","69853046","69853298","30","30094152"
"chr7","39769537","39769652","chr3","69842449","69842568","12","30072912"
"chr7","39823636","39823784","chr4","154150833","154150979","30","114327197"
"chr7","39823828","39823892","chrUn_NW_014806600v1","312","373","10","39823516"
"chr7","39831922","39832233","chr3","69780350","69780654","32","29948428"
"chr7","39839331","39839514","chr3","69773126","69773310","13","29933795"
"chr7","39897511","39897821","chr3","69724574","69724875","60","29827063"
"chr7","39966957","39967248","chr3","69653830","69654110","29","29686873"
"chr7","40068422","40068730","chr3","69545930","69546228","32","29477508"
"chr7","40097866","40098160","chr3","69515842","69516145","28","29417976"
"chr7","40153538","40153700","chr9","26540592","26540755","32","13612946"
"chr7","40187491","40187787","chr3","69427733","69428028","15","29240242"
"chr7","40237150","40237441","chr19","4819808","4820082","69","35417342"
"chr7","40239393","40239698","chr3","69366061","69366366","22","29126668"
"chr7","40265919","40266229","chr3","69337731","69338045","22","29071812"
"chr7","40374881","40375169","chr3","69211709","69211990","27","28836828"
"chr7","40411810","40412088","chr3","64828586","64828865","27","24416776"
"chr7","40448676","40448972","chr11","45515601","45515900","70","5066925"
"chr7","40458246","40458483","chr3","64877305","64877567","44","24419059"
"chr7","40462688","40462947","chr3","64882869","64883122","20","24420181"
"chr7","40542865","40543152","chr3","64952321","64952596","33","24409456"
"chr7","40545079","40545357","chr3","64954804","64955086","23","24409725"
"chr7","40554363","40554626","chr3","64964759","64965020","12","24410396"
"chr7","40560589","40560867","chr3","64971487","64971760","22","24410898"
"chr7","40605532","40605872","chr7","151723324","151723660","76","111117792"
"chr7","40641207","40641285","chr3","65054244","65054322","6","24413037"
"chr7","40718449","40718748","chr3","65149988","65150281","22","24431539"
"chr7","40739673","40739925","chr3","65171588","65171868","47","24431915"
"chr7","40744815","40744933","chr3","65176757","65176878","10","24431942"
"chr7","40762871","40763156","chr3","65194817","65195117","39","24431946"
"chr7","40788020","40788330","chr5","17075579","17075891","64","23712441"
"chr7","40801869","40802154","chr7","47672853","47673140","57","6870984"
"chr7","40820625","40820851","chr3","65252765","65252984","23","24432140"
"chr7","40823470","40823638","chr3","65255495","65255665","22","24432025"
"chr7","40824273","40824579","chr3","65256302","65256581","45","24432029"
"chr7","40864412","40864723","chr3","65296277","65296593","22","24431865"
"chr7","40893902","40894201","chr3","65330081","65330339","57","24436179"
"chr7","40894528","40894800","chr3","65330667","65330939","18","24436139"
"chr7","40902991","40903178","chr3","65339221","65339399","16","24436230"
"chr7","40947681","40947947","chr3","65386145","65386402","29","24438464"
"chr7","40955737","40956018","chr3","65394193","65394475","20","24438456"
"chr7","40985845","40986149","chr3","65424109","65424403","32","24438264"
"chr7","41013138","41013351","chr3","65463190","65463415","24","24450052"
"chr7","41034231","41034493","chr3","65484520","65484787","26","24450289"
"chr7","41035537","41035792","chr3","65485839","65486112","40","24450302"
"chr7","41057000","41057299","chr3","65506021","65506319","24","24449021"
"chr7","41107532","41107825","chr3","65555934","65556212","34","24448402"
"chr7","41113001","41113284","chr3","65561286","65561570","22","24448285"
"chr7","41222519","41222816","chr3","65667198","65667509","32","24444679"
"chr7","41239850","41239965","chr3","65685104","65685225","15","24445254"
"chr7","41257148","41257266","chr3","65703025","65703155","14","24445877"
"chr7","41282242","41282550","chr3","65735255","65735565","39","24453013"
"chr7","41283705","41283998","chr3","65736388","65736681","15","24452683"
"chr7","41327719","41327997","chr3","65788538","65788819","12","24460819"
"chr7","41349782","41349913","chr3","34439258","34439382","32","6910524"
"chr7","41355172","41355268","chr3","65815651","65815746","7","24460479"
"chr7","41366369","41366671","chr3","65826779","65827081","27","24460410"
"chr7","41396684","41396839","chr5","51008800","51008951","44","9612116"
"chr7","41398588","41398747","chr5","67610623","67610789","40","26212035"
"chr7","41423735","41424044","chr3","65882287","65882605","27","24458552"
"chr7","41432085","41432202","chr3","65890622","65890739","6","24458537"
"chr7","41450659","41450923","chr3","65913477","65913739","24","24462818"
"chr7","41460810","41461101","chr3","65925249","65925534","30","24464439"
"chr7","41551053","41551342","chr3","66015213","66015499","25","24464160"
"chr7","41599916","41600213","chr18","36205933","36206221","72","5393983"
"chr7","41677423","41677646","chr3","66158122","66158342","22","24480699"
"chr7","41751328","41751606","chr3","66234285","66234581","37","24482957"
"chr7","41777071","41777222","chr3","66261121","66261278","15","24484050"
"chr7","41787942","41788144","chr3","66272168","66272370","22","24484226"
"chr7","41853208","41853367","chr12","21323547","21323703","24","20529661"
"chr7","41945830","41946083","chr3","66442086","66442338","18","24496256"
"chr7","41986662","41986933","chr3","66481627","66481903","29","24494965"
"chr7","42009027","42009311","chr3","66506325","66506634","45","24497298"
"chr7","42075154","42075453","chr2","100485244","100485539","51","58410090"
"chr7","42115422","42115733","chr15","7988541","7988851","57","34126881"
"chr7","42182698","42182978","chr3","66688076","66688367","31","24505378"
"chr7","42184467","42184755","chr3","66689842","66690115","27","24505375"
"chr7","42239190","42239400","chr16","31100169","31100379","41","11139021"
"chr7","42270387","42270656","chr13","105368958","105369221","59","63098571"
"chr7","42368641","42368934","chr2","139523227","139523524","59","97154586"
"chr7","42422909","42423135","chr3","66929496","66929736","33","24506587"
"chr7","42437873","42437988","chr3","66947195","66947310","3","24509322"
"chr7","42441329","42441620","chr3","66950987","66951268","37","24509658"
"chr7","42489964","42490238","chr3","66999630","66999904","13","24509666"
"chr7","42490571","42490861","chr3","67000194","67000483","27","24509623"
"chr7","42506868","42507188","chr3","67016653","67016991","44","24509785"
"chr7","42559335","42559636","chr3","67068506","67068807","23","24509171"
"chr7","42637556","42637824","chr3","67148972","67149240","17","24511416"
"chr7","42684369","42684671","chr2","91979788","91980094","59","49295419"
"chr7","42714959","42715216","chr3","67226620","67226875","18","24511661"
"chr7","42787350","42787412","chr3","67299474","67299540","9","24512124"
"chr7","42787706","42787847","chr3","67299841","67299981","16","24512135"
"chr7","42789746","42789865","chr3","67301864","67301983","5","24512118"
"chr7","42799284","42799516","chr3","67311370","67311609","23","24512086"
"chr7","42810490","42810738","chr3","67322381","67322647","38","24511891"
"chr7","42842350","42842467","chr3","67355443","67355560","6","24513093"
"chr7","42842489","42842739","chr4","33679870","33680118","62","9162619"
"chr7","42860977","42861242","chr3","67374139","67374381","33","24513162"
"chr7","42888764","42888856","chrX","17349647","17349738","14","25539117"
"chr7","42940900","42941202","chr3","67461258","67461549","28","24520358"
"chr7","42968399","42968700","chr3","127162429","127162726","58","84194030"
"chr7","43014937","43015176","chr5","58758312","58758541","77","15743375"
"chr7","43022398","43022658","chr3","67546714","67546960","33","24524316"
"chr7","43099365","43099591","chr3","67626410","67626636","11","24527045"
"chr7","43111265","43111547","chr3","67638287","67638574","19","24527022"
"chr7","43208250","43208381","chr3","67735721","67735853","8","24527471"
"chr7","43241006","43241143","chr20","52016692","52016831","21","8775686"
"chr7","43241436","43241609","chr19","28356007","28356185","28","14885429"
"chr7","43243150","43243372","chr3","67779335","67779557","15","24536185"
"chr7","43356096","43356395","chr3","67888274","67888574","36","24532178"
"chr7","43376033","43376352","chr3","67906401","67906715","30","24530368"
"chr7","43389253","43389544","chr3","67918031","67918319","22","24528778"
"chr7","43413249","43413545","chr3","67941905","67942201","24","24528656"
"chr7","43427126","43427396","chr3","67955987","67956256","20","24528861"
"chr7","43442576","43442744","chr3","67975846","67976014","11","24533270"
"chr7","43445950","43446263","chr7","142482349","142482660","66","99036399"
"chr7","43595959","43596084","chr3","68124884","68125009","10","24528925"
"chr7","43626466","43626734","chr1","166806528","166806793","61","123180062"
"chr7","43674678","43674974","chr3","36458013","36458312","49","7216665"
"chr7","43733496","43733805","chr3","68267848","68268158","47","24534352"
"chr7","43777563","43777679","chr3","68308747","68308852","20","24531184"
"chr7","43795098","43795334","chr8","17740891","17741122","69","26054207"
"chr7","43800698","43801004","chr3","68332418","68332710","38","24531720"
"chr7","43803734","43804025","chr3","68335364","68335659","26","24531630"
"chr7","43815780","43816091","chr4","37362088","37362376","82","6453692"
"chr7","43817253","43817353","chr9","57541292","57541384","33","13724039"
"chr7","43840994","43841207","chr18","9688276","9688483","70","34152718"
"chr7","43873188","43873488","chr11","6522521","6522820","57","37350667"
"chr7","43932588","43932892","chr6","177639966","177640254","68","133707378"
"chr7","43958807","43959088","chr3","68500252","68500533","21","24541445"
"chr7","43959503","43959840","chr3","68500991","68501271","78","24541488"
"chr7","43994415","43994703","chr3","68539207","68539510","37","24544792"
"chr7","44003062","44003368","chr3","68547227","68547535","26","24544165"
"chr7","44009691","44009947","chr3","68553038","68553315","40","24543347"
"chr7","44029257","44029542","chr3","68575973","68576255","25","24546716"
"chr7","44032870","44033163","chr3","68579572","68579863","19","24546702"
"chr7","44042549","44042813","chr3","68589575","68589842","20","24547026"
"chr7","44076455","44076762","chr3","68623781","68624085","45","24547326"
"chr7","44088607","44088682","chr3","68640735","68640811","4","24552128"
"chr7","44112016","44112321","chr5","6843994","6844285","63","37268022"
"chr7","44137303","44137583","chr3","68697450","68697734","17","24560147"
"chr7","44155808","44156139","chr3","68715314","68715645","12","24559506"
"chr7","44161344","44161617","chr3","68720836","68721108","17","24559492"
"chr7","44172184","44172490","chr3","68733208","68733489","50","24561024"
"chr7","44174894","44175162","chr3","68740194","68740493","51","24565300"
"chr7","44181178","44181471","chr3","68746841","68747128","18","24565663"
"chr7","44198963","44199077","chr3","68765296","68765410","8","24566333"
"chr7","44242985","44243088","chr3","68806203","68806320","20","24563218"
"chr7","44243130","44243309","chr3","68806347","68806524","16","24563217"
"chr7","44261881","44262158","chr3","68825116","68825423","47","24563235"
"chr7","44317478","44317771","chr3","68873559","68873852","23","24556081"
"chr7","44332777","44333053","chr3","68888409","68888685","13","24555632"
"chr7","44341610","44341901","chr3","68896759","68897031","34","24555149"
"chr7","44348837","44349142","chr1","141677669","141677973","58","97328832"
"chr7","44350474","44350584","chr1","154266423","154266534","19","109915949"
"chr7","44352214","44352469","chr3","68907703","68907961","24","24555489"
"chr7","44359126","44359404","chr3","68914484","68914784","41","24555358"
"chr7","44371170","44371459","chr3","68932427","68932716","34","24561257"
"chr7","44386052","44386197","chr3","68947031","68947178","8","24560979"
"chr7","44386492","44386660","chr3","68947466","68947637","13","24560974"
"chr7","44518277","44518658","chr17","77029668","77030009","118","32511391"
"chr7","44519922","44520205","chr3","68981919","68982203","17","24461997"
"chr7","44525774","44526066","chr3","68987795","68988087","19","24462021"
"chr7","44537327","44537633","chr3","68998555","68998859","22","24461228"
"chr7","44541917","44542183","chr2","196077584","196077849","54","151535667"
"chr7","44549294","44549453","chrX","105928843","105928984","51","61379549"
"chr7","44549758","44549890","chr7","16781339","16781468","25","27768419"
"chr7","44550590","44550832","chr3","69012118","69012401","52","24461528"
"chr7","44571416","44571713","chr3","69032645","69032947","21","24461229"
"chr7","44579075","44579183","chr10","27124670","27124780","27","17454405"
"chr7","44590360","44590669","chr3","69051566","69051869","44","24461206"
"chr7","44595666","44595955","chr3","69056874","69057171","46","24461208"
"chr7","44596285","44596598","chr3","69057502","69057786","49","24461217"
"chr7","44610852","44611156","chr3","69072192","69072485","41","24461340"
"chr7","44612318","44612557","chr3","69073659","69073899","12","24461341"
"chr7","44619004","44619283","chr3","69080759","69081052","39","24461755"
"chr7","44850656","44850702","chr6","37515145","37515194","17","7335511"
"chr7","44850988","44851168","chr3","42357857","42358034","34","2493131"
"chr7","44858484","44858788","chr3","64711541","64711843","20","19853057"
"chr7","44866747","44867047","chr3","64703418","64703709","40","19836671"
"chr7","44872893","44873160","chr3","64697175","64697455","26","19824282"
"chr7","44924438","44924568","chr13","96453125","96453253","27","51528687"
"chr7","44924884","44925024","chr9","115755848","115755993","33","70830964"
"chr7","44949974","44950134","chr3","82067092","82067250","23","37117118"
"chr7","44950465","44950589","chr14","63834899","63835019","28","18884434"
"chr7","45037717","45038019","chr3","64534811","64535101","23","19497094"
"chr7","45085962","45086277","chr1","69847904","69848205","67","24761942"
"chr7","45149483","45149794","chr13","71248269","71248571","50","26098786"
"chr7","45190045","45190348","chr3","64383502","64383805","12","19193457"
"chr7","45209797","45210094","chr3","64364187","64364478","27","19154390"
"chr7","45240057","45240342","chr3","64332962","64333261","49","19092905"
"chr7","45242743","45243040","chr3","64330246","64330544","24","19087503"
"chr7","45259009","45259325","chr3","64314118","64314431","36","19055109"
"chr7","45265946","45266066","chr14","115448600","115448717","23","70182654"
"chr7","45267514","45267686","chr1","207948084","207948245","43","162680570"
"chr7","45291734","45291952","chr19","29525976","29526197","58","15765758"
"chr7","45293740","45293851","chr3","64282047","64282157","5","18988307"
"chr7","45294504","45294780","chr3","64280808","64281085","21","18986304"
"chr7","45311549","45311813","chr3","64255030","64255304","29","18943481"
"chr7","45328869","45329174","chr3","64237746","64238033","29","18908877"
"chr7","45329443","45329723","chr3","64237199","64237476","26","18907756"
"chr7","45329760","45330004","chr3","64236877","64237162","81","18907117"
"chr7","45330017","45330287","chr11","98499507","98499775","32","53169490"
"chr7","45331150","45331313","chr9","10113916","10114073","36","35217234"
"chr7","45332851","45333143","chr19","17994219","17994503","72","27338632"
"chr7","45333557","45333689","chr14","10675636","10675769","14","34657921"
"chr7","45335896","45336021","chr3","64230558","64230682","5","18894662"
"chr7","45358401","45358747","chr2","187692066","187692376","122","142333665"
"chr7","45372179","45372460","chr3","64199068","64199370","30","18826889"
"chr7","45383858","45384159","chr3","64188047","64188347","20","18804189"
"chr7","45384605","45384925","chr3","64187258","64187590","33","18802653"
"chr7","45385721","45385827","chr19","4704757","4704862","17","40680964"
"chr7","45386135","45386320","chr13","37230748","37230927","38","8155387"
"chr7","45386889","45387153","chr2","56485157","56485414","70","11098268"
"chr7","45387205","45387474","chr3","64184407","64184685","28","18797202"
"chr7","45405871","45406174","chr3","64167402","64167699","22","18761531"
"chr7","45416860","45417153","chr10","49449900","49450186","69","4033040"
"chr7","45444177","45444401","chr3","64127216","64127439","15","18683039"
"chr7","45444707","45444968","chr1","19444520","19444782","65","26000187"
"chr7","45467037","45467334","chr1","34759064","34759369","67","10707973"
"chr7","45492751","45493034","chr3","64083444","64083728","26","18590693"
"chr7","45499122","45499377","chr3","64074484","64074740","15","18575362"
"chr7","45517233","45517424","chr5","153377016","153377210","45","107859783"
"chr7","45517719","45517832","chr8","101968472","101968583","25","56450753"
"chr7","45521375","45521653","chr3","64048903","64049190","23","18527528"
"chr7","45524795","45524927","chr3","64044915","64045049","9","18520120"
"chr7","45525236","45525370","chr3","64044461","64044607","19","18519225"
"chr7","45535777","45536083","chr3","64033419","64033737","37","18497642"
"chr7","45553051","45553356","chr3","64015819","64016127","27","18462768"
"chr7","45555617","45555921","chr3","64013272","64013571","17","18457655"
"chr7","45572953","45573201","chr11","25344147","25344400","60","20228806"
"chr7","45575855","45576084","chr3","63993267","63993496","14","18417412"
"chr7","45576400","45576688","chr13","39475662","39475956","70","6100738"
"chr7","45577552","45577847","chr10","72937157","72937431","83","27359605"
"chr7","45583676","45583921","chr3","63984892","63985109","58","18401216"
"chr7","45585750","45585886","chr1","128720611","128720750","32","83134861"
"chr7","45586182","45586328","chr16","39660694","39660850","34","5925488"
"chr7","45586487","45586560","chr3","63982321","63982394","4","18395834"
"chr7","45604180","45604357","chr18","13104442","13104612","45","32499738"
"chr7","45618805","45618924","chr1","11561082","11561198","24","34057723"
"chr7","45620952","45621067","chr20","71250545","71250655","24","25629593"
"chr7","45621384","45621403","chr1","30210224","30210240","8","15411160"
"chr7","45634643","45634936","chr1","43902169","43902461","70","1732474"
"chr7","45644136","45644421","chr3","63917248","63917533","19","18273112"
"chr7","45692127","45692402","chr3","63878741","63879030","36","18186614"
"chr7","45693788","45694011","chr17","19662127","19662346","45","26031661"
"chr7","45699284","45699458","chr1","21576038","21576212","29","24123246"
"chr7","45699478","45699772","chr3","63871008","63871309","19","18171530"
"chr7","45711311","45711321","chr4","47708396","47708406","1","1997085"
"chr7","45711459","45711744","chr10","13786018","13786298","52","31925441"
"chr7","45715284","45715577","chr3","124230038","124230316","59","78514754"
"chr7","45725230","45725529","chr8","96791279","96791575","44","51066049"
"chr7","45725557","45725822","chr3","63843660","63843923","18","18118103"
"chr7","45770856","45771146","chr10","65154571","65154853","65","19383715"
"chr7","45771829","45771987","chr3","63796259","63796421","11","18024430"
"chr7","45772286","45772427","chr3","63795810","63795951","9","18023524"
"chr7","45777188","45777473","chr6","68750302","68750588","45","22973114"
"chr7","45792966","45793234","chr3","63772157","63772426","17","17979191"
"chr7","45801430","45801597","chr14","32139013","32139178","31","13662417"
"chr7","45811085","45811343","chr3","63753533","63753799","24","17942448"
"chr7","45812039","45812190","chr3","63752671","63752822","8","17940632"
"chr7","45823516","45823813","chr3","123699206","123699496","56","77875690"
"chr7","45842172","45842288","chr11","113226186","113226302","15","67384014"
"chr7","45873098","45873289","chr5","7150541","7150724","51","38722557"
"chr7","45919219","45919431","chr17","73253363","73253572","53","27334144"
"chr7","45919463","45919592","chr8","124405124","124405255","20","78485661"
"chr7","45950504","45950787","chr2","109967146","109967434","74","64016642"
"chr7","45998373","45998549","chr4","34350518","34350690","36","11647855"
"chr7","46056284","46056569","chr3","63503622","63503909","22","17447338"
"chr7","46103970","46104273","chr3","63460078","63460384","33","17356108"
"chr7","46164685","46165006","chr3","46869547","46869867","70","704862"
"chr7","46352382","46352688","chr5","148599569","148599859","80","102247187"
"chr7","46395877","46396191","chr3","63180708","63181022","34","16784831"
"chr7","46417702","46418004","chr3","63158755","63159038","42","16741053"
"chr7","46458337","46458646","chr3","63121372","63121669","54","16663035"
"chr7","46621403","46621566","chr3","50472595","50472766","19","3851192"
"chr7","46621873","46622020","chr3","50473069","50473212","16","3851196"
"chr7","46653600","46653908","chr3","63050941","63051232","37","16397341"
"chr7","46678249","46678526","chr3","63024200","63024488","21","16345951"
"chr7","46733658","46733985","chr3","62938776","62939123","52","16205118"
"chr7","46863287","46863589","chr1","188490261","188490555","69","141626974"
"chr7","46878827","46879127","chrX","43540969","43541269","55","3337858"
"chr7","46881537","46881638","chr3","62781891","62781988","12","15900354"
"chr7","46881762","46881946","chr3","62781585","62781767","12","15899823"
"chr7","47035219","47035503","chr3","62626488","62626754","52","15591269"
"chr7","47042388","47042709","chr3","62619260","62619568","51","15576872"
"chr7","47051520","47051825","chr3","62609865","62610168","15","15558345"
"chr7","47065016","47065328","chr3","62594941","62595282","61","15529925"
"chr7","47084472","47084761","chr9","39037044","39037333","71","8047428"
"chr7","47128336","47128454","chr8","101773159","101773279","21","54644823"
"chr7","47280077","47280346","chr3","62366399","62366663","24","15086322"
"chr7","47282972","47283268","chr3","62362664","62362957","23","15079692"
"chr7","47544988","47545303","chr16","58313322","58313631","63","10768334"
"chr7","47595572","47595853","chr3","62047816","62048097","31","14452244"
"chr7","47646892","47647023","chr3","61997801","61997921","20","14350909"
"chr7","47736098","47736387","chr20","40199344","40199643","67","7536754"
"chr7","47744025","47744340","chr3","61896913","61897228","32","14152888"
"chr7","47751251","47751536","chr3","61889664","61889949","28","14138413"
"chr7","47781477","47781644","chr19","4960640","4960806","35","42820837"
"chr7","47781945","47782077","chr1","218607147","218607279","31","170825202"
"chr7","47804145","47804421","chr3","61835490","61835764","18","14031345"
"chr7","47858339","47858589","chr8","38873401","38873636","57","8984938"
"chr7","48050005","48050319","chr3","61602105","61602418","26","13552100"
"chr7","48172257","48172536","chr3","61481663","61481943","20","13309406"
"chr7","48173314","48173619","chr3","61480557","61480881","45","13307243"
"chr7","48197588","48197882","chr15","45551963","45552258","70","2645625"
"chr7","48264375","48264673","chr3","61389593","61389894","24","13125218"
"chr7","48269760","48269892","chr3","61384355","61384478","16","13114595"
"chr7","48279140","48279417","chr3","61376117","61376406","31","13096977"
"chr7","48343480","48343660","chr3","61306347","61306527","12","12962867"
"chr7","48346420","48346692","chr3","61303035","61303313","35","12956615"
"chr7","48347968","48348071","chr16","54005646","54005750","20","5657678"
"chr7","48367779","48368086","chr3","38371574","38371884","64","9996205"
"chr7","48422835","48423133","chr11","121290594","121290887","57","72867759"
"chr7","48679119","48679198","chr3","60877897","60877976","4","12198778"
"chr7","48715478","48715777","chr3","60841216","60841515","21","12125738"
"chr7","48737137","48737424","chr3","60813494","60813773","28","12076357"
"chr7","48737617","48737908","chr3","60813030","60813301","37","12075413"
"chr7","48783964","48784276","chr3","60761086","60761359","67","11977122"
"chr7","48801395","48801578","chr3","60742818","60742996","14","11941423"
"chr7","48803922","48804226","chr3","60739921","60740221","27","11935999"
"chr7","48865372","48865489","chr3","60676898","60677015","12","11811526"
"chr7","48968032","48968148","chr3","60579917","60580033","6","11611885"
"chr7","49007159","49007455","chr3","60538598","60538892","26","11531439"
"chr7","49045003","49045313","chr3","60500093","60500389","32","11455090"
"chr7","49109309","49109531","chr3","60432861","60433077","23","11323552"
"chr7","49321587","49321701","chr3","41881824","41881939","15","7439763"
"chr7","49321737","49321907","chr10","20801654","20801818","42","28520083"
"chr7","49364921","49365205","chr13","72710035","72710323","68","23345114"
"chr7","49518797","49519078","chr3","59978859","59979151","38","10460062"
"chr7","49861501","49861796","chr3","59804010","59804296","33","9942509"
"chr7","49916012","49916325","chr3","59756021","59756311","45","9840009"
"chr7","50097742","50098010","chr3","59578765","59579032","32","9481023"
"chr7","50280696","50280805","chr13","96113902","96114009","19","45833206"
"chr7","50283101","50283295","chr20","28451788","28451985","45","21831313"
"chr7","50505331","50505618","chr3","59093492","59093784","26","8588161"
"chr7","50574928","50575220","chr9","87894591","87894876","54","37319663"
"chr7","50625803","50626024","chr3","58976491","58976704","17","8350688"
"chr7","50659051","50659376","chr3","58931042","58931338","67","8271991"
"chr7","50798436","50798751","chr3","58782681","58783002","22","7984245"
"chr7","50813171","50813239","chr11","32817966","32818024","19","17995205"
"chr7","50995206","50995423","chr16","25942172","25942394","35","25053034"
"chr7","51189136","51189461","chr3","58394141","58394476","25","7205005"
"chr7","51323316","51323632","chr3","58245266","58245574","27","6921950"
"chr7","51585514","51585801","chr3","57993941","57994229","21","6408427"
"chr7","51643176","51643485","chr5","173220228","173220531","59","121577052"
"chr7","51777309","51777635","chr3","57790868","57791166","51","6013559"
"chr7","51803225","51803521","chr3","57770530","57770829","33","5967305"
"chr7","51899661","51899966","chr3","57674481","57674804","40","5774820"
"chr7","51920691","51920982","chr3","57653351","57653642","16","5732660"
"chr7","51971872","51972172","chr3","57601619","57601915","27","5629747"
"chr7","52210557","52210705","chr3","57361914","57362063","22","5151357"
"chr7","52211433","52211568","chr3","57361056","57361189","12","5149623"
"chr7","52211898","52211956","chr3","57360671","57360730","3","5148773"
"chr7","52214978","52215297","chr3","57357015","57357301","50","5142037"
"chr7","52270309","52270616","chr3","50370743","50371048","37","1899566"
"chr7","52540387","52540577","chr3","57211438","57211634","20","4671051"
"chr7","52692490","52692804","chr3","57056115","57056429","26","4363625"
"chr7","52716082","52716363","chr3","103442357","103442638","56","50726275"
"chr7","52899635","52899766","chr3","55096645","55096777","26","2197010"
"chr7","52953246","52953573","chr3","56801625","56801902","66","3848379"
"chr7","52989131","52989220","chr11","49586469","49586557","10","3402662"
"chr7","53035989","53036274","chr1","52562383","52562678","72","473606"
"chr7","53104406","53104707","chr3","56552730","56553031","26","3448324"
"chr7","53374474","53374603","chr3","56277020","56277150","10","2902546"
"chr7","53586653","53586955","chr3","56060137","56060442","22","2473484"
"chr7","53637169","53637477","chr3","56004996","56005295","55","2367827"
"chr7","53662504","53662808","chr3","55978298","55978603","26","2315794"
"chr7","53675428","53675541","chr3","55966323","55966436","6","2290895"
"chr7","53809617","53809919","chr3","55833086","55833428","62","2023469"
"chr7","53921541","53921857","chr3","52168065","52168361","45","1753476"
"chr7","53934020","53934303","chr3","52179746","52180030","20","1754274"
"chr7","54088938","54089218","chr3","52345064","52345346","26","1743874"
"chr7","54213170","54213266","chr6","169656271","169656367","17","115443101"
"chr7","54258013","54258323","chr3","52517761","52518039","63","1740252"
"chr7","54403881","54404002","chr3","57790746","57790867","28","3386865"
"chr7","54457010","54457306","chr3","52756071","52756367","18","1700939"
"chr7","54525442","54525749","chr3","52826249","52826549","26","1699193"
"chr7","54555768","54556051","chr3","52857900","52858176","35","1697868"
"chr7","54594696","54594886","chr2","172034538","172034727","50","117439842"
"chr7","54620747","54621032","chr3","52982119","52982400","27","1638628"
"chr7","54729122","54729296","chr3","53088994","53089166","7","1640128"
"chr7","54879252","54879546","chr9","17890586","17890873","59","36988666"
"chr7","54894894","54895196","chr3","53276781","53277083","20","1618113"
"chr7","54929463","54929714","chr3","53303342","53303592","19","1626121"
"chr7","55235478","55235760","chr3","53604090","53604371","19","1631388"
"chr7","55341310","55341590","chr3","53703040","53703330","27","1638270"
"chr7","55496693","55496924","chr3","53888452","53888681","19","1608241"
"chr7","55558288","55558528","chr17","8036913","8037142","58","47521375"
"chr7","55558831","55558919","chr2","148733834","148733921","14","93175003"
"chr7","55597271","55597539","chr3","53987760","53988035","35","1609511"
"chr7","55655872","55656155","chr3","54047148","54047433","17","1608724"
"chr7","55674115","55674416","chrX","113149918","113150210","70","57475803"
"chr7","55712772","55712851","chr20","21906148","21906214","22","33806624"
"chr7","55727137","55727418","chr3","54115117","54115395","19","1612020"
"chr7","55790495","55790756","chr3","54183060","54183342","38","1607435"
"chr7","55805674","55805938","chr3","54200078","54200342","23","1605596"
"chr7","55919018","55919304","chr3","54316226","54316509","22","1602792"
"chr7","56020017","56020260","chr3","54419249","54419492","6","1600768"
"chr7","56082692","56082975","chr3","54481480","54481765","12","1601212"
"chr7","56137176","56137464","chr8","139927709","139928008","63","83790533"
"chr7","56155853","56156001","chr3","54552193","54552341","7","1603660"
"chr7","56276438","56276725","chr3","54682890","54683189","37","1593548"
"chr7","56297094","56297382","chr3","54703476","54703764","11","1593618"
"chr7","56318095","56318397","chr3","54723064","54723345","41","1595031"
"chr7","56396090","56396179","chr3","54804926","54805019","11","1591164"
"chr7","56409654","56409956","chr3","54823733","54824036","19","1585921"
"chr7","56410253","56410441","chr3","54824310","54824497","14","1585943"
"chr7","56494979","56495088","chr3","54898318","54898427","10","1596661"
"chr7","56515688","56515976","chr3","54927888","54928178","24","1587800"
"chr7","56533590","56533713","chr3","54948224","54948347","7","1585366"
"chr7","56697197","56697373","chr9","60473538","60473710","30","3776341"
"chr7","56697665","56697695","chr3","126170007","126170033","9","69472342"
"chr7","56697986","56698112","chr7","111606608","111606736","9","54908622"
"chr7","56698998","56699293","chr4","7111325","7111614","60","49587673"
"chr7","56702120","56702418","chr16","6571800","6572090","57","50130320"
"chr7","56704191","56704434","chr3","50352763","50352982","39","6351428"
"chr7","56706116","56706422","chr3","49792493","49792793","26","6913623"
"chr7","56711556","56711864","chr3","49787832","49788139","31","6923724"
"chr7","56712091","56712200","chr20","9068455","9068561","29","47643636"
"chr7","56712448","56712745","chr3","55092716","55093013","21","1619732"
"chr7","56713740","56714029","chr3","50362907","50363196","12","6350833"
"chr7","56715059","56715347","chr3","50363686","50363977","21","6351373"
"chr7","56715733","56715858","chr3","50364377","50364489","17","6351356"
"chr7","56717348","56717644","chr3","55095000","55095280","33","1622348"
"chr7","56717884","56717975","chr4","21863828","21863923","24","34854056"
"chr7","56718339","56718469","chr3","49780368","49780500","21","6937971"
"chr7","56720942","56721066","chr3","55099098","55099220","14","1621844"
"chr7","56722586","56722890","chr3","50370743","50371048","20","6351843"
"chr7","56723819","56724122","chr3","50372006","50372295","35","6351813"
"chr7","56724377","56724486","chr2","169096495","169096603","15","112372118"
"chr7","56726769","56727065","chr3","55106308","55106604","42","1620461"
"chr7","56729861","56730157","chr3","50378361","50378657","25","6351500"
"chr7","56732658","56732958","chr3","50381564","50381870","27","6351094"
"chr7","56734593","56734865","chr3","49773302","49773577","21","6961291"
"chr7","56738615","56738909","chr3","50386442","50386734","26","6352173"
"chr7","56741550","56741784","chr20","41332824","41333057","47","15408726"
"chr7","56743868","56744176","chr3","50391581","50391890","27","6352287"
"chr7","56771527","56771720","chr7","153622086","153622284","56","96850559"
"chr7","56772489","56772545","chr5","73307081","73307136","18","16534592"
"chr7","56774189","56774511","chr3","50686372","50686684","42","6087817"
"chr7","56780140","56780248","chr1","212741019","212741130","18","155960879"
"chr7","56797430","56797735","chr1","42013299","42013590","60","14784131"
"chr7","56800004","56800286","chr3","55442160","55442439","18","1357844"
"chr7","56801888","56802107","chr7","3786693","3786911","41","53015195"
"chr7","56805595","56805698","chr14","67564557","67564658","27","10758962"
"chr7","56870731","56871037","chr3","185287384","185287687","63","128416653"
"chr7","56872257","56872557","chr3","55268080","55268368","23","1604177"
"chr7","56909777","56910053","chr3","55299063","55299339","13","1610714"
"chr7","56912514","56912794","chr3","55301789","55302082","35","1610725"
"chr7","56913909","56914218","chr3","55310692","55310977","45","1603217"
"chr7","56918436","56918721","chr3","55312862","55313150","27","1605574"
"chr7","56964115","56964396","chr3","55350609","55350893","28","1613506"
"chr7","57000665","57000975","chr10","32154454","32154755","70","24846211"
"chr7","57004455","57004618","chr3","55394866","55395031","18","1609589"
"chr7","57004916","57005056","chr3","55395331","55395463","16","1609585"
"chr7","57008445","57008657","chr7","92447396","92447604","47","35438951"
"chr7","57013603","57013911","chr3","55404409","55404708","36","1609194"
"chr7","57022281","57022576","chr3","55414150","55414460","36","1608131"
"chr7","57038338","57038637","chr1","93484103","93484405","67","36445765"
"chr7","57039017","57039259","chr1","189368444","189368679","55","132329427"
"chr7","57042758","57043024","chr3","55442160","55442439","30","1600598"
"chr7","57044107","57044400","chr3","55438797","55439100","24","1605310"
"chr7","57053942","57054200","chr1","77866439","77866698","71","20812497"
"chr7","57057654","57057908","chr7","49378464","49378703","55","7679190"
"chr7","57058817","57059113","chr3","55187824","55188134","24","1870993"
"chr7","57059778","57059945","chr3","55187260","55187443","27","1872518"
"chr7","57060019","57060326","chr3","55186894","55187186","35","1873125"
"chr7","57063445","57063743","chr3","55146884","55147194","60","1916561"
"chr7","57063908","57064206","chr3","55183078","55183376","24","1880830"
"chr7","57073223","57073524","chr3","126627788","126628074","66","69554565"
"chr7","57077795","57078093","chr3","55166311","55166604","48","1911484"
"chr7","57080317","57080578","chr3","55163458","55163704","34","1916859"
"chr7","57081503","57081604","chr3","55162427","55162527","8","1919076"
"chr7","57109547","57109853","chrX","133624148","133624458","55","76514601"
"chr7","57110626","57110917","chr3","55558270","55558561","25","1552356"
"chr7","57114551","57114820","chr3","55561793","55562083","40","1552758"
"chr7","57115904","57116198","chr3","55563463","55563766","28","1552441"
"chr7","57123004","57123154","chr1","77911239","77911385","30","20788235"
"chr7","57124444","57124556","chr3","55571720","55571831","11","1552724"
"chr7","57125315","57125448","chr3","55572594","55572732","15","1552721"
"chr7","57125721","57125849","chr3","55572998","55573128","8","1552723"
"chr7","57129287","57129546","chr14","3459439","3459711","55","53669848"
"chr7","57134913","57135096","chr3","55581899","55582081","15","1553014"
"chr7","57140634","57140935","chr3","55587908","55588211","23","1552726"
"chr7","57151154","57151354","chr3","55598985","55599185","22","1552169"
"chr7","57163700","57163935","chr20","41332824","41333057","44","15830876"
"chr7","57187821","57188109","chr3","46969343","46969642","34","10218478"
"chr7","57189829","57189963","chr3","47682607","47682736","24","9507222"
"chr7","57192399","57192605","chr5","1284661","1284867","48","55907738"
"chr7","57199256","57199542","chr3","55612606","55612893","17","1586650"
"chr7","57205262","57205579","chr3","55618516","55618815","33","1586746"
"chr7","57218898","57219181","chr3","55643422","55643711","27","1575476"
"chr7","57232499","57232787","chr3","47042540","47042839","37","10189959"
"chr7","57238919","57239224","chr3","47047331","47047622","55","10191588"
"chr7","57248699","57249003","chr3","47055551","47055853","32","10193148"
"chr7","57252948","57253245","chr3","47059732","47060028","41","10193216"
"chr7","57256353","57256645","chr3","47063253","47063538","45","10193100"
"chr7","57258634","57258809","chr3","47065508","47065682","17","10193126"
"chr7","57259101","57259228","chr3","47065972","47066100","17","10193129"
"chr7","57265415","57265705","chr7","47672853","47673140","59","9592562"
"chr7","57267969","57268244","chr9","7035874","7036152","63","50232095"
"chr7","57270209","57270507","chr1","121643407","121643710","59","64373198"
"chr7","57271694","57272013","chr19","43210585","43210888","70","14061109"
"chr7","57274061","57274281","chr19","33928910","33929130","40","23345151"
"chr7","57274716","57274947","chr3","123807829","123808054","38","66533113"
"chr7","57285182","57285472","chr3","48036640","48036934","42","9248542"
"chr7","57286812","57287107","chr3","48034684","48034975","39","9252128"
"chr7","57292261","57292559","chr8","96648963","96649265","88","39356702"
"chr7","57300257","57300568","chr5","41007202","41007507","74","16293055"
"chr7","58787925","58788214","chr3","50523105","50523393","21","8264820"
"chr7","58788432","58788729","chr3","50522584","50522888","54","8265848"
"chr7","59587062","59587315","chr19","22403290","22403539","40","37183772"
"chr7","59662153","59662454","chr19","22265899","22266202","33","37396254"
"chr7","62883537","62883829","chr3","50561281","50561568","32","12322256"
"chr7","62923705","62923829","chr6","74132606","74132729","29","11208901"
"chr7","62934333","62934613","chr3","50595636","50595909","36","12338697"
"chr7","62963941","62964067","chr17","8231938","8232067","21","54732003"
"chr7","62979203","62979491","chr7","137856198","137856481","57","74876995"
"chr7","62984031","62984249","chr10","14031404","14031631","27","48952627"
"chr7","62998436","62998728","chr3","51003001","51003298","31","11995435"
"chr7","63003544","63003837","chr10","14010287","14010575","36","48993257"
"chr7","63003862","63004164","chr10","14009961","14010254","32","48993901"
"chr7","63014955","63015240","chrX","30018316","30018603","61","32996639"
"chr7","63055961","63056203","chr1","139930623","139930867","59","76874662"
"chr7","63073814","63074157","chr3","48336474","48336789","52","14737340"
"chr7","63110190","63110467","chr10","16684728","16685027","49","46425462"
"chr7","63150743","63150972","chr10","65626533","65626754","42","2475790"
"chr7","63168061","63168191","chr6","17252977","17253107","21","45915084"
"chr7","63169217","63169353","chr10","66312076","66312240","43","3142859"
"chr7","63169643","63169759","chr10","69288267","69288382","27","6118624"
"chr7","63519541","63519813","chr1","10904976","10905255","64","52614565"
"chr7","63524647","63524946","chr16","72756834","72757132","51","9232187"
"chr7","63583525","63583651","chr6","174854302","174854430","28","111270777"
"chr7","63629258","63629388","chr6","46500507","46500636","22","17128751"
"chr7","63635214","63635534","chr17","34461790","34462112","23","29173424"
"chr7","63649493","63649611","chr3","52023446","52023561","26","11626047"
"chr7","63716817","63717078","chr3","52057518","52057772","36","11659299"
"chr7","63749172","63749282","chr3","52023446","52023561","15","11725726"
"chr7","63765942","63766257","chr10","65687300","65687612","25","1921358"
"chr7","63766264","63766567","chr10","65686991","65687295","34","1920727"
"chr7","63770152","63770324","chr3","55667146","55667326","28","8103006"
"chr7","63775558","63775737","chr10","66312076","66312240","36","2536518"
"chr7","63776058","63776177","chr10","66312534","66312657","21","2536476"
"chr7","63778079","63778353","chr3","55671087","55671352","19","8106992"
"chr7","63792079","63792365","chr3","50160004","50160296","56","13632075"
"chr7","63794107","63794389","chr12","114130342","114130631","59","50336235"
"chr7","63795648","63795937","chr3","50156881","50157167","42","13638767"
"chr7","63796818","63796931","chrX","40491044","40491160","16","23305774"
"chr7","63799288","63799573","chr3","50188245","50188526","57","13611043"
"chr7","63799632","63799748","chr16","72571018","72571135","15","8771386"
"chr7","63815132","63815370","chr3","48388161","48388394","22","15426971"
"chr7","63817347","63817640","chr3","48386435","48386725","44","15430912"
"chr7","63854054","63854322","chr3","50595636","50595909","28","13258418"
"chr7","63891818","63892112","chr3","50561281","50561568","36","13330537"
"chr7","63936322","63936611","chr3","50561281","50561568","31","13375041"
"chr7","63983172","63983437","chr3","52057518","52057772","26","11925654"
"chr7","64011907","64012015","chr3","52023446","52023561","14","11988461"
"chr7","64107824","64108134","chr3","51926083","51926375","29","12181741"
"chr7","64191834","64191959","chr12","14732091","14732215","17","49459743"
"chr7","64201344","64201626","chr3","51815686","51815966","20","12385658"
"chr7","64206016","64206123","chr3","51047078","51047192","21","13158938"
"chr7","64364695","64364949","chr3","51643976","51644221","18","12720719"
"chr7","64515929","64516219","chr3","51358697","51358982","42","13157232"
"chr7","64518772","64519059","chr3","51355932","51356212","29","13162840"
"chr7","64608157","64608302","chr3","50473069","50473212","26","14135088"
"chr7","64608585","64608746","chr3","50472595","50472766","23","14135990"
"chr7","64611085","64611359","chr3","55142225","55142506","29","9468860"
"chr7","64616765","64617061","chr11","105627947","105628240","63","41011182"
"chr7","64618322","64618437","chr3","50347916","50348033","11","14270406"
"chr7","64619878","64620080","chr16","23905346","23905542","49","40714532"
"chr7","64628906","64629118","chr3","50333021","50333233","13","14295885"
"chr7","64632149","64632439","chr3","50324704","50325005","29","14307445"
"chr7","64641974","64642289","chr3","50315476","50315794","22","14326498"
"chr7","64671301","64671535","chr3","50287796","50288029","20","14383505"
"chr7","64678648","64678941","chr3","50278622","50278895","38","14400026"
"chr7","64679258","64679559","chr3","50278027","50278303","45","14401231"
"chr7","64685821","64685988","chr11","113432876","113433042","35","48747055"
"chr7","64686291","64686405","chr16","46274531","46274645","23","18411760"
"chr7","64698133","64698257","chr3","50262642","50262767","5","14435491"
"chr7","64701423","64701747","chr3","50258790","50259125","44","14442633"
"chr7","64704063","64704360","chr3","50256280","50256572","24","14447783"
"chr7","64727498","64727782","chr3","50156881","50157167","36","14570617"
"chr7","64729970","64730264","chr3","50158701","50158987","32","14571269"
"chr7","64730950","64731240","chr3","50160004","50160296","29","14570946"
"chr7","64731246","64731371","chr7","92846413","92846536","23","28115167"
"chr7","64731622","64731905","chr3","50213657","50213931","31","14517965"
"chr7","64739367","64739611","chr19","7046635","7046876","55","57692732"
"chr7","64741526","64741795","chr3","50225290","50225551","26","14516236"
"chr7","64743829","64743932","chr19","27160563","27160671","20","37583266"
"chr7","64744253","64744427","chr10","66312076","66312240","32","1567823"
"chr7","64748426","64748585","chr3","50180249","50180397","19","14568177"
"chr7","64748884","64748915","chr3","50180688","50180719","1","14568196"
"chr7","64750693","64750807","chr3","50182533","50182654","22","14568160"
"chr7","64755503","64755773","chr4","5085405","5085685","57","59670098"
"chr7","64763257","64763306","chr5","141212210","141212261","6","76448953"
"chr7","64956553","64956841","chr3","51169528","51169806","30","13787025"
"chr7","64961428","64961719","chr3","51164974","51165277","36","13796454"
"chr7","64967175","64967295","chr1","23338581","23338704","29","41628594"
"chr7","64967612","64967779","chr3","51153429","51153593","11","13814183"
"chr7","64969181","64969462","chr3","51151462","51151743","19","13817719"
"chr7","65022556","65022832","chr3","51098459","51098735","17","13924097"
"chr7","65082702","65082816","chr3","51047078","51047192","9","14035624"
"chr7","65086660","65086914","chr3","51042677","51042931","9","14043983"
"chr7","65088253","65088372","chr3","51041211","51041331","6","14047042"
"chr7","65121416","65121724","chr6","70441047","70441347","51","5319631"
"chr7","65136086","65136215","chr3","50262642","50262767","18","14873444"
"chr7","65239828","65240086","chr16","21456395","21456661","53","43783433"
"chr7","65257876","65258123","chr16","21456395","21456661","58","43801481"
"chr7","65271336","65271622","chr3","49773302","49773577","28","15498034"
"chr7","65496086","65496361","chr3","52345064","52345346","42","13151022"
"chr7","65915200","65915476","chr3","52345064","52345346","32","13570136"
"chr7","68990182","68990454","chr16","21456395","21456661","36","47533787"
"chr7","73083788","73083903","chr1","92690108","92690223","15","19606320"
"chr7","73108320","73108615","chr3","50118575","50118859","31","22989745"
"chr7","73110487","73110610","chr3","50115979","50116103","9","22994508"
"chr7","73110953","73111204","chr3","50115388","50115636","28","22995565"
"chr7","73142057","73142322","chr3","50086619","50086881","25","23055438"
"chr7","73148837","73149008","chr3","50076898","50077053","24","23071939"
"chr7","73149291","73149429","chr17","54442955","54443088","24","18706336"
"chr7","73149866","73149977","chr6","139383516","139383625","20","66233650"
"chr7","73150273","73150482","chr3","43437358","43437567","40","29712915"
"chr7","73154570","73154856","chr1","211215809","211216098","48","138061239"
"chr7","73155552","73155861","chr3","50068989","50069281","43","23086563"
"chr7","73157337","73157625","chr3","50067197","50067476","32","23090140"
"chr7","73179121","73179369","chr3","50115388","50115636","32","23063733"
"chr7","73182565","73182863","chr3","50052523","50052823","35","23130042"
"chr7","73204495","73204626","chr3","50031584","50031713","12","23172911"
"chr7","73208804","73209078","chr3","50027170","50027444","15","23181634"
"chr7","73210778","73211058","chr3","50024945","50025225","15","23185833"
"chr7","73214042","73214334","chr3","50021842","50022136","40","23192200"
"chr7","73232343","73232460","chr4","37995962","37996079","18","35236381"
"chr7","73235057","73235208","chr3","49998455","49998606","10","23236602"
"chr7","73235478","73235579","chr20","21137165","21137268","13","52098313"
"chr7","73237582","73237887","chr14","29928047","29928354","53","43309535"
"chr7","73238428","73238729","chr15","6469011","6469317","54","66769417"
"chr7","73247797","73248099","chr3","49991114","49991409","37","23256683"
"chr7","73249645","73249771","chr3","49989265","49989386","12","23260380"
"chr7","73250066","73250251","chr3","49988768","49988958","28","23261298"
"chr7","73252649","73252940","chr3","49985709","49986000","22","23266940"
"chr7","73264654","73264860","chr19","39028175","39028394","47","34236479"
"chr7","73268226","73268433","chr10","36731418","36731622","44","36536808"
"chr7","73276340","73276471","chr3","49949304","49949435","4","23327036"
"chr7","73277187","73277471","chr3","49948301","49948581","14","23328886"
"chr7","73289569","73289883","chr3","49937718","49938031","28","23351851"
"chr7","73312732","73313035","chr3","49916205","49916514","30","23396527"
"chr7","73364764","73365063","chr3","49861741","49862039","20","23503023"
"chr7","73403812","73403938","chr4","142259591","142259717","24","68855779"
"chr7","73423327","73423450","chr10","30386760","30386884","17","43036567"
"chr7","73425156","73425417","chr3","49801329","49801591","25","23623827"
"chr7","73426950","73427247","chr9","99101491","99101790","65","25674541"
"chr7","73432344","73432589","chr3","49794439","49794656","41","23637905"
"chr7","73434245","73434531","chr3","49792493","49792793","38","23641752"
"chr7","73438925","73439197","chr3","49787832","49788139","51","23651093"
"chr7","73440079","73440374","chr3","55092716","55093013","26","18347363"
"chr7","73441786","73442080","chr3","50362907","50363196","24","23078879"
"chr7","73443392","73443655","chr3","50363686","50363977","54","23079706"
"chr7","73443715","73443830","chr13","92229940","92230056","18","18786225"
"chr7","73444541","73444718","chr3","49781546","49781724","26","23662995"
"chr7","73445022","73445154","chr3","49781106","49781239","9","23663916"
"chr7","73445780","73445911","chr3","49780368","49780500","12","23665412"
"chr7","73447491","73447781","chr3","49778017","49778315","21","23669474"
"chr7","73450751","73450982","chr3","49774772","49775006","22","23675979"
"chr7","73452169","73452457","chr3","49773302","49773577","34","23678867"
"chr7","73453240","73453526","chr3","49387733","49388033","37","24065507"
"chr7","73453961","73454164","chr3","49771627","49771808","35","23682334"
"chr7","73454471","73454604","chr3","49771183","49771317","6","23683288"
"chr7","73457775","73458083","chr3","49767688","49768001","35","23690087"
"chr7","73460172","73460460","chr3","49765344","49765653","39","23694828"
"chr7","73467843","73467914","chr3","49408957","49409026","8","24058886"
"chr7","73473924","73474015","chr3","49439309","49439403","12","24034615"
"chr7","73474310","73474514","chr19","2255131","2255338","48","71219179"
"chr7","73476792","73477091","chr3","49447461","49447769","49","24029331"
"chr7","73509650","73509935","chr3","49604121","49604397","52","23905529"
"chr7","73518970","73519087","chr3","49485835","49485952","9","24033135"
"chr7","73524104","73524423","chr12","89412367","89412671","63","15888263"
"chr7","73547250","73547322","chr3","49408957","49409026","8","24138293"
"chr7","73562435","73562741","chr14","9493908","9494210","58","64068527"
"chr7","73566287","73566392","chr13","27686278","27686385","19","45880009"
"chr7","73573467","73573579","chr3","49730715","49730826","13","23842752"
"chr7","73575979","73576286","chr3","42479001","42479304","29","31096978"
"chr7","73582048","73582339","chr3","42484931","42485236","32","31097117"
"chr7","73585369","73585658","chr3","42488879","42489173","27","31096490"
"chr7","73586976","73587291","chr16","40135755","40136058","81","33451221"
"chr7","73587304","73587375","chr6","68703734","68703802","16","4883570"
"chr7","73596421","73596707","chr8","129433118","129433406","58","55836697"
"chr7","73598590","73598870","chr3","42508435","42508730","42","31090155"
"chr7","73602928","73603086","chr10","63504110","63504264","27","10098818"
"chr7","73605548","73605697","chr3","42515980","42516127","8","31089568"
"chr7","73606295","73606340","chr10","36717798","36717840","8","36888497"
"chr7","73640383","73640500","chr3","49485835","49485952","7","24154548"
"chr7","73644855","73645025","chr3","49491582","49491757","22","24153273"
"chr7","73645308","73645426","chr3","49492029","49492149","12","24153279"
"chr7","73648382","73648678","chr3","49503886","49504177","34","24144496"
"chr7","73649141","73649265","chr5","58864037","58864164","27","14785104"
"chr7","73653941","73654128","chr3","49581521","49581690","31","24072420"
"chr7","73654421","73654558","chr3","49580793","49580914","23","24073628"
"chr7","73656562","73656851","chr3","55206198","55206484","33","18450364"
"chr7","73664251","73664549","chr3","50345008","50345306","12","23319243"
"chr7","73670821","73670995","chr5","165397239","165397411","41","91726418"
"chr7","73672544","73672820","chr3","49569130","49569380","52","24103414"
"chr7","73673743","73673981","chr13","27034311","27034546","54","46639432"
"chr7","73674954","73675029","chr4","45293405","45293476","21","28381549"
"chr7","73675785","73676085","chr3","49567123","49567439","34","24108662"
"chr7","73682361","73682488","chr3","49560525","49560646","11","24121836"
"chr7","73682785","73682957","chr3","49560064","49560235","21","24122721"
"chr7","73684258","73684366","chr3","49558568","49558677","8","24125690"
"chr7","73684686","73684992","chr3","49557953","49558247","35","24126733"
"chr7","73685003","73685130","chr3","49557806","49557933","4","24127197"
"chr7","73688919","73689014","chr3","49554190","49554285","8","24134729"
"chr7","73702022","73702336","chr3","49540270","49540584","14","24161752"
"chr7","73708161","73708314","chr10","70545751","70545894","42","3162410"
"chr7","73708629","73708728","chr9","3779458","3779553","23","69929171"
"chr7","73710405","73710704","chr3","49503886","49504177","33","24206519"
"chr7","73712456","73712580","chr13","25546692","25546816","13","48165764"
"chr7","73719097","73719413","chr1","101094660","101094976","59","27375563"
"chr7","73731030","73731307","chr3","43543324","43543608","38","30187706"
"chr7","73736164","73736444","chr16","56720965","56721247","56","17015199"
"chr7","73744048","73744279","chr3","43505458","43505713","39","30238590"
"chr7","73746421","73746698","chr15","46265389","46265656","49","27481032"
"chr7","73750596","73750896","chr3","43499421","43499721","38","30251175"
"chr7","73754779","73754961","chr13","47508388","47508574","37","26246391"
"chr7","73761813","73762108","chr3","43481889","43482207","42","30279924"
"chr7","73766590","73766877","chr3","43471604","43471900","42","30294986"
"chr7","73771830","73771920","chr3","49554190","49554285","17","24217640"
"chr7","73774679","73774934","chr3","49506525","49506762","33","24268154"
"chr7","73777366","73777657","chr3","49503886","49504177","26","24273480"
"chr7","73778351","73778501","chr1","159768051","159768190","43","85989700"
"chr7","73778797","73778927","chr1","14222547","14222679","26","59556250"
"chr7","73789221","73789339","chr3","49492029","49492149","12","24297192"
"chr7","73789645","73789816","chr3","49491582","49491757","14","24298063"
"chr7","73795115","73795232","chr3","49593803","49593918","11","24201312"
"chr7","73804790","73805093","chr10","33736833","33737139","52","40067957"
"chr7","73844761","73845039","chr3","49649572","49649863","35","24195189"
"chr7","73850934","73851231","chr3","49440853","49441143","42","24410081"
"chr7","73851534","73851767","chr3","49439719","49439961","38","24411815"
"chr7","73852074","73852165","chr3","49439309","49439403","12","24412765"
"chr7","73854158","73854270","chr3","49730715","49730826","10","24123443"
"chr7","73858111","73858399","chr3","42469043","42469342","26","31389068"
"chr7","73862276","73862572","chr3","49423821","49424130","34","24438455"
"chr7","73865594","73865709","chr3","101090196","101090312","17","27224602"
"chr7","73871281","73871386","chr13","27686278","27686385","19","46185003"
"chr7","73893408","73893631","chr18","24650027","24650248","44","49243381"
"chr7","73919254","73919375","chr3","49771183","49771317","22","24148071"
"chr7","73919685","73919872","chr3","49771627","49771808","29","24148058"
"chr7","73920307","73920610","chr3","49387733","49388033","24","24532574"
"chr7","73921512","73921794","chr3","49773302","49773577","36","24148210"
"chr7","73923028","73923140","chr3","55114447","55114555","13","18808581"
"chr7","73923667","73923967","chr3","49384427","49384728","21","24539240"
"chr7","73927037","73927339","chr3","49380229","49380531","26","24546808"
"chr7","73928096","73928264","chr16","72816142","72816311","35","1111954"
"chr7","73928291","73928393","chr8","38214751","38214853","19","35713540"
"chr7","73930108","73930374","chr3","49377170","49377424","31","24552938"
"chr7","73930628","73930930","chr3","49376611","49376917","33","24554017"
"chr7","73931924","73932196","chr3","49375007","49375290","44","24556917"
"chr7","73943518","73943818","chr20","28651476","28651780","54","45292042"
"chr7","73944214","73944527","chr14","63858277","63858583","62","10085937"
"chr7","73945590","73945910","chr11","109624796","109625101","70","35679206"
"chr7","73951547","73951671","chr3","49356678","49356803","10","24594869"
"chr7","73961552","73961839","chr1","130726452","130726730","71","56764900"
"chr7","73973749","73973882","chr3","39810823","39810958","19","34162926"
"chr7","73974184","73974334","chr3","49333423","49333572","12","24640761"
"chr7","73979242","73979551","chr3","49328055","49328371","29","24651187"
"chr7","73980060","73980362","chr3","49327267","49327549","32","24652793"
"chr7","73984004","73984276","chr3","49323189","49323460","26","24660815"
"chr7","73988882","73989188","chr3","49318128","49318422","46","24670754"
"chr7","73994282","73994441","chr10","7402377","7402528","38","66591905"
"chr7","73994715","73994739","chr8","33625467","33625487","7","40369248"
"chr7","73995029","73995129","chr7","164031472","164031582","27","90036443"
"chr7","74001582","74001688","chr6","93630790","93630896","20","19629208"
"chr7","74005981","74006292","chr3","48982959","48983270","32","25023022"
"chr7","74017707","74017958","chr7","39681161","39681412","53","34336546"
"chr7","74027725","74027834","chr3","49281441","49281553","10","24746284"
"chr7","74037089","74037354","chr3","123351694","123351976","66","49314605"
"chr7","74052500","74052813","chr3","49257298","49257589","41","24795202"
"chr7","74053527","74053650","chrX","112401388","112401505","23","38347861"
"chr7","74055996","74056282","chr3","49248431","49248715","35","24807565"
"chr7","74057734","74058045","chr3","49252864","49253150","36","24804870"
"chr7","74061237","74061509","chr3","49246178","49246439","37","24815059"
"chr7","74063957","74064123","chr18","15248476","15248640","38","58815481"
"chr7","74066667","74066892","chr3","49242705","49242926","19","24823962"
"chr7","74082663","74082964","chr1","121643407","121643710","59","47560744"
"chr7","74109134","74109391","chr9","8141390","8141647","47","65967744"
"chr7","74114309","74114600","chr1","47419013","47419303","64","26695296"
"chr7","74124847","74125116","chr3","49192931","49193206","25","24931916"
"chr7","74546381","74546595","chr9","36662456","36662669","18","37883925"
"chr7","74555442","74555553","chr6","156185594","156185707","21","81630152"
"chr7","74586308","74586594","chr16","20836830","20837113","21","53749478"
"chr7","74592106","74592352","chr16","20820030","20820296","35","53772076"
"chr7","74614069","74614341","chr16","21456395","21456661","35","53157674"
"chr7","74635823","74636094","chr16","21456395","21456661","39","53179428"
"chr7","74666087","74666365","chr3","52345064","52345346","35","22321023"
"chr7","74754612","74754848","chr7","138589300","138589547","50","63834688"
"chr7","74765449","74765767","chr3","48889118","48889434","27","25876331"
"chr7","74772417","74772716","chr3","48882633","48882943","63","25889784"
"chr7","74780513","74780754","chr3","48875508","48875768","33","25905005"
"chr7","74784983","74785272","chr6","174439284","174439572","47","99654301"
"chr7","74789695","74789991","chr3","48866089","48866382","25","25923606"
"chr7","74803239","74803490","chr3","48850631","48850882","23","25952608"
"chr7","74814548","74814641","chr3","48839057","48839137","18","25975491"
"chr7","74814644","74814917","chr3","48838768","48839041","42","25975876"
"chr7","74822320","74822583","chr16","22628047","22628318","52","52194273"
"chr7","74828268","74828585","chr3","48818410","48818730","26","26009858"
"chr7","74833716","74833982","chr3","48812887","48813153","20","26020829"
"chr7","74835796","74835914","chr3","48810602","48810723","14","26025194"
"chr7","74839831","74839970","chrX","16140339","16140486","37","58699492"
"chr7","74841490","74841715","chr3","48808078","48808307","24","26033412"
"chr7","74843788","74844017","chr3","48805708","48805958","40","26038080"
"chr7","74850609","74850919","chr3","48797827","48798158","44","26052782"
"chr7","74852940","74853238","chr3","48796086","48796395","34","26056854"
"chr7","74874178","74874294","chr2","42624560","42624676","17","32249618"
"chr7","74874331","74874491","chr20","8901623","8901786","33","65972708"
"chr7","74879462","74879769","chr3","48771390","48771693","36","26108072"
"chr7","74880266","74880555","chr3","48770586","48770873","24","26109680"
"chr7","74885025","74885332","chr3","48765448","48765748","35","26119577"
"chr7","74886652","74886954","chr3","48762586","48762896","52","26124066"
"chr7","74895366","74895658","chr3","48752862","48753151","21","26142504"
"chr7","74911534","74911835","chr3","48736550","48736831","43","26174984"
"chr7","74925983","74926114","chr7","137998780","137998910","22","63072797"
"chr7","74942514","74942700","chr3","48702847","48703035","15","26239667"
"chr7","74943578","74943844","chrX","758935","759201","72","74184643"
"chr7","74961127","74961431","chr3","48683980","48684284","23","26277147"
"chr7","74970582","74970726","chr11","66292823","66292968","32","8677759"
"chr7","74971019","74971174","chr6","125857818","125857973","26","50886799"
"chr7","74973293","74973604","chr3","48672065","48672378","21","26301228"
"chr7","74974654","74974950","chr3","48670725","48671020","38","26303929"
"chr7","74978010","74978309","chr3","48667270","48667551","30","26310740"
"chr7","74980598","74980846","chr3","48664845","48665086","22","26315753"
"chr7","75030056","75030333","chr5","151427418","151427685","52","76397362"
"chr7","75030731","75031026","chr3","48614901","48615215","52","26415830"
"chr7","75031487","75031822","chr6","131826577","131826877","99","56795090"
"chr7","75035926","75036231","chr3","48609439","48609752","26","26426487"
"chr7","75039582","75039839","chr1","37126383","37126644","60","37913199"
"chr7","75039844","75040136","chr3","48606845","48607137","24","26432999"
"chr7","75049023","75049319","chr3","48597591","48597900","37","26451432"
"chr7","75049932","75050166","chr3","48596683","48596917","17","26453249"
"chr7","75075683","75075971","chr3","48570831","48571151","52","26504852"
"chr7","75092432","75092712","chr3","48556636","48556917","27","26535796"
"chr7","75236488","75236609","chr1","90182553","90182674","26","14946065"
"chr7","75306726","75307027","chr6","147432797","147433108","73","72126071"
"chr7","75453752","75454028","chr6","55846718","55847002","63","19607034"
"chr7","75457215","75457525","chrX","128863488","128863802","60","53406273"
"chr7","75458008","75458277","chr1","44248959","44249223","61","31209049"
"chr7","75459019","75459223","chr16","20993700","20993914","23","54465319"
"chr7","75474324","75474472","chr8","25436187","25436334","27","50038137"
"chr7","75474766","75474903","chr5","24916403","24916528","38","50558363"
"chr7","75502675","75502969","chr9","5743881","5744173","60","69758794"
"chr7","75512452","75512648","chr5","182870756","182870952","50","107358304"
"chr7","75552345","75552636","chr19","35320177","35320461","40","40232168"
"chr7","75593738","75594043","chr3","2871128","2871439","74","72722610"
"chr7","75600102","75600186","chrX","53790985","53791067","13","21809117"
"chr7","75614980","75615271","chr3","48533963","48534263","27","27081017"
"chr7","75615276","75615432","chr3","48533810","48533962","13","27081466"
"chr7","75619726","75620012","chr3","48529542","48529824","33","27090184"
"chr7","75630316","75630603","chr10","77425876","77426160","50","1795560"
"chr7","75631182","75631488","chr3","48522370","48522671","50","27108812"
"chr7","75634493","75634696","chr14","10700506","10700711","42","64933987"
"chr7","75635576","75635880","chr11","108487950","108488261","60","32852374"
"chr7","75641064","75641343","chr3","48512964","48513245","22","27128100"
"chr7","75649836","75650142","chr3","48504222","48504534","38","27145614"
"chr7","75651892","75652006","chr3","48502365","48502480","11","27149527"
"chr7","75652395","75652777","chrX","47229042","47229392","116","28423353"
"chr7","75656586","75656871","chr3","48055991","48056284","62","27600595"
"chr7","75671137","75671440","chr3","48483322","48483642","43","27187815"
"chr7","75685060","75685282","chr3","48469679","48469900","16","27215381"
"chr7","75705083","75705187","chr19","3024654","3024753","16","72680429"
"chr7","75705236","75705408","chr2","75488309","75488482","37","216927"
"chr7","75705653","75705966","chr10","88007645","88007955","60","12301992"
"chr7","75706181","75706468","chr10","88398175","88398465","55","12691994"
"chr7","75710468","75710751","chr3","48444020","48444304","27","27266448"
"chr7","75712866","75713167","chr3","124267629","124267922","55","48554763"
"chr7","75720749","75721017","chr3","48433923","48434209","38","27286826"
"chr7","75723166","75723461","chr3","48431648","48431939","18","27291518"
"chr7","75735435","75735604","chr3","48420926","48421085","17","27314509"
"chr7","75735984","75736297","chr3","48420232","48420550","28","27315752"
"chr7","75741012","75741120","chr3","48416148","48416256","11","27324864"
"chr7","75748381","75748650","chr3","48408242","48408535","44","27340139"
"chr7","75750158","75750256","chr7","35657108","35657206","12","40093050"
"chr7","75755980","75756285","chr8","82034150","82034450","68","6278170"
"chr7","75766539","75766775","chr3","48388161","48388394","22","27378378"
"chr7","75781079","75781346","chr3","48372961","48373220","26","27408118"
"chr7","75790721","75791016","chr3","48361151","48361456","26","27429570"
"chr7","75792405","75792682","chr3","48359575","48359852","20","27432830"
"chr7","75797814","75798054","chr2","96976430","96976667","78","21178616"
"chr7","75814789","75815092","chr3","48336474","48336789","37","27478315"
"chr7","75827957","75828259","chr3","48323396","48323692","30","27504561"
"chr7","75844613","75844921","chr9","94346653","94346954","62","18502040"
"chr7","75846387","75846685","chr3","48310019","48310316","25","27536368"
"chr7","75852377","75852593","chrX","18708291","18708494","47","57144086"
"chr7","75858502","75858812","chr3","48300541","48300859","36","27557961"
"chr7","75882108","75882426","chr4","36470308","36470624","69","39411800"
"chr7","75883361","75883535","chr3","48266522","48266696","6","27616839"
"chr7","75883851","75884133","chr3","48265931","48266214","29","27617920"
"chr7","75885851","75886127","chr3","48263758","48264032","25","27622093"
"chr7","75888034","75888098","chr10","14221515","14221578","10","61666519"
"chr7","75901325","75901630","chr3","48247568","48247869","28","27653757"
"chr7","75904857","75905038","chr3","48244132","48244315","20","27660725"
"chr7","75918831","75919127","chr3","48229886","48230191","34","27688945"
"chr7","75920418","75920584","chr3","48228469","48228637","18","27691949"
"chr7","75922423","75922724","chr3","48226308","48226595","31","27696115"
"chr7","75939338","75939631","chr3","48208612","48208898","22","27730726"
"chr7","75945846","75946137","chr3","48203268","48203560","32","27742578"
"chr7","75947567","75947823","chr3","48201581","48201838","14","27745986"
"chr7","75949293","75949459","chr12","101537347","101537508","39","25588054"
"chr7","75949490","75949617","chr7","152899855","152899972","34","76950365"
"chr7","75949881","75950183","chr3","48199098","48199366","46","27750783"
"chr7","75961513","75961638","chr3","48187200","48187325","4","27774313"
"chr7","75971214","75971501","chr3","48177577","48177869","26","27793637"
"chr7","75981498","75981650","chr3","48166737","48166903","27","27814761"
"chr7","75981939","75982088","chr3","48166296","48166448","12","27815643"
"chr7","75989097","75989244","chr3","48160050","48160198","10","27829047"
"chr7","75990599","75990899","chr3","48158387","48158679","42","27832212"
"chr7","75996537","75996836","chr3","48153836","48154141","28","27842701"
"chr7","75999662","75999791","chr3","48150857","48150973","17","27848805"
"chr7","76005705","76005999","chr3","48141416","48141716","32","27864289"
"chr7","76010764","76011076","chr3","48139485","48139776","47","27871279"
"chr7","76022114","76022400","chr3","48128078","48128381","39","27894036"
"chr7","76036096","76036410","chr3","48107711","48108022","38","27928385"
"chr7","76037820","76037960","chr19","36030380","36030518","35","40007440"
"chr7","76052775","76053076","chr8","22350458","22350753","62","53702317"
"chr7","76058927","76059056","chr3","48085056","48085181","15","27973871"
"chr7","76060234","76060543","chrX","18704319","18704621","66","57355915"
"chr7","76066034","76066319","chr3","48077837","48078121","23","27988197"
"chr7","76066331","76066558","chr3","48077615","48077825","37","27988716"
"chr7","76069045","76069367","chr9","30651570","30651886","60","45417475"
"chr7","76071639","76071980","chr8","58481167","58481473","82","17590472"
"chr7","76074651","76074912","chr4","115129767","115130025","56","39055116"
"chr7","76074943","76074979","chr1","8291072","8291112","9","67783871"
"chr7","76078412","76078573","chr4","13629108","13629270","33","62449304"
"chr7","76080025","76080308","chr3","48064354","48064643","25","28015671"
"chr7","76081801","76081969","chr3","48062452","48062619","14","28019349"
"chr7","76082261","76082397","chr2","169133199","169133321","31","93050938"
"chr7","76087701","76087974","chr3","48055991","48056284","46","28031710"
"chr7","76088004","76088098","chr4","15278126","15278223","17","60809878"
"chr7","76094749","76095018","chr3","48048056","48048333","27","28046693"
"chr7","76106410","76106708","chr3","48036640","48036934","34","28069770"
"chr7","76114174","76114432","chr8","25415552","25415819","77","50698622"
"chr7","76118503","76118727","chr2","51041029","51041254","44","25077474"
"chr7","76163768","76164043","chr3","47975196","47975490","43","28188572"
"chr7","76165307","76165606","chr3","47973613","47973914","17","28191694"
"chr7","76167685","76167944","chr4","158590779","158591033","66","82423094"
"chr7","76173474","76173697","chr4","24998518","24998737","53","51174956"
"chr7","76190003","76190124","chr3","47948154","47948277","9","28241849"
"chr7","76202859","76203156","chr3","47935540","47935838","37","28267319"
"chr7","76206432","76206627","chr10","31228290","31228480","41","44978142"
"chr7","76207525","76207835","chr3","47930685","47930995","28","28276840"
"chr7","76216804","76217088","chr3","47920392","47920665","24","28296412"
"chr7","76236338","76236645","chr3","47905549","47905863","38","28330789"
"chr7","76237208","76237499","chr3","47904711","47905002","23","28332497"
"chr7","76240368","76240669","chr3","47901232","47901548","35","28339136"
"chr7","76241397","76241703","chr3","15122472","15122781","58","61118925"
"chr7","76252434","76252665","chr3","47889867","47890113","30","28362567"
"chr7","76252669","76252801","chr2","42645372","42645505","26","33607297"
"chr7","76269547","76269841","chr3","47873564","47873873","33","28395983"
"chr7","76282506","76282767","chr3","47860259","47860522","19","28422247"
"chr7","76320622","76320847","chr3","47822424","47822647","17","28498198"
"chr7","76330145","76330305","chr15","14220279","14220430","39","62109866"
"chr7","76337833","76338112","chr3","47805129","47805407","25","28532704"
"chr7","76343168","76343465","chr3","47801118","47801423","32","28542050"
"chr7","76373428","76373731","chr10","72249221","72249509","71","4124207"
"chr7","76397302","76397589","chr3","47748629","47748909","30","28648673"
"chr7","76400545","76400840","chr3","47745273","47745567","25","28655272"
"chr7","76403924","76404052","chr2","95353003","95353133","21","18949079"
"chr7","76406139","76406429","chr3","47735625","47735919","31","28670514"
"chr7","76407784","76407906","chr15","110025773","110025895","16","33617989"
"chr7","76420365","76420662","chr3","47720309","47720606","24","28700056"
"chr7","76428348","76428656","chr3","47712254","47712533","44","28716094"
"chr7","76430431","76430756","chr11","76067720","76068044","73","362711"
"chr7","76458183","76458497","chr3","47684507","47684823","26","28773676"
"chr7","76488772","76488846","chr3","47654337","47654413","7","28834435"
"chr7","76501771","76502079","chr3","47641491","47641797","28","28860280"
"chr7","76504459","76504775","chr3","47638771","47639084","32","28865688"
"chr7","76507004","76507312","chr3","47636016","47636330","25","28870988"
"chr7","76509884","76510184","chr3","47633012","47633312","28","28876872"
"chr7","76513412","76513564","chr3","42941233","42941386","24","33572179"
"chr7","76513595","76513721","chr1","140189670","140189791","28","63676075"
"chr7","76521892","76522099","chr3","47619172","47619389","31","28902720"
"chr7","76528547","76528849","chr3","47610491","47610791","29","28918056"
"chr7","76556189","76556326","chr6","171557602","171557736","30","95001413"
"chr7","76567657","76567916","chr3","47568209","47568466","18","28999448"
"chr7","76568042","76568366","chr3","47567768","47568083","30","29000274"
"chr7","76568375","76568705","chr3","47567768","47568083","34","29000607"
"chr7","76577326","76577479","chr3","47558463","47558615","10","29018863"
"chr7","76577817","76577952","chr1","129993617","129993748","31","53415800"
"chr7","76590507","76590787","chr3","47543506","47543790","29","29047001"
"chr7","76610437","76610743","chr3","47522908","47523208","31","29087529"
"chr7","76613210","76613511","chrX","17672800","17673101","54","58940410"
"chr7","76624945","76625242","chr3","47508765","47509055","29","29116180"
"chr7","76647626","76647812","chr3","47484729","47484921","14","29162897"
"chr7","76648110","76648240","chr3","47484304","47484428","18","29163806"
"chr7","76650583","76650883","chr3","47479679","47479978","27","29170904"
"chr7","76651448","76651748","chr3","47478816","47479113","17","29172632"
"chr7","76658771","76659034","chr3","47472019","47472285","26","29186752"
"chr7","76664798","76665074","chr3","47465736","47466011","20","29199062"
"chr7","76668487","76668797","chr3","47462017","47462327","23","29206470"
"chr7","76671522","76671816","chr3","47459158","47459438","30","29212364"
"chr7","76684750","76684879","chr16","10200708","10200837","21","66484042"
"chr7","76691089","76691404","chr3","47439614","47439931","42","29251475"
"chr7","76702271","76702514","chr3","47427224","47427480","24","29275047"
"chr7","76728492","76728802","chr3","47392567","47392884","23","29335925"
"chr7","76731002","76731266","chr3","47389735","47390007","25","29341267"
"chr7","76751483","76751772","chr12","114130342","114130631","55","37378859"
"chr7","76762072","76762368","chr9","109164176","109164476","60","32402104"
"chr7","76777790","76778086","chr3","47341736","47342003","45","29436054"
"chr7","76780943","76781243","chr3","47338601","47338893","36","29442342"
"chr7","76794789","76795095","chr3","47323130","47323441","24","29471659"
"chr7","76795513","76795790","chr3","47322453","47322711","32","29473060"
"chr7","76796447","76796749","chr3","47321476","47321775","22","29474971"
"chr7","76802893","76803208","chr10","25047921","25048219","68","51754972"
"chr7","76820112","76820203","chr3","47296042","47296133","7","29524070"
"chr7","76820514","76820745","chr3","47295515","47295727","39","29524999"
"chr7","76836842","76837145","chr3","47278672","47278950","46","29558170"
"chr7","76847709","76848019","chr3","47266972","47267279","29","29580737"
"chr7","76848454","76848775","chr3","47266212","47266525","28","29582242"
"chr7","76851009","76851306","chr3","127162429","127162726","57","50311420"
"chr7","76856367","76856547","chr3","47258498","47258676","19","29597869"
"chr7","76856662","76856934","chr4","157020938","157021220","58","80164276"
"chr7","76859926","76860224","chr3","47254552","47254851","24","29605374"
"chr7","76860706","76860989","chr3","47253786","47254068","27","29606920"
"chr7","76874851","76875114","chr3","47240048","47240320","34","29634803"
"chr7","76877260","76877432","chr11","114844548","114844709","38","37967288"
"chr7","76877472","76877565","chr5","120757371","120757456","21","43879899"
"chr7","76879021","76879348","chr3","47235875","47236189","47","29643146"
"chr7","76889273","76889306","chr10","6938570","6938606","8","69950703"
"chr7","76889491","76889579","chr12","102113970","102114058","14","25224479"
"chr7","76893353","76893674","chr3","47221692","47221985","55","29671661"
"chr7","76931074","76931381","chr3","47181096","47181404","18","29749978"
"chr7","76932560","76932856","chr3","47179578","47179877","20","29752982"
"chr7","76938504","76938598","chr3","165339814","165339909","22","88401310"
"chr7","76940406","76940703","chr3","47172096","47172393","25","29768310"
"chr7","76941148","76941445","chr3","47171354","47171643","32","29769794"
"chr7","76951480","76951774","chr3","47162576","47162890","45","29788904"
"chr7","76953809","76954101","chr3","47160136","47160428","18","29793673"
"chr7","76956340","76956622","chr3","47157225","47157507","21","29799115"
"chr7","76971238","76971535","chr3","47143723","47144042","42","29827515"
"chr7","76972707","76973015","chr20","21744624","21744918","63","55228083"
"chr7","76975376","76975661","chr15","43687639","43687935","65","33287737"
"chr7","76983009","76983316","chr3","47131826","47132135","20","29851183"
"chr7","76986870","76987141","chr3","47127543","47127814","14","29859327"
"chr7","76992277","76992558","chr3","47119153","47119439","28","29873124"
"chr7","77003780","77003903","chr10","35165431","35165557","19","41838349"
"chr7","77003915","77004197","chr1","13605985","13606264","60","63397930"
"chr7","77005768","77006040","chrX","758935","759201","60","76246833"
"chr7","77012774","77013041","chr6","93690849","93691113","55","16678075"
"chr7","77021320","77021628","chr1","4131757","4132050","76","72889563"
"chr7","77024094","77024263","chr6","159574836","159575006","32","82550742"
"chr7","77024299","77024418","chr6","39578111","39578228","22","37446188"
"chr7","77026031","77026207","chr3","47082515","47082690","14","29943516"
"chr7","77026499","77026633","chr3","47082088","47082223","10","29944411"
"chr7","77033923","77034199","chr3","47074764","47075053","41","29959159"
"chr7","77035226","77035539","chr3","47073433","47073724","45","29961793"
"chr7","77042869","77042995","chr3","47065972","47066100","7","29976897"
"chr7","77043285","77043460","chr3","47065508","47065682","17","29977777"
"chr7","77045456","77045738","chr3","47063253","47063538","15","29982203"
"chr7","77048898","77049190","chr3","47059732","47060028","20","29989166"
"chr7","77053075","77053372","chr3","47055551","47055853","27","29997524"
"chr7","77061219","77061503","chr3","47047331","47047622","34","30013888"
"chr7","77066021","77066313","chr3","47042540","47042839","24","30023481"
"chr7","77070357","77070689","chr3","47038080","47038424","30","30032277"
"chr7","77076429","77076496","chr1","54094474","54094540","17","22981955"
"chr7","77077857","77077981","chr7","129858214","129858337","15","52780357"
"chr7","77082490","77082780","chr3","47025685","47025975","19","30056805"
"chr7","77092768","77092926","chr3","47015232","47015392","14","30077536"
"chr7","77093981","77094230","chr3","47013944","47014187","23","30080037"
"chr7","77105138","77105435","chr3","47002597","47002896","31","30102541"
"chr7","77110951","77111233","chr3","46996393","46996671","18","30114558"
"chr7","77126873","77127150","chr3","46980892","46981179","26","30145981"
"chr7","77132036","77132336","chr3","46975531","46975830","16","30156505"
"chr7","77135986","77136110","chr3","46971303","46971425","15","30164683"
"chr7","77136233","77136538","chr7","36331166","36331462","60","40805067"
"chr7","77137776","77138065","chr3","46969343","46969642","29","30168433"
"chr7","77148810","77149105","chr3","46959050","46959347","23","30189760"
"chr7","77153560","77153866","chr4","2185273","2185588","67","74968287"
"chr7","77162289","77162421","chr3","46948083","46948217","12","30214206"
"chr7","77163591","77163887","chr3","46946607","46946907","28","30216984"
"chr7","77168016","77168298","chr3","46941991","46942271","30","30226025"
"chr7","77169146","77169472","chr16","67475653","67475963","65","9693493"
"chr7","77170661","77170972","chr3","46938115","46938418","35","30232546"
"chr7","77171646","77171942","chr3","46937017","46937311","27","30234629"
"chr7","77179429","77179721","chr3","46929311","46929602","29","30250118"
"chr7","77180346","77180633","chr3","46928397","46928686","19","30251949"
"chr7","77183124","77183211","chr3","50540259","50540346","8","26642865"
"chr7","77184365","77184661","chr3","46924383","46924679","18","30259982"
"chr7","77185021","77185335","chr3","46923714","46924027","13","30261307"
"chr7","77189687","77189963","chr3","46917027","46917319","38","30272660"
"chr7","77191321","77191563","chr3","46915380","46915627","23","30275941"
"chr7","77196109","77196411","chr3","46910306","46910604","30","30285803"
"chr7","77203018","77203318","chr3","46901660","46901940","40","30301358"
"chr7","77204044","77204322","chr1","220290357","220290635","60","143086313"
"chr7","77207982","77208282","chr3","46896756","46897066","29","30311226"
"chr7","77213039","77213324","chr3","46886686","46886971","18","30326353"
"chr7","77219968","77220287","chr3","46879703","46880020","24","30340265"
"chr7","77223242","77223551","chr3","41630422","41630740","66","35592820"
"chr7","77225592","77225865","chr5","138937198","138937473","54","61711606"
"chr7","77229825","77230107","chr3","46865994","46866269","41","30363831"
"chr7","77230301","77230548","chr3","46865524","46865800","66","30364777"
"chr7","77237142","77237448","chr3","46859431","46859750","36","30377711"
"chr7","77244071","77244355","chr3","46852711","46852999","26","30391360"
"chr7","77248792","77249030","chr3","46847744","46847978","38","30401048"
"chr7","77255997","77256078","chr1","40170325","40170418","23","37085672"
"chr7","77260878","77261165","chr9","58809616","58809897","63","18451262"
"chr7","77261794","77261997","chr3","46834850","46835058","20","30426944"
"chr7","77269525","77269816","chr1","50705144","50705441","58","26564381"
"chr7","77270657","77270964","chr3","46824588","46824899","20","30446069"
"chr7","77273088","77273407","chr3","46821916","46822202","62","30451172"
"chr7","77275625","77275907","chr3","46820354","46820649","38","30455271"
"chr7","77278772","77279075","chr17","76613814","76614115","51","664958"
"chr7","77280517","77280813","chr3","46816907","46817202","31","30463610"
"chr7","77287756","77288024","chr3","46809765","46810027","27","30477991"
"chr7","77290703","77291019","chr3","46806413","46806720","34","30484290"
"chr7","77294461","77294760","chr3","46801105","46801412","33","30493356"
"chr7","77297556","77297858","chr3","46799387","46799688","16","30498169"
"chr7","77299005","77299091","chr10","72452712","72452785","30","4846293"
"chr7","77299125","77299288","chr3","46798102","46798274","31","30501023"
"chr7","77303682","77303953","chr3","64697175","64697455","68","12606507"
"chr7","77307149","77307423","chr1","20257747","20258018","62","57049402"
"chr7","77310702","77311023","chr3","46785936","46786250","29","30524766"
"chr7","77313782","77314085","chr3","46782823","46783119","25","30530959"
"chr7","77317152","77317437","chr3","46779667","46779955","18","30537485"
"chr7","77318243","77318558","chr8","32459685","32459997","57","44858558"
"chr7","77318890","77319175","chr3","46777930","46778218","22","30540960"
"chr7","77321982","77322285","chr3","46774795","46775094","25","30547187"
"chr7","77324181","77324444","chr3","46772620","46772893","27","30551561"
"chr7","77328118","77328413","chr3","46768624","46768927","31","30559494"
"chr7","77329722","77329883","chr3","46767169","46767315","29","30562553"
"chr7","77330166","77330305","chr3","46766731","46766873","7","30563435"
"chr7","77335198","77335494","chr3","46761528","46761843","30","30573670"
"chr7","77336565","77336862","chr3","46760155","46760465","45","30576410"
"chr7","77343009","77343303","chr12","84883590","84883883","63","7540581"
"chr7","77345194","77345399","chr3","46751618","46751821","22","30593576"
"chr7","77347355","77347570","chr4","42911085","42911296","50","34436270"
"chr7","77348403","77348675","chr3","46748277","46748526","36","30600126"
"chr7","77350091","77350382","chr3","46746604","46746889","36","30603487"
"chr7","77357705","77358010","chr3","46738918","46739208","49","30618787"
"chr7","77361468","77361650","chr15","88492699","88492875","48","11131231"
"chr7","77361958","77362092","chr10","83131046","83131178","25","5769088"
"chr7","77365939","77366231","chr3","46731144","46731442","39","30634795"
"chr7","77373100","77373398","chr3","46725050","46725356","38","30648050"
"chr7","77375079","77375377","chr1","188627840","188628135","59","111252761"
"chr7","77385872","77386000","chr3","46712867","46712992","16","30673005"
"chr7","77388272","77388617","chr3","46710286","46710582","62","30677986"
"chr7","77391464","77391769","chr1","39092983","39093291","66","38298481"
"chr7","77398364","77398658","chr3","46699188","46699496","42","30699176"
"chr7","77408712","77408986","chr3","46688640","46688915","19","30720072"
"chr7","77412248","77412523","chr3","46685032","46685308","16","30727216"
"chr7","77416654","77416937","chr3","46680596","46680884","25","30736058"
"chr7","77416975","77417260","chr3","46680268","46680555","18","30736707"
"chr7","77433423","77433530","chr17","19080413","19080525","20","58353010"
"chr7","77433555","77433836","chr3","46664558","46664859","43","30768997"
"chr7","77439112","77439233","chr3","46659104","46659225","8","30780008"
"chr7","77450215","77450494","chr3","46648431","46648725","35","30801784"
"chr7","77451047","77451337","chr3","46647583","46647874","17","30803464"
"chr7","77453274","77453554","chr10","77333941","77334222","57","119333"
"chr7","77454808","77455100","chr3","46644120","46644433","49","30810688"
"chr7","77458047","77458345","chr3","46640767","46641075","44","30817280"
"chr7","77459460","77459745","chr3","46639103","46639391","28","30820357"
"chr7","77462960","77463281","chr3","46635573","46635891","26","30827387"
"chr7","77469552","77469839","chr3","43652365","43652670","64","33817187"
"chr7","77472667","77472986","chr14","21340239","21340560","66","56132428"
"chr7","77473788","77474121","chr3","46624675","46624999","31","30849113"
"chr7","77479518","77479816","chr3","46616905","46617199","37","30862613"
"chr7","77480803","77481100","chr1","194672097","194672386","62","117191294"
"chr7","77483922","77484041","chr3","41881824","41881939","22","35602098"
"chr7","77484069","77484238","chr8","26885500","26885666","34","50598569"
"chr7","77509045","77509329","chr3","46587015","46587310","31","30922030"
"chr7","77510943","77511078","chr3","79769611","79769747","37","2258668"
"chr7","77511081","77511339","chr3","47104622","47104882","64","30406459"
"chr7","77519425","77519559","chr8","25790151","25790275","43","51729274"
"chr7","77522097","77522399","chr1","52278325","52278626","62","25243772"
"chr7","77534231","77534529","chr8","28623574","28623869","54","48910657"
"chr7","77541121","77541419","chr3","46555068","46555368","19","30986053"
"chr7","77543558","77543852","chr3","46552626","46552920","34","30990932"
"chr7","77562842","77563138","chr3","46532817","46533128","33","31030025"
"chr7","77566793","77567073","chr3","46528953","46529241","24","31037840"
"chr7","77591180","77591482","chr3","46504508","46504817","34","31086672"
"chr7","77639728","77640011","chr3","46451697","46451990","28","31188031"
"chr7","77641785","77642080","chr3","46449608","46449913","28","31192177"
"chr7","77661345","77661470","chr3","46421896","46422007","20","31239449"
"chr7","77668274","77668566","chr3","46416358","46416650","18","31251916"
"chr7","77669948","77670226","chr3","46414700","46414989","38","31255248"
"chr7","77672235","77672534","chr3","46412383","46412680","15","31259852"
"chr7","77675654","77675958","chr1","33298849","33299154","61","44376805"
"chr7","77677898","77678159","chr3","46406285","46406551","31","31271613"
"chr7","77685669","77685969","chr3","46398177","46398472","22","31287492"
"chr7","77691057","77691187","chr3","46393359","46393483","18","31297698"
"chr7","77691896","77692206","chr3","46392327","46392645","37","31299569"
"chr7","77694362","77694644","chr3","46389862","46390156","25","31304500"
"chr7","77699373","77699664","chr3","46384812","46385102","13","31314561"
"chr7","77701522","77701816","chr3","46382670","46382979","50","31318852"
"chr7","77743982","77744190","chr8","30275478","30275683","50","47468504"
"chr7","77820709","77820949","chr3","46261305","46261546","11","31559404"
"chr7","77828814","77828948","chr3","46254542","46254667","11","31574272"
"chr7","77840984","77841287","chr3","46242070","46242355","41","31598914"
"chr7","77851963","77852132","chrUn_NW_014806985v1","621","788","32","77851342"
"chr7","77852168","77852274","chr1","42071228","42071335","27","35780940"
"chr7","77865984","77866272","chrX","65737401","65737687","56","12128583"
"chr7","77882513","77882817","chr1","5791348","5791647","73","72091165"
"chr7","77887619","77887945","chr3","46197116","46197401","57","31690503"
"chr7","77909805","77910107","chr3","46180260","46180565","33","31729545"
"chr7","77949370","77949492","chr3","46140626","46140742","10","31808744"
"chr7","77953190","77953489","chr7","137064482","137064770","64","59111292"
"chr7","77965356","77965595","chr3","46125478","46125724","27","31839878"
"chr7","78009935","78010223","chr3","46083883","46084181","34","31926052"
"chr7","78011119","78011414","chr3","46082653","46082959","26","31928466"
"chr7","78035629","78035858","chr3","46055057","46055274","33","31980572"
"chr7","78088086","78088206","chr1","139862049","139862167","21","61773963"
"chr7","78101155","78101404","chr3","45989341","45989593","17","32111814"
"chr7","78109289","78109603","chr3","45980826","45981130","40","32128463"
"chr7","78154756","78154937","chr3","45934082","45934264","13","32220674"
"chr7","78155240","78155379","chr3","45933639","45933772","11","32221601"
"chr7","78194426","78194732","chr3","45894173","45894484","21","32300253"
"chr7","78221875","78222125","chr3","45867625","45867877","21","32354250"
"chr7","78225720","78226016","chr3","45863741","45864034","19","32361979"
"chr7","78257583","78257885","chr3","45832151","45832435","40","32425432"
"chr7","78291903","78292025","chr11","121219101","121219227","21","42927198"
"chr7","78296082","78296390","chr2","22643052","22643359","54","55653030"
"chr7","78304731","78305053","chr12","84462101","84462410","89","6157370"
"chr7","78321465","78321744","chr3","45769041","45769347","51","32552424"
"chr7","78337861","78338151","chr3","45751554","45751846","13","32586307"
"chr7","78372186","78372482","chr3","45716334","45716623","22","32655852"
"chr7","78398827","78399126","chr3","45690037","45690334","22","32708790"
"chr7","78423874","78423979","chr6","67879633","67879731","27","10544241"
"chr7","78433122","78433388","chr3","45655472","45655737","15","32777650"
"chr7","78456005","78456264","chr3","48372961","48373220","55","30083044"
"chr7","78475270","78475394","chr3","45613552","45613689","14","32861718"
"chr7","78475811","78476014","chr3","45613104","45613274","52","32862707"
"chr7","78487281","78487585","chr3","45601270","45601571","33","32886011"
"chr7","78504852","78505054","chr3","45582920","45583122","42","32921932"
"chr7","78531040","78531329","chr3","45554517","45554810","24","32976523"
"chr7","78543496","78543773","chr3","45542066","45542314","63","33001430"
"chr7","78547340","78547614","chr1","193445861","193446149","59","114898521"
"chr7","78559128","78559432","chr3","45525472","45525772","31","33033656"
"chr7","78571907","78572027","chr3","45512933","45513053","4","33058974"
"chr7","78582853","78583142","chr3","45499596","45499886","20","33083257"
"chr7","78583382","78583701","chr3","45499026","45499354","41","33084356"
"chr7","78584942","78585221","chr3","45497800","45498068","25","33087142"
"chr7","78611057","78611365","chr19","6633619","6633914","71","71977438"
"chr7","78647936","78648222","chr3","45431609","45431909","38","33216327"
"chr7","78648865","78648984","chr3","45430853","45430968","14","33218012"
"chr7","78671098","78671393","chr3","45408264","45408547","24","33262834"
"chr7","78690142","78690438","chr3","45389566","45389871","41","33300576"
"chr7","78699964","78700269","chr15","77801706","77802006","53","898258"
"chr7","78706003","78706098","chr3","45375478","45375573","3","33330525"
"chr7","78722467","78722748","chr3","45358414","45358694","20","33364053"
"chr7","78725460","78725763","chr3","45355358","45355657","27","33370102"
"chr7","78746631","78746909","chr3","45332394","45332675","16","33414237"
"chr7","78750837","78751115","chr3","45327887","45328164","21","33422950"
"chr7","78751562","78751860","chr3","45327142","45327436","25","33424420"
"chr7","78768547","78768677","chr3","45309289","45309419","10","33459258"
"chr7","78769100","78769279","chr3","45308673","45308867","29","33460427"
"chr7","78771943","78772218","chr3","45305198","45305459","35","33466745"
"chr7","78773029","78773307","chr8","42593523","42593805","55","36179506"
"chr7","78775397","78775711","chr3","45301725","45302036","33","33473672"
"chr7","78785502","78785598","chr20","54626635","54626721","30","24158867"
"chr7","78786609","78786664","chr3","45287101","45287155","3","33499508"
"chr7","78786975","78787081","chr3","45286640","45286747","10","33500335"
"chr7","78791484","78791787","chr3","45280980","45281276","32","33510504"
"chr7","78800392","78800682","chr3","45272150","45272441","23","33528242"
"chr7","78808941","78809251","chr3","45263138","45263447","22","33545803"
"chr7","78809474","78809750","chr3","45262693","45262962","24","33546781"
"chr7","78812175","78812317","chr3","158620808","158620945","32","79808633"
"chr7","78814112","78814390","chrX","23374584","23374854","61","55439528"
"chr7","78820418","78820753","chr3","45252825","45253160","25","33567593"
"chr7","78825235","78825513","chr3","45248082","45248359","24","33577153"
"chr7","78834467","78834767","chr3","45239454","45239758","24","33595013"
"chr7","78834780","78834904","chr9","107933148","107933272","13","29098368"
"chr7","78836511","78836803","chr1","94588825","94589122","58","15752314"
"chr7","78849797","78849915","chr3","45223970","45224088","14","33625827"
"chr7","78851099","78851390","chr3","45222520","45222790","43","33628579"
"chr7","78855830","78856003","chr13","11409935","11410101","33","67445895"
"chr7","78856030","78856152","chr3","36373230","36373353","20","42482800"
"chr7","78856453","78856672","chr3","45217250","45217471","19","33639203"
"chr7","78866345","78866630","chr3","45206850","45207130","41","33659495"
"chr7","78871763","78872054","chr3","45201401","45201683","32","33670362"
"chr7","78873089","78873391","chr3","45200054","45200356","15","33673035"
"chr7","78874434","78874725","chr3","45198724","45199033","47","33675710"
"chr7","78880587","78880887","chr3","45192305","45192606","23","33688282"
"chr7","78881174","78881446","chr3","45191768","45192031","25","33689406"
"chr7","78884337","78884446","chr3","45188175","45188281","7","33696162"
"chr7","78885855","78886137","chr3","45186454","45186744","21","33699401"
"chr7","78907282","78907549","chr3","45167767","45168002","55","33739515"
"chr7","78912446","78912747","chr3","45162633","45162916","36","33749813"
"chr7","78918532","78918846","chr3","35052808","35053125","69","43865724"
"chr7","78920384","78920678","chr3","45153993","45154275","32","33766391"
"chr7","78922261","78922536","chr3","45152140","45152431","44","33770121"
"chr7","78924667","78924973","chr3","45149740","45150041","24","33774927"
"chr7","78947068","78947191","chr12","83400819","83400945","20","4453751"
"chr7","78949901","78950040","chr3","45131102","45131241","13","33818799"
"chr7","78962645","78962918","chr3","45116649","45116932","25","33845996"
"chr7","78964754","78964926","chr3","45114937","45115121","23","33849817"
"chr7","78965225","78965337","chr3","45114530","45114643","9","33850695"
"chr7","78966200","78966531","chr3","500655","500980","90","78465545"
"chr7","78966538","78966762","chr7","134195596","134195804","54","55229058"
"chr7","78977355","78977630","chr16","55700437","55700720","57","23276918"
"chr7","78979032","78979204","chr6","166882515","166882692","39","87903483"
"chr7","78979509","78979650","chr20","34149577","34149713","31","44829932"
"chr7","78980417","78980715","chr3","45103721","45104000","40","33876696"
"chr7","78983681","78983975","chr3","45100695","45101016","41","33882986"
"chr7","78988013","78988318","chr3","45096384","45096723","61","33891629"
"chr7","78989074","78989415","chr7","151723324","151723660","82","72734250"
"chr7","78989994","78990177","chr3","45094502","45094681","29","33895492"
"chr7","79010193","79010493","chr3","45071379","45071673","22","33938814"
"chr7","79016117","79016425","chr3","45066100","45066409","24","33950017"
"chr7","79020509","79020726","chr3","45062128","45062348","22","33958381"
"chr7","79021024","79021116","chr3","45061732","45061824","6","33959292"
"chr7","79029554","79029869","chr3","45053057","45053366","31","33976497"
"chr7","79032675","79032944","chr3","45049819","45050087","19","33982856"
"chr7","79035354","79035644","chr3","45047058","45047333","37","33988296"
"chr7","79039577","79039780","chr3","45042910","45043113","10","33996667"
"chr7","79059547","79059830","chr3","45020204","45020485","32","34039343"
"chr7","79063853","79064142","chr3","45015260","45015542","41","34048593"
"chr7","79074219","79074494","chrX","14494750","14495023","56","64579469"
"chr7","79079577","79079827","chr3","44999419","44999703","46","34080158"
"chr7","79085563","79085860","chr3","44993175","44993455","47","34092388"
"chr7","79088003","79088276","chr2","84155954","84156223","51","5067951"
"chr7","79107975","79108051","chr6","67480260","67480337","19","11627715"
"chr7","79108087","79108240","chr18","53524035","53524190","27","25584052"
"chr7","79114792","79115075","chr3","44962409","44962690","37","34152383"
"chr7","79129516","79129816","chr3","44947837","44948123","49","34181679"
"chr7","79131433","79131756","chr3","44945914","44946220","41","34185519"
"chr7","79133858","79134146","chr3","44943471","44943783","46","34190387"
"chr7","79136900","79137193","chr3","44940332","44940640","29","34196568"
"chr7","79143634","79143923","chr3","44933504","44933792","22","34210130"
"chr7","79152815","79153114","chr2","56803979","56804276","62","22348836"
"chr7","79154328","79154628","chr3","44922184","44922474","30","34232144"
"chr7","79161364","79161658","chr3","44915492","44915798","39","34245872"
"chr7","79166480","79166762","chr3","44909799","44910081","21","34256681"
"chr7","79173437","79173507","chr14","46168179","46168248","12","33005258"
"chr7","79187604","79187865","chr3","44887155","44887409","42","34300449"
"chr7","79192968","79193247","chr3","44881304","44881588","31","34311664"
"chr7","79195125","79195332","chr3","44879390","44879619","38","34315735"
"chr7","79204808","79205069","chr3","44869205","44869466","23","34335603"
"chr7","79206585","79206858","chr3","44867408","44867681","19","34339177"
"chr7","79214209","79214396","chr13","47508388","47508574","32","31705821"
"chr7","79223477","79223775","chr3","44852386","44852684","18","34371091"
"chr7","79237916","79238199","chr3","44838219","44838496","33","34399697"
"chr7","79262340","79262542","chr11","1793486","1793688","44","77468854"
"chr7","79263642","79263827","chr1","34770672","34770848","48","44492970"
"chr7","79267148","79267433","chr3","44807814","44808100","33","34459334"
"chr7","79270233","79270533","chr3","44804504","44804797","30","34465729"
"chr7","79271863","79272129","chr3","44802589","44802859","29","34469274"
"chr7","79274965","79275228","chr3","44799478","44799756","34","34475487"
"chr7","79278855","79279128","chr3","44789493","44789791","46","34489362"
"chr7","79296849","79297014","chrX","117902759","117902921","38","38605910"
"chr7","79300099","79300381","chr3","44767914","44768193","25","34532185"
"chr7","79321104","79321288","chr3","44747043","44747217","18","34574061"
"chr7","79321577","79321717","chr3","44746609","44746744","16","34574968"
"chr7","79324250","79324367","chr16","61292718","61292835","19","18031532"
"chr7","79326610","79326733","chr2","165531071","165531193","17","86204461"
"chr7","79326740","79326768","chr1","93915665","93915693","11","14588925"
"chr7","79327784","79327944","chr5","51008800","51008951","42","28318984"
"chr7","79329269","79329581","chr3","44740474","44740789","21","34588795"
"chr7","79330455","79330763","chr3","44739143","44739448","20","34591312"
"chr7","79344366","79344601","chr4","159921811","159922007","69","80577445"
"chr7","79360342","79360630","chr2","99689040","99689328","55","20328698"
"chr7","79378805","79379098","chr3","44682897","44683182","34","34695908"
"chr7","79379721","79379903","chr3","44682127","44682313","37","34697594"
"chr7","79380101","79380398","chr3","44681615","44681926","34","34698486"
"chr7","79381798","79381904","chr3","44679472","44679580","9","34702326"
"chr7","79382524","79382691","chr2","134840996","134841164","39","55458472"
"chr7","79389360","79389646","chr3","44672413","44672680","49","34716947"
"chr7","79391841","79391955","chr1","15121551","15121655","23","64270290"
"chr7","79393816","79394095","chr3","44667918","44668197","22","34725898"
"chr7","79397870","79398159","chr3","44663808","44664100","20","34734062"
"chr7","79399497","79399808","chr3","44662179","44662472","33","34737318"
"chr7","79402487","79402788","chr3","44659196","44659505","25","34743291"
"chr7","79403439","79403735","chr3","44658285","44658586","23","34745154"
"chr7","79415678","79415985","chr3","44646226","44646532","25","34769452"
"chr7","79415997","79416124","chr3","157449830","157449952","25","78033833"
"chr7","79449505","79449726","chr17","59264752","59264980","51","20184753"
"chr7","79452114","79452368","chr3","44602992","44603246","12","34849122"
"chr7","79456098","79456394","chr3","44598014","44598322","40","34858084"
"chr7","79464426","79464709","chr3","44588926","44589209","19","34875500"
"chr7","79470551","79470837","chr16","31833496","31833785","68","47637055"
"chr7","79485113","79485395","chr3","44570035","44570318","26","34915078"
"chr7","79487382","79487703","chr3","44567676","44567977","44","34919706"
"chr7","79489113","79489245","chr3","44566096","44566233","13","34923017"
"chr7","79489544","79489705","chr1","65439667","65439813","38","14049877"
"chr7","79493657","79493954","chr3","44561314","44561593","48","34932343"
"chr7","79500679","79500957","chr12","70180559","70180840","52","9320120"
"chr7","79502200","79502486","chr3","44554763","44555054","17","34947437"
"chr7","79506399","79506609","chr3","44550669","44550884","27","34955730"
"chr7","79521222","79521525","chr1","182255008","182255307","81","102733786"
"chr7","79522640","79522942","chr3","44533351","44533655","30","34989289"
"chr7","79535542","79535675","chr3","44520652","44520785","11","35014890"
"chr7","79535960","79536115","chr8","35981294","35981446","25","43554666"
"chr7","79539457","79539753","chr3","44516079","44516380","26","35023378"
"chr7","79539785","79539916","chr3","44515912","44516045","9","35023873"
"chr7","79543006","79543307","chr3","44512606","44512918","35","35030400"
"chr7","79549428","79549709","chr3","44503907","44504188","14","35045521"
"chr7","79565191","79565325","chr6","93577303","93577440","26","14012112"
"chr7","79565356","79565457","chr1","10773311","10773410","26","68792045"
"chr7","79566065","79566361","chr3","44486313","44486611","19","35079752"
"chr7","79570700","79570937","chr3","44480817","44481031","40","35089883"
"chr7","79572261","79572564","chr3","44479102","44479408","24","35093159"
"chr7","79573918","79574242","chr7","21735439","21735747","75","57838479"
"chr7","79576045","79576340","chr3","44474362","44474656","24","35101683"
"chr7","79583423","79583742","chr3","44466371","44466673","43","35117052"
"chr7","79589313","79589603","chr3","44446093","44446387","21","35143220"
"chr7","79589656","79589862","chr3","44445523","44445724","17","35144133"
"chr7","79595597","79595707","chr1","25442987","25443099","23","54152610"
"chr7","79596011","79596175","chr2","134635259","134635401","63","55039248"
"chr7","79596401","79596555","chr3","44440351","44440515","15","35156050"
"chr7","79597204","79597271","chr3","44439313","44439383","8","35157891"
"chr7","79600138","79600441","chr3","44435825","44436133","33","35164313"
"chr7","79603175","79603447","chr3","44433107","44433378","21","35170068"
"chr7","79611610","79611918","chr11","113220012","113220319","58","33608402"
"chr7","79629119","79629425","chr3","44408110","44408416","24","35221009"
"chr7","79646853","79647131","chr3","44389574","44389854","36","35257279"
"chr7","79651895","79652210","chr14","6219237","6219551","63","73432658"
"chr7","79658283","79658566","chr3","44383742","44384022","33","35274541"
"chr7","79669225","79669494","chr3","124713310","124713578","62","45044085"
"chr7","79681642","79681850","chr3","44362071","44362264","29","35319571"
"chr7","79689498","79689684","chr20","23185454","23185631","43","56504044"
"chr7","79689931","79690046","chr19","52954681","52954797","20","26735250"
"chr7","79692628","79692843","chr3","44347707","44347928","22","35344921"
"chr7","79700034","79700061","chr3","44339435","44339460","4","35360599"
"chr7","79700784","79700846","chr3","44338700","44338762","0","35362084"
"chr7","79710316","79710619","chr6","74464066","74464369","75","5246250"
"chr7","79711480","79711778","chr3","44329937","44330219","42","35381543"
"chr7","79715629","79715753","chr3","44319786","44319910","5","35395843"
"chr7","79716823","79717154","chr3","44318368","44318716","48","35398455"
"chr7","79725816","79726098","chr3","44307720","44308000","24","35418096"
"chr7","79727098","79727375","chr20","57187889","57188168","61","22539209"
"chr7","79728533","79728836","chr3","44304641","44304951","41","35423892"
"chr7","79739375","79739632","chr3","44294696","44294977","37","35444679"
"chr7","79747796","79747927","chr3","44286391","44286523","9","35461405"
"chr7","79758094","79758380","chr2","48622768","48623061","57","31135326"
"chr7","79758995","79759296","chr12","49172411","49172712","64","30586584"
"chr7","79759589","79759675","chr17","34002600","34002686","15","45756989"
"chr7","79770628","79770886","chr3","44265192","44265444","29","35505436"
"chr7","79785327","79785578","chr3","44249748","44250020","29","35535579"
"chr7","79789866","79790019","chr8","29653012","29653169","23","50136854"
"chr7","79808250","79808506","chr3","44227571","44227828","18","35580679"
"chr7","79813545","79813809","chr3","44222466","44222721","20","35591079"
"chr7","79824790","79825092","chr19","32310076","32310380","55","47514714"
"chr7","79828985","79829271","chr3","44205619","44205913","29","35623366"
"chr7","79830065","79830200","chr3","44204701","44204836","10","35625364"
"chr7","79830487","79830683","chr3","44204213","44204383","37","35626274"
"chr7","79837905","79838198","chr3","44196501","44196791","32","35641404"
"chr7","79843114","79843417","chr3","44189086","44189376","44","35654028"
"chr7","79844515","79844812","chr2","144695501","144695798","56","64850986"
"chr7","79851148","79851454","chr3","44180657","44180970","31","35670491"
"chr7","79852354","79852375","chr3","44179748","44179769","1","35672606"
"chr7","79852914","79853194","chr3","44178979","44179231","40","35673935"
"chr7","79868121","79868425","chr3","44163898","44164207","30","35704223"
"chr7","79872689","79872999","chr19","18064212","18064515","63","61808477"
"chr7","79883350","79883467","chr3","44148660","44148773","12","35734690"
"chr7","79886953","79887194","chr3","44144247","44144498","51","35742706"
"chr7","79895627","79895836","chr3","44135947","44136158","18","35759680"
"chr7","79896567","79896875","chr3","44134869","44135177","29","35761698"
"chr7","79897969","79898258","chr3","44133505","44133790","28","35764464"
"chr7","79905967","79906225","chr3","44125816","44126088","33","35780151"
"chr7","79906789","79906953","chr3","44125088","44125251","12","35781701"
"chr7","79907258","79907286","chr16","72124145","72124164","9","7783113"
"chr7","79907477","79907621","chr3","44124652","44124790","10","35782825"
"chr7","79918611","79918883","chr3","44113679","44113952","24","35804932"
"chr7","79919721","79920025","chr3","44112518","44112817","28","35807203"
"chr7","79922428","79922709","chr10","35934129","35934404","66","43988299"
"chr7","79923908","79924222","chr3","44107568","44107855","62","35816340"
"chr7","79930859","79931159","chr3","44100590","44100889","29","35830269"
"chr7","79932055","79932369","chr10","37707166","37707474","72","42224889"
"chr7","79941676","79941830","chr12","21323547","21323703","24","58618129"
"chr7","79948854","79949161","chr3","44081719","44082015","36","35867135"
"chr7","79959736","79959950","chr3","44072254","44072470","12","35887482"
"chr7","79962232","79962343","chr3","44069789","44069900","6","35892443"
"chr7","79972719","79973011","chr3","44058778","44059060","28","35913941"
"chr7","79975375","79975680","chr3","44055062","44055361","35","35920313"
"chr7","79977331","79977666","chr3","44053274","44053613","39","35924057"
"chr7","79988565","79988830","chr3","44042131","44042405","31","35946434"
"chr7","79994048","79994295","chr3","44036531","44036774","14","35957517"
"chr7","79999395","79999688","chr3","44031153","44031453","42","35968242"
"chr7","80001331","80001595","chrX","48756183","48756428","62","31245148"
"chr7","80017111","80017399","chr3","44015807","44016080","38","36001304"
"chr7","80026680","80026862","chr3","129669679","129669864","39","49642999"
"chr7","80028368","80028646","chr2","82184758","82185036","58","2156390"
"chr7","80029721","80030022","chr3","44014207","44014504","28","36015514"
"chr7","80041385","80041479","chr10","29571273","29571370","16","50470112"
"chr7","80045803","80046102","chr3","43998544","43998845","28","36047259"
"chr7","80046481","80046762","chr3","43997876","43998157","22","36048605"
"chr7","80047362","80047661","chr3","43996981","43997275","26","36050381"
"chr7","80047830","80047963","chr7","161169871","161170006","28","81122041"
"chr7","80061260","80061580","chr3","43983145","43983438","35","36078115"
"chr7","80071830","80072120","chr3","43972937","43973231","30","36098893"
"chr7","80073987","80074348","chr3","43970730","43971053","65","36103257"
"chr7","80088735","80089039","chr3","43955494","43955787","33","36133241"
"chr7","80091226","80091511","chr3","40680935","40681233","68","39410291"
"chr7","80096228","80096477","chr3","43946624","43946878","22","36149604"
"chr7","80105374","80105659","chr1","64522903","64523179","68","15582471"
"chr7","80110045","80110316","chr3","43932851","43933129","28","36177194"
"chr7","80111579","80111870","chr3","43931307","43931596","34","36180272"
"chr7","80115700","80116002","chr3","43927198","43927490","37","36188502"
"chr7","80116768","80117072","chr3","43926103","43926399","28","36190665"
"chr7","80124224","80124531","chr3","43918099","43918403","33","36206125"
"chr7","80127765","80128063","chr3","43913498","43913781","33","36214267"
"chr7","80132566","80132864","chrX","43540969","43541269","56","36591597"
"chr7","80132994","80133143","chr1","163921344","163921492","38","83788350"
"chr7","80136325","80136568","chr3","43905963","43906211","25","36230362"
"chr7","80139729","80140059","chr3","43902117","43902447","27","36237612"
"chr7","80140841","80141036","chr3","43901119","43901328","37","36239722"
"chr7","80141342","80141463","chr3","123701140","123701259","27","43559798"
"chr7","80144070","80144356","chr3","43897758","43898061","29","36246312"
"chr7","80149835","80150137","chr3","43892198","43892495","29","36257637"
"chr7","80159561","80159858","chr3","43882598","43882910","44","36276963"
"chr7","80160326","80160617","chr3","43881823","43882114","24","36278503"
"chr7","80166219","80166518","chr7","152260696","152260990","63","72094477"
"chr7","80170862","80171158","chr3","43873510","43873796","31","36297352"
"chr7","80191156","80191437","chr3","43852992","43853280","32","36338164"
"chr7","80192929","80193257","chr3","43851212","43851534","41","36341717"
"chr7","80201262","80201555","chr3","43841584","43841875","30","36359678"
"chr7","80216579","80216676","chr16","7442755","7442849","15","72773824"
"chr7","80234322","80234607","chr3","43806739","43807017","40","36427583"
"chr7","80243931","80244051","chr3","81994559","81994683","23","1750628"
"chr7","80244356","80244554","chr7","92039014","92039198","47","11794658"
"chr7","80251854","80252157","chr3","43789886","43790188","30","36461968"
"chr7","80252231","80252346","chr3","43789704","43789816","12","36462527"
"chr7","80255698","80255864","chr2","61281692","61281857","36","18974006"
"chr7","80263240","80263399","chr3","43778358","43778515","11","36484882"
"chr7","80269384","80269687","chr3","43771904","43772185","45","36497480"
"chr7","80271341","80271628","chr3","43770341","43770633","38","36501000"
"chr7","80273646","80273927","chrX","125989015","125989296","45","45715369"
"chr7","80295553","80295830","chr3","43744508","43744776","34","36551045"
"chr7","80301634","80301898","chr3","43738230","43738503","32","36563404"
"chr7","80304032","80304318","chr3","43735819","43736084","38","36568213"
"chr7","80304571","80304804","chr3","43735357","43735569","52","36569214"
"chr7","80308585","80308888","chr3","43731210","43731526","33","36577375"
"chr7","80310846","80311132","chr3","43728648","43728945","31","36582198"
"chr7","80312131","80312449","chr3","43727542","43727855","38","36584589"
"chr7","80314051","80314268","chr3","43725718","43725946","29","36588333"
"chr7","80315139","80315440","chr3","43724507","43724811","20","36590632"
"chr7","80316200","80316489","chr15","85015612","85015905","60","4699412"
"chr7","80317564","80317695","chr3","43722079","43722210","10","36595485"
"chr7","80333558","80333678","chr9","122912010","122912131","17","42578452"
"chr7","80333709","80333859","chr9","72272836","72272988","29","8060873"
"chr7","80340357","80340661","chr3","43700497","43700802","26","36639860"
"chr7","80340940","80341107","chr7","44865346","44865512","28","35475594"
"chr7","80347691","80347918","chr3","48925909","48926148","29","31421782"
"chr7","80348543","80348839","chr3","48926775","48927071","27","31421768"
"chr7","80354166","80354466","chr3","48932723","48933027","29","31421443"
"chr7","80354843","80354962","chr13","95288408","95288530","21","14933565"
"chr7","80370709","80370962","chr3","48951120","48951396","45","31419589"
"chr7","80371364","80371638","chr3","48951790","48952074","36","31419574"
"chr7","80373383","80373646","chr3","48953822","48954078","20","31419561"
"chr7","80381438","80381723","chr3","48961922","48962212","25","31419516"
"chr7","80383126","80383407","chr3","48963632","48963922","42","31419494"
"chr7","80384130","80384427","chr3","48964946","48965246","28","31419184"
"chr7","80412279","80412580","chr3","48989421","48989720","27","31422858"
"chr7","80414219","80414499","chr1","50742672","50742937","66","29671547"
"chr7","80419453","80419568","chr2","30065286","30065407","24","50354167"
"chr7","80420613","80420868","chr3","48995734","48995997","29","31424879"
"chr7","80462224","80462517","chr3","41870198","41870490","30","38592026"
"chr7","80464449","80464722","chr3","41872451","41872735","32","38591998"
"chr7","80467864","80468173","chr3","41875922","41876228","21","38591942"
"chr7","80470791","80471081","chr3","124286205","124286493","55","43815414"
"chr7","80472157","80472274","chr3","41881824","41881939","10","38590333"
"chr7","80475467","80475599","chr19","40426551","40426683","17","40048916"
"chr7","80476998","80477301","chr3","41884357","41884653","28","38592641"
"chr7","80479130","80479414","chr3","41887081","41887366","18","38592049"
"chr7","80479491","80479624","chr3","41887442","41887575","7","38592049"
"chr7","80487720","80487846","chr3","41894547","41894673","11","38593173"
"chr7","80505187","80505450","chr3","41913861","41914152","45","38591326"
"chr7","80516260","80516515","chr3","41925261","41925513","27","38590999"
"chr7","80523639","80523935","chr3","41932498","41932794","27","38591141"
"chr7","80527964","80528251","chr8","101759668","101759954","58","21231704"
"chr7","80530147","80530427","chr3","41936772","41937045","53","38593375"
"chr7","80535897","80536185","chr3","41943668","41943932","33","38592229"
"chr7","80541110","80541416","chr3","41949233","41949534","45","38591877"
"chr7","80542973","80543270","chr1","77744196","77744495","70","2798777"
"chr7","80550633","80550937","chr3","41958987","41959287","29","38591646"
"chr7","80553578","80553859","chr3","41960874","41961165","35","38592704"
"chr7","80560092","80560398","chr3","41965104","41965408","29","38594988"
"chr7","80566244","80566522","chr3","41971173","41971457","24","38595071"
"chr7","80573824","80574125","chr10","29695459","29695744","40","50878365"
"chr7","80577990","80578293","chr2","95985561","95985850","56","15407571"
"chr7","80580307","80580607","chr10","33320267","33320567","53","47260040"
"chr7","80587369","80587670","chr10","6022103","6022404","57","74565266"
"chr7","80608214","80608330","chr11","114029774","114029891","18","33421560"
"chr7","80608359","80608520","chr6","67603718","67603884","48","13004641"
"chr7","80609693","80609999","chr3","42016566","42016875","29","38593127"
"chr7","80614646","80614891","chr3","42021211","42021432","40","38593435"
"chr7","80617374","80617679","chr3","42023978","42024284","32","38593396"
"chr7","80627529","80627804","chr19","2489601","2489882","64","78137928"
"chr7","80638098","80638404","chr3","42045076","42045368","44","38593022"
"chr7","80656611","80656904","chr3","42064779","42065072","29","38591832"
"chr7","80663424","80663538","chr2","178082637","178082751","22","97419213"
"chr7","80665707","80665811","chr10","88509301","88509403","27","7843594"
"chr7","80667414","80667611","chrX","24510947","24511140","52","56156467"
"chr7","80669776","80670087","chr3","42078369","42078688","46","38591407"
"chr7","80676687","80676817","chr16","53876762","53876894","21","26799925"
"chr7","80678696","80679005","chr3","42087429","42087712","56","38591267"
"chr7","80681677","80681968","chr3","42107648","42107937","61","38574029"
"chr7","80685024","80685329","chr3","42095051","42095354","33","38589973"
"chr7","80688062","80688177","chr3","42098713","42098828","4","38589349"
"chr7","80690538","80690862","chr3","40250673","40250981","76","40439865"
"chr7","80705145","80705470","chr7","42323467","42323788","70","38381678"
"chr7","80708572","80708701","chr2","44878801","44878925","14","35829771"
"chr7","80715950","80716223","chr3","42130593","42130877","52","38585357"
"chr7","80717551","80717859","chr3","42132473","42132785","30","38585078"
"chr7","80718407","80718693","chr3","42133639","42133915","34","38584768"
"chr7","80719527","80719726","chr3","42134762","42134973","27","38584765"
"chr7","80724355","80724659","chr11","117366311","117366614","57","36641956"
"chr7","80727874","80728170","chr3","42143565","42143860","28","38584309"
"chr7","80735404","80735694","chr3","42149983","42150273","14","38585421"
"chr7","80738072","80738394","chr16","52242291","52242593","73","28495781"
"chr7","80739437","80739717","chr3","42155194","42155470","22","38584243"
"chr7","80743387","80743520","chr3","42157778","42157911","11","38585609"
"chr7","80760825","80761112","chr3","42176488","42176777","18","38584337"
"chr7","80763547","80763843","chr3","42179870","42180170","22","38583677"
"chr7","80770531","80770664","chr3","42187247","42187374","18","38583284"
"chr7","80770962","80771127","chr3","42188004","42188169","11","38582958"
"chr7","80777927","80778171","chrX","53362017","53362261","55","27415910"
"chr7","80781073","80781356","chr3","42202995","42203279","26","38578078"
"chr7","80786114","80786243","chr3","42207528","42207657","12","38578586"
"chr7","80795843","80796140","chr3","42219849","42220138","33","38575994"
"chr7","80796145","80796268","chr3","42220151","42220275","11","38575994"
"chr7","80797099","80797406","chr1","52166007","52166310","58","28631092"
"chr7","80816321","80816622","chr5","185678151","185678451","62","104861830"
"chr7","80818123","80818336","chr3","38839947","38840148","39","41978176"
"chr7","80843952","80844067","chr3","42278184","42278299","7","38565768"
"chr7","80844889","80845195","chr3","42279137","42279426","45","38565752"
"chr7","80848270","80848544","chr14","64685578","64685852","49","16162692"
"chr7","80862998","80863128","chr3","42297889","42298012","12","38565109"
"chr7","80866540","80866834","chr3","42301406","42301700","25","38565134"
"chr7","80873331","80873623","chr3","42307993","42308283","23","38565338"
"chr7","80875110","80875217","chr3","42309350","42309455","10","38565760"
"chr7","80886790","80887048","chr3","42321617","42321886","22","38565173"
"chr7","80893955","80894033","chr3","42328137","42328214","5","38565818"
"chr7","80909868","80910173","chr3","42346623","42346911","57","38563245"
"chr7","80911378","80911638","chr12","3445340","3445596","53","77466038"
"chr7","80915365","80915539","chr3","124587370","124587535","29","43672005"
"chr7","80922553","80922864","chr3","43686597","43686908","20","37235956"
"chr7","80926463","80926757","chr1","44171967","44172258","53","36754496"
"chr7","80927653","80927954","chr3","43681527","43681817","35","37246126"
"chr7","80929920","80930212","chr3","43679031","43679338","36","37250889"
"chr7","80932284","80932590","chr3","43676706","43677013","65","37255578"
"chr7","80948008","80948131","chr19","43394787","43394910","15","37553221"
"chr7","80952305","80952614","chr3","43652365","43652670","32","37299940"
"chr7","80953309","80953624","chr15","7988541","7988851","57","72964768"
"chr7","80960471","80960585","chr3","43642287","43642401","6","37318184"
"chr7","80960874","80961036","chr1","160129566","160129712","37","79168692"
"chr7","80964641","80964932","chr11","122444007","122444300","64","41479366"
"chr7","80964949","80965243","chr3","43637148","43637445","23","37327801"
"chr7","80966821","80967124","chr3","43635254","43635566","26","37331567"
"chr7","80968462","80968747","chr3","43633682","43633953","32","37334780"
"chr7","80974001","80974130","chr13","91569938","91570070","19","10595937"
"chr7","80976398","80976699","chr3","43626390","43626692","27","37350008"
"chr7","80977183","80977482","chr3","43625280","43625571","26","37351903"
"chr7","80985493","80985791","chr3","43616991","43617294","31","37368502"
"chr7","80988060","80988355","chr3","43615605","43615897","26","37372455"
"chr7","80990858","80991127","chr20","14544642","14544902","50","66446216"
"chr7","80993158","80993453","chr3","43610527","43610835","73","37382631"
"chr7","81001356","81001662","chr3","43600755","43601066","21","37400601"
"chr7","81010704","81010985","chr3","43591120","43591396","30","37419584"
"chr7","81011497","81011797","chr3","43590308","43590608","20","37421189"
"chr7","81014226","81014361","chr10","83131046","83131178","19","2116820"
"chr7","81014367","81014654","chr3","13514020","13514308","71","67500347"
"chr7","81024972","81025184","chr3","92581046","92581256","52","11556074"
"chr7","81025473","81025584","chr10","74922772","74922885","19","6102701"
"chr7","81026532","81026825","chr3","43574851","43575152","35","37451681"
"chr7","81028446","81028719","chr3","43572948","43573229","25","37455498"
"chr7","81035819","81036136","chr3","43564902","43565220","30","37470917"
"chr7","81036239","81036545","chr4","131078940","131079243","51","50042701"
"chr7","81049366","81049646","chr3","43551400","43551672","28","37497966"
"chr7","81053128","81053277","chr3","44674966","44675110","30","36378162"
"chr7","81053573","81053709","chr7","16934676","16934812","21","64118897"
"chr7","81061162","81061459","chr14","12540994","12541290","57","68520168"
"chr7","81065357","81065631","chr3","43533971","43534245","18","37531386"
"chr7","81071370","81071669","chr3","43527428","43527733","30","37543942"
"chr7","81078114","81078228","chr3","43520533","43520647","11","37557581"
"chr7","81093984","81094210","chr3","43505458","43505713","38","37588526"
"chr7","81096225","81096531","chr3","43502847","43503139","37","37593378"
"chr7","81098184","81098470","chr2","121788357","121788646","51","40690173"
"chr7","81099887","81100189","chr3","43499421","43499721","35","37600466"
"chr7","81105053","81105232","chr13","47508388","47508574","33","33596665"
"chr7","81107883","81107998","chr3","50076569","50076674","32","31031314"
"chr7","81108309","81108326","chr10","20584856","20584872","4","60523453"
"chr7","81112029","81112320","chr1","101913923","101914206","62","20801894"
"chr7","81115329","81115496","chr3","63876628","63876793","30","17238701"
"chr7","81115795","81115931","chr2","91690263","91690400","26","10574468"
"chr7","81120397","81120696","chr3","43471604","43471900","21","37648793"
"chr7","81131808","81132124","chr3","43459431","43459751","30","37672377"
"chr7","81134127","81134470","chr3","43456644","43456980","45","37677483"
"chr7","81135007","81135321","chr3","43455801","43456111","28","37679206"
"chr7","81138001","81138295","chr3","43452506","43452802","32","37685495"
"chr7","81139685","81139817","chr8","71179092","71179225","17","9960593"
"chr7","81139821","81140089","chr3","43450705","43450980","24","37689116"
"chr7","81145959","81146239","chr3","43444472","43444752","15","37701487"
"chr7","81147972","81148300","chr11","93886546","93886856","75","12738574"
"chr7","81152614","81152903","chr3","43437568","43437855","22","37715046"
"chr7","81152909","81153106","chr3","43437358","43437567","19","37715551"
"chr7","81156052","81156363","chr3","43434280","43434590","29","37721772"
"chr7","81159537","81159833","chr3","43430497","43430796","20","37729040"
"chr7","81161764","81161986","chr15","8384710","8384936","47","72777054"
"chr7","81166167","81166474","chr3","43423749","43424061","19","37742418"
"chr7","81167992","81168284","chr3","43421255","43421545","25","37746737"
"chr7","81170623","81170923","chr3","43418601","43418897","28","37752022"
"chr7","81185517","81185635","chr3","64873136","64873250","17","16312381"
"chr7","81193633","81193935","chr3","43395486","43395788","18","37798147"
"chr7","81202243","81202527","chr7","133323953","133324223","26","52121710"
"chr7","81204619","81204899","chr19","5641935","5642216","56","75562684"
"chr7","81208226","81208476","chr5","184439751","184439998","72","103231525"
"chr7","81214072","81214357","chr3","43348170","43348458","18","37865902"
"chr7","81218493","81218758","chr3","43340606","43340824","67","37877887"
"chr7","81219898","81220080","chr3","43339253","43339434","19","37880645"
"chr7","81220376","81220454","chr3","43338867","43338951","11","37881509"
"chr7","81221893","81222023","chr4","114936919","114937049","14","33715026"
"chr7","81228217","81228529","chr3","43328615","43328910","48","37899602"
"chr7","81229476","81229695","chr1","213316318","213316528","54","132086842"
"chr7","81230725","81230893","chr3","36684318","36684493","36","44546407"
"chr7","81231188","81231310","chr3","182536047","182536170","21","101304859"
"chr7","81234679","81234984","chr3","43322417","43322726","33","37912262"
"chr7","81239574","81239841","chr3","43317750","43318026","26","37921824"
"chr7","81243741","81244033","chr1","212801492","212801783","57","131557751"
"chr7","81250110","81250398","chr3","43308110","43308398","22","37942000"
"chr7","81252052","81252357","chr3","43306164","43306451","37","37945888"
"chr7","81252380","81252497","chr14","8294861","8294977","12","72957519"
"chr7","81256345","81256643","chr3","43301862","43302120","54","37954483"
"chr7","81263543","81263598","chr3","72077881","72077936","9","9185662"
"chr7","81265240","81265400","chr1","125498961","125499117","31","44233721"
"chr7","81265714","81265840","chr3","178269661","178269783","20","97003947"
"chr7","81273877","81274171","chr3","43287043","43287346","20","37986834"
"chr7","81278070","81278286","chr3","43282828","43283021","46","37995242"
"chr7","81288347","81288571","chr3","43278382","43278614","26","38009965"
"chr7","81294729","81295025","chr3","43273102","43273393","55","38021627"
"chr7","81299842","81300155","chr3","43257597","43257904","34","38042245"
"chr7","81306851","81307159","chr3","43250221","43250532","28","38056630"
"chr7","81310989","81311091","chr19","3024654","3024753","18","78286335"
"chr7","81318839","81318905","chr7","4948533","4948598","11","76370306"
"chr7","81320563","81320850","chr3","43238671","43238970","26","38081892"
"chr7","81322520","81322810","chr3","43236434","43236701","49","38086086"
"chr7","81324584","81324731","chr3","43234186","43234333","4","38090398"
"chr7","81325005","81325185","chr3","43233424","43233588","27","38091581"
"chr7","81332517","81332638","chr3","43223773","43223901","18","38108744"
"chr7","81336704","81336792","chr16","39059248","39059341","13","42277456"
"chr7","81351194","81351295","chr11","132608503","132608604","18","51257309"
"chr7","81352557","81352848","chr3","43197659","43197948","45","38154898"
"chr7","81354942","81355247","chr3","43195533","43195836","34","38159409"
"chr7","81357526","81357844","chr3","43192908","43193202","86","38164618"
"chr7","81361741","81362039","chr3","43189208","43189507","28","38172533"
"chr7","81362673","81362798","chr13","25546692","25546816","19","55815981"
"chr7","81370847","81371129","chrX","113606813","113607107","67","32235966"
"chr7","81378090","81378401","chr6","75151967","75152278","53","6226123"
"chr7","81380516","81380722","chr3","38839947","38840148","46","42540569"
"chr7","81392466","81392761","chr1","52187439","52187737","65","29205027"
"chr7","81397980","81398279","chr3","43152560","43152861","33","38245420"
"chr7","81399253","81399589","chr3","43150978","43151301","49","38248275"
"chr7","81404623","81404935","chr17","92297134","92297464","83","10892511"
"chr7","81406969","81407278","chr3","43143047","43143353","54","38263922"
"chr7","81413187","81413468","chr3","43135811","43136109","39","38277376"
"chr7","81417816","81418004","chr19","7887117","7887299","39","73530699"
"chr7","81419770","81419890","chr3","43127793","43127906","18","38291977"
"chr7","81426862","81427085","chr14","33234455","33234675","56","48192407"
"chr7","81427435","81427735","chr3","43121253","43121551","28","38306182"
"chr7","81432077","81432208","chr14","63263786","63263912","21","18168291"
"chr7","81434540","81434830","chr3","43111551","43111841","20","38322989"
"chr7","81435416","81435695","chr3","43110679","43110964","33","38324737"
"chr7","81450149","81450434","chr3","43089981","43090275","34","38360168"
"chr7","81450893","81451168","chr3","43088917","43089219","48","38361976"
"chr7","81457958","81458075","chr3","43083893","43084013","11","38374065"
"chr7","81458104","81458266","chr3","43083707","43083867","13","38374397"
"chr7","81458271","81458577","chr3","43083408","43083702","36","38374863"
"chr7","81464615","81464904","chr1","155141171","155141450","52","73676556"
"chr7","81468423","81468717","chr3","43072550","43072836","23","38395873"
"chr7","81480608","81480826","chr20","21561588","21561799","56","59919020"
"chr7","81481716","81482011","chr3","43062072","43062367","19","38419644"
"chr7","81491773","81492087","chr3","43051856","43052173","37","38439917"
"chr7","81492552","81492861","chr3","43051094","43051395","28","38441458"
"chr7","81494144","81494432","chr3","43049152","43049445","25","38444992"
"chr7","81498797","81498917","chr8","14736018","14736138","19","66762779"
"chr7","81499004","81499312","chr16","30378842","30379148","60","51120162"
"chr7","81501939","81502203","chrX","103046997","103047266","52","21545058"
"chr7","81504400","81504697","chr3","43040236","43040528","21","38464164"
"chr7","81508061","81508340","chr1","59387441","59387720","61","22120620"
"chr7","81515307","81515615","chrX","2668164","2668464","63","78847143"
"chr7","81516346","81516471","chr3","43029249","43029383","15","38487097"
"chr7","81517454","81517594","chr20","53415864","53416006","31","28101590"
"chr7","81525737","81526038","chr1","44171967","44172258","57","37353770"
"chr7","81531119","81531252","chr1","182272624","182272756","22","100741505"
"chr7","81542835","81542972","chr3","43002189","43002326","11","38540646"
"chr7","81545799","81546073","chr3","42998501","42998781","27","38547298"
"chr7","81556445","81556597","chr3","42988449","42988590","20","38567996"
"chr7","81556870","81557029","chr10","8082273","8082427","34","73474597"
"chr7","81560564","81560852","chr3","42985064","42985372","30","38575500"
"chr7","81568111","81568362","chr20","10289992","10290257","77","71278119"
"chr7","81570485","81570791","chr7","150795674","150795979","55","69225189"
"chr7","81575435","81575612","chr3","42357857","42358034","12","39217578"
"chr7","81575907","81576043","chr3","42358337","42358473","14","39217570"
"chr7","81577590","81577902","chr3","42360065","42360378","33","39217525"
"chr7","81586813","81587092","chr3","42369992","42370245","41","39216821"
"chr7","81588055","81588380","chr3","42371203","42371513","35","39216852"
"chr7","81590649","81590914","chr5","51959320","51959585","50","29631329"
"chr7","81591944","81592128","chr3","42374453","42374640","21","39217491"
"chr7","81592392","81592456","chr3","42374906","42374968","8","39217486"
"chr7","81592530","81592852","chr3","42375035","42375353","35","39217495"
"chr7","81594081","81594360","chr3","42376381","42376669","48","39217700"
"chr7","81602388","81602692","chr10","66723137","66723445","56","14879251"
"chr7","81605659","81605925","chr8","78513790","78514060","61","3091869"
"chr7","81607368","81607385","chr7","100500648","100500663","6","18893280"
"chr7","81607386","81607617","chr3","31497813","31498037","58","50109573"
"chr7","81607618","81607696","chr9","60638757","60638835","12","20968861"
"chr7","81608624","81608931","chr3","42391235","42391542","18","39217389"
"chr7","81616761","81617033","chr3","42399347","42399601","57","39217414"
"chr7","81620336","81620465","chr1","205327020","205327148","19","123706684"
"chr7","81620478","81620786","chr3","42403027","42403327","30","39217451"
"chr7","81623974","81624249","chr3","183694819","183695107","44","102070845"
"chr7","81624259","81624481","chr3","42406885","42407113","21","39217374"
"chr7","81626673","81626966","chr3","42409281","42409577","23","39217392"
"chr7","81629061","81629367","chr3","42411674","42411985","18","39217387"
"chr7","81631142","81631453","chr7","151830495","151830805","55","70199353"
"chr7","81632187","81632459","chrX","758935","759201","63","80873252"
"chr7","81633493","81633785","chr3","42415782","42416072","32","39217711"
"chr7","81633968","81634271","chr3","42416256","42416560","19","39217712"
"chr7","81638408","81638547","chr1","153513820","153513961","9","71875412"
"chr7","81638554","81638866","chr1","153513507","153513811","32","71874953"
"chr7","81640204","81640505","chr3","41604589","41604891","53","40035615"
"chr7","81642294","81642603","chr10","36280517","36280821","54","45361777"
"chr7","81643591","81643717","chr4","73819458","73819584","19","7824133"
"chr7","81647391","81647677","chr3","123903538","123903830","54","42256147"
"chr7","81662904","81663001","chr2","74636905","74637003","12","7025999"
"chr7","81663881","81664184","chr3","42442443","42442729","33","39221438"
"chr7","81666736","81667044","chr3","42445592","42445917","41","39221144"
"chr7","81669718","81669857","chr3","42448596","42448736","12","39221122"
"chr7","81670167","81670328","chr3","42449035","42449193","13","39221132"
"chr7","81675964","81676178","chr12","84505735","84505949","42","2829771"
"chr7","81677370","81677668","chr11","110011587","110011884","49","28334217"
"chr7","81678845","81679134","chr10","51823199","51823491","54","29855646"
"chr7","81684270","81684564","chr3","42459490","42459776","30","39224780"
"chr7","81686454","81686593","chr3","42461557","42461697","14","39224897"
"chr7","81686834","81686863","chr4","108732531","108732559","8","27045697"
"chr7","81687195","81687368","chrX","93152402","93152581","37","11465207"
"chr7","81688874","81689152","chr1","155141171","155141450","63","73452297"
"chr7","81701690","81701802","chr3","49730715","49730826","17","31970975"
"chr7","81704308","81704575","chr3","49727940","49728225","59","31976368"
"chr7","81709172","81709464","chr3","42484077","42484370","36","39225095"
"chr7","81710025","81710321","chr3","42484931","42485236","30","39225094"
"chr7","81711239","81711557","chr3","42486172","42486477","45","39225067"
"chr7","81715899","81716102","chr20","35094996","35095206","43","46620903"
"chr7","81717072","81717362","chr3","42490069","42490372","36","39227003"
"chr7","81723714","81723968","chr3","42496498","42496750","15","39227216"
"chr7","81724898","81725165","chr3","42497699","42497969","26","39227199"
"chr7","81729016","81729328","chr19","17613597","17613920","73","64115419"
"chr7","81732711","81733001","chr8","129433118","129433406","55","47700407"
"chr7","81735102","81735399","chr3","42508435","42508730","21","39226667"
"chr7","81741067","81741289","chr20","40659296","40659518","47","41081771"
"chr7","81743411","81743554","chr3","42515980","42516127","12","39227431"
"chr7","81744160","81744204","chr10","36717798","36717840","8","45026362"
"chr7","81744531","81744747","chr2","19149265","19149474","47","62595266"
"chr7","81746659","81746932","chr3","42519577","42519838","30","39227082"
"chr7","81749433","81749535","chr3","42523670","42523770","9","39225763"
"chr7","81750973","81751254","chr3","42525328","42525616","27","39225645"
"chr7","81754440","81754719","chr19","41278883","41279162","54","40475557"
"chr7","81766223","81766533","chr10","31200285","31200586","58","50565938"
"chr7","81780372","81780631","chr3","42556361","42556646","41","39224011"
"chr7","81781873","81782160","chr3","42557888","42558170","23","39223985"
"chr7","81797995","81798298","chr2","107411533","107411833","63","25613538"
"chr7","81814306","81814608","chr3","42590480","42590780","12","39223826"
"chr7","81816809","81817102","chr3","42593147","42593440","28","39223662"
"chr7","81840860","81841171","chr3","42617664","42617965","53","39223196"
"chr7","81847038","81847315","chr3","42624449","42624740","31","39222589"
"chr7","81869754","81870010","chr3","42647676","42647931","16","39222078"
"chr7","81913486","81913586","chr4","44669677","44669775","17","37243809"
"chr7","81916443","81916718","chr3","42695780","42696054","25","39220663"
"chr7","81920838","81921055","chr20","14440544","14440744","47","67480294"
"chr7","81924752","81925059","chr3","42705012","42705309","24","39219740"
"chr7","81929178","81929479","chr3","42709447","42709745","28","39219731"
"chr7","81929643","81929906","chr4","7530238","7530504","63","74399405"
"chr7","81934092","81934358","chr2","91599500","91599768","60","9665408"
"chr7","81941854","81942122","chr20","13219480","13219721","71","68722374"
"chr7","81942240","81942518","chr3","42726612","42726891","12","39215628"
"chr7","81942784","81943072","chr3","42727171","42727436","47","39215613"
"chr7","81950843","81951014","chr3","42735663","42735836","15","39215180"
"chr7","81951315","81951451","chr3","42736137","42736286","21","39215178"
"chr7","81960220","81960529","chr1","6095512","6095811","64","75864708"
"chr7","81961295","81961586","chr1","42013299","42013590","61","39947996"
"chr7","81968385","81968661","chr18","52660824","52661104","61","29307561"
"chr7","81979290","81979530","chr3","42766324","42766584","40","39212966"
"chr7","81992954","81993273","chr3","42779752","42780074","39","39213202"
"chr7","81994264","81994476","chr3","42781100","42781339","43","39213164"
"chr7","81999802","81999926","chr3","42787595","42787734","24","39212207"
"chr7","82010349","82010652","chr3","42798832","42799140","29","39211517"
"chr7","82013225","82013535","chr7","150795674","150795979","55","68782449"
"chr7","82015561","82015822","chr3","42802943","42803189","27","39212618"
"chr7","82027586","82027889","chr3","42816511","42816799","44","39211075"
"chr7","82029064","82029323","chr3","42817906","42818173","52","39211158"
"chr7","82034362","82034505","chr3","42824562","42824705","11","39209800"
"chr7","82034800","82034946","chr3","42825018","42825164","10","39209782"
"chr7","82037564","82037858","chr13","107408005","107408290","52","25370441"
"chr7","82040470","82040780","chr3","42830758","42831066","24","39209712"
"chr7","82042235","82042466","chr13","65720169","65720390","59","16322066"
"chr7","82044474","82044778","chr3","42834604","42834906","12","39209870"
"chr7","82049635","82049761","chr5","5565413","5565545","27","76484222"
"chr7","82063236","82063364","chr3","42852795","42852921","17","39210441"
"chr7","82076904","82077168","chr3","41700254","41700542","47","40376650"
"chr7","82077374","82077506","chr10","63212487","63212617","24","18864887"
"chr7","82085839","82086103","chr3","41690980","41691244","10","40394859"
"chr7","82089896","82090202","chr3","41686909","41687208","27","40402987"
"chr7","82090565","82090884","chr3","41686225","41686554","45","40404340"
"chr7","82105238","82105322","chr3","41672460","41672544","7","40432778"
"chr7","82108350","82108639","chr3","41669622","41669935","45","40438728"
"chr7","82109350","82109565","chr3","41668700","41668919","18","40440650"
"chr7","82118160","82118465","chr3","41661438","41661736","33","40456722"
"chr7","82120787","82121086","chr3","41659292","41659574","39","40461495"
"chr7","82123300","82123585","chr3","41656467","41656720","48","40466833"
"chr7","82127147","82127438","chr1","138872834","138873119","60","56745687"
"chr7","82130220","82130533","chr4","159585989","159586293","61","77455769"
"chr7","82143264","82143595","chr19","43430733","43431054","68","38712531"
"chr7","82149028","82149206","chr7","137325995","137326168","34","55176967"
"chr7","82151265","82151581","chr3","41630422","41630740","25","40520843"
"chr7","82155303","82155600","chr3","41626509","41626813","28","40528794"
"chr7","82158330","82158621","chr3","41623484","41623759","27","40534846"
"chr7","82171668","82171951","chr8","29558523","29558807","49","52613145"
"chr7","82172701","82173073","chr3","41607942","41608306","39","40564759"
"chr7","82176878","82177185","chr3","41604589","41604891","26","40572289"
"chr7","82179582","82179870","chr14","115049792","115050083","50","32870210"
"chr7","82183564","82183859","chr3","41596570","41596842","49","40586994"
"chr7","82189776","82190002","chr3","41589467","41589690","22","40600309"
"chr7","82190536","82190669","chr3","41588793","41588926","6","40601743"
"chr7","82194460","82194742","chrX","30235373","30235651","55","51959087"
"chr7","82202303","82202620","chr9","121771852","121772166","61","39569549"
"chr7","82205253","82205552","chr2","118545024","118545317","30","36339771"
"chr7","82211388","82211655","chr3","41569005","41569302","44","40642383"
"chr7","82215471","82215570","chr3","41563534","41563652","21","40651937"
"chr7","82241901","82242233","chr11","117366311","117366614","71","35124410"
"chr7","82249188","82249216","chr3","46942577","46942607","7","35306611"
"chr7","82249520","82249790","chr7","77447147","77447419","65","4802373"
"chr7","82250106","82250402","chr2","84913076","84913368","50","2662970"
"chr7","82260438","82260597","chr16","74403178","74403342","32","7857260"
"chr7","82260890","82261034","chr3","41516763","41516896","25","40744127"
"chr7","82261677","82261959","chr3","41516098","41516366","44","40745579"
"chr7","82263776","82264058","chr3","41513645","41513937","33","40750131"
"chr7","82265956","82266241","chr3","39571415","39571697","56","42694541"
"chr7","82266729","82267025","chr3","41509870","41510165","23","40756859"
"chr7","82268553","82268834","chr3","41507864","41508152","25","40760689"
"chr7","82281304","82281597","chr20","24010200","24010492","47","58271104"
"chr7","82287616","82287838","chr3","41484944","41485163","14","40802672"
"chr7","82290022","82290294","chr3","41482482","41482747","15","40807540"
"chr7","82291384","82291684","chr3","41480459","41480757","31","40810925"
"chr7","82295717","82296013","chr1","100649392","100649693","49","18353675"
"chr7","82297433","82297713","chr3","41473034","41473327","27","40824399"
"chr7","82298724","82299019","chr3","41472271","41472570","22","40826453"
"chr7","82308634","82308940","chr3","41462635","41462931","28","40845999"
"chr7","82314536","82314859","chr13","53140744","53141062","69","29173792"
"chr7","82318205","82318313","chr11","49341562","49341670","20","32976643"
"chr7","82318990","82319258","chr3","41452328","41452607","33","40866662"
"chr7","82320892","82321117","chrX","66022890","66023106","49","16298002"
"chr7","82334040","82334345","chr3","41436713","41437015","28","40897327"
"chr7","82347812","82348100","chr3","41421952","41422237","22","40925860"
"chr7","82351474","82351778","chr3","41419314","41419604","42","40932160"
"chr7","82354327","82354599","chr3","41416461","41416739","34","40937866"
"chr7","82359287","82359589","chr7","140100928","140101221","61","57741641"
"chr7","82362518","82362816","chr3","41409587","41409892","24","40952931"
"chr7","82363603","82363873","chr3","41408539","41408815","17","40955064"
"chr7","82368818","82368935","chr8","36632233","36632350","18","45736585"
"chr7","82374508","82374803","chr3","41397804","41398100","30","40976704"
"chr7","82385751","82386065","chr3","41376402","41376706","44","41009349"
"chr7","82392605","82392907","chr19","29108741","29109042","70","53283864"
"chr7","82411449","82411605","chr1","43681663","43681817","46","38729786"
"chr7","82412747","82413046","chr3","41352174","41352469","33","41060573"
"chr7","82415446","82415766","chr3","41349147","41349449","40","41066299"
"chr7","82421119","82421366","chr15","9745877","9746112","68","72675242"
"chr7","82424083","82424381","chr3","41340153","41340445","32","41083930"
"chr7","82445744","82446064","chr3","41317438","41317752","23","41128306"
"chr7","82453366","82453479","chr3","41304760","41304873","2","41148606"
"chr7","82456246","82456553","chr3","41297914","41298218","27","41158332"
"chr7","82457841","82458113","chr1","213887492","213887785","40","131429651"
"chr7","82461108","82461394","chr3","41293129","41293413","21","41167979"
"chr7","82469521","82469849","chr3","41284848","41285148","52","41184673"
"chr7","82470060","82470181","chr1","50985719","50985834","20","31484341"
"chr7","82472631","82472943","chr3","41281774","41282077","27","41190857"
"chr7","82473615","82473787","chr2","75488309","75488482","30","6985306"
"chr7","82476464","82476747","chr3","41278040","41278317","25","41198424"
"chr7","82477598","82477781","chr3","84781903","84782098","48","2304305"
"chr7","82482232","82482540","chr3","41272866","41273190","64","41209366"
"chr7","82483274","82483575","chr3","41271863","41272144","42","41211411"
"chr7","82484243","82484442","chr3","41270686","41270884","7","41213557"
"chr7","82488189","82488376","chr3","41266668","41266852","10","41221521"
"chr7","82488910","82489078","chr3","41266277","41266444","16","41222633"
"chr7","82489363","82489501","chr3","41265853","41265990","16","41223510"
"chr7","82505322","82505616","chr2","143271726","143272021","52","60766404"
"chr7","82512553","82512835","chr1","32031173","32031460","66","50481380"
"chr7","82517981","82518169","chrX","52447863","52448045","40","30070118"
"chr7","82518464","82518582","chr9","8446572","8446689","23","74071892"
"chr7","82525328","82525610","chr3","49787832","49788139","46","32737496"
"chr7","82526506","82526797","chr3","55092716","55093013","25","27433790"
"chr7","82527808","82528076","chr3","49784026","49784295","26","32743782"
"chr7","82530658","82530884","chr9","97022418","97022646","60","14491760"
"chr7","82531749","82531925","chr3","49781546","49781724","25","32750203"
"chr7","82532239","82532372","chr3","49781106","49781239","10","32751133"
"chr7","82533058","82533348","chr7","26540909","26541193","70","55992149"
"chr7","82535916","82536148","chr3","49774772","49775006","14","32761144"
"chr7","82537332","82537441","chr8","96949211","96949317","20","14411879"
"chr7","82538263","82538572","chr3","49772277","49772588","30","32765986"
"chr7","82539009","82539205","chr3","49771627","49771808","40","32767382"
"chr7","82539517","82539650","chr3","49771183","49771317","5","32768334"
"chr7","82542802","82543108","chr3","49767688","49768001","31","32775114"
"chr7","82545178","82545487","chr3","49765344","49765653","20","32779834"
"chr7","82554820","82555112","chr2","56803979","56804276","66","25750841"
"chr7","82580577","82580863","chr3","49604121","49604397","50","32976456"
"chr7","82590990","82591107","chr3","49485835","49485952","7","33105155"
"chr7","82596115","82596427","chr3","43652365","43652670","57","38943750"
"chr7","82616866","82616937","chr3","49408957","49409026","9","33207909"
"chr7","82621949","82622073","chr10","87818140","87818263","17","5196191"
"chr7","82625001","82625296","chr3","42459490","42459776","31","40165511"
"chr7","82631942","82632254","chr3","41228110","41228402","38","41403832"
"chr7","82632845","82633137","chr7","21016573","21016867","61","61616272"
"chr7","82634133","82634447","chr3","41226982","41227284","29","41407151"
"chr7","82635194","82635436","chr16","30717966","30718215","53","51917228"
"chr7","82636370","82636662","chr3","41224486","41224759","42","41411884"
"chr7","82640588","82640905","chr3","159046115","159046419","64","76405527"
"chr7","82656054","82656186","chr1","117811669","117811797","16","35155615"
"chr7","82658358","82658590","chr3","41201878","41202093","33","41456480"
"chr7","82658846","82658962","chr13","89958796","89958914","19","7299950"
"chr7","82658999","82659167","chr14","18300239","18300397","30","64358760"
"chr7","82660781","82661090","chr3","41199050","41199360","26","41461731"
"chr7","82666656","82666772","chr3","41193563","41193680","9","41473093"
"chr7","82667260","82667485","chr3","41192550","41192774","22","41474710"
"chr7","82667490","82667800","chr1","155141171","155141450","112","72473681"
"chr7","82673421","82673713","chr3","41186339","41186629","55","41487082"
"chr7","82676834","82676961","chr3","41182892","41183013","15","41493942"
"chr7","82684119","82684429","chr3","41173932","41174246","27","41510187"
"chr7","82690771","82690891","chr1","43693513","43693608","44","38997258"
"chr7","82691163","82691248","chr20","34166413","34166498","13","48524750"
"chr7","82703850","82703935","chr12","68993986","68994067","18","13709864"
"chr7","82706857","82707155","chr3","41152313","41152609","24","41554544"
"chr7","82709299","82709587","chr3","41148422","41148737","43","41560877"
"chr7","82710224","82710467","chr8","38412179","38412409","55","44298045"
"chr7","82721990","82722223","chr3","41136451","41136703","32","41585539"
"chr7","82725043","82725239","chr10","28314994","28315173","47","54410049"
"chr7","82725496","82725789","chr3","41132511","41132814","31","41592985"
"chr7","82740248","82740354","chr6","124030144","124030244","27","41289896"
"chr7","82740663","82740791","chr9","28772222","28772353","20","53968441"
"chr7","82744913","82745209","chr3","41112200","41112511","36","41632713"
"chr7","82747197","82747508","chr14","63858277","63858583","54","18888920"
"chr7","82749805","82750099","chr3","41107186","41107484","28","41642619"
"chr7","82753271","82753558","chr3","41103728","41104025","28","41649543"
"chr7","82756303","82756585","chr3","41099945","41100215","50","41656358"
"chr7","82760992","82761298","chr3","41095810","41096115","21","41665182"
"chr7","82763349","82763645","chr3","41093803","41094105","32","41669546"
"chr7","82763883","82764157","chr3","41093285","41093564","31","41670598"
"chr7","82767917","82768240","chr3","41088553","41088884","34","41679364"
"chr7","82769259","82769562","chr3","41086897","41087211","31","41682362"
"chr7","82770628","82770918","chr8","10309775","10310074","62","72460853"
"chr7","82771056","82771186","chr10","28923557","28923690","26","53847499"
"chr7","82771487","82771628","chr16","52962732","52962880","34","29808755"
"chr7","82780099","82780293","chr13","24164593","24164777","42","58615506"
"chr7","82810365","82810644","chr3","41045978","41046264","40","41764387"
"chr7","82814906","82815180","chr3","41040972","41041254","26","41773934"
"chr7","82824380","82824563","chr3","41029820","41029993","21","41794560"
"chr7","82825558","82825880","chr3","41028526","41028824","41","41797032"
"chr7","82826741","82826944","chr3","41027468","41027673","18","41799273"
"chr7","82834877","82835174","chr3","41020144","41020445","29","41814733"
"chr7","82841514","82841626","chr3","41013956","41014084","22","41827558"
"chr7","82848641","82848813","chr9","53484534","53484710","37","29364107"
"chr7","82849112","82849248","chr3","41005127","41005255","14","41843985"
"chr7","82852642","82852911","chr3","41001043","41001323","35","41851599"
"chr7","82857423","82857723","chr3","40994407","40994714","33","41863016"
"chr7","82865483","82865795","chr3","40988213","40988529","36","41877270"
"chr7","82867351","82867475","chr3","40986434","40986558","6","41880917"
"chr7","82868696","82868779","chr1","216473979","216474054","18","133605283"
"chr7","82874482","82874585","chr4","78673190","78673291","20","4201292"
"chr7","82874615","82874763","chr19","5858474","5858626","32","77016141"
"chr7","82875461","82875676","chr3","40978473","40978688","12","41896988"
"chr7","82876990","82877107","chr3","40977084","40977199","9","41899906"
"chr7","82892320","82892589","chr3","40963384","40963658","55","41928936"
"chr7","82937489","82937697","chr3","117287892","117288100","11","34350403"
"chr7","82941355","82941609","chr3","117284054","117284308","15","34342699"
"chr7","82945716","82945974","chr3","117280068","117280351","36","34334352"
"chr7","82957863","82958177","chr3","117259960","117260270","16","34302097"
"chr7","83010919","83011133","chr3","117200781","117200980","34","34189862"
"chr7","83029591","83029903","chr3","117182182","117182490","18","34152591"
"chr7","83070137","83070432","chr3","117087763","117088071","63","34017626"
"chr7","83080053","83080373","chr3","117078923","117079230","29","33998870"
"chr7","83088056","83088353","chr3","117070934","117071237","41","33982878"
"chr7","83127285","83127579","chr3","117033553","117033845","25","33906268"
"chr7","83159472","83159752","chr7","26602255","26602529","57","56557217"
"chr7","83177249","83177553","chr3","116981831","116982131","18","33804582"
"chr7","83193648","83193931","chr7","140588016","140588306","49","57394368"
"chr7","83197675","83197969","chr1","17386249","17386538","59","65811426"
"chr7","83205672","83205817","chr11","1361225","1361361","27","81844447"
"chr7","83206600","83206771","chr3","116949073","116949240","21","33742473"
"chr7","83261659","83261973","chr6","38543147","38543456","62","44718512"
"chr7","83263630","83263912","chr3","167477786","167478063","53","84214156"
"chr7","83281180","83281488","chr3","116874999","116875299","35","33593819"
"chr7","83288638","83288941","chr1","109806160","109806457","67","26517522"
"chr7","83298064","83298348","chr7","137748404","137748687","53","54450340"
"chr7","83301491","83301594","chr20","14807158","14807268","21","68494333"
"chr7","83306811","83306922","chr3","41881824","41881939","20","41424987"
"chr7","83306962","83307122","chr13","65549303","65549453","34","17757659"
"chr7","83322438","83322622","chr3","116832061","116832245","19","33509623"
"chr7","83330878","83331144","chr3","116823182","116823453","22","33492304"
"chr7","83346668","83346924","chr3","116807016","116807274","25","33460348"
"chr7","83364896","83365058","chr1","85381837","85381993","33","2016941"
"chr7","83373496","83373687","chr3","116778546","116778745","25","33405050"
"chr7","83373986","83374088","chr3","116778144","116778244","10","33404158"
"chr7","83385081","83385198","chr9","61837632","61837748","20","21547449"
"chr7","83389807","83390102","chr3","116761486","116761780","20","33371679"
"chr7","83402200","83402485","chr3","116748200","116748494","39","33346000"
"chr7","83405136","83405314","chr10","14457055","14457230","35","68948081"
"chr7","83446643","83446915","chr16","55700437","55700720","65","27746206"
"chr7","83449450","83449736","chr17","20053596","20053878","56","63395854"
"chr7","83457261","83457448","chr15","47495549","47495725","53","35961712"
"chr7","83463301","83463591","chr3","116684558","116684858","29","33221257"
"chr7","83483820","83483942","chr10","87818140","87818263","14","4334320"
"chr7","83510211","83510504","chrX","98518156","98518450","56","15007945"
"chr7","83514912","83514998","chr6","73021123","73021211","23","10493789"
"chr7","83526492","83526739","chr3","116619898","116620152","20","33093406"
"chr7","83528043","83528343","chr3","116618293","116618590","23","33090250"
"chr7","83563873","83564155","chr19","36112659","36112945","60","47451214"
"chr7","83568019","83568307","chr3","116578995","116579284","17","33010976"
"chr7","83585817","83586077","chr3","116561090","116561358","29","32975273"
"chr7","83589219","83589533","chr3","116557619","116557935","34","32968400"
"chr7","83591175","83591342","chr3","116555787","116555959","16","32964612"
"chr7","83595507","83595788","chr3","116551021","116551273","52","32955514"
"chr7","83607308","83607625","chr3","116537954","116538266","34","32930646"
"chr7","83617866","83618077","chr3","116527071","116527292","22","32909205"
"chr7","83626378","83626650","chr1","188619656","188619927","64","104993278"
"chr7","83646879","83647165","chr3","116500312","116500598","23","32853433"
"chr7","83650994","83651299","chr13","104133188","104133476","61","20482194"
"chr7","83663623","83663928","chr3","116482870","116483184","20","32819247"
"chr7","83680582","83680877","chr3","116466780","116467071","26","32786198"
"chr7","83704906","83705195","chr3","116442469","116442759","16","32737563"
"chr7","83710588","83710845","chr3","116436811","116437068","17","32726223"
"chr7","83713003","83713283","chr19","43944004","43944293","64","39768999"
"chr7","83718220","83718521","chr3","116423041","116423344","25","32704821"
"chr7","83733426","83733732","chr3","116409411","116409708","30","32675985"
"chr7","83772932","83773156","chr1","45544948","45545172","41","38227984"
"chr7","83803056","83803363","chr3","116341923","116342226","31","32538867"
"chr7","83824894","83825193","chr3","116320803","116321101","15","32495909"
"chr7","83839679","83839976","chr3","116305835","116306134","12","32466156"
"chr7","83922177","83922473","chr16","11545677","11545975","70","72376500"
"chr7","83959987","83960333","chr3","116181010","116181354","33","32221023"
"chr7","83990108","83990403","chr3","116151541","116151847","26","32161433"
"chr7","84074266","84074582","chr3","116054031","116054319","45","31979765"
"chr7","84255704","84256010","chr3","115874196","115874479","38","31618492"
"chr7","84437000","84437302","chr3","115650701","115651015","35","31213701"
"chr7","84440188","84440464","chr4","18697171","18697456","52","65743017"
"chr7","84494819","84495074","chrX","52930864","52931128","43","31563955"
"chr7","84555408","84555641","chr2","51041029","51041254","52","33514379"
"chr7","84594649","84594949","chr7","45639425","45639731","55","38955224"
"chr7","84596396","84596554","chr12","88971756","88971915","41","4375360"
"chr7","84720615","84720909","chr3","115362229","115362531","33","30641614"
"chr7","84803937","84804241","chr3","115227873","115228175","21","30423936"
"chr7","84809707","84809917","chrX","24510947","24511140","67","60298760"
"chr7","84882776","84883094","chr3","115140907","115141228","32","30258131"
"chr7","84885848","84886132","chr3","115135312","115135593","26","30249464"
"chr7","84923578","84923879","chr3","115099471","115099761","25","30175893"
"chr7","84943204","84943289","chr3","115081532","115081616","5","30138328"
"chr7","84946932","84947245","chrX","41249935","41250247","62","43696997"
"chr7","84948130","84948429","chr3","115076395","115076698","29","30128265"
"chr7","84961472","84961793","chr3","115017870","115018197","50","30056398"
"chr7","84985974","84986191","chr3","115000183","115000407","16","30014209"
"chr7","85030736","85031038","chr3","114953296","114953601","27","29922560"
"chr7","85055698","85055964","chr12","17831887","17832146","66","67223811"
"chr7","85068481","85068721","chr3","114910734","114910975","22","29842253"
"chr7","85267213","85267305","chr4","45723814","45723906","19","39543399"
"chr7","85271617","85271892","chr3","114610403","114610680","18","29338786"
"chr7","85414227","85414532","chr3","114474903","114475211","19","29060676"
"chr7","85677305","85677634","chr3","114189202","114189522","37","28511897"
"chr7","85681808","85682114","chr3","114184965","114185263","27","28503157"
"chr7","85724755","85725078","chr3","114146384","114146700","37","28421629"
"chr7","85733896","85734220","chr3","114137360","114137683","25","28403464"
"chr7","85758754","85759083","chr7","92633971","92634289","69","6875217"
"chr7","85809092","85809370","chr3","114063459","114063737","15","28254367"
"chr7","85971798","85972072","chr1","14754978","14755245","67","71216820"
"chr7","85975641","85975949","chr8","78850789","78851109","62","7124852"
"chr7","86028552","86028837","chr3","113828876","113829164","19","27800324"
"chr7","86049861","86050152","chr3","113805969","113806247","40","27756108"
"chr7","86064905","86065205","chr4","10758695","10758989","56","75306210"
"chr7","86084767","86085073","chr3","113773642","113773963","33","27688875"
"chr7","86145409","86145611","chr3","113711086","113711293","29","27565677"
"chr7","86145891","86146018","chr3","113710674","113710801","6","27564783"
"chr7","86148654","86148973","chr3","113707768","113708060","51","27559114"
"chr7","86214095","86214385","chr3","113650167","113650461","22","27436072"
"chr7","86220956","86221228","chr3","113643368","113643665","45","27422412"
"chr7","86237546","86237852","chr3","113626634","113626936","31","27389088"
"chr7","86306912","86307204","chr3","113554678","113554973","23","27247766"
"chr7","86416244","86416544","chr3","113450692","113450987","28","27034448"
"chr7","86454701","86454974","chr3","113411062","113411342","33","26956361"
"chr7","86481115","86481388","chr3","113384472","113384735","24","26903357"
"chr7","86653044","86653323","chr1","11251860","11252129","61","75401184"
"chr7","86662670","86662867","chr3","113191785","113192003","31","26529115"
"chr7","86727752","86728018","chr3","113133860","113134126","32","26406108"
"chr7","86829957","86830055","chr20","72262239","72262330","20","14567718"
"chr7","86842741","86842866","chr3","113008532","113008655","12","26165791"
"chr7","86930068","86930356","chr2","54599109","54599391","60","32330959"
"chr7","86968905","86969082","chr3","112865944","112866110","19","25897039"
"chr7","87024303","87024580","chr3","112807036","112807304","36","25782733"
"chr7","87056781","87057087","chr3","112777402","112777681","48","25720621"
"chr7","87073222","87073518","chr3","112763719","112764017","21","25690497"
"chr7","87223532","87223648","chr14","8294861","8294977","16","78928671"
"chr7","87223676","87223875","chr9","22982404","22982594","52","64241272"
"chr7","87280951","87281081","chr3","112548248","112548378","10","25267297"
"chr7","87293404","87293719","chr3","112535594","112535912","17","25242190"
"chr7","87354368","87354470","chr3","112475988","112476090","1","25121620"
"chr7","87414669","87414838","chrX","113173870","113174044","35","25759201"
"chr7","87414887","87415006","chr7","113641019","113641138","21","26226132"
"chr7","87452673","87452963","chr3","112381697","112382023","50","24929024"
"chr7","87554078","87554376","chr3","112269972","112270228","64","24715894"
"chr7","87747222","87747494","chr3","112074229","112074501","26","24327007"
"chr7","87748357","87748663","chr3","112069355","112069651","32","24320998"
"chr7","87799640","87799919","chr1","26631916","26632186","64","61167724"
"chr7","87800940","87801236","chr15","34234250","34234544","58","53566690"
"chr7","87947666","87947953","chr3","111863122","111863392","36","23915456"
"chr7","88025811","88026121","chr3","111783475","111783790","36","23757664"
"chr7","88050551","88050833","chr3","111759648","111759948","47","23709097"
"chr7","88076021","88076251","chrX","8697309","8697538","45","79378712"
"chr7","88105005","88105273","chr3","111705592","111705861","28","23600587"
"chr7","88122597","88122812","chr3","93515202","93515421","51","5392605"
"chr7","88187272","88187578","chr3","111622894","111623175","38","23435622"
"chr7","88201206","88201502","chr3","111608636","111608935","28","23407430"
"chr7","88234289","88234336","chr2","105983264","105983310","16","17748975"
"chr7","88234386","88234518","chr11","75714758","75714890","30","12519628"
"chr7","88239205","88239549","chr3","111569821","111570156","43","23330616"
"chr7","88291966","88292085","chr3","111523890","111524008","6","23231924"
"chr7","88301634","88301788","chr3","111515169","111515327","17","23213535"
"chr7","88302355","88302376","chr3","111514580","111514601","1","23212225"
"chr7","88316070","88316370","chr6","138710434","138710734","61","50394364"
"chr7","88355260","88355381","chr11","110654980","110655102","23","22299720"
"chr7","88384108","88384285","chr3","111421566","111421735","26","23037458"
"chr7","88386003","88386113","chr1","212741019","212741130","15","124355016"
"chr7","88505848","88505954","chr3","111301920","111302026","3","22796072"
"chr7","88506406","88506694","chr3","111301175","111301460","26","22794769"
"chr7","88550367","88550666","chr3","111259971","111260263","32","22709604"
"chr7","88612814","88613023","chr3","111195183","111195390","23","22582369"
"chr7","88836856","88837145","chr3","110975643","110975956","45","22138787"
"chr7","88841497","88841751","chr3","110970770","110971024","23","22129273"
"chr7","88877487","88877774","chr3","110940629","110940924","29","22063142"
"chr7","89039530","89039838","chr9","12526150","12526464","71","76513380"
"chr7","89287146","89287354","chrX","4057388","4057588","41","85229758"
"chr7","89305336","89305626","chr3","110504404","110504706","33","21199068"
"chr7","89344653","89344961","chr3","110463257","110463566","31","21118604"
"chr7","89358156","89358286","chr8","71179092","71179225","24","18179064"
"chr7","89381464","89381754","chr3","110432074","110432365","26","21050610"
"chr7","89463198","89463325","chr3","110351822","110351949","14","20888624"
"chr7","89488630","89488914","chr3","110326219","110326522","50","20837589"
"chr7","89775587","89775831","chr3","110011328","110011547","35","20235741"
"chr7","89798203","89798502","chr1","223979328","223979622","63","134181125"
"chr7","89845513","89845811","chr3","109940896","109941196","24","20095383"
"chr7","89849855","89850049","chr1","34916004","34916198","47","54933851"
"chr7","89975978","89976300","chr13","104018636","104018943","77","14042658"
"chr7","89994412","89994459","chr3","109773498","109773545","3","19779086"
"chr7","90193935","90194064","chr6","150070890","150071017","34","59876955"
"chr7","90235709","90235843","chr3","109538753","109538886","4","19303044"
"chr7","90249590","90249723","chr3","55568507","55568639","29","34681083"
"chr7","90279855","90280140","chr3","109497007","109497292","33","19217152"
"chr7","90301538","90301826","chr3","109472994","109473291","28","19171456"
"chr7","90335236","90335528","chr2","43036767","43037061","61","47298469"
"chr7","90374344","90374636","chr3","109398105","109398418","44","19023761"
"chr7","90455561","90455872","chr3","109315049","109315371","47","18859488"
"chr7","90464623","90464931","chr6","147497028","147497329","67","57032405"
"chr7","90703421","90703676","chr3","165224084","165224336","57","74520663"
"chr7","90757338","90757633","chr4","10613679","10613973","68","80143659"
"chr7","90892268","90892523","chr15","109204312","109204554","67","18312044"
"chr7","90924779","90925070","chr3","108862348","108862644","36","17937569"
"chr7","91000985","91001160","chr18","12820393","12820569","40","78180592"
"chr7","91075987","91076297","chr3","108719810","108720113","32","17643823"
"chr7","91096964","91097215","chr3","108698313","108698563","21","17601349"
"chr7","91343109","91343243","chr3","108437811","108437952","23","17094702"
"chr7","91343522","91343701","chrX","148597346","148597520","56","57253824"
"chr7","91549484","91549607","chr3","108193556","108193688","19","16644072"
"chr7","91750530","91750827","chr3","108005565","108005873","39","16255035"
"chr7","91803914","91804114","chr4","137840969","137841167","48","46037055"
"chr7","91823050","91823417","chr2","56386837","56387173","119","35436213"
"chr7","91991966","91992253","chr3","107774016","107774294","32","15782050"
"chr7","92065516","92065776","chr3","107710660","107710933","38","15645144"
"chr7","92440548","92440835","chr3","107323071","107323369","31","14882523"
"chr7","92494639","92494936","chr3","107268297","107268598","23","14773658"
"chr7","92627436","92627732","chr3","107123378","107123672","26","14495942"
"chr7","92688088","92688366","chr3","107070117","107070407","32","14382029"
"chr7","92764141","92764371","chr3","107003421","107003655","23","14239280"
"chr7","92802442","92802703","chr3","106966294","106966543","27","14163852"
"chr7","92826555","92826841","chr5","22397555","22397847","62","70429000"
"chr7","92827545","92827841","chr3","106940028","106940338","35","14112483"
"chr7","92843621","92843917","chr3","106924028","106924294","47","14080407"
"chr7","92855874","92856002","chr3","106913934","106914063","18","14058060"
"chr7","92856302","92856464","chr3","106913451","106913631","37","14057149"
"chr7","92867517","92867780","chr3","106901827","106902090","15","14034310"
"chr7","92869745","92870044","chr3","106899306","106899603","24","14029561"
"chr7","92899054","92899336","chr3","106874760","106875062","45","13975706"
"chr7","92976984","92977304","chr9","39006809","39007106","97","53970175"
"chr7","92980550","92980828","chr3","106786916","106787206","21","13806366"
"chr7","93015945","93016247","chr9","129382548","129382853","55","36366603"
"chr7","93040186","93040310","chr3","106718361","106718485","7","13678175"
"chr7","93043229","93043532","chr3","106715124","106715442","31","13671895"
"chr7","93085602","93085932","chr3","106661973","106662292","25","13576371"
"chr7","93093468","93093712","chr19","46256590","46256844","64","46836878"
"chr7","93194957","93195163","chr3","106550277","106550472","23","13355320"
"chr7","93205141","93205420","chr3","106540281","106540560","11","13335140"
"chr7","93250622","93250815","chr3","106432599","106432803","29","13181977"
"chr7","93253279","93253583","chr3","106429778","106430104","48","13176499"
"chr7","93265736","93266051","chr3","106417412","106417709","43","13151676"
"chr7","93282618","93282916","chr6","35025991","35026298","67","58256627"
"chr7","93306444","93306624","chr3","106378211","106378383","18","13071767"
"chr7","93318211","93318522","chr3","106364483","106364788","22","13046272"
"chr7","93344153","93344458","chr3","106339081","106339361","57","12994928"
"chr7","93403598","93403909","chr3","106303603","106303908","20","12900005"
"chr7","93405077","93405371","chr9","23116704","23116994","62","70288373"
"chr7","93448143","93448433","chr3","106255431","106255736","36","12807288"
"chr7","93497460","93497757","chr3","106205103","106205399","26","12707643"
"chr7","93500036","93500326","chr3","106202815","106203120","34","12702779"
"chr7","93555423","93555542","chr4","70720225","70720347","24","22835198"
"chr7","93613598","93613942","chr19","6953784","6954109","86","86659814"
"chr7","93658172","93658466","chr3","106041761","106042055","17","12383589"
"chr7","93661576","93661897","chr3","106038337","106038659","17","12376761"
"chr7","93666585","93666902","chr3","106033363","106033661","49","12366778"
"chr7","93694204","93694506","chr3","106005706","106006010","27","12311502"
"chr7","93697355","93697590","chr3","106002405","106002620","39","12305050"
"chr7","93751323","93751615","chr8","72244479","72244763","66","21506844"
"chr7","93756972","93757281","chr3","105947325","105947648","43","12190353"
"chr7","93799438","93799745","chr3","105904884","105905196","19","12105446"
"chr7","93860000","93860279","chr3","105844982","105845267","17","11984982"
"chr7","93876372","93876678","chr3","105829916","105830219","26","11953544"
"chr7","93892463","93892590","chr3","105814583","105814718","20","11922120"
"chr7","93896529","93896809","chr3","105810424","105810726","41","11913895"
"chr7","93987912","93988222","chr3","105720183","105720495","34","11732271"
"chr7","94017848","94018073","chr3","105690308","105690530","31","11672460"
"chr7","94106282","94106558","chr3","105604270","105604552","19","11497988"
"chr7","94220214","94220440","chr19","29380231","29380468","54","64839983"
"chr7","94299708","94300009","chr3","105407430","105407731","23","11107722"
"chr7","94302229","94302547","chrX","100630173","100630473","75","6327944"
"chr7","94356173","94356452","chr3","105342510","105342788","22","10986337"
"chr7","94381100","94381383","chr3","105316704","105316986","33","10935604"
"chr7","94407424","94407722","chr3","105288369","105288660","45","10880945"
"chr7","94452308","94452608","chr6","161557509","161557798","61","67105201"
"chr7","94578221","94578338","chr1","109971249","109971366","16","15393028"
"chr7","94583304","94583580","chr5","25436975","25437257","58","69146329"
"chr7","94694607","94694785","chr3","45094502","45094681","29","49600105"
"chr7","94901300","94901588","chr1","160551781","160552083","68","65650481"
"chr7","94987194","94987477","chr3","104687146","104687447","34","9699952"
"chr7","95120646","95120915","chr3","104551957","104552223","46","9431311"
"chr7","95199826","95199978","chr14","80529059","80529219","41","14670767"
"chr7","95235813","95235945","chr3","104434963","104435095","14","9199150"
"chr7","95310111","95310395","chr3","104354068","104354345","22","9043957"
"chr7","95365828","95366116","chr3","104302513","104302800","31","8936685"
"chr7","95500001","95500234","chr20","29246987","29247224","53","66253014"
"chr7","95569878","95570179","chr3","104114151","104114456","20","8544273"
"chr7","95571499","95571790","chr3","104112520","104112818","31","8541021"
"chr7","95595264","95595375","chr3","104088011","104088122","5","8492747"
"chr7","95785350","95785621","chr10","60492874","60493152","60","35292476"
"chr7","95830970","95831257","chr3","103751880","103752168","18","7920910"
"chr7","95870654","95870965","chr3","103710370","103710673","38","7839716"
"chr7","95871425","95871731","chr3","103709600","103709894","30","7838175"
"chr7","95893245","95893529","chr3","103687823","103688116","29","7794578"
"chr7","95943813","95944107","chr3","103641953","103642239","26","7698140"
"chr7","95945251","95945525","chr3","103640537","103640817","23","7695286"
"chr7","95953937","95953995","chr3","167040605","167040666","16","71086668"
"chr7","95964168","95964455","chr3","103625429","103625711","33","7661261"
"chr7","95967520","95967637","chr3","103621949","103622065","6","7654429"
"chr7","95970018","95970343","chr11","108487950","108488261","69","12517932"
"chr7","95992762","95993067","chr3","103599735","103600013","42","7606973"
"chr7","96005589","96005894","chr3","103586926","103587220","33","7581337"
"chr7","96020358","96020534","chr3","103572242","103572410","16","7551884"
"chr7","96044274","96044567","chr20","9769818","9770112","65","86274456"
"chr7","96109962","96110225","chr3","103475915","103476178","19","7365953"
"chr7","96112371","96112492","chr8","30714568","30714691","16","65397803"
"chr7","96116488","96116775","chr3","103469707","103469993","15","7353219"
"chr7","96130227","96130336","chr16","34446799","34446909","16","61683428"
"chr7","96146961","96147283","chr3","103442357","103442638","71","7295396"
"chr7","96192565","96192917","chr3","103394678","103395021","32","7202113"
"chr7","96200343","96200658","chr3","103386794","103387112","36","7186451"
"chr7","96204541","96204837","chr3","103382642","103382936","24","7178101"
"chr7","96241020","96241326","chr20","34287022","34287322","63","61953998"
"chr7","96241587","96241874","chr1","38411056","38411341","59","57830531"
"chr7","96242901","96243197","chr3","103343870","103344166","29","7100969"
"chr7","96286928","96287235","chr3","103304642","103304939","25","7017714"
"chr7","96293375","96293681","chr3","103296062","103296371","26","7002687"
"chr7","96299908","96300147","chr3","103289601","103289834","20","6989693"
"chr7","96311771","96311894","chr3","103277539","103277663","11","6965768"
"chr7","96399817","96400121","chr3","103192350","103192673","45","6792533"
"chr7","96481326","96481625","chr3","103118256","103118561","26","6636930"
"chr7","96558534","96558827","chr3","102993860","102994153","21","6435326"
"chr7","96576971","96577254","chr3","102976121","102976385","41","6399150"
"chr7","96590156","96590460","chr3","102964213","102964515","30","6374057"
"chr7","96662683","96662800","chr3","102889129","102889245","10","6226446"
"chr7","96682888","96683170","chr3","102875320","102875604","22","6192432"
"chr7","96737538","96737817","chr3","102816937","102817215","20","6079399"
"chr7","96757041","96757316","chr3","102797175","102797453","25","6040134"
"chr7","96761662","96761949","chrX","6404367","6404658","69","90357295"
"chr7","96837382","96837677","chr3","102655490","102655787","27","5818108"
"chr7","96847952","96848232","chr3","102644580","102644863","20","5796628"
"chr7","96857368","96857678","chr3","102635018","102635333","26","5777650"
"chr7","96860130","96860424","chr3","102631975","102632265","24","5771845"
"chr7","96868159","96868420","chr3","102623994","102624266","25","5755835"
"chr7","96881854","96882154","chr3","47567768","47568083","60","49314086"
"chr7","96908770","96909073","chr3","102582330","102582638","37","5673560"
"chr7","96962319","96962612","chr3","102530512","102530815","31","5568193"
"chr7","97029437","97029682","chr3","102475567","102475816","20","5446130"
"chr7","97066877","97067130","chr10","80116427","80116688","58","16950450"
"chr7","97073344","97073626","chr3","102423631","102423913","18","5350287"
"chr7","97301382","97301682","chr3","102219166","102219446","34","4917784"
"chr7","97330340","97330639","chr2","84913076","84913368","58","12417264"
"chr7","97373483","97373769","chr3","102143894","102144182","20","4770411"
"chr7","97378839","97379118","chr3","102138513","102138815","50","4759674"
"chr7","97444253","97444537","chr3","102066157","102066438","20","4621904"
"chr7","97470871","97471151","chr3","102032505","102032768","39","4561634"
"chr7","97494812","97495122","chr20","58197268","58197580","56","39297544"
"chr7","97509330","97509620","chr3","101997387","101997694","36","4488057"
"chr7","97521691","97521910","chr7","114021627","114021842","58","16499936"
"chr7","97529367","97529661","chrX","126328105","126328399","52","28798738"
"chr7","97542220","97542494","chr3","101967311","101967556","47","4425091"
"chr7","97550469","97550745","chr10","29962056","29962344","60","67588413"
"chr7","97555497","97555757","chr3","101953270","101953531","17","4397773"
"chr7","97573111","97573398","chr3","101932185","101932483","26","4359074"
"chr7","97590060","97590355","chr3","101916723","101917017","21","4326663"
"chr7","97606276","97606518","chr3","101900887","101901126","21","4294611"
"chr7","97606982","97607064","chr3","101900349","101900431","4","4293367"
"chr7","97607068","97607358","chr3","101900054","101900345","19","4292986"
"chr7","97608238","97608496","chr3","101898882","101899168","51","4290644"
"chr7","97625203","97625327","chr3","101883074","101883198","9","4257871"
"chr7","97631998","97632175","chr14","7837183","7837361","52","89794815"
"chr7","97713493","97713805","chr3","117399254","117399561","45","19685761"
"chr7","97745696","97746010","chr3","117431722","117432035","27","19686026"
"chr7","97765005","97765297","chr7","140588016","140588306","60","42823011"
"chr7","97791662","97791944","chr3","117461658","117461941","17","19669996"
"chr7","97799067","97799401","chr3","117469043","117469371","26","19669976"
"chr7","97806915","97807199","chr3","117477133","117477416","23","19670218"
"chr7","97864758","97865048","chr3","117543132","117543422","17","19678374"
"chr7","97868454","97868738","chr3","117547667","117547963","36","19679213"
"chr7","97872329","97872461","chr3","39810823","39810958","21","58061506"
"chr7","97872756","97872932","chr5","39688759","39688932","35","58183997"
"chr7","97908847","97909151","chr20","26132723","26133020","54","71776124"
"chr7","97914500","97914781","chr3","117581391","117581657","34","19666891"
"chr7","97945060","97945364","chr3","117613920","117614228","23","19668860"
"chr7","97962336","97962639","chr3","117631774","117632077","12","19669438"
"chr7","97966133","97966262","chr1","117811669","117811797","21","19845536"
"chr7","98014897","98015206","chr3","117674307","117674619","25","19659410"
"chr7","98022859","98023160","chr3","117682762","117683060","19","19659903"
"chr7","98030090","98030395","chr3","117691215","117691526","19","19661125"
"chr7","98060164","98060454","chr6","176458169","176458462","54","78398005"
"chr7","98080580","98080708","chr3","117770435","117770559","21","19689855"
"chr7","98106614","98106738","chr9","68738518","68738642","16","29368096"
"chr7","98114811","98115094","chr3","117805520","117805804","15","19690709"
"chr7","98117143","98117432","chr3","117807858","117808149","18","19690715"
"chr7","98153085","98153316","chr3","117857395","117857630","27","19704310"
"chr7","98160224","98160526","chr2","77445806","77446105","56","20714418"
"chr7","98160811","98161116","chr3","117866225","117866534","23","19705414"
"chr7","98167056","98167345","chr6","69305372","69305652","60","28861684"
"chr7","98188406","98188694","chr5","158972495","158972780","54","60784089"
"chr7","98260975","98261233","chr3","117970786","117971084","51","19709811"
"chr7","98310807","98311077","chr20","20708335","20708610","57","77602472"
"chr7","98323471","98323773","chr1","146550511","146550804","63","48227040"
"chr7","98406138","98406442","chr3","118121434","118121733","16","19715296"
"chr7","98465480","98465607","chr3","118181126","118181261","17","19715646"
"chr7","98542131","98542393","chr3","118255427","118255669","39","19713296"
"chr7","98549352","98549482","chr3","118262531","118262662","6","19713179"
"chr7","98649886","98650188","chr3","118369614","118369908","29","19719728"
"chr7","98709407","98709528","chr3","118466087","118466208","7","19756680"
"chr7","99061829","99062121","chr3","118830376","118830668","18","19768547"
"chr7","99244866","99245091","chr3","119064714","119064950","23","19819848"
"chr7","99264336","99264603","chr3","119084670","119084934","25","19820334"
"chr7","99406518","99406835","chr3","119233346","119233660","25","19826828"
"chr7","99433407","99433715","chr3","119260142","119260441","26","19826735"
"chr7","99458623","99458726","chr3","119286166","119286257","22","19827543"
"chr7","99523757","99524054","chr13","48098897","48099205","59","51424860"
"chr7","99618521","99618645","chr19","37005197","37005307","30","62613324"
"chr7","99618882","99618919","chr2","61642245","61642286","10","37976637"
"chr7","99901311","99901588","chr3","119716994","119717271","17","19815683"
"chr7","99916860","99917175","chr3","119732170","119732459","62","19815310"
"chr7","99925344","99925596","chr3","119742008","119742269","24","19816664"
"chr7","100045367","100045671","chrX","17672800","17673101","51","82372567"
"chr7","100109322","100109590","chr3","119921888","119922156","18","19812566"
"chr7","100235043","100235301","chr3","120051639","120051920","49","19816596"
"chr7","100287816","100288103","chr3","120105057","120105362","35","19817241"
"chr7","100346294","100346553","chr5","122989508","122989772","68","22643214"
"chr7","100429393","100429566","chr4","118310602","118310776","43","17881209"
"chr7","100429898","100430033","chr8","39319135","39319268","26","61110763"
"chr7","100432158","100432489","chr2","165334861","165335167","79","64902703"
"chr7","100436410","100436530","chr1","188493066","188493186","18","88056656"
"chr7","100480345","100480496","chr3","120287898","120288049","4","19807553"
"chr7","100518872","100519179","chr3","120328525","120328820","36","19809653"
"chr7","100555237","100555525","chr1","44972296","44972592","59","55582941"
"chr7","100585324","100585381","chr3","120398254","120398303","9","19812930"
"chr7","100589438","100589773","chr3","120402385","120402708","47","19812947"
"chr7","100609843","100610153","chr3","120422799","120423103","26","19812956"
"chr7","100627106","100627393","chr3","120436828","120437119","20","19809722"
"chr7","100650332","100650445","chr3","120459639","120459751","9","19809307"
"chr7","100702543","100702653","chr6","139383516","139383625","17","38680973"
"chr7","100738969","100739261","chr3","120550831","120551128","26","19811862"
"chr7","100755257","100755541","chr3","120571261","120571545","20","19816004"
"chr7","100820333","100820635","chr3","120631770","120632051","40","19811437"
"chr7","100837180","100837342","chr3","120649010","120649177","12","19811830"
"chr7","100958208","100958503","chr3","120765240","120765533","28","19807032"
"chr7","100968283","100968594","chr3","120775115","120775424","25","19806832"
"chr7","100975413","100975538","chr9","41126160","41126284","19","59849253"
"chr7","100977373","100977680","chr3","120784102","120784409","17","19806729"
"chr7","100982576","100982700","chr3","120789320","120789443","6","19806744"
"chr7","101003750","101004044","chr3","120816627","120816936","45","19812877"
"chr7","101010696","101010936","chr3","120823484","120823716","27","19812788"
"chr7","101045381","101045684","chr3","120857368","120857680","21","19811987"
"chr7","101050953","101051268","chr3","120862625","120862940","11","19811672"
"chr7","101110255","101110565","chr3","120920626","120920943","24","19810371"
"chr7","101134489","101134609","chr3","120942762","120942882","7","19808273"
"chr7","101135487","101135784","chr3","120943756","120944054","23","19808269"
"chr7","101195992","101196282","chr3","121002163","121002444","26","19806171"
"chr7","101260188","101260405","chr3","121077189","121077406","16","19817001"
"chr7","101273683","101273993","chr3","121090498","121090779","52","19816815"
"chr7","101318045","101318357","chr3","121140739","121141049","25","19822694"
"chr7","101355329","101355634","chr3","121178140","121178448","16","19822811"
"chr7","101357629","101357792","chr20","10622030","10622195","39","90735599"
"chr7","101357818","101357969","chr2","182219386","182219537","44","80861568"
"chr7","101360086","101360203","chr3","50082395","50082511","17","51277691"
"chr7","101389723","101390007","chr3","121208841","121209129","21","19819118"
"chr7","101424256","101424546","chr3","121243917","121244218","38","19819661"
"chr7","101471337","101471649","chr3","121291364","121291680","27","19820027"
"chr7","101493822","101494087","chr3","121307897","121308162","27","19814075"
"chr7","101496799","101497068","chr3","121310895","121311175","21","19814096"
"chr7","101676625","101676864","chr1","38653399","38653624","53","63023226"
"chr7","101678900","101679216","chr3","121506091","121506385","48","19827191"
"chr7","101711366","101711499","chr3","121539648","121539781","13","19828282"
"chr7","101839079","101839378","chr3","121660055","121660363","24","19820976"
"chr7","101853395","101853599","chr3","121674312","121674511","18","19820917"
"chr7","101862699","101863005","chr15","14616084","14616383","58","87246615"
"chr7","101892586","101892706","chr8","320367","320492","25","101572219"
"chr7","101913795","101914089","chr13","26642857","26643150","57","75270938"
"chr7","101916134","101916301","chr16","74403178","74403342","32","27512956"
"chr7","102019537","102019660","chr3","121884887","121885010","8","19865350"
"chr7","102130973","102131233","chr3","123351694","123351976","60","21220721"
"chr7","102161727","102161920","chr20","19507699","19507894","43","82654028"
"chr7","102246863","102247180","chr3","122112100","122112406","43","19865237"
"chr7","102268220","102268505","chr3","122130325","122130611","12","19862105"
"chr7","102306116","102306309","chr3","122168112","122168299","31","19861996"
"chr7","102341970","102342101","chr3","122203970","122204096","12","19862000"
"chr7","102342389","102342599","chr3","122204420","122204607","39","19862031"
"chr7","102346517","102346802","chr3","122246970","122247255","22","19900453"
"chr7","102441940","102442242","chr3","122341113","122341418","29","19899173"
"chr7","102459617","102459897","chr3","122360384","122360664","15","19900767"
"chr7","102521370","102521631","chr3","122423403","122423668","25","19902033"
"chr7","102634342","102634656","chrX","18781652","18781959","63","83852690"
"chr7","102683775","102684078","chr3","122582082","122582390","17","19898307"
"chr7","102975273","102975501","chr3","122905625","122905853","38","19930352"
"chr7","103061146","103061270","chr7","31804546","31804669","19","71256600"
"chr7","103103857","103104125","chr3","123023600","123023859","22","19919743"
"chr7","103209899","103210060","chr1","25357979","25358141","27","77851920"
"chr7","103269305","103269601","chr3","123192888","123193184","22","19923583"
"chr7","103323527","103323816","chr3","123228013","123228300","43","19904486"
"chr7","103413158","103413420","chr3","123284741","123285007","23","19871583"
"chr7","103432769","103433070","chr3","40872068","40872376","37","62560701"
"chr7","103445315","103445537","chr3","123289148","123289370","16","19843833"
"chr7","103457763","103457905","chr3","123310289","123310418","23","19852526"
"chr7","103458203","103458363","chr3","123310724","123310893","19","19852521"
"chr7","103459430","103459732","chr3","123311848","123312162","33","19852418"
"chr7","103460719","103460805","chr10","60641694","60641772","21","42819025"
"chr7","103462566","103462864","chr11","125183756","125184048","52","21721190"
"chr7","103465525","103465827","chr14","109630730","109631041","63","6165205"
"chr7","103473935","103474225","chr5","42278676","42278963","53","61195259"
"chr7","103475661","103475935","chr7","92483796","92484065","62","10991865"
"chr7","103479227","103479506","chr3","123333458","123333733","24","19854231"
"chr7","103482739","103483042","chr3","123336068","123336378","27","19853329"
"chr7","103484526","103484830","chr3","123337786","123338101","42","19853260"
"chr7","103484835","103485108","chr3","123338106","123338389","23","19853271"
"chr7","103486317","103486594","chr3","123342372","123342664","42","19856055"
"chr7","103488754","103489037","chr3","123341157","123341443","25","19852403"
"chr7","103496849","103497163","chr3","123351694","123351976","47","19854845"
"chr7","103502884","103503005","chr2","202620772","202620898","25","99117888"
"chr7","103518704","103519004","chr3","123371477","123371791","39","19852773"
"chr7","103520120","103520421","chr3","123373814","123374119","35","19853694"
"chr7","103520764","103521092","chr7","45487943","45488254","71","58032821"
"chr7","103525845","103526147","chrX","30604149","30604445","54","72921696"
"chr7","103526361","103526665","chr3","123380863","123381174","29","19854502"
"chr7","103539958","103540264","chr3","123395963","123396266","17","19856005"
"chr7","103541633","103541906","chr6","52071946","52072221","63","51469687"
"chr7","103548590","103548898","chr3","123408497","123408811","29","19859907"
"chr7","103552518","103552807","chr3","123412788","123413082","23","19860270"
"chr7","103553062","103553191","chr9","97270771","97270897","18","6282291"
"chr7","103555481","103555717","chr3","123415571","123415812","35","19860090"
"chr7","103556897","103557185","chr11","1767086","1767360","53","101789811"
"chr7","103561394","103561675","chr3","123420704","123420986","12","19859310"
"chr7","103567887","103568189","chr3","123427553","123427848","23","19859666"
"chr7","103578036","103578227","chr3","123438179","123438379","22","19860143"
"chr7","103578601","103578714","chr3","123438754","123438867","4","19860153"
"chr7","103579399","103579715","chr3","123439865","123440181","27","19860466"
"chr7","103581055","103581363","chr3","123441764","123442072","25","19860709"
"chr7","103586770","103587067","chr3","123447940","123448255","52","19861170"
"chr7","103589542","103589829","chr3","123450902","123451191","34","19861360"
"chr7","103600324","103600639","chrX","117878386","117878697","58","14278062"
"chr7","103605738","103606043","chr15","26678342","26678643","71","76927396"
"chr7","103612156","103612445","chr2","104445382","104445669","56","833226"
"chr7","103618658","103618942","chr3","123484858","123485141","24","19866200"
"chr7","103630504","103630624","chr10","29589654","29589765","27","74040850"
"chr7","103653520","103653644","chr3","123522771","123522897","15","19869251"
"chr7","103662626","103662895","chr3","123531833","123532101","31","19869207"
"chr7","103666696","103666976","chr3","123535554","123535849","30","19868858"
"chr7","103669408","103669711","chr3","123538631","123538929","25","19869223"
"chr7","103690057","103690328","chr3","123560578","123560812","62","19870521"
"chr7","103694313","103694623","chr3","123564892","123565202","28","19870579"
"chr7","103699304","103699613","chr3","123569897","123570196","44","19870593"
"chr7","103700196","103700487","chr3","123570746","123571070","45","19870550"
"chr7","103707940","103708130","chr3","123581455","123581658","37","19873515"
"chr7","103711203","103711479","chr3","123584954","123585236","28","19873751"
"chr7","103711749","103712062","chr3","123585503","123585819","30","19873754"
"chr7","103721371","103721665","chr3","123596266","123596573","37","19874895"
"chr7","103727893","103728173","chr3","123602206","123602481","40","19874313"
"chr7","103736165","103736467","chr11","116556340","116556646","82","12820175"
"chr7","103739513","103739678","chr12","10462851","10463007","29","93276662"
"chr7","103739969","103740090","chr7","125865849","125865964","22","22125880"
"chr7","103741142","103741397","chr1","37126383","37126644","54","66614759"
"chr7","103742557","103742857","chr3","123614097","123614392","32","19871540"
"chr7","103743511","103743813","chr3","41028526","41028824","71","62714985"
"chr7","103745347","103745651","chr3","123618206","123618497","47","19872859"
"chr7","103745728","103745998","chr3","123618554","123618821","29","19872826"
"chr7","103767572","103767865","chr3","123641474","123641765","28","19873902"
"chr7","103773277","103773563","chr3","123647919","123648206","18","19874642"
"chr7","103779915","103780219","chr3","123654518","123654822","27","19874603"
"chr7","103791179","103791366","chr12","10438108","10438293","48","93353071"
"chr7","103824713","103825012","chr3","123699206","123699496","34","19874493"
"chr7","103826174","103826345","chr3","123700657","123700843","27","19874483"
"chr7","103826647","103826766","chr3","123701140","123701259","6","19874493"
"chr7","103831132","103831434","chr3","123706160","123706468","27","19875028"
"chr7","103833301","103833461","chr4","160825138","160825301","37","56991837"
"chr7","103840626","103840914","chr3","35342054","35342344","53","68498572"
"chr7","103842745","103843049","chr2","56487045","56487341","63","47355700"
"chr7","103849374","103849505","chr13","107548702","107548834","18","3699328"
"chr7","103869817","103870117","chr3","123744370","123744678","27","19874553"
"chr7","103873750","103873917","chr7","153688648","153688814","28","49814898"
"chr7","103874059","103874178","chr11","70573457","70573574","15","33300602"
"chr7","103876333","103876624","chr3","123752481","123752753","57","19876148"
"chr7","103890663","103890984","chr3","123772419","123772740","29","19881756"
"chr7","103891929","103892097","chr3","123773694","123773859","13","19881765"
"chr7","103892182","103892489","chr3","123773944","123774273","42","19881762"
"chr7","103894114","103894400","chr3","123783786","123784089","39","19889672"
"chr7","103896970","103897220","chr3","123787783","123788028","24","19890813"
"chr7","103900239","103900342","chr15","28416570","28416671","19","75483669"
"chr7","103911418","103911643","chr3","123807829","123808054","17","19896411"
"chr7","103912047","103912237","chr2","44064217","44064411","33","59847830"
"chr7","103914472","103914606","chr19","1367912","1368045","18","102546560"
"chr7","103914607","103914894","chr9","95575173","95575462","63","8339434"
"chr7","103919552","103919866","chr3","123812985","123813278","40","19893433"
"chr7","103924861","103925140","chr3","123818965","123819243","19","19894104"
"chr7","103945141","103945452","chr3","123840080","123840394","18","19894939"
"chr7","103946242","103946542","chr3","123841197","123841498","29","19894955"
"chr7","103956162","103956269","chr11","109358164","109358269","14","5402002"
"chr7","103957396","103957599","chr17","5229611","5229823","42","98727785"
"chr7","103962523","103962844","chr3","123585503","123585819","66","19622980"
"chr7","103965015","103965314","chr3","123859389","123859706","38","19894374"
"chr7","103966892","103967126","chr3","123861324","123861559","17","19894432"
"chr7","103969855","103970077","chr7","54288564","54288786","49","49681291"
"chr7","103977801","103977928","chr3","123873297","123873424","8","19895496"
"chr7","103980845","103981127","chr10","33219167","33219456","66","70761678"
"chr7","103983523","103983735","chr11","112699213","112699425","38","8715690"
"chr7","103983905","103983952","chr13","87327185","87327230","6","16656720"
"chr7","103985186","103985449","chr3","123880478","123880748","21","19895292"
"chr7","103985778","103986077","chr16","68450975","68451269","64","35534803"
"chr7","104000090","104000386","chr3","123893992","123894289","21","19893902"
"chr7","104001270","104001574","chr3","123895153","123895457","26","19893883"
"chr7","104005351","104005627","chr3","123898417","123898701","25","19893066"
"chr7","104006830","104007131","chr3","123899920","123900224","22","19893090"
"chr7","104007524","104007828","chr3","123900618","123900920","18","19893094"
"chr7","104009566","104009861","chr3","123903117","123903425","32","19893551"
"chr7","104009974","104010275","chr3","123903538","123903830","27","19893564"
"chr7","104011364","104011665","chr3","123904942","123905252","41","19893578"
"chr7","104023401","104023673","chr16","55700437","55700720","56","48322964"
"chr7","104024566","104024866","chr3","123917420","123917724","33","19892854"
"chr7","104036046","104036338","chr3","123929347","123929648","34","19893301"
"chr7","104038110","104038412","chr3","123931914","123932216","21","19893804"
"chr7","104055281","104055567","chr3","123949355","123949641","18","19894074"
"chr7","104057071","104057349","chr3","123951154","123951441","27","19894083"
"chr7","104061094","104061385","chr3","123955747","123956059","49","19894653"
"chr7","104062428","104062719","chr3","123958408","123958700","30","19895980"
"chr7","104065012","104065212","chr3","123960104","123960289","28","19895092"
"chr7","104067134","104067445","chr3","123962238","123962545","30","19895104"
"chr7","104071326","104071624","chr16","11545677","11545975","63","92525649"
"chr7","104071891","104072097","chr3","123966580","123966784","23","19894689"
"chr7","104073287","104073501","chr3","123967981","123968199","18","19894694"
"chr7","104091699","104091962","chr3","123986268","123986570","52","19894569"
"chr7","104104345","104104642","chr3","124002644","124002941","8","19898299"
"chr7","104104858","104105156","chr3","124003157","124003450","23","19898299"
"chr7","104108863","104108993","chr3","124007176","124007306","12","19898313"
"chr7","104111914","104112085","chr3","124010397","124010549","26","19898483"
"chr7","104112351","104112484","chr3","124010843","124010980","16","19898492"
"chr7","104120980","104121187","chr3","124025342","124025516","39","19904362"
"chr7","104127844","104128142","chr7","53430469","53430755","61","50697375"
"chr7","104133126","104133441","chr3","124037705","124038025","46","19904579"
"chr7","104136320","104136620","chr3","124041012","124041334","39","19904692"
"chr7","104143648","104143963","chr3","124048410","124048726","22","19904762"
"chr7","104144842","104145138","chr3","124049597","124049892","19","19904755"
"chr7","104152093","104152246","chr1","22995824","22995974","29","81156269"
"chr7","104152557","104152695","chr3","50473069","50473212","19","53679488"
"chr7","104170121","104170432","chr3","124075952","124076241","37","19905831"
"chr7","104174417","104174723","chr3","124080953","124081238","43","19906536"
"chr7","104178262","104178559","chr16","31596976","31597275","62","72581286"
"chr7","104182406","104182694","chr3","124089950","124090244","37","19907544"
"chr7","104186455","104186753","chr3","124093075","124093372","29","19906620"
"chr7","104193799","104194039","chr3","124101292","124101540","31","19907493"
"chr7","104198848","104198984","chr3","124107264","124107387","24","19908416"
"chr7","104199282","104199386","chr3","124107692","124107797","13","19908410"
"chr7","104203440","104203717","chr3","124111848","124112138","32","19908408"
"chr7","104204489","104204789","chr3","124112928","124113235","30","19908439"
"chr7","104211292","104211576","chr3","124121508","124121762","52","19910216"
"chr7","104214583","104214861","chr3","2302914","2303193","64","101911669"
"chr7","104219614","104219919","chr15","1554629","1554929","54","102664985"
"chr7","104226442","104226716","chr3","43572948","43573229","60","60653494"
"chr7","104235013","104235315","chr3","124189124","124189424","19","19954111"
"chr7","104239245","104239378","chr3","124193345","124193463","22","19954100"
"chr7","104239599","104239810","chr3","30241225","30241450","57","73998374"
"chr7","104240242","104240469","chr3","124194810","124195040","21","19954568"
"chr7","104243716","104244036","chr3","124198299","124198619","32","19954583"
"chr7","104244672","104244979","chr3","124199253","124199561","29","19954581"
"chr7","104245533","104245691","chr3","124200097","124200249","19","19954564"
"chr7","104246001","104246147","chr4","157639029","157639171","25","53393028"
"chr7","104248193","104248355","chr3","124202196","124202354","17","19954003"
"chr7","104255216","104255517","chr3","124209366","124209656","35","19954150"
"chr7","104258347","104258605","chrX","23103607","23103876","56","81154740"
"chr7","104261377","104261543","chr3","124214530","124214701","17","19953153"
"chr7","104261878","104262063","chr3","124215034","124215217","29","19953156"
"chr7","104266336","104266643","chr3","124219906","124220208","24","19953570"
"chr7","104267178","104267374","chr3","124221074","124221275","22","19953896"
"chr7","104276547","104276836","chr3","124230038","124230316","20","19953491"
"chr7","104284769","104285056","chr3","124235279","124235566","21","19950510"
"chr7","104287425","104287721","chr3","124237937","124238232","18","19950512"
"chr7","104302953","104303245","chr3","124253131","124253435","64","19950178"
"chr7","104310892","104311189","chr3","124261238","124261514","37","19950346"
"chr7","104313604","104313901","chr3","124263856","124264123","51","19950252"
"chr7","104315482","104315766","chr19","2356197","2356485","53","101959285"
"chr7","104316497","104316803","chr3","124265774","124266077","21","19949277"
"chr7","104325731","104325923","chr7","39788872","39789057","40","64536859"
"chr7","104326217","104326345","chr2","91690263","91690400","27","12635954"
"chr7","104331545","104331833","chr3","124280443","124280730","33","19948898"
"chr7","104331856","104332117","chr3","124280745","124281005","15","19948889"
"chr7","104337299","104337602","chr3","124286205","124286493","30","19948906"
"chr7","104347997","104348271","chr3","124296724","124297023","45","19948727"
"chr7","104349343","104349610","chr3","124298184","124298447","26","19948841"
"chr7","104350014","104350204","chr3","124298862","124299052","20","19948848"
"chr7","104361808","104362120","chr13","75093610","75093915","70","29268198"
"chr7","104363057","104363371","chr3","124312496","124312797","31","19949439"
"chr7","104367017","104367136","chr3","124316520","124316639","13","19949503"
"chr7","104374730","104374934","chr8","53742132","53742330","61","50632598"
"chr7","104402341","104402523","chr3","38240090","38240274","35","66162251"
"chr7","104402820","104402941","chr19","36174729","36174852","26","68228091"
"chr7","104405496","104405668","chr2","119060253","119060421","36","14654757"
"chr7","104405980","104405990","chr10","32485365","32485375","2","71920615"
"chr7","104410505","104410619","chr3","124359741","124359856","10","19949236"
"chr7","104422496","104422785","chr3","124372626","124372904","22","19950130"
"chr7","104423885","104424068","chr3","124374010","124374185","23","19950125"
"chr7","104446035","104446327","chr3","124394457","124394755","24","19948422"
"chr7","104491093","104491389","chr3","124440601","124440898","23","19949508"
"chr7","104504426","104504534","chr7","166133090","166133203","21","61628664"
"chr7","104518388","104518691","chr3","124467614","124467917","19","19949226"
"chr7","104527436","104527719","chr7","140100928","140101221","66","35573492"
"chr7","104535377","104535565","chr19","15032352","15032540","34","89503025"
"chr7","104536531","104536809","chr3","124486790","124487069","24","19950259"
"chr7","104538313","104538599","chr3","40783093","40783379","60","63755220"
"chr7","104541498","104541802","chr3","124490507","124490810","20","19949009"
"chr7","104542567","104542821","chr3","124491579","124491832","13","19949012"
"chr7","104545401","104545477","chr19","32703576","32703654","15","71841825"
"chr7","104547082","104547351","chr3","124498682","124498949","24","19951600"
"chr7","104560611","104560925","chr19","41900012","41900311","60","62660599"
"chr7","104574666","104574885","chr3","124525520","124525743","19","19950854"
"chr7","104576302","104576587","chr6","63212874","63213160","62","41363428"
"chr7","104592339","104592534","chr11","133200379","133200578","59","28608040"
"chr7","104596877","104597158","chr3","124550628","124550907","27","19953751"
"chr7","104601021","104601145","chr15","91152840","91152964","12","13448181"
"chr7","104603025","104603309","chr3","124556687","124556966","38","19953662"
"chr7","104605090","104605342","chr3","124559124","124559376","16","19954034"
"chr7","104621436","104621559","chr1","83361255","83361383","29","21260181"
"chr7","104622209","104622482","chr3","124576519","124576804","49","19954310"
"chr7","104630154","104630380","chr3","128728563","128728790","41","24098409"
"chr7","104630381","104630549","chr3","124587370","124587535","8","19956989"
"chr7","104635723","104636016","chr9","23116704","23116994","51","81519019"
"chr7","104640836","104641118","chr3","124597782","124598076","46","19956946"
"chr7","104647520","104647776","chr17","31455377","31455623","67","73192143"
"chr7","104650915","104651039","chr8","30714568","30714691","19","73936347"
"chr7","104658068","104658365","chr3","124613473","124613736","49","19955405"
"chr7","104660134","104660301","chr11","461319","461484","56","104198815"
"chr7","104660602","104660706","chr15","25344931","25345032","17","79315671"
"chr7","104663743","104663899","chrX","19470669","19470831","32","85193074"
"chr7","104665502","104665787","chr3","124621999","124622294","35","19956497"
"chr7","104665926","104666043","chr1","148386664","148386780","20","43720738"
"chr7","104666749","104667060","chr11","113220012","113220319","62","8553263"
"chr7","104677194","104677473","chr3","124634402","124634686","25","19957208"
"chr7","104677691","104677973","chr3","124634905","124635185","22","19957214"
"chr7","104679568","104679871","chr3","124636800","124637101","24","19957232"
"chr7","104682544","104682851","chr3","124639711","124640018","36","19957167"
"chr7","104685420","104685722","chr7","135915339","135915632","66","31229919"
"chr7","104686222","104686510","chr3","124643834","124644131","29","19957612"
"chr7","104688644","104688923","chr3","124645870","124646157","45","19957226"
"chr7","104688963","104689255","chr3","124646204","124646478","49","19957241"
"chr7","104690965","104691193","chr7","40089149","40089394","72","64601816"
"chr7","104693820","104694108","chr3","124652219","124652507","17","19958399"
"chr7","104699980","104700187","chr8","144166719","144166924","39","39466739"
"chr7","104703541","104703692","chr10","37946367","37946508","28","66757174"
"chr7","104704000","104704175","chr19","5460745","5460916","35","99243255"
"chr7","104704707","104705004","chr3","124664494","124664793","26","19959787"
"chr7","104710440","104710746","chr3","124670285","124670595","30","19959845"
"chr7","104712594","104712778","chr3","124672938","124673111","26","19960344"
"chr7","104713096","104713231","chr1","128086244","128086378","22","23373148"
"chr7","104714518","104714811","chr3","124674830","124675137","51","19960312"
"chr7","104718163","104718445","chr3","124678563","124678851","19","19960400"
"chr7","104719965","104720271","chr3","124680323","124680623","16","19960358"
"chr7","104723514","104723831","chr3","124684511","124684826","26","19960997"
"chr7","104728067","104728353","chr3","124689093","124689380","23","19961026"
"chr7","104732593","104732961","chr8","23000386","23000729","113","81732207"
"chr7","104733917","104734089","chr12","87917476","87917649","33","16816441"
"chr7","104734756","104735072","chr7","131944896","131945201","65","27210140"
"chr7","104749231","104749527","chr3","124709920","124710214","28","19960689"
"chr7","104752139","104752500","chr8","54263849","54264215","121","50488290"
"chr7","104755008","104755280","chr3","124716240","124716510","22","19961232"
"chr7","104758863","104759045","chr8","97941070","97941252","42","6817793"
"chr7","104760057","104760340","chr3","124726311","124726602","24","19966254"
"chr7","104763887","104764191","chr3","124730166","124730495","42","19966279"
"chr7","104765923","104766101","chr3","48266522","48266696","34","56499401"
"chr7","104767190","104767297","chr3","124733550","124733659","8","19966360"
"chr7","104774522","104774786","chr4","51801264","51801515","59","52973258"
"chr7","104776118","104776385","chr3","124742496","124742769","30","19966378"
"chr7","104778125","104778420","chr3","124744666","124744966","26","19966541"
"chr7","104779029","104779315","chr3","124745574","124745876","52","19966545"
"chr7","104780414","104780717","chr3","124746920","124747241","33","19966506"
"chr7","104788221","104788513","chr3","124754769","124755061","26","19966548"
"chr7","104802727","104802818","chr3","124769586","124769677","4","19966859"
"chr7","104812258","104812391","chr3","124779313","124779446","3","19967055"
"chr7","104814687","104814972","chr3","124781876","124782176","45","19967189"
"chr7","104822416","104822727","chr3","124789657","124789947","37","19967241"
"chr7","104824396","104824718","chr1","18420676","18420991","57","86403720"
"chr7","104825981","104826272","chr3","124793225","124793516","32","19967244"
"chr7","104836499","104836756","chr13","71324585","71324849","64","33511914"
"chr7","104838908","104839096","chr3","124805692","124805866","28","19966784"
"chr7","104840503","104840627","chr6","170666909","170667032","17","65826406"
"chr7","104847880","104848008","chr3","124813543","124813667","13","19965663"
"chr7","104848306","104848475","chr3","124813963","124814133","19","19965657"
"chr7","104852040","104852323","chr3","124819073","124819351","19","19967033"
"chr7","104858365","104858648","chr3","124824263","124824537","39","19965898"
"chr7","104864826","104865088","chr3","48105482","48105749","54","56759344"
"chr7","104874002","104874320","chr3","124840532","124840836","38","19966530"
"chr7","104904182","104904300","chr2","202498707","202498823","15","97594525"
"chr7","104907722","104907962","chr3","124871156","124871399","20","19963434"
"chr7","104910927","104911157","chr3","124874368","124874594","19","19963441"
"chr7","104911774","104912078","chr3","124875214","124875504","28","19963440"
"chr7","104913075","104913377","chr3","124876201","124876470","61","19963126"
"chr7","104942472","104942680","chr5","78578822","78579040","50","26363650"
"chr7","104976160","104976269","chr2","93071221","93071331","23","11904939"
"chr7","104986564","104986872","chr3","124954454","124954754","47","19967890"
"chr7","104998878","104999143","chr3","124969168","124969425","19","19970290"
"chr7","105000733","105001016","chr1","195814241","195814525","43","90813508"
"chr7","105002602","105002912","chr3","124971874","124972187","22","19969272"
"chr7","105010112","105010238","chr3","50142617","50142746","20","54867495"
"chr7","105011082","105011405","chr3","124980119","124980437","48","19969037"
"chr7","105013458","105013769","chr3","124982395","124982698","31","19968937"
"chr7","105015209","105015427","chr15","5304276","5304492","50","99710933"
"chr7","105019378","105019626","chr3","124988390","124988633","27","19969012"
"chr7","105034725","105034848","chr3","125003500","125003624","10","19968775"
"chr7","105049716","105049831","chr3","125019580","125019695","7","19969864"
"chr7","105076559","105076830","chr3","125038254","125038527","17","19961695"
"chr7","105079977","105080262","chr19","8077508","8077785","54","97002469"
"chr7","105080848","105081139","chr3","125043326","125043594","40","19962478"
"chr7","105082243","105082541","chr3","125045041","125045343","24","19962798"
"chr7","105083796","105083953","chr3","125046611","125046768","11","19962815"
"chr7","105090758","105091030","chr3","125054300","125054568","23","19963542"
"chr7","105091352","105091641","chr3","125054884","125055160","32","19963532"
"chr7","105095937","105096160","chr3","125059551","125059780","17","19963614"
"chr7","105107771","105108048","chr8","68025108","68025400","57","37082663"
"chr7","105151016","105151288","chr3","125115091","125115365","17","19964075"
"chr7","105212317","105212622","chr3","125172842","125173146","28","19960525"
"chr7","105261799","105262074","chr3","125297444","125297748","51","20035645"
"chr7","105286830","105287139","chrX","66944404","66944712","68","38342426"
"chr7","105319442","105319542","chr3","125361019","125361119","6","20041577"
"chr7","105366662","105366945","chr3","125408882","125409145","27","20042220"
"chr7","105414877","105415178","chr3","125456672","125456975","30","20041795"
"chr7","105420495","105420761","chr3","125462280","125462553","51","20041785"
"chr7","105456178","105456477","chr3","125496969","125497272","25","20040791"
"chr7","105458403","105458686","chr3","125499177","125499461","15","20040774"
"chr7","105463602","105463904","chr3","125504365","125504661","30","20040763"
"chr7","105469937","105470235","chr3","125511631","125511925","28","20041694"
"chr7","105472118","105472429","chr3","125514119","125514427","22","20042001"
"chr7","105490289","105490590","chr3","125533771","125534071","21","20043482"
"chr7","105492952","105493149","chrX","4057388","4057588","38","101435564"
"chr7","105500492","105500795","chr3","125545934","125546233","26","20045442"
"chr7","105511803","105512024","chr14","9611892","9612110","57","95899911"
"chr7","105514533","105514749","chr19","39028175","39028394","58","66486358"
"chr7","105521086","105521428","chr3","500655","500980","99","105020431"
"chr7","105527508","105527709","chr3","125573332","125573512","35","20045824"
"chr7","105536076","105536340","chr3","125584463","125584723","32","20048387"
"chr7","105537320","105537475","chr3","125587990","125588145","15","20050670"
"chr7","105537781","105537908","chr3","125588416","125588535","15","20050635"
"chr7","105548397","105548692","chr3","125598788","125599095","33","20050391"
"chr7","105557032","105557339","chr3","125609643","125609951","17","20052611"
"chr7","105571841","105572122","chr3","125624168","125624441","38","20052327"
"chr7","105573012","105573337","chr1","182642228","182642528","71","77069216"
"chr7","105580199","105580498","chr3","125632699","125632995","33","20052500"
"chr7","105583818","105583910","chr19","34337353","34337449","25","71246465"
"chr7","105584024","105584154","chr1","207476913","207477027","42","101892889"
"chr7","105586786","105587075","chr3","125640068","125640323","55","20053282"
"chr7","105591770","105591892","chr3","125644725","125644847","15","20052955"
"chr7","105594029","105594121","chr17","19984851","19984943","25","85609178"
"chr7","105594905","105595200","chr14","4227776","4228060","66","101367129"
"chr7","105597069","105597194","chr7","82687570","82687688","32","22909499"
"chr7","105597500","105597647","chr16","48023623","48023770","38","57573877"
"chr7","105600116","105600319","chr3","125665919","125666111","28","20065803"
"chr7","105614479","105614684","chr3","125681258","125681464","10","20066779"
"chr7","105615370","105615690","chr10","69564648","69564947","88","36050722"
"chr7","105626352","105626645","chr3","125691797","125692081","27","20065445"
"chr7","105628718","105628837","chr3","125694823","125694955","22","20066105"
"chr7","105629146","105629156","chr16","2538107","2538118","3","103091039"
"chr7","105629602","105629688","chr14","42334227","42334313","14","63295375"
"chr7","105630988","105631286","chr3","125697129","125697419","34","20066141"
"chr7","105633061","105633289","chr3","125699927","125700158","23","20066866"
"chr7","105633329","105633645","chr3","125700228","125700535","33","20066899"
"chr7","105640987","105641284","chr9","54782893","54783190","62","50858094"
"chr7","105647904","105648227","chr3","125713786","125714087","37","20065882"
"chr7","105694119","105694414","chr3","40288905","40289201","60","65405214"
"chr7","105702658","105702824","chr3","42875311","42875476","14","62827347"
"chr7","105703122","105703270","chr3","42875781","42875928","13","62827341"
"chr7","105704894","105705080","chr3","42878054","42878240","11","62826840"
"chr7","105707655","105707944","chr3","42881006","42881291","24","62826649"
"chr7","105711536","105711699","chr3","42885674","42885837","20","62825862"
"chr7","105712000","105712061","chr19","41975561","41975621","13","63736439"
"chr7","105713731","105713845","chr5","153377537","153377648","20","47663806"
"chr7","105720532","105720824","chr15","43687639","43687935","54","62032893"
"chr7","105732463","105732764","chr3","42911235","42911510","54","62821228"
"chr7","105733785","105734097","chr3","42912566","42912874","18","62821219"
"chr7","105735934","105736195","chr3","42914543","42914819","37","62821391"
"chr7","105740716","105740882","chr2","102507593","102507742","37","3233123"
"chr7","105741179","105741268","chr3","42920300","42920381","11","62820879"
"chr7","105749188","105749320","chr5","58661067","58661194","26","47088121"
"chr7","105756879","105757188","chr3","42934586","42934903","28","62822293"
"chr7","105759837","105760106","chr3","42939940","42940187","51","62819897"
"chr7","105761077","105761384","chr11","95916643","95916946","54","9844434"
"chr7","105763511","105763809","chr3","42944246","42944546","49","62819265"
"chr7","105764242","105764486","chr18","12446919","12447174","57","93317323"
"chr7","105811973","105812142","chr3","125792311","125792481","14","19980338"
"chr7","105812450","105812527","chr16","48109817","48109901","11","57702633"
"chr7","105822266","105822376","chr6","69893870","69893980","18","35928396"
"chr7","105822410","105822587","chr2","34813885","34814057","42","71008525"
"chr7","105838611","105838902","chr3","125820111","125820403","13","19981500"
"chr7","105845604","105845853","chr11","118504184","118504438","50","12658580"
"chr7","105849544","105849674","chr3","125830500","125830630","7","19980956"
"chr7","105868846","105869159","chr3","125849892","125850211","52","19981046"
"chr7","105875301","105875596","chr3","125857058","125857350","29","19981757"
"chr7","105877649","105877780","chr3","125859429","125859560","2","19981780"
"chr7","105879933","105880113","chr1","195941816","195941998","37","90061883"
"chr7","105891177","105891385","chr3","125874357","125874576","34","19983180"
"chr7","105894324","105894652","chr14","69384104","69384414","62","36510220"
"chr7","105894842","105894965","chr3","125879730","125879857","13","19984888"
"chr7","105910280","105910472","chr3","125665919","125666111","53","19755639"
"chr7","105921680","105921794","chr3","125906249","125906360","6","19984569"
"chr7","105923692","105924016","chr3","125908041","125908369","26","19984349"
"chr7","105926937","105927232","chr3","125911851","125912158","33","19984914"
"chr7","105927664","105927979","chr3","125912902","125913213","43","19985238"
"chr7","105929293","105929497","chr6","56095484","56095688","39","49833809"
"chr7","105930221","105930399","chr3","125917298","125917455","38","19987077"
"chr7","105930680","105930811","chr3","125917736","125917868","5","19987056"
"chr7","105933017","105933238","chr3","125920714","125920928","21","19987697"
"chr7","105934538","105934845","chr3","125922534","125922841","20","19987996"
"chr7","105939569","105939863","chr3","125928245","125928514","47","19988676"
"chr7","105944622","105944883","chr7","32054611","32054873","60","73890011"
"chr7","105945421","105945709","chr16","1095250","1095541","63","104850171"
"chr7","105948135","105948223","chr3","125939865","125939953","5","19991730"
"chr7","105948528","105948731","chr3","125940267","125940452","28","19991739"
"chr7","105950981","105951280","chr9","99726642","99726948","59","6224339"
"chr7","105954102","105954234","chr3","125946624","125946756","5","19992522"
"chr7","105955795","105956005","chr9","12066098","12066309","49","93889697"
"chr7","105981866","105982159","chr4","71517233","71517531","58","34464633"
"chr7","106016587","106016806","chr2","100610118","100610341","68","5406469"
"chr7","106017734","106018032","chr8","33501347","33501642","68","72516387"
"chr7","106022764","106022903","chrX","65810626","65810764","20","40212138"
"chr7","106026514","106026688","chr10","74803071","74803247","36","31223443"
"chr7","106026724","106026841","chr1","15003529","15003646","18","91023195"
"chr7","106035586","106035735","chr3","126030856","126031002","12","19995270"
"chr7","106036764","106037056","chr3","126032043","126032346","33","19995279"
"chr7","106042778","106043048","chr3","126038450","126038714","23","19995672"
"chr7","106045667","106045846","chr3","126041377","126041559","17","19995710"
"chr7","106047531","106047844","chr3","126043160","126043469","26","19995629"
"chr7","106050105","106050267","chr12","10462851","10463007","34","95587254"
"chr7","106051757","106051972","chr14","9611892","9612110","44","96439865"
"chr7","106052840","106053146","chr3","47567768","47568083","60","58485072"
"chr7","106053841","106054109","chr12","83658601","83658861","49","22395240"
"chr7","106057834","106057974","chr6","93577303","93577440","24","12480531"
"chr7","106061942","106062138","chr9","24482768","24482974","48","81579174"
"chr7","106066155","106066199","chr20","23244907","23244948","8","82821248"
"chr7","106066502","106066650","chr20","32284199","32284357","35","73782303"
"chr7","106073686","106073802","chr3","126068513","126068629","9","19994827"
"chr7","106083910","106084182","chr9","115181847","115182127","63","9097937"
"chr7","106085002","106085285","chr9","96028798","96029097","65","10056204"
"chr7","106086411","106086526","chr4","13998167","13998284","15","92088244"
"chr7","106087634","106087937","chr3","126082703","126082982","39","19995069"
"chr7","106090873","106091102","chr5","78578822","78579040","51","27512051"
"chr7","106092786","106092901","chr3","1838435","1838551","18","104254351"
"chr7","106093670","106093897","chr3","126091436","126091662","22","19997766"
"chr7","106097622","106097902","chr3","126094872","126095160","35","19997250"
"chr7","106105113","106105383","chr3","126102669","126102927","27","19997556"
"chr7","106118635","106118740","chr3","126115928","126116033","3","19997293"
"chr7","106124317","106124497","chr3","126121660","126121834","22","19997343"
"chr7","106124807","106124954","chr1","137396806","137396947","32","31271999"
"chr7","106129253","106129476","chr20","22161284","22161503","50","83967969"
"chr7","106130388","106130681","chrX","15953272","15953560","55","90177116"
"chr7","106136373","106136563","chr4","8454525","8454703","46","97681848"
"chr7","106138165","106138436","chr3","126139412","126139684","22","20001247"
"chr7","106141408","106141738","chr3","126142446","126142803","48","20001038"
"chr7","106141910","106142198","chr2","99648006","99648286","52","6493904"
"chr7","106156856","106157108","chr7","19739822","19740079","68","86417034"
"chr7","106159863","106160151","chr3","126163685","126163973","17","20003822"
"chr7","106162889","106163189","chr3","126167167","126167463","22","20004278"
"chr7","106165434","106165560","chr3","126169580","126169705","4","20004146"
"chr7","106165859","106166034","chr3","126170332","126170491","30","20004473"
"chr7","106168485","106168602","chr13","100812951","100813068","19","5355534"
"chr7","106175270","106175500","chr3","126182679","126182909","17","20007409"
"chr7","106180501","106180793","chr3","126188899","126189181","17","20008398"
"chr7","106181920","106182222","chr3","126190298","126190604","40","20008378"
"chr7","106183963","106184243","chr3","126192298","126192577","20","20008335"
"chr7","106189957","106190269","chr3","126198496","126198809","25","20008539"
"chr7","106194909","106195043","chr8","101225515","101225642","20","4969394"
"chr7","106195074","106195362","chr8","51819236","51819512","67","54375838"
"chr7","106200505","106200809","chr2","139523227","139523524","61","33322722"
"chr7","106206412","106206725","chr3","126214767","126215081","23","20008355"
"chr7","106207153","106207452","chr3","126215504","126215820","42","20008351"
"chr7","106209531","106209750","chr9","69381443","69381670","45","36828088"
"chr7","106215440","106215744","chr3","126223080","126223363","31","20007640"
"chr7","106217732","106218020","chr10","27535995","27536278","53","78681737"
"chr7","106218661","106218952","chr3","126226681","126226975","29","20008020"
"chr7","106219706","106220010","chr3","126227729","126228034","24","20008023"
"chr7","106220554","106220726","chr15","62000771","62000947","47","44219783"
"chr7","106221440","106221695","chr3","126229669","126229921","17","20008229"
"chr7","106222365","106222687","chr3","126230592","126230921","41","20008227"
"chr7","106227818","106228021","chr3","126236519","126236722","9","20008701"
"chr7","106228491","106228772","chr5","17210631","17210908","58","89017860"
"chr7","106229057","106229359","chr3","126237989","126238298","30","20008932"
"chr7","106231309","106231611","chr19","15562519","15562818","54","90668790"
"chr7","106235432","106235733","chr3","126244795","126245079","39","20009363"
"chr7","106236405","106236701","chr3","126245753","126246064","49","20009348"
"chr7","106252892","106253190","chrX","127495164","127495450","56","21242272"
"chr7","106271808","106272096","chr16","21353392","21353685","70","84918416"
"chr7","106283641","106283904","chr3","126291513","126291777","16","20007872"
"chr7","106293212","106293409","chr2","51400859","51401043","41","54892353"
"chr7","106293713","106293987","chr1","11251860","11252129","60","95041853"
"chr7","106297492","106297670","chr3","126305685","126305863","20","20008193"
"chr7","106297960","106298017","chr3","126306162","126306209","11","20008202"
"chr7","106313018","106313328","chr3","126322046","126322348","46","20009028"
"chr7","106326377","106326684","chr3","126344900","126345208","17","20018523"
"chr7","106335279","106335589","chr3","126349726","126350034","33","20014447"
"chr7","106352272","106352396","chr3","126360115","126360239","3","20007843"
"chr7","106385881","106386157","chr3","126406047","126406317","41","20020166"
"chr7","106387650","106387961","chr3","126402951","126403258","25","20015301"
"chr7","106395388","106395488","chrX","97916876","97916974","19","8478512"
"chr7","106396677","106396978","chr7","140588016","140588306","52","34191339"
"chr7","106428008","106428255","chr15","83752479","83752725","56","22675529"
"chr7","106430000","106430311","chr10","70947259","70947566","69","35482741"
"chr7","106431530","106431828","chr2","164793215","164793516","58","58361685"
"chr7","106435163","106435313","chr19","35574608","35574755","31","70860555"
"chr7","106435581","106435756","chr3","41704437","41704602","34","64731144"
"chr7","106436212","106436500","chr3","126498555","126498840","39","20062343"
"chr7","106439116","106439248","chr3","126501850","126501982","5","20062734"
"chr7","106439254","106439561","chr3","126501988","126502290","28","20062734"
"chr7","106443764","106444057","chr3","126507128","126507441","38","20063364"
"chr7","106458408","106458536","chr3","126521212","126521341","12","20062804"
"chr7","106462550","106462652","chr3","126525457","126525554","10","20062907"
"chr7","106464849","106465119","chr11","104343346","104343580","76","2121503"
"chr7","106465552","106465706","chr20","14831069","14831233","36","91634483"
"chr7","106468292","106468443","chr3","126531380","126531530","18","20063088"
"chr7","106468746","106468901","chr3","126531825","126531984","11","20063079"
"chr7","106472506","106472797","chr3","126535617","126535868","52","20063111"
"chr7","106477022","106477301","chr10","13786018","13786298","47","92691004"
"chr7","106487621","106487744","chr3","126549274","126549391","11","20061653"
"chr7","106488039","106488220","chr3","126549688","126549871","15","20061649"
"chr7","106489394","106489689","chr3","126551042","126551324","37","20061648"
"chr7","106492480","106492797","chr15","28474256","28474552","76","78018224"
"chr7","106493958","106494280","chrY","71148","71460","64","106422810"
"chr7","106512762","106512948","chr13","55435857","55436044","11","51076905"
"chr7","106513255","106513361","chr13","55436350","55436460","16","51076905"
"chr7","106513403","106513414","chr17","84809390","84809401","1","21704013"
"chr7","106515794","106516092","chr13","55433470","55433770","14","51082324"
"chr7","106517649","106517940","chr13","55440018","55440311","25","51077631"
"chr7","106529414","106529703","chr13","55449231","55449526","25","51080183"
"chr7","106535703","106536001","chr13","55453789","55454089","18","51081914"
"chr7","106540659","106540975","chr3","126564382","126564695","23","20023723"
"chr7","106555666","106555974","chr3","126579273","126579576","26","20023607"
"chr7","106558994","106559312","chr3","126583083","126583398","23","20024089"
"chr7","106565143","106565412","chr3","126589070","126589338","23","20023927"
"chr7","106565908","106566202","chr3","126590189","126590465","30","20024281"
"chr7","106567221","106567519","chr2","72923747","72924047","49","33643474"
"chr7","106569240","106569463","chr3","126594848","126595081","30","20025608"
"chr7","106579098","106579384","chr3","126605745","126606033","25","20026647"
"chr7","106584915","106585226","chr3","117682762","117683060","59","11097847"
"chr7","106589966","106590125","chr7","111972311","111972479","33","5382345"
"chr7","106590411","106590557","chr8","27412285","27412430","23","79178126"
"chr7","106591080","106591243","chr3","126621167","126621327","8","20030087"
"chr7","106591547","106591695","chr3","126621644","126621785","23","20030097"
"chr7","106593038","106593336","chr3","126623446","126623744","20","20030408"
"chr7","106597384","106597675","chr3","126627788","126628074","23","20030404"
"chr7","106600175","106600451","chr3","126630580","126630885","45","20030405"
"chr7","106603171","106603479","chr8","25196104","25196415","68","81407067"
"chr7","106612706","106613037","chr7","85497116","85497424","74","21115590"
"chr7","106623546","106623813","chr3","126655512","126655763","34","20031966"
"chr7","106626975","106627253","chr3","126658925","126659194","34","20031950"
"chr7","106638475","106638786","chr3","126668184","126668485","35","20029709"
"chr7","106641772","106642017","chr13","32857396","32857642","54","73784376"
"chr7","106644901","106645206","chr3","126681993","126682294","25","20037092"
"chr7","106645779","106646076","chr3","126678304","126678603","23","20032525"
"chr7","106659294","106659424","chr3","126695333","126695469","12","20036039"
"chr7","106660702","106660937","chr20","33668679","33668914","41","72992023"
"chr7","106661147","106661436","chr3","126697541","126697825","23","20036394"
"chr7","106671808","106672071","chr3","126709147","126709386","36","20037339"
"chr7","106691549","106691877","chr7","131043261","131043567","82","24351712"
"chr7","106696020","106696207","chr17","25131334","25131517","54","81564686"
"chr7","106696490","106696621","chr3","126737774","126737906","5","20041284"
"chr7","106697682","106697968","chr13","34170606","34170896","65","72527076"
"chr7","106703734","106703843","chr3","126745524","126745632","8","20041790"
"chr7","106703876","106704039","chr3","126745685","126745842","13","20041809"
"chr7","106707458","106707747","chr3","47074764","47075053","73","59632694"
"chr7","106718275","106718563","chr3","126766094","126766390","23","20047819"
"chr7","106729065","106729368","chr7","35839947","35840247","54","70889118"
"chr7","106731518","106731784","chr5","186636747","186637039","73","79905229"
"chr7","106732436","106732671","chr3","128728563","128728790","53","21996127"
"chr7","106733559","106733824","chrX","113906906","113907171","50","7173347"
"chr7","106735098","106735295","chr2","159196181","159196359","80","52461083"
"chr7","106738694","106738996","chr12","114081655","114081960","59","7342961"
"chr7","106740603","106740910","chr3","126787525","126787821","32","20046922"
"chr7","106745625","106745904","chr3","126792919","126793194","22","20047294"
"chr7","106746835","106747102","chr3","126794297","126794543","28","20047462"
"chr7","106749527","106749807","chr3","126797251","126797544","32","20047724"
"chr7","106751391","106751495","chr7","129543479","129543585","19","22792088"
"chr7","106752719","106752797","chr20","52095772","52095851","15","54656947"
"chr7","106756179","106756483","chr3","126803659","126803949","38","20047480"
"chr7","106760211","106760436","chr3","126805900","126806112","23","20045689"
"chr7","106760728","106760820","chr3","126806420","126806512","8","20045692"
"chr7","106764424","106764716","chr3","126811896","126812188","15","20047472"
"chr7","106767692","106768016","chr3","126815172","126815489","33","20047480"
"chr7","106771441","106771734","chr4","110888143","110888432","55","4116702"
"chr7","106776432","106776736","chr3","126824595","126824901","17","20048163"
"chr7","106777148","106777270","chr3","126825310","126825432","6","20048162"
"chr7","106778921","106779084","chr3","126827889","126828046","21","20048968"
"chr7","106791108","106791277","chr1","204280359","204280529","58","97489251"
"chr7","106791573","106791708","chr8","72239683","72239817","25","34551890"
"chr7","106795915","106796215","chr1","43214523","43214825","55","63581392"
"chr7","106797201","106797508","chr1","42712584","42712883","64","64084617"
"chr7","106798202","106798371","chr20","4601558","4601721","27","102196644"
"chr7","106800319","106800625","chr4","7011292","7011590","78","99789027"
"chr7","106801423","106801645","chr9","62480277","62480505","38","44321146"
"chr7","106802961","106803280","chr20","23217396","23217711","61","83585565"
"chr7","106807476","106807765","chr3","126855068","126855364","28","20047592"
"chr7","106817070","106817385","chr3","126868293","126868609","11","20051223"
"chr7","106829936","106830114","chr3","126882080","126882258","17","20052144"
"chr7","106830392","106830536","chrX","144393215","144393346","32","37562823"
"chr7","106832519","106832830","chr3","126887821","126888141","33","20055302"
"chr7","106834696","106834992","chr2","56803979","56804276","54","50030717"
"chr7","106837025","106837332","chr2","46260060","46260367","62","60576965"
"chr7","106837795","106838086","chr3","126892692","126892977","26","20054897"
"chr7","106838103","106838416","chr3","126893017","126893325","39","20054914"
"chr7","106839487","106839775","chr3","126894386","126894661","29","20054899"
"chr7","106846560","106846662","chr3","42168883","42168983","16","64677677"
"chr7","106846738","106846902","chr6","138881841","138882006","34","32035103"
"chr7","106847351","106847655","chrX","18985711","18986004","54","87861640"
"chr7","106854618","106854898","chr3","126905209","126905489","21","20050591"
"chr7","106856648","106856864","chr12","115132434","115132646","49","8275786"
"chr7","106864480","106864747","chr6","17609699","17609979","54","89254781"
"chr7","106875077","106875344","chrX","113906906","113907171","50","7031829"
"chr7","106879894","106880194","chr3","126932801","126933106","40","20052907"
"chr7","106881694","106881996","chr3","126934625","126934922","30","20052931"
"chr7","106882249","106882488","chr3","126935175","126935413","20","20052926"
"chr7","106884108","106884409","chr3","126936921","126937220","19","20052813"
"chr7","106887987","106888265","chr5","165714831","165715111","55","58826844"
"chr7","106889495","106889799","chr3","126942104","126942393","34","20052609"
"chr7","106892089","106892285","chr3","126944977","126945174","23","20052888"
"chr7","106911105","106911396","chr3","126966655","126966943","30","20055550"
"chr7","106912511","106912645","chr1","207322754","207322885","21","100410243"
"chr7","106912987","106913302","chr10","22447058","22447370","63","84465929"
"chr7","106918283","106918609","chr3","126971937","126972280","41","20053654"
"chr7","106924753","106925038","chr4","14281391","14281673","54","92643362"
"chr7","106932886","106933198","chr3","126986156","126986463","36","20053270"
"chr7","106945935","106946240","chr3","126999113","126999416","26","20053178"
"chr7","106950672","106950941","chr3","127003934","127004233","56","20053262"
"chr7","106951587","106951888","chr3","127004986","127005290","23","20053399"
"chr7","106958656","106958956","chr3","127012073","127012377","40","20053417"
"chr7","106970253","106970567","chr3","127023868","127024180","19","20053615"
"chr7","106978134","106978425","chr3","127031727","127032019","17","20053593"
"chr7","106983535","106983851","chr12","100960763","100961074","68","6022772"
"chr7","106985545","106985835","chr3","124267629","124267922","51","17282084"
"chr7","106996411","106996721","chr3","127050903","127051212","28","20054492"
"chr7","107001206","107001507","chr3","127055604","127055907","15","20054398"
"chr7","107012279","107012580","chr3","127067841","127068133","28","20055562"
"chr7","107015277","107015605","chr3","127071195","127071516","31","20055918"
"chr7","107016987","107017272","chr3","127073178","127073448","31","20056191"
"chr7","107025552","107025867","chr3","127083631","127083982","53","20058079"
"chr7","107026349","107026481","chr3","127084462","127084594","5","20058113"
"chr7","107037302","107037594","chr3","127097180","127097470","25","20059878"
"chr7","107039847","107040142","chr3","127099729","127100006","40","20059882"
"chr7","107041111","107041373","chr3","127101028","127101299","27","20059917"
"chr7","107042483","107042657","chr14","55758634","55758805","37","51283849"
"chr7","107042659","107042735","chr11","3132112","3132193","16","103910547"
"chr7","107047789","107048041","chr16","22313832","22314093","57","84733957"
"chr7","107051469","107051702","chr20","27069657","27069873","52","79981812"
"chr7","107051767","107052077","chr3","127112731","127113044","39","20060964"
"chr7","107053143","107053447","chr3","127114102","127114411","28","20060959"
"chr7","107057018","107057302","chr3","127117875","127118171","34","20060857"
"chr7","107059374","107059684","chr1","162692161","162692468","59","55632787"
"chr7","107066654","107066968","chr3","127127223","127127524","30","20060569"
"chr7","107067921","107068035","chr3","127128489","127128605","17","20060568"
"chr7","107068036","107068357","chr3","127128606","127128915","39","20060570"
"chr7","107068358","107068537","chr3","127128916","127129121","32","20060558"
"chr7","107069470","107069591","chr7","136687340","136687461","20","29617870"
"chr7","107073660","107073967","chr3","127134974","127135285","42","20061314"
"chr7","107083562","107083857","chr3","127145404","127145705","26","20061842"
"chr7","107084297","107084429","chr15","109869590","109869722","18","2785293"
"chr7","107084597","107084892","chr7","131151695","131151975","62","24067098"
"chr7","107092356","107092521","chr9","26520390","26520553","35","80571966"
"chr7","107092838","107092966","chr3","127155029","127155158","17","20062191"
"chr7","107094187","107094481","chr3","127156385","127156664","36","20062198"
"chr7","107096015","107096327","chr3","127158223","127158526","37","20062208"
"chr7","107098246","107098533","chr16","9213865","9214152","52","97884381"
"chr7","107100089","107100400","chr3","127162429","127162726","44","20062340"
"chr7","107100719","107100834","chr9","52115920","52116029","25","54984799"
"chr7","107103082","107103383","chr3","127165732","127166033","21","20062650"
"chr7","107105530","107105837","chr3","127168680","127168990","22","20063150"
"chr7","107108906","107109125","chr12","35414648","35414860","48","71694258"
"chr7","107114015","107114332","chr3","127177314","127177631","14","20063299"
"chr7","107115332","107115611","chr3","127178643","127178924","29","20063311"
"chr7","107119801","107120099","chr3","127183006","127183299","23","20063205"
"chr7","107120479","107120640","chr8","25587737","25587894","34","81532742"
"chr7","107124496","107124797","chr3","127187489","127187783","25","20062993"
"chr7","107126118","107126295","chr4","61425777","61425954","32","45700341"
"chr7","107126807","107127116","chr3","127189529","127189831","31","20062722"
"chr7","107128132","107128421","chr6","17609699","17609979","52","89518433"
"chr7","107130171","107130297","chr2","165531071","165531193","19","58400900"
"chr7","107131363","107131588","chr3","127193893","127194128","35","20062530"
"chr7","107132977","107133240","chr3","39023062","39023328","48","68109915"
"chr7","107134883","107135180","chr9","54470311","54470606","56","52664572"
"chr7","107140391","107140700","chr3","127205322","127205635","30","20064931"
"chr7","107142083","107142287","chr3","127207015","127207224","17","20064932"
"chr7","107143768","107144059","chr3","127208852","127209161","33","20065084"
"chr7","107146092","107146309","chr3","127211364","127211577","28","20065272"
"chr7","107147000","107147301","chr2","84913076","84913368","59","22233924"
"chr7","107148776","107148906","chr3","127213603","127213731","7","20064827"
"chr7","107152047","107152168","chr3","127216920","127217042","10","20064873"
"chr7","107153873","107154201","chr9","110786043","110786351","74","3632170"
"chr7","107155536","107155818","chr3","127219952","127220253","31","20064416"
"chr7","107158888","107159162","chr3","127223338","127223613","29","20064450"
"chr7","107173565","107173813","chr3","127231565","127231830","42","20058000"
"chr7","107174921","107175038","chr2","95307409","95307526","17","11867512"
"chr7","107175068","107175079","chrX","117782793","117782803","3","10607725"
"chr7","107175375","107175557","chr3","127233552","127233733","13","20058177"
"chr7","107179253","107179388","chr20","5026807","5026940","23","102152446"
"chr7","107179676","107179870","chr19","28356007","28356185","43","78823669"
"chr7","107200712","107201012","chr3","127258693","127258977","32","20057981"
"chr7","107205221","107205505","chr3","127263189","127263495","44","20057968"
"chr7","107219309","107219610","chr3","127279118","127279433","36","20059809"
"chr7","107219835","107220145","chr8","17315066","17315367","62","89904769"
"chr7","107220592","107220692","chr19","1606998","1607096","15","105613594"
"chr7","107223662","107223952","chr3","127283034","127283323","23","20059372"
"chr7","107233606","107233882","chr3","127293300","127293589","34","20059694"
"chr7","107236958","107237254","chr3","127296612","127296915","22","20059654"
"chr7","107238826","107238962","chr3","127298494","127298631","7","20059668"
"chr7","107239267","107239424","chr16","39660694","39660850","28","67578573"
"chr7","107240598","107240902","chrX","8489750","8490046","91","98750848"
"chr7","107242928","107243240","chr3","127303048","127303335","49","20060120"
"chr7","107246119","107246234","chr3","127306462","127306593","24","20060343"
"chr7","107256207","107256489","chr3","127317663","127317934","27","20061456"
"chr7","107259607","107259913","chr3","127321073","127321390","35","20061466"
"chr7","107261283","107261553","chr3","127322752","127323048","46","20061469"
"chr7","107268278","107268556","chr1","212846655","212846936","66","105578377"
"chr7","107269668","107269895","chr1","202751892","202752109","51","95482224"
"chr7","107278219","107278499","chr3","127339852","127340152","40","20061633"
"chr7","107281348","107281405","chr3","49509699","49509754","12","57771649"
"chr7","107281464","107281506","chr3","127343514","127343556","5","20062050"
"chr7","107281515","107281570","chr3","127343669","127343721","5","20062154"
"chr7","107281566","107281603","chr8","29452845","29452878","7","77828721"
"chr7","107291929","107292107","chr3","127354069","127354227","34","20062140"
"chr7","107292419","107292554","chr3","127354537","127354673","16","20062118"
"chr7","107293825","107294118","chr3","127355913","127356217","40","20062088"
"chr7","107299351","107299638","chr3","127361422","127361707","20","20062071"
"chr7","107325320","107325637","chr3","127388160","127388453","62","20062840"
"chr7","107334005","107334299","chr9","5743881","5744173","53","101590124"
"chr7","107334952","107335238","chr9","29847332","29847618","50","77487620"
"chr7","107346314","107346594","chr3","127402828","127403113","35","20056514"
"chr7","107351219","107351522","chr3","127407662","127407974","31","20056443"
"chr7","107359678","107359969","chr3","127416564","127416853","20","20056886"
"chr7","107371703","107372021","chr3","127429265","127429583","24","20057562"
"chr7","107374813","107374915","chr3","127432748","127432857","16","20057935"
"chr7","107376262","107376566","chr3","127434205","127434502","31","20057943"
"chr7","107386734","107387029","chr3","127444677","127444982","34","20057943"
"chr7","107388907","107389205","chr3","127446837","127447136","20","20057930"
"chr7","107396843","107397137","chr3","127455153","127455444","25","20058310"
"chr7","107416844","107417146","chr3","127476154","127476456","34","20059310"
"chr7","107435309","107435599","chr3","127494448","127494733","24","20059139"
"chr7","107438454","107438791","chr11","105302222","105302548","70","2136232"
"chr7","107453687","107453969","chr3","127513564","127513848","16","20059877"
"chr7","107461608","107461924","chr3","127521429","127521741","28","20059821"
"chr7","107466696","107466991","chr3","127526489","127526764","43","20059793"
"chr7","107468597","107468892","chr3","127528389","127528682","23","20059792"
"chr7","107484326","107484630","chr3","127543560","127543868","28","20059234"
"chr7","107485361","107485674","chr3","127544597","127544886","41","20059236"
"chr7","107510114","107510419","chr3","127570099","127570403","48","20059985"
"chr7","107513108","107513417","chr3","127573070","127573379","21","20059962"
"chr7","107522518","107522824","chr15","43687639","43687935","70","63834879"
"chr7","107531278","107531574","chr3","127591199","127591495","21","20059921"
"chr7","107533414","107533638","chr3","127593220","127593443","32","20059806"
"chr7","107543056","107543347","chr3","127602143","127602426","22","20059087"
"chr7","107553632","107553704","chr16","74470944","74471020","18","33082688"
"chr7","107554203","107554490","chr3","127613449","127613745","33","20059246"
"chr7","107554937","107555239","chr3","127614192","127614489","25","20059255"
"chr7","107559648","107559826","chr14","94902675","94902838","39","12656973"
"chr7","107564564","107564835","chr3","127624824","127625104","24","20060260"
"chr7","107584954","107585165","chr20","35094996","35095206","35","72489958"
"chr7","107589466","107589750","chr9","22873625","22873899","57","84715841"
"chr7","107593806","107593921","chr15","7629654","7629770","20","99964152"
"chr7","107596248","107596500","chr3","47104622","47104882","56","60491626"
"chr7","107599024","107599184","chr3","127658075","127658235","10","20059051"
"chr7","107599236","107599533","chr7","113150637","113150924","55","5551401"
"chr7","107607758","107607977","chr11","55331161","55331384","45","52276597"
"chr7","107611006","107611304","chr18","34987717","34988024","70","72623289"
"chr7","107615140","107615423","chr3","127673217","127673485","47","20058077"
"chr7","107618260","107618540","chr3","127676250","127676533","20","20057990"
"chr7","107633368","107633651","chr3","128032983","128033269","25","20399615"
"chr7","107659898","107660176","chr3","128058948","128059227","21","20399050"
"chr7","107740594","107740705","chrX","16054042","16054150","19","91686552"
"chr7","107773998","107774291","chr3","128183878","128184182","38","20409880"
"chr7","107856905","107857185","chr20","57187889","57188168","59","50669016"
"chr7","107861675","107861960","chr3","128267223","128267509","17","20405548"
"chr7","107883119","107883435","chr3","128289619","128289930","24","20406500"
"chr7","107895565","107895880","chr3","128302784","128303101","36","20407219"
"chr7","107897524","107897673","chr3","128304725","128304872","8","20407201"
"chr7","107906666","107906784","chr11","33393852","33393977","26","74512814"
"chr7","107907492","107907784","chr7","127802025","127802307","59","19894533"
"chr7","107914508","107914621","chr3","128322440","128322543","16","20407932"
"chr7","107920366","107920482","chr3","128327940","128328055","7","20407574"
"chr7","107974581","107974838","chr3","128382060","128382350","48","20407479"
"chr7","108073576","108073857","chr3","128471236","128471515","18","20397660"
"chr7","108081130","108081254","chr3","128478615","128478731","17","20397485"
"chr7","108085991","108086286","chr20","41706573","41706866","63","66379418"
"chr7","108123418","108123541","chr7","31804546","31804669","28","76318872"
"chr7","108155712","108155997","chr1","28082947","28083228","67","80072765"
"chr7","108207029","108207255","chr3","128645446","128645679","25","20438417"
"chr7","108212487","108212610","chr3","128650912","128651034","11","20438425"
"chr7","108254234","108254488","chr3","128686267","128686523","22","20432033"
"chr7","108261230","108261531","chr3","128692219","128692527","26","20430989"
"chr7","108277110","108277359","chr3","128708634","128708861","43","20431524"
"chr7","108295959","108296197","chr3","128728563","128728790","24","20432604"
"chr7","108301569","108301757","chr3","128734140","128734321","14","20432571"
"chr7","108342675","108342965","chr3","128784204","128784497","20","20441529"
"chr7","108395196","108395476","chr4","5085405","5085685","53","103309791"
"chr7","108439173","108439413","chr3","128877679","128877919","19","20438506"
"chr7","108497255","108497550","chrX","113296290","113296582","60","4799035"
"chr7","108499333","108499637","chr3","128930637","128930945","30","20431304"
"chr7","108669024","108669318","chr3","129188105","129188400","22","20519081"
"chr7","108715469","108715677","chr3","129234899","129235111","19","20519430"
"chr7","108732753","108733041","chr3","129249787","129250075","8","20517034"
"chr7","108753014","108753317","chr3","129269880","129270184","14","20516866"
"chr7","108771744","108772039","chr3","129291306","129291597","33","20519562"
"chr7","108772936","108773221","chr3","129292509","129292796","25","20519573"
"chr7","108786911","108787216","chr10","27036187","27036493","59","81750724"
"chr7","108815152","108815283","chr3","129332532","129332655","12","20517380"
"chr7","108870396","108870521","chr3","129393020","129393140","13","20522624"
"chr7","108872024","108872309","chr3","129394646","129394912","42","20522622"
"chr7","108873080","108873113","chr14","109545748","109545781","7","672668"
"chr7","108896280","108896592","chr3","129418171","129418483","15","20521891"
"chr7","108933183","108933469","chr3","129456033","129456314","26","20522850"
"chr7","108984257","108984528","chr3","129505592","129505870","25","20521335"
"chr7","108989356","108989468","chr3","129510749","129510865","13","20521393"
"chr7","108999016","108999239","chr3","129520399","129520620","24","20521383"
"chr7","109018296","109018571","chr3","129535797","129536073","16","20517501"
"chr7","109025959","109026252","chr3","129543469","129543764","13","20517510"
"chr7","109032833","109032961","chr3","129550306","129550434","8","20517473"
"chr7","109081883","109082142","chr3","129600757","129601029","28","20518874"
"chr7","109149969","109150214","chr9","95738470","95738706","47","13411499"
"chr7","109155048","109155397","chr3","129674955","129675305","31","20519907"
"chr7","109166869","109167164","chr3","129686644","129686939","20","20519775"
"chr7","109208662","109208960","chr3","129734775","129735075","35","20526113"
"chr7","109212902","109213189","chr3","129741718","129741995","28","20528816"
"chr7","109224183","109224353","chr19","14612970","14613142","40","94611213"
"chr7","109224652","109224792","chr8","116061148","116061283","25","6836496"
"chr7","109259551","109259900","chr3","129792257","129792607","70","20532706"
"chr7","109330370","109330584","chr3","92581046","92581256","40","16749324"
"chr7","109341867","109342155","chr5","25436975","25437257","58","83904892"
"chr7","109404578","109404876","chr3","129973523","129973770","67","20568945"
"chr7","109508977","109509240","chr3","130074474","130074738","13","20565497"
"chr7","109596228","109596526","chrX","3053239","3053539","65","106542989"
"chr7","109614350","109614647","chr3","130173341","130173654","39","20558991"
"chr7","109622944","109623230","chr6","68750302","68750588","51","40872642"
"chr7","109623460","109623796","chr3","130188329","130188638","67","20564869"
"chr7","109634556","109634876","chr3","130205035","130205349","35","20570479"
"chr7","109637494","109637771","chr3","130207035","130207314","21","20569541"
"chr7","109643314","109643594","chr3","130213151","130213450","37","20569837"
"chr7","109646246","109646545","chr2","44803783","44804082","52","64842463"
"chr7","109667197","109667322","chr9","97270771","97270897","20","12396426"
"chr7","109728139","109728331","chr3","130294939","130295145","24","20566800"
"chr7","109748136","109748412","chr3","130314561","130314835","32","20566425"
"chr7","109763075","109763374","chr3","130331286","130331573","38","20568211"
"chr7","109772386","109772684","chr3","130340820","130341134","40","20568434"
"chr7","109776196","109776508","chr3","130344959","130345262","28","20568763"
"chr7","109779167","109779471","chr3","130348253","130348556","13","20569086"
"chr7","109797107","109797397","chr9","59210030","59210323","64","50587077"
"chr7","109798443","109798729","chr3","130368164","130368456","22","20569721"
"chr7","109816749","109816926","chr3","130386643","130386827","30","20569894"
"chr7","109817222","109817243","chr3","130387125","130387147","1","20569903"
"chr7","109823186","109823473","chr3","130392680","130392951","38","20569494"
"chr7","109823665","109823950","chr3","130393145","130393425","24","20569480"
"chr7","109876734","109877040","chr3","130448018","130448321","14","20571284"
"chr7","109878044","109878319","chr3","130449324","130449603","20","20571280"
"chr7","109922119","109922248","chr3","130497944","130498037","40","20575825"
"chr7","109936395","109936581","chr3","130512825","130513008","14","20576430"
"chr7","109952347","109952630","chr3","130529256","130529539","27","20576909"
"chr7","109963096","109963390","chr3","130540060","130540376","42","20576964"
"chr7","109968372","109968679","chr3","130545468","130545776","52","20577096"
"chr7","109976398","109976687","chr3","130553543","130553825","24","20577145"
"chr7","109996361","109996658","chr2","160551205","160551504","64","50554844"
"chr7","110010182","110010339","chr3","130592033","130592192","10","20581851"
"chr7","110017821","110017894","chrX","15934857","15934923","18","94082964"
"chr7","110034058","110034192","chr3","130616362","130616495","6","20582304"
"chr7","110049675","110049913","chr2","72472536","72472761","82","37577139"
"chr7","110051598","110051918","chr3","130634978","130635275","43","20583380"
"chr7","110056057","110056345","chr3","130639632","130639921","29","20583575"
"chr7","110064934","110065134","chr4","42911085","42911296","52","67153849"
"chr7","110067674","110067964","chr5","7277016","7277305","59","102790658"
"chr7","110085368","110085634","chr1","27728770","27729054","37","82356598"
"chr7","110091240","110091461","chr3","130672627","130672844","19","20581387"
"chr7","110099022","110099222","chr3","130680658","130680877","31","20581636"
"chr7","110122938","110123107","chr15","8429087","8429254","38","101693851"
"chr7","110123411","110123523","chr1","11321778","11321889","34","98801633"
"chr7","110128709","110129014","chr3","130713408","130713684","53","20584699"
"chr7","110129467","110129731","chr3","130714127","130714392","18","20584660"
"chr7","110132004","110132315","chr7","131798681","131798995","61","21666677"
"chr7","110133726","110133982","chr1","8159052","8159309","58","101974674"
"chr7","110136456","110136720","chr3","130724323","130724586","20","20587867"
"chr7","110153792","110154069","chr3","123351694","123351976","47","13197902"
"chr7","110154420","110154556","chrX","8417026","8417160","19","101737394"
"chr7","110154849","110154931","chr16","48109817","48109901","10","62045032"
"chr7","110161501","110161824","chr3","130744598","130744917","21","20583097"
"chr7","110192908","110193124","chr1","124805622","124805832","61","14612714"
"chr7","110239226","110239373","chr3","130829879","130830027","5","20590653"
"chr7","110239377","110239469","chr3","130830031","130830125","9","20590654"
"chr7","110239756","110239915","chr3","130830425","130830590","19","20590669"
"chr7","110242283","110242565","chr3","130832938","130833218","16","20590655"
"chr7","110256149","110256445","chr3","130847818","130848104","30","20591669"
"chr7","110262631","110262842","chr3","130855649","130855868","20","20593018"
"chr7","110275740","110276019","chr3","130869685","130869964","32","20593945"
"chr7","110282249","110282509","chr13","38907730","38907994","63","71374519"
"chr7","110286400","110286678","chr3","130894451","130894727","20","20608051"
"chr7","110287774","110288034","chr3","130896121","130896388","25","20608347"
"chr7","110310609","110310900","chr3","130918299","130918575","42","20607690"
"chr7","110310939","110311227","chr3","130918584","130918874","28","20607645"
"chr7","110312440","110312680","chr3","130920579","130920816","21","20608139"
"chr7","110338994","110339295","chr3","130948449","130948754","31","20609455"
"chr7","110346668","110346981","chr3","130957092","130957389","41","20610424"
"chr7","110351919","110352216","chr10","78267748","78268045","60","32084171"
"chr7","110365589","110365665","chr3","130975696","130975770","9","20610107"
"chr7","110365966","110366205","chr7","49378464","49378703","59","60987502"
"chr7","110411327","110411601","chr19","266476","266751","72","110144851"
"chr7","110411773","110412074","chr3","131023022","131023325","20","20611249"
"chr7","110428340","110428609","chr3","131038873","131039148","28","20610533"
"chr7","110472161","110472525","chr2","56386837","56387173","104","54085324"
"chr7","110475343","110475648","chr3","131086055","131086356","33","20610712"
"chr7","110504194","110504504","chr3","131115872","131116178","30","20611678"
"chr7","110523496","110523791","chr3","131139339","131139620","28","20615843"
"chr7","110531357","110531656","chr3","131147029","131147328","36","20615672"
"chr7","110571413","110571719","chr3","131188216","131188522","12","20616803"
"chr7","110575646","110575915","chr13","75205555","75205804","55","35370091"
"chr7","110643771","110644083","chr3","131259764","131260058","41","20615993"
"chr7","110657174","110657471","chr3","131273813","131274112","15","20616639"
"chr7","110674479","110674769","chr3","131287342","131287645","35","20612863"
"chr7","110697707","110697991","chr3","131312436","131312717","21","20614729"
"chr7","110726976","110727258","chr3","131341892","131342194","53","20614916"
"chr7","110758864","110758988","chr3","131373899","131374022","9","20615035"
"chr7","110798650","110798936","chr3","131413961","131414264","61","20615311"
"chr7","110801343","110801633","chr3","131416636","131416920","25","20615293"
"chr7","110811878","110812166","chr3","131427807","131428097","26","20615929"
"chr7","110900487","110900650","chr1","126122408","126122572","32","15221921"
"chr7","110905557","110905836","chr3","131531467","131531753","36","20625910"
"chr7","110913142","110913439","chr3","131539050","131539358","24","20625908"
"chr7","110928761","110929035","chr3","131547403","131547683","21","20618642"
"chr7","110931016","110931304","chr3","131549667","131549960","35","20618651"
"chr7","110938372","110938684","chr3","131556974","131557289","24","20618602"
"chr7","110961968","110962267","chr3","40288905","40289201","70","70673063"
"chr7","111100191","111100317","chr3","131721610","131721737","8","20621419"
"chr7","111223624","111223928","chr7","84841819","84842127","72","26381805"
"chr7","111275972","111276101","chr3","131927779","131927908","8","20651807"
"chr7","111322139","111322209","chrX","8915011","8915076","17","102407128"
"chr7","111326268","111326555","chr3","131978839","131979119","22","20652571"
"chr7","111329772","111330075","chr3","131982406","131982709","25","20652634"
"chr7","111343348","111343574","chr2","88924457","88924686","55","22418891"
"chr7","111469756","111470054","chr3","132118314","132118606","26","20648558"
"chr7","111562857","111563150","chr3","132272060","132272358","25","20709203"
"chr7","111581273","111581567","chr3","132290796","132291096","20","20709523"
"chr7","111617877","111618153","chr15","47855867","47856141","49","63762010"
"chr7","111630089","111630370","chr3","132341191","132341493","41","20711102"
"chr7","111638998","111639317","chr3","132351538","132351859","31","20712540"
"chr7","111646734","111647024","chr3","167477786","167478063","66","55831052"
"chr7","111682047","111682245","chr13","42904008","42904210","36","68778039"
"chr7","111698071","111698300","chr1","222943933","222944161","45","111245862"
"chr7","111706744","111707018","chr20","14933143","14933401","64","96773601"
"chr7","111729443","111729739","chr3","132445626","132445923","20","20716183"
"chr7","111754461","111754585","chr3","132470215","132470338","12","20715754"
"chr7","111786353","111786483","chr17","7192625","7192755","28","104593728"
"chr7","111812724","111813038","chr3","132520571","132520880","29","20707847"
"chr7","111885152","111885430","chr3","132599020","132599308","32","20713868"
"chr7","111931915","111932129","chr9","65429045","65429248","49","46502870"
"chr7","111969034","111969319","chrX","18310076","18310371","62","93658958"
"chr7","111971533","111971651","chr13","62085074","62085191","13","49886459"
"chr7","111977243","111977439","chr3","132690679","132690852","34","20713436"
"chr7","111993912","111994029","chr3","132707409","132707526","7","20713497"
"chr7","112032343","112032644","chr3","132743093","132743393","27","20710750"
"chr7","112060095","112060404","chr3","132771230","132771518","42","20711135"
"chr7","112073812","112073914","chr1","94061554","94061655","18","18012258"
"chr7","112115831","112116109","chr3","132835201","132835463","44","20719370"
"chr7","112134414","112134721","chr19","43800281","43800567","76","68334133"
"chr7","112161313","112161588","chr3","132880727","132881025","48","20719414"
"chr7","112184883","112185184","chr3","132904136","132904450","46","20719253"
"chr7","112191210","112191497","chr15","15178553","15178841","53","97012657"
"chr7","112228500","112228829","chr3","132944836","132945154","34","20716336"
"chr7","112243224","112243542","chr3","132961096","132961384","60","20717872"
"chr7","112268056","112268337","chr6","9643866","9644144","55","102624190"
"chr7","112287049","112287344","chr3","133004909","133005201","25","20717860"
"chr7","112292442","112292554","chr10","27663251","27663372","21","84629191"
"chr7","112294604","112294720","chr3","133012775","133012891","9","20718171"
"chr7","112299932","112300025","chr3","133017814","133017908","6","20717882"
"chr7","112301443","112301544","chr4","39400012","39400116","17","72901431"
"chr7","112305632","112305922","chr3","133023699","133023989","40","20718067"
"chr7","112347820","112348112","chr3","133066349","133066660","38","20718529"
"chr7","112355011","112355178","chrX","113320960","113321125","30","965949"
"chr7","112355214","112355332","chr14","9262393","9262510","19","103092821"
"chr7","112355434","112355732","chr3","133067802","133068100","18","20712368"
"chr7","112358326","112358385","chr3","40170472","40170533","18","72187854"
"chr7","112381074","112381199","chr3","133095058","133095182","8","20713984"
"chr7","112385234","112385548","chr3","133098199","133098505","28","20712965"
"chr7","112426659","112426903","chr12","97216564","97216810","54","15210095"
"chr7","112446792","112446949","chr7","94341083","94341236","42","18105709"
"chr7","112454547","112454852","chr1","23321222","23321525","59","89133325"
"chr7","112459439","112459732","chr3","133172295","133172589","16","20712856"
"chr7","112469159","112469277","chr2","107844001","107844127","18","4625158"
"chr7","112479703","112479992","chr3","133192820","133193114","43","20713117"
"chr7","112504629","112504745","chr2","107613237","107613354","20","4891392"
"chr7","112514284","112514504","chr1","213911110","213911337","47","101396826"
"chr7","112530103","112530394","chr16","38882945","38883236","64","73647158"
"chr7","112537319","112537613","chr3","43652365","43652670","55","68884954"
"chr7","112556166","112556275","chr3","133259706","133259814","5","20703540"
"chr7","112559398","112559614","chr3","133262951","133263164","14","20703553"
"chr7","112572734","112573038","chr3","133276670","133276954","35","20703936"
"chr7","112576139","112576475","chr3","133280029","133280364","29","20703890"
"chr7","112610958","112611254","chr3","133314498","133314804","30","20703540"
"chr7","112657841","112658145","chr7","100651852","100652138","68","12005989"
"chr7","112664588","112664716","chr2","83802680","83802806","17","28861908"
"chr7","112677686","112677792","chr3","133385278","133385398","25","20707592"
"chr7","112703753","112704040","chr3","133417906","133418211","40","20714153"
"chr7","112756413","112756621","chr1","60748125","60748334","54","52008288"
"chr7","112787141","112787440","chr6","77260247","77260553","53","35526894"
"chr7","112799064","112799370","chr3","133520898","133521194","33","20721834"
"chr7","112819291","112819579","chr9","28362746","28363032","58","84456545"
"chr7","112826556","112826761","chr3","133548020","133548218","22","20721464"
"chr7","113055615","113055881","chr3","133784100","133784379","28","20728485"
"chr7","113085139","113085435","chr3","133812601","133812923","59","20727462"
"chr7","113085592","113085894","chr3","133813008","133813312","17","20727416"
"chr7","113087785","113088105","chr3","133815234","133815554","33","20727449"
"chr7","113111315","113111421","chr8","96949211","96949317","15","16162104"
"chr7","113183176","113183461","chr3","133904990","133905282","22","20721814"
"chr7","113222289","113222436","chr3","133940221","133940372","12","20717932"
"chr7","113223653","113223816","chr3","133941570","133941714","26","20717917"
"chr7","113265028","113265310","chr3","133978280","133978563","30","20713252"
"chr7","113279632","113279728","chr3","133994127","133994239","24","20714495"
"chr7","113293159","113293461","chr2","93029856","93030159","78","20263303"
"chr7","113306337","113306629","chr11","117366311","117366614","71","4059974"
"chr7","113313903","113314194","chr3","134027552","134027839","22","20713649"
"chr7","113402107","113402421","chr3","134107849","134108146","34","20705742"
"chr7","113409164","113409280","chr16","72571018","72571135","14","40838146"
"chr7","113573074","113573393","chr3","134281083","134281402","29","20708009"
"chr7","113593656","113593786","chr3","134313690","134313823","5","20720034"
"chr7","113611990","113612266","chr3","134332363","134332638","23","20720373"
"chr7","113646442","113646736","chr3","134357061","134357356","21","20710619"
"chr7","113736998","113737300","chr4","159090526","159090826","48","45353528"
"chr7","113778079","113778391","chr3","134491707","134492023","29","20713628"
"chr7","113825466","113825773","chr15","43687639","43687935","60","70137827"
"chr7","114124792","114125085","chrX","23305692","23305972","72","90819100"
"chr7","114168543","114168707","chr3","134891892","134892061","30","20723349"
"chr7","114238984","114239307","chr19","28575889","28576183","85","85663095"
"chr7","114273420","114273632","chr3","135003979","135004212","40","20730559"
"chr7","114306968","114307280","chr3","135030586","135030942","69","20723618"
"chr7","114415796","114416094","chr3","135132456","135132758","43","20716660"
"chr7","114448418","114448690","chr3","37042470","37042744","58","77405948"
"chr7","114622471","114622743","chr3","135324776","135325033","37","20702305"
"chr7","114650385","114650679","chr3","135351845","135352148","29","20701460"
"chr7","114798614","114798911","chr3","135516302","135516593","22","20717688"
"chr7","114811070","114811353","chr3","135528817","135529121","40","20717747"
"chr7","114824341","114824638","chr3","135548041","135548356","42","20723700"
"chr7","115032903","115033186","chr3","135746345","135746630","29","20713442"
"chr7","115114716","115115045","chr3","135831756","135832071","48","20717040"
"chr7","115169696","115170001","chr3","135887820","135888132","26","20718124"
"chr7","115283799","115283929","chr3","136047488","136047618","6","20763689"
"chr7","115284240","115284413","chr3","136047928","136048094","23","20763688"
"chr7","115310528","115310829","chr3","136074175","136074476","18","20763647"
"chr7","115400310","115400602","chr3","136163891","136164188","19","20763581"
"chr7","115429428","115429723","chr3","136194469","136194768","19","20765041"
"chr7","115521073","115521282","chr3","136282175","136282385","16","20761102"
"chr7","115558925","115559221","chr3","136318291","136318591","33","20759366"
"chr7","115592516","115592644","chr3","136352661","136352790","13","20760145"
"chr7","115593200","115593452","chr3","136353342","136353591","17","20760142"
"chr7","115687020","115687302","chr3","136444338","136444624","20","20757318"
"chr7","115701269","115701563","chr3","136459037","136459335","21","20757768"
"chr7","115701974","115702213","chr3","136459749","136460007","36","20757775"
"chr7","115751869","115752167","chr3","136512021","136512283","59","20760152"
"chr7","115782659","115782973","chr3","136544369","136544699","50","20761710"
"chr7","115873691","115874001","chr3","136635648","136635963","31","20761957"
"chr7","116037098","116037332","chr3","136805393","136805638","31","20768295"
"chr7","116070712","116070964","chr3","136841094","136841348","15","20770382"
"chr7","116156785","116156950","chr1","53225263","53225421","38","62931522"
"chr7","116156978","116157108","chr11","121219101","121219227","21","5062123"
"chr7","116168444","116168756","chr3","136937107","136937425","36","20768663"
"chr7","116205219","116205467","chr3","136967574","136967816","21","20762355"
"chr7","116225372","116225520","chr8","21621594","21621739","30","94603778"
"chr7","116287722","116288000","chr3","137046356","137046633","18","20758634"
"chr7","116294911","116295197","chr3","137053190","137053475","21","20758279"
"chr7","116297847","116298134","chr3","137056118","137056408","30","20758271"
"chr7","116300254","116300554","chr3","137058834","137059147","46","20758580"
"chr7","116305041","116305332","chr3","137063959","137064250","23","20758918"
"chr7","116314451","116314570","chr3","137073095","137073225","17","20758644"
"chr7","116320459","116320563","chr3","137078134","137078245","11","20757675"
"chr7","116340243","116340537","chr3","117682762","117683060","57","1342519"
"chr7","116355567","116355717","chr2","34841972","34842120","31","81513595"
"chr7","116418236","116418480","chr3","137186416","137186660","7","20768180"
"chr7","116437589","116437666","chr1","89754302","89754376","10","26683287"
"chr7","116446624","116446772","chr3","133941570","133941714","41","17494946"
"chr7","116486748","116487024","chr3","137256354","137256630","19","20769606"
"chr7","116507668","116507963","chr3","137277324","137277620","41","20769656"
"chr7","116587606","116587919","chr3","137359222","137359538","21","20771616"
"chr7","116670362","116670662","chr3","137441830","137442145","36","20771468"
"chr7","116714877","116715179","chr2","44803783","44804082","68","71911094"
"chr7","116724313","116724440","chr3","137494646","137494780","18","20770333"
"chr7","116724441","116724765","chr9","99341170","99341479","78","17383271"
"chr7","116724766","116724979","chr3","137495089","137495292","37","20770323"
"chr7","116772525","116772829","chr3","137583000","137583318","38","20810475"
"chr7","116780108","116780386","chr11","4094680","4094964","63","112685428"
"chr7","116782178","116782453","chr3","137592598","137592874","17","20810420"
"chr7","116783252","116783368","chr3","137593657","137593774","7","20810405"
"chr7","116788924","116789041","chr3","137599027","137599141","11","20810103"
"chr7","116790500","116790791","chr3","137600907","137601211","32","20810407"
"chr7","116818381","116818504","chr3","137627456","137627576","17","20809075"
"chr7","116829669","116829952","chr7","6165105","6165387","60","110664564"
"chr7","116834082","116834364","chr3","137643946","137644216","40","20809864"
"chr7","116835818","116836125","chr9","21543081","21543383","58","95292737"
"chr7","116846989","116847281","chr3","137656374","137656662","25","20809385"
"chr7","116885207","116885475","chr3","137694966","137695236","20","20809759"
"chr7","116920209","116920526","chr3","137731777","137732092","40","20811568"
"chr7","116952685","116952948","chr3","137769320","137769580","18","20816635"
"chr7","116958738","116959035","chr18","47235394","47235686","52","69723344"
"chr7","116978722","116978932","chr3","137796467","137796647","40","20817745"
"chr7","117028544","117028781","chr3","137847264","137847498","23","20818720"
"chr7","117059617","117059906","chr3","137877067","137877357","15","20817450"
"chr7","117073839","117074154","chr3","137891231","137891557","33","20817392"
"chr7","117090892","117091055","chr3","137909215","137909377","5","20818323"
"chr7","117101860","117102000","chr3","137920352","137920489","10","20818492"
"chr7","117105678","117105813","chr3","137924091","137924226","6","20818413"
"chr7","117106129","117106272","chr3","137924538","137924698","31","20818409"
"chr7","117116920","117117190","chr3","137935157","137935430","28","20818237"
"chr7","117218695","117218985","chr3","138031160","138031456","31","20812465"
"chr7","117220784","117221082","chr1","90159285","90159578","54","27061499"
"chr7","117322936","117323096","chr3","138138218","138138379","8","20815282"
"chr7","117344181","117344537","chr4","27191661","27191993","99","90152520"
"chr7","117398285","117398395","chr3","138207385","138207495","11","20809100"
"chr7","117493917","117494198","chr1","10904976","10905255","56","106588941"
"chr7","117496611","117496899","chr15","18718188","18718481","55","98778423"
"chr7","117516796","117517101","chr3","138329803","138330099","27","20813007"
"chr7","117529965","117530038","chr3","138342699","138342772","3","20812734"
"chr7","117533778","117533887","chr7","21866055","21866162","14","95667723"
"chr7","117544780","117545066","chr3","138355820","138356102","28","20811040"
"chr7","117561304","117561599","chr7","36331166","36331462","54","81230138"
"chr7","117698482","117698781","chr3","138505152","138505452","16","20806670"
"chr7","117703704","117703948","chr3","138510396","138510636","30","20806692"
"chr7","117764451","117764740","chr3","138569711","138570012","24","20805260"
"chr7","117827277","117827555","chr3","138643649","138643944","45","20816372"
"chr7","117931632","117931860","chr3","138745061","138745285","25","20813429"
"chr7","117950450","117950694","chr2","46138962","46139184","60","71811488"
"chr7","118029505","118029802","chr3","138879678","138879976","23","20850173"
"chr7","118032141","118032414","chr3","138881601","138881874","11","20849460"
"chr7","118146256","118146554","chr3","138990596","138990904","32","20844340"
"chr7","118250236","118250568","chr3","139081248","139081569","35","20831012"
"chr7","118268438","118268563","chr4","18342650","18342774","19","99925788"
"chr7","118345308","118345618","chr9","26595486","26595783","81","91749822"
"chr7","118358770","118358964","chr3","139188224","139188418","17","20829454"
"chr7","118441424","118441715","chr3","139302065","139302362","42","20860641"
"chr7","118648113","118648402","chr3","139517335","139517621","30","20869222"
"chr7","118664347","118664646","chr6","147497028","147497329","75","28832681"
"chr7","118680580","118680902","chr3","139550218","139550529","40","20869638"
"chr7","118682262","118682531","chr3","139551911","139552186","38","20869649"
"chr7","118690381","118690503","chr3","139560097","139560219","13","20869716"
"chr7","118723797","118724110","chr3","139590515","139590827","26","20866718"
"chr7","118745976","118746188","chr3","139611309","139611523","16","20865333"
"chr7","118764689","118764968","chr3","139630046","139630341","34","20865357"
"chr7","118876321","118876643","chr3","139742805","139743121","33","20866484"
"chr7","118912638","118912901","chr3","139773097","139773347","26","20860459"
"chr7","118925115","118925447","chr2","93061919","93062254","84","25863196"
"chr7","118934159","118934466","chr16","69929549","69929858","68","49004610"
"chr7","118960660","118960945","chr3","139820576","139820865","26","20859916"
"chr7","118973061","118973180","chr3","139831961","139832068","16","20858900"
"chr7","119053455","119053772","chr3","139906003","139906325","37","20852548"
"chr7","119270721","119271012","chr11","33842909","33843192","71","85427812"
"chr7","119374149","119374410","chr3","140224263","140224521","17","20850114"
"chr7","119378822","119378995","chr20","21685848","21686018","48","97692974"
"chr7","119411100","119411296","chr3","38839947","38840148","43","80571153"
"chr7","119418786","119419073","chr3","140315072","140315361","21","20896286"
"chr7","119430711","119430971","chr3","140327945","140328205","29","20897234"
"chr7","119442205","119442484","chr3","140339649","140339907","36","20897444"
"chr7","119447624","119447937","chr3","140345394","140345690","28","20897770"
"chr7","119626148","119626451","chr3","140524847","140525133","33","20898699"
"chr7","119644998","119645292","chr3","140543945","140544251","35","20898947"
"chr7","119660049","119660358","chr3","140553578","140553886","32","20893529"
"chr7","119670350","119670669","chr11","69522270","69522575","94","50148080"
"chr7","119719321","119719608","chr3","140608669","140608972","33","20889348"
"chr7","119726480","119726753","chr3","140616137","140616422","38","20889657"
"chr7","119733306","119733620","chr7","125738636","125738950","61","6005330"
"chr7","119781101","119781288","chr2","76019685","76019873","53","43761416"
"chr7","119810784","119811119","chr3","140700193","140700504","46","20889409"
"chr7","119932310","119932585","chr3","140831457","140831739","19","20899147"
"chr7","119940674","119940959","chr3","140839741","140840051","39","20899067"
"chr7","119975236","119975435","chr3","140874753","140874957","21","20899517"
"chr7","120034761","120035048","chr3","140937850","140938123","37","20903089"
"chr7","120177510","120177816","chr2","113501850","113502146","76","6675660"
"chr7","120405011","120405259","chr3","141318589","141318838","24","20913578"
"chr7","120492959","120493283","chr3","141407051","141407371","27","20914092"
"chr7","120505953","120506115","chr3","141419440","141419612","23","20913487"
"chr7","120589879","120590166","chr3","141502778","141503071","34","20912899"
"chr7","121008919","121009214","chr3","141909365","141909666","21","20900446"
"chr7","121038083","121038372","chr3","141938254","141938544","16","20900171"
"chr7","121058849","121059129","chr3","141953034","141953313","21","20894185"
"chr7","121136394","121136515","chr3","142026097","142026218","9","20889703"
"chr7","121153922","121154216","chr5","97271534","97271831","73","23882388"
"chr7","121191637","121191946","chr3","142077928","142078242","27","20886291"
"chr7","121313222","121313557","chr3","142197632","142197936","52","20884410"
"chr7","121318601","121318898","chr3","142203097","142203382","30","20884496"
"chr7","121423607","121423808","chr3","142303558","142303762","12","20879951"
"chr7","121451347","121451652","chr3","142331409","142331710","38","20880062"
"chr7","121486321","121486595","chr3","142362259","142362545","32","20875938"
"chr7","121501628","121501935","chr3","142368712","142369011","30","20867084"
"chr7","121514773","121515059","chr3","142381813","142382103","17","20867040"
"chr7","121519828","121520112","chr3","142387821","142388128","54","20867993"
"chr7","121522575","121522865","chr3","142390397","142390687","14","20867822"
"chr7","121524898","121525196","chr3","142392643","142392957","46","20867745"
"chr7","121533732","121534002","chr3","142402027","142402328","52","20868295"
"chr7","121573340","121573615","chr3","142443848","142444123","21","20870508"
"chr7","121579758","121580040","chr3","142449965","142450251","27","20870207"
"chr7","121605867","121606089","chr3","142475782","142476001","26","20869915"
"chr7","121616073","121616315","chr2","122209229","122209469","59","593156"
"chr7","121704079","121704377","chr19","46352560","46352866","55","75351519"
"chr7","121724689","121724989","chr1","60679452","60679746","63","61045237"
"chr7","121845258","121845562","chr10","12355678","12355978","55","109489580"
"chr7","121894443","121894711","chr3","142870869","142871149","31","20976426"
"chr7","121913024","121913286","chr8","30257500","30257766","64","91655524"
"chr7","121935060","121935227","chr19","31709980","31710139","34","90225080"
"chr7","121935253","121935391","chr12","57964185","57964303","30","63971068"
"chr7","121963133","121963432","chr3","142940062","142940355","20","20976929"
"chr7","121971477","121971764","chr3","142948429","142948724","38","20976952"
"chr7","122003836","122004137","chr3","142980726","142981020","26","20976890"
"chr7","122030397","122030744","chr3","143007352","143007697","27","20976955"
"chr7","122042010","122042287","chr3","143016746","143017024","22","20974736"
"chr7","122054958","122055247","chr3","143029674","143029959","34","20974716"
"chr7","122058910","122059174","chr3","143033608","143033876","12","20974698"
"chr7","122099283","122099573","chr3","143072186","143072472","26","20972903"
"chr7","122119931","122120011","chr5","2738092","2738170","16","119381839"
"chr7","122148418","122148727","chr3","143125374","143125657","60","20976956"
"chr7","122161049","122161346","chr3","143138261","143138560","23","20977212"
"chr7","122168883","122169187","chr3","143150572","143150859","29","20981689"
"chr7","122245385","122245699","chr3","143222571","143222881","26","20977186"
"chr7","122290723","122290839","chr3","143263349","143263468","8","20972626"
"chr7","122338932","122339198","chr3","143315466","143315733","20","20976534"
"chr7","122386225","122386515","chr7","30265324","30265610","61","92120901"
"chr7","122418215","122418494","chr3","143393339","143393638","37","20975124"
"chr7","122472700","122472984","chr3","143449922","143450207","16","20977222"
"chr7","122687351","122687600","chr6","76782124","76782372","65","45905227"
"chr7","122799612","122799890","chr3","143758130","143758405","18","20958518"
"chr7","122846050","122846261","chr3","34594079","34594293","55","88251971"
"chr7","122944976","122945263","chr3","143922633","143922949","41","20977657"
"chr7","122982520","122982828","chr3","143959806","143960107","23","20977286"
"chr7","123035258","123035542","chr3","144018513","144018797","23","20983255"
"chr7","123106998","123107274","chr3","144090336","144090600","25","20983338"
"chr7","123241117","123241396","chr3","144237412","144237717","48","20996295"
"chr7","123302511","123302794","chr3","144296355","144296611","49","20993844"
"chr7","123405769","123406063","chr3","144405707","144406010","24","20999938"
"chr7","123507450","123507735","chr3","144520885","144521175","51","21013435"
"chr7","123579017","123579321","chr3","144681016","144681310","30","21101999"
"chr7","123886335","123886647","chr3","145018627","145018919","48","21132292"
"chr7","123903853","123904168","chr3","145027159","145027473","21","21123306"
"chr7","124104150","124104450","chr3","145470962","145471262","18","21366812"
"chr7","124222256","124222559","chr3","145348065","145348376","53","21125809"
"chr7","124442959","124443216","chr3","145105220","145105479","18","20662261"
"chr7","124616571","124616817","chr6","166806973","166807213","66","42190402"
"chr7","124890749","124891052","chr3","146165950","146166223","40","21275201"
"chr7","125257606","125257895","chr3","146536129","146536434","39","21278523"
"chr7","125347375","125347668","chr3","146628909","146629214","32","21281534"
"chr7","125507990","125508295","chr3","146785212","146785522","26","21277222"
"chr7","125553682","125553934","chr3","146831743","146832000","35","21278061"
"chr7","125615832","125616126","chr3","146891633","146891901","47","21275801"
"chr7","125674223","125674453","chr3","146950344","146950567","29","21276121"
"chr7","125674458","125674489","chr3","146950572","146950603","0","21276114"
"chr7","125722723","125723039","chr3","146998516","146998825","34","21275793"
"chr7","126025724","126026022","chr3","147295391","147295702","35","21269667"
"chr7","126067710","126067998","chr3","147337110","147337409","32","21269400"
"chr7","126107978","126108295","chr3","147377402","147377709","32","21269424"
"chr7","126128714","126129004","chr3","147395853","147396134","57","21267139"
"chr7","126137383","126137671","chr3","147404828","147405119","31","21267445"
"chr7","126190854","126191157","chr10","32154454","32154755","58","94036400"
"chr7","126254107","126254383","chr3","147525461","147525757","38","21271354"
"chr7","126300226","126300489","chr3","147569814","147570076","27","21269588"
"chr7","126360978","126361255","chr3","147631667","147631948","26","21270689"
"chr7","126401494","126401697","chr3","147673897","147674100","15","21272403"
"chr7","126505876","126505997","chr3","147781524","147781645","11","21275648"
"chr7","126508798","126508975","chr3","147784822","147784996","14","21276024"
"chr7","126538530","126538827","chr13","32417351","32417638","74","94121179"
"chr7","126647499","126647771","chr3","147928567","147928868","56","21281068"
"chr7","126770973","126771290","chr3","148053158","148053470","43","21282185"
"chr7","126841139","126841259","chr3","148123302","148123422","9","21282163"
"chr7","126841369","126841686","chr3","148123531","148123837","48","21282162"
"chr7","126853837","126854107","chr3","148137599","148137866","31","21283762"
"chr7","126854638","126854935","chr3","148138433","148138710","42","21283795"
"chr7","126858738","126859029","chr19","13587623","13587915","67","113271115"
"chr7","126924989","126925280","chr3","148203275","148203568","22","21278286"
"chr7","126930022","126930317","chr3","148208225","148208513","38","21278203"
"chr7","126959199","126959375","chr1","191518008","191518188","48","64558809"
"chr7","126959741","126959771","chr3","148232389","148232419","2","21272648"
"chr7","126982289","126982582","chr3","124267629","124267922","59","2714660"
"chr7","127015786","127016069","chr3","148286542","148286823","20","21270756"
"chr7","127033358","127033652","chr17","56562552","56562854","65","70470806"
"chr7","127058394","127058692","chr3","148329954","148330264","33","21271560"
"chr7","127119180","127119485","chr3","148395607","148395880","55","21276427"
"chr7","127143548","127143845","chr3","148420213","148420502","34","21276665"
"chr7","127187325","127187536","chr3","148468031","148468242","30","21280706"
"chr7","127195897","127196192","chr3","148482840","148483136","19","21286943"
"chr7","127199474","127199767","chr16","26744282","26744558","70","100455192"
"chr7","127211157","127211440","chr10","77425876","77426160","65","49785281"
"chr7","127242745","127243012","chr3","148528785","148529074","43","21286040"
"chr7","127268738","127269033","chr19","3353989","3354279","62","123914749"
"chr7","127303423","127303547","chr2","44878801","44878925","15","82424622"
"chr7","127483770","127484090","chr3","148758300","148758611","42","21274530"
"chr7","127504191","127504398","chr15","26747036","26747237","43","100757155"
"chr7","127553387","127553681","chr3","40288905","40289201","61","87264482"
"chr7","127632746","127633044","chr3","148917802","148918097","29","21285056"
"chr7","127656360","127656659","chr3","148941969","148942267","26","21285609"
"chr7","127818315","127818577","chr3","149167399","149167681","29","21349084"
"chr7","127958735","127959043","chr3","149316194","149316499","40","21357459"
"chr7","128329142","128329455","chr1","67060884","67061188","74","61268258"
"chr7","128383587","128383884","chr3","149749858","149750148","16","21366271"
"chr7","128388839","128389143","chr3","149755563","149755866","26","21366724"
"chr7","128415784","128416073","chr3","149782804","149783095","19","21367020"
"chr7","128448906","128449230","chr3","149815628","149815940","33","21366722"
"chr7","128450040","128450346","chr3","149816769","149817082","24","21366729"
"chr7","128451303","128451600","chr3","149817976","149818276","29","21366673"
"chr7","128496487","128496759","chr3","149861371","149861643","16","21364884"
"chr7","128503424","128503627","chr3","149866384","149866586","22","21362960"
"chr7","128551929","128552053","chr9","103068152","103068271","23","25483777"
"chr7","128586008","128586298","chr9","74384192","74384482","35","54201816"
"chr7","128587353","128587615","chr9","74385540","74385810","46","54201813"
"chr7","128613928","128614226","chr3","150008719","150009017","18","21394791"
"chr7","128620714","128620996","chr3","150017334","150017616","16","21396620"
"chr7","128637824","128638005","chr10","59954475","59954640","55","68683349"
"chr7","128643776","128643892","chr3","150040890","150041010","19","21397114"
"chr7","128650710","128650996","chr3","150047927","150048193","44","21397217"
"chr7","128699046","128699338","chr3","150143712","150143998","21","21444666"
"chr7","128701070","128701360","chr9","63095691","63095976","64","65605379"
"chr7","128709863","128710188","chr10","20052893","20053199","68","108656970"
"chr7","128749603","128749870","chr3","150194987","150195266","26","21445384"
"chr7","128978533","128978801","chr3","150404484","150404752","22","21425951"
"chr7","129174922","129175167","chr3","150592554","150592798","10","21417632"
"chr7","129201765","129202004","chr1","222943933","222944161","60","93742168"
"chr7","129391252","129391574","chr3","150810805","150811131","34","21419553"
"chr7","129459162","129459448","chr3","39913959","39914245","64","89545203"
"chr7","129462048","129462268","chr3","150879509","150879729","16","21417461"
"chr7","129467921","129468205","chr3","150885376","150885665","22","21417455"
"chr7","129521227","129521558","chr3","150939833","150940160","32","21418606"
"chr7","129606908","129607115","chr3","151027904","151028111","12","21420996"
"chr7","129665563","129665692","chr3","151095863","151095996","8","21430300"
"chr7","129666142","129666316","chr3","151096441","151096598","38","21430299"
"chr7","129821483","129821746","chr14","49696634","49696902","59","80124849"
"chr7","129975871","129975996","chr3","151418018","151418143","11","21442147"
"chr7","130051587","130051851","chr3","151503382","151503640","43","21451795"
"chr7","130151752","130152004","chr3","151623452","151623705","20","21471700"
"chr7","130377737","130378018","chr2","84913076","84913368","60","45464661"
"chr7","130378096","130378394","chr3","151695522","151695837","54","21317426"
"chr7","130381568","130381851","chr3","151692438","151692700","58","21310870"
"chr7","130526849","130527058","chr8","30275478","30275683","53","100251371"
"chr7","130571159","130571442","chr3","152062874","152063156","22","21491715"
"chr7","130571611","130571911","chr3","152063315","152063613","26","21491704"
"chr7","130649556","130649823","chr3","152137524","152137802","43","21487968"
"chr7","130736218","130736340","chr3","152221766","152221891","12","21485548"
"chr7","130894842","130894966","chr3","152367132","152367255","9","21472290"
"chr7","130915909","130916178","chr3","152387611","152387879","19","21471702"
"chr7","131149284","131149569","chr3","152679021","152679322","37","21529737"
"chr7","131227040","131227159","chr1","41882609","41882725","20","89344431"
"chr7","131227205","131227359","chr16","5299652","5299807","27","125927553"
"chr7","131321784","131322001","chr16","12815462","12815681","44","118506322"
"chr7","131442502","131442631","chr5","37288892","37289024","21","94153610"
"chr7","131450495","131450796","chr3","152977132","152977437","27","21526637"
"chr7","131595213","131595488","chr3","153135448","153135722","21","21540235"
"chr7","131634954","131635237","chr3","153175930","153176215","23","21540976"
"chr7","131638579","131638887","chr1","44516138","44516440","64","87122441"
"chr7","131871241","131871491","chr3","153404334","153404590","22","21533093"
"chr7","131940540","131940767","chr3","153479068","153479299","16","21538528"
"chr7","131954443","131954729","chr3","153494595","153494898","33","21540152"
"chr7","132011818","132012085","chr3","153559893","153560160","13","21548075"
"chr7","132058296","132058555","chr3","153607424","153607683","14","21549128"
"chr7","132087020","132087337","chr10","84049729","84050040","58","48037291"
"chr7","132090064","132090371","chr20","60819528","60819838","49","71270536"
"chr7","132128819","132129038","chr1","222636255","222636478","50","90507436"
"chr7","132129918","132130153","chr12","65437236","65437466","53","66692682"
"chr7","132162005","132162310","chr3","153759007","153759310","24","21597002"
"chr7","132182794","132183037","chr1","17778281","17778527","54","114404513"
"chr7","132212555","132212858","chr3","153809122","153809422","26","21596567"
"chr7","132217560","132217863","chr3","153814048","153814346","24","21596488"
"chr7","132243232","132243521","chrX","127405926","127406217","60","4837306"
"chr7","132276196","132276327","chr7","51796125","51796255","23","80480071"
"chr7","132289805","132290098","chr3","153885701","153886029","49","21595896"
"chr7","132303673","132303793","chr3","153900353","153900470","13","21596680"
"chr7","132307634","132307941","chr7","45639425","45639731","52","86668209"
"chr7","132337826","132338121","chr3","153933415","153933699","32","21595589"
"chr7","132338563","132338879","chr3","153934114","153934438","30","21595551"
"chr7","132385446","132385571","chr3","153982016","153982149","15","21596570"
"chr7","132399791","132400090","chr3","153996689","153996984","15","21596898"
"chr7","132413772","132414020","chr3","50287796","50288029","72","82125976"
"chr7","132434863","132435163","chr3","154032249","154032548","30","21597386"
"chr7","132448417","132448714","chr3","154045515","154045812","13","21597098"
"chr7","132493138","132493251","chr1","8162205","8162319","25","124330933"
"chr7","132515893","132516110","chr3","154113508","154113715","34","21597615"
"chr7","132522122","132522413","chr3","154119675","154119965","24","21597553"
"chr7","132523861","132524054","chr3","154121421","154121623","22","21597560"
"chr7","132532174","132532454","chr20","52878526","52878808","54","79653648"
"chr7","132558133","132558273","chr20","42683082","42683211","26","89875051"
"chr7","132559394","132559677","chr3","154156535","154156813","30","21597141"
"chr7","132572901","132573153","chr3","154170078","154170339","41","21597177"
"chr7","132586396","132586706","chr3","154183393","154183687","28","21596997"
"chr7","132602738","132603012","chr5","165714831","165715111","50","33112093"
"chr7","132691787","132691996","chr3","154288655","154288868","20","21596868"
"chr7","132733809","132734069","chr3","154332752","154333001","45","21598943"
"chr7","132734377","132734404","chr8","22177824","22177847","5","110556553"
"chr7","132771632","132771886","chr3","154370785","154371042","11","21599153"
"chr7","132788538","132788829","chr3","154387538","154387843","30","21599000"
"chr7","132792265","132792385","chr3","154391079","154391196","13","21598814"
"chr7","132817835","132818090","chr3","154417406","154417670","34","21599571"
"chr7","132819359","132819657","chr3","154419459","154419781","39","21600100"
"chr7","132823008","132823323","chr3","154423162","154423477","26","21600154"
"chr7","132849486","132849764","chr5","169061750","169062024","65","36212264"
"chr7","132860623","132860900","chr3","154462206","154462486","27","21601583"
"chr7","132875493","132875800","chrX","18434636","18434931","75","114440857"
"chr7","132877150","132877443","chr3","154479189","154479474","23","21602039"
"chr7","132890178","132890494","chr8","124056441","124056744","61","8833737"
"chr7","132905011","132905294","chr3","43572948","43573229","60","89332063"
"chr7","132927297","132927540","chr3","154519902","154520138","29","21592605"
"chr7","132947302","132947595","chr3","154537926","154538200","28","21590624"
"chr7","132952370","132952478","chr3","154542962","154543070","12","21590592"
"chr7","132989917","132990204","chr3","154579454","154579746","24","21589537"
"chr7","133030019","133030318","chr3","154616784","154617069","42","21586765"
"chr7","133061560","133061744","chr3","154648637","154648814","21","21587077"
"chr7","133066141","133066457","chr4","2185273","2185588","56","130880868"
"chr7","133078119","133078435","chr19","2522911","2523212","79","130555208"
"chr7","133080318","133080512","chr5","2023599","2023790","37","131056719"
"chr7","133081803","133082084","chr3","154669162","154669442","18","21587359"
"chr7","133095934","133096063","chr1","155846166","155846296","17","22750232"
"chr7","133103811","133103953","chr3","154692891","154693032","10","21589080"
"chr7","133104246","133104430","chr3","154693309","154693492","20","21589063"
"chr7","133124337","133124639","chr3","49778017","49778315","39","83346320"
"chr7","133143508","133143797","chr11","109188160","109188443","77","23955348"
"chr7","133150595","133150720","chr3","154706310","154706435","8","21555715"
"chr7","133157822","133158101","chr3","154713164","154713425","38","21555342"
"chr7","133172387","133172686","chr3","154740477","154740761","47","21568090"
"chr7","133179906","133180192","chr16","55700437","55700720","57","77479469"
"chr7","133182056","133182350","chr1","52796524","52796820","58","80385532"
"chr7","133183854","133184134","chr3","154747978","154748260","11","21564124"
"chr7","133213503","133213737","chr20","27892908","27893144","71","105320595"
"chr7","133221287","133221558","chr3","154786969","154787237","22","21565682"
"chr7","133227212","133227521","chr11","117366311","117366614","51","15860901"
"chr7","133230794","133231090","chr3","154797045","154797341","28","21566251"
"chr7","133232549","133232853","chr5","6877676","6877984","67","126354873"
"chr7","133262428","133262759","chr3","154831725","154832065","31","21569297"
"chr7","133351802","133352106","chrX","64991673","64991978","60","68360129"
"chr7","133366174","133366463","chr3","154936141","154936398","47","21569967"
"chr7","133398095","133398400","chr3","154969449","154969741","33","21571354"
"chr7","133400245","133400549","chr3","154971572","154971876","19","21571327"
"chr7","133403356","133403661","chr3","154974706","154974999","34","21571350"
"chr7","133421428","133421709","chr3","154993304","154993599","31","21571876"
"chr7","133426918","133427186","chr3","154998808","154999080","28","21571890"
"chr7","133443772","133444024","chr3","155015710","155015961","11","21571938"
"chr7","133444709","133445013","chr3","155016599","155016903","33","21571890"
"chr7","133472967","133473170","chr3","155044884","155045088","19","21571917"
"chr7","133473704","133474013","chr13","37831904","37832211","70","95641800"
"chr7","133474246","133474542","chr20","69793772","69794067","83","63680474"
"chr7","133479077","133479357","chr3","155051011","155051292","17","21571934"
"chr7","133485884","133486172","chr7","41168727","41169016","60","92317157"
"chr7","133491349","133491633","chr3","155061423","155061718","30","21570074"
"chr7","133496671","133496814","chr3","155067051","155067195","10","21570380"
"chr7","133497120","133497193","chr3","155067508","155067584","11","21570388"
"chr7","133501842","133502112","chr3","155072257","155072560","53","21570415"
"chr7","133508842","133508958","chr1","130463532","130463644","20","3045310"
"chr7","133511942","133512255","chr3","155082330","155082624","46","21570388"
"chr7","133517691","133517985","chr3","155088406","155088685","28","21570715"
"chr7","133519723","133520015","chr3","155090406","155090691","37","21570683"
"chr7","133534891","133535183","chr3","155104962","155105251","15","21570071"
"chr7","133542572","133542874","chr3","155113259","155113564","23","21570687"
"chr7","133543056","133543339","chr3","155113746","155114031","18","21570690"
"chr7","133547351","133547631","chr3","155118030","155118309","14","21570679"
"chr7","133555783","133556077","chr3","155126543","155126835","26","21570760"
"chr7","133556206","133556486","chr3","155126977","155127245","29","21570771"
"chr7","133556959","133557083","chr3","155127713","155127837","10","21570754"
"chr7","133557784","133558115","chr4","27191661","27191993","78","106366123"
"chr7","133564481","133564760","chr5","51322379","51322663","51","82242102"
"chr7","133572706","133572822","chr3","155143744","155143860","7","21571038"
"chr7","133587514","133587790","chr3","155157095","155157373","13","21569581"
"chr7","133590363","133590633","chr3","155159967","155160226","29","21569604"
"chr7","133603004","133603313","chr8","101745971","101746276","56","31857033"
"chr7","133606974","133607250","chr3","155172636","155172910","19","21565662"
"chr7","133626520","133626820","chr3","155195905","155196202","37","21569385"
"chr7","133629435","133629706","chr3","155198800","155199072","17","21569365"
"chr7","133641097","133641359","chr3","155207102","155207364","18","21566005"
"chr7","133651514","133651859","chr3","155218740","155219109","45","21567226"
"chr7","133699134","133699442","chr3","155268032","155268341","15","21568898"
"chr7","133700358","133700584","chr3","155269174","155269404","16","21568816"
"chr7","133713689","133713896","chr3","155282643","155282855","25","21568954"
"chr7","133714187","133714304","chr3","155283153","155283260","15","21568966"
"chr7","133714318","133714441","chr3","155283274","155283397","8","21568956"
"chr7","133721379","133721490","chr1","148386664","148386780","16","14665285"
"chr7","133729281","133729554","chr3","155298608","155298885","19","21569327"
"chr7","133731729","133732014","chr3","155301041","155301307","38","21569312"
"chr7","133777655","133777858","chr3","155349064","155349264","39","21571409"
"chr7","133787735","133788042","chr3","155358868","155359166","21","21571133"
"chr7","133790465","133790608","chr15","9978764","9978905","34","123811701"
"chr7","133790609","133790868","chr1","35382302","35382551","57","98408307"
"chr7","133790869","133791072","chr3","41137310","41137484","63","92653559"
"chr7","133805996","133806283","chr3","155378361","155378666","37","21572365"
"chr7","133807355","133807646","chr3","155380382","155380691","38","21573027"
"chr7","133808185","133808474","chr3","155381217","155381493","41","21573032"
"chr7","133817761","133818036","chr3","155391490","155391750","44","21573729"
"chr7","133839340","133839544","chr3","155412357","155412564","23","21573017"
"chr7","133841653","133841926","chr3","155416476","155416751","20","21574823"
"chr7","133860779","133861080","chr3","155436608","155436918","34","21575829"
"chr7","133878396","133878703","chr3","155452291","155452595","33","21573895"
"chr7","133889384","133889575","chr3","155463420","155463599","19","21574036"
"chr7","133921288","133921636","chr3","143007352","143007697","90","9086064"
"chr7","133922746","133923066","chr3","155498266","155498585","18","21575520"
"chr7","133957809","133958147","chr3","155534036","155534388","28","21576227"
"chr7","133979507","133979804","chr3","155558904","155559194","26","21579397"
"chr7","133987621","133987924","chr3","46082653","46082959","67","87904968"
"chr7","133993544","133993828","chr3","155583784","155584072","32","21590240"
"chr7","134010826","134011112","chr3","155598062","155598336","27","21587236"
"chr7","134013527","134013830","chr3","155600782","155601095","25","21587255"
"chr7","134022642","134022914","chr3","155614446","155614718","19","21591804"
"chr7","134038686","134038887","chr3","155633580","155633782","11","21594894"
"chr7","134048617","134048738","chr3","155643971","155644090","10","21595354"
"chr7","134054884","134055001","chr19","12616527","12616642","15","121438357"
"chr7","134093078","134093320","chr1","124676766","124677019","56","9416312"
"chr7","134099860","134100162","chr12","49172411","49172712","70","84927449"
"chr7","134101966","134102263","chr3","155699006","155699301","22","21597040"
"chr7","134108938","134109127","chr3","38240090","38240274","45","95868848"
"chr7","134109431","134109567","chr17","54442955","54443088","21","79666476"
"chr7","134114675","134115003","chr3","155712012","155712291","89","21597337"
"chr7","134115431","134115719","chr3","155712888","155713169","36","21597457"
"chr7","134141824","134142130","chr3","155740691","155741001","21","21598867"
"chr7","134151301","134151557","chr20","29357836","29358099","54","104793465"
"chr7","134157646","134157937","chr3","155755051","155755351","33","21597405"
"chr7","134164644","134164921","chr3","155762313","155762590","40","21597669"
"chr7","134165025","134165330","chr3","155762694","155762981","38","21597669"
"chr7","134165435","134165656","chr3","155763103","155763325","19","21597668"
"chr7","134168358","134168510","chr3","155765722","155765874","9","21597364"
"chr7","134183674","134183980","chr3","155781725","155782035","18","21598051"
"chr7","134214027","134214329","chr3","155814442","155814753","27","21600415"
"chr7","134214943","134215232","chr3","155815373","155815666","25","21600430"
"chr7","134219602","134219669","chr1","54094474","54094540","17","80125128"
"chr7","134237265","134237584","chr3","155838336","155838643","27","21601071"
"chr7","134283722","134284009","chr3","155885379","155885678","26","21601657"
"chr7","134293365","134293666","chr5","58336931","58337232","53","75956434"
"chr7","134302027","134302207","chr11","117464535","117464706","38","16837492"
"chr7","134311758","134312050","chr8","140237579","140237870","60","5925821"
"chr7","134327624","134327899","chr3","155933953","155934231","23","21606329"
"chr7","134343128","134343275","chr14","64835571","64835718","27","69507557"
"chr7","134375782","134375912","chr3","155986093","155986221","8","21610311"
"chr7","134382065","134382353","chr3","155988789","155989076","19","21606724"
"chr7","134389268","134389561","chr3","155996000","155996293","32","21606732"
"chr7","134403831","134403886","chr5","73307081","73307136","16","61096750"
"chr7","134444518","134444796","chr3","156052350","156052617","30","21607832"
"chr7","134446435","134446720","chr20","57045353","57045640","60","77401082"
"chr7","134450745","134451067","chr3","127889632","127889949","73","6561113"
"chr7","134465670","134465852","chr3","156076285","156076451","25","21610615"
"chr7","134466128","134466286","chr1","130805601","130805750","31","3660527"
"chr7","134469355","134469475","chr8","17947254","17947371","21","116522101"
"chr7","134475422","134475661","chr20","24231851","24232119","88","110243571"
"chr7","134478017","134478274","chr10","79561228","79561491","53","54916789"
"chr7","134481441","134481569","chr3","156095196","156095317","18","21613755"
"chr7","134494110","134494275","chr3","156108756","156108921","6","21614646"
"chr7","134517063","134517225","chr5","63843987","63844154","36","70673076"
"chr7","134532480","134532594","chr3","156149772","156149884","9","21617292"
"chr7","134547066","134547246","chr3","38240090","38240274","31","96306976"
"chr7","134548128","134548313","chr6","76606783","76606975","38","57941345"
"chr7","134551147","134551417","chr16","21941769","21942047","56","112609378"
"chr7","134553178","134553284","chr2","46187533","46187640","22","88365645"
"chr7","134564731","134565002","chr3","156182074","156182342","21","21617343"
"chr7","134584433","134584598","chr3","156205113","156205291","24","21620680"
"chr7","134593695","134593916","chr3","156214474","156214698","15","21620779"
"chr7","134603601","134603885","chr3","156224483","156224775","24","21620882"
"chr7","134657247","134657530","chr3","156285053","156285337","15","21627806"
"chr7","134662945","134663263","chr3","156290853","156291161","28","21627908"
"chr7","134698552","134698835","chr4","15192582","15192862","66","119505970"
"chr7","134717134","134717218","chr4","113431942","113432025","17","21285192"
"chr7","134727044","134727161","chr13","89958796","89958914","13","44768248"
"chr7","134771699","134771984","chrX","103046997","103047266","61","31724702"
"chr7","134774587","134774868","chr3","156401095","156401396","35","21626508"
"chr7","134780565","134780884","chr3","132351538","132351859","71","2429027"
"chr7","134804421","134804716","chr20","10719806","10720100","51","124084615"
"chr7","134808955","134809271","chr3","156435379","156435680","42","21626424"
"chr7","134810390","134810518","chr1","200289163","200289285","23","65478773"
"chr7","134824644","134824824","chr3","156452640","156452819","15","21627996"
"chr7","134862260","134862544","chr3","156490899","156491194","30","21628639"
"chr7","134873476","134873779","chr3","156502232","156502542","32","21628756"
"chr7","134903864","134903997","chr3","156532967","156533099","12","21629103"
"chr7","134915972","134916254","chr7","137856198","137856481","52","2940226"
"chr7","134926638","134926760","chr19","19289947","19290075","23","115636691"
"chr7","134939730","134940036","chr3","156574642","156574955","28","21634912"
"chr7","134940590","134940895","chr9","112769142","112769441","64","22171448"
"chr7","134942749","134943007","chr3","156577932","156578189","11","21635183"
"chr7","134955324","134955628","chr3","156590264","156590576","38","21634940"
"chr7","134985801","134986116","chr3","156622456","156622767","27","21636655"
"chr7","135073291","135073592","chr3","156693544","156693844","28","21620253"
"chr7","135110448","135110714","chr3","156734707","156734959","27","21624259"
"chr7","135125355","135125653","chr3","156745906","156746211","30","21620551"
"chr7","135151759","135152052","chr12","91704994","91705286","65","43446765"
"chr7","135159755","135160060","chr3","156783068","156783375","24","21623313"
"chr7","135162928","135163123","chr10","31228290","31228480","41","103934638"
"chr7","135163419","135163539","chr16","44320962","44321073","22","90842457"
"chr7","135186656","135186930","chr3","156811483","156811757","18","21624827"
"chr7","135188044","135188315","chr3","156812919","156813190","17","21624875"
"chr7","135203245","135203549","chr1","94546171","94546474","62","40657074"
"chr7","135203673","135203802","chr1","163001034","163001161","25","27797361"
"chr7","135222363","135222547","chr3","156847357","156847546","15","21624994"
"chr7","135250871","135250966","chr3","156889692","156889787","8","21638821"
"chr7","135256186","135256463","chr3","156893306","156893582","25","21637120"
"chr7","135326217","135326530","chr3","156969898","156970209","30","21643681"
"chr7","135328804","135329164","chr3","156972529","156972874","44","21643725"
"chr7","135346261","135346555","chr3","156990475","156990783","44","21644214"
"chr7","135370759","135371060","chr3","157015677","157015948","56","21644918"
"chr7","135387353","135387653","chr3","157032247","157032528","43","21644894"
"chr7","135409098","135409407","chr3","157054449","157054729","41","21645351"
"chr7","135418558","135418846","chr3","157063792","157064084","22","21645234"
"chr7","135426865","135427167","chr3","157072108","157072406","19","21645243"
"chr7","135465789","135466090","chr3","157112072","157112357","33","21646283"
"chr7","135497037","135497160","chr10","31827978","31828101","16","103669059"
"chr7","135534998","135535201","chr3","157180296","157180499","24","21645298"
"chr7","135535222","135535507","chr3","157180520","157180811","27","21645298"
"chr7","135536790","135537077","chr3","157182100","157182391","55","21645310"
"chr7","135548940","135549048","chr3","157192335","157192444","11","21643395"
"chr7","135567772","135568063","chr3","157210407","157210698","31","21642635"
"chr7","135579076","135579374","chr3","157221913","157222211","19","21642837"
"chr7","135602726","135602788","chr3","157245013","157245075","6","21642287"
"chr7","135604829","135604963","chr3","157247111","157247235","16","21642282"
"chr7","135608785","135609085","chr3","157250743","157251024","30","21641958"
"chr7","135609983","135610283","chr3","157251923","157252225","25","21641940"
"chr7","135610289","135610404","chr7","130813010","130813119","21","4797279"
"chr7","135610449","135610608","chr4","161962632","161962792","31","26352183"
"chr7","135623018","135623326","chr3","157265022","157265329","19","21642004"
"chr7","135627963","135628267","chr3","157269989","157270294","29","21642026"
"chr7","135631518","135631801","chr3","157273512","157273793","16","21641994"
"chr7","135660742","135660877","chr1","182272624","182272756","23","46611882"
"chr7","135665537","135665832","chr4","38028758","38029046","61","97636779"
"chr7","135675969","135676272","chr3","157317512","157317821","31","21641543"
"chr7","135677989","135678201","chr3","157319856","157320068","13","21641867"
"chr7","135681153","135681250","chr14","99484777","99484882","15","36196376"
"chr7","135685559","135685846","chr7","71549523","71549809","55","64136036"
"chr7","135715718","135716022","chr3","157356433","157356742","30","21640715"
"chr7","135718328","135718630","chr3","157359017","157359324","21","21640689"
"chr7","135718914","135719209","chr3","157359608","157359908","21","21640694"
"chr7","135721262","135721560","chr3","157361980","157362274","21","21640718"
"chr7","135733889","135734227","chr3","157374813","157375181","57","21640924"
"chr7","135752480","135752766","chr3","157393446","157393732","30","21640966"
"chr7","135757496","135757775","chr3","157398559","157398837","16","21641063"
"chr7","135760862","135761143","chr3","157401620","157401908","17","21640758"
"chr7","135765948","135766250","chr20","10607880","10608176","66","125158068"
"chr7","135770940","135771235","chr3","157412073","157412366","21","21641133"
"chr7","135772644","135772920","chr3","157413782","157414067","20","21641138"
"chr7","135778043","135778129","chr18","40031232","40031316","17","95746811"
"chr7","135783181","135783485","chr3","157424273","157424582","18","21641092"
"chr7","135829881","135830132","chr3","157470191","157470446","22","21640310"
"chr7","135871897","135872203","chr3","157508283","157508585","19","21636386"
"chr7","135886791","135886908","chr14","31928471","31928586","22","103958320"
"chr7","135900345","135900631","chr3","157536431","157536713","19","21636086"
"chr7","135905965","135906276","chr3","157542074","157542361","52","21636109"
"chr7","135912654","135912950","chr3","157550264","157550575","38","21637610"
"chr7","135924584","135924708","chr3","133994127","133994239","38","1930457"
"chr7","135924786","135924922","chr1","70047654","70047775","43","65877132"
"chr7","135942042","135942347","chr3","157577642","157577945","27","21635600"
"chr7","135942860","135943163","chr3","157578458","157578760","26","21635598"
"chr7","135947104","135947195","chr12","43283820","43283911","15","92663284"
"chr7","135957611","135957856","chr3","157593202","157593456","20","21635591"
"chr7","135959582","135959870","chr3","157595188","157595492","43","21635606"
"chr7","135972743","135973046","chr7","114691184","114691486","55","21281559"
"chr7","135978785","135979078","chr14","113120392","113120687","65","22858393"
"chr7","135988718","135988841","chr5","146222003","146222128","18","10233285"
"chr7","136023099","136023405","chr1","35595269","35595576","61","100427830"
"chr7","136041759","136041872","chr3","157679179","157679296","10","21637420"
"chr7","136053444","136053758","chr1","89966414","89966727","57","46087030"
"chr7","136071098","136071198","chr3","157707645","157707745","5","21636547"
"chr7","136074549","136074682","chr3","157711258","157711385","15","21636709"
"chr7","136075239","136075452","chr3","157711851","157712066","11","21636612"
"chr7","136085306","136085523","chr3","157722380","157722598","18","21637074"
"chr7","136094351","136094647","chr3","157732433","157732732","27","21638082"
"chr7","136094744","136095048","chr3","157732830","157733173","54","21638086"
"chr7","136100928","136101228","chr3","157739051","157739355","27","21638123"
"chr7","136124368","136124689","chr3","157763655","157763969","35","21639287"
"chr7","136135146","136135444","chr3","157775048","157775350","19","21639902"
"chr7","136138763","136139059","chr3","157778438","157778732","27","21639675"
"chr7","136139106","136139237","chr3","157778778","157778907","14","21639672"
"chr7","136162143","136162455","chr3","157800697","157800989","46","21638554"
"chr7","136182922","136183211","chr15","26923116","26923393","77","109259806"
"chr7","136192979","136193099","chr3","157831829","157831950","4","21638850"
"chr7","136194661","136194962","chr1","88358086","88358390","65","47836575"
"chr7","136202923","136203137","chr1","114320499","114320718","49","21882424"
"chr7","136217102","136217371","chr1","24628960","24629237","58","111588142"
"chr7","136251039","136251268","chr3","157891846","157892089","35","21640807"
"chr7","136273871","136274180","chr3","157911336","157911633","34","21637465"
"chr7","136295263","136295561","chr3","157932378","157932646","50","21637115"
"chr7","136330247","136330537","chr3","157965829","157966108","29","21635582"
"chr7","136446474","136446740","chr3","158083304","158083565","22","21636830"
"chr7","136451753","136452053","chr3","158088665","158088947","52","21636912"
"chr7","136477821","136478101","chr3","158116897","158117189","42","21639076"
"chr7","136495919","136496210","chr3","10015916","10016212","56","126480003"
"chr7","136508865","136509180","chr3","158184399","158184683","44","21675534"
"chr7","136557764","136558030","chrX","111904330","111904595","54","24653434"
"chr7","136651772","136652092","chr3","158325213","158325528","25","21673441"
"chr7","136767376","136767660","chr3","158441062","158441347","22","21673686"
"chr7","136816236","136816547","chr3","158491937","158492256","41","21675701"
"chr7","136818292","136818355","chr14","88158486","88158547","14","48659806"
"chr7","136850618","136850913","chr3","158526135","158526420","31","21675517"
"chr7","136946734","136946868","chr3","158620808","158620945","10","21674074"
"chr7","136962712","136963011","chr3","158636770","158637057","56","21674058"
"chr7","137008953","137009233","chr3","158682194","158682476","24","21673241"
"chr7","137126239","137126532","chr3","158797371","158797666","28","21671132"
"chr7","137185396","137185576","chr19","4906316","4906490","51","132279080"
"chr7","137185877","137186068","chr12","117781566","117781757","43","19404311"
"chr7","137196864","137197186","chr3","158861266","158861593","34","21664402"
"chr7","137208673","137208762","chr3","158873113","158873201","2","21664440"
"chr7","137208788","137209097","chr3","158873231","158873545","28","21664443"
"chr7","137211246","137211378","chr3","158875680","158875813","10","21664434"
"chr7","137215717","137216002","chr3","158880222","158880506","27","21664505"
"chr7","137229625","137229915","chr3","158894101","158894409","34","21664476"
"chr7","137236448","137236731","chr3","158900787","158901075","31","21664339"
"chr7","137261240","137261513","chr3","158923533","158923826","56","21662293"
"chr7","137319780","137320091","chr3","158981354","158981625","57","21661574"
"chr7","137387261","137387558","chr3","159046115","159046419","25","21658854"
"chr7","137399820","137400100","chr3","159059575","159059863","26","21659755"
"chr7","137469471","137469786","chr3","159129004","159129314","35","21659533"
"chr7","137541490","137541795","chr3","159200734","159201038","22","21659244"
"chr7","137580968","137581262","chr19","18993582","18993879","61","118587386"
"chr7","137589717","137589954","chr3","159248356","159248592","14","21658639"
"chr7","137594304","137594601","chr3","159253971","159254285","39","21659667"
"chr7","137608825","137609111","chr3","159268583","159268848","32","21659758"
"chr7","137640617","137640914","chr3","159300785","159301080","34","21660168"
"chr7","137641945","137642108","chr2","50659820","50659989","41","86982125"
"chr7","137672103","137672399","chr3","159331205","159331498","22","21659102"
"chr7","137681403","137681705","chr3","159344053","159344351","19","21662650"
"chr7","137685422","137685699","chr16","55700437","55700720","66","81984985"
"chr7","137720135","137720207","chr1","164329086","164329157","15","26608951"
"chr7","137722611","137722926","chr3","159385141","159385425","50","21662530"
"chr7","137823979","137824266","chr3","159487991","159488293","29","21664012"
"chr7","137881499","137881780","chr3","159553106","159553385","17","21671607"
"chr7","137884670","137884810","chr3","159556145","159556278","12","21671475"
"chr7","137884850","137885007","chr3","159556326","159556486","12","21671476"
"chr7","137927851","137928152","chr3","159598820","159599135","29","21670969"
"chr7","137929719","137929998","chr2","99689040","99689328","57","38240679"
"chr7","137944341","137944653","chr3","159615193","159615507","49","21670852"
"chr7","137975572","137975900","chr3","159645420","159645747","23","21669848"
"chr7","137994895","137995168","chr7","40020972","40021243","59","97973923"
"chr7","137998553","137998849","chr20","10719806","10720100","62","127278747"
"chr7","138017786","138018099","chr3","159683704","159683992","53","21665918"
"chr7","138068541","138068611","chr3","159739132","159739203","6","21670591"
"chr7","138069393","138069578","chr3","159739987","159740178","19","21670594"
"chr7","138100169","138100449","chr3","159770047","159770325","23","21669878"
"chr7","138102505","138102753","chr3","126794297","126794543","45","11308208"
"chr7","138182095","138182361","chr3","159851042","159851308","30","21668947"
"chr7","138229992","138230298","chr3","159898688","159898985","35","21668696"
"chr7","138238507","138238624","chr10","15668849","15668965","20","122569658"
"chr7","138266360","138266540","chr19","28356007","28356185","30","109910353"
"chr7","138266575","138266602","chr16","41419029","41419053","7","96847546"
"chr7","138304168","138304461","chr3","159972340","159972685","74","21668172"
"chr7","138358153","138358451","chr3","160029539","160029836","33","21671386"
"chr7","138362409","138362668","chr3","160034370","160034649","47","21671961"
"chr7","138389415","138389535","chr3","160061449","160061575","12","21672034"
"chr7","138460624","138460822","chr3","160132476","160132674","14","21671852"
"chr7","138482121","138482400","chr3","160153992","160154274","16","21671871"
"chr7","138599606","138599907","chr3","160278652","160278970","40","21679046"
"chr7","138626604","138626912","chr3","160305499","160305789","45","21678895"
"chr7","138635583","138635887","chr20","33290128","33290435","63","105345455"
"chr7","138657750","138658054","chr3","160336865","160337164","16","21679115"
"chr7","138691218","138691339","chr3","160371385","160371515","14","21680167"
"chr7","138898501","138898719","chr18","45791808","45792027","49","93106693"
"chr7","138908227","138908509","chr3","160581656","160581950","32","21673429"
"chr7","138988990","138989236","chr3","160664912","160665160","19","21675922"
"chr7","138993361","138993633","chr3","160698822","160699095","30","21705461"
"chr7","139000011","139000153","chr4","68582319","68582454","41","70417692"
"chr7","139008114","139008412","chr3","160715600","160715884","46","21707486"
"chr7","139030827","139031133","chr3","160698822","160699095","57","21667995"
"chr7","139038711","139038995","chr3","160853048","160853314","55","21814337"
"chr7","139046415","139046712","chr3","160715600","160715884","76","21669185"
"chr7","139047393","139047526","chr3","160740796","160740919","23","21693403"
"chr7","139083451","139083628","chr3","160896478","160896657","19","21813027"
"chr7","139175758","139175987","chr17","28541848","28542084","53","110633910"
"chr7","139266113","139266428","chr14","69384104","69384414","61","69882009"
"chr7","139277665","139277963","chr3","161094377","161094684","30","21816712"
"chr7","139348594","139348909","chr3","161170090","161170409","21","21821496"
"chr7","139369503","139369812","chr1","8665723","8666021","55","130703780"
"chr7","139512511","139512811","chr3","161331100","161331400","17","21818589"
"chr7","139611836","139611967","chr20","10592316","10592447","18","129019520"
"chr7","139624289","139624597","chr3","161466525","161466836","29","21842236"
"chr7","139660744","139661046","chr3","161503080","161503385","13","21842336"
"chr7","139701302","139701471","chr3","161541446","161541638","36","21840144"
"chr7","139703322","139703618","chr3","161544812","161545101","49","21841490"
"chr7","139799499","139799763","chr3","161652160","161652447","39","21852661"
"chr7","139862048","139862313","chr3","161715770","161716039","22","21853722"
"chr7","139874659","139874791","chr3","161728325","161728457","8","21853666"
"chr7","139897325","139897630","chr3","161750508","161750797","46","21853183"
"chr7","139897950","139898242","chr3","161751138","161751430","21","21853188"
"chr7","139900318","139900619","chr3","161753447","161753750","30","21853129"
"chr7","139906439","139906739","chr8","129433118","129433406","73","10473321"
"chr7","139909739","139910022","chr5","25436975","25437257","61","114472764"
"chr7","139912834","139913135","chr3","161764674","161764973","31","21851840"
"chr7","139918954","139919231","chr3","161770822","161771096","19","21851868"
"chr7","139921962","139922265","chr3","161773804","161774109","27","21851842"
"chr7","139934400","139934687","chr3","161787113","161787386","36","21852713"
"chr7","139949786","139950075","chr9","62234728","62235009","66","77715058"
"chr7","139959360","139959482","chr3","161808557","161808679","6","21849197"
"chr7","139969331","139969618","chr3","161820387","161820676","21","21851056"
"chr7","139979333","139979632","chr3","161829883","161830188","24","21850550"
"chr7","139982854","139983155","chr3","161834840","161835116","44","21851986"
"chr7","139989863","139990009","chr8","38185493","38185639","38","101804370"
"chr7","139991559","139991761","chr18","9758311","9758516","50","130233248"
"chr7","139992595","139992885","chr7","140100928","140101221","56","108333"
"chr7","139995469","139995736","chr3","161844185","161844457","47","21848716"
"chr7","139995991","139996249","chr3","161844749","161845007","23","21848758"
"chr7","140031591","140031869","chr3","161883149","161883425","23","21851558"
"chr7","140039869","140039975","chr3","161889819","161889929","8","21849950"
"chr7","140040321","140040601","chr3","161890260","161890537","15","21849939"
"chr7","140056955","140057059","chr3","161908529","161908642","17","21851574"
"chr7","140058009","140058289","chr3","161909590","161909871","21","21851581"
"chr7","140098944","140099227","chr3","161952696","161952981","29","21853752"
"chr7","140103423","140103735","chr3","161954687","161954996","23","21851264"
"chr7","140104095","140104215","chr3","161955341","161955461","14","21851246"
"chr7","140112814","140112937","chr3","161966280","161966408","9","21853466"
"chr7","140116712","140116997","chr3","161970181","161970471","21","21853469"
"chr7","140134118","140134371","chr12","64998241","64998491","67","75135877"
"chr7","140156086","140156387","chr14","9118976","9119265","62","131037110"
"chr7","140158797","140159141","chr9","105999659","105999970","86","34159138"
"chr7","140170182","140170443","chr20","20219234","20219493","50","119950948"
"chr7","140194884","140195173","chr20","33898905","33899198","65","106295979"
"chr7","140218833","140219132","chr3","162074964","162075249","28","21856131"
"chr7","140257142","140257440","chr3","162115035","162115347","36","21857893"
"chr7","140273582","140273870","chr3","162131761","162132050","13","21858179"
"chr7","140285765","140285895","chr3","162144405","162144534","4","21858640"
"chr7","140340908","140341094","chr10","61766160","61766338","42","78574748"
"chr7","140366752","140367023","chr3","162223169","162223439","24","21856417"
"chr7","140374099","140374349","chr3","162228415","162228691","49","21854316"
"chr7","140444915","140445210","chr3","162298446","162298762","38","21853531"
"chr7","140465764","140465998","chr3","162319430","162319655","36","21853666"
"chr7","140599107","140599397","chr3","162446499","162446791","23","21847392"
"chr7","140848740","140849052","chr11","117366311","117366614","64","23482429"
"chr7","140862684","140862991","chr3","162712829","162713132","31","21850145"
"chr7","140976265","140976550","chr3","162840075","162840360","22","21863810"
"chr7","140980590","140980860","chrX","23849808","23850081","58","117130782"
"chr7","141130634","141130918","chr6","76129927","76130214","71","65000707"
"chr7","141376311","141376616","chr3","163239482","163239793","30","21863171"
"chr7","141401806","141402102","chr3","163264609","163264912","29","21862803"
"chr7","141403288","141403541","chr3","41943668","41943932","70","99459620"
"chr7","141800786","141801089","chr3","163661596","163661906","27","21860810"
"chr7","141918010","141918280","chr3","163773252","163773520","27","21855242"
"chr7","142007066","142007357","chr3","163862917","163863217","26","21855851"
"chr7","142165814","142166114","chr3","164021937","164022227","20","21856123"
"chr7","142220094","142220168","chr3","164075593","164075676","15","21855499"
"chr7","142228724","142229006","chr3","164084268","164084570","51","21855544"
"chr7","142402077","142402367","chr3","164261672","164261987","45","21859595"
"chr7","142455944","142456201","chr3","164316778","164317036","19","21860834"
"chr7","142470793","142471099","chr2","84913076","84913368","54","57557717"
"chr7","142494676","142494789","chr14","124266147","124266261","41","18228529"
"chr7","142494982","142495204","chr15","27036591","27036810","60","115458391"
"chr7","142537726","142538034","chr3","164442156","164442461","23","21904430"
"chr7","142544389","142544654","chr3","164449681","164449952","18","21905292"
"chr7","142549565","142549941","chr12","52127277","52127631","116","90422288"
"chr7","142553656","142553942","chr3","164458415","164458709","24","21904759"
"chr7","142554561","142554847","chr3","164459323","164459607","18","21904762"
"chr7","142564971","142565264","chr3","164469748","164470042","22","21904777"
"chr7","142569004","142569319","chr3","164473532","164473847","22","21904528"
"chr7","142580489","142580606","chr3","164483313","164483414","18","21902824"
"chr7","142586216","142586330","chr3","164489787","164489901","6","21903571"
"chr7","142588887","142589070","chrY","10836463","10836639","47","131752424"
"chr7","142589355","142589498","chr3","164492911","164493054","7","21903556"
"chr7","142597317","142597424","chr3","164499143","164499255","14","21901826"
"chr7","142601347","142601577","chr3","164503204","164503448","35","21901857"
"chr7","142601669","142601946","chr3","164503540","164503793","46","21901871"
"chr7","142623854","142623981","chr20","37290700","37290826","21","105333154"
"chr7","142625205","142625497","chr15","26072924","26073215","61","116552281"
"chr7","142631213","142631483","chr3","164530139","164530408","20","21898926"
"chr7","142632826","142633106","chr3","164531724","164532006","24","21898898"
"chr7","142633897","142634204","chr3","164532802","164533103","23","21898905"
"chr7","142672531","142672731","chr3","164564149","164564349","17","21891618"
"chr7","142672780","142672936","chr3","164564399","164564580","36","21891619"
"chr7","142684610","142684883","chr3","164577269","164577541","15","21892659"
"chr7","142693054","142693109","chr10","59648710","59648775","19","83044344"
"chr7","142699820","142700109","chr1","53106748","53107031","47","89593072"
"chr7","142717631","142717927","chr7","127144040","127144341","57","15573591"
"chr7","142718611","142718914","chrX","64991673","64991978","57","77726938"
"chr7","142719792","142719938","chr13","62544009","62544139","35","80175783"
"chr7","142723138","142723439","chr3","164605865","164606158","25","21882727"
"chr7","142726859","142726974","chr3","164609482","164609606","18","21882623"
"chr7","142729630","142729950","chr3","164611326","164611633","43","21881696"
"chr7","142734893","142735216","chr3","164619528","164619824","61","21884635"
"chr7","142739161","142739434","chr3","164625377","164625614","56","21886216"
"chr7","142785324","142785600","chr3","164665688","164665981","34","21880364"
"chr7","142797652","142797932","chr3","164678363","164678643","26","21880711"
"chr7","142803723","142804017","chrX","133384189","133384486","73","9419534"
"chr7","142806777","142807073","chr19","736920","737215","62","142069857"
"chr7","142808776","142809006","chr3","35639309","35639528","45","107169467"
"chr7","142811311","142811538","chr3","164695978","164696215","31","21884667"
"chr7","142834590","142834880","chr1","1724256","1724542","56","141110334"
"chr7","142846209","142846482","chr3","164738271","164738554","29","21892062"
"chr7","142847924","142848114","chr3","164740135","164740325","24","21892211"
"chr7","142848196","142848489","chr3","164740407","164740713","35","21892211"
"chr7","142849082","142849372","chr3","164741303","164741601","22","21892221"
"chr7","142860987","142861287","chr3","164753992","164754291","23","21893005"
"chr7","142881058","142881217","chr3","164775015","164775164","27","21893957"
"chr7","142881246","142881403","chrX","19470669","19470831","42","123410577"
"chr7","142900267","142900391","chr3","164796222","164796338","14","21895955"
"chr7","142900949","142901242","chr3","164797535","164797829","29","21896586"
"chr7","142926817","142926927","chr3","164824114","164824228","19","21897297"
"chr7","142929962","142930263","chr3","164827428","164827739","27","21897466"
"chr7","142931198","142931326","chr3","164828675","164828802","9","21897477"
"chr7","142931348","142931639","chr3","164828824","164829140","51","21897476"
"chr7","142944938","142945066","chr3","164840700","164840828","7","21895762"
"chr7","142946281","142946405","chr12","120563713","120563835","19","22382568"
"chr7","142947327","142947459","chr3","164843087","164843217","13","21895760"
"chr7","142971576","142971767","chr3","164868660","164868870","29","21897084"
"chr7","142981782","142981952","chr3","164879204","164879371","11","21897422"
"chr7","142981962","142982133","chr3","164879381","164879560","22","21897419"
"chr7","142992166","142992276","chr3","164883326","164883434","23","21891160"
"chr7","142994803","142995029","chr3","4567942","4568157","62","138426861"
"chr7","143024791","143025054","chr3","164919476","164919753","30","21894685"
"chr7","143026299","143026482","chr3","164921009","164921155","47","21894710"
"chr7","143051303","143051603","chr3","164947358","164947678","62","21896055"
"chr7","143052678","143052984","chr3","164951392","164951704","36","21898714"
"chr7","143066907","143067174","chr13","55206784","55207060","53","87860123"
"chr7","143073644","143073951","chr3","164974944","164975254","18","21901300"
"chr7","143075246","143075352","chr3","164976552","164976658","6","21901306"
"chr7","143075353","143075520","chr7","83975810","83975960","52","59099543"
"chr7","143077726","143077855","chr3","164979496","164979627","13","21901770"
"chr7","143083073","143083199","chr3","164984791","164984918","8","21901718"
"chr7","143083206","143083515","chr15","83665176","83665476","60","59418030"
"chr7","143089379","143089675","chr8","71023728","71024027","63","72065651"
"chr7","143097757","143098054","chr3","164997295","164997596","26","21899538"
"chr7","143100393","143100568","chr1","21576038","21576212","40","121524355"
"chr7","143100840","143100973","chr7","133813449","133813579","22","9287391"
"chr7","143105723","143105988","chr3","165003039","165003326","42","21897316"
"chr7","143117659","143117912","chr3","165015564","165015813","27","21897905"
"chr7","143141464","143141671","chr6","44168034","44168239","56","98973430"
"chr7","143145239","143145363","chr13","107761171","107761292","19","35384068"
"chr7","143158853","143158970","chr3","165390639","165390763","16","22231786"
"chr7","143172861","143173162","chr3","165374499","165374803","19","22201638"
"chr7","143175124","143175348","chr3","165372795","165373037","37","22197671"
"chr7","143195573","143195863","chr3","165352825","165353131","35","22157252"
"chr7","143206854","143207156","chr3","165341563","165341858","40","22134709"
"chr7","143208783","143208907","chr7","137736915","137737039","10","5471868"
"chr7","143223155","143223316","chr3","165324787","165324945","12","22101632"
"chr7","143223618","143223781","chr20","10622496","10622641","40","132601122"
"chr7","143226756","143227067","chr3","165321026","165321331","31","22094270"
"chr7","143230980","143231097","chr3","165318636","165318758","17","22087656"
"chr7","143231133","143231420","chr3","165318318","165318605","17","22087185"
"chr7","143233922","143234217","chr1","93452484","93452781","55","49781438"
"chr7","143253184","143253393","chr3","165295251","165295467","20","22042067"
"chr7","143269158","143269429","chr3","165278348","165278618","17","22009190"
"chr7","143270831","143271131","chr17","7032433","7032735","54","136238398"
"chr7","143278245","143278545","chr3","165268523","165268807","33","21990278"
"chr7","143284931","143285060","chr3","165262057","165262192","13","21977126"
"chr7","143304172","143304446","chr3","165241524","165241809","34","21937352"
"chr7","143307610","143307915","chr3","165237854","165238156","26","21930244"
"chr7","143308242","143308544","chr3","165237254","165237541","35","21929012"
"chr7","143313311","143313603","chr3","165232151","165232447","23","21918840"
"chr7","143318633","143318914","chr3","165226767","165227053","33","21908134"
"chr7","143321374","143321664","chr3","165224084","165224336","49","21902710"
"chr7","143321816","143322032","chr3","165223698","165223916","23","21901882"
"chr7","143332279","143332574","chr3","165212916","165213213","24","21880637"
"chr7","143356568","143356690","chr3","36373230","36373353","18","106983338"
"chr7","143375948","143376229","chrX","103046997","103047266","60","40328951"
"chr7","143386186","143386309","chr3","36373230","36373353","22","107012956"
"chr7","143394047","143394350","chr9","99101491","99101790","45","44292556"
"chr7","143406454","143406577","chr3","165142712","165142835","6","21736258"
"chr7","143445758","143446053","chr3","165099668","165099971","28","21653910"
"chr7","143454916","143455209","chr3","165090835","165091128","19","21635919"
"chr7","143467120","143467450","chr9","62162362","62162677","73","81304758"
"chr7","143477427","143477560","chr3","165069203","165069338","11","21591776"
"chr7","143478190","143478377","chr3","165068384","165068575","20","21590194"
"chr7","143497630","143497937","chr3","165048147","165048444","53","21550517"
"chr7","143509151","143509450","chr3","165405696","165405992","52","21896545"
"chr7","143549884","143549914","chr2","11345879","11345909","7","132204005"
"chr7","143549944","143550106","chr16","10807571","10807735","31","132742373"
"chr7","143555385","143555500","chr1","31175608","31175721","22","112379777"
"chr7","143555527","143555685","chr20","32284199","32284357","36","111271328"
"chr7","143556517","143556798","chr3","165461090","165461364","20","21904573"
"chr7","143564906","143565213","chr3","165469932","165470250","38","21905026"
"chr7","143566288","143566575","chr3","165471682","165471975","32","21905394"
"chr7","143596951","143597233","chr3","165505313","165505599","20","21908362"
"chr7","143630820","143631124","chr3","165544452","165544739","34","21913632"
"chr7","143637255","143637494","chr3","165550876","165551105","20","21913621"
"chr7","143640388","143640526","chr3","39810823","39810958","23","103829565"
"chr7","143646721","143647011","chr3","165560334","165560636","36","21913613"
"chr7","143648228","143648517","chr3","165562891","165563179","13","21914663"
"chr7","143702883","143703114","chr3","165625577","165625824","37","21922694"
"chr7","143708675","143708918","chrX","8697309","8697538","59","135011366"
"chr7","143724361","143724653","chr11","124404546","124404835","58","19319815"
"chr7","143729541","143729728","chr8","9033796","9033987","46","134695745"
"chr7","143770251","143770521","chr3","165692177","165692432","34","21921926"
"chr7","143776038","143776245","chr3","165699170","165699377","12","21923132"
"chr7","143784553","143784838","chr3","165706755","165707030","17","21922202"
"chr7","143784839","143785128","chr3","165707031","165707320","13","21922192"
"chr7","143788669","143788975","chr3","165710895","165711212","26","21922226"
"chr7","143817502","143817801","chr3","165741010","165741319","40","21923508"
"chr7","143822127","143822317","chr6","137961184","137961394","56","5860943"
"chr7","143857163","143857347","chr3","165781333","165781506","41","21924170"
"chr7","143857678","143857798","chr7","159427890","159428006","17","15570212"
"chr7","143868969","143869246","chr3","165793674","165793952","20","21924705"
"chr7","143891600","143891896","chr1","44230646","44230948","71","99660954"
"chr7","143901971","143902277","chr3","165825484","165825763","53","21923513"
"chr7","143909559","143909843","chr3","165832519","165832818","37","21922960"
"chr7","143910408","143910533","chr3","165833572","165833694","8","21923164"
"chr7","143910846","143910986","chr3","165833998","165834121","27","21923152"
"chr7","143925421","143925747","chr3","127889632","127889949","76","16035789"
"chr7","143938529","143938850","chr3","165862257","165862578","23","21923728"
"chr7","143945698","143945962","chr3","165868043","165868332","69","21922345"
"chr7","144015723","144016005","chr3","165939533","165939833","38","21923810"
"chr7","144016861","144017138","chr3","165940697","165941005","47","21923836"
"chr7","144020091","144020379","chr7","47831303","47831588","59","96188788"
"chr7","144048938","144049237","chr3","165974681","165974979","19","21925743"
"chr7","144062653","144062784","chr1","31118551","31118669","31","112944102"
"chr7","144063045","144063211","chr3","165989960","165990117","27","21926915"
"chr7","144075290","144075601","chr10","32184869","32185181","57","111890421"
"chr7","144099258","144099582","chr3","166025954","166026259","37","21926696"
"chr7","144113230","144113524","chr3","166040498","166040775","38","21927268"
"chr7","144125101","144125421","chr3","166052129","166052444","30","21927028"
"chr7","144150979","144151111","chr16","43488947","43489078","25","100662032"
"chr7","144156007","144156307","chr3","166114406","166114718","23","21958399"
"chr7","144234491","144234646","chr7","164502678","164502823","42","20268187"
"chr7","144234937","144235030","chr9","35502223","35502320","18","108732714"
"chr7","144273815","144274101","chr3","166235175","166235478","39","21961360"
"chr7","144275080","144275388","chr16","61265248","61265545","80","83009832"
"chr7","144283789","144284104","chr3","166244957","166245267","37","21961168"
"chr7","144288621","144288796","chrX","47794178","47794354","34","96494443"
"chr7","144289090","144289236","chr11","66292823","66292968","32","77996267"
"chr7","144290953","144291238","chr3","166257550","166257835","13","21966597"
"chr7","144333700","144334002","chr3","166300172","166300471","24","21966472"
"chr7","144342697","144342831","chr19","14104908","14105041","30","130237789"
"chr7","144342863","144343011","chr1","24769307","24769455","30","119573556"
"chr7","144352433","144352731","chr3","166318411","166318708","18","21965978"
"chr7","144365685","144365987","chr3","166331529","166331831","38","21965844"
"chr7","144398496","144398801","chr3","166364467","166364779","40","21965971"
"chr7","144415751","144415979","chr3","166381027","166381252","19","21965276"
"chr7","144464092","144464400","chr3","166431068","166431370","25","21966976"
"chr7","144483883","144484184","chr3","166451117","166451416","50","21967234"
"chr7","144500860","144501113","chr3","166471541","166471829","49","21970681"
"chr7","144518314","144518612","chr3","166489974","166490275","22","21971660"
"chr7","144532861","144532985","chr3","166504127","166504251","6","21971266"
"chr7","144576778","144577039","chr13","28680679","28680936","62","115896099"
"chr7","144585869","144586141","chr3","166556095","166556376","22","21970226"
"chr7","144609594","144609872","chr3","166580003","166580297","42","21970409"
"chr7","144626329","144626493","chr3","166597144","166597303","14","21970815"
"chr7","144655347","144655626","chr3","166627945","166628243","33","21972598"
"chr7","144657158","144657418","chr3","166630563","166630830","17","21973405"
"chr7","144658012","144658073","chr1","5524372","5524423","15","139133640"
"chr7","144666804","144667094","chr3","166639981","166640289","30","21973177"
"chr7","144670363","144670662","chr3","166645340","166645647","22","21974977"
"chr7","144683712","144684028","chr3","166660423","166660721","34","21976711"
"chr7","144694927","144695236","chr3","166671105","166671403","32","21976178"
"chr7","144713746","144714025","chrX","107792704","107792988","54","36921042"
"chr7","144722987","144723315","chr3","166699618","166699948","31","21976631"
"chr7","144734718","144734847","chr3","166711756","166711885","3","21977038"
"chr7","144753714","144754025","chr8","42889006","42889306","56","101864708"
"chr7","144761726","144762004","chr3","166744588","166744871","18","21982862"
"chr7","144767394","144767725","chr3","166750589","166750916","18","21983195"
"chr7","144780620","144780900","chr3","166763689","166763969","28","21983069"
"chr7","144799406","144799712","chr2","51202813","51203125","59","93596593"
"chr7","144813484","144813790","chr3","166806867","166807167","26","21993383"
"chr7","144816266","144816553","chr3","166809885","166810191","35","21993619"
"chr7","144825424","144825534","chr3","166816888","166816997","11","21991464"
"chr7","144832743","144833045","chr3","166824300","166824568","49","21991557"
"chr7","144835238","144835353","chrX","144692053","144692170","18","143185"
"chr7","144836121","144836340","chr10","31190522","31190740","45","113645599"
"chr7","144878739","144878904","chrX","5568422","5568585","34","139310317"
"chr7","144880861","144881096","chr7","116674048","116674273","68","28206813"
"chr7","144885195","144885479","chrX","13287297","13287589","61","131597898"
"chr7","144901677","144901797","chr3","166885046","166885160","18","21983369"
"chr7","144903952","144904030","chr7","24247493","24247566","25","120656459"
"chr7","144914262","144914369","chr3","166907184","166907291","8","21992922"
"chr7","144945222","144945574","chr3","166942138","166942481","35","21996916"
"chr7","144950549","144950835","chr3","166948381","166948704","50","21997832"
"chr7","144956006","144956152","chr8","21621594","21621739","27","123334412"
"chr7","144965121","144965246","chr19","19289947","19290075","23","125675174"
"chr7","144970989","144971260","chr7","41245987","41246244","61","103725002"
"chr7","144979237","144979532","chr3","124267629","124267922","44","20711608"
"chr7","144987861","144988138","chr3","166987908","166988191","14","22000047"
"chr7","144995753","144995916","chr3","166995123","166995283","14","21999370"
"chr7","144997767","144998084","chr3","166997174","166997482","29","21999407"
"chr7","145009635","145009759","chr3","167008363","167008487","6","21998728"
"chr7","145020829","145021121","chr3","167018710","167019009","18","21997881"
"chr7","145026990","145027287","chr3","167024222","167024517","19","21997232"
"chr7","145042171","145042336","chr3","167040143","167040311","12","21997972"
"chr7","145042630","145042691","chr3","167040605","167040666","4","21997975"
"chr7","145057157","145057296","chr3","167055264","167055377","30","21998107"
"chr7","145057585","145057891","chr3","167055667","167055962","28","21998082"
"chr7","145092230","145092358","chr3","49771183","49771317","23","95321047"
"chr7","145092655","145092797","chr3","167089952","167090096","23","21997297"
"chr7","145098972","145099222","chr3","167097725","167097953","30","21998753"
"chr7","145119312","145119581","chr3","167111953","167112217","35","21992641"
"chr7","145141316","145141622","chr3","124267629","124267922","61","20873687"
"chr7","145163013","145163294","chr3","167155791","167156080","23","21992778"
"chr7","145178144","145178431","chr3","167166496","167166785","17","21988352"
"chr7","145182853","145183013","chr3","167171055","167171217","7","21988202"
"chr7","145196939","145197232","chr3","167185501","167185792","29","21988562"
"chr7","145201992","145202070","chr9","123682701","123682783","14","21519291"
"chr7","145263366","145263581","chrX","113718001","113718209","57","31545365"
"chr7","145275442","145275709","chr1","44248959","44249223","55","101026483"
"chr7","145283543","145283779","chr1","221628641","221628888","58","76345098"
"chr7","145284247","145284352","chr3","167275874","167275976","7","21991627"
"chr7","145300669","145300971","chr3","167292928","167293244","47","21992259"
"chr7","145313046","145313328","chr3","167305028","167305308","20","21991982"
"chr7","145352530","145352662","chr3","167335825","167335951","9","21983295"
"chr7","145361631","145361743","chr3","167343827","167343945","9","21982196"
"chr7","145372769","145372902","chr16","76575587","76575720","30","68797182"
"chr7","145372903","145373210","chrX","71454497","71454809","77","73918406"
"chr7","145373211","145373283","chr8","30668398","30668473","11","114704813"
"chr7","145413436","145413774","chr7","126631825","126632149","80","18781611"
"chr7","145421203","145421407","chr3","167409504","167409708","13","21988301"
"chr7","145458455","145458741","chr1","191690399","191690678","64","46231944"
"chr7","145461745","145462039","chr3","167446801","167447097","20","21985056"
"chr7","145492182","145492473","chr3","167477786","167478063","29","21985604"
"chr7","145507580","145507899","chr3","167493045","167493356","38","21985465"
"chr7","145516014","145516305","chr3","167501462","167501751","29","21985448"
"chr7","145529284","145529584","chr3","167514784","167515077","27","21985500"
"chr7","145600139","145600426","chr3","167584544","167584839","32","21984405"
"chr7","145603216","145603498","chr3","167587617","167587905","32","21984401"
"chr7","145625843","145626014","chr3","167610193","167610367","23","21984350"
"chr7","145626076","145626149","chr3","167610443","167610516","5","21984367"
"chr7","145694917","145695218","chr3","167679364","167679664","20","21984447"
"chr7","145893945","145894246","chr3","167879266","167879576","40","21985321"
"chr7","145951029","145951322","chr3","167939139","167939419","34","21988110"
"chr7","146021750","146021971","chr14","105129753","105129968","46","40891997"
"chr7","146079937","146080236","chr3","168068145","168068442","33","21988208"
"chr7","146088643","146088864","chr3","168076200","168076405","37","21987557"
"chr7","146090285","146090565","chr3","168077832","168078096","40","21987547"
"chr7","146162810","146162950","chr3","168151678","168151818","10","21988868"
"chr7","146226268","146226553","chr9","99101491","99101790","54","47124777"
"chr7","146559954","146560248","chr8","101798622","101798918","56","44761332"
"chr7","146580655","146580737","chr3","168519600","168519674","12","21938945"
"chr7","146585052","146585341","chr3","168522144","168522434","19","21937092"
"chr7","146589343","146589462","chr14","124266147","124266261","38","22323196"
"chr7","146679025","146679092","chr1","124845148","124845217","14","21833877"
"chr7","146679137","146679252","chr16","61554680","61554795","16","85124457"
"chr7","146683559","146683863","chr1","61834265","61834552","66","84849294"
"chr7","146717952","146718168","chr14","69113872","69114083","59","77604080"
"chr7","147451781","147451910","chr3","35481328","35481429","47","111970453"
"chr7","147480489","147480797","chr3","169580587","169580883","34","22100098"
"chr7","147547601","147547887","chr3","169650541","169650826","15","22102940"
"chr7","147628328","147628648","chr2","99945161","99945467","62","47683167"
"chr7","147637894","147638195","chr18","6870105","6870403","57","140767789"
"chr7","147659952","147660074","chr3","169761496","169761618","7","22101544"
"chr7","147681246","147681363","chr3","169780374","169780491","10","22099128"
"chr7","147700903","147701205","chr3","169808484","169808794","22","22107581"
"chr7","147752689","147752998","chr3","169863374","169863677","30","22110685"
"chr7","147764316","147764537","chr3","169871947","169872178","17","22107631"
"chr7","147778623","147778897","chr3","169889385","169889685","50","22110762"
"chr7","147784238","147784442","chr3","169895545","169895756","24","22111307"
"chr7","147804953","147805230","chr3","169916216","169916500","18","22111263"
"chr7","147850375","147850506","chr1","117811669","117811797","24","30038706"
"chr7","147884797","147885095","chr3","170001237","170001536","12","22116440"
"chr7","147940387","147940672","chr3","175562979","175563265","16","27622592"
"chr7","147959872","147960181","chr3","175533728","175534039","23","27573856"
"chr7","147963890","147964177","chr3","175529718","175530020","38","27565828"
"chr7","147986550","147986713","chr5","59439078","59439244","44","88547472"
"chr7","147986963","147987011","chr3","125862580","125862618","18","22124383"
"chr7","148145768","148146006","chr3","175325227","175325440","34","27179459"
"chr7","148318390","148318671","chr3","175165790","175166073","25","26847400"
"chr7","148509461","148509796","chr10","43220606","43220914","82","105288855"
"chr7","148517698","148518006","chr3","174920366","174920664","34","26402668"
"chr7","148518043","148518365","chr3","174919995","174920319","32","26401952"
"chr7","148535050","148535249","chr3","174903049","174903240","18","26367999"
"chr7","148548733","148549019","chr3","174890452","174890738","26","26341719"
"chr7","148553949","148554245","chr3","174885173","174885469","24","26331224"
"chr7","148571511","148571816","chr11","120832938","120833247","53","27738573"
"chr7","148584963","148585087","chr3","174854012","174854136","9","26269049"
"chr7","148589643","148589926","chr3","174849236","174849518","18","26259593"
"chr7","148669085","148669212","chr7","16781339","16781468","17","131887746"
"chr7","148703829","148704139","chr3","174691329","174691637","25","25987500"
"chr7","148709640","148709892","chr9","95472122","95472374","72","53237518"
"chr7","148724931","148725215","chr3","174669905","174670189","21","25944974"
"chr7","148779712","148780003","chr17","58472107","58472403","61","90307605"
"chr7","148828574","148828731","chr3","174571666","174571822","11","25743092"
"chr7","148850558","148850850","chr3","174544450","174544748","24","25693892"
"chr7","148895229","148895518","chr8","70254305","70254593","63","78640924"
"chr7","148931821","148932102","chr10","70077632","70077910","60","78854189"
"chr7","148963237","148963533","chr3","174431195","174431478","39","25467958"
"chr7","148968463","148968724","chr3","174422705","174422971","35","25454242"
"chr7","149042675","149042981","chr3","174343416","174343721","36","25300741"
"chr7","149098656","149098947","chr3","174281513","174281795","26","25182857"
"chr7","149149386","149149683","chr3","174234745","174235048","19","25085359"
"chr7","149203351","149203626","chr3","70517814","70518093","69","78685537"
"chr7","149300689","149301008","chr7","67145065","67145366","78","82155624"
"chr7","149487956","149488237","chr3","173903188","173903467","12","24415232"
"chr7","149551571","149551792","chr3","173842550","173842770","12","24290979"
"chr7","149610809","149611092","chr3","173789778","173790070","35","24178969"
"chr7","149684421","149684601","chr3","173719947","173720107","36","24035526"
"chr7","149950700","149950843","chr3","173454701","173454846","15","23504001"
"chr7","150004747","150005069","chr3","173405794","173406095","42","23401047"
"chr7","150088498","150088643","chr7","96789597","96789744","38","53298901"
"chr7","150154479","150154786","chr2","108110624","108110917","67","42043855"
"chr7","150212049","150212331","chr3","173122925","173123208","27","22910876"
"chr7","150230621","150230939","chr3","173103451","173103769","22","22872830"
"chr7","150362489","150362780","chr3","172971050","172971335","26","22608561"
"chr7","150403608","150403881","chr3","172935560","172935857","38","22531952"
"chr7","150484206","150484507","chr3","172862060","172862363","18","22377854"
"chr7","150517108","150517229","chr3","172828810","172828931","5","22311702"
"chr7","150518321","150518599","chr3","172827412","172827712","39","22309091"
"chr7","150529836","150530101","chr20","3061113","3061378","65","147468723"
"chr7","150834375","150834676","chr3","172518430","172518731","25","21684055"
"chr7","150901110","150901382","chr3","172456348","172456605","32","21555238"
"chr7","151103523","151103640","chr3","172203161","172203278","11","21099638"
"chr7","151103682","151103696","chr20","27308439","27308452","1","123795243"
"chr7","151104965","151105257","chr1","45880575","45880862","67","105224390"
"chr7","151169447","151169726","chr3","172145387","172145650","33","20975940"
"chr7","151307635","151307920","chr3","172011795","172012110","44","20704160"
"chr7","151350425","151350767","chr3","171965792","171966133","24","20615367"
"chr7","151460156","151460376","chr3","171856850","171857067","15","20396694"
"chr7","151489883","151490187","chr3","171825904","171826199","61","20336021"
"chr7","151582201","151582489","chr3","171733795","171734081","16","20151594"
"chr7","151688887","151689167","chr3","171627647","171627937","22","19938760"
"chr7","151759182","151759472","chr3","171558783","171559069","35","19799601"
"chr7","151779876","151779993","chr3","171536747","171536863","9","19756871"
"chr7","151835561","151835874","chr3","171483597","171483911","62","19648036"
"chr7","152004291","152004587","chr3","171301275","171301563","26","19296984"
"chr7","152167003","152167292","chr14","122733616","122733911","57","29433387"
"chr7","152236371","152236654","chr14","69165770","69166057","57","83070601"
"chr7","152295702","152295718","chr12","35289754","35289769","2","117005948"
"chr7","152295750","152295888","chr6","77185478","77185624","34","75110272"
"chr7","152322417","152322662","chr3","170982590","170982855","38","18660173"
"chr7","152393391","152393673","chr3","170911300","170911598","37","18517909"
"chr7","152429371","152429509","chr11","1688347","1688484","23","150741024"
"chr7","152429511","152429838","chr3","170874997","170875306","43","18445486"
"chr7","152475336","152475638","chr3","170829669","170829966","28","18354333"
"chr7","152514880","152515183","chr3","170789616","170789906","30","18274736"
"chr7","152527311","152527435","chr3","170783719","170783843","7","18256408"
"chr7","152585683","152585973","chr3","170727916","170728190","36","18142233"
"chr7","152776476","152776662","chr8","115743565","115743748","35","37032911"
"chr7","152784476","152784525","chr18","20753860","20753909","14","132030616"
"chr7","152784825","152785007","chr3","170514934","170515111","33","17730109"
"chr7","152791286","152791596","chr14","116401415","116401716","59","36389871"
"chr7","152799037","152799289","chr3","170500482","170500730","27","17701445"
"chr7","152809025","152809332","chr3","170491807","170492110","28","17682782"
"chr7","152860468","152860741","chr3","170434075","170434358","22","17573607"
"chr7","152868431","152868722","chr3","170426153","170426449","27","17557722"
"chr7","152894940","152895229","chr3","170399930","170400232","29","17504990"
"chr7","152904698","152904964","chr3","170390021","170390281","33","17485323"
"chr7","152941802","152942015","chr3","170352684","170352881","29","17410882"
"chr7","152947320","152947618","chr3","170346973","170347271","21","17399653"
"chr7","152965569","152965886","chr3","170328015","170328334","24","17362446"
"chr7","152969198","152969452","chr3","170324091","170324336","37","17354893"
"chr7","152976126","152976419","chr3","170317432","170317722","17","17341306"
"chr7","153001289","153001401","chr2","66546751","66546869","19","86454538"
"chr7","153031740","153032022","chr3","170257492","170257807","50","17225752"
"chr7","153047927","153048139","chr3","170242210","170242417","22","17194283"
"chr7","153067738","153067954","chr3","170222522","170222736","16","17154784"
"chr7","153078114","153078403","chr3","170211303","170211586","18","17133189"
"chr7","153081678","153081952","chr3","170207734","170208007","25","17126056"
"chr7","153088562","153088797","chr3","170200974","170201211","26","17112412"
"chr7","153095275","153095558","chr2","98193250","98193524","72","54902025"
"chr7","153110003","153110126","chr3","170177619","170177742","6","17067616"
"chr7","153124374","153124478","chr5","1889927","1890031","18","151234447"
"chr7","153146938","153147258","chr3","170140233","170140552","24","16993295"
"chr7","153154503","153154547","chr14","52645848","52645891","10","100508655"
"chr7","153159426","153159544","chr3","170128923","170129047","13","16969497"
"chr7","153164886","153165082","chr7","133773620","133773819","42","19391266"
"chr7","153220890","153221192","chr3","170067120","170067430","35","16846230"
"chr7","153234508","153234621","chr16","22616217","22616342","33","130618291"
"chr7","153234895","153235068","chr3","170051723","170051878","27","16816828"
"chr7","153280915","153281192","chrX","30235373","30235651","49","123045542"
"chr7","153298711","153298827","chr3","175646033","175646149","12","22347322"
"chr7","153312243","153312579","chr5","42141877","42142205","68","111170366"
"chr7","153317973","153318094","chr9","64307930","64308054","15","89010043"
"chr7","153318398","153318576","chr11","51724204","51724379","30","101594194"
"chr7","153346437","153346731","chr3","175697938","175698239","24","22351501"
"chr7","153347322","153347555","chr3","175703792","175704025","19","22356470"
"chr7","153352488","153352585","chr18","12849349","12849442","21","140503139"
"chr7","153364420","153364721","chr3","175720200","175720510","49","22355780"
"chr7","153366112","153366341","chr10","71417740","71417969","50","81948372"
"chr7","153399554","153399665","chr3","175746925","175747036","5","22347371"
"chr7","153408801","153409096","chr3","175756090","175756386","25","22347289"
"chr7","153421318","153421627","chr3","175769068","175769377","10","22347750"
"chr7","153427732","153427851","chr3","175775191","175775316","10","22347459"
"chr7","153428161","153428173","chr10","72446288","72446300","4","80981873"
"chr7","153428489","153428677","chr3","175775988","175776174","19","22347499"
"chr7","153438764","153439053","chr3","175789427","175789740","41","22350663"
"chr7","153441343","153441636","chr3","175792073","175792367","20","22350730"
"chr7","153450581","153450868","chr3","175799356","175799650","31","22348775"
"chr7","153455775","153456071","chr3","175804306","175804593","43","22348531"
"chr7","153477502","153477794","chr3","175827593","175827902","31","22350091"
"chr7","153484499","153484789","chr3","175833407","175833706","39","22348908"
"chr7","153521627","153521932","chr5","41182246","41182533","64","112339381"
"chr7","153532958","153533061","chr15","108465059","108465154","23","45067899"
"chr7","153533319","153533498","chr1","221237138","221237313","42","67703819"
"chr7","153548129","153548399","chr3","175902132","175902402","12","22354003"
"chr7","153563485","153563569","chr9","23473568","23473652","14","130089917"
"chr7","153563859","153564066","chr6","53077888","53078086","50","100485971"
"chr7","153588507","153588620","chr6","116160077","116160192","17","37428430"
"chr7","153589239","153589513","chr3","175930286","175930582","41","22341047"
"chr7","153599249","153599514","chr3","175942616","175942883","19","22343367"
"chr7","153600909","153601203","chr3","175943970","175944269","28","22343061"
"chr7","153605182","153605452","chr3","175948568","175948838","23","22343386"
"chr7","153612230","153612475","chr3","175956186","175956454","44","22343956"
"chr7","153637279","153637591","chr1","20748646","20748959","66","132888633"
"chr7","153643397","153643683","chr3","175987917","175988203","14","22344520"
"chr7","153760018","153760247","chr3","176112935","176113170","17","22352917"
"chr7","153773136","153773428","chr3","176126064","176126366","29","22352928"
"chr7","153803052","153803343","chr3","176155529","176155835","30","22352477"
"chr7","153881426","153881743","chrX","113699984","113700293","58","40181442"
"chr7","153902731","153902853","chr3","157449830","157449952","13","3547099"
"chr7","153903150","153903339","chr19","2202101","2202290","42","151701049"
"chr7","153944488","153944786","chr3","176318906","176319200","30","22374418"
"chr7","153981343","153981599","chr3","176356018","176356280","21","22374675"
"chr7","154023877","154024168","chr7","81730787","81731078","56","72293090"
"chr7","154053990","154054259","chr3","176428309","176428579","9","22374319"
"chr7","154066378","154066565","chr7","50028509","50028691","46","104037869"
"chr7","154122526","154122631","chr4","35739553","35739656","27","118382973"
"chr7","154122929","154123119","chr3","35440483","35440667","38","118682446"
"chr7","154124165","154124472","chr2","54477146","54477449","83","99647019"
"chr7","154129062","154129328","chr3","176524661","176524930","21","22395599"
"chr7","154129443","154129744","chr3","176525043","176525344","19","22395600"
"chr7","154135494","154135788","chr3","176531051","176531357","37","22395557"
"chr7","154161538","154161783","chr3","176556832","176557095","31","22395294"
"chr7","154187223","154187458","chr3","176584149","176584380","20","22396926"
"chr7","154199882","154200167","chr3","176596893","176597183","30","22397011"
"chr7","154214300","154214611","chr3","176613540","176613853","20","22399240"
"chr7","154253107","154253412","chr11","8098665","8098958","71","146154442"
"chr7","154268552","154268851","chr3","176720136","176720428","27","22451584"
"chr7","154359765","154360062","chr3","176833173","176833484","31","22473408"
"chr7","154504635","154504935","chr3","176997464","176997753","23","22492829"
"chr7","154582337","154582458","chr8","105426128","105426250","17","49156209"
"chr7","154623563","154623861","chr3","41604589","41604891","57","113018974"
"chr7","154628672","154628983","chr7","42278598","42278899","73","112350074"
"chr7","154634236","154634521","chr3","177122315","177122598","14","22488079"
"chr7","154743504","154743586","chr3","177223749","177223832","4","22480245"
"chr7","154765263","154765396","chr3","177245829","177245960","5","22480566"
"chr7","154784027","154784296","chr3","177265098","177265365","25","22481071"
"chr7","154791123","154791237","chr3","177272766","177272879","9","22481643"
"chr7","154831817","154832100","chr3","177314895","177315177","31","22483078"
"chr7","154833559","154833801","chr3","177316939","177317178","15","22483380"
"chr7","154837352","154837606","chr3","177319672","177319900","46","22482320"
"chr7","154910380","154910681","chr3","177392860","177393159","22","22482480"
"chr7","154922062","154922279","chr3","177404458","177404682","17","22482396"
"chr7","155000636","155000920","chr3","177488181","177488477","29","22487545"
"chr7","155005236","155005537","chr3","177492782","177493078","24","22487546"
"chr7","155006222","155006525","chr3","177494110","177494419","32","22487888"
"chr7","155007305","155007431","chr18","51350456","51350581","17","103656849"
"chr7","155024005","155024281","chr3","177511999","177512267","30","22487994"
"chr7","155031377","155031652","chr3","177519089","177519366","20","22487712"
"chr7","155035467","155035763","chr3","177523173","177523470","38","22487706"
"chr7","155044018","155044320","chr3","177531285","177531602","35","22487267"
"chr7","155048202","155048376","chr19","28356007","28356185","29","126692195"
"chr7","155048424","155048457","chr3","14358657","14358691","7","140689767"
"chr7","155084889","155085187","chrX","16629346","16629636","57","138455543"
"chr7","155156084","155156380","chr3","177643715","177644022","26","22487631"
"chr7","155183147","155183439","chr3","177670701","177670987","20","22487554"
"chr7","155184064","155184367","chr3","177671632","177671939","37","22487568"
"chr7","155191044","155191320","chrX","103046997","103047266","58","52144047"
"chr7","155226172","155226321","chr3","177709291","177709440","10","22483119"
"chr7","155232897","155233153","chr1","44248959","44249223","56","110983938"
"chr7","155237796","155237910","chr3","177720851","177720964","8","22483055"
"chr7","155237986","155238221","chr10","14829670","14829905","58","140408316"
"chr7","155251988","155252283","chr3","177736962","177737255","15","22484974"
"chr7","155263805","155263933","chr3","177749244","177749369","11","22485439"
"chr7","155270842","155271132","chrX","42417114","42417387","78","112853728"
"chr7","155277095","155277395","chr9","99101491","99101790","56","56175604"
"chr7","155284011","155284306","chr13","10104164","10104455","48","145179847"
"chr7","155286735","155287043","chr3","177771345","177771652","21","22484610"
"chr7","155288251","155288546","chr3","177773078","177773374","28","22484827"
"chr7","155297253","155297447","chr3","177782123","177782332","33","22484870"
"chr7","155315004","155315328","chr3","177805672","177805981","43","22490668"
"chr7","155318174","155318455","chr3","177808806","177809080","25","22490632"
"chr7","155340112","155340383","chr3","177830568","177830846","18","22490456"
"chr7","155342811","155343088","chr3","177833481","177833749","24","22490670"
"chr7","155357628","155357923","chr3","177846817","177847122","45","22489189"
"chr7","155364835","155365106","chr3","177854291","177854529","54","22489456"
"chr7","155379244","155379450","chr3","42318438","42318645","49","113060806"
"chr7","155418858","155419145","chr15","42427848","42428135","51","112991010"
"chr7","155428550","155428831","chr3","177920508","177920786","22","22491958"
"chr7","155450251","155450555","chr3","177942293","177942584","32","22492042"
"chr7","155470840","155471110","chr3","43551400","43551672","49","111919440"
"chr7","155489274","155489548","chr3","177981712","177981951","51","22492438"
"chr7","155563907","155564205","chr3","178055709","178056009","32","22491802"
"chr7","155698730","155699026","chr10","29170051","29170335","58","126528679"
"chr7","155701148","155701453","chr3","178187424","178187730","18","22486276"
"chr7","155719412","155719717","chr3","161503080","161503385","58","5783668"
"chr7","155726700","155726994","chr3","178214406","178214687","31","22487706"
"chr7","155738543","155738661","chr3","178228758","178228875","13","22490215"
"chr7","155779091","155779185","chr19","50750460","50750554","12","105028631"
"chr7","155784455","155784760","chr3","178275617","178275958","55","22491162"
"chr7","155836992","155837289","chr3","178319894","178320186","25","22482902"
"chr7","155851936","155852194","chr16","50585497","50585762","54","105266439"
"chr7","155867559","155867834","chr3","178349308","178349611","52","22481749"
"chr7","155958388","155958675","chr3","178448125","178448419","31","22489737"
"chr7","155967545","155967680","chr3","178457909","178458038","14","22490364"
"chr7","155972429","155972622","chr2","92392609","92392805","43","63579820"
"chr7","155974248","155974368","chr3","178465142","178465262","11","22490894"
"chr7","155976565","155976845","chr3","178467496","178467775","32","22490931"
"chr7","155978308","155978591","chr11","125201626","125201907","50","30776682"
"chr7","155979496","155979714","chr2","50329372","50329593","52","105650124"
"chr7","156017314","156017478","chr20","52898696","52898849","45","103118618"
"chr7","156023992","156024120","chr1","217223102","217223224","44","61199110"
"chr7","156024433","156024585","chr10","54250811","54250962","38","101773622"
"chr7","156046122","156046428","chr3","178534292","178534567","46","22488170"
"chr7","156051987","156052299","chr3","178539780","178540096","30","22487793"
"chr7","156055564","156055836","chr3","178543450","178543723","22","22487886"
"chr7","156068089","156068404","chr3","178556126","178556442","20","22488037"
"chr7","156088024","156088094","chr7","10549219","10549288","18","145538805"
"chr7","156127927","156128206","chr3","178611276","178611559","27","22483349"
"chr7","156150193","156150496","chr3","178629115","178629414","14","22478922"
"chr7","156174187","156174337","chr1","93842715","93842859","27","62331472"
"chr7","156174649","156174819","chr11","7045224","7045395","27","149129425"
"chr7","156179670","156179819","chr13","89421250","89421403","25","66758420"
"chr7","156180119","156180223","chr9","6051471","6051572","20","150128648"
"chr7","156212041","156212203","chr8","32609663","32609819","30","123602378"
"chr7","156225811","156226115","chr1","8981776","8982081","59","147244035"
"chr7","156233984","156234278","chr3","178703573","178703871","28","22469589"
"chr7","156276022","156276149","chr3","178749148","178749275","12","22473126"
"chr7","156278400","156278526","chr3","178751871","178751997","13","22473471"
"chr7","156281368","156281633","chr3","178754819","178755107","37","22473451"
"chr7","156308280","156308563","chr3","178779477","178779778","35","22471197"
"chr7","156314974","156315086","chrX","49324840","49324956","19","106990134"
"chr7","156317513","156317812","chr3","178789303","178789583","38","22471790"
"chr7","156333468","156333618","chr16","56252080","56252218","43","100081388"
"chr7","156333659","156333793","chr4","42994812","42994941","25","113338847"
"chr7","156339444","156339735","chr3","178810456","178810747","21","22471012"
"chr7","156361785","156362005","chr3","178837173","178837392","23","22475388"
"chr7","156364601","156364860","chr3","178839827","178840100","38","22475226"
"chr7","156396658","156396948","chr11","109186448","109186735","46","47210210"
"chr7","156399519","156399653","chr3","178880737","178880877","8","22481218"
"chr7","156431783","156432058","chr3","178915505","178915774","47","22483722"
"chr7","156458296","156458372","chr7","165707535","165707601","24","9249239"
"chr7","156459918","156460127","chr1","34916004","34916198","47","121543914"
"chr7","156470629","156470861","chr10","29777070","29777306","48","126693559"
"chr7","156502150","156502449","chr3","178985880","178986176","31","22483730"
"chr7","156518812","156519108","chr3","179003459","179003756","25","22484647"
"chr7","156519696","156519986","chr3","179004350","179004622","33","22484654"
"chr7","156530775","156531073","chr3","179018957","179019259","26","22488182"
"chr7","156533706","156534011","chr3","179055654","179055957","47","22521948"
"chr7","156553773","156553920","chr3","179075821","179075960","13","22522048"
"chr7","156557316","156557606","chr3","179079579","179079866","20","22522263"
"chr7","156573204","156573496","chr16","72756834","72757132","47","83816370"
"chr7","156576398","156576689","chr3","179096537","179096834","35","22520139"
"chr7","156588250","156588556","chr9","12539664","12539969","56","144048586"
"chr7","156589959","156590266","chr3","179115698","179115993","47","22525739"
"chr7","156613953","156614225","chrX","127678846","127679135","62","28935107"
"chr7","156653308","156653514","chr2","93979931","93980136","43","62673377"
"chr7","156655812","156656120","chr20","21525221","21525520","64","135130591"
"chr7","156690870","156691159","chr3","179212925","179213221","40","22522055"
"chr7","156691276","156691412","chr13","87095059","87095190","22","69596217"
"chr7","156732528","156732642","chr3","179250077","179250194","17","22517549"
"chr7","156734000","156734288","chr3","179251530","179251829","36","22517530"
"chr7","156826903","156827205","chr15","12106034","12106332","58","144720869"
"chr7","156903521","156903816","chr16","1095250","1095541","57","155808271"
"chr7","157061110","157061409","chr3","179551890","179552190","21","22490780"
"chr7","157233124","157233420","chr3","179719785","179720089","30","22486661"
"chr7","157308123","157308236","chr12","55388284","55388403","30","101919839"
"chr7","157375505","157375816","chr3","179876448","179876756","39","22500943"
"chr7","157545725","157546014","chr2","148748470","148748763","60","8797255"
"chr7","157587795","157588052","chr3","180533577","180533845","33","22945782"
"chr7","157741419","157741697","chr3","180684128","180684403","25","22942709"
"chr7","157755707","157755989","chr3","180699146","180699428","18","22943439"
"chr7","157853710","157854021","chr3","180802320","180802631","15","22948610"
"chr7","157865277","157865569","chrX","2716504","2716793","49","155148773"
"chr7","157974660","157974930","chr3","180923901","180924168","28","22949241"
"chr7","158012319","158012630","chr3","180958119","180958421","20","22945800"
"chr7","158028636","158028933","chr3","180974156","180974454","26","22945520"
"chr7","158041290","158041618","chr3","180986761","180987050","55","22945471"
"chr7","158189656","158189856","chr3","181164162","181164376","30","22974506"
"chr7","158190248","158190481","chr3","181164775","181165008","13","22974527"
"chr7","158196651","158196934","chr16","40168086","40168364","55","118028565"
"chr7","158201557","158201792","chr3","181175859","181176093","17","22974302"
"chr7","158217018","158217323","chr3","181190269","181190575","24","22973251"
"chr7","158259695","158260009","chr14","113670800","113671110","53","44588895"
"chr7","158278759","158279046","chr3","181264480","181264767","16","22985721"
"chr7","158367963","158368223","chr3","181359284","181359544","18","22991321"
"chr7","158408464","158408804","chr3","181399515","181399822","58","22991051"
"chr7","158445484","158445553","chr2","106049199","106049272","9","52396285"
"chr7","158538842","158539142","chr3","181532073","181532353","46","22993231"
"chr7","158685721","158686037","chr17","454572","454869","63","158231149"
"chr7","158687524","158687811","chr3","181666616","181666913","25","22979092"
"chr7","158862465","158862753","chrX","18434636","18434931","67","140427829"
"chr7","158927180","158927363","chr3","181911951","181912132","13","22984771"
"chr7","158932891","158933183","chr3","181918066","181918358","18","22985175"
"chr7","158935380","158935504","chr10","30386760","30386884","18","128548620"
"chr7","158946088","158946209","chr3","181930416","181930545","13","22984328"
"chr7","158973720","158974002","chr12","44575526","44575809","62","114398194"
"chr7","159042555","159042859","chr14","20030401","20030708","57","139012154"
"chr7","159048578","159048850","chr6","17609699","17609979","53","141438879"
"chr7","159097723","159097977","chr16","19526439","19526686","52","139571284"
"chr7","159213739","159213923","chr3","182194070","182194261","24","22980331"
"chr7","159353977","159354291","chr3","182338219","182338524","37","22984242"
"chr7","159498385","159498508","chr3","182536047","182536170","8","23037662"
"chr7","159612709","159613023","chr9","21275712","21275996","82","138336997"
"chr7","159720478","159720736","chr2","94170908","94171161","52","65549570"
"chr7","159722215","159722501","chr3","182766467","182766748","31","23044252"
"chr7","159893533","159893708","chr3","182951787","182951955","25","23058254"
"chr7","159933451","159933777","chr3","182990066","182990356","51","23056615"
"chr7","160009553","160009823","chr3","183074620","183074888","13","23065067"
"chr7","160032211","160032523","chr3","183095882","183096174","35","23063671"
"chr7","160044167","160044443","chr3","183106499","183106782","23","23062332"
"chr7","160084474","160084778","chr11","48283444","48283741","61","111801030"
"chr7","160097037","160097335","chr3","183161992","183162292","17","23064955"
"chr7","160109615","160109872","chr3","183174617","183174873","17","23065002"
"chr7","160127309","160127431","chr3","183191658","183191780","10","23064349"
"chr7","160159598","160159930","chr3","183224277","183224582","44","23064679"
"chr7","160178634","160178928","chr3","183240330","183240626","27","23061696"
"chr7","160195348","160195637","chr3","183252572","183252839","35","23057224"
"chr7","160218169","160218462","chr3","183276362","183276659","18","23058193"
"chr7","160220030","160220332","chr3","183278835","183279140","19","23058805"
"chr7","160258609","160258872","chr11","46510063","46510322","72","113748546"
"chr7","160266930","160267212","chr3","183319992","183320284","37","23053062"
"chr7","160283804","160284050","chr11","7508963","7509219","76","152774841"
"chr7","160292274","160292397","chr1","23338581","23338704","17","136953693"
"chr7","160302692","160303007","chr3","183400594","183400904","30","23097902"
"chr7","160335787","160336006","chr16","40160687","40160905","42","120175100"
"chr7","160358396","160358685","chr3","183455883","183456174","44","23097487"
"chr7","160378842","160378964","chr20","59259652","59259778","24","101119190"
"chr7","160379259","160379458","chr3","183475693","183475889","16","23096434"
"chr7","160387546","160387838","chr3","183484232","183484521","31","23096686"
"chr7","160403764","160404067","chr3","183502831","183503140","24","23099067"
"chr7","160424623","160424874","chr3","183518353","183518604","23","23093730"
"chr7","160425803","160426088","chr3","183520524","183520813","29","23094721"
"chr7","160437931","160438195","chr3","183533469","183533748","33","23095538"
"chr7","160475110","160475410","chr3","183571127","183571429","25","23096017"
"chr7","160481537","160481750","chrX","48222572","48222783","43","112258965"
"chr7","160483463","160483726","chr3","183581186","183581433","27","23097723"
"chr7","160518913","160519210","chr3","183613633","183613916","36","23094720"
"chr7","160528127","160528264","chr3","183622802","183622936","17","23094675"
"chr7","160533178","160533477","chr2","200043325","200043629","73","39510147"
"chr7","160544233","160544519","chr3","183639615","183639886","35","23095382"
"chr7","160575078","160575208","chr3","183673405","183673536","10","23098327"
"chr7","160577425","160577718","chr3","124267629","124267922","57","36309796"
"chr7","160588233","160588347","chr13","46512186","46512305","24","114076047"
"chr7","160590391","160590527","chr11","56147302","56147432","36","104443089"
"chr7","160593457","160593779","chr3","69636003","69636292","73","90957454"
"chr7","160595143","160595456","chr3","183694819","183695107","54","23099676"
"chr7","160610099","160610176","chr10","73667768","73667847","13","86942331"
"chr7","160610442","160610587","chr10","7402377","7402528","39","153208065"
"chr7","160613740","160614051","chr3","183718577","183718889","22","23104837"
"chr7","160626599","160626912","chr3","133314498","133314804","64","27312101"
"chr7","160641127","160641189","chr3","183745929","183745991","3","23104802"
"chr7","160653788","160654051","chr3","183760219","183760484","18","23106431"
"chr7","160663260","160663544","chr3","183768922","183769206","27","23105662"
"chr7","160688661","160688919","chr3","183796959","183797215","22","23108298"
"chr7","160699970","160700254","chr9","95575173","95575462","60","65124797"
"chr7","160703969","160704244","chr2","163445135","163445414","64","2741166"
"chr7","160731738","160732007","chr3","183841234","183841511","27","23109496"
"chr7","160758809","160759098","chr3","183865333","183865630","24","23106524"
"chr7","160831352","160831657","chr3","183953845","183954158","37","23122493"
"chr7","160971286","160971556","chr3","184094832","184095105","22","23123546"
"chr7","161268439","161268709","chr3","184396785","184397057","11","23128346"
"chr7","161367498","161367789","chr3","184498802","184499078","42","23131304"
"chr7","161391689","161391810","chr3","184524475","184524596","9","23132786"
"chr7","161671050","161671365","chr9","34977979","34978290","62","126693071"
"chr7","161750569","161750867","chr3","184898113","184898396","35","23147544"
"chr7","161827451","161827752","chr3","184970694","184971000","16","23143243"
"chr7","161844533","161844769","chr3","184988514","184988751","18","23143981"
"chr7","161846973","161847218","chr3","184991302","184991546","19","23144329"
"chr7","161851115","161851491","chr3","184995495","184995861","43","23144380"
"chr7","161877522","161877840","chr8","132343698","132344009","64","29533824"
"chr7","161916835","161917133","chr3","185051265","185051534","48","23134430"
"chr7","161921308","161921611","chr3","185055736","185056028","24","23134428"
"chr7","161922272","161922558","chr3","185056682","185056968","15","23134410"
"chr7","161933849","161934153","chr3","185067704","185068015","35","23133855"
"chr7","161951300","161951601","chr3","185085638","185085930","27","23134338"
"chr7","161971305","161971597","chr3","185106303","185106598","37","23134998"
"chr7","161991068","161991348","chr3","185126887","185127187","55","23135819"
"chr7","161992193","161992473","chr3","185128029","185128331","44","23135836"
"chr7","162000824","162001115","chr3","185135973","185136266","40","23135149"
"chr7","162013324","162013457","chr3","185147451","185147582","9","23134127"
"chr7","162070877","162071173","chr3","185204527","185204830","37","23133650"
"chr7","162091724","162091910","chr3","185227431","185227625","25","23135707"
"chr7","162107880","162108156","chr3","185244361","185244631","50","23136481"
"chr7","162108448","162108742","chr12","38582080","38582375","53","123526368"
"chr7","162136419","162136656","chr7","138589300","138589547","52","23547119"
"chr7","162137340","162137380","chr5","47471105","47471146","10","114666235"
"chr7","162144010","162144318","chr4","36484206","36484512","60","125659804"
"chr7","162145681","162145979","chr3","185283361","185283668","22","23137680"
"chr7","162147531","162147644","chr5","117152809","117152909","39","44994722"
"chr7","162147945","162148087","chr7","21004196","21004344","37","141143749"
"chr7","162160519","162160801","chr3","185302646","185302945","38","23142127"
"chr7","162163121","162163177","chr3","185305383","185305436","5","23142262"
"chr7","162181199","162181509","chr3","185328441","185328727","48","23147242"
"chr7","162206333","162206558","chr3","185356054","185356274","26","23149721"
"chr7","162214038","162214332","chr3","185368150","185368443","20","23154112"
"chr7","162231303","162231566","chr3","185386754","185387020","19","23155451"
"chr7","162244801","162245069","chr3","185398039","185398281","52","23153238"
"chr7","162331861","162332174","chr1","6863286","6863588","65","155468575"
"chr7","162353930","162354059","chr3","185549181","185549315","16","23195251"
"chr7","162390715","162391023","chr1","10811316","10811617","64","151579399"
"chr7","162415443","162415700","chr3","185603731","185604005","32","23188288"
"chr7","162441098","162441389","chr3","69803201","69803508","61","92637897"
"chr8","34602966","34603272","chr8","38401001","38401316","31","3798035"
"chr8","123731823","123732060","chr8","123497749","123497984","23","234074"
"chr8","3538886","3539002","chr2","137216972","137217085","27","133678086"
"chr8","22282145","22282415","chr8","26117864","26118134","14","3835719"
"chr8","24772475","24772693","chr8","28310633","28310859","25","3538158"
"chr8","26869569","26869792","chr8","30437653","30437891","28","3568084"
"chr8","68288479","68288768","chr4","19154114","19154403","59","49134365"
"chr8","71958352","71958645","chr8","72030731","72031004","44","72379"
"chr8","465132","465299","chr8","526362","526532","13","61230"
"chr8","465609","465750","chr3","50473069","50473212","24","50007460"
"chr8","484416","484711","chr8","547149","547446","31","62733"
"chr8","523881","524110","chr8","589445","589674","13","65564"
"chr8","540555","540869","chr8","603786","604100","28","63231"
"chr8","653598","653871","chr8","715320","715600","35","61722"
"chr8","664941","665223","chr8","726271","726555","31","61330"
"chr8","723649","723944","chr1","166267323","166267607","60","165543674"
"chr8","737605","737887","chr6","17609699","17609979","61","16872094"
"chr8","835819","836108","chr8","893858","894139","30","58039"
"chr8","860102","860328","chr19","3857062","3857284","56","2996960"
"chr8","873712","873916","chr8","931298","931517","38","57586"
"chr8","915324","915622","chr19","9891286","9891591","59","8975962"
"chr8","932336","932613","chr8","986088","986370","24","53752"
"chr8","1071235","1071483","chr8","1128746","1129004","27","57511"
"chr8","1201885","1202148","chr8","1247213","1247468","28","45328"
"chr8","1259826","1260128","chrX","19017046","19017338","66","17757220"
"chr8","1299437","1299745","chr8","1338902","1339204","36","39465"
"chr8","1335976","1336262","chr8","1374432","1374743","50","38456"
"chr8","1438470","1438677","chr8","1466052","1466253","24","27582"
"chr8","1624530","1624743","chr8","30275478","30275683","41","28650948"
"chr8","1699411","1699524","chr19","50275174","50275283","19","48575763"
"chr8","1708008","1708297","chr8","1557095","1557395","24","150913"
"chr8","1756912","1757207","chr8","1599891","1600184","26","157021"
"chr8","1824898","1825199","chr8","1670207","1670509","39","154691"
"chr8","1863132","1863451","chr8","1713019","1713342","36","150113"
"chr8","1911712","1912040","chr8","1762383","1762693","49","149329"
"chr8","1994998","1995285","chr8","1843449","1843735","24","151549"
"chr8","2017709","2018008","chr8","1865861","1866158","16","151848"
"chr8","2473399","2473540","chr8","2417803","2417941","13","55596"
"chr8","2513001","2513136","chr8","2543706","2543841","18","30705"
"chr8","2545737","2545840","chr8","2569845","2569950","11","24108"
"chr8","2578281","2578579","chr8","2603515","2603826","33","25234"
"chr8","2591671","2591795","chr8","2633773","2633897","10","42102"
"chr8","2723373","2723663","chr13","26642857","26643150","57","23919484"
"chr8","2736528","2736798","chr8","2784723","2784997","25","48195"
"chr8","2753050","2753215","chrX","47799482","47799654","34","45046432"
"chr8","2799861","2800141","chr8","2932442","2932722","24","132581"
"chr8","2821468","2821769","chr11","108881618","108881911","67","106060150"
"chr8","2832919","2833231","chr9","110786043","110786351","81","107953124"
"chr8","2856068","2856192","chr8","3049834","3049958","5","193766"
"chr8","2859257","2859537","chr8","3052720","3053007","36","193463"
"chr8","2876180","2876466","chr8","3069696","3069982","33","193516"
"chr8","2914833","2915129","chr8","30893269","30893565","64","27978436"
"chr8","3034096","3034344","chr8","3221714","3221963","19","187618"
"chr8","3058691","3058992","chr8","3247467","3247764","35","188776"
"chr8","3108970","3109249","chr8","3306583","3306871","54","197613"
"chr8","3153521","3153805","chr13","107408005","107408290","70","104254484"
"chr8","3178963","3179068","chr8","3338629","3338735","7","159666"
"chr8","3352356","3352612","chr1","144291826","144292083","68","140939470"
"chr8","3415533","3415831","chr8","3598076","3598375","34","182543"
"chr8","3463643","3463924","chr8","3649108","3649390","21","185465"
"chr8","3539012","3539174","chr9","69694259","69694420","42","66155247"
"chr8","3687437","3687733","chr8","3872271","3872569","27","184834"
"chr8","3722459","3722674","chr8","3907295","3907507","26","184836"
"chr8","3753545","3753827","chr8","3944504","3944814","51","190959"
"chr8","3817741","3818042","chr8","4007661","4007952","43","189920"
"chr8","3883223","3883544","chr8","4071032","4071345","52","187809"
"chr8","3921097","3921355","chr13","100982699","100982964","59","97061602"
"chr8","4074990","4075155","chr3","42832480","42832641","46","38757490"
"chr8","4075448","4075627","chr7","33319056","33319230","33","29243608"
"chr8","4100388","4100671","chr7","137856198","137856481","65","133755810"
"chr8","4134437","4134723","chr8","4310563","4310850","25","176126"
"chr8","4190617","4190814","chr8","4370857","4371057","23","180240"
"chr8","4375532","4375817","chr8","4557284","4557602","63","181752"
"chr8","4385427","4385704","chr8","4567207","4567475","33","181780"
"chr8","4395931","4396089","chr11","110460757","110460916","44","106064826"
"chr8","4396381","4396516","chr8","4577402","4577536","14","181021"
"chr8","4426744","4426970","chr8","4609583","4609822","33","182839"
"chr8","4428052","4428364","chr8","4611265","4611580","31","183213"
"chr8","4642236","4642527","chr1","64445048","64445343","68","59802812"
"chr8","4829918","4830218","chr8","5015710","5016011","27","185792"
"chr8","4865928","4866222","chr8","5051800","5052107","41","185872"
"chr8","4891210","4891498","chr8","5078087","5078368","32","186877"
"chr8","5029273","5029361","chr8","5217851","5217940","9","188578"
"chr8","5050280","5050386","chr20","63772075","63772183","25","58721795"
"chr8","5107798","5107881","chr8","5304149","5304232","6","196351"
"chr8","5179846","5180058","chr8","5379534","5379750","13","199688"
"chr8","5346913","5347207","chr10","26838196","26838479","65","21491283"
"chr8","5349959","5350116","chr2","102507593","102507742","35","97157634"
"chr8","5350398","5350562","chr11","13600063","13600216","43","8249665"
"chr8","5516177","5516481","chr8","5631562","5631858","42","115385"
"chr8","5735000","5735300","chr8","5891766","5892059","33","156766"
"chr8","5959183","5959351","chr8","6107175","6107345","21","147992"
"chr8","5998538","5998832","chr11","117366311","117366614","64","111367773"
"chr8","5999730","6000000","chr8","6169569","6169874","52","169839"
"chr8","6042219","6042511","chr8","6212718","6213038","61","170499"
"chr8","6103977","6104281","chr15","14616084","14616383","60","8512107"
"chr8","6216138","6216417","chr8","6375762","6376045","19","159624"
"chr8","6252869","6253159","chr9","29656993","29657284","63","23404124"
"chr8","6325907","6326067","chr10","46752990","46753157","33","40427083"
"chr8","6326383","6326516","chrX","52901194","52901327","23","46574811"
"chr8","6406352","6406662","chr12","11672579","11672884","58","5266227"
"chr8","6410700","6410980","chr8","92798428","92798708","72","86387728"
"chr8","6421629","6421799","chr19","15121843","15122009","40","8700214"
"chr8","6422101","6422217","chr1","130635065","130635179","27","124212964"
"chr8","6429955","6430251","chr8","6593060","6593359","26","163105"
"chr8","6434722","6434842","chr8","6597843","6597961","7","163121"
"chr8","6462994","6463117","chr8","6625326","6625447","13","162332"
"chr8","6469813","6470119","chr8","6632730","6633038","18","162917"
"chr8","6471126","6471419","chr8","6634028","6634321","18","162902"
"chr8","6476935","6477058","chr9","47926792","47926915","26","41449857"
"chr8","6528685","6528893","chr8","6689534","6689747","25","160849"
"chr8","6544949","6545253","chr1","10227902","10228202","51","3682953"
"chr8","6560156","6560429","chr8","6721614","6721886","27","161458"
"chr8","6568944","6569070","chr8","6730383","6730510","7","161439"
"chr8","6621173","6621351","chr9","78784818","78784988","42","72163645"
"chr8","6621395","6621506","chr15","35525468","35525582","17","28904073"
"chr8","6639868","6640029","chr13","11409935","11410101","34","4770067"
"chr8","6642754","6643055","chrX","44593764","44594066","68","37951010"
"chr8","6698333","6698609","chr8","6860491","6860765","21","162158"
"chr8","6698676","6698883","chr8","6860854","6861072","25","162178"
"chr8","6709599","6709874","chr8","6872789","6873056","31","163190"
"chr8","6717391","6717656","chr8","6880206","6880471","17","162815"
"chr8","6764209","6764439","chr8","6928073","6928292","28","163864"
"chr8","6831790","6832060","chr12","113687505","113687774","58","106855715"
"chr8","6880135","6880449","chr8","7038476","7038801","36","158341"
"chr8","6911272","6911531","chr8","7071539","7071797","33","160267"
"chr8","8802434","8802642","chr8","11801064","11801271","18","2998630"
"chr8","8811072","8811383","chr8","11808952","11809268","38","2997880"
"chr8","8833043","8833356","chr8","11831461","11831775","23","2998418"
"chr8","8858225","8858309","chr8","11852563","11852649","9","2994338"
"chr8","8858585","8858721","chr8","11852908","11853047","16","2994323"
"chr8","8859639","8859918","chr8","11853959","11854242","38","2994320"
"chr8","8866679","8866976","chr8","11861431","11861727","26","2994752"
"chr8","8869723","8870016","chr8","11867538","11867827","28","2997815"
"chr8","8874614","8874894","chr8","11872592","11872901","48","2997978"
"chr8","8876366","8876504","chr8","11874342","11874480","13","2997976"
"chr8","8881779","8882040","chr8","11879697","11879969","31","2997918"
"chr8","8887818","8888115","chr8","11886950","11887246","22","2999132"
"chr8","8901466","8901760","chr8","11900655","11900934","32","2999189"
"chr8","8917008","8917187","chr9","53308189","53308368","37","44391181"
"chr8","8917230","8917334","chr11","116317863","116317962","17","107400633"
"chr8","8922112","8922411","chr8","11920513","11920825","36","2998401"
"chr8","8926322","8926625","chr8","11925263","11925553","53","2998941"
"chr8","8930132","8930435","chr8","11929335","11929648","48","2999203"
"chr8","8933968","8934251","chr8","11932916","11933207","17","2998948"
"chr8","8986642","8986926","chr2","103230109","103230382","27","94243467"
"chr8","8988119","8988239","chr8","11986162","11986282","5","2998043"
"chr8","9001097","9001415","chr8","11997434","11997732","37","2996337"
"chr8","9010965","9011218","chr8","12006871","12007136","51","2995906"
"chr8","9013019","9013080","chr7","126813550","126813608","12","117800531"
"chr8","9013377","9013544","chr3","41704437","41704602","37","32691060"
"chr8","9014346","9014674","chr8","12009563","12009886","25","2995217"
"chr8","9023148","9023441","chr8","12017431","12017723","15","2994283"
"chr8","9024192","9024462","chr8","12018804","12019058","41","2994612"
"chr8","9028571","9028880","chr8","12023142","12023450","21","2994571"
"chr8","9032611","9032891","chr3","123351694","123351976","53","114319083"
"chr8","9041109","9041395","chr8","12036342","12036627","17","2995233"
"chr8","9042448","9042748","chr2","72923747","72924047","52","63881299"
"chr8","9052970","9053271","chr8","12049198","12049458","57","2996228"
"chr8","9055266","9055569","chr3","42107648","42107937","82","33052382"
"chr8","9066215","9066529","chr8","12062657","12062965","29","2996442"
"chr8","9074009","9074276","chr8","12071045","12071306","24","2997036"
"chr8","9115584","9115866","chr8","12109882","12110174","41","2994298"
"chr8","9116939","9117186","chr14","58394049","58394271","75","49277110"
"chr8","9117966","9118275","chr8","12112270","12112584","27","2994304"
"chr8","9124056","9124350","chr8","12118339","12118630","37","2994283"
"chr8","9125718","9126014","chr8","12119970","12120246","40","2994252"
"chr8","9155007","9155293","chr8","12148778","12149069","19","2993771"
"chr8","9176923","9177212","chr3","154616784","154617069","56","145439861"
"chr8","9179882","9180178","chrX","45813028","45813319","61","36633146"
"chr8","9182418","9182706","chr8","12176531","12176804","40","2994113"
"chr8","9198181","9198483","chr8","12192316","12192615","23","2994135"
"chr8","9223343","9223614","chr8","12217910","12218179","34","2994567"
"chr8","9231758","9232038","chr8","12225959","12226254","24","2994201"
"chr8","9238227","9238525","chr8","12232437","12232742","39","2994210"
"chr8","9244141","9244353","chr13","30070965","30071173","43","20826824"
"chr8","9247659","9247963","chr8","12241828","12242132","31","2994169"
"chr8","9275315","9275436","chr8","12269212","12269333","7","2993897"
"chr8","9284523","9284820","chr8","43117340","43117636","64","33832817"
"chr8","9287783","9287961","chr12","87917476","87917649","33","78629693"
"chr8","9287996","9288114","chr19","38974140","38974256","28","29686144"
"chr8","9309232","9309500","chr8","12302207","12302477","20","2992975"
"chr8","9318211","9318508","chr15","13264602","13264884","73","3946391"
"chr8","9356214","9356485","chr8","12345638","12345910","38","2989424"
"chr8","9414794","9415085","chr8","12471381","12471673","22","3056587"
"chr8","9427672","9427925","chr7","68298810","68299062","68","58871138"
"chr8","9463338","9463603","chr8","12519138","12519407","22","3055800"
"chr8","9553456","9553675","chr8","12615098","12615317","17","3061642"
"chr8","9727332","9727634","chr8","12790363","12790665","54","3063031"
"chr8","9770847","9770969","chr4","128388118","128388230","23","118617271"
"chr8","9771001","9771156","chr5","82692745","82692901","38","72921744"
"chr8","9807770","9808057","chr8","12878963","12879248","24","3071193"
"chr8","10011331","10011629","chr9","24972535","24972840","67","14961204"
"chr8","10075821","10076126","chr1","23294871","23295170","61","13219050"
"chr8","10131281","10131565","chr8","13746205","13746483","44","3614924"
"chr8","10250642","10250940","chr8","13866813","13867094","48","3616171"
"chr8","10425588","10425633","chr3","55436788","55436835","4","45011200"
"chr8","10468948","10469230","chr8","14088995","14089276","28","3620047"
"chr8","10487250","10487534","chr8","14103655","14103953","56","3616405"
"chr8","10502249","10502478","chr8","14118455","14118684","20","3616206"
"chr8","10617536","10617842","chr11","7403903","7404204","61","3213633"
"chr8","10661529","10661619","chr3","101395274","101395364","23","90733745"
"chr8","10661651","10661798","chr8","14278894","14279041","16","3617243"
"chr8","10767037","10767302","chr8","14438562","14438829","26","3671525"
"chr8","10777886","10778010","chr8","14449746","14449869","4","3671860"
"chr8","10855235","10855525","chr8","14519114","14519402","33","3663879"
"chr8","10895628","10895908","chr8","14559588","14559883","34","3663960"
"chr8","10896004","10896103","chr3","124806901","124807002","20","113910897"
"chr8","10971656","10971924","chr8","14645843","14646106","31","3674187"
"chr8","11000049","11000338","chr13","39475662","39475956","65","28475613"
"chr8","11005784","11005908","chr8","14678290","14678413","8","3672506"
"chr8","11056665","11056795","chr8","14736018","14736138","19","3679353"
"chr8","11084792","11085058","chr13","92036466","92036742","75","80951674"
"chr8","11107055","11107380","chr8","14787079","14787382","49","3680024"
"chr8","11404492","11404794","chr8","15090552","15090869","40","3686060"
"chr8","11411605","11411791","chr8","15098267","15098453","8","3686662"
"chr8","11455715","11456014","chr8","15143476","15143786","39","3687761"
"chr8","11479073","11479355","chr8","15164432","15164713","19","3685359"
"chr8","11489705","11489906","chr8","15174733","15174937","16","3685028"
"chr8","11513765","11513895","chr8","15198350","15198480","13","3684585"
"chr8","11678134","11678448","chr8","15355293","15355599","51","3677159"
"chr8","11736028","11736310","chr8","15412131","15412421","30","3676103"
"chr8","11758440","11758550","chr8","15441148","15441262","16","3682708"
"chr8","11761394","11761672","chr8","15444098","15444380","16","3682704"
"chr8","11789529","11789809","chr8","15476655","15476935","15","3687126"
"chr8","11830356","11830661","chr8","15517519","15517841","41","3687163"
"chr8","11836326","11836570","chr8","15523410","15523663","21","3687084"
"chr8","11855861","11856166","chr8","15543938","15544239","44","3688077"
"chr8","11899428","11899704","chr8","15587340","15587602","39","3687912"
"chr8","11903522","11903624","chr8","15591742","15591837","12","3688220"
"chr8","11936489","11936771","chr16","3734857","3735135","63","8201632"
"chr8","11945948","11946235","chr19","41712639","41712926","68","29766691"
"chr8","11958174","11958471","chr8","15643919","15644217","30","3685745"
"chr8","12028425","12028726","chr8","15708678","15708977","31","3680253"
"chr8","12041036","12041322","chr8","15721479","15721780","40","3680443"
"chr8","12098702","12099002","chr8","15783113","15783427","40","3684411"
"chr8","12102711","12103003","chr8","15787176","15787487","44","3684465"
"chr8","12112448","12112722","chr5","109550554","109550822","67","97438106"
"chr8","12120727","12121039","chr8","15805657","15805970","30","3684930"
"chr8","12169680","12169981","chr8","15855967","15856263","30","3686287"
"chr8","12223394","12223485","chr8","15905420","15905508","13","3682026"
"chr8","12812252","12812533","chr8","16333194","16333473","18","3520942"
"chr8","12825995","12826285","chr8","16346861","16347150","21","3520866"
"chr8","12839688","12839911","chr8","16361392","16361614","13","3521704"
"chr8","12880486","12880783","chr8","16398817","16399106","32","3518331"
"chr8","12888982","12889285","chr1","8981776","8982081","52","3907206"
"chr8","12901812","12902117","chr8","16420027","16420305","50","3518215"
"chr8","12929990","12930102","chr8","16448263","16448375","10","3518273"
"chr8","12933321","12933624","chr8","16450059","16450358","40","3516738"
"chr8","12960864","12961159","chr1","67019962","67020252","65","54059098"
"chr8","13050641","13050908","chr8","16565253","16565509","39","3514612"
"chr8","13080939","13081249","chr8","16591148","16591469","32","3510209"
"chr8","13085077","13085244","chr6","170058579","170058742","38","156973502"
"chr8","13150809","13150932","chr1","205464254","205464380","19","192313445"
"chr8","13159178","13159261","chr8","16674651","16674734","8","3515473"
"chr8","13168629","13168913","chr8","16689180","16689458","40","3520551"
"chr8","13181845","13182134","chr8","16702416","16702704","23","3520571"
"chr8","13190293","13190445","chr8","16710571","16710723","14","3520278"
"chr8","13225540","13225838","chr8","16745190","16745477","29","3519650"
"chr8","13238507","13238759","chr8","16758019","16758271","20","3519512"
"chr8","13269317","13269628","chr8","16789349","16789611","64","3520032"
"chr8","13337185","13337484","chr8","16856680","16856979","25","3519495"
"chr8","13337630","13337940","chr8","16857190","16857504","27","3519560"
"chr8","13410156","13410467","chr8","16933158","16933456","39","3523002"
"chr8","13467907","13468197","chr8","16990424","16990699","41","3522517"
"chr8","13473620","13473917","chr3","124267629","124267922","59","110794009"
"chr8","13495743","13495964","chr8","17018384","17018605","20","3522641"
"chr8","13542223","13542528","chr8","17064246","17064556","29","3522023"
"chr8","13596068","13596321","chr11","50418617","50418873","53","36822549"
"chr8","13598232","13598353","chr8","17124256","17124372","18","3526024"
"chr8","13611356","13611680","chr8","17137806","17138133","41","3526450"
"chr8","13651261","13651569","chr8","17177993","17178297","35","3526732"
"chr8","13677632","13677760","chr6","152366421","152366549","20","138688789"
"chr8","13693135","13693433","chr20","42006914","42007213","55","28313779"
"chr8","13698737","13699062","chrX","19017046","19017338","87","5318309"
"chr8","13723285","13723573","chr8","17249657","17249949","17","3526372"
"chr8","13723712","13724022","chr8","17250088","17250397","23","3526376"
"chr8","13733359","13733658","chr8","17259805","17260100","16","3526446"
"chr8","13742096","13742370","chr8","17269410","17269676","31","3527314"
"chr8","13760141","13760416","chr8","17288595","17288887","48","3528454"
"chr8","13772287","13772555","chr20","20219234","20219493","60","6446947"
"chr8","13772560","13772731","chr7","127089124","127089289","35","113316564"
"chr8","13786193","13786371","chr8","17314027","17314207","14","3527834"
"chr8","13787236","13787513","chr8","17315066","17315367","38","3527830"
"chr8","13789660","13789958","chr8","17317499","17317810","33","3527839"
"chr8","13797364","13797662","chr8","17324934","17325231","24","3527570"
"chr8","13804797","13805022","chr8","17332311","17332537","16","3527514"
"chr8","13844416","13844697","chr8","17372862","17373144","15","3528446"
"chr8","13854784","13854890","chr3","111301920","111302026","19","97447136"
"chr8","13865293","13865419","chr8","17394192","17394318","7","3528899"
"chr8","13908719","13909003","chr8","17439164","17439443","39","3530445"
"chr8","13913297","13913583","chr8","17443771","17444062","58","3530474"
"chr8","13931142","13931458","chr8","17461908","17462182","67","3530766"
"chr8","13985017","13985306","chr16","11545677","11545975","61","2439340"
"chr8","13989798","13990012","chr8","17522046","17522259","13","3532248"
"chr8","14012789","14013060","chr8","17545760","17546038","32","3532971"
"chr8","14023232","14023538","chr8","17556314","17556655","59","3533082"
"chr8","14049329","14049622","chr1","163013756","163014048","66","148964427"
"chr8","14220988","14221287","chr8","17767247","17767532","33","3546259"
"chr8","14257316","14257436","chr13","25546692","25546816","16","11289376"
"chr8","14284122","14284324","chr8","17833358","17833560","14","3549236"
"chr8","14399563","14399879","chr8","17975301","17975635","50","3575738"
"chr8","14402525","14402809","chr1","212846655","212846936","60","198444130"
"chr8","14525025","14525148","chr8","18101417","18101545","11","3576392"
"chr8","14593982","14594284","chr8","18169021","18169311","25","3575039"
"chr8","14601075","14601385","chr8","18176009","18176302","37","3574934"
"chr8","14640838","14641125","chr8","18213326","18213604","32","3572488"
"chr8","14669933","14670221","chr1","23223583","23223878","69","8553650"
"chr8","14673508","14673650","chr8","18239116","18239239","23","3565608"
"chr8","14682862","14683158","chr8","18246564","18246878","33","3563702"
"chr8","14683664","14683965","chr1","44171967","44172258","60","29488303"
"chr8","14702892","14703157","chr8","18267302","18267573","31","3564410"
"chr8","14793021","14793260","chrX","51567105","51567331","56","36774084"
"chr8","14796721","14796892","chr8","18358104","18358274","19","3561383"
"chr8","14801309","14801433","chr7","18158315","18158439","18","3357006"
"chr8","14851815","14852110","chr3","157361980","157362274","60","142510165"
"chr8","14901886","14902196","chr8","18462034","18462341","33","3560148"
"chr8","14914503","14914727","chr8","18475315","18475568","51","3560812"
"chr8","14920817","14921081","chr8","18481540","18481818","59","3560723"
"chr8","14997514","14997806","chr8","18563828","18564123","44","3566314"
"chr8","15022263","15022387","chr8","18590988","18591108","12","3568725"
"chr8","15051341","15051630","chr8","18621024","18621312","30","3569683"
"chr8","15053959","15054257","chr9","22447944","22448242","64","7393985"
"chr8","15077109","15077263","chr17","29269902","29270063","38","14192793"
"chr8","15086737","15086971","chr4","97919057","97919273","59","82832320"
"chr8","15100647","15100839","chr8","18667970","18668172","23","3567323"
"chr8","15110878","15111209","chr8","18678554","18678859","45","3567676"
"chr8","15121753","15122043","chr1","200066136","200066426","68","184944383"
"chr8","15126542","15126851","chr8","18694590","18694901","26","3568048"
"chr8","15162973","15163252","chr8","105628485","105628773","35","90465512"
"chr8","15175541","15175853","chr8","105641455","105641767","26","90465914"
"chr8","15198635","15198937","chr8","105665150","105665453","31","90466515"
"chr8","15201784","15202084","chr8","105668242","105668519","52","90466458"
"chr8","15207568","15207885","chr8","105674057","105674367","24","90466489"
"chr8","15224735","15225048","chr8","105691421","105691740","44","90466686"
"chr8","15235776","15235974","chr8","18856745","18856943","16","3620969"
"chr8","15243614","15243899","chr13","10443034","10443317","61","4800580"
"chr8","15249707","15249836","chr8","18871734","18871863","13","3622027"
"chr8","15271313","15271613","chr18","3132014","3132308","58","12139299"
"chr8","15281294","15281578","chr8","18903048","18903349","38","3621754"
"chr8","15281706","15281971","chr8","18903476","18903741","12","3621770"
"chr8","15306428","15306710","chr8","18927620","18927899","21","3621192"
"chr8","15307876","15308056","chr2","165762796","165762974","40","150454920"
"chr8","15320237","15320525","chr8","18941414","18941693","31","3621177"
"chr8","15321772","15321888","chr13","100812951","100813068","13","85491179"
"chr8","15369387","15369546","chr12","21323547","21323703","28","5954160"
"chr8","15369547","15369851","chr8","18989284","18989587","22","3619737"
"chr8","15371180","15371489","chr3","47930685","47930995","62","32559505"
"chr8","15384195","15384318","chr8","19004090","19004212","7","3619895"
"chr8","15384322","15384624","chr8","19004216","19004519","22","3619894"
"chr8","15434193","15434490","chr8","19059068","19059369","28","3624875"
"chr8","15467080","15467283","chr8","19091595","19091797","11","3624515"
"chr8","15487999","15488288","chr8","19112439","19112730","31","3624440"
"chr8","15493201","15493492","chr20","42006914","42007213","60","26513713"
"chr8","15509332","15509644","chr8","19133410","19133737","36","3624078"
"chr8","15512256","15512565","chr8","19136343","19136643","37","3624087"
"chr8","15552393","15552697","chr8","19177840","19178108","55","3625447"
"chr8","15580600","15580706","chr11","51565600","51565699","20","35985000"
"chr8","15594452","15594735","chr8","19223807","19224090","27","3629355"
"chr8","15608880","15609170","chr8","19238197","19238500","34","3629317"
"chr8","15622880","15623204","chr8","19247776","19248096","34","3624896"
"chr8","15641632","15641941","chr2","55049181","55049491","67","39407549"
"chr8","15671270","15671553","chr8","19300918","19301217","36","3629648"
"chr8","15695681","15695969","chr8","19324866","19325155","35","3629185"
"chr8","15696414","15696695","chr8","19325603","19325876","25","3629189"
"chr8","15705469","15705762","chr8","19335042","19335348","34","3629573"
"chr8","15710395","15710695","chr8","19340337","19340594","63","3629942"
"chr8","15746310","15746585","chr8","19376342","19376616","33","3630032"
"chr8","15749690","15749985","chr8","19379714","19380026","54","3630024"
"chr8","15751323","15751428","chr8","19381350","19381455","6","3630027"
"chr8","15768240","15768538","chr8","19398462","19398765","32","3630222"
"chr8","15790293","15790569","chr8","19420311","19420569","36","3630018"
"chr8","15792794","15793098","chr8","19422802","19423122","45","3630008"
"chr8","15793862","15794161","chr8","19423954","19424249","22","3630092"
"chr8","15799914","15800213","chr8","19429964","19430256","28","3630050"
"chr8","15827666","15828010","chr2","36730496","36730825","91","20902830"
"chr8","15848523","15848822","chr17","11251715","11252011","55","4596808"
"chr8","15873806","15874080","chr8","19508424","19508709","30","3634618"
"chr8","15878276","15878478","chr8","19512959","19513153","28","3634683"
"chr8","15931365","15931645","chr4","36489831","36490104","57","20558466"
"chr8","15981148","15981436","chr8","19620239","19620532","21","3639091"
"chr8","15984030","15984335","chr5","158872038","158872331","64","142888008"
"chr8","15988471","15988770","chr9","115146364","115146659","58","99157893"
"chr8","16002405","16002710","chr8","19638351","19638660","22","3635946"
"chr8","16026755","16027041","chr8","19663923","19664205","35","3637168"
"chr8","16056566","16056682","chr20","31267810","31267926","14","15211244"
"chr8","16063363","16063633","chr16","40184802","40185080","67","24121439"
"chr8","16064525","16064810","chr8","19690759","19691075","53","3626234"
"chr8","16074669","16074961","chr8","19700895","19701185","29","3626226"
"chr8","16094514","16094633","chr13","46512186","46512305","21","30417672"
"chr8","16097896","16098189","chr11","26024257","26024550","63","9926361"
"chr8","16168243","16168529","chr8","19778488","19778779","31","3610245"
"chr8","16179559","16179683","chr8","19789023","19789155","14","3609464"
"chr8","16191453","16191761","chr8","19801598","19801910","32","3610145"
"chr8","16192973","16193277","chr8","19803162","19803457","30","3610189"
"chr8","16199004","16199305","chr8","19809292","19809602","28","3610288"
"chr8","16222904","16223085","chr12","59016380","59016547","41","42793476"
"chr8","16223124","16223184","chr3","2448772","2448832","14","13774352"
"chr8","16228442","16228728","chr8","19832229","19832526","28","3603787"
"chr8","16234378","16234599","chr8","19838040","19838250","28","3603662"
"chr8","16281497","16281622","chr8","19886046","19886178","21","3604549"
"chr8","16294788","16295104","chr13","71248269","71248571","64","54953481"
"chr8","16297093","16297364","chr8","19901690","19901962","21","3604597"
"chr8","16315421","16315455","chrX","417852","417886","4","15897569"
"chr8","16315489","16315653","chr12","83338561","83338720","29","67023072"
"chr8","16340873","16341090","chr8","19944365","19944594","26","3603492"
"chr8","16385951","16386241","chr8","19989562","19989839","46","3603611"
"chr8","16401898","16402202","chr8","20005797","20006098","26","3603899"
"chr8","16413129","16413423","chr3","79875711","79876007","57","63462582"
"chr8","16414332","16414588","chr8","20019307","20019562","20","3604975"
"chr8","16417065","16417366","chr15","43687639","43687935","56","27270574"
"chr8","16420364","16420664","chr8","20025978","20026291","23","3605614"
"chr8","16428083","16428379","chr4","159090526","159090826","57","142662443"
"chr8","16428787","16428901","chr8","20034454","20034566","8","3605667"
"chr8","16432158","16432474","chr8","20037712","20038023","29","3605554"
"chr8","16437633","16437952","chr8","20043543","20043846","30","3605910"
"chr8","16451673","16451920","chr8","20057431","20057688","43","3605758"
"chr8","16465817","16466144","chr8","20071650","20071994","51","3605833"
"chr8","16470732","16471043","chr8","20077244","20077560","33","3606512"
"chr8","16483781","16484014","chr8","20089737","20089969","12","3605956"
"chr8","16516833","16517000","chr8","20123195","20123356","15","3606362"
"chr8","16528314","16528624","chr8","20135304","20135614","24","3606990"
"chr8","16533044","16533329","chr8","20139957","20140243","32","3606913"
"chr8","16540441","16540776","chr8","20147505","20147816","62","3607064"
"chr8","16541836","16542140","chr7","58370727","58371021","66","41828891"
"chr8","16543557","16543845","chr11","131260074","131260355","54","114716517"
"chr8","16549296","16549606","chr8","20158629","20158935","23","3609333"
"chr8","16558586","16558881","chr1","90159285","90159578","69","73600699"
"chr8","16570428","16570710","chr8","20179832","20180109","26","3609404"
"chr8","16578207","16578513","chr8","20188160","20188456","27","3609953"
"chr8","16582322","16582637","chr8","20192597","20192941","51","3610275"
"chr8","16595647","16595943","chr8","20199367","20199663","18","3603720"
"chr8","16598802","16598982","chr11","8648553","8648726","45","7950249"
"chr8","16633945","16634262","chr8","20239569","20239882","27","3605624"
"chr8","16672440","16672659","chr8","20277707","20277926","13","3605267"
"chr8","16701920","16702076","chr8","20307301","20307460","14","3605381"
"chr8","16703301","16703590","chr13","107408005","107408290","58","90704704"
"chr8","16704178","16704472","chr8","20309491","20309774","30","3605313"
"chr8","16721284","16721573","chr8","20326728","20327028","37","3605444"
"chr8","16736595","16736869","chr8","20341048","20341350","48","3604453"
"chr8","16774688","16774883","chr8","20378718","20378913","16","3604030"
"chr8","16775261","16775374","chr8","20379289","20379402","12","3604028"
"chr8","16856269","16856579","chr8","20508574","20508880","46","3652305"
"chr8","16916570","16916869","chr8","20571487","20571787","27","3654917"
"chr8","17042135","17042340","chr8","20689929","20690133","13","3647794"
"chr8","17069048","17069352","chr8","20717800","20718106","29","3648752"
"chr8","17140659","17140930","chr8","20788198","20788463","33","3647539"
"chr8","17199877","17200139","chr8","20847474","20847736","14","3647597"
"chr8","17276009","17276320","chr7","137169603","137169912","71","119893594"
"chr8","17380903","17381120","chr8","21079401","21079618","24","3698498"
"chr8","17400131","17400395","chr8","21098645","21098913","22","3698514"
"chr8","17460927","17461248","chr1","23696132","23696439","72","6235205"
"chr8","17489207","17489328","chr8","21194321","21194432","13","3705114"
"chr8","17502155","17502456","chr8","21207832","21208134","14","3705677"
"chr8","17503426","17503692","chr8","21209103","21209358","31","3705677"
"chr8","17526783","17527050","chr8","21241235","21241503","22","3714452"
"chr8","17529135","17529421","chr8","21243630","21243916","20","3714495"
"chr8","17587180","17587461","chr8","21303033","21303325","49","3715853"
"chr8","17648316","17648617","chr8","21365016","21365317","24","3716700"
"chr8","17759946","17760204","chr7","77763841","77764109","58","60003895"
"chr8","17816844","17817144","chr8","21524932","21525217","34","3708088"
"chr8","17832218","17832382","chr8","21540443","21540611","15","3708225"
"chr8","17873431","17873729","chr8","21580934","21581216","42","3707503"
"chr8","17912969","17913114","chr8","21621594","21621739","2","3708625"
"chr8","17919458","17919743","chr8","21628050","21628331","25","3708592"
"chr8","17920287","17920578","chr8","21628874","21629165","23","3708587"
"chr8","17964303","17964607","chr8","21673675","21673972","30","3709372"
"chr8","17964613","17964905","chr8","21673978","21674270","41","3709365"
"chr8","17979348","17979629","chr8","21691427","21691707","21","3712079"
"chr8","17989087","17989357","chr8","21701573","21701843","14","3712486"
"chr8","17998618","17998901","chr8","21711115","21711396","35","3712497"
"chr8","18006060","18006175","chr8","21720324","21720447","14","3714264"
"chr8","18047615","18047876","chr8","21755783","21756092","63","3708168"
"chr8","18052034","18052330","chr8","21760591","21760887","26","3708557"
"chr8","18069786","18069969","chr7","42466133","42466326","42","24396347"
"chr8","18090810","18091117","chr3","185283361","185283668","51","167192551"
"chr8","18127058","18127203","chr8","21834335","21834478","15","3707277"
"chr8","18177584","18177757","chr8","21884781","21884958","11","3707197"
"chr8","18196577","18196869","chr8","21906521","21906813","10","3709944"
"chr8","18200528","18200821","chr8","21910760","21911041","35","3710232"
"chr8","18201929","18202198","chr8","21911902","21912195","37","3709973"
"chr8","18215033","18215332","chr8","21925848","21926147","26","3710815"
"chr8","18215488","18215640","chr12","21323547","21323703","25","3108059"
"chr8","18220040","18220338","chr8","21930789","21931084","20","3710749"
"chr8","18222576","18222882","chr8","21933398","21933706","44","3710822"
"chr8","18223501","18223819","chr8","21934287","21934604","51","3710786"
"chr8","18246745","18247041","chr8","21958233","21958548","31","3711488"
"chr8","18250083","18250314","chr8","21961613","21961847","24","3711530"
"chr8","18250848","18251154","chr8","21962389","21962679","44","3711541"
"chr8","18253669","18253933","chr8","21965153","21965418","15","3711484"
"chr8","18257416","18257713","chr3","36904507","36904821","74","18647091"
"chr8","18272986","18273257","chr8","21983073","21983358","40","3710087"
"chr8","18273849","18274155","chr8","21983975","21984281","42","3710126"
"chr8","18290761","18291070","chr3","43395486","43395788","62","25104725"
"chr8","18292312","18292601","chr8","22006519","22006815","36","3714207"
"chr8","18320481","18320766","chr8","22032066","22032352","28","3711585"
"chr8","18353428","18353735","chr8","22064419","22064722","45","3710991"
"chr8","18367540","18367826","chr8","22078734","22079019","18","3711194"
"chr8","18372650","18372939","chr8","22083670","22083966","35","3711020"
"chr8","18374004","18374242","chr8","22085064","22085297","18","3711060"
"chr8","18380130","18380420","chr8","22091610","22091897","21","3711480"
"chr8","18382380","18382632","chr8","22093859","22094110","19","3711479"
"chr8","18389970","18390244","chr8","22101515","22101794","21","3711545"
"chr8","18399749","18400016","chr15","79560595","79560865","52","61160846"
"chr8","18406932","18407038","chr8","96949211","96949317","11","78542279"
"chr8","18441429","18441562","chr8","22152952","22153088","21","3711523"
"chr8","18445913","18446227","chr1","207126685","207126992","70","188680772"
"chr8","18448081","18448359","chr8","22159817","22160097","24","3711736"
"chr8","18460423","18460689","chr6","171622945","171623206","58","153162522"
"chr8","18462026","18462309","chr8","22179128","22179386","40","3717102"
"chr8","18469969","18470079","chr8","22187496","22187605","6","3717527"
"chr8","18470384","18470567","chr8","22187905","22188098","25","3717521"
"chr8","18473897","18474214","chr8","22191739","22192045","41","3717842"
"chr8","18480350","18480651","chr8","22197957","22198248","30","3717607"
"chr8","18486773","18487057","chr8","22204757","22205039","26","3717984"
"chr8","18495798","18496078","chr11","113662304","113662586","63","95166506"
"chr8","18505117","18505305","chrX","23180057","23180250","52","4674940"
"chr8","18505844","18506146","chr5","8246617","8246904","64","10259227"
"chr8","18520060","18520298","chr8","22235316","22235564","24","3715256"
"chr8","18529467","18529767","chr8","22245917","22246211","36","3716450"
"chr8","18537060","18537253","chr14","23470682","23470878","64","4933622"
"chr8","18539212","18539420","chr8","11531837","11532041","51","7007375"
"chr8","18561395","18561475","chr8","22282443","22282524","5","3721048"
"chr8","18570878","18571186","chr8","22292680","22292982","32","3721802"
"chr8","18595647","18595950","chr8","22318959","22319261","27","3723312"
"chr8","18614210","18614511","chr8","22337907","22338211","30","3723697"
"chr8","18615912","18616038","chr8","22339611","22339734","13","3723699"
"chr8","18618194","18618375","chr8","22342496","22342691","31","3724302"
"chr8","18620064","18620352","chr8","22346042","22346329","21","3725978"
"chr8","18622751","18623042","chr8","22349524","22349817","17","3726773"
"chr8","18623681","18623989","chr8","22350458","22350753","27","3726777"
"chr8","18639754","18640068","chr8","22366203","22366521","25","3726449"
"chr8","18648019","18648135","chr8","22374094","22374204","15","3726075"
"chr8","18648183","18648481","chr8","22374254","22374553","12","3726071"
"chr8","18649595","18649898","chr8","22375662","22375966","25","3726067"
"chr8","18654379","18654669","chr8","22380777","22381071","30","3726398"
"chr8","18682722","18683027","chr8","22409390","22409687","25","3726668"
"chr8","18691742","18692032","chr8","22419443","22419734","23","3727701"
"chr8","18697135","18697335","chr8","22424599","22424800","8","3727464"
"chr8","18697628","18697734","chr8","22425103","22425206","10","3727475"
"chr8","18707288","18707512","chr8","22432946","22433177","16","3725658"
"chr8","18714099","18714404","chr2","160551205","160551504","57","141837106"
"chr8","18714890","18715169","chr9","11806930","11807198","56","6907960"
"chr8","18746032","18746336","chr8","22475055","22475350","25","3729023"
"chr8","18773303","18773594","chr8","22502538","22502827","25","3729235"
"chr8","18781897","18782184","chr8","22511280","22511568","33","3729383"
"chr8","18784802","18785096","chr11","121290594","121290887","55","102505792"
"chr8","18832260","18832527","chr8","22562438","22562703","20","3730178"
"chr8","18853052","18853240","chr3","129669679","129669864","45","110816627"
"chr8","18887771","18888083","chr8","22620192","22620518","38","3732421"
"chr8","18901440","18901767","chr8","22634072","22634393","19","3732632"
"chr8","18925879","18926181","chr8","22657982","22658283","29","3732103"
"chr8","18936463","18936711","chr1","34112065","34112319","66","15175602"
"chr8","18941384","18941697","chr8","22672912","22673225","26","3731528"
"chr8","18975675","18975957","chr1","138872834","138873119","50","119897159"
"chr8","18976196","18976499","chr9","128228335","128228636","48","109252139"
"chr8","18993387","18993685","chr8","22724896","22725198","19","3731509"
"chr8","19027369","19027669","chr8","22790527","22790816","26","3763158"
"chr8","19049263","19049529","chr8","22812518","22812790","32","3763255"
"chr8","19062731","19063032","chr8","22825931","22826247","36","3763200"
"chr8","19103096","19103268","chr8","22866115","22866273","22","3763019"
"chr8","19103552","19103664","chr8","22866577","22866689","27","3763025"
"chr8","19115645","19115943","chr8","22878685","22878980","24","3763040"
"chr8","19132428","19132706","chr8","22914623","22914897","21","3782195"
"chr8","19144846","19145144","chr18","52579006","52579304","51","33434160"
"chr8","19147791","19148094","chr8","22932714","22933012","28","3784923"
"chr8","19150188","19150313","chr8","22935218","22935348","13","3785030"
"chr8","19162287","19162596","chr8","22948000","22948297","33","3785713"
"chr8","19175617","19175900","chrX","105702256","105702529","61","86526639"
"chr8","19184470","19184594","chr20","39460047","39460171","16","20275577"
"chr8","19202035","19202213","chr8","22988139","22988313","16","3786104"
"chr8","19202781","19203001","chr19","39028175","39028394","39","19825394"
"chr8","19223867","19224163","chr8","23010642","23010912","44","3786775"
"chr8","19251492","19251789","chr18","7946005","7946305","56","11305487"
"chr8","19276346","19276641","chr8","23078471","23078772","29","3802125"
"chr8","19331962","19332083","chr8","23150065","23150187","2","3818103"
"chr8","19424253","19424480","chr8","23249521","23249740","35","3825268"
"chr8","19451118","19451399","chr8","23278038","23278320","27","3826920"
"chr8","19456962","19457268","chr3","38363753","38364051","56","18906791"
"chr8","19457619","19457928","chr7","129585391","129585697","56","110127772"
"chr8","19506715","19507017","chr8","23324672","23324973","20","3817957"
"chr8","19528843","19529161","chr8","23347529","23347845","20","3818686"
"chr8","19534162","19534313","chr8","23352629","23352791","24","3818467"
"chr8","19541354","19541642","chr8","23359915","23360213","30","3818561"
"chr8","19559098","19559246","chr6","87757586","87757731","35","68198488"
"chr8","19583970","19584143","chr1","50631653","50631831","49","31047683"
"chr8","19677163","19677474","chr8","23497964","23498273","31","3820801"
"chr8","19690861","19691165","chr8","23512279","23512587","21","3821418"
"chr8","19709167","19709465","chr2","84913076","84913368","50","65203909"
"chr8","19721574","19721867","chr8","23542683","23542967","34","3821109"
"chr8","19727737","19728038","chr8","23548826","23549116","22","3821089"
"chr8","19730409","19730534","chr8","23551589","23551715","12","3821180"
"chr8","19730834","19731010","chr8","23552019","23552198","14","3821185"
"chr8","19740829","19741131","chr8","23562391","23562670","53","3821562"
"chr8","19744635","19744901","chr8","23566208","23566475","14","3821573"
"chr8","19747787","19748090","chr8","23569367","23569675","30","3821580"
"chr8","19774815","19775129","chr8","23597648","23597962","21","3822833"
"chr8","19820192","19820237","chr3","48113227","48113278","13","28293035"
"chr8","19841740","19842053","chr8","23661465","23661776","39","3819725"
"chr8","19879594","19879899","chr1","16024355","16024647","66","3855239"
"chr8","19882659","19882938","chr8","23708136","23708419","19","3825477"
"chr8","19906098","19906395","chr8","23730030","23730329","41","3823932"
"chr8","19924476","19924769","chr8","23748329","23748631","33","3823853"
"chr8","19951191","19951528","chr8","23790831","23791172","19","3839640"
"chr8","20121093","20121125","chr3","49553172","49553202","9","29432079"
"chr8","20121452","20121637","chr12","96011333","96011499","62","75889881"
"chr8","20149263","20149561","chr8","23988969","23989241","45","3839706"
"chr8","20369311","20369609","chr8","24214237","24214532","31","3844926"
"chr8","20416359","20416476","chr8","24261867","24261984","9","3845508"
"chr8","20479606","20479906","chr8","24323188","24323494","32","3843582"
"chr8","20550747","20551056","chr13","75561375","75561687","58","55010628"
"chr8","20595574","20595875","chr8","24435687","24435957","54","3840113"
"chr8","20645612","20645919","chr1","88358086","88358390","66","67712474"
"chr8","20660569","20660878","chr8","24495562","24495849","55","3834993"
"chr8","20666711","20667028","chr3","43652365","43652670","73","22985654"
"chr8","20689919","20690205","chr8","24525525","24525834","38","3835606"
"chr8","20715823","20716130","chr16","21430282","21430584","61","714459"
"chr8","20813371","20813668","chr8","24647771","24648073","16","3834400"
"chr8","20814297","20814441","chr8","24648729","24648873","13","3834432"
"chr8","20833332","20833617","chr8","24666185","24666472","21","3832853"
"chr8","20878768","20878858","chr8","24714886","24714973","10","3836118"
"chr8","20893510","20893816","chr8","24730658","24730965","14","3837148"
"chr8","20911404","20911697","chr2","21268158","21268449","59","356754"
"chr8","21068363","21068543","chr20","23628256","23628440","42","2559893"
"chr8","21069798","21070133","chr8","24903495","24903795","49","3833697"
"chr8","21080082","21080381","chr8","24913387","24913687","23","3833305"
"chr8","21151768","21152070","chr4","6937789","6938091","73","14213979"
"chr8","21152565","21152851","chr8","24987499","24987785","14","3834934"
"chr8","21173824","21174120","chr8","25010161","25010457","15","3836337"
"chr8","21195139","21195261","chr8","25031924","25032037","17","3836785"
"chr8","21245718","21245995","chr8","25081679","25081964","29","3835961"
"chr8","21260219","21260536","chr1","53872477","53872791","59","32612258"
"chr8","21271729","21272016","chr2","52798756","52799036","53","31527027"
"chr8","21284530","21284802","chr8","25123803","25124097","57","3839273"
"chr8","21295418","21295734","chr8","25132391","25132706","32","3836973"
"chr8","21315494","21315579","chr8","25157441","25157524","6","3841947"
"chr8","21328981","21329151","chr3","41137310","41137484","37","19808329"
"chr8","21339886","21340020","chr8","25183504","25183638","11","3843618"
"chr8","21352809","21353074","chrX","67448189","67448456","47","46095380"
"chr8","21359040","21359351","chr2","108888321","108888615","74","87529281"
"chr8","21361215","21361536","chr8","25202558","25202885","32","3841343"
"chr8","21370120","21370360","chr8","25211562","25211801","7","3841442"
"chr8","21377836","21378145","chr8","25218552","25218844","55","3840716"
"chr8","21393612","21393729","chr8","25233500","25233616","7","3839888"
"chr8","21398414","21398720","chr12","109188322","109188627","91","87789908"
"chr8","21411324","21411439","chr8","25250936","25251055","9","3839612"
"chr8","21411472","21411750","chr8","25251578","25251838","40","3840106"
"chr8","21422984","21423312","chr8","25264181","25264472","58","3841197"
"chr8","21434517","21434825","chr8","25275735","25276015","42","3841218"
"chr8","21434955","21435245","chr8","25276135","25276423","30","3841180"
"chr8","21447088","21447397","chr19","44625774","44626074","60","23178686"
"chr8","21448399","21448686","chr8","25290848","25291108","42","3842449"
"chr8","21470788","21471086","chr8","25311576","25311868","47","3840788"
"chr8","21474849","21475167","chr8","25315631","25315957","35","3840782"
"chr8","21483371","21483589","chr8","25324211","25324434","21","3840840"
"chr8","21485781","21486079","chr8","25326620","25326919","25","3840839"
"chr8","21486616","21486838","chr8","25327582","25327798","21","3840966"
"chr8","21497091","21497389","chr8","25337817","25338115","19","3840726"
"chr8","21500024","21500134","chr20","4293677","4293787","18","17206347"
"chr8","21506615","21506914","chr19","40926811","40927106","53","19420196"
"chr8","21524782","21525080","chr8","25370090","25370397","37","3845308"
"chr8","21545221","21545517","chr11","122928736","122929029","60","101383515"
"chr8","21560721","21561026","chr8","25404491","25404800","16","3843770"
"chr8","21561036","21561166","chr8","25404810","25404939","12","3843774"
"chr8","21571570","21571867","chr13","39475662","39475956","50","17904092"
"chr8","21572241","21572510","chr8","25415552","25415819","22","3843311"
"chr8","21580541","21580667","chr8","25423896","25424015","14","3843355"
"chr8","21581271","21581409","chr8","25424581","25424723","9","3843310"
"chr8","21581460","21581570","chr8","25424779","25424888","7","3843319"
"chr8","21592332","21592510","chr8","25435680","25435857","19","3843348"
"chr8","21592813","21592961","chr8","25436187","25436334","9","3843374"
"chr8","21600685","21600968","chr8","25443865","25444144","19","3843180"
"chr8","21642779","21642903","chr8","25485709","25485832","8","3842930"
"chr8","21652514","21652806","chr8","25496283","25496571","30","3843769"
"chr8","21653977","21654272","chr8","25497745","25498036","27","3843768"
"chr8","21683895","21684012","chr8","25528873","25528990","7","3844978"
"chr8","21706929","21707219","chr8","25552933","25553223","19","3846004"
"chr8","21724547","21724844","chr19","19223451","19223750","47","2501096"
"chr8","21743167","21743325","chr8","25587737","25587894","3","3844570"
"chr8","21745877","21746170","chr8","25590471","25590758","20","3844594"
"chr8","21748899","21749211","chr8","25593420","25593733","24","3844521"
"chr8","21753818","21754104","chr7","77307440","77307706","70","55553622"
"chr8","21769026","21769174","chr16","54031136","54031283","35","32262110"
"chr8","21783106","21783397","chr8","25627924","25628217","21","3844818"
"chr8","21785666","21785788","chr20","26844688","26844811","16","5059022"
"chr8","21788211","21788493","chr8","25633304","25633606","28","3845093"
"chr8","21812597","21812685","chr2","95463417","95463506","11","73650820"
"chr8","21819089","21819368","chr8","25657547","25657850","42","3838458"
"chr8","21855444","21855728","chr10","24953516","24953804","68","3098072"
"chr8","21875182","21875304","chr1","166753759","166753883","19","144878577"
"chr8","21924608","21924914","chr8","25763804","25764097","37","3839196"
"chr8","21936881","21937025","chr8","25776540","25776678","13","3839659"
"chr8","21950471","21950596","chr8","25790151","25790275","7","3839680"
"chr8","22061000","22061275","chr8","25900264","25900541","56","3839264"
"chr8","22129433","22129774","chr8","25969281","25969582","67","3839848"
"chr8","22138259","22138537","chr8","25978021","25978290","31","3839762"
"chr8","22142150","22142237","chr8","25981926","25982010","7","3839776"
"chr8","22143814","22144054","chr8","25983592","25983833","26","3839778"
"chr8","22157060","22157368","chr8","25997476","25997770","41","3840416"
"chr8","22211832","22212123","chr8","26052749","26053040","29","3840917"
"chr8","22215983","22216197","chr2","45945040","45945260","44","23729057"
"chr8","22254141","22254326","chr8","26087841","26088027","14","3833700"
"chr8","22254523","22254636","chr8","26088250","26088361","10","3833727"
"chr8","22264079","22264389","chr8","26098794","26099106","20","3834715"
"chr8","22265728","22266005","chr8","26100439","26100716","16","3834711"
"chr8","22283068","22283191","chr8","26118804","26118927","11","3835736"
"chr8","22293128","22293406","chr8","26131021","26131304","36","3837893"
"chr8","22301791","22302097","chr8","26139739","26140050","46","3837948"
"chr8","22334623","22334932","chr9","98807840","98808149","57","76473217"
"chr8","22350024","22350284","chr8","26189483","26189741","14","3839459"
"chr8","22354113","22354406","chr1","35294285","35294565","53","12940172"
"chr8","22365440","22365730","chr11","54711361","54711653","53","32345921"
"chr8","22383002","22383299","chr8","26219248","26219553","32","3836246"
"chr8","22383962","22384265","chr8","26220080","26220390","31","3836118"
"chr8","22405317","22405598","chr8","26246901","26247185","23","3841584"
"chr8","22408006","22408326","chr8","26249466","26249787","25","3841460"
"chr8","22410516","22410815","chr8","26252062","26252357","38","3841546"
"chr8","22420569","22420844","chr8","26262081","26262357","17","3841512"
"chr8","22420904","22421114","chr1","199401689","199401890","49","176980785"
"chr8","22438147","22438478","chr9","112119513","112119851","80","89681366"
"chr8","22447404","22447662","chr9","15488397","15488657","57","6959007"
"chr8","22452662","22452934","chr5","109550554","109550822","56","87097892"
"chr8","22474902","22475208","chr8","26314380","26314682","33","3839478"
"chr8","22521109","22521390","chr8","26362231","26362506","21","3841122"
"chr8","22521554","22521799","chr8","26362670","26362923","32","3841116"
"chr8","22535350","22535631","chr8","26376781","26377047","45","3841431"
"chr8","22546363","22546515","chr1","163892122","163892272","33","141345759"
"chr8","22553551","22553759","chr8","26394370","26394577","15","3840819"
"chr8","22573368","22573486","chr7","113641019","113641138","15","91067651"
"chr8","22573530","22573688","chr3","104772367","104772528","30","82198837"
"chr8","22582335","22582641","chr8","26422387","26422700","35","3840052"
"chr8","22586444","22586716","chr6","132267130","132267394","60","109680686"
"chr8","22603479","22603779","chr8","26442490","26442781","22","3839011"
"chr8","22609901","22610010","chr8","26448975","26449086","7","3839074"
"chr8","22613999","22614115","chr8","26452377","26452493","12","3838378"
"chr8","22632053","22632347","chr8","26470253","26470550","24","3838200"
"chr8","22634255","22634556","chr8","26472453","26472745","26","3838198"
"chr8","22638134","22638437","chr8","26477335","26477631","36","3839201"
"chr8","22643191","22643487","chr8","26481999","26482286","29","3838808"
"chr8","22644079","22644234","chr8","26482883","26483050","28","3838804"
"chr8","22646730","22646912","chr8","26485622","26485804","8","3838892"
"chr8","22653478","22653793","chr8","38369272","38369586","68","15715794"
"chr8","22656175","22656469","chr8","26495233","26495529","17","3839058"
"chr8","22662787","22663066","chr8","26506169","26506442","28","3843382"
"chr8","22666680","22666973","chr8","26510049","26510344","25","3843369"
"chr8","22667675","22667973","chr8","26511042","26511339","18","3843367"
"chr8","22670148","22670410","chr8","26513532","26513821","51","3843384"
"chr8","22682268","22682582","chr9","106607385","106607691","58","83925117"
"chr8","22690272","22690576","chr8","26533089","26533393","22","3842817"
"chr8","22705018","22705306","chr8","26549053","26549334","30","3844035"
"chr8","22714504","22714811","chr8","26558188","26558492","27","3843684"
"chr8","22746526","22746639","chr8","26594721","26594834","7","3848195"
"chr8","22768139","22768428","chr8","26616327","26616617","23","3848188"
"chr8","22770859","22771187","chr8","26619080","26619398","36","3848221"
"chr8","22793219","22793453","chr8","26642834","26643068","20","3849615"
"chr8","22794244","22794538","chr8","26643860","26644152","28","3849616"
"chr8","22820202","22820501","chr20","28618222","28618522","56","5798020"
"chr8","22830740","22831061","chr8","26680260","26680578","31","3849520"
"chr8","22831123","22831415","chr8","26680640","26680929","25","3849517"
"chr8","22835872","22836076","chrX","134881073","134881251","60","112045201"
"chr8","22856342","22856653","chr8","26703775","26704068","61","3847433"
"chr8","22864441","22864753","chr8","26717404","26717715","31","3852963"
"chr8","22884686","22884987","chr8","26740214","26740510","32","3855528"
"chr8","22890162","22890425","chr8","26745724","26746022","57","3855562"
"chr8","22897004","22897289","chr8","26752886","26753170","18","3855882"
"chr8","22980624","22980907","chr8","26835894","26836141","52","3855270"
"chr8","22990941","22991263","chr8","26845808","26846131","26","3854867"
"chr8","23033603","23033903","chr8","26888644","26888944","21","3855041"
"chr8","23138939","23139213","chr8","26989607","26989880","16","3850668"
"chr8","23175857","23176140","chr8","27032691","27032982","30","3856834"
"chr8","23202677","23202948","chr8","27052895","27053184","45","3850218"
"chr8","23205602","23205813","chr13","43715293","43715505","42","20509691"
"chr8","23210991","23211317","chr8","27061292","27061624","29","3850301"
"chr8","23249237","23249368","chr1","31359612","31359744","28","8110375"
"chr8","23254408","23254698","chr20","24010200","24010492","56","755792"
"chr8","23594531","23594846","chr8","27144041","27144340","29","3549510"
"chr8","23640293","23640569","chr8","27200285","27200557","24","3559992"
"chr8","23658904","23659193","chr5","78689579","78689868","49","55030675"
"chr8","23672022","23672305","chr5","107205231","107205502","69","83533209"
"chr8","23696502","23696797","chr8","27251793","27252091","27","3555291"
"chr8","23709806","23709921","chr8","27266874","27266989","11","3557068"
"chr8","23765666","23765969","chr8","27321280","27321595","30","3555614"
"chr8","23774564","23774829","chr8","27330474","27330735","23","3555910"
"chr8","23778004","23778248","chr8","27333922","27334167","15","3555918"
"chr8","23793114","23793417","chr8","27349057","27349353","32","3555943"
"chr8","23804986","23805274","chr2","184143766","184144059","61","160338780"
"chr8","23814070","23814375","chr8","27369822","27370105","37","3555752"
"chr8","23833583","23833898","chr8","27389291","27389607","17","3555708"
"chr8","23851570","23851854","chr8","27407382","27407666","13","3555812"
"chr8","23854798","23854877","chr8","27410615","27410693","5","3555817"
"chr8","23856015","23856221","chr6","172252298","172252482","59","148396283"
"chr8","23856437","23856582","chr8","27412285","27412430","9","3555848"
"chr8","23862635","23862962","chr8","27418554","27418863","30","3555919"
"chr8","23962439","23962739","chr8","27521267","27521568","20","3558828"
"chr8","23965428","23965632","chr8","27524269","27524474","12","3558841"
"chr8","23979113","23979402","chr8","27541420","27541710","25","3562307"
"chr8","23983784","23984060","chr8","27545973","27546229","50","3562189"
"chr8","23987147","23987415","chr8","27549297","27549579","22","3562150"
"chr8","24000021","24000211","chr11","88961679","88961861","53","64961658"
"chr8","24002928","24003023","chr8","27565288","27565383","7","3562360"
"chr8","24005666","24005949","chr1","211353988","211354282","51","187348322"
"chr8","24006413","24006713","chr8","27568764","27569071","30","3562351"
"chr8","24009111","24009171","chr3","161670182","161670241","10","137661071"
"chr8","24054786","24054971","chr8","115743565","115743748","37","91688779"
"chr8","24055014","24055133","chr5","97114497","97114620","23","73059483"
"chr8","24071129","24071418","chr8","27626320","27626630","36","3555191"
"chr8","24076563","24076877","chr8","27631721","27632035","18","3555158"
"chr8","24089691","24089996","chr6","148031539","148031850","58","123941848"
"chr8","24094776","24095098","chr9","30651570","30651886","64","6556794"
"chr8","24107475","24107771","chr8","27650424","27650703","62","3542949"
"chr8","24112396","24112656","chr8","27655329","27655597","31","3542933"
"chr8","24114539","24114852","chr8","27657494","27657804","28","3542955"
"chr8","24121936","24122229","chr8","27664799","27665093","32","3542863"
"chr8","24126419","24126752","chr8","27669577","27669892","47","3543158"
"chr8","24153135","24153435","chr8","27696857","27697158","26","3543722"
"chr8","24156088","24156375","chr8","27700096","27700373","25","3544008"
"chr8","24160090","24160308","chr3","35639309","35639528","37","11479219"
"chr8","24161517","24161648","chr8","27706124","27706259","13","3544607"
"chr8","24162378","24162655","chr8","27707309","27707567","38","3544931"
"chr8","24167669","24167971","chr8","27712590","27712912","37","3544921"
"chr8","24168099","24168404","chr8","27713027","27713331","31","3544928"
"chr8","24186333","24186648","chr8","27732289","27732601","27","3545956"
"chr8","24187402","24187682","chr8","27733644","27733916","21","3546242"
"chr8","24197546","24197801","chrX","1835494","1835745","52","22362052"
"chr8","24219888","24220147","chr4","115129767","115130025","49","90909879"
"chr8","24221282","24221573","chr8","27763688","27763977","16","3542406"
"chr8","24259646","24259771","chr8","27804633","27804758","11","3544987"
"chr8","24272945","24273232","chr8","27818044","27818331","21","3545099"
"chr8","24301008","24301292","chr8","27840963","27841245","16","3539955"
"chr8","24304056","24304347","chr7","92028418","92028710","78","67724362"
"chr8","24320920","24321224","chr8","27861538","27861840","24","3540618"
"chr8","24328406","24328703","chr15","8920430","8920718","54","15407976"
"chr8","24330239","24330558","chr8","27871250","27871567","25","3541011"
"chr8","24335007","24335305","chr8","27876329","27876624","22","3541322"
"chr8","24336445","24336724","chr8","27877759","27878034","27","3541314"
"chr8","24351128","24351362","chr11","3726492","3726723","51","20624636"
"chr8","24437520","24437811","chr3","124267629","124267922","56","99830109"
"chr8","24449925","24450212","chr8","27989727","27990017","38","3539802"
"chr8","24455824","24456155","chr6","67166681","67166993","68","42710857"
"chr8","24472209","24472513","chr8","28012919","28013214","30","3540710"
"chr8","24478048","24478348","chr8","28018869","28019158","31","3540821"
"chr8","24479530","24479669","chr8","28020346","28020466","27","3540816"
"chr8","24482667","24482965","chr8","28023292","28023585","20","3540625"
"chr8","24499616","24499758","chr3","9755296","9755438","32","14744320"
"chr8","24510019","24510330","chr8","28050978","28051291","11","3540959"
"chr8","24513035","24513324","chr8","28054003","28054293","40","3540968"
"chr8","24547217","24547355","chr1","142993218","142993341","31","118446001"
"chr8","24563402","24563745","chr8","28101559","28101882","40","3538157"
"chr8","24629638","24629812","chr8","28168934","28169102","34","3539296"
"chr8","24672358","24672655","chr8","28211844","28212147","25","3539486"
"chr8","24673411","24673650","chr8","28212897","28213143","28","3539486"
"chr8","24695516","24695802","chr8","45074900","45075192","52","20379384"
"chr8","24698732","24699020","chr8","28236354","28236636","37","3537622"
"chr8","24737328","24737625","chr3","177809645","177809922","63","153072317"
"chr8","24748705","24748933","chr8","28287757","28288013","39","3539052"
"chr8","24784313","24784605","chr8","28322205","28322514","26","3537892"
"chr8","24790186","24790308","chr8","28328472","28328589","13","3538286"
"chr8","24805576","24805868","chr8","28343530","28343822","17","3537954"
"chr8","24833082","24833175","chrX","45940355","45940449","15","21107273"
"chr8","24837816","24838114","chr8","28375970","28376274","23","3538154"
"chr8","24854714","24855026","chr8","28393124","28393412","35","3538410"
"chr8","24867139","24867261","chr1","53704936","53705059","19","28837797"
"chr8","24867773","24868079","chr8","28406802","28407107","29","3539029"
"chr8","24868685","24868952","chr8","28407731","28408019","30","3539046"
"chr8","24882672","24882987","chr8","28422342","28422631","52","3539670"
"chr8","24885105","24885330","chr8","28424414","28424640","12","3539309"
"chr8","24889908","24890214","chr8","28430242","28430532","29","3540334"
"chr8","24900828","24901117","chr17","82854019","82854302","73","57953191"
"chr8","24909561","24909858","chr8","28447582","28447871","34","3538021"
"chr8","24917068","24917377","chr6","77210653","77210958","56","52293585"
"chr8","24918950","24919249","chr1","122104598","122104888","62","97185648"
"chr8","24919623","24919852","chr9","34901511","34901729","50","9981888"
"chr8","24922890","24923195","chr8","28457468","28457770","17","3534578"
"chr8","24928768","24929065","chr8","28463436","28463735","18","3534668"
"chr8","24934669","24934960","chr8","28468934","28469227","18","3534265"
"chr8","24940115","24940414","chr19","16703982","16704290","76","8236133"
"chr8","24941328","24941616","chr8","28475621","28475910","17","3534293"
"chr8","24948085","24948395","chr8","28482414","28482708","38","3534329"
"chr8","24951491","24951788","chr8","28486033","28486326","23","3534542"
"chr8","24959265","24959581","chr8","28493663","28493978","38","3534398"
"chr8","24971637","24971891","chr8","28505898","28506153","19","3534261"
"chr8","24987294","24987587","chr8","28521897","28522198","19","3534603"
"chr8","25002700","25002984","chr8","28537812","28538109","30","3535112"
"chr8","25008235","25008488","chr8","28543361","28543613","14","3535126"
"chr8","25059379","25059505","chr8","28595767","28595890","11","3536388"
"chr8","25059571","25059713","chr17","80955360","80955498","49","55895789"
"chr8","25073596","25073892","chr8","28610500","28610810","35","3536904"
"chr8","25084621","25084924","chr8","28623574","28623869","25","3538953"
"chr8","25089919","25090212","chr8","28629300","28629587","32","3539381"
"chr8","25092596","25092875","chr8","28632009","28632293","22","3539413"
"chr8","25105069","25105384","chr8","28642992","28643310","30","3537923"
"chr8","25112184","25112489","chr8","28649852","28650163","29","3537668"
"chr8","25123325","25123594","chr8","28660656","28660943","30","3537331"
"chr8","25131258","25131540","chr12","114712741","114713031","57","89581483"
"chr8","25133243","25133466","chr16","39245643","39245870","51","14112400"
"chr8","25138944","25139241","chr8","28676387","28676662","47","3537443"
"chr8","25148730","25149038","chr16","58313322","58313631","72","33164592"
"chr8","25160206","25160479","chr2","91599500","91599768","64","66439294"
"chr8","25165206","25165488","chr8","28703014","28703296","17","3537808"
"chr8","25176806","25177076","chr8","28714982","28715247","23","3538176"
"chr8","25190973","25191138","chr8","28729736","28729911","21","3538763"
"chr8","25202782","25203076","chr8","28741825","28742107","39","3539043"
"chr8","25208770","25208983","chr20","22071230","22071432","55","3137540"
"chr8","25216629","25216920","chr8","28755865","28756154","31","3539236"
"chr8","25221256","25221576","chr8","28760303","28760612","32","3539047"
"chr8","25229625","25229884","chr3","126794297","126794543","57","101564672"
"chr8","25234695","25234812","chr8","28773723","28773852","19","3539028"
"chr8","25251791","25252081","chr8","28789834","28790113","33","3538043"
"chr8","25266255","25266563","chr8","28804412","28804706","30","3538157"
"chr8","25270387","25270598","chr8","28808553","28808763","22","3538166"
"chr8","25284730","25285025","chr7","140100928","140101221","59","114816198"
"chr8","25285812","25286119","chr8","28825128","28825433","23","3539316"
"chr8","25323840","25324141","chr8","28856962","28857262","38","3533122"
"chr8","25363891","25364193","chr8","28906769","28907063","29","3542878"
"chr8","25388503","25388801","chr8","28932631","28932933","22","3544128"
"chr8","25420453","25420776","chr8","28960999","28961325","21","3540546"
"chr8","25420916","25421036","chr8","28961455","28961569","11","3540539"
"chr8","25433930","25434232","chr14","107684465","107684767","68","82250535"
"chr8","25479819","25480113","chr8","29021743","29022036","9","3541924"
"chr8","25489779","25490067","chr8","29031610","29031901","26","3541831"
"chr8","25504353","25504649","chr8","29046015","29046302","33","3541662"
"chr8","25564645","25564866","chr8","29116777","29117011","33","3552132"
"chr8","25565049","25565339","chr8","29117197","29117494","26","3552148"
"chr8","25568428","25568666","chr3","185356054","185356274","63","159787626"
"chr8","25581137","25581429","chr8","29133479","29133794","50","3552342"
"chr8","25598026","25598226","chr8","30275478","30275683","44","4677452"
"chr8","25623288","25623561","chr8","29178552","29178825","18","3555264"
"chr8","25634457","25634741","chr15","77581304","77581583","62","51946847"
"chr8","25653810","25654096","chr8","29205806","29206113","60","3551996"
"chr8","25657762","25658069","chr8","29210036","29210343","17","3552274"
"chr8","25659312","25659603","chr8","29211535","29211829","14","3552223"
"chr8","25673185","25673317","chrX","12403505","12403640","19","13269680"
"chr8","25701342","25701581","chr8","29253568","29253807","17","3552226"
"chr8","25701886","25701969","chr8","29254121","29254203","14","3552235"
"chr8","25708130","25708416","chr8","29260351","29260642","23","3552221"
"chr8","25727320","25727611","chr8","29280863","29281161","31","3553543"
"chr8","25727762","25728067","chr18","6336977","6337277","62","19390785"
"chr8","25733271","25733543","chr8","29286868","29287140","8","3553597"
"chr8","25737794","25738023","chr17","8036913","8037142","52","17700881"
"chr8","25745213","25745519","chr8","29298677","29298958","48","3553464"
"chr8","25746130","25746418","chr8","29299557","29299853","25","3553427"
"chr8","25752495","25752634","chr8","29304210","29304348","13","3551715"
"chr8","25752944","25753103","chr8","29304677","29304841","23","3551733"
"chr8","25760331","25760599","chr3","127673217","127673485","62","101912886"
"chr8","25762428","25762738","chr8","29314056","29314368","33","3551628"
"chr8","25770111","25770379","chr8","29321410","29321692","30","3551299"
"chr8","25772725","25773024","chrX","69126646","69126942","58","43353921"
"chr8","25777876","25778104","chr8","29332724","29332969","32","3554848"
"chr8","25822447","25822731","chr8","29376738","29377010","28","3554291"
"chr8","25823257","25823539","chr8","29377546","29377825","22","3554289"
"chr8","25850803","25851111","chr8","29404022","29404339","28","3553219"
"chr8","25855380","25855690","chr8","29408748","29409057","22","3553368"
"chr8","25867930","25868220","chr8","29422372","29422653","27","3554442"
"chr8","25868987","25869275","chr8","29423724","29424004","26","3554737"
"chr8","25895165","25895448","chr8","29446791","29447077","21","3551626"
"chr8","25900970","25901003","chr8","29452845","29452878","0","3551875"
"chr8","25901366","25901422","chr8","29453241","29453295","6","3551875"
"chr8","25908295","25908571","chr8","29460514","29460795","32","3552219"
"chr8","25911672","25911971","chrX","15902142","15902434","57","10009530"
"chr8","25914410","25914521","chr8","29467845","29467956","6","3553435"
"chr8","25923441","25923719","chr3","55299063","55299339","53","29375622"
"chr8","25944886","25945180","chr8","29496647","29496942","16","3551761"
"chr8","25953617","25953736","chr8","29505366","29505484","8","3551749"
"chr8","25953782","25953948","chr8","29505524","29505686","15","3551742"
"chr8","25982172","25982462","chr8","29532255","29532528","34","3550083"
"chr8","25989527","25989825","chr8","29539772","29540064","23","3550245"
"chr8","25991387","25991661","chr8","29541630","29541904","19","3550243"
"chr8","25994574","25994871","chr8","29544778","29545075","22","3550204"
"chr8","26011376","26011692","chr11","48401419","48401716","78","22390043"
"chr8","26016661","26016959","chr8","29568317","29568623","43","3551656"
"chr8","26027620","26027915","chr8","29578612","29578883","45","3550992"
"chr8","26054931","26055210","chr8","29606268","29606547","16","3551337"
"chr8","26068965","26069241","chr8","29620362","29620636","17","3551397"
"chr8","26104943","26105154","chr8","92766074","92766284","43","66661131"
"chr8","26136722","26137015","chr8","29688640","29688953","43","3551918"
"chr8","26312710","26313015","chr8","29856058","29856340","39","3543348"
"chr8","26342271","26342584","chr8","29885491","29885794","34","3543220"
"chr8","26343180","26343495","chr8","29886389","29886697","30","3543209"
"chr8","26436407","26436528","chr8","29989474","29989597","7","3553067"
"chr8","26437539","26437662","chr8","29989474","29989597","9","3551935"
"chr8","26438696","26438994","chr2","160551205","160551504","77","134112509"
"chr8","26440525","26440806","chr8","29990773","29991071","35","3550248"
"chr8","26457799","26458092","chr8","30007750","30008031","32","3549951"
"chr8","26461129","26461437","chr2","97039137","97039445","55","70578008"
"chr8","26471258","26471566","chr8","30018428","30018719","33","3547170"
"chr8","26477654","26477946","chr8","30024125","30024432","36","3546471"
"chr8","26483518","26483690","chr8","30030006","30030182","20","3546488"
"chr8","26483991","26484126","chr8","30030491","30030626","8","3546500"
"chr8","26500962","26501258","chr8","30044552","30044858","34","3543590"
"chr8","26505351","26505481","chr8","30048961","30049091","7","3543610"
"chr8","26509150","26509429","chr11","121178437","121178716","54","94669287"
"chr8","26528586","26528880","chr8","30070172","30070475","43","3541586"
"chr8","26531014","26531301","chr8","30072550","30072837","26","3541536"
"chr8","26541739","26542015","chr8","30082412","30082702","38","3540673"
"chr8","26554159","26554401","chr11","32361075","32361317","53","5806916"
"chr8","26578006","26578155","chr8","30122377","30122528","20","3544371"
"chr8","26578447","26578606","chr8","30122827","30122976","19","3544380"
"chr8","26609046","26609162","chr8","30151063","30151187","12","3542017"
"chr8","26614142","26614268","chr8","30155267","30155391","10","3541125"
"chr8","26622920","26623252","chr1","166346816","166347119","93","139723896"
"chr8","26630765","26631037","chr8","30175314","30175588","44","3544549"
"chr8","26631465","26631755","chr3","124267629","124267922","56","97636164"
"chr8","26632646","26632942","chr8","30177190","30177484","21","3544544"
"chr8","26647003","26647119","chr13","24665652","24665769","14","1981351"
"chr8","26647777","26648044","chr8","30201575","30201807","79","3553798"
"chr8","26656303","26656571","chr8","30212304","30212576","27","3556001"
"chr8","26660193","26660498","chr8","30216241","30216530","35","3556048"
"chr8","26662405","26662703","chr8","30218500","30218781","30","3556095"
"chr8","26667484","26667786","chr8","30224592","30224888","19","3557108"
"chr8","26669581","26669876","chr8","30226671","30226966","8","3557090"
"chr8","26672907","26673149","chr8","30229995","30230233","23","3557088"
"chr8","26696997","26697274","chr8","30257025","30257293","28","3560028"
"chr8","26697484","26697749","chr8","30257500","30257766","17","3560016"
"chr8","26698275","26698437","chr10","60677207","60677362","38","33978932"
"chr8","26702431","26702727","chr2","109967146","109967434","60","83264715"
"chr8","26707213","26707507","chr8","30267348","30267644","21","3560135"
"chr8","26707537","26707550","chr6","148162172","148162184","2","121454635"
"chr8","26708938","26708969","chr10","64650449","64650481","7","37941511"
"chr8","26709271","26709543","chr8","30269400","30269672","19","3560129"
"chr8","26715102","26715307","chr8","30275478","30275683","10","3560376"
"chr8","26720920","26721149","chr8","30280379","30280605","17","3559459"
"chr8","26744876","26744995","chr8","30303852","30303971","4","3558976"
"chr8","26751519","26751641","chr8","30310845","30310968","7","3559326"
"chr8","26772767","26773020","chr5","173660605","173660865","60","146887838"
"chr8","26774649","26774939","chr8","30334058","30334351","18","3559409"
"chr8","26775425","26775585","chr3","126621167","126621327","33","99845742"
"chr8","26775628","26775744","chr13","92229940","92230056","21","65454312"
"chr8","26787847","26787919","chr5","158931521","158931583","19","132143674"
"chr8","26788212","26788270","chr6","32209322","32209376","14","5421110"
"chr8","26790622","26790849","chr8","30353006","30353232","17","3562384"
"chr8","26792440","26792722","chrX","30235373","30235651","45","3442933"
"chr8","26803226","26803507","chr8","30365610","30365891","21","3562384"
"chr8","26814052","26814363","chr8","30377277","30377572","30","3563225"
"chr8","26821436","26821744","chr14","94878162","94878466","54","68056726"
"chr8","26824820","26824961","chr4","37461855","37461993","22","10637035"
"chr8","26827737","26828042","chr8","30393365","30393666","34","3565628"
"chr8","26829758","26830023","chr8","30395391","30395656","23","3565633"
"chr8","26831361","26831674","chr8","30396984","30397300","24","3565623"
"chr8","26847003","26847122","chr8","30414246","30414366","8","3567243"
"chr8","26847387","26847573","chr15","11347253","11347435","46","15500134"
"chr8","26862701","26863000","chr8","30429947","30430247","28","3567246"
"chr8","26863558","26863859","chr8","30430805","30431108","16","3567247"
"chr8","26865320","26865582","chr4","154445507","154445774","60","127580187"
"chr8","26866540","26866677","chr8","30433776","30433916","17","3567236"
"chr8","26893726","26894037","chr8","30461406","30461686","56","3567680"
"chr8","26894998","26895168","chr8","30462640","30462810","18","3567642"
"chr8","26895464","26895601","chr8","30463109","30463255","20","3567645"
"chr8","26896583","26896892","chr11","63061742","63062041","78","36165159"
"chr8","26901473","26901784","chr8","30468625","30468947","28","3567152"
"chr8","26918380","26918495","chr8","30486243","30486356","4","3567863"
"chr8","26918789","26918933","chr2","101380040","101380184","33","74461251"
"chr8","26922334","26922636","chr8","30490127","30490435","23","3567793"
"chr8","26928632","26928723","chr8","30496340","30496429","4","3567708"
"chr8","26930379","26930495","chr9","15155936","15156054","14","11774443"
"chr8","26931269","26931597","chr7","55740891","55741181","97","28809622"
"chr8","26957206","26957471","chr8","30524290","30524560","23","3567084"
"chr8","26980082","26980380","chr7","28707792","28708094","65","1727710"
"chr8","27008467","27008753","chr8","30574932","30575218","23","3566465"
"chr8","27009169","27009459","chr10","62843999","62844296","63","35834830"
"chr8","27033490","27033778","chr6","17609699","17609979","66","9423791"
"chr8","27065735","27066027","chr8","30632469","30632759","41","3566734"
"chr8","27078876","27079170","chr8","30644611","30644902","31","3565735"
"chr8","27080218","27080502","chr5","51322379","51322663","60","24242161"
"chr8","27082351","27082650","chr8","30648091","30648399","18","3565740"
"chr8","27084279","27084587","chr8","30650029","30650309","54","3565750"
"chr8","27086576","27086853","chr8","30652358","30652651","39","3565782"
"chr8","27100284","27100533","chr5","78345069","78345318","55","51244785"
"chr8","27101633","27101709","chr8","30668398","30668473","7","3566765"
"chr8","27143339","27143661","chr3","12964523","12964827","79","14178816"
"chr8","27144402","27144525","chr8","30714568","30714691","6","3570166"
"chr8","27147346","27147629","chr8","30717528","30717807","20","3570182"
"chr8","27156693","27156869","chr9","98649529","98649704","35","71492836"
"chr8","27174747","27175055","chr8","30742637","30742946","47","3567890"
"chr8","27180587","27180881","chr7","140588016","140588306","61","113407429"
"chr8","27184907","27184944","chr14","109545748","109545781","9","82360841"
"chr8","27185266","27185390","chr18","70082377","70082496","31","42897111"
"chr8","27188521","27188809","chr1","69962111","69962392","63","42773590"
"chr8","27190413","27190700","chr8","30757779","30758090","58","3567366"
"chr8","27192213","27192503","chr8","30759861","30760143","18","3567648"
"chr8","27192827","27193103","chr8","30760463","30760759","35","3567636"
"chr8","27195697","27195888","chr8","30764594","30764779","22","3568897"
"chr8","27195898","27195998","chr8","30764780","30764890","15","3568882"
"chr8","27196262","27196419","chr8","30765159","30765331","22","3568897"
"chr8","27200320","27200611","chr8","30771322","30771614","27","3571002"
"chr8","27207448","27207644","chr4","87163988","87164176","48","59956540"
"chr8","27209266","27209537","chr8","30780142","30780405","25","3570876"
"chr8","27210967","27211269","chr8","30781814","30782116","30","3570847"
"chr8","27214218","27214508","chr8","30785481","30785766","27","3571263"
"chr8","27216310","27216597","chr8","30787558","30787846","19","3571248"
"chr8","27221841","27222132","chr8","30795894","30796185","23","3574053"
"chr8","27224336","27224650","chr1","44230646","44230948","53","17006310"
"chr8","27227062","27227203","chr3","49958137","49958275","34","22731075"
"chr8","27227494","27227582","chr17","24569237","24569323","14","2658257"
"chr8","27228182","27228482","chr8","30803146","30803455","40","3574964"
"chr8","27230210","27230305","chr9","87007160","87007252","19","59776950"
"chr8","27236387","27236675","chr19","2201752","2202042","57","25034635"
"chr8","27243345","27243648","chr8","30813175","30813472","57","3569830"
"chr8","27245273","27245559","chr8","30814360","30814644","27","3569087"
"chr8","27259563","27259779","chr1","39307023","39307224","49","12047460"
"chr8","27264076","27264391","chr7","29042959","29043275","75","1778883"
"chr8","27264894","27265157","chr8","30837185","30837464","41","3572291"
"chr8","27271846","27272139","chr8","30844544","30844837","17","3572698"
"chr8","27287938","27288219","chr8","30858679","30858961","22","3570741"
"chr8","27290877","27291175","chr8","30861598","30861868","42","3570721"
"chr8","27295270","27295590","chr8","30865585","30865904","32","3570315"
"chr8","27299679","27299971","chr8","30869936","30870222","22","3570257"
"chr8","27303763","27304054","chr8","30874028","30874320","13","3570265"
"chr8","27306012","27306306","chr5","6843994","6844285","58","20462018"
"chr8","27322400","27322701","chr8","30893269","30893565","19","3570869"
"chr8","27324792","27325057","chr8","30895643","30895905","28","3570851"
"chr8","27331004","27331286","chr8","30898044","30898327","22","3567040"
"chr8","27337603","27337731","chr8","30906603","30906735","9","3569000"
"chr8","27337985","27338195","chr8","30907321","30907501","38","3569336"
"chr8","27384798","27384873","chr9","30243622","30243697","16","2858824"
"chr8","27390634","27390902","chr8","30960930","30961172","45","3570296"
"chr8","27392208","27392346","chr8","30962516","30962662","16","3570308"
"chr8","27409103","27409396","chr8","30979415","30979706","20","3570312"
"chr8","27418625","27418886","chr8","30988617","30988883","39","3569992"
"chr8","27438293","27438472","chr8","31008913","31009092","10","3570620"
"chr8","27449306","27449615","chr15","7988541","7988851","56","19460765"
"chr8","27450995","27451290","chr8","31021948","31022249","30","3570953"
"chr8","27464636","27464931","chr8","31036493","31036793","34","3571857"
"chr8","27465948","27466037","chr1","196860676","196860765","16","169394728"
"chr8","27474026","27474145","chr8","31043873","31043992","6","3569847"
"chr8","27477541","27477827","chr8","31047384","31047679","25","3569843"
"chr8","27497586","27497802","chr8","31066344","31066541","32","3568758"
"chr8","27554685","27554972","chr8","31123381","31123676","52","3568696"
"chr8","27561781","27561906","chr9","69068598","69068719","16","41506817"
"chr8","27567650","27567927","chr8","31136366","31136620","35","3568716"
"chr8","27570145","27570438","chr8","31138918","31139215","18","3568773"
"chr8","27571021","27571333","chr4","73908479","73908787","67","46337458"
"chr8","27589128","27589435","chr8","31158327","31158634","25","3569199"
"chr8","27599780","27599981","chr3","175325227","175325440","52","147725447"
"chr8","27601148","27601461","chr8","31171475","31171780","32","3570327"
"chr8","27633281","27633594","chr8","31203277","31203596","30","3569996"
"chr8","27635717","27635834","chr8","31204522","31204640","7","3568805"
"chr8","27640851","27641094","chr8","31209762","31210002","19","3568911"
"chr8","27641798","27642056","chr8","31210710","31210969","22","3568912"
"chr8","27642322","27642601","chr8","31211236","31211507","22","3568914"
"chr8","27643573","27643852","chr8","31212492","31212778","28","3568919"
"chr8","27658480","27658750","chr8","31227702","31227971","18","3569222"
"chr8","27669977","27670256","chr8","31238833","31239132","33","3568856"
"chr8","27688748","27689051","chr8","31257538","31257836","28","3568790"
"chr8","27707546","27707845","chr8","31280456","31280758","36","3572910"
"chr8","27711238","27711513","chr8","31283435","31283679","55","3572197"
"chr8","27720500","27720806","chr7","129554975","129555269","92","101834475"
"chr8","27720827","27720959","chr1","109570884","109571013","23","81850057"
"chr8","27721382","27721666","chr8","31293829","31294096","26","3572447"
"chr8","27729095","27729259","chr1","84651531","84651698","37","56922436"
"chr8","27729330","27729447","chr1","27251044","27251157","27","478286"
"chr8","27733921","27734068","chr3","44304041","44304188","32","16570120"
"chr8","27735475","27735754","chr8","31308015","31308299","31","3572540"
"chr8","27746398","27746664","chr8","31313374","31313648","28","3566976"
"chr8","27747069","27747307","chr8","31314046","31314286","23","3566977"
"chr8","27752926","27753213","chr8","31318505","31318799","26","3565579"
"chr8","27801284","27801577","chr8","31368700","31369007","30","3567416"
"chr8","27855434","27855675","chr8","31430848","31431074","32","3575414"
"chr8","27938596","27938886","chr8","31530588","31530900","60","3591992"
"chr8","27966369","27966483","chr1","218552090","218552204","14","190585721"
"chr8","27969575","27969634","chr8","31558921","31558979","5","3589346"
"chr8","27969701","27969846","chr8","31559018","31559164","8","3589317"
"chr8","28016941","28017057","chr9","97914846","97914963","19","69897905"
"chr8","28042105","28042385","chr8","31630540","31630828","33","3588435"
"chr8","28094679","28094958","chr8","31678634","31678912","14","3583955"
"chr8","28236349","28236626","chr8","31825558","31825843","28","3589209"
"chr8","28336082","28336396","chr8","31925656","31925946","39","3589574"
"chr8","28437302","28437481","chr8","32015547","32015748","31","3578245"
"chr8","28437785","28437914","chr8","32016040","32016175","14","3578255"
"chr8","28461840","28461936","chr9","11149750","11149850","21","17312090"
"chr8","28476080","28476328","chr8","32053012","32053267","38","3576932"
"chr8","28485293","28485519","chr8","32062222","32062455","21","3576929"
"chr8","28496259","28496561","chr8","32073226","32073524","21","3576967"
"chr8","28502314","28502468","chr8","32078857","32079017","13","3576543"
"chr8","28518312","28518442","chr8","32095401","32095525","12","3577089"
"chr8","28541784","28542089","chr8","32124793","32125106","28","3583009"
"chr8","28544238","28544360","chr7","35642740","35642863","24","7098502"
"chr8","28554163","28554413","chr8","32137363","32137634","37","3583200"
"chr8","28666710","28667011","chr8","32253053","32253347","30","3586343"
"chr8","28696801","28697087","chr8","32277296","32277589","33","3580495"
"chr8","28707424","28707701","chr8","32288003","32288291","47","3580579"
"chr8","28734684","28734974","chr8","32321436","32321739","33","3586752"
"chr8","28743321","28743615","chr5","22397555","22397847","58","6345766"
"chr8","28766606","28766870","chr6","100627764","100628027","58","71861158"
"chr8","28778153","28778359","chr8","32364931","32365138","19","3586778"
"chr8","28791354","28791657","chr8","28623574","28623869","57","167780"
"chr8","28827356","28827660","chr8","32414358","32414655","60","3587002"
"chr8","28830916","28831172","chr8","32418219","32418466","40","3587303"
"chr8","28853582","28853862","chr8","32440414","32440692","17","3586832"
"chr8","28855596","28855696","chr8","32442445","32442558","20","3586849"
"chr8","28873040","28873342","chr8","32459685","32459997","33","3586645"
"chr8","28876029","28876331","chr8","32462682","32462983","26","3586653"
"chr8","28883992","28884286","chr8","32470362","32470650","41","3586370"
"chr8","28884997","28885283","chr8","32471359","32471647","22","3586362"
"chr8","28892197","28892395","chr8","32478230","32478427","14","3586033"
"chr8","28925653","28925975","chr8","32511917","32512214","46","3586264"
"chr8","28943986","28944293","chr8","32537310","32537636","53","3593324"
"chr8","28948646","28948910","chr8","32542121","32542384","31","3593475"
"chr8","28964641","28964863","chr14","9611892","9612110","44","19352749"
"chr8","28971613","28971892","chr14","12824319","12824598","70","16147294"
"chr8","28974487","28974798","chr8","32576232","32576547","24","3601745"
"chr8","28997107","28997375","chr8","93540152","93540409","68","64543045"
"chr8","29000163","29000437","chr8","32601927","32602211","23","3601764"
"chr8","29002624","29002749","chr8","32604411","32604532","18","3601787"
"chr8","29007783","29007954","chr8","32609663","32609819","29","3601880"
"chr8","29016713","29017012","chr8","32618517","32618821","27","3601804"
"chr8","29021390","29021698","chr8","32623207","32623513","27","3601817"
"chr8","29063851","29064141","chr1","211353988","211354282","55","182290137"
"chr8","29066375","29066675","chr8","32667358","32667664","35","3600983"
"chr8","29088440","29088748","chr12","60326502","60326804","80","31238062"
"chr8","29109677","29110001","chr8","32710064","32710406","48","3600387"
"chr8","29120428","29120742","chr8","32721211","32721524","25","3600783"
"chr8","29122044","29122377","chr8","32722827","32723121","57","3600783"
"chr8","29135264","29135474","chr8","32735744","32735951","12","3600480"
"chr8","29142195","29142522","chr19","29147342","29147667","80","5147"
"chr8","29189202","29189291","chr12","102113970","102114058","20","72924768"
"chr8","29210726","29211026","chr8","32815646","32815935","30","3604920"
"chr8","29270679","29270960","chr8","32877875","32878164","28","3607196"
"chr8","29278270","29278499","chr8","32885604","32885805","58","3607334"
"chr8","29288677","29288988","chr8","32895627","32895929","31","3606950"
"chr8","29290115","29290316","chr2","95564771","95564965","41","66274656"
"chr8","29291831","29292119","chr8","32898554","32898859","39","3606723"
"chr8","29306779","29306938","chr7","84537557","84537711","28","55230778"
"chr8","29319240","29319552","chr8","32934621","32934901","51","3615381"
"chr8","29320973","29321258","chr8","32936400","32936690","28","3615427"
"chr8","29325006","29325318","chr8","32941290","32941592","38","3616284"
"chr8","29329692","29329982","chr8","32945943","32946223","46","3616251"
"chr8","29370232","29370532","chr8","32988997","32989283","42","3618765"
"chr8","29458618","29458897","chr1","1247395","1247665","68","28211223"
"chr8","29467336","29467630","chr8","33085596","33085892","25","3618260"
"chr8","29480508","29480818","chr8","33099441","33099742","31","3618933"
"chr8","29505783","29506047","chr8","33124921","33125184","22","3619138"
"chr8","29543949","29544235","chr8","33172786","33173072","26","3628837"
"chr8","29572930","29573150","chr14","105129753","105129968","52","75556823"
"chr8","29636790","29637078","chr8","33260986","33261281","24","3624196"
"chr8","29655170","29655463","chr8","33278610","33278905","24","3623440"
"chr8","29773322","29773423","chr15","4485622","4485717","27","25287700"
"chr8","29773737","29773861","chr8","33390241","33390363","10","3616504"
"chr8","29828252","29828555","chr8","33441729","33442035","17","3613477"
"chr8","29881880","29882148","chr8","33501643","33501929","30","3619763"
"chr8","29895285","29895561","chrX","103046997","103047266","59","73151712"
"chr8","29904455","29904749","chr5","41182246","41182533","59","11277791"
"chr8","29905117","29905380","chr8","33523771","33524085","62","3618654"
"chr8","29909728","29910015","chr8","33529112","33529399","23","3619384"
"chr8","29926603","29926901","chr8","33546860","33547147","36","3620257"
"chr8","29941753","29942029","chr8","99621127","99621413","54","69679374"
"chr8","29945386","29945506","chr8","33569938","33570057","10","3624552"
"chr8","29965867","29966140","chrX","23632610","23632891","69","6333257"
"chr8","29987756","29988045","chr8","33613789","33614073","28","3626033"
"chr8","29998800","29998933","chr6","17252977","17253107","24","12745823"
"chr8","29999227","29999246","chr8","33625467","33625487","3","3626240"
"chr8","29999538","29999704","chr8","33625807","33625982","26","3626269"
"chr8","30009186","30009466","chr14","19313874","19314153","50","10695312"
"chr8","30016768","30017047","chr16","49265995","49266270","59","19249227"
"chr8","30032901","30032977","chr7","151554870","151554945","10","121521969"
"chr8","30037404","30037529","chr8","33662521","33662649","13","3625117"
"chr8","30038304","30038572","chr8","33663424","33663692","21","3625120"
"chr8","30048773","30049053","chr8","33673468","33673766","37","3624695"
"chr8","30060462","30060778","chr8","33685501","33685813","27","3625039"
"chr8","30063865","30064149","chr8","33688693","33688999","37","3624828"
"chr8","30068975","30069267","chr8","33694166","33694446","35","3625191"
"chr8","30071332","30071582","chr8","33696521","33696784","15","3625189"
"chr8","30077415","30077697","chr8","33701955","33702248","30","3624540"
"chr8","30082692","30082977","chr8","33707009","33707302","22","3624317"
"chr8","30096087","30096351","chr8","33715306","33715583","42","3619219"
"chr8","30105049","30105345","chr5","86867827","86868121","53","56762778"
"chr8","30108034","30108332","chr16","57748158","57748457","76","27640124"
"chr8","30119550","30119848","chr9","93979962","93980254","54","63860412"
"chr8","30120374","30120490","chr16","60832325","60832442","23","30711951"
"chr8","30120517","30120661","chr11","3089756","3089899","41","27030761"
"chr8","30127388","30127568","chr20","23185454","23185631","37","6941934"
"chr8","30127695","30127819","chr12","83298219","83298342","14","53170524"
"chr8","30129960","30130258","chr8","33756318","33756623","27","3626358"
"chr8","30153573","30153864","chr8","33776919","33777211","19","3623346"
"chr8","30159363","30159660","chr8","33782863","33783159","33","3623500"
"chr8","30161941","30162072","chr8","33786099","33786229","14","3624158"
"chr8","30174072","30174247","chr8","33798414","33798586","13","3624342"
"chr8","30177646","30177940","chr8","33801560","33801835","41","3623914"
"chr8","30185516","30185807","chr8","33808236","33808533","23","3622720"
"chr8","30204691","30204985","chr8","33822884","33823178","19","3618193"
"chr8","30207048","30207358","chr8","33825245","33825566","34","3618197"
"chr8","30209203","30209505","chr8","33827190","33827505","36","3617987"
"chr8","30243452","30243497","chr8","33866986","33867031","4","3623534"
"chr8","30243865","30244153","chr8","33867400","33867652","53","3623535"
"chr8","30262661","30262948","chr8","33885851","33886138","13","3623190"
"chr8","30264074","30264302","chr8","33887265","33887510","33","3623191"
"chr8","30288795","30289103","chr8","33912255","33912532","46","3623460"
"chr8","30306423","30306741","chr8","33929903","33930232","27","3623480"
"chr8","30324950","30325222","chr8","33950248","33950538","30","3625298"
"chr8","30352184","30352308","chr8","33978418","33978547","15","3626234"
"chr8","30378077","30378372","chr8","34003990","34004292","40","3625913"
"chr8","30384237","30384517","chr8","34009982","34010265","22","3625745"
"chr8","30412941","30413248","chr8","34034529","34034837","23","3621588"
"chr8","30419085","30419446","chr8","34040895","34041223","67","3621810"
"chr8","30426864","30427173","chr8","34048529","34048847","29","3621665"
"chr8","30560470","30560746","chr8","34179833","34180131","34","3619363"
"chr8","30637786","30638086","chr1","160551781","160552083","60","129913995"
"chr8","30638561","30638859","chr10","69624523","69624806","83","38985962"
"chr8","30701703","30702000","chr8","34330692","34331004","35","3628989"
"chr8","30783688","30783968","chr8","34407665","34407949","24","3623977"
"chr8","30787040","30787242","chr9","28839934","28840135","43","1947106"
"chr8","30873275","30873387","chr5","77755582","77755694","25","46882307"
"chr8","30873566","30873721","chr14","7002991","7003156","30","23870575"
"chr8","30874699","30875001","chr8","34504432","34504726","24","3629733"
"chr8","30889866","30890148","chr8","34518000","34518287","33","3628134"
"chr8","30911582","30911731","chr8","34540112","34540264","17","3628530"
"chr8","30912720","30912874","chr8","34540897","34541052","10","3628177"
"chr8","30915285","30915577","chr8","34543467","34543773","33","3628182"
"chr8","30916191","30916497","chr8","34544705","34545010","15","3628514"
"chr8","31077638","31077762","chr8","34701662","34701785","6","3624024"
"chr8","31081329","31081639","chr8","34705055","34705324","63","3623726"
"chr8","31084496","31084646","chr8","34708190","34708343","16","3623694"
"chr8","31146672","31146915","chr7","165818186","165818422","58","134671514"
"chr8","31150512","31150713","chr8","34774284","34774486","19","3623772"
"chr8","31189859","31190173","chr8","34819765","34820066","32","3629906"
"chr8","31280312","31280560","chr8","34912629","34912870","26","3632317"
"chr8","31283357","31283549","chr8","34915585","34915777","15","3632228"
"chr8","31350498","31350781","chr8","35049749","35050041","44","3699251"
"chr8","31365285","31365578","chr6","135235368","135235664","62","103870083"
"chr8","31422169","31422383","chr2","163071425","163071630","62","131649256"
"chr8","31426655","31426968","chr8","35125431","35125731","35","3698776"
"chr8","31473458","31473720","chr8","35178644","35178901","22","3705186"
"chr8","31475206","31475326","chr1","188493066","188493186","28","157017860"
"chr8","31486514","31486776","chr8","35191196","35191457","24","3704682"
"chr8","31521875","31521950","chr3","127418823","127418900","15","95896948"
"chr8","31522141","31522364","chr13","44010930","44011160","46","12488789"
"chr8","31533590","31533898","chr8","35237239","35237535","32","3703649"
"chr8","31559826","31560135","chr8","35263937","35264261","40","3704111"
"chr8","31573769","31574058","chr8","35276913","35277188","40","3703144"
"chr8","31625427","31625634","chr8","35326997","35327204","14","3701570"
"chr8","31655318","31655592","chr8","35364538","35364811","10","3709220"
"chr8","31692303","31692576","chr8","35396218","35396479","36","3703915"
"chr8","31709097","31709391","chr8","35412446","35412748","33","3703349"
"chr8","31813864","31814173","chr8","35520876","35521164","49","3707012"
"chr8","31820482","31820757","chr8","35527440","35527716","18","3706958"
"chr8","31858367","31858603","chr8","35573542","35573792","29","3715175"
"chr8","31860035","31860330","chr8","35575216","35575505","24","3715181"
"chr8","31879567","31879866","chr8","35595006","35595313","36","3715439"
"chr8","31950865","31951077","chr5","126644167","126644368","53","94693302"
"chr8","31977443","31977770","chr8","35699550","35699870","45","3722107"
"chr8","32000506","32000608","chr8","35724852","35724966","20","3724346"
"chr8","32011262","32011573","chr8","35735374","35735674","41","3724112"
"chr8","32023275","32023550","chr8","35741520","35741815","38","3718245"
"chr8","32056965","32057078","chr8","35776047","35776149","17","3719082"
"chr8","32068954","32069240","chr8","35787732","35788019","18","3718778"
"chr8","32070320","32070633","chr20","18804981","18805288","81","13265339"
"chr8","32100793","32101083","chr1","188619656","188619927","75","156518863"
"chr8","32125657","32125937","chr8","35838781","35839080","51","3713124"
"chr8","32143319","32143610","chr8","35857672","35857969","31","3714353"
"chr8","32146714","32146953","chr1","38653399","38653624","55","6506685"
"chr8","32150680","32150978","chr8","35865179","35865477","23","3714499"
"chr8","32176208","32176495","chr8","35890533","35890822","12","3714325"
"chr8","32177066","32177359","chr8","35891391","35891684","14","3714325"
"chr8","32209074","32209338","chr8","35923554","35923804","38","3714480"
"chr8","32262384","32262518","chr8","35980904","35981008","35","3718520"
"chr8","32262804","32262956","chr8","35981294","35981446","5","3718490"
"chr8","32273161","32273424","chr9","31266350","31266610","50","1006811"
"chr8","32315871","32316119","chr8","36040820","36041069","25","3724949"
"chr8","32327650","32327901","chr8","36052493","36052733","24","3724843"
"chr8","32448462","32448745","chr8","36187575","36187862","19","3739113"
"chr8","32489146","32489451","chr8","36225406","36225708","23","3736260"
"chr8","32505343","32505642","chr8","36245993","36246287","31","3740650"
"chr8","32554542","32554828","chr8","36301919","36302206","16","3747377"
"chr8","32584573","32584886","chr4","8532076","8532392","55","24052497"
"chr8","32625192","32625504","chr8","36365521","36365828","28","3740329"
"chr8","32633357","32633666","chr8","36374130","36374426","32","3740773"
"chr8","32684289","32684586","chr8","36424506","36424802","25","3740217"
"chr8","32686784","32687078","chr8","36426989","36427292","25","3740205"
"chr8","32731825","32732112","chr8","36470105","36470405","27","3738280"
"chr8","32800326","32800607","chr8","36546193","36546475","23","3745867"
"chr8","32805029","32805273","chr2","52643052","52643281","63","19838023"
"chr8","32846943","32847254","chr8","36595165","36595472","38","3748222"
"chr8","32860271","32860361","chr5","108695568","108695669","24","75835297"
"chr8","32870073","32870223","chr9","9985498","9985646","35","22884575"
"chr8","32883825","32883942","chr8","36632233","36632350","11","3748408"
"chr8","32896509","32896653","chr8","36637733","36637874","12","3741224"
"chr8","32910244","32910559","chr18","47305339","47305652","63","14395095"
"chr8","32965464","32965578","chr19","18440170","18440279","25","14525294"
"chr8","33016196","33016295","chr8","36760593","36760692","7","3744397"
"chr8","33033048","33033349","chr8","36779467","36779766","30","3746419"
"chr8","33067964","33068180","chr8","36815204","36815406","28","3747240"
"chr8","33069571","33069870","chr8","36816785","36817084","21","3747214"
"chr8","33091217","33091515","chr8","36838830","36839126","26","3747613"
"chr8","33161601","33161894","chr8","36910010","36910302","26","3748409"
"chr8","33165922","33166236","chr8","36914074","36914360","58","3748152"
"chr8","33176878","33177161","chr8","36926444","36926721","25","3749566"
"chr8","33178118","33178392","chr8","36927656","36927929","16","3749538"
"chr8","33266171","33266471","chr8","37019675","37019970","22","3753504"
"chr8","33271386","33271700","chr1","53872477","53872791","62","20601091"
"chr8","33342430","33342730","chr8","37100440","37100750","41","3758010"
"chr8","33357956","33358245","chr8","37116815","37117095","30","3758859"
"chr8","33393981","33394281","chr8","37160121","37160436","55","3766140"
"chr8","33394887","33395205","chr11","112586138","112586449","66","79191251"
"chr8","33448136","33448451","chr8","37220730","37221053","32","3772594"
"chr8","33502009","33502174","chr8","37274692","37274853","19","3772683"
"chr8","33534771","33535069","chr8","37307757","37308055","27","3772986"
"chr8","33539365","33539670","chr8","37312363","37312671","16","3772998"
"chr8","33545200","33545503","chr8","37318228","37318551","49","3773028"
"chr8","33546954","33547079","chr8","37321975","37322101","10","3775021"
"chr8","33636438","33636648","chr8","37418556","37418763","17","3782118"
"chr8","33666074","33666364","chr14","29928047","29928354","61","3738027"
"chr8","33752354","33752728","chr8","37530525","37530914","40","3778171"
"chr8","33779512","33779795","chr8","37557757","37558041","52","3778245"
"chr8","33824004","33824232","chr8","37603312","37603533","27","3779308"
"chr8","33847129","33847416","chr8","37626169","37626451","20","3779040"
"chr8","33856822","33857110","chr3","40206060","40206351","58","6349238"
"chr8","33877024","33877335","chr15","85146368","85146677","70","51269344"
"chr8","33923450","33923574","chr9","115052851","115052979","15","81129401"
"chr8","33946677","33946907","chr8","37725251","37725483","12","3778574"
"chr8","33963642","33963922","chr8","37742176","37742473","28","3778534"
"chr8","33965287","33965516","chr16","72431500","72431726","51","38466213"
"chr8","33987442","33987731","chr3","127162429","127162726","63","93174987"
"chr8","33988854","33989183","chr8","37767669","37767965","65","3778815"
"chr8","33998945","33999213","chr9","15488397","15488657","56","18510548"
"chr8","34020130","34020421","chr3","124689093","124689380","55","90668963"
"chr8","34024950","34025262","chr8","37804165","37804472","23","3779215"
"chr8","34026748","34026956","chr8","37805934","37806142","19","3779186"
"chr8","34033380","34033686","chr8","37812546","37812849","26","3779166"
"chr8","34044053","34044342","chr8","37823363","37823651","11","3779310"
"chr8","34054537","34054820","chrX","6428813","6429092","54","27625724"
"chr8","34059927","34060243","chr8","37839493","37839806","22","3779566"
"chr8","34060717","34061024","chr8","37840240","37840549","26","3779523"
"chr8","34071919","34072076","chr8","37851675","37851839","35","3779756"
"chr8","34075562","34075838","chr12","20012360","20012632","55","14063202"
"chr8","34093754","34094053","chr8","37873433","37873732","12","3779679"
"chr8","34097628","34097937","chr8","37877459","37877770","39","3779831"
"chr8","34098952","34099278","chr8","37878791","37879129","33","3779839"
"chr8","34115850","34116144","chr7","50799934","50800222","53","16684084"
"chr8","34116922","34117237","chr8","37896966","37897278","28","3780044"
"chr8","34118233","34118500","chr11","8485257","8485525","67","25632976"
"chr8","34118527","34118736","chr20","35094996","35095206","46","976469"
"chr8","34141169","34141295","chr8","37921101","37921232","12","3779932"
"chr8","34150592","34150850","chr8","37930746","37931013","28","3780154"
"chr8","34156487","34156784","chr8","37937102","37937387","25","3780615"
"chr8","34165747","34166034","chr8","37947148","37947435","22","3781401"
"chr8","34188899","34189231","chr8","37970724","37971027","53","3781825"
"chr8","34195162","34195451","chr8","37977589","37977880","12","3782427"
"chr8","34197258","34197570","chr8","37979729","37980043","15","3782471"
"chr8","34200830","34201032","chr9","97427101","97427303","41","63226271"
"chr8","34205218","34205512","chr8","37987533","37987826","28","3782315"
"chr8","34212005","34212287","chr8","37994254","37994537","23","3782249"
"chr8","34214637","34214931","chr8","37996844","37997105","49","3782207"
"chr8","34250288","34250360","chr8","38039341","38039413","1","3789053"
"chr8","34261888","34262238","chr8","38051719","38052030","56","3789831"
"chr8","34271872","34272074","chr10","17041385","17041582","38","17230487"
"chr8","34273655","34273943","chr8","38063863","38064155","34","3790208"
"chr8","34296019","34296321","chr8","38086059","38086352","29","3790040"
"chr8","34310212","34310424","chr8","38101226","38101450","22","3791014"
"chr8","34312483","34312615","chr8","38103837","38103971","10","3791354"
"chr8","34312617","34312908","chr8","38103973","38104285","40","3791356"
"chr8","34326641","34326936","chr8","38118143","38118441","33","3791502"
"chr8","34330224","34330524","chr8","38122052","38122356","34","3791828"
"chr8","34345542","34345716","chr9","32289497","32289670","39","2056045"
"chr8","34354542","34354853","chr8","38146464","38146760","35","3791922"
"chr8","34356944","34357231","chr8","38149121","38149408","18","3792177"
"chr8","34362491","34362642","chr3","125536846","125536999","32","91174355"
"chr8","34362934","34363073","chr8","38156944","38157081","9","3794010"
"chr8","34372412","34372715","chr8","39007844","39008154","58","4635432"
"chr8","34381431","34381721","chr8","38174017","38174301","27","3792586"
"chr8","34385110","34385225","chr20","28253970","28254072","38","6131140"
"chr8","34385622","34385845","chr19","38184423","38184647","47","3798801"
"chr8","34395597","34395826","chr8","38190322","38190555","13","3794725"
"chr8","34414324","34414646","chr2","48658615","48658922","78","14244291"
"chr8","34430824","34431126","chr8","38228497","38228797","36","3797673"
"chr8","34433563","34433858","chr8","38231311","38231606","18","3797748"
"chr8","34434950","34435236","chr8","38232555","38232839","20","3797605"
"chr8","34441743","34442053","chr8","38239624","38239920","60","3797881"
"chr8","34451734","34452018","chr8","38248936","38249218","24","3797202"
"chr8","34452723","34452972","chr3","36424130","36424381","54","1971407"
"chr8","34455823","34456115","chr1","44171967","44172258","68","9716144"
"chr8","34456835","34457180","chr3","123570746","123571070","81","89113911"
"chr8","34477723","34478043","chr8","38270148","38270462","28","3792425"
"chr8","34480065","34480297","chr8","38273099","38273336","45","3793034"
"chr8","34509610","34509739","chr8","38301393","38301523","4","3791783"
"chr8","34510002","34510124","chr1","223444164","223444286","18","188934162"
"chr8","34515020","34515309","chr8","38307843","38308115","28","3792823"
"chr8","34518021","34518155","chr8","44064817","44064948","25","9546796"
"chr8","34523545","34523827","chr8","38320120","38320408","16","3796575"
"chr8","34524839","34525002","chr8","38321712","38321876","14","3796873"
"chr8","34525300","34525374","chr8","38322173","38322247","5","3796873"
"chr8","34535229","34535456","chr8","38331999","38332225","14","3796770"
"chr8","34537953","34538258","chr8","38334738","38335047","20","3796785"
"chr8","34540162","34540386","chr9","97022418","97022646","40","62482256"
"chr8","34540694","34540947","chr8","38337419","38337672","14","3796725"
"chr8","34541627","34541926","chr8","38338352","38338646","28","3796725"
"chr8","34542378","34542502","chr8","38339104","38339228","2","3796726"
"chr8","34607969","34608194","chr8","38406138","38406387","35","3798169"
"chr8","34613776","34613859","chr8","38412016","38412097","7","3798240"
"chr8","34613941","34614171","chr8","38412179","38412409","15","3798238"
"chr8","34628830","34629144","chr8","38425994","38426320","26","3797164"
"chr8","34645341","34645518","chr3","5152601","5152765","38","29492740"
"chr8","34645753","34646036","chr19","2507487","2507757","59","32138266"
"chr8","34669365","34669681","chr1","136053595","136053894","80","101384230"
"chr8","34674463","34674587","chr11","127664104","127664228","19","92989641"
"chr8","34681599","34681865","chrX","67448189","67448456","54","32766590"
"chr8","34686100","34686272","chr8","38485023","38485195","7","3798923"
"chr8","34686567","34686716","chr7","139645530","139645674","24","104958963"
"chr8","34693620","34693929","chr6","134870801","134871115","67","100177181"
"chr8","34710158","34710329","chr7","153688648","153688814","50","118978490"
"chr8","34734772","34735074","chr8","38533293","38533603","25","3798521"
"chr8","34735383","34735649","chr10","79561228","79561491","62","44825845"
"chr8","34736946","34737107","chr8","38534971","38535165","36","3798025"
"chr8","34775623","34775734","chr8","38576227","38576342","8","3800604"
"chr8","34779155","34779455","chr8","38579621","38579925","17","3800466"
"chr8","34781680","34781913","chr8","38582141","38582373","9","3800461"
"chr8","34787524","34787803","chr8","38588275","38588563","29","3800751"
"chr8","34806841","34807124","chr8","38608336","38608620","17","3801495"
"chr8","34810866","34811161","chr8","38612613","38612923","31","3801747"
"chr8","34819650","34819915","chr8","38622615","38622888","20","3802965"
"chr8","34838306","34838589","chr8","38639954","38640243","35","3801648"
"chr8","34852085","34852178","chr8","38656329","38656423","6","3804244"
"chr8","34852485","34852658","chr8","38656725","38656899","11","3804240"
"chr8","34872789","34872917","chr11","13462208","13462337","25","21410581"
"chr8","34875624","34875942","chr8","38678384","38678712","32","3802760"
"chr8","34882881","34883073","chr8","38685959","38686152","16","3803078"
"chr8","34894297","34894554","chr8","38697493","38697740","24","3803196"
"chr8","34901781","34902078","chr8","38704895","38705190","12","3803114"
"chr8","34904517","34904802","chr8","38707615","38707901","21","3803098"
"chr8","34916715","34917008","chr7","139279698","139279986","48","104362983"
"chr8","34924100","34924407","chr7","67145065","67145366","62","32220965"
"chr8","34951410","34951674","chr8","38752979","38753242","14","3801569"
"chr8","34964774","34965046","chr8","38766447","38766718","19","3801673"
"chr8","34970497","34970761","chr8","38772105","38772397","46","3801608"
"chr8","34971998","34972309","chr8","38773649","38773951","20","3801651"
"chr8","34975341","34975674","chr8","38776717","38777022","45","3801376"
"chr8","34977295","34977579","chr8","38778635","38778934","38","3801340"
"chr8","34978242","34978441","chr3","43028745","43028938","46","8050503"
"chr8","34979051","34979126","chr8","38780103","38780168","14","3801052"
"chr8","34979562","34979848","chr8","38780600","38780886","19","3801038"
"chr8","34985456","34985775","chr8","38786857","38787175","31","3801401"
"chr8","34986754","34987031","chr5","139263693","139263952","72","104276939"
"chr8","34999420","34999717","chr8","38800744","38801043","19","3801324"
"chr8","35003393","35003649","chr8","38805097","38805344","27","3801704"
"chr8","35004765","35004856","chr8","38806459","38806555","11","3801694"
"chr8","35012332","35012604","chr8","38813995","38814267","49","3801663"
"chr8","35012647","35012663","chr12","35289754","35289769","2","277107"
"chr8","35013822","35014110","chr8","38815417","38815691","45","3801595"
"chr8","35018640","35018937","chr8","38820652","38820954","22","3802012"
"chr8","35035968","35036279","chr8","38843451","38843748","28","3807483"
"chr8","35056354","35056517","chr8","21540443","21540611","29","13515911"
"chr8","35058543","35058853","chr3","43652365","43652670","54","8593822"
"chr8","35062569","35062685","chr8","38869333","38869449","5","3806764"
"chr8","35064045","35064350","chr8","38870813","38871121","27","3806768"
"chr8","35066632","35066880","chr8","38873401","38873636","23","3806769"
"chr8","35074270","35074576","chr3","35650760","35651064","55","576490"
"chr8","35078631","35078879","chr8","38888286","38888553","32","3809655"
"chr8","35083640","35083946","chr1","163051602","163051916","67","127967962"
"chr8","35088222","35088343","chr1","205486630","205486748","18","170398408"
"chr8","35088372","35088542","chr1","21942508","21942674","37","13145864"
"chr8","35091653","35091930","chr8","38901496","38901772","19","3809843"
"chr8","35146981","35147233","chr8","38962589","38962841","13","3815608"
"chr8","35148758","35149047","chr8","38964379","38964669","31","3815621"
"chr8","35153306","35153586","chr8","38969267","38969553","18","3815961"
"chr8","35157642","35157957","chr8","38973639","38973939","36","3815997"
"chr8","35163956","35164259","chr8","38979651","38979927","44","3815695"
"chr8","35164267","35164563","chr8","38979970","38980267","20","3815703"
"chr8","35164879","35165038","chr8","38980641","38980809","17","3815762"
"chr8","35166711","35166999","chr8","38982427","38982735","41","3815716"
"chr8","35169710","35169913","chr8","38985414","38985617","14","3815704"
"chr8","35170282","35170365","chr8","38985987","38986070","3","3815705"
"chr8","35195661","35195903","chr8","39011050","39011287","28","3815389"
"chr8","35207766","35208079","chr8","39021873","39022183","20","3814107"
"chr8","35214941","35215174","chr8","39029036","39029280","30","3814095"
"chr8","35222453","35222712","chr8","39036757","39037021","29","3814304"
"chr8","35232034","35232320","chr8","39046579","39046878","31","3814545"
"chr8","35239574","35239886","chr8","39056637","39056931","40","3817063"
"chr8","35250797","35251014","chr10","73195715","73195925","45","37944918"
"chr8","35253869","35253987","chrX","102128051","102128168","19","66874182"
"chr8","35254016","35254184","chr4","16552355","16552517","32","18701661"
"chr8","35262738","35262854","chr2","107613237","107613354","20","72350499"
"chr8","35268543","35268701","chr9","15628977","15629142","28","19639566"
"chr8","35269020","35269152","chr17","54442955","54443088","19","19173935"
"chr8","35276166","35276423","chr8","39125560","39125826","60","3849394"
"chr8","35284690","35285000","chr8","39135072","39135382","28","3850382"
"chr8","35286602","35286930","chr8","39136982","39137273","57","3850380"
"chr8","35298418","35298748","chr14","110139067","110139393","69","74840649"
"chr8","35345064","35345374","chr8","39195897","39196203","23","3850833"
"chr8","35351385","35351561","chr8","39202442","39202597","27","3851057"
"chr8","35351839","35351970","chr8","39202906","39203039","11","3851067"
"chr8","35354828","35355137","chrX","64991673","64991978","54","29636845"
"chr8","35357600","35357892","chr8","39208551","39208846","28","3850951"
"chr8","35374641","35374939","chr8","39225796","39226097","23","3851155"
"chr8","35390679","35390989","chr8","39242542","39242851","19","3851863"
"chr8","35396552","35396766","chr8","39253505","39253726","17","3856953"
"chr8","35403511","35403786","chr9","7990953","7991236","59","27412558"
"chr8","35410337","35410452","chr8","39267052","39267175","15","3856715"
"chr8","35411581","35411868","chr8","39268249","39268543","27","3856668"
"chr8","35415948","35416259","chr8","39272606","39272890","44","3856658"
"chr8","35418313","35418593","chr8","39274907","39275177","22","3856594"
"chr8","35427932","35428261","chr8","39285166","39285492","21","3857234"
"chr8","35455609","35455720","chr8","39313455","39313566","9","3857846"
"chr8","35462367","35462620","chr8","39320757","39320998","50","3858390"
"chr8","35480573","35480875","chr8","39339201","39339501","16","3858628"
"chr8","35489843","35490151","chr8","39348237","39348537","26","3858394"
"chr8","35504170","35504467","chr8","39362412","39362707","28","3858242"
"chr8","35513489","35513730","chr8","39372103","39372366","34","3858614"
"chr8","35546719","35546934","chr8","39410836","39411064","25","3864117"
"chr8","35612626","35612852","chr8","39470038","39470267","18","3857412"
"chr8","35764541","35764849","chr8","39617407","39617727","37","3852866"
"chr8","36285655","36285933","chr16","56995540","56995829","68","20709885"
"chr8","36335093","36335340","chr8","40094007","40094254","19","3758914"
"chr8","36343258","36343563","chr8","40144863","40145173","27","3801605"
"chr8","36363681","36363972","chr9","54330679","54330974","23","17966998"
"chr8","36364550","36364785","chr1","23942951","23943176","47","12421599"
"chr8","36365677","36365797","chr9","54332676","54332800","8","17966999"
"chr8","36438838","36439113","chr8","40235554","40235827","14","3796716"
"chr8","36468502","36468769","chr15","10750349","10750617","61","25718153"
"chr8","36488883","36489079","chr10","37073265","37073464","53","584382"
"chr8","36611163","36611471","chr8","40451117","40451419","33","3839954"
"chr8","36659071","36659377","chr8","40498090","40498397","17","3839019"
"chr8","36681454","36681747","chr8","40521274","40521557","31","3839820"
"chr8","36699280","36699570","chr4","159090526","159090826","63","122391246"
"chr8","36702743","36702886","chr8","40543141","40543270","25","3840398"
"chr8","36734714","36734898","chr16","34379814","34379977","54","2354900"
"chr8","36798067","36798342","chr8","40631357","40631630","21","3833290"
"chr8","36824229","36824527","chr8","40658611","40658915","32","3834382"
"chr8","36865204","36865491","chr8","40692691","40692996","35","3827487"
"chr8","36883413","36883674","chr8","40710888","40711154","22","3827475"
"chr8","36904893","36905180","chr8","40733035","40733333","31","3828142"
"chr8","36967214","36967534","chr8","40790932","40791253","46","3823718"
"chr8","36968523","36968807","chr4","116758963","116759246","61","79790440"
"chr8","37005922","37006035","chr8","40834075","40834178","16","3828153"
"chr8","37043359","37043645","chr8","40869598","40869888","46","3826239"
"chr8","37086313","37086600","chr8","40912473","40912769","35","3826160"
"chr8","37099762","37100004","chr8","40925861","40926110","26","3826099"
"chr8","37108019","37108334","chr8","40934096","40934410","37","3826077"
"chr8","37134050","37134321","chr8","40959772","40960048","19","3825722"
"chr8","37153220","37153529","chr9","117609917","117610227","63","80456697"
"chr8","37166542","37166835","chr8","41005178","41005489","33","3838636"
"chr8","37192197","37192478","chr8","41034028","41034310","26","3841831"
"chr8","37232180","37232460","chr8","41073693","41073974","19","3841513"
"chr8","37260193","37260509","chr8","41101563","41101880","36","3841370"
"chr8","37329395","37329668","chr8","41173917","41174200","28","3844522"
"chr8","37375678","37375922","chr8","41213898","41214148","26","3838220"
"chr8","37383056","37383341","chr8","41221282","41221567","14","3838226"
"chr8","37390315","37390624","chr8","41228595","41228907","27","3838280"
"chr8","37407287","37407592","chr8","41245903","41246209","24","3838616"
"chr8","37421431","37421725","chr8","41260416","41260680","47","3838985"
"chr8","37442927","37443226","chr8","41284029","41284324","33","3841102"
"chr8","37450605","37450905","chr8","41291568","41291876","31","3840963"
"chr8","37453072","37453355","chr8","41294677","41294955","30","3841605"
"chr8","37513332","37513535","chr8","43967873","43968065","38","6454541"
"chr8","37515034","37515163","chr8","43964013","43964145","13","6448979"
"chr8","37544725","37545032","chr4","32423663","32423971","56","5121062"
"chr8","37565138","37565433","chr8","43914275","43914572","24","6349137"
"chr8","37568510","37568820","chr4","2185273","2185588","63","35383237"
"chr8","37573304","37573624","chr8","43906082","43906381","48","6332778"
"chr8","37597850","37598060","chr8","43880265","43880472","30","6282415"
"chr8","37617386","37617515","chr7","112235772","112235896","25","74618386"
"chr8","37619199","37619479","chr8","43859901","43860186","25","6240702"
"chr8","37658120","37658409","chr8","43828936","43829225","22","6170816"
"chr8","37669971","37670267","chr8","43817119","43817420","23","6147148"
"chr8","37692767","37693053","chr8","43794156","43794435","28","6101389"
"chr8","37693915","37694180","chr8","43793001","43793257","26","6099086"
"chr8","37752104","37752178","chr8","43723081","43723159","7","5970977"
"chr8","37752180","37752491","chr2","22466411","22466720","70","15285769"
"chr8","37758831","37759149","chr8","43715710","43716004","43","5956879"
"chr8","37765359","37765650","chr8","43711920","43712210","16","5946561"
"chr8","37785511","37785827","chr3","69803201","69803508","67","32017690"
"chr8","37792294","37792577","chr8","43683167","43683478","48","5890873"
"chr8","37798820","37798960","chr6","38241059","38241193","33","442239"
"chr8","37801937","37802223","chr8","43671196","43671492","32","5869259"
"chr8","37808511","37808748","chr10","31264543","31264771","60","6543968"
"chr8","37810462","37810741","chr8","43659811","43660100","36","5849349"
"chr8","37810815","37811110","chr8","43659448","43659740","36","5848633"
"chr8","37818062","37818181","chr8","43652264","43652379","9","5834202"
"chr8","37863187","37863449","chr8","43608044","43608297","36","5744857"
"chr8","37874889","37875168","chr8","43594516","43594804","31","5719627"
"chr8","37876443","37876739","chr8","43592961","43593254","26","5716518"
"chr8","37885283","37885404","chr8","43584314","43584437","8","5699031"
"chr8","37888404","37888703","chr8","43580737","43581050","42","5692333"
"chr8","37894267","37894532","chr8","43574892","43575180","51","5680625"
"chr8","37903257","37903556","chr8","43565961","43566262","18","5662704"
"chr8","37905486","37905728","chr8","43563771","43564013","14","5658285"
"chr8","37908860","37909034","chr20","26957218","26957389","40","10951642"
"chr8","37909077","37909205","chr7","31804546","31804669","21","6104531"
"chr8","37911177","37911485","chr8","43557947","43558253","41","5646770"
"chr8","37929458","37929768","chr2","107411533","107411833","61","69482075"
"chr8","37940543","37940826","chr8","43529120","43529438","53","5588577"
"chr8","37948978","37949276","chr8","43519960","43520261","23","5570982"
"chr8","37951599","37951912","chr8","43517325","43517638","14","5565726"
"chr8","37960823","37961116","chr8","43508026","43508324","27","5547203"
"chr8","37972457","37972745","chr8","43496979","43497271","25","5524522"
"chr8","37977066","37977363","chr8","43492382","43492671","40","5515316"
"chr8","37982755","37982843","chr8","43486893","43486982","8","5504138"
"chr8","37983155","37983328","chr13","101505769","101505948","36","63522614"
"chr8","37993269","37993565","chr8","43476512","43476818","31","5483243"
"chr8","38007964","38008271","chr8","43461531","43461840","46","5453567"
"chr8","38009062","38009416","chr8","43460387","43460741","17","5451325"
"chr8","38021066","38021382","chr8","43448368","43448680","26","5427302"
"chr8","38026414","38026614","chr15","6503383","6503578","45","31523031"
"chr8","38038629","38038958","chr8","43429409","43429738","25","5390780"
"chr8","38053397","38053566","chrX","9854404","9854573","39","28198993"
"chr8","38054862","38055154","chr8","43418700","43419009","35","5363838"
"chr8","38061694","38062005","chr8","43412548","43412858","22","5350854"
"chr8","38064057","38064315","chr8","43410027","43410281","24","5345970"
"chr8","38099546","38099858","chr7","16836681","16836985","56","21262865"
"chr8","38108371","38108674","chr8","43358311","43358607","18","5249940"
"chr8","38111508","38111834","chr8","43346060","43346368","48","5234552"
"chr8","38117975","38118285","chr4","108967969","108968277","57","70849994"
"chr8","38137815","38138104","chr8","43323274","43323563","15","5185459"
"chr8","38147538","38147819","chr8","43313637","43313926","18","5166099"
"chr8","38150702","38151021","chr8","43310430","43310748","19","5159728"
"chr8","38156305","38156594","chr8","43304086","43304370","28","5147781"
"chr8","38158732","38158990","chr8","43301699","43301956","15","5142967"
"chr8","38167295","38167404","chr8","43291903","43292012","8","5124608"
"chr8","38172557","38172851","chr8","43286489","43286782","19","5113932"
"chr8","38198259","38198376","chr8","43262917","43263034","9","5064658"
"chr8","38213968","38214090","chr8","43247071","43247193","6","5033103"
"chr8","38214402","38214553","chr6","56108880","56109036","39","17894478"
"chr8","38216573","38216801","chr8","43244366","43244581","30","5027793"
"chr8","38217354","38217487","chr19","1367912","1368045","25","36849442"
"chr8","38218283","38218564","chr8","43242586","43242857","33","5024303"
"chr8","38236773","38237088","chr8","43223063","43223370","27","4986290"
"chr8","38251405","38251507","chr1","140328428","140328538","28","102077023"
"chr8","38254690","38254987","chr16","11545677","11545975","46","26709013"
"chr8","38270534","38270658","chr15","49029242","49029367","22","10758708"
"chr8","38307258","38307527","chr12","115177119","115177394","58","76869861"
"chr8","38322055","38322350","chr8","43146525","43146820","25","4824470"
"chr8","38351146","38351444","chr8","43117340","43117636","20","4766194"
"chr8","38362555","38362749","chr8","43106030","43106214","22","4743475"
"chr8","38388870","38388999","chr10","14362357","14362489","22","24026513"
"chr8","38393571","38393877","chr8","43071157","43071468","22","4677586"
"chr8","38396325","38396581","chr8","43068465","43068720","21","4672140"
"chr8","38402433","38402717","chr8","43062314","43062588","25","4659881"
"chr8","38417304","38417566","chr8","43047074","43047348","33","4629770"
"chr8","38418829","38419131","chr8","43045522","43045819","26","4626693"
"chr8","38421821","38422049","chr2","44355954","44356183","48","5934133"
"chr8","38426971","38427280","chr8","43037627","43037952","41","4610656"
"chr8","38457090","38457393","chr8","43007191","43007488","25","4550101"
"chr8","38460395","38460686","chr8","43003429","43003742","37","4543034"
"chr8","38467272","38467577","chr8","42996263","42996543","50","4528991"
"chr8","38470923","38471214","chr8","42992634","42992927","20","4521711"
"chr8","38475540","38475827","chr8","42988150","42988445","25","4512610"
"chr8","38484831","38485145","chr8","42978523","42978839","25","4493692"
"chr8","38497567","38497843","chr8","42966523","42966804","20","4468956"
"chr8","38508727","38509018","chr19","29108741","29109042","51","9399986"
"chr8","38512471","38512632","chr8","42951723","42951904","29","4439252"
"chr8","38512668","38512782","chr8","42951581","42951695","10","4438913"
"chr8","38515788","38516045","chr8","42948427","42948680","36","4432639"
"chr8","38528860","38529156","chr8","42935263","42935556","33","4406403"
"chr8","38536135","38536409","chr8","42927992","42928254","26","4391857"
"chr8","38543790","38544076","chr8","42920051","42920336","21","4376261"
"chr8","38546882","38547190","chr8","42916961","42917268","31","4370079"
"chr8","38554731","38555032","chr8","42908910","42909202","31","4354179"
"chr8","38558230","38558510","chr20","28723910","28724188","53","9834320"
"chr8","38569144","38569270","chr8","42895550","42895679","15","4326406"
"chr8","38575561","38575864","chr8","42889006","42889306","21","4313445"
"chr8","38576656","38576957","chr8","42887941","42888248","36","4311285"
"chr8","38579323","38579643","chr8","42885230","42885538","40","4305907"
"chr8","38591395","38591662","chr20","29357836","29358099","51","9233559"
"chr8","38635234","38635357","chr8","42768527","42768650","11","4133293"
"chr8","38638977","38639289","chr8","42764820","42765132","15","4125843"
"chr8","38702448","38702739","chr8","42699857","42700134","32","3997409"
"chr8","38739991","38740274","chr8","42662538","42662826","24","3922547"
"chr8","38765009","38765285","chr8","42637835","42638103","21","3872826"
"chr8","38766876","38767174","chr8","42628027","42628331","35","3861151"
"chr8","38767891","38768186","chr7","162154968","162155262","60","123387077"
"chr8","38773807","38773914","chr14","77947695","77947799","30","39173888"
"chr8","38782550","38782689","chr8","42612953","42613102","27","3830403"
"chr8","38792667","38792896","chr15","13117864","13118086","43","25674803"
"chr8","38795854","38796141","chr8","42599965","42600253","25","3804111"
"chr8","38801433","38801715","chr8","42593523","42593805","13","3792090"
"chr8","38807714","38808020","chr8","42587227","42587528","24","3779513"
"chr8","38811335","38811607","chr12","118907626","118907899","64","80096291"
"chr8","38819473","38819757","chr8","42577570","42577817","53","3758097"
"chr8","38820318","38820599","chr1","223979328","223979622","61","185159010"
"chr8","38826310","38826475","chr8","42568907","42569079","22","3742597"
"chr8","38881536","38881832","chr7","68062157","68062454","55","29180621"
"chr8","38892115","38892412","chr8","42503578","42503895","42","3611463"
"chr8","38904631","38904933","chr3","21279895","21280200","55","17624736"
"chr8","38907059","38907289","chr8","42487856","42488089","12","3580797"
"chr8","38908646","38908970","chr8","42486073","42486389","29","3577427"
"chr8","38909870","38910165","chr8","42484866","42485164","17","3574996"
"chr8","38917353","38917652","chr8","42477363","42477663","18","3560010"
"chr8","38927849","38928154","chr8","42465281","42465577","31","3537432"
"chr8","38962351","38962620","chr8","42425775","42426052","29","3463424"
"chr8","38968741","38969039","chr8","42419384","42419688","19","3450643"
"chr8","38971065","38971400","chr10","32184869","32185181","76","6786196"
"chr8","38974156","38974458","chr20","28618222","28618522","57","10355934"
"chr8","38980564","38980831","chr8","42410233","42410500","19","3429669"
"chr8","38989747","38990058","chr8","42401016","42401327","31","3411269"
"chr8","39018868","39018998","chr8","42372064","42372194","8","3353196"
"chr8","39039591","39039877","chr8","42351324","42351624","35","3311733"
"chr8","39068580","39068704","chr7","68824427","68824555","29","29755847"
"chr8","39068724","39068975","chr8","42310951","42311184","34","3242227"
"chr8","39077687","39077868","chr8","42304770","42304957","16","3227083"
"chr8","39078092","39078384","chr8","42304241","42304539","31","3226149"
"chr8","39079479","39079714","chr8","42302851","42303083","23","3223372"
"chr8","39129746","39129903","chr8","42252692","42252861","21","3122946"
"chr8","39137969","39138232","chr15","17365574","17365834","51","21772395"
"chr8","39144207","39144308","chr3","13711275","13711376","18","25432932"
"chr8","39148118","39148273","chr8","59127020","59127174","29","19978902"
"chr8","39153980","39154286","chr8","42226806","42227119","21","3072826"
"chr8","39156708","39157017","chr8","42224252","42224558","11","3067544"
"chr8","39182853","39183133","chr8","42196193","42196478","28","3013340"
"chr8","39194071","39194392","chr9","7241107","7241411","71","31952964"
"chr8","39197190","39197322","chr2","165531071","165531193","26","126333881"
"chr8","39198415","39198736","chr8","42180423","42180746","32","2982008"
"chr8","39216554","39216839","chr8","42160965","42161246","21","2944411"
"chr8","39225751","39226047","chr8","42152512","42152791","29","2926761"
"chr8","39240261","39240557","chr8","42137657","42137951","26","2897396"
"chr8","39265471","39265754","chr8","42114277","42114558","33","2848806"
"chr8","39266315","39266611","chr8","42113420","42113733","42","2847105"
"chr8","39269697","39269993","chr8","42110278","42110568","25","2840581"
"chr8","39269994","39270170","chr8","42110096","42110274","17","2840102"
"chr8","39276872","39277020","chr8","61026951","61027094","32","21750079"
"chr8","39295767","39296013","chr8","42075985","42076233","17","2780218"
"chr8","39305853","39305978","chr8","42064453","42064571","17","2758600"
"chr8","39310715","39310839","chr4","73819458","73819584","18","34508743"
"chr8","39313147","39313455","chr8","42051154","42051462","19","2738007"
"chr8","39315873","39316005","chr8","42048564","42048696","4","2732691"
"chr8","39327574","39327853","chr8","42036323","42036607","25","2708749"
"chr8","39335306","39335585","chr8","42028450","42028738","23","2693144"
"chr8","39338164","39338468","chr8","42025874","42026188","23","2687710"
"chr8","39358593","39358887","chr8","42005514","42005814","17","2646921"
"chr8","39360338","39360618","chr8","42003783","42004092","53","2643445"
"chr8","39412507","39412804","chr8","41957927","41958229","21","2545420"
"chr8","39430578","39430884","chr8","41945218","41945521","24","2514640"
"chr8","39446008","39446277","chr3","38934767","38935033","66","511241"
"chr8","39446849","39447043","chr8","41919880","41920086","27","2473031"
"chr8","39467836","39468138","chr8","41900106","41900407","23","2432270"
"chr8","39490251","39490472","chr8","41876496","41876718","11","2386245"
"chr8","39494132","39494462","chr14","8439133","8439435","76","31054999"
"chr8","39502103","39502405","chr8","41864319","41864644","48","2362216"
"chr8","39502985","39503187","chr8","41863536","41863738","16","2360551"
"chr8","39507451","39507708","chr8","41858446","41858703","22","2350995"
"chr8","39509410","39509632","chrX","2601846","2602063","50","36907564"
"chr8","39538483","39538658","chr8","41828940","41829115","6","2290457"
"chr8","39543493","39543766","chr8","41823782","41824063","25","2280289"
"chr8","39544694","39544995","chr9","12871172","12871473","70","26673522"
"chr8","39555913","39556206","chr8","41811145","41811443","20","2255232"
"chr8","39556776","39557065","chr8","41810218","41810510","19","2253442"
"chr8","39578324","39578585","chr11","576346","576611","60","39001978"
"chr8","39613587","39613902","chr8","41748877","41749199","35","2135290"
"chr8","39653008","39653296","chr6","144017468","144017757","57","104364460"
"chr8","39659938","39660193","chr8","41699985","41700240","10","2040047"
"chr8","39662990","39663284","chr8","41696863","41697154","24","2033873"
"chr8","39666800","39667068","chrX","113906906","113907171","68","74240106"
"chr8","39669287","39669592","chr8","41689888","41690191","19","2020601"
"chr8","39707200","39707494","chr8","41652217","41652503","46","1945017"
"chr8","39736167","39736390","chr8","41624664","41624894","26","1888497"
"chr8","39737889","39738200","chr8","41622872","41623190","26","1884983"
"chr8","39760735","39761031","chr8","41599009","41599295","26","1838274"
"chr8","39764143","39764315","chr11","54803508","54803685","41","15039365"
"chr8","39764625","39764751","chr8","41594175","41594301","21","1829550"
"chr8","39769825","39770127","chr8","41588914","41589184","46","1819089"
"chr8","39772479","39772768","chr8","41586312","41586606","23","1813833"
"chr8","39775736","39776018","chrX","16345355","16345638","61","23430381"
"chr8","39787223","39787516","chr8","41567785","41568087","30","1780562"
"chr8","39789417","39789708","chr8","41565651","41565957","32","1776234"
"chr8","39804564","39804856","chr8","41546567","41546859","20","1742003"
"chr8","39839435","39839516","chr11","86075906","86075987","15","46236471"
"chr8","39851656","39851970","chr8","41491820","41492131","26","1640164"
"chr8","39868614","39868736","chr8","41474875","41474997","11","1606261"
"chr8","39880381","39880676","chr8","41469111","41469397","27","1588730"
"chr8","39890959","39891232","chr1","129543506","129543782","66","89652547"
"chr8","39908454","39908728","chr8","41448593","41448866","23","1540139"
"chr8","40028670","40028921","chr2","588268","588514","41","39440402"
"chr8","40032087","40032418","chr19","29595568","29595878","80","10436519"
"chr8","40449979","40450245","chr3","123284741","123285007","26","82834762"
"chr8","40451293","40451402","chr19","50275174","50275283","17","9823881"
"chr8","40520167","40520468","chr5","61613725","61614027","60","21093558"
"chr8","40780047","40780348","chr8","44304635","44304940","30","3524588"
"chr8","40792655","40792950","chr8","44291717","44292023","35","3499062"
"chr8","40929123","40929389","chr8","44145901","44146182","35","3216778"
"chr8","40937143","40937258","chr8","44140460","44140574","7","3203317"
"chr8","40964546","40964794","chr3","74945806","74946044","74","33981260"
"chr8","41075954","41076153","chr8","44062357","44062565","15","2986403"
"chr8","41076452","41076551","chr8","44061937","44062036","5","2985485"
"chr8","41088207","41088497","chr8","44041924","44042230","40","2953717"
"chr8","41101131","41101343","chr16","42183034","42183244","41","1081903"
"chr8","41103044","41103208","chr10","31561023","31561188","41","9542021"
"chr8","41103506","41103651","chr8","44016234","44016378","11","2912728"
"chr8","41151927","41152211","chr8","43975023","43975296","40","2823096"
"chr8","41159705","41160014","chr14","109630730","109631041","63","68471025"
"chr8","41177182","41177480","chr8","44802535","44802847","37","3625353"
"chr8","41214368","41214672","chr2","84913076","84913368","52","43698708"
"chr8","41247339","41247644","chr7","114691184","114691486","75","73443845"
"chr8","41257987","41258335","chr8","44894728","44895059","41","3636741"
"chr8","41259457","41259756","chr8","44896175","44896475","17","3636718"
"chr8","41265788","41265920","chr8","44901642","44901774","4","3635854"
"chr8","41277895","41278083","chr5","24193743","24193917","54","17084152"
"chr8","41314896","41315067","chr15","8429087","8429254","34","32885809"
"chr8","41342690","41342992","chr8","44965295","44965602","27","3622605"
"chr8","41354108","41354379","chrX","51871583","51871875","74","10517475"
"chr8","41379725","41380044","chr8","45004092","45004399","41","3624367"
"chr8","41422880","41423182","chr20","26502560","26502862","56","14920320"
"chr8","41434542","41434702","chr14","121786411","121786574","37","80351869"
"chr8","41453106","41453177","chr8","45074690","45074761","4","3621584"
"chr8","41456962","41457250","chr8","45078469","45078759","10","3621507"
"chr8","41459202","41459481","chr3","39007741","39008023","49","2451461"
"chr8","41465260","41465537","chr8","45089897","45090173","23","3624637"
"chr8","41480325","41480626","chr8","45103762","45104053","42","3623437"
"chr8","41489999","41490202","chr8","45113258","45113478","33","3623259"
"chr8","41493579","41493876","chr17","54072119","54072406","51","12578540"
"chr8","41494629","41494927","chr8","45120755","45121054","24","3626126"
"chr8","41510406","41510604","chr13","75616065","75616265","34","34105659"
"chr8","41517054","41517322","chr8","45142791","45143061","15","3625737"
"chr8","41528142","41528425","chr8","45153916","45154209","30","3625774"
"chr8","41529348","41529465","chr8","45155143","45155260","9","3625795"
"chr8","41545222","41545373","chr6","152858918","152859059","40","111313696"
"chr8","41545413","41545527","chr6","139383516","139383625","19","97838103"
"chr8","41605315","41605612","chr4","87333067","87333363","54","45727752"
"chr8","41612486","41612789","chr8","45307180","45307481","21","3694694"
"chr8","41628216","41628447","chr8","45329065","45329298","17","3700849"
"chr8","41654826","41655105","chr8","45355828","45356109","24","3701002"
"chr8","41657399","41657702","chr8","45358342","45358624","39","3700943"
"chr8","41670976","41671179","chr8","45372330","45372533","11","3701354"
"chr8","41705681","41705923","chr8","45404265","45404504","20","3698584"
"chr8","41706831","41707154","chr8","45405417","45405742","40","3698586"
"chr8","41713752","41714049","chr8","45412627","45412921","18","3698875"
"chr8","41723972","41724180","chr8","45422662","45422872","11","3698690"
"chr8","41724918","41725206","chr8","45423609","45423897","31","3698691"
"chr8","41756436","41756700","chr8","45455445","45455729","37","3699009"
"chr8","41769148","41769447","chr8","45467842","45468140","17","3698694"
"chr8","41769888","41770191","chr10","86104849","86105154","67","44334961"
"chr8","41783349","41783584","chr8","45482035","45482249","39","3698686"
"chr8","41822996","41823195","chr7","39074479","39074661","57","2748517"
"chr8","41830558","41830840","chr8","45532980","45533263","24","3702422"
"chr8","41835328","41835563","chr8","45541665","45541940","54","3706337"
"chr8","41844201","41844449","chr8","45549754","45550002","15","3705553"
"chr8","41847495","41847781","chr8","45553141","45553417","22","3705646"
"chr8","41925322","41925530","chr8","45641822","45642031","14","3716500"
"chr8","41933688","41933976","chr8","45649519","45649827","42","3715831"
"chr8","41985027","41985297","chr5","58565912","58566184","69","16580885"
"chr8","42011055","42011288","chr8","38331999","38332225","50","3679056"
"chr8","42136213","42136518","chr8","45867235","45867532","31","3731022"
"chr8","42189286","42189577","chr8","45920584","45920859","41","3731298"
"chr8","42205329","42205588","chr1","31011624","31011882","59","11193705"
"chr8","42270419","42270720","chr19","15562519","15562818","59","26707900"
"chr8","42307853","42308169","chr20","42042273","42042584","81","265580"
"chr8","42467541","42467844","chr8","46189258","46189560","24","3721717"
"chr8","42485967","42486093","chr19","12812292","12812422","32","29673675"
"chr8","42494866","42495169","chr8","46217489","46217792","20","3722623"
"chr8","42543951","42544244","chr8","46266181","46266484","25","3722230"
"chr8","42576521","42576799","chr1","52182984","52183264","67","9606463"
"chr8","42579890","42580180","chr8","46301050","46301336","30","3721160"
"chr8","42665442","42665612","chr8","46387444","46387617","15","3722002"
"chr8","42791150","42791446","chr8","46551155","46551454","28","3760005"
"chr8","43100493","43100803","chr8","46862858","46863166","40","3762365"
"chr8","43172071","43172375","chr8","105628485","105628773","72","62456414"
"chr8","43175119","43175413","chr4","149426544","149426840","72","106251425"
"chr8","43202740","43203059","chr8","46961522","46961827","27","3758782"
"chr8","43290636","43290916","chr8","47072643","47072920","21","3782007"
"chr8","43305861","43306184","chr8","47088265","47088556","61","3782404"
"chr8","43325962","43326244","chr8","47107517","47107798","15","3781555"
"chr8","43461051","43461352","chr8","47229547","47229844","27","3768496"
"chr8","43475183","43475329","chr13","107520945","107521083","33","64045762"
"chr8","43475429","43475717","chr8","47239830","47240139","58","3764401"
"chr8","43526273","43526570","chr8","47286239","47286564","67","3759966"
"chr8","43715598","43715740","chr20","18642628","18642775","42","25072970"
"chr8","43756559","43756856","chr8","47504344","47504654","37","3747785"
"chr8","43764703","43765017","chr8","47512509","47512798","53","3747806"
"chr8","43873291","43873455","chr11","67683115","67683281","42","23809824"
"chr8","43873474","43873759","chr1","100753208","100753448","90","56879734"
"chr8","43945802","43945935","chr8","47695557","47695690","12","3749755"
"chr8","44100112","44100176","chr6","168955069","168955133","19","124854957"
"chr8","44100471","44100624","chr3","13044305","13044455","37","31056166"
"chr8","44247485","44247785","chr8","51330176","51330474","23","7082691"
"chr8","44624392","44624664","chr8","50945292","50945570","32","6320900"
"chr8","44798106","44798395","chr8","50758956","50759248","25","5960850"
"chr8","44918607","44918913","chr8","50628319","50628604","45","5709712"
"chr8","44970435","44970709","chr8","50567641","50567893","54","5597206"
"chr8","45007070","45007192","chr8","50493290","50493412","10","5486220"
"chr8","45131910","45132212","chr8","50373755","50374053","35","5241845"
"chr8","45157370","45157623","chr2","172398914","172399164","66","127241544"
"chr8","45272271","45272571","chr8","50188491","50188785","37","4916220"
"chr8","45276404","45276685","chr9","7951605","7951888","53","37324799"
"chr8","45332549","45332870","chr8","50127639","50127962","35","4795090"
"chr8","45435130","45435440","chr8","50025353","50025661","27","4590223"
"chr8","45443636","45443912","chr8","50015645","50015929","23","4572009"
"chr8","45555898","45556008","chr14","10488926","10489044","30","35066972"
"chr8","45639990","45640106","chr16","45097922","45098040","15","542068"
"chr8","45641439","45641738","chr8","49802087","49802385","24","4160648"
"chr8","45678551","45678820","chr3","45103721","45104000","61","574830"
"chr8","45705355","45705575","chr8","49737383","49737592","21","4032028"
"chr8","45708053","45708357","chr8","49734621","49734923","20","4026568"
"chr8","45712165","45712448","chr8","49730509","49730795","35","4018344"
"chr8","45713134","45713424","chr8","49729543","49729834","17","4016409"
"chr8","45732702","45732974","chr8","49704382","49704650","27","3971680"
"chr8","45749257","45749380","chr10","87818140","87818263","18","42068883"
"chr8","45755050","45755338","chr8","49683224","49683511","22","3928174"
"chr8","45810215","45810261","chr8","49623399","49623445","3","3813184"
"chr8","45826165","45826480","chr8","49607248","49607555","44","3781083"
"chr8","45835336","45835631","chr8","49603167","49603475","47","3767831"
"chr8","45905885","45906012","chr8","49540011","49540138","4","3634126"
"chr8","45927856","45928162","chr8","49517527","49517826","43","3589671"
"chr8","46141364","46141642","chr8","49250068","49250340","30","3108704"
"chr8","46168304","46168562","chr8","49222823","49223077","21","3054519"
"chr8","46222589","46222866","chr8","49168685","49168964","21","2946096"
"chr8","46278411","46278677","chr8","49103687","49103965","29","2825276"
"chr8","46348454","46348740","chr8","49040011","49040287","23","2691557"
"chr8","46358584","46358892","chr8","49028177","49028481","26","2669593"
"chr8","46360370","46360638","chr8","49026103","49026365","31","2665733"
"chr8","46389379","46389687","chr8","49000494","49000802","23","2611115"
"chr8","46389980","46390280","chr7","140588016","140588306","54","94198036"
"chr8","46390715","46390952","chr8","48999094","48999330","20","2608379"
"chr8","46400183","46400474","chr8","48990650","48990940","21","2590467"
"chr8","46421411","46421660","chr8","48967361","48967644","48","2545950"
"chr8","46480143","46480444","chr8","48904755","48905042","41","2424612"
"chr8","46493973","46494272","chr8","48889148","48889453","18","2395175"
"chr8","46528829","46528967","chr8","48853501","48853645","13","2324672"
"chr8","46529249","46529405","chr8","48853036","48853191","17","2323787"
"chr8","46533259","46533556","chr8","48848549","48848863","32","2315290"
"chr8","46537485","46537778","chr12","61068295","61068588","58","14530810"
"chr8","46540536","46540651","chr8","48845852","48845967","5","2305316"
"chr8","46548689","46548963","chr8","48837856","48838140","35","2289167"
"chr8","46550101","46550402","chr8","48836426","48836717","33","2286325"
"chr8","46550967","46551046","chr8","48835759","48835837","7","2284792"
"chr8","46552874","46553159","chr8","48832714","48832990","31","2279840"
"chr8","46555992","46556124","chr8","48829622","48829754","4","2273630"
"chr8","46569023","46569320","chr8","48815811","48816102","40","2246788"
"chr8","46581355","46581643","chr8","48803539","48803826","19","2222184"
"chr8","46600070","46600362","chr8","48784752","48785063","51","2184682"
"chr8","46628441","46628574","chr4","114936919","114937049","17","68308478"
"chr8","46630100","46630393","chr8","28623574","28623869","67","18006526"
"chr8","46641312","46641626","chr8","48751357","48751657","29","2110045"
"chr8","46645929","46646114","chr8","48746801","48746977","23","2100872"
"chr8","46707905","46708201","chr8","48667721","48668016","14","1959816"
"chr8","46805764","46806079","chr1","7114733","7115046","68","39691031"
"chr8","46928673","46928977","chr8","48394692","48394989","27","1466019"
"chr8","46961921","46962044","chr8","48360734","48360857","4","1398813"
"chr8","47063712","47063957","chr8","48235894","48236154","37","1172182"
"chr8","47127446","47127715","chr4","13407447","13407700","62","33719999"
"chr8","47201826","47202119","chr8","48108509","48108829","53","906683"
"chr8","47209046","47209351","chr8","48101456","48101772","36","892410"
"chr8","47343636","47343806","chr1","90673430","90673593","42","43329794"
"chr8","47347537","47347834","chr8","47917659","47917959","25","570122"
"chr8","47441854","47442138","chr8","51528735","51529024","21","4086881"
"chr8","47445521","47445822","chr8","51532421","51532722","19","4086900"
"chr8","47464563","47464850","chr8","51552238","51552522","21","4087675"
"chr8","47521183","47521495","chr8","51613655","51613950","31","4092472"
"chr8","47561788","47562099","chr8","51651672","51651971","39","4089884"
"chr8","47600886","47601019","chr9","5875837","5875970","26","41725049"
"chr8","47622416","47622728","chr8","51718032","51718344","15","4095616"
"chr8","47623895","47624127","chr8","51720032","51720261","25","4096137"
"chr8","47628096","47628220","chr8","51724778","51724902","4","4096682"
"chr8","47687946","47688164","chr8","51786470","51786697","22","4098524"
"chr8","47694319","47694522","chr8","51792687","51792895","21","4098368"
"chr8","47699678","47699975","chr8","51798933","51799233","21","4099255"
"chr8","47703876","47704135","chr8","51803046","51803305","17","4099170"
"chr8","47717694","47717989","chr8","51819236","51819512","33","4101542"
"chr8","47720102","47720416","chr5","14864191","14864482","68","32855911"
"chr8","47727238","47727398","chr8","51830234","51830403","17","4102996"
"chr8","47727699","47727836","chr8","51830708","51830842","12","4103009"
"chr8","47785880","47786179","chrX","15902142","15902434","63","31883738"
"chr8","47793819","47793937","chr7","152899855","152899972","25","105106036"
"chr8","47794232","47794339","chr13","97720172","97720284","24","49925940"
"chr8","47797213","47797270","chr12","61450729","61450799","18","13653516"
"chr8","47801189","47801459","chr14","52931834","52932095","73","5130645"
"chr8","47837974","47838084","chr5","128066868","128066980","23","80228894"
"chr8","47840454","47840746","chr8","51948327","51948619","13","4107873"
"chr8","47841925","47842240","chr8","51949728","51950046","27","4107803"
"chr8","47845203","47845500","chr20","36934619","36934907","69","10910584"
"chr8","47847301","47847453","chr8","21621594","21621739","41","26225707"
"chr8","47863458","47863711","chr8","51968058","51968298","26","4104600"
"chr8","47865377","47865583","chr8","51969975","51970192","29","4104598"
"chr8","47886143","47886267","chr8","51989741","51989866","9","4103598"
"chr8","47917767","47918082","chr8","52017755","52018071","19","4099988"
"chr8","47945932","47946160","chr15","2451903","2452139","48","45494029"
"chr8","47985862","47986078","chr15","5304276","5304492","48","42681586"
"chr8","48004137","48004437","chr8","52097733","52098038","24","4093596"
"chr8","48008948","48009160","chr8","52102919","52103129","15","4093971"
"chr8","48023937","48024235","chr1","211673170","211673470","54","163649233"
"chr8","48026476","48026667","chr20","30429126","30429316","49","17597350"
"chr8","48036094","48036391","chr8","52130405","52130708","24","4094311"
"chr8","48071012","48071267","chr8","52167993","52168248","20","4096981"
"chr8","48085719","48086012","chr8","52184287","52184568","29","4098568"
"chr8","48112314","48112581","chr8","129380495","129380777","82","81268181"
"chr8","48119552","48119844","chr19","8730061","8730347","59","39389491"
"chr8","48134903","48135203","chr8","52233146","52233408","57","4098243"
"chr8","48199205","48199345","chr3","42988449","42988590","27","5210756"
"chr8","48199654","48199813","chr20","32284199","32284357","25","15915455"
"chr8","48216611","48216649","chr4","38012955","38012988","10","10203656"
"chr8","48216953","48217198","chr8","52316711","52316961","21","4099758"
"chr8","48234903","48235114","chr8","52335215","52335453","43","4100312"
"chr8","48245160","48245466","chr8","52345829","52346128","22","4100669"
"chr8","48377145","48377447","chr8","52478617","52478929","20","4101472"
"chr8","48475775","48476088","chr8","52570013","52570328","18","4094238"
"chr8","48589970","48590243","chr13","69215333","69215602","67","20625363"
"chr8","48703619","48703930","chr8","52849447","52849767","33","4145828"
"chr8","48716192","48716313","chr8","52862451","52862580","13","4146259"
"chr8","48725578","48725888","chr8","52870802","52871115","29","4145224"
"chr8","48728042","48728348","chr8","52873318","52873628","36","4145276"
"chr8","48761491","48761762","chr8","52909078","52909353","37","4147587"
"chr8","48784761","48785061","chr8","52936974","52937255","39","4152213"
"chr8","48831567","48831889","chr8","52975636","52975954","32","4144069"
"chr8","48896456","48896580","chr8","53043558","53043687","14","4147102"
"chr8","48907452","48907665","chr8","53054603","53054816","18","4147151"
"chr8","48909052","48909164","chr8","53056197","53056309","4","4147145"
"chr8","48949536","48949811","chr8","53096520","53096819","38","4146984"
"chr8","49015402","49015673","chr8","53162976","53163231","40","4147574"
"chr8","49077236","49077369","chr9","54403521","54403650","26","5326285"
"chr8","49077677","49077835","chr8","53221799","53221958","9","4144122"
"chr8","49135483","49135780","chr8","53281161","53281458","17","4145678"
"chr8","49180543","49180789","chr8","53327666","53327912","14","4147123"
"chr8","49181339","49181481","chr8","53328516","53328650","22","4147177"
"chr8","49239106","49239230","chr8","53386361","53386484","9","4147255"
"chr8","49241149","49241481","chr8","53388714","53389018","53","4147565"
"chr8","49245477","49245764","chr8","53393060","53393335","52","4147583"
"chr8","49316484","49316517","chrX","417852","417886","4","48898632"
"chr8","49316543","49316722","chr3","41137310","41137484","41","8179233"
"chr8","49355133","49355425","chr8","53491309","53491592","32","4136176"
"chr8","49356608","49356887","chr8","53492750","53493024","34","4136142"
"chr8","49410175","49410466","chr15","8537702","8537983","70","40872473"
"chr8","49423091","49423392","chr8","53571473","53571758","33","4148382"
"chr8","49427843","49428154","chr8","53575683","53575992","19","4147840"
"chr8","49456635","49456924","chr8","53611486","53611776","28","4154851"
"chr8","49467260","49467556","chr5","78689579","78689868","54","29222319"
"chr8","49487332","49487631","chr8","53639496","53639786","45","4152164"
"chr8","49490231","49490345","chr11","62483836","62483953","22","12993605"
"chr8","49496206","49496315","chr1","22457543","22457653","16","27038663"
"chr8","49514231","49514528","chr8","53662434","53662731","32","4148203"
"chr8","49533882","49534002","chr9","121345079","121345205","25","71811197"
"chr8","49543331","49543645","chr2","56803979","56804276","63","7260648"
"chr8","49548783","49548927","chr8","53690425","53690568","13","4141642"
"chr8","49559417","49559537","chr8","53702331","53702450","4","4142914"
"chr8","49564259","49564555","chr8","53707179","53707483","37","4142920"
"chr8","49565602","49565662","chr8","17300112","17300170","6","32265490"
"chr8","49597218","49597417","chr8","53742132","53742330","17","4144914"
"chr8","49605954","49606153","chr8","53750942","53751137","18","4144988"
"chr8","49606869","49606993","chr8","53751835","53751949","12","4144966"
"chr8","49607123","49607226","chr9","29260197","29260303","22","20346926"
"chr8","49612221","49612517","chr8","53757205","53757503","30","4144984"
"chr8","49617832","49617948","chr8","53762474","53762588","10","4144642"
"chr8","49618250","49618413","chr8","53762876","53763040","15","4144626"
"chr8","49619859","49620167","chr8","53764140","53764432","31","4144281"
"chr8","49626288","49626588","chr1","220797557","220797858","58","171171269"
"chr8","49662291","49662396","chr3","50076569","50076674","27","414278"
"chr8","49662661","49662931","chr16","70963621","70963889","70","21300960"
"chr8","49700363","49700699","chr8","53845995","53846327","26","4145632"
"chr8","49706292","49706412","chr8","53851853","53851973","9","4145561"
"chr8","49711138","49711439","chr8","53856729","53857036","32","4145591"
"chr8","49719295","49719375","chr2","55868506","55868588","13","6149211"
"chr8","49719694","49719761","chr1","51114102","51114163","18","1394408"
"chr8","49737913","49738205","chr8","53882297","53882597","24","4144384"
"chr8","49762003","49762295","chr8","53907597","53907887","9","4145594"
"chr8","49768570","49768848","chr1","191690399","191690678","53","141921829"
"chr8","49791422","49791723","chr8","53937650","53937938","32","4146228"
"chr8","49800514","49800791","chr8","53948059","53948338","29","4147545"
"chr8","49819381","49819670","chr8","53967863","53968152","17","4148482"
"chr8","49826028","49826331","chr8","53974872","53975157","45","4148844"
"chr8","49827959","49828090","chrX","52807641","52807772","22","2979682"
"chr8","49842224","49842511","chr8","53987646","53987939","22","4145422"
"chr8","49842927","49843060","chr10","13705811","13705940","24","36137116"
"chr8","49853324","49853611","chr1","100649392","100649693","59","50796068"
"chr8","49856513","49856731","chr8","54001802","54002000","39","4145289"
"chr8","49880614","49880914","chr8","54022245","54022548","27","4141631"
"chr8","49889179","49889444","chr8","54030667","54030936","32","4141488"
"chr8","49901488","49901628","chr5","21319395","21319536","27","28582093"
"chr8","49932177","49932445","chr8","54074765","54075033","14","4142588"
"chr8","49948582","49948721","chr4","157639029","157639171","26","107690447"
"chr8","49948989","49949134","chr7","78950159","78950305","28","29001170"
"chr8","50062203","50062476","chr8","54208861","54209124","28","4146658"
"chr8","50115181","50115489","chr10","70947259","70947566","55","20832078"
"chr8","50119588","50119900","chr8","54262114","54262432","77","4142526"
"chr8","50121753","50121976","chr16","50487929","50488154","43","366176"
"chr8","50213329","50213595","chr11","61107850","61108114","58","10894521"
"chr8","50272150","50272365","chr13","30070965","30071173","45","20201185"
"chr8","50272723","50272831","chr6","176850371","176850469","28","126577648"
"chr8","50275037","50275327","chr8","54427247","54427551","29","4152210"
"chr8","50282358","50282644","chr8","54434295","54434581","21","4151937"
"chr8","50293852","50294145","chr8","54446846","54447137","30","4152994"
"chr8","50319258","50319501","chr8","54475465","54475706","16","4156207"
"chr8","50469923","50470168","chr19","12438308","12438546","56","38031615"
"chr8","50507182","50507373","chr8","54678164","54678356","10","4170982"
"chr8","50527087","50527409","chr8","54699499","54699815","25","4172412"
"chr8","50626830","50627141","chr8","54787843","54788150","21","4161013"
"chr8","50642811","50643092","chr8","54805492","54805772","30","4162681"
"chr8","50800806","50801099","chr8","54964622","54964917","22","4163816"
"chr8","50910954","50911253","chr8","55100126","55100423","22","4189172"
"chr8","55471070","55471340","chr8","55332032","55332305","17","139038"
"chr8","55490437","55490730","chr8","55350350","55350647","24","140087"
"chr8","55517619","55517941","chr8","55373326","55373652","25","144293"
"chr8","55547522","55547749","chr10","47529404","47529641","67","8018118"
"chr8","55618933","55619216","chr8","55477984","55478291","39","140949"
"chr8","55628989","55629110","chr8","55488691","55488812","5","140298"
"chr8","55728931","55729232","chr8","55540762","55541072","27","188169"
"chr8","55879955","55880245","chr8","55735977","55736232","64","143978"
"chr8","55885053","55885170","chr8","84625454","84625570","17","28740401"
"chr8","55887137","55887253","chr8","55743104","55743227","15","144033"
"chr8","55963432","55963749","chr8","55822904","55823216","34","140528"
"chr8","55987621","55987922","chr8","55846807","55847123","34","140814"
"chr8","56070990","56071287","chr8","55938124","55938435","38","132866"
"chr8","56075256","56075533","chr8","55942878","55943156","22","132378"
"chr8","56141078","56141359","chr8","56010683","56010976","31","130395"
"chr8","56143737","56143832","chr8","56013491","56013586","10","130246"
"chr8","56179321","56179615","chr9","91014031","91014322","67","34834710"
"chr8","56182863","56183149","chr8","56052517","56052803","24","130346"
"chr8","56186052","56186385","chr7","80186341","80186667","82","24000289"
"chr8","56292038","56292308","chr14","116109124","116109385","73","59817086"
"chr8","56300423","56300558","chr8","56169208","56169330","22","131215"
"chr8","56371652","56371958","chr8","56239898","56240208","23","131754"
"chr8","56400311","56400621","chr8","56265031","56265339","19","135280"
"chr8","56561012","56561299","chr8","56468869","56469158","24","92143"
"chr8","56610814","56611091","chr8","56527834","56528091","31","82980"
"chr8","56617323","56617582","chr8","56534593","56534856","16","82730"
"chr8","56641148","56641397","chr8","92687825","92688073","60","36046677"
"chr8","56659838","56660015","chr8","56578851","56579014","25","80987"
"chr8","56660322","56660453","chr8","56579336","56579466","8","80986"
"chr8","56675616","56675897","chr8","56595295","56595585","35","80321"
"chr8","56713212","56713363","chr8","56636289","56636435","14","76923"
"chr8","56713654","56713793","chr8","56636740","56636880","6","76914"
"chr8","56728971","56729263","chr8","56652504","56652780","29","76467"
"chr8","56752135","56752347","chr6","42676796","42677002","47","14075339"
"chr8","56755461","56755766","chr8","56681884","56682143","59","73577"
"chr8","56759821","56760118","chr1","15852698","15852981","71","40907123"
"chr8","56803152","56803456","chr17","10153919","10154216","62","46649233"
"chr8","56810036","56810322","chr3","159059575","159059863","61","102249539"
"chr8","56823485","56823780","chr8","56727983","56728278","11","95502"
"chr8","56837231","56837516","chr8","56737681","56737970","25","99550"
"chr8","57020582","57020747","chr20","26957218","26957389","27","30063364"
"chr8","57236002","57236305","chr8","57146644","57146955","35","89358"
"chr8","57283940","57284236","chr8","57188738","57189036","27","95202"
"chr8","57304064","57304349","chr8","57261573","57261859","33","42491"
"chr8","57501304","57501500","chr8","57467626","57467824","18","33678"
"chr8","57609552","57609835","chr8","57565481","57565763","24","44071"
"chr8","57796575","57796868","chr8","57754272","57754570","31","42303"
"chr8","57852411","57852700","chr8","57805927","57806226","61","46484"
"chr8","57939924","57940225","chr8","57888785","57889084","23","51139"
"chr8","58002963","58003256","chr8","57949081","57949391","33","53882"
"chr8","58029399","58029700","chr13","71248269","71248571","62","13218870"
"chr8","58067635","58067834","chr8","58009252","58009451","17","58383"
"chr8","58257918","58258164","chr8","58192225","58192470","19","65693"
"chr8","58265003","58265274","chr8","58199567","58199853","29","65436"
"chr8","58268552","58268845","chr2","44809541","44809832","65","13459011"
"chr8","58309528","58309805","chr8","58244537","58244819","33","64991"
"chr8","58357265","58357584","chr8","58293164","58293463","44","64101"
"chr8","58435987","58436313","chr8","58366769","58367063","60","69218"
"chr8","58466249","58466533","chr8","58396813","58397094","19","69436"
"chr8","58474249","58474520","chr8","58405048","58405325","25","69201"
"chr8","58477530","58477829","chr15","17816055","17816351","59","40661475"
"chr8","58498570","58498863","chr20","28651476","28651780","58","29847094"
"chr8","58534551","58534854","chr8","58473216","58473502","34","61335"
"chr8","58536964","58537319","chr12","11912117","11912464","82","46624847"
"chr8","58539419","58539720","chr8","58478408","58478702","27","61011"
"chr8","58541871","58542183","chr8","58481167","58481473","27","60704"
"chr8","58545730","58546033","chr8","58485088","58485402","33","60642"
"chr8","58546288","58546575","chr8","58485652","58485941","26","60636"
"chr8","58563964","58564309","chr8","58504583","58504914","25","59381"
"chr8","58584056","58584348","chr5","145452372","145452661","66","86868316"
"chr8","58586989","58587256","chr8","58533482","58533725","34","53507"
"chr8","58593333","58593577","chr8","58539814","58540053","21","53519"
"chr8","58599974","58600264","chr8","58546703","58546976","31","53271"
"chr8","58607823","58607954","chr8","58554358","58554488","6","53465"
"chr8","58609064","58609218","chr8","58555586","58555743","12","53478"
"chr8","58609521","58609663","chr8","58556036","58556181","11","53485"
"chr8","58616584","58616883","chr8","58563433","58563739","35","53151"
"chr8","58641076","58641362","chr8","58588970","58589287","41","52106"
"chr8","58645395","58645705","chr1","8981776","8982081","60","49663619"
"chr8","58650984","58651210","chr8","58598950","58599175","21","52034"
"chr8","58657618","58657753","chr1","155846166","155846296","28","97188548"
"chr8","58661180","58661489","chr8","58609003","58609306","32","52177"
"chr8","58661897","58662202","chr8","58609689","58609989","27","52208"
"chr8","58704450","58704559","chr8","58651613","58651718","6","52837"
"chr8","58713209","58713521","chr8","58661031","58661331","36","52178"
"chr8","58735064","58735363","chr8","58682006","58682305","18","53058"
"chr8","58742245","58742537","chr8","58689115","58689407","17","53130"
"chr8","58808537","58808834","chr8","58754708","58755009","41","53829"
"chr8","58863899","58864206","chr8","58809800","58810126","33","54099"
"chr8","58941940","58942242","chr15","51002476","51002779","59","7939464"
"chr8","58942326","58942628","chr8","58886343","58886649","18","55983"
"chr8","58995597","58995910","chr10","32184869","32185181","56","26810728"
"chr8","59009861","59010155","chr7","140588016","140588306","52","81578155"
"chr8","59082229","59082503","chr8","58971809","58972084","15","110420"
"chr8","59095742","59096021","chr8","58984987","58985251","29","110755"
"chr8","59115576","59115738","chr8","59004483","59004650","18","111093"
"chr8","59160413","59160463","chr19","873794","873842","9","58286619"
"chr8","59160529","59160563","chr18","10212714","10212754","13","48947815"
"chr8","59194728","59194819","chr1","16674594","16674681","14","42520134"
"chr8","59195123","59195325","chr8","59080581","59080783","27","114542"
"chr8","59197628","59197929","chr8","59083100","59083403","18","114528"
"chr8","59209627","59209868","chr4","39275641","39275885","61","19933986"
"chr8","59216274","59216549","chr8","59101962","59102243","31","114312"
"chr8","59240409","59240566","chr8","59127020","59127174","21","113389"
"chr8","59279355","59279508","chr7","131392072","131392224","36","72112717"
"chr8","59305731","59306041","chr1","39515746","39516064","73","19789985"
"chr8","59370686","59370945","chr8","59243031","59243290","28","127655"
"chr8","59388913","59389200","chr8","59261943","59262225","25","126970"
"chr8","59457973","59458262","chr8","59330607","59330888","26","127366"
"chr8","59518920","59519135","chr8","59387524","59387753","33","131396"
"chr8","59628320","59628494","chr8","59487343","59487517","7","140977"
"chr8","59643406","59643523","chr20","3356781","3356895","31","56286625"
"chr8","59643830","59643957","chr8","59502976","59503102","11","140854"
"chr8","59652897","59653167","chr8","59512015","59512285","13","140882"
"chr8","59666466","59666728","chr3","36424130","36424381","59","23242336"
"chr8","59683801","59684097","chr8","59537992","59538262","55","145809"
"chr8","59690736","59691045","chr8","59543986","59544285","34","146750"
"chr8","59743472","59743766","chr8","59602818","59603102","31","140654"
"chr8","59757120","59757404","chr16","61203222","61203518","51","1446102"
"chr8","59774843","59775094","chr8","59634020","59634261","30","140823"
"chr8","59827621","59827907","chr8","59693765","59694055","19","133856"
"chr8","59885300","59885392","chr2","184439175","184439260","20","124553875"
"chr8","59918326","59918619","chr8","59795587","59795877","24","122739"
"chr8","59939048","59939339","chr8","59816924","59817225","31","122124"
"chr8","59956747","59957032","chr8","59835792","59836077","21","120955"
"chr8","59994275","59994411","chr19","7403702","7403840","37","52590573"
"chr8","60049930","60050051","chr8","59925219","59925334","11","124711"
"chr8","60334067","60334333","chr8","60160575","60160845","23","173492"
"chr8","60336247","60336537","chr8","60164374","60164677","32","171873"
"chr8","60459600","60459910","chr8","60284242","60284524","64","175358"
"chr8","60462437","60462746","chr8","60287062","60287381","31","175375"
"chr8","60476366","60476663","chr8","60300736","60301030","22","175630"
"chr8","60549764","60550055","chr8","60357356","60357630","34","192408"
"chr8","60563896","60564184","chr8","60371009","60371287","26","192887"
"chr8","60616080","60616349","chr8","60428182","60428435","41","187898"
"chr8","60883936","60884227","chr7","140100928","140101221","61","79216992"
"chr8","60907049","60907293","chr8","60716857","60717118","27","190192"
"chr8","60923956","60924083","chr8","60733542","60733660","21","190414"
"chr8","60940776","60941078","chr8","60750192","60750495","23","190584"
"chr8","60971420","60971622","chr10","73195715","73195925","40","12224295"
"chr8","61141168","61141447","chr8","60940586","60940872","38","200582"
"chr8","61177044","61177370","chr8","60976450","60976761","46","200594"
"chr8","61224161","61224333","chr3","41137310","41137484","32","20086851"
"chr8","61276576","61276881","chr8","61078179","61078475","24","198397"
"chr8","61311549","61311851","chr8","61112902","61113205","21","198647"
"chr8","61320456","61320751","chr8","61121501","61121802","27","198955"
"chr8","61323277","61323562","chr8","61123925","61124213","13","199352"
"chr8","61325446","61325661","chr8","61126120","61126335","20","199326"
"chr8","61387229","61387530","chr8","61174461","61174753","30","212768"
"chr8","61405482","61405584","chr8","61194040","61194152","16","211442"
"chr8","61441648","61441955","chr8","61231004","61231304","23","210644"
"chr8","61446418","61446528","chr8","61235792","61235912","23","210626"
"chr8","61475138","61475432","chr8","61264179","61264454","35","210959"
"chr8","61709813","61710135","chr8","61511536","61511844","57","198277"
"chr8","61761400","61761709","chr8","61565390","61565694","30","196010"
"chr8","61785522","61785794","chr8","61590860","61591136","26","194662"
"chr8","62251361","62251660","chr8","62092849","62093144","47","158512"
"chr8","62406566","62406827","chr8","62251783","62252031","31","154783"
"chr8","62551809","62552107","chr8","62388949","62389246","22","162860"
"chr8","62623399","62623721","chr8","62464537","62464857","20","158862"
"chr8","62671715","62672027","chr8","62512054","62512339","47","159661"
"chr8","62675094","62675390","chr8","62515786","62516083","15","159308"
"chr8","62711425","62711729","chr8","62618440","62618744","52","92985"
"chr8","62718173","62718363","chr8","62624552","62624753","29","93621"
"chr8","62749292","62749574","chr6","176142939","176143213","67","113393647"
"chr8","62762192","62762509","chr10","84049729","84050040","66","21287537"
"chr8","62829914","62830171","chr8","62744832","62745074","34","85082"
"chr8","62871902","62872124","chr8","62785538","62785762","16","86364"
"chr8","62941418","62941702","chr8","62853344","62853663","51","88074"
"chr8","62944857","62944999","chr8","62856829","62856971","11","88028"
"chr8","63009764","63009934","chr8","62922687","62922856","7","87077"
"chr8","63108785","63108905","chr8","63022465","63022586","10","86320"
"chr8","63116628","63116915","chr8","63030217","63030533","49","86411"
"chr8","63223375","63223672","chr8","63123801","63124074","51","99574"
"chr8","63248597","63248878","chr8","63158244","63158544","42","90353"
"chr8","63312421","63312550","chr8","63229864","63229993","10","82557"
"chr8","63388439","63388650","chr8","63298248","63298461","12","90191"
"chr8","63507131","63507414","chr8","63416950","63417234","18","90181"
"chr8","63516118","63516409","chr8","63425614","63425914","31","90504"
"chr8","63554106","63554423","chr8","63463725","63464010","45","90381"
"chr8","63582556","63582861","chr8","63491713","63492006","27","90843"
"chr8","63584798","63585085","chr8","63493401","63493706","46","91397"
"chr8","63596343","63596624","chr8","63504773","63505048","19","91570"
"chr8","63606084","63606381","chr8","63514673","63514970","19","91411"
"chr8","63684162","63684467","chr8","63588683","63588978","29","95479"
"chr8","63704439","63704699","chr8","63608607","63608870","15","95832"
"chr8","63725904","63726201","chr7","140100928","140101221","61","76375024"
"chr8","63738213","63738434","chr8","63642578","63642798","33","95635"
"chr8","63753702","63754009","chr8","63658885","63659194","33","94817"
"chr8","63785135","63785412","chr8","63686108","63686419","64","99027"
"chr8","63792664","63792958","chr8","63694450","63694746","20","98214"
"chr8","63821536","63821838","chr8","63725032","63725335","15","96504"
"chr8","63830234","63830537","chr20","28651476","28651780","54","35178758"
"chr8","63862878","63863184","chr8","63766496","63766803","20","96382"
"chr8","63887677","63887959","chr8","63797086","63797363","21","90591"
"chr8","63922439","63922564","chr20","54797040","54797166","20","9125399"
"chr8","63922861","63922885","chr5","2631756","2631777","7","61291105"
"chr8","63923201","63923338","chr16","69183048","69183183","34","5259847"
"chr8","63939710","63939968","chr8","63856649","63856906","13","83061"
"chr8","63943623","63943908","chr8","63860568","63860840","30","83055"
"chr8","64025944","64026238","chr8","63943080","63943369","24","82864"
"chr8","64039369","64039626","chr8","63957569","63957827","16","81800"
"chr8","64095573","64095749","chr9","60473538","60473710","33","3622035"
"chr8","64105528","64105840","chr8","64032230","64032541","15","73298"
"chr8","64106404","64106692","chr8","64033104","64033393","28","73300"
"chr8","64166312","64166428","chr8","64100503","64100619","7","65809"
"chr8","64209336","64209639","chr8","64139963","64140264","17","69373"
"chr8","64218879","64219046","chr8","64149377","64149544","12","69502"
"chr8","64259103","64259399","chr8","64190527","64190822","32","68576"
"chr8","64268832","64269183","chr8","64200488","64200834","27","68344"
"chr8","64316056","64316087","chr1","191184112","191184142","7","126868056"
"chr8","64316114","64316398","chr8","64247160","64247442","27","68954"
"chr8","64317788","64318047","chr8","64248810","64249060","24","68978"
"chr8","64329621","64329893","chr8","64260914","64261181","21","68707"
"chr8","64374275","64374569","chr8","64305904","64306201","23","68371"
"chr8","64422565","64422823","chr1","44248959","44249223","51","20173606"
"chr8","64461918","64462202","chr8","64391769","64392054","18","70149"
"chr8","64520102","64520224","chr8","64448008","64448127","16","72094"
"chr8","64556258","64556563","chr8","64484212","64484516","22","72046"
"chr8","64596370","64596589","chr8","64523347","64523585","30","73023"
"chr8","64622112","64622408","chr8","64549431","64549736","30","72681"
"chr8","64627093","64627421","chr8","64554752","64555092","34","72341"
"chr8","64635474","64635740","chr8","64563285","64563558","32","72189"
"chr8","64645182","64645481","chr8","64572946","64573253","33","72236"
"chr8","64688732","64688991","chr3","126894386","126894661","61","62205654"
"chr8","64691896","64692171","chr8","64618354","64618630","19","73542"
"chr8","64696850","64697164","chr8","64622656","64622983","37","74194"
"chr8","64699092","64699274","chr8","64624893","64625071","19","74199"
"chr8","64699327","64699442","chr8","64625116","64625231","14","74211"
"chr8","64715386","64715663","chr8","64649219","64649504","34","66167"
"chr8","64755151","64755453","chr3","39007741","39008023","77","25747410"
"chr8","64758870","64759119","chr8","64690238","64690490","22","68632"
"chr8","64766815","64766913","chr7","37481324","37481413","22","27285491"
"chr8","64793615","64793749","chr15","109869590","109869722","17","45075975"
"chr8","64834101","64834333","chr8","64769026","64769278","32","65075"
"chr8","64835240","64835502","chr8","64770170","64770428","18","65070"
"chr8","64844909","64845219","chr8","64782118","64782401","42","62791"
"chr8","64849161","64849316","chr13","75696174","75696326","40","10847013"
"chr8","64863886","64864181","chr8","64801454","64801726","35","62432"
"chr8","64882768","64883068","chr8","64820316","64820616","16","62452"
"chr8","64900228","64900504","chr1","24418526","24418808","57","40481702"
"chr8","64934900","64935075","chr8","64873215","64873371","24","61685"
"chr8","64936907","64937179","chr8","64875224","64875491","19","61683"
"chr8","64949755","64950060","chr8","64888916","64889220","17","60839"
"chr8","64953961","64954247","chr8","64893388","64893681","27","60573"
"chr8","64954957","64955168","chr8","64894388","64894610","18","60569"
"chr8","64970863","64971140","chr8","64905067","64905344","17","65796"
"chr8","64979768","64980057","chr8","64914871","64915160","21","64897"
"chr8","64991285","64991596","chr9","115478933","115479238","69","50487648"
"chr8","65005735","65006028","chr1","135785522","135785813","55","70779787"
"chr8","65012651","65012919","chr8","64949176","64949444","20","63475"
"chr8","65018881","65019164","chr3","155113746","155114031","58","90094865"
"chr8","65028362","65028674","chr8","64965597","64965910","20","62765"
"chr8","65039055","65039338","chr8","64976816","64977113","39","62239"
"chr8","65070260","65070579","chr8","65010324","65010638","34","59936"
"chr8","65074065","65074350","chr8","65014160","65014450","23","59905"
"chr8","65084181","65084487","chr8","65024607","65024919","27","59574"
"chr8","65093414","65093711","chr8","65033963","65034260","20","59451"
"chr8","65098553","65098676","chr1","140201164","140201287","18","75102611"
"chr8","65100707","65100978","chr8","65041282","65041552","18","59425"
"chr8","65132812","65133101","chr8","65075898","65076199","49","56914"
"chr8","65136400","65136495","chr8","65078759","65078854","2","57641"
"chr8","65137911","65138180","chr8","65080289","65080553","29","57622"
"chr8","65149020","65149326","chr8","65091296","65091594","31","57724"
"chr8","65164984","65165164","chr8","65099310","65099495","10","65674"
"chr8","65171239","65171410","chr2","88726812","88726967","40","23555573"
"chr8","65172778","65173070","chr8","65107291","65107580","27","65487"
"chr8","65183458","65183581","chr8","65117580","65117703","4","65878"
"chr8","65188479","65188737","chr2","80177389","80177649","68","14988910"
"chr8","65203226","65203522","chr4","54238484","54238781","66","10964742"
"chr8","65211991","65212319","chr20","23379716","23380010","90","41832275"
"chr8","65218701","65218792","chr16","51119244","51119331","18","14099457"
"chr8","65218828","65218985","chr9","70048932","70049079","38","4830104"
"chr8","65229552","65229648","chr20","56950492","56950574","35","8279060"
"chr8","65229649","65229917","chr8","65166297","65166588","39","63352"
"chr8","65229918","65230084","chrX","19212518","19212664","38","46017400"
"chr8","65260867","65261053","chr8","65197426","65197612","7","63441"
"chr8","65265834","65265942","chr12","120652336","120652442","22","55386502"
"chr8","65276988","65277336","chr8","65214845","65215191","27","62143"
"chr8","65326863","65327146","chr8","65265210","65265493","8","61653"
"chr8","65327560","65327868","chr8","65265899","65266205","30","61661"
"chr8","65328485","65328646","chrX","128665735","128665894","25","63337250"
"chr8","65328654","65328942","chr8","65266980","65267266","16","61674"
"chr8","65335113","65335404","chr15","8920430","8920718","61","56414683"
"chr8","65350535","65350830","chr8","65287406","65287686","41","63129"
"chr8","65376439","65376581","chr16","25658356","25658508","31","39718083"
"chr8","65376880","65377014","chr1","128086244","128086378","27","62709364"
"chr8","65385770","65386074","chr8","65319966","65320270","16","65804"
"chr8","65391899","65392181","chr8","65326327","65326595","41","65572"
"chr8","65401615","65401914","chr8","65336184","65336467","35","65431"
"chr8","65406706","65407009","chr8","65341264","65341567","29","65442"
"chr8","65427571","65427845","chr4","103236724","103237002","76","37809153"
"chr8","65439998","65440267","chr20","26445288","26445555","81","38994710"
"chr8","65483349","65483474","chr8","65421005","65421129","9","62344"
"chr8","65489613","65489918","chr8","65427255","65427565","28","62358"
"chr8","65501018","65501323","chr8","65438607","65438944","43","62411"
"chr8","65502172","65502472","chr8","65439788","65440093","18","62384"
"chr8","65515278","65515359","chr8","65452904","65452985","6","62374"
"chr8","65520877","65521167","chr8","65458166","65458462","24","62711"
"chr8","65524582","65524886","chr8","65463128","65463434","17","61454"
"chr8","65547690","65547913","chr8","65487399","65487639","36","60291"
"chr8","65564579","65564883","chr8","65505440","65505753","19","59139"
"chr8","65594721","65595037","chr8","65532818","65533138","20","61903"
"chr8","65619190","65619481","chr8","65556304","65556596","29","62886"
"chr8","65632658","65632941","chr8","65570025","65570311","18","62633"
"chr8","65657396","65657682","chr8","65595399","65595698","33","61997"
"chr8","65744393","65744685","chr8","65690088","65690373","27","54305"
"chr8","65830346","65830464","chr11","19818584","19818699","20","46011762"
"chr8","65830502","65830670","chr4","160825138","160825301","35","94994636"
"chr8","65881450","65881729","chr1","212846655","212846936","67","146965205"
"chr8","65884749","65884905","chr2","96846068","96846219","38","30961319"
"chr8","65884942","65885090","chr20","58662828","58662975","25","7222114"
"chr8","65888886","65889106","chr8","65852343","65852557","24","36543"
"chr8","65915271","65915484","chr5","152953935","152954134","74","87038664"
"chr8","65993564","65993822","chr8","65953942","65954198","12","39622"
"chr8","66002406","66002711","chr8","65962798","65963099","25","39608"
"chr8","66019610","66019910","chr9","63436171","63436463","58","2583439"
"chr8","66054439","66054746","chr8","66011901","66012202","25","42538"
"chr8","66131163","66131458","chr16","68450975","68451269","63","2319812"
"chr8","66180276","66180548","chr15","26284944","26285224","53","39895332"
"chr8","66196614","66196917","chr8","66150629","66150937","33","45985"
"chr8","66214721","66215015","chr8","66169105","66169399","23","45616"
"chr8","66238111","66238419","chr8","66192400","66192706","29","45711"
"chr8","66328137","66328456","chr8","66284316","66284602","53","43821"
"chr8","66354211","66354494","chr8","66309305","66309589","20","44906"
"chr8","66364561","66364813","chr9","36221090","36221345","61","30143471"
"chr8","66375151","66375439","chr10","13786018","13786298","63","52589133"
"chr8","66411625","66411920","chrX","127495164","127495450","56","61083539"
"chr8","66421521","66421828","chr2","107411533","107411833","60","40990012"
"chr8","66425851","66425989","chr8","66384015","66384154","7","41836"
"chr8","66426293","66426468","chr8","66384460","66384638","22","41833"
"chr8","66460420","66460704","chr8","66416548","66416831","22","43872"
"chr8","66515742","66516045","chr14","57869118","57869420","56","8646624"
"chr8","66526200","66526480","chr8","66480837","66481117","20","45363"
"chr8","66591770","66591944","chr19","8026553","8026714","38","58565217"
"chr8","66686046","66686343","chr8","66681507","66681811","38","4539"
"chr8","66734692","66734993","chr8","66740270","66740581","30","5578"
"chr8","66801243","66801527","chr8","66807574","66807873","35","6331"
"chr8","66917187","66917482","chr8","66926123","66926424","35","8936"
"chr8","66970731","66971002","chr8","66973566","66973838","23","2835"
"chr8","67077243","67077400","chr8","67081881","67082038","12","4638"
"chr8","67117132","67117292","chr16","74403178","74403342","33","7286046"
"chr8","67119683","67119971","chr8","67123450","67123741","22","3767"
"chr8","67191732","67192034","chr8","67191717","67192008","52","15"
"chr8","67206754","67207020","chr8","67213945","67214212","16","7191"
"chr8","67211253","67211572","chr8","67218432","67218777","54","7179"
"chr8","67241213","67241421","chr8","67244282","67244495","20","3069"
"chr8","67263365","67263673","chrX","46805715","46806015","65","20457650"
"chr8","67349825","67350112","chr3","124634402","124634686","52","57284577"
"chr8","67366528","67366651","chr8","67362099","67362219","7","4429"
"chr8","67474187","67474491","chr8","67468649","67468958","30","5538"
"chr8","67491790","67492000","chr16","1437430","1437644","38","66054360"
"chr8","67575578","67575797","chr9","110759626","110759823","72","43184048"
"chr8","67598083","67598349","chr16","31823360","31823644","69","35774723"
"chr8","67615808","67615948","chr9","28783871","28783993","35","38831937"
"chr8","67616334","67616426","chr6","175600238","175600324","26","107983904"
"chr8","67653332","67653617","chr8","67639182","67639471","19","14150"
"chr8","67658333","67658623","chr8","67644191","67644488","27","14142"
"chr8","67675689","67675873","chr8","67662967","67663150","13","12722"
"chr8","67678680","67678922","chr13","24068530","24068785","69","43610150"
"chr8","67680731","67681026","chr3","126975901","126976192","53","59295170"
"chr8","67707389","67707700","chr8","31021948","31022249","68","36685441"
"chr8","67815760","67816052","chr8","22350458","22350753","57","45465302"
"chr8","67821637","67821936","chr8","67807794","67808084","31","13843"
"chr8","67833523","67833639","chr1","52434936","52435052","9","15398587"
"chr8","67840870","67841153","chr8","67819311","67819569","32","21559"
"chr8","67887622","67887891","chr1","14264801","14265072","61","53622821"
"chr8","67891859","67891985","chr8","67867190","67867316","9","24669"
"chr8","67911006","67911311","chr7","131691373","131691686","58","63780367"
"chr8","67959263","67959537","chr8","67934564","67934848","26","24699"
"chr8","67963267","67963560","chrX","13287297","13287589","56","54675970"
"chr8","67969159","67969455","chr8","67944655","67944928","54","24504"
"chr8","67983016","67983303","chr8","67957985","67958272","15","25031"
"chr8","67988887","67989202","chr8","67962953","67963271","29","25934"
"chr8","67990386","67990636","chr8","67964423","67964670","31","25963"
"chr8","68007289","68007412","chr9","82847515","82847637","20","14840226"
"chr8","68008278","68008582","chr8","67982248","67982586","58","26030"
"chr8","68036283","68036569","chr8","68000458","68000743","18","35825"
"chr8","68061894","68062185","chr8","68025108","68025400","17","36786"
"chr8","68064290","68064581","chr8","68027489","68027782","23","36801"
"chr8","68082801","68083106","chr7","165716105","165716404","54","97633304"
"chr8","68088129","68088428","chr12","89412367","89412671","68","21324238"
"chr8","68098999","68099220","chr8","68081543","68081766","19","17456"
"chr8","68117309","68117627","chr8","68100722","68101058","44","16587"
"chr8","68134620","68134732","chr8","68117834","68117946","8","16786"
"chr8","68147510","68147711","chr8","68131899","68132122","38","15611"
"chr8","68155692","68156006","chr8","68144386","68144700","17","11306"
"chr8","68161539","68161648","chr8","68148698","68148811","10","12841"
"chr8","68196513","68196801","chr9","57720841","57721119","57","10475672"
"chr8","68203433","68203626","chr7","150438122","150438297","62","82234689"
"chr8","68208156","68208433","chr8","68195446","68195725","18","12710"
"chr8","68208451","68208737","chr1","219005311","219005599","47","150796860"
"chr8","68210026","68210334","chr8","68197631","68197941","24","12395"
"chr8","68244271","68244566","chr10","86775507","86775805","61","18531236"
"chr8","68248731","68249021","chr15","49988046","49988333","62","18260685"
"chr8","68255284","68255587","chr8","68251927","68252230","26","3357"
"chr8","68263104","68263398","chr8","68259733","68260028","24","3371"
"chr8","68305690","68305979","chr8","68303474","68303762","22","2216"
"chr8","68308693","68308976","chr8","68306492","68306775","20","2201"
"chr8","68329035","68329340","chr8","68328324","68328634","45","711"
"chr8","68332603","68332911","chr8","68331928","68332221","39","675"
"chr8","68337787","68338070","chr8","68337058","68337341","10","729"
"chr8","68355100","68355262","chr8","68354651","68354811","10","449"
"chr8","68355550","68355688","chr8","68355106","68355240","9","444"
"chr8","68381528","68381795","chr8","68381714","68381965","33","186"
"chr8","68384462","68384752","chr6","176458169","176458462","60","108073707"
"chr8","68447610","68447868","chr8","68444610","68444868","17","3000"
"chr8","68480640","68480919","chr8","68477821","68478100","22","2819"
"chr8","68490918","68491237","chr8","68485220","68485559","43","5698"
"chr8","68510432","68510703","chr1","110793495","110793757","62","42283063"
"chr8","68515027","68515195","chr2","61281692","61281857","33","7233335"
"chr8","68515196","68515482","chr3","42107648","42107937","61","26407548"
"chr8","68515483","68515612","chr3","125502119","125502238","29","56986636"
"chr8","68516353","68516661","chr8","68511156","68511434","65","5197"
"chr8","68537840","68538134","chr8","68585977","68586265","38","48137"
"chr8","68556052","68556327","chr8","68604213","68604475","39","48161"
"chr8","68560653","68560949","chr8","68608871","68609167","37","48218"
"chr8","68564294","68564411","chr8","68612497","68612614","7","48203"
"chr8","68571548","68571842","chr8","68619973","68620265","20","48425"
"chr8","68576583","68576885","chr8","68625027","68625323","21","48444"
"chr8","68594864","68594962","chr10","29571273","29571370","12","39023591"
"chr8","68607436","68607731","chr3","127162429","127162726","60","58554993"
"chr8","68608567","68608868","chr1","44053866","44054177","67","24554701"
"chr8","68618560","68618863","chr8","68669473","68669785","28","50913"
"chr8","68628541","68628832","chr8","68677341","68677632","18","48800"
"chr8","68629025","68629304","chr8","68677824","68678104","24","48799"
"chr8","68634251","68634554","chr8","68683001","68683342","54","48750"
"chr8","68656055","68656182","chr8","68700113","68700239","15","44058"
"chr8","68659289","68659598","chr8","68703271","68703580","31","43982"
"chr8","68667673","68667961","chr8","68710606","68710894","13","42933"
"chr8","68673735","68674038","chr15","34234250","34234544","54","34439485"
"chr8","68679694","68679983","chr8","68721518","68721813","25","41824"
"chr8","68681082","68681369","chr8","68722913","68723200","14","41831"
"chr8","68683831","68684044","chr8","68725535","68725748","13","41704"
"chr8","68691040","68691203","chr8","68732678","68732841","8","41638"
"chr8","68711252","68711538","chr8","68752214","68752499","25","40962"
"chr8","68712547","68712822","chr8","68753530","68753800","31","40983"
"chr8","68716272","68716581","chr8","68757266","68757572","23","40994"
"chr8","68747726","68748009","chr1","25400931","25401212","56","43346795"
"chr8","68748581","68748868","chr8","68789590","68789874","18","41009"
"chr8","68757017","68757111","chr8","68797957","68798051","9","40940"
"chr8","68761041","68761197","chr8","68801971","68802126","17","40930"
"chr8","68773507","68773798","chr8","68812108","68812384","29","38601"
"chr8","68773876","68774183","chr4","31751916","31752223","57","37021960"
"chr8","68784500","68784774","chr8","68823213","68823466","38","38713"
"chr8","68791716","68792014","chr8","68830802","68831110","50","39086"
"chr8","68810291","68810406","chr8","68849391","68849506","5","39100"
"chr8","68825761","68826047","chr8","68869497","68869783","25","43736"
"chr8","68829675","68829791","chr8","68873362","68873478","5","43687"
"chr8","68830225","68830532","chr8","68873903","68874209","29","43678"
"chr8","68830904","68831077","chr8","68874553","68874733","21","43649"
"chr8","68870470","68870634","chr20","70562054","70562216","33","1691584"
"chr8","68871968","68872201","chr20","41332824","41333057","45","27539144"
"chr8","68959635","68959930","chr8","68993671","68993963","40","34036"
"chr8","69051204","69051485","chr17","10980668","10980942","62","58070536"
"chr8","69118310","69118589","chr8","69174482","69174760","21","56172"
"chr8","69217438","69217756","chr2","159477557","159477868","72","90260119"
"chr8","69263108","69263388","chr7","96863166","96863444","60","27600058"
"chr8","69467146","69467474","chr8","69533332","69533632","53","66186"
"chr8","69579768","69579990","chr8","69647446","69647704","59","67678"
"chr8","69705625","69705915","chr8","69765131","69765418","21","59506"
"chr8","69818923","69819208","chr1","361871","362138","71","69457052"
"chr8","69823527","69823776","chr8","69880892","69881143","23","57365"
"chr8","69842701","69843007","chr8","69900053","69900364","27","57352"
"chr8","69883227","69883497","chr5","25258187","25258455","54","44625040"
"chr8","69909039","69909320","chr8","69955530","69955810","24","46491"
"chr8","69970211","69970504","chr17","11251715","11252011","60","58718496"
"chr8","70010478","70010780","chr8","70107906","70108204","27","97428"
"chr8","70033518","70033802","chr5","165714831","165715111","70","95681313"
"chr8","70039853","70040144","chr8","70137087","70137378","8","97234"
"chr8","70148787","70149074","chr8","70254305","70254593","14","105518"
"chr8","70170187","70170302","chr8","70277129","70277243","5","106942"
"chr8","70199624","70199936","chr8","70490039","70490339","62","290415"
"chr8","70204615","70204926","chr8","70314901","70315209","21","110286"
"chr8","70295947","70296088","chr8","70406871","70407029","26","110924"
"chr8","70302716","70303012","chr8","70412600","70412892","32","109884"
"chr8","70320515","70320742","chr8","70431889","70432112","19","111374"
"chr8","70324779","70325076","chr8","70438674","70438973","18","113895"
"chr8","70344048","70344261","chr8","70452838","70453056","29","108790"
"chr8","70348554","70348851","chr8","70457667","70457951","41","109113"
"chr8","70486774","70487042","chr5","182213314","182213559","73","111726540"
"chr8","70533167","70533446","chr7","19471164","19471448","39","51062003"
"chr8","70573107","70573404","chr8","70614393","70614690","28","41286"
"chr8","70574598","70574856","chr8","70615772","70616019","33","41174"
"chr8","70632464","70632761","chr11","68187166","68187478","64","2445298"
"chr8","70685515","70685775","chr8","70723511","70723772","22","37996"
"chr8","70735438","70735650","chr8","70766351","70766561","12","30913"
"chr8","70779660","70779969","chr8","70816790","70817087","67","37130"
"chr8","70822920","70823216","chr8","70857002","70857316","47","34082"
"chr8","70839319","70839526","chr7","20198891","20199096","43","50640428"
"chr8","70873541","70873832","chrX","109482319","109482606","57","38608778"
"chr8","70978079","70978287","chr8","71019662","71019876","33","41583"
"chr8","70982143","70982427","chr8","71023728","71024027","31","41585"
"chr8","71131993","71132125","chr8","71179092","71179225","3","47099"
"chr8","71152665","71152782","chr8","71203382","71203499","9","50717"
"chr8","71173005","71173301","chr8","71223848","71224135","45","50843"
"chr8","71176681","71176955","chr8","71227525","71227802","38","50844"
"chr8","71200817","71201073","chr8","71256439","71256695","18","55622"
"chr8","71207043","71207331","chr8","71262597","71262885","22","55554"
"chr8","71222084","71222386","chr8","71276687","71276994","24","54603"
"chr8","71233501","71233600","chr8","71288647","71288745","4","55146"
"chr8","71251533","71251837","chr8","71306755","71307069","25","55222"
"chr8","71259028","71259154","chr1","211231687","211231814","27","139972659"
"chr8","71282293","71282592","chr8","71335080","71335354","37","52787"
"chr8","71291507","71291785","chr8","71344285","71344564","17","52778"
"chr8","71295828","71296118","chr8","71348652","71348949","26","52824"
"chr8","71364035","71364245","chr8","71417515","71417726","14","53480"
"chr8","71391906","71392204","chr20","28098206","28098509","68","43293700"
"chr8","71399929","71400214","chr8","71452774","71453051","22","52845"
"chr8","71448525","71448832","chr8","71507417","71507723","19","58892"
"chr8","71523834","71523963","chr8","71584649","71584777","8","60815"
"chr8","71533055","71533171","chr8","71594199","71594315","8","61144"
"chr8","71537269","71537532","chr8","71598495","71598763","15","61226"
"chr8","71555309","71555434","chr8","71617230","71617348","10","61921"
"chr8","71559392","71559657","chr8","71621305","71621566","20","61913"
"chr8","71565883","71566171","chr8","71627579","71627866","24","61696"
"chr8","71580544","71580693","chr16","5299652","5299807","28","66280892"
"chr8","71614620","71614922","chr8","71675935","71676234","29","61315"
"chr8","71628732","71629023","chr8","71689849","71690123","28","61117"
"chr8","71655698","71655994","chr8","71715166","71715483","39","59468"
"chr8","71670558","71670843","chr8","71730464","71730742","31","59906"
"chr8","71671655","71671943","chr5","8246617","8246904","51","63425038"
"chr8","71702097","71702386","chr8","71762568","71762854","24","60471"
"chr8","71718602","71718718","chr8","30167669","30167784","25","41550933"
"chr8","71747171","71747425","chr8","71809189","71809448","14","62018"
"chr8","71753312","71753611","chr8","71815243","71815554","35","61931"
"chr8","71782027","71782301","chr8","71849870","71850158","48","67843"
"chr8","71787883","71788194","chr8","71855073","71855392","28","67190"
"chr8","71813245","71813531","chr8","71880193","71880496","45","66948"
"chr8","71816235","71816566","chr8","71883221","71883551","25","66986"
"chr8","71829430","71829587","chr7","44865346","44865512","32","26964084"
"chr8","71832709","71833011","chr8","71899958","71900250","36","67249"
"chr8","71833934","71834208","chr8","71901163","71901444","23","67229"
"chr8","71839110","71839397","chr8","71906992","71907282","24","67882"
"chr8","71895074","71895353","chr8","71965562","71965846","22","70488"
"chr8","71903045","71903344","chr8","71973909","71974223","29","70864"
"chr8","71932143","71932258","chr1","186576054","186576167","20","114643911"
"chr8","71933663","71933958","chr8","72004542","72004835","23","70879"
"chr8","71935305","71935623","chr8","72006192","72006482","54","70887"
"chr8","71935639","71935794","chr8","72006520","72006682","13","70881"
"chr8","71941477","71941764","chr8","72013232","72013520","21","71755"
"chr8","71963490","71963608","chr8","72036305","72036423","8","72815"
"chr8","71997054","71997356","chr8","72065069","72065381","41","68015"
"chr8","72002757","72002899","chr8","72071789","72071930","7","69032"
"chr8","72009478","72009779","chr1","212890378","212890672","58","140880900"
"chr8","72012432","72012714","chr8","72080674","72080957","20","68242"
"chr8","72013473","72013777","chr8","72081696","72081996","37","68223"
"chr8","72019551","72019654","chr3","40165859","40165963","27","31853692"
"chr8","72030779","72031084","chrX","17672800","17673101","67","54357979"
"chr8","72035697","72035936","chr8","72094780","72094969","61","59083"
"chr8","72043752","72043875","chr8","72102296","72102416","12","58544"
"chr8","72050565","72050683","chr8","72108820","72108939","13","58255"
"chr8","72053293","72053476","chr13","37283867","37284043","35","34769426"
"chr8","72056191","72056449","chr2","203613478","203613733","64","131557287"
"chr8","72066053","72066339","chr8","72127661","72127952","28","61608"
"chr8","72073397","72073682","chr8","72135045","72135320","42","61648"
"chr8","72078096","72078409","chr1","39092983","39093291","63","32985113"
"chr8","72081186","72081498","chr7","156977987","156978291","58","84896801"
"chr8","72098218","72098422","chr8","72161841","72162043","13","63623"
"chr8","72130870","72131129","chr8","93186171","93186432","67","21055301"
"chr8","72153476","72153767","chr8","72220758","72221060","38","67282"
"chr8","72153971","72154285","chr8","72221265","72221581","21","67294"
"chr8","72158337","72158505","chr8","72225632","72225794","18","67295"
"chr8","72165997","72166278","chr8","72233242","72233541","26","67245"
"chr8","72172263","72172482","chr1","16316885","16317107","37","55855378"
"chr8","72173103","72173390","chr8","72240457","72240736","27","67354"
"chr8","72177521","72177832","chr8","72244479","72244763","39","66958"
"chr8","72178534","72178651","chr8","72245817","72245934","4","67283"
"chr8","72215656","72215949","chr8","72283425","72283717","19","67769"
"chr8","72216865","72216994","chr11","56141490","56141619","24","16075375"
"chr8","72232278","72232576","chr8","72299255","72299545","26","66977"
"chr8","72245391","72245652","chr8","72314933","72315207","25","69542"
"chr8","72253468","72253783","chr3","71524571","71524880","64","728897"
"chr8","72256032","72256334","chr8","72325811","72326117","24","69779"
"chr8","72299928","72300240","chr8","72370343","72370649","33","70415"
"chr8","72300580","72300590","chr6","82780716","82780726","1","10480136"
"chr8","72300639","72300944","chr20","11370789","11371088","74","60929850"
"chr8","72315316","72315340","chr8","72387315","72387339","3","71999"
"chr8","72315778","72315881","chr8","72387775","72387878","7","71997"
"chr8","72319406","72319525","chr8","72391371","72391497","18","71965"
"chr8","72319560","72319750","chr8","72391529","72391709","20","71969"
"chr8","72343520","72343792","chr1","13605985","13606264","62","58737535"
"chr8","72356801","72357051","chr8","72428321","72428582","26","71520"
"chr8","72366828","72367126","chr7","91923437","91923736","71","19556609"
"chr8","72399430","72399542","chr10","73913634","73913741","32","1514204"
"chr8","72417746","72418036","chr7","140588016","140588306","54","68170270"
"chr8","72490023","72490130","chr8","72554786","72554904","17","64763"
"chr8","72585227","72585338","chr8","72641116","72641227","5","55889"
"chr8","72585787","72585800","chr8","72641672","72641685","1","55885"
"chr8","72605969","72606085","chr8","72662472","72662588","8","56503"
"chr8","72616526","72616810","chr8","72672948","72673231","15","56422"
"chr8","72709465","72709754","chr13","47263576","47263856","63","25445889"
"chr8","72762658","72762940","chr8","72810099","72810372","21","47441"
"chr8","72803287","72803584","chr8","72841908","72842180","39","38621"
"chr8","72837598","72837879","chr8","72884840","72885124","24","47242"
"chr8","72923070","72923357","chr8","72965140","72965440","38","42070"
"chr8","72961339","72961629","chr8","45074900","45075192","46","27886439"
"chr8","73130940","73131212","chr3","42244052","42244335","64","30886888"
"chr8","73172928","73173221","chr2","160551205","160551504","48","87378277"
"chr8","73183834","73184145","chr3","43652365","43652670","75","29531469"
"chr8","73353348","73353648","chr8","73375572","73375854","38","22224"
"chr8","73371092","73371323","chr8","73390731","73391006","63","19639"
"chr8","73371355","73371478","chr18","30782581","30782704","26","42588774"
"chr8","73396266","73396546","chr8","73412675","73412955","33","16409"
"chr8","73422126","73422410","chr8","73437556","73437839","15","15430"
"chr8","73479846","73479941","chr8","73511229","73511324","5","31383"
"chr8","73514073","73514344","chr8","73546559","73546862","54","32486"
"chr8","73547357","73547640","chr8","73582059","73582344","19","34702"
"chr8","73549069","73549353","chr8","73583753","73584037","20","34684"
"chr8","73561849","73562144","chr8","73602689","73602976","29","40840"
"chr8","73614304","73614605","chr8","73658099","73658413","41","43795"
"chr8","73617940","73618199","chr6","155858026","155858290","48","82240086"
"chr8","73622022","73622237","chr8","73666585","73666776","32","44563"
"chr8","73633473","73633792","chr8","73676198","73676503","54","42725"
"chr8","73677830","73678112","chr8","73728671","73728961","38","50841"
"chr8","73718673","73718962","chr8","73772867","73773157","17","54194"
"chr8","73879680","73879943","chr3","116551021","116551273","69","42671341"
"chr8","73944927","73945148","chr8","73998817","73999042","16","53890"
"chr8","73956030","73956312","chr8","74009960","74010255","50","53930"
"chr8","73957336","73957448","chr8","74011284","74011396","6","53948"
"chr8","73969099","73969351","chr8","74023362","74023612","26","54263"
"chr8","73976140","73976444","chr8","74030296","74030606","20","54156"
"chr8","74283044","74283346","chr11","1678142","1678449","68","72604902"
"chr8","74327530","74327850","chr8","74418335","74418651","28","90805"
"chr8","74479246","74479518","chr8","74560004","74560288","31","80758"
"chr8","74544987","74545267","chr11","131260074","131260355","69","56715087"
"chr8","74552815","74553105","chr8","74624619","74624909","34","71804"
"chr8","74587487","74587696","chr3","126129363","126129565","51","51541876"
"chr8","74727475","74727776","chr2","160551205","160551504","51","85823730"
"chr8","74781427","74781726","chr8","74847740","74848039","24","66313"
"chr8","74801804","74802098","chr8","74868527","74868793","43","66723"
"chr8","74909177","74909483","chr10","66723137","66723445","62","8186040"
"chr8","74911506","74911759","chr8","74981209","74981462","16","69703"
"chr8","74916666","74916960","chr8","74986336","74986656","44","69670"
"chr8","74923670","74923970","chr8","74993700","74994009","37","70030"
"chr8","74934497","74934787","chr8","75004654","75004915","58","70157"
"chr8","74985405","74985698","chr7","31738462","31738759","68","43246943"
"chr8","75035294","75035528","chr1","222943933","222944161","58","147908639"
"chr8","75082510","75082808","chr8","75155292","75155589","28","72782"
"chr8","75093277","75093463","chr2","162936434","162936601","53","87843157"
"chr8","75127824","75128033","chrX","48222572","48222783","52","26905252"
"chr8","75130202","75130331","chrX","14085322","14085451","23","61044880"
"chr8","75144189","75144489","chr8","75217394","75217688","26","73205"
"chr8","75344099","75344304","chr8","75404410","75404606","20","60311"
"chr8","75456532","75456796","chr8","75522077","75522339","26","65545"
"chr8","75556000","75556309","chr14","63858277","63858583","61","11697723"
"chr8","75740558","75740870","chr8","75836171","75836482","24","95613"
"chr8","75797023","75797313","chr8","75890436","75890712","32","93413"
"chr8","75800032","75800320","chr8","75894014","75894297","25","93982"
"chr8","75810884","75811007","chr3","82978998","82979111","34","7168114"
"chr8","75849103","75849266","chr8","75944032","75944202","24","94929"
"chr8","75927641","75927941","chr1","111636595","111636896","79","35708954"
"chr8","76146930","76147229","chr8","76257847","76258174","61","110917"
"chr8","76159381","76159507","chr10","30386760","30386884","26","45772621"
"chr8","76405205","76405490","chr7","116343039","116343325","67","39937834"
"chr8","76460273","76460405","chr8","76567432","76567556","18","107159"
"chr8","76576186","76576344","chr19","13668412","13668569","26","62907774"
"chr8","76586228","76586521","chr8","76705518","76705812","27","119290"
"chr8","76645588","76645872","chr2","171827381","171827672","66","95181793"
"chr8","76689925","76690147","chr8","76799809","76800027","20","109884"
"chr8","76782198","76782450","chr17","6606969","6607227","65","70175229"
"chr8","76785235","76785555","chrX","66786613","66786930","80","9998622"
"chr8","76962295","76962584","chr8","77062115","77062427","51","99820"
"chr8","76990552","76990862","chr8","77088489","77088802","37","97937"
"chr8","76996591","76996909","chr2","87353905","87354218","70","10357314"
"chr8","77050256","77050521","chr8","77148676","77148954","38","98420"
"chr8","77138963","77139086","chr8","77233454","77233577","7","94491"
"chr8","77362739","77363018","chr5","50412784","50413060","22","26949955"
"chr8","77727201","77727513","chr8","77812702","77813011","26","85501"
"chr8","77815759","77816075","chr8","77907194","77907495","44","91435"
"chr8","77832470","77832774","chr8","77923835","77924137","40","91365"
"chr8","77855505","77855638","chr1","54133245","54133375","39","23722260"
"chr8","77855699","77855801","chr3","165339814","165339909","22","87484115"
"chr8","77912464","77912580","chr4","107585407","107585526","27","29672943"
"chr8","77945292","77945553","chr8","78040502","78040761","18","95210"
"chr8","77958031","77958332","chr8","78053264","78053572","31","95233"
"chr8","77965569","77965863","chr2","160551205","160551504","51","82585636"
"chr8","78008673","78008963","chr8","78102691","78102981","13","94018"
"chr8","78012449","78012748","chr8","78106473","78106777","30","94024"
"chr8","78026985","78027272","chr8","78119253","78119540","14","92268"
"chr8","78079813","78080102","chr8","78182575","78182871","31","102762"
"chr8","78087877","78088171","chr8","78190531","78190808","30","102654"
"chr8","78092840","78092939","chr8","78195568","78195660","15","102728"
"chr8","78111219","78111511","chr7","137856198","137856481","67","59744979"
"chr8","78127710","78127826","chr8","78231403","78231526","11","103693"
"chr8","78185387","78185648","chr8","78277921","78278182","16","92534"
"chr8","78216297","78216608","chr8","78310720","78311022","30","94423"
"chr8","78218760","78218818","chr5","73307081","73307136","9","4911679"
"chr8","78243381","78243631","chr8","78338343","78338582","26","94962"
"chr8","78264180","78264496","chr8","78358938","78359256","28","94758"
"chr8","78281574","78281855","chr8","78376299","78376585","24","94725"
"chr8","78312723","78313012","chr5","22397555","22397847","51","55915168"
"chr8","78326432","78326503","chr20","32201899","32201974","13","46124533"
"chr8","78344227","78344523","chr8","78441154","78441439","28","96927"
"chr8","78347297","78347562","chr8","78444535","78444800","16","97238"
"chr8","78367431","78367559","chrX","18362144","18362269","21","60005287"
"chr8","78376003","78376111","chr20","26105974","26106078","20","52270029"
"chr8","78381591","78381816","chr15","10211767","10211989","40","68169824"
"chr8","78385264","78385513","chr8","39011050","39011287","60","39374214"
"chr8","78392541","78392831","chr8","78489743","78490045","41","97202"
"chr8","78403156","78403457","chr8","78501405","78501706","33","98249"
"chr8","78412612","78412914","chr8","78511957","78512224","52","99345"
"chr8","78414733","78415042","chr8","78513790","78514060","59","99057"
"chr8","78418043","78418166","chrX","47078051","47078174","17","31339992"
"chr8","78418550","78418845","chr8","78516986","78517299","30","98436"
"chr8","78419615","78419785","chr19","35574608","35574755","48","42845007"
"chr8","78420367","78420508","chr11","2920867","2920996","33","75499500"
"chr8","78428170","78428344","chr7","17907213","17907381","35","60520957"
"chr8","78428636","78428691","chr8","78526395","78526450","1","97759"
"chr8","78436592","78436886","chr8","78533484","78533783","28","96892"
"chr8","78439552","78439665","chr8","78537163","78537289","23","97611"
"chr8","78440004","78440078","chr8","78537587","78537659","6","97583"
"chr8","78440079","78440135","chr14","33394929","33394986","19","45045150"
"chr8","78462423","78462695","chr8","78560456","78560741","37","98033"
"chr8","78477520","78477839","chr8","78577479","78577775","41","99959"
"chr8","78485783","78486081","chr1","135619994","135620289","65","57134211"
"chr8","78492845","78493146","chr8","78593166","78593450","34","100321"
"chr8","78499644","78499915","chr8","78599941","78600197","25","100297"
"chr8","78506137","78506426","chr2","134217641","134217927","56","55711504"
"chr8","78512679","78512893","chr8","78612689","78612903","18","100010"
"chr8","78531910","78532026","chr8","78631750","78631866","7","99840"
"chr8","78543682","78543882","chr19","7913658","7913840","54","70630024"
"chr8","78544187","78544321","chr17","54442955","54443088","20","24101232"
"chr8","78545674","78545804","chr8","78643117","78643247","8","97443"
"chr8","78556444","78556585","chr19","741417","741557","29","77815027"
"chr8","78556760","78556996","chr19","34786063","34786294","52","43770697"
"chr8","78561813","78562106","chr8","78660692","78660990","29","98879"
"chr8","78563323","78563609","chr3","123351694","123351976","52","44788371"
"chr8","78566079","78566192","chr8","78665232","78665344","12","99153"
"chr8","78567256","78567552","chr8","78666716","78667012","27","99460"
"chr8","78576585","78576869","chr8","78676048","78676340","23","99463"
"chr8","78587213","78587377","chr1","53482939","53483101","35","25104274"
"chr8","78591085","78591357","chr8","78690014","78690314","50","98929"
"chr8","78597190","78597337","chr8","78696813","78696961","17","99623"
"chr8","78599259","78599480","chr8","78699564","78699748","46","100305"
"chr8","78599982","78600115","chr8","78700245","78700378","13","100263"
"chr8","78600739","78600893","chr8","78700670","78700817","16","99931"
"chr8","78621469","78621775","chr4","15096791","15097094","66","63524678"
"chr8","78629471","78629644","chr15","50715278","50715460","36","27914193"
"chr8","78645464","78645559","chr4","15278126","15278223","24","63367338"
"chr8","78661831","78662004","chrX","113173870","113174044","43","34512039"
"chr8","78680881","78681180","chr8","78783847","78784147","16","102966"
"chr8","78698761","78698994","chr8","78801704","78801937","16","102943"
"chr8","78700474","78700778","chr8","78803926","78804219","46","103452"
"chr8","78712214","78712229","chr2","106903982","106903998","4","28191768"
"chr8","78712493","78712631","chr1","153250707","153250848","26","74538214"
"chr8","78746537","78746858","chr8","78850789","78851109","12","104252"
"chr8","78747723","78748024","chr8","78851964","78852265","25","104241"
"chr8","78750085","78750357","chr8","78854410","78854705","48","104325"
"chr8","78756671","78756846","chr8","78859760","78859934","15","103089"
"chr8","78757151","78757291","chr8","78860240","78860380","11","103089"
"chr8","78773415","78773698","chr8","78891450","78891747","48","118035"
"chr8","78812884","78813165","chr8","78924521","78924826","41","111637"
"chr8","78834872","78835197","chr8","78948579","78948907","12","113707"
"chr8","78836426","78836717","chr8","78950121","78950413","18","113695"
"chr8","78897674","78897795","chr8","79013054","79013174","5","115380"
"chr8","78908239","78908531","chr8","79023690","79023982","16","115451"
"chr8","78938050","78938355","chr8","79056941","79057248","16","118891"
"chr8","79004667","79004956","chr8","79130499","79130788","21","125832"
"chr8","79070006","79070207","chr8","79193141","79193339","18","123135"
"chr8","79070501","79070659","chr8","79193644","79193802","8","123143"
"chr8","79091974","79092157","chr4","32585514","32585697","50","46506460"
"chr8","79092196","79092295","chr9","69539296","69539397","18","9552900"
"chr8","79111797","79112056","chr8","79233759","79233991","41","121962"
"chr8","79136415","79136715","chr8","79259069","79259368","19","122654"
"chr8","79145183","79145456","chr8","79267942","79268200","29","122759"
"chr8","79157522","79157811","chr8","79280021","79280309","16","122499"
"chr8","79202936","79203147","chr8","79323141","79323336","30","120205"
"chr8","79206349","79206467","chr8","79324283","79324398","8","117934"
"chr8","79206491","79206784","chr8","79324425","79324735","35","117934"
"chr8","79220424","79220583","chr8","79338432","79338575","29","118008"
"chr8","79355462","79355579","chr8","79475960","79476077","12","120498"
"chr8","79390254","79390374","chr8","79510663","79510782","9","120409"
"chr8","79518856","79519075","chr8","79642623","79642846","17","123767"
"chr8","79555209","79555397","chr8","79680457","79680651","11","125248"
"chr8","79626133","79626420","chr8","79752272","79752560","18","126139"
"chr8","79663196","79663310","chr8","79791368","79791482","6","128172"
"chr8","79674263","79674570","chr8","79802365","79802651","39","128102"
"chr8","79765639","79765929","chr3","126975901","126976192","46","47210262"
"chr8","79784052","79784320","chr8","79919153","79919451","46","135101"
"chr8","79790173","79790290","chr9","8207384","8207502","18","71582789"
"chr8","79795379","79795693","chr8","79930569","79930867","44","135190"
"chr8","79799647","79799940","chr8","79934828","79935112","24","135181"
"chr8","79799989","79800235","chr8","79935170","79935419","20","135181"
"chr8","79823407","79823698","chr10","28218647","28218926","70","51604760"
"chr8","79883522","79883806","chr8","80006037","80006326","23","122515"
"chr8","79897673","79897971","chr8","80021021","80021313","22","123348"
"chr8","80040005","80040137","chr8","80158244","80158376","5","118239"
"chr8","80223534","80223818","chr8","11867538","11867827","68","68355996"
"chr8","80400105","80400379","chr8","80516562","80516850","32","116457"
"chr8","80581477","80581606","chr8","80697385","80697514","8","115908"
"chr8","80646934","80647206","chr8","80757816","80758090","21","110882"
"chr8","80663915","80664199","chr8","80773469","80773754","23","109554"
"chr8","80785671","80785948","chr1","191690399","191690678","73","110904728"
"chr8","80821177","80821472","chr8","80939840","80940145","35","118663"
"chr8","80825654","80825926","chr8","80944365","80944654","35","118711"
"chr8","80846512","80846771","chr8","80965928","80966191","26","119416"
"chr8","80874612","80874896","chr8","80994775","80995059","20","120163"
"chr8","80926465","80926547","chr8","81044986","81045070","14","118521"
"chr8","80936778","80937082","chr8","81052663","81052974","33","115885"
"chr8","80953334","80953443","chr8","81069622","81069733","11","116288"
"chr8","80966238","80966529","chr11","109186448","109186735","58","28220210"
"chr8","81100531","81100826","chr8","81229587","81229869","37","129056"
"chr8","81267389","81267604","chr8","81391398","81391617","24","124009"
"chr8","81267731","81268026","chr8","81391741","81392024","38","124010"
"chr8","81345588","81345890","chr11","48283444","48283741","64","33062144"
"chr8","81473866","81474109","chr8","81619610","81619853","12","145744"
"chr8","81628821","81629117","chrX","54010187","54010486","61","27618634"
"chr8","81636312","81636578","chr8","81783456","81783722","22","147144"
"chr8","81678450","81678748","chr8","81819824","81820127","28","141374"
"chr8","81825684","81825918","chr6","117009626","117009878","56","35183942"
"chr8","81841613","81841728","chr8","82047429","82047543","11","205816"
"chr8","81951449","81951734","chr3","143033608","143033876","73","61082159"
"chr8","81967925","81968212","chr8","82162566","82162840","29","194641"
"chr8","82104198","82104483","chr8","82292926","82293211","12","188728"
"chr8","82348456","82348766","chr8","82600835","82601135","38","252379"
"chr8","82460994","82461151","chr9","28475979","28476129","36","53985015"
"chr8","82518929","82519088","chr8","82776680","82776845","19","257751"
"chr8","82574789","82574948","chr8","82831432","82831600","20","256643"
"chr8","82584101","82584407","chr8","82840794","82841097","39","256693"
"chr8","82611597","82611858","chr12","57799258","57799516","64","24812339"
"chr8","82639970","82640266","chr8","82897437","82897747","31","257467"
"chr8","82643356","82643662","chr2","89619040","89619335","70","6975684"
"chr8","82859919","82860039","chr2","77408539","77408657","21","5451380"
"chr8","82955981","82956269","chr17","80641181","80641464","59","2314800"
"chr8","83006389","83006678","chr8","83262248","83262538","19","255859"
"chr8","83096041","83096172","chr8","83353233","83353376","23","257192"
"chr8","83180072","83180381","chr11","68178189","68178486","61","15001883"
"chr8","83259368","83259661","chr8","83509029","83509324","17","249661"
"chr8","83285952","83286253","chr8","83538333","83538631","38","252381"
"chr8","83331191","83331500","chr11","120832938","120833247","59","37501747"
"chr8","83361066","83361287","chr17","13758751","13758979","51","69602315"
"chr8","83373239","83373561","chr19","7651153","7651428","81","75722086"
"chr8","83392957","83393242","chr6","105934688","105934964","74","22541731"
"chr8","83394109","83394393","chr8","83658213","83658502","27","264104"
"chr8","83397467","83397696","chr14","64527974","64528205","55","18869493"
"chr8","83405487","83405769","chr8","83669191","83669473","29","263704"
"chr8","83416902","83417202","chr17","80429135","80429431","55","2987767"
"chr8","83419502","83419805","chr2","84913076","84913368","61","1493574"
"chr8","83423695","83423990","chr8","83685738","83686033","15","262043"
"chr8","83463901","83464122","chr8","83726422","83726628","28","262521"
"chr8","83491775","83492041","chr4","13407447","13407700","61","70084328"
"chr8","83535816","83536094","chr10","72052522","72052804","62","11483294"
"chr8","83554956","83555249","chr8","83819621","83819920","21","264665"
"chr8","83597592","83597888","chr8","83856245","83856543","25","258653"
"chr8","83611538","83611682","chr1","15750972","15751120","28","67860566"
"chr8","83611989","83612209","chr1","25017762","25017981","57","58594227"
"chr8","83620063","83620368","chr8","83877880","83878185","32","257817"
"chr8","83706861","83707197","chr8","83959046","83959361","45","252185"
"chr8","83719558","83719850","chr2","83884719","83885008","46","165161"
"chr8","83731927","83732140","chr8","84025422","84025631","17","293495"
"chr8","84670510","84670767","chr19","46056786","46057045","68","38613724"
"chr8","84698970","84699078","chr6","93630790","93630896","26","8931820"
"chr8","84710684","84710975","chr1","31163250","31163529","66","53547434"
"chr8","84716072","84716194","chr8","84250780","84250902","14","465292"
"chr8","84722778","84723072","chr8","84257470","84257764","21","465308"
"chr8","84729356","84729659","chr8","84264575","84264881","22","464781"
"chr8","84747453","84747711","chr3","128645446","128645679","70","43897993"
"chr8","84747802","84748075","chr3","40915322","40915603","71","43832480"
"chr8","84754834","84755126","chr8","84290042","84290343","42","464792"
"chr8","84767358","84767542","chr8","84302782","84302965","17","464576"
"chr8","84769079","84769358","chr8","84304487","84304783","45","464592"
"chr8","84773873","84774178","chr8","84309695","84309999","26","464178"
"chr8","84778276","84778581","chr8","84314963","84315284","35","463313"
"chr8","84792260","84792568","chr8","84328745","84329050","34","463515"
"chr8","84801495","84801630","chr8","84335312","84335450","12","466183"
"chr8","84801927","84802105","chr8","84335759","84335923","19","466168"
"chr8","84818599","84818894","chr8","84351251","84351545","16","467348"
"chr8","84834165","84834268","chr7","36222527","36222638","21","48611638"
"chr8","84852004","84852312","chr8","84383617","84383926","14","468387"
"chr8","84892149","84892278","chr8","84429496","84429617","14","462653"
"chr8","84895625","84895816","chr8","84433018","84433181","36","462607"
"chr8","84896113","84896232","chr2","102450278","102450399","22","17554165"
"chr8","84939915","84940217","chr8","84527393","84527693","14","412522"
"chr8","84953321","84953479","chr12","101537347","101537508","37","16584026"
"chr8","84975097","84975239","chr8","84562671","84562817","8","412426"
"chr8","84975535","84975674","chr8","84563121","84563268","16","412414"
"chr8","84983628","84983790","chr8","84571183","84571339","16","412445"
"chr8","84984286","84984423","chr8","84571837","84571971","8","412449"
"chr8","84996547","84996834","chr8","84589190","84589439","50","407357"
"chr8","84997671","84997958","chr1","138872834","138873119","60","53875163"
"chr8","85003765","85004059","chr8","84596443","84596738","23","407322"
"chr8","85004334","85004448","chr8","84597012","84597125","3","407322"
"chr8","85014073","85014363","chr8","84607043","84607328","22","407030"
"chr8","85032638","85032754","chr8","84625454","84625570","3","407184"
"chr8","85041535","85041814","chr8","84634321","84634624","43","407214"
"chr8","85063218","85063527","chr8","84655214","84655527","33","408004"
"chr8","85067910","85068194","chr8","84659870","84660155","21","408040"
"chr8","85072151","85072440","chr8","84664503","84664793","16","407648"
"chr8","85115200","85115476","chr9","24501290","24501568","67","60613910"
"chr8","85175712","85175848","chr20","23393491","23393621","25","61782221"
"chr8","85175882","85176048","chr7","153688648","153688814","35","68512766"
"chr8","85215941","85216065","chr8","84810541","84810664","8","405400"
"chr8","85286197","85286297","chr12","108969704","108969803","19","23683507"
"chr8","85331256","85331425","chr1","138856573","138856739","14","53525317"
"chr8","85337856","85338073","chr8","84933184","84933417","28","404672"
"chr8","85362766","85362879","chr8","84949196","84949309","5","413570"
"chr8","85397273","85397544","chr8","84983904","84984175","26","413369"
"chr8","85503055","85503177","chr4","32621742","32621865","20","52881313"
"chr8","85530512","85530775","chr8","85159569","85159829","19","370943"
"chr8","85549642","85549754","chr8","85178396","85178520","16","371246"
"chr8","85660116","85660426","chr8","85349790","85350107","35","310326"
"chr8","86033831","86034117","chr8","85725224","85725504","25","308607"
"chr8","86340317","86340515","chr7","53643903","53644105","46","32696414"
"chr8","86387085","86387375","chr8","86069349","86069639","23","317736"
"chr8","86433067","86433368","chr8","86121056","86121364","22","312011"
"chr8","86483559","86483871","chr8","86150777","86151062","45","332782"
"chr8","86486220","86486540","chr8","86153469","86153779","36","332751"
"chr8","86622789","86623061","chr8","86336990","86337263","15","285799"
"chr8","86884426","86884655","chr8","86672032","86672260","24","212394"
"chr8","86909308","86909389","chr8","86695113","86695191","7","214195"
"chr8","86919537","86919824","chr8","86709265","86709553","15","210272"
"chr8","86977850","86978107","chr8","86768229","86768522","45","209621"
"chr8","87020753","87020979","chr8","86824230","86824434","34","196523"
"chr8","87157678","87157970","chr8","86969399","86969715","34","188279"
"chr8","87272837","87273156","chr5","169147487","169147792","74","81874650"
"chr8","87273773","87274076","chr13","27604982","27605294","67","59668791"
"chr8","87307574","87307728","chr6","158348950","158349107","34","71041376"
"chr8","87832706","87832984","chr8","87655105","87655391","24","177601"
"chr8","87966825","87967099","chr8","87795990","87796280","31","170835"
"chr8","88035392","88035681","chr8","87860724","87861014","27","174668"
"chr8","88178503","88178600","chr8","88061547","88061644","2","116956"
"chr8","88253461","88253745","chr8","88122835","88123119","15","130626"
"chr8","88280760","88280919","chr8","88150686","88150852","24","130074"
"chr8","88280954","88281084","chr1","117811669","117811797","19","29530715"
"chr8","88298016","88298302","chr8","88167430","88167720","27","130586"
"chr8","88389875","88390177","chr8","88247853","88248153","22","142022"
"chr8","88422070","88422253","chr8","25350058","25350236","42","63072012"
"chr8","88466730","88466779","chr2","92589317","92589363","16","4122587"
"chr8","88481184","88481474","chr8","88340644","88340936","19","140540"
"chr8","88482734","88482977","chr8","88342235","88342482","24","140499"
"chr8","88540990","88541317","chr8","88402092","88402411","34","138898"
"chr8","88602069","88602340","chr8","88462489","88462760","21","139580"
"chr8","88626746","88627047","chr8","88487426","88487738","29","139320"
"chr8","88661629","88661905","chr8","88560605","88560872","29","101024"
"chr8","88678678","88678970","chr8","88574634","88574928","25","104044"
"chr8","88695050","88695172","chr1","53704936","53705059","21","34990114"
"chr8","88741223","88741521","chr8","88635065","88635357","18","106158"
"chr8","88793742","88794046","chr8","88686125","88686429","34","107617"
"chr8","88829502","88829764","chr8","88722683","88722957","33","106819"
"chr8","88835317","88835616","chr8","88728514","88728822","28","106803"
"chr8","88846042","88846344","chr8","88739016","88739317","20","107026"
"chr8","88902895","88903143","chr8","88800131","88800387","22","102764"
"chr8","89030164","89030472","chr19","15410307","15410607","77","73619857"
"chr8","89031036","89031337","chr8","88981529","88981845","34","49507"
"chr8","89106141","89106454","chr13","47985843","47986156","65","41120298"
"chr8","89137467","89137709","chr8","89106294","89106535","30","31173"
"chr8","89168530","89168830","chr8","89156294","89156584","36","12236"
"chr8","89192844","89192943","chr2","74636905","74637003","24","14555939"
"chr8","89193298","89193526","chr16","67041001","67041222","61","22152297"
"chr8","89274588","89274710","chr8","89265463","89265585","11","9125"
"chr8","89276998","89277082","chr16","64998798","64998878","22","24278200"
"chr8","89463066","89463359","chr8","89434329","89434632","33","28737"
"chr8","89596796","89597008","chr8","89574524","89574740","14","22272"
"chr8","89629574","89629873","chr8","89607676","89607976","14","21898"
"chr8","89635612","89635883","chr8","89613662","89613933","13","21950"
"chr8","89670681","89670864","chr4","43533868","43534045","51","46136813"
"chr8","89722387","89722691","chr8","89700969","89701267","25","21418"
"chr8","89919740","89919862","chr11","88601602","88601726","18","1318138"
"chr8","89953679","89953973","chr8","89924362","89924658","33","29317"
"chr8","89956674","89956976","chr16","11775609","11775900","67","78181065"
"chr8","90255271","90255555","chr8","90254525","90254815","36","746"
"chr8","90422170","90422462","chr8","90417902","90418195","24","4268"
"chr8","90527976","90528261","chr8","90523780","90524071","35","4196"
"chr8","90537724","90537986","chr11","99931325","99931585","57","9393601"
"chr8","90564584","90564887","chr20","42657951","42658246","58","47906633"
"chr8","90614886","90615164","chr8","90611778","90612064","22","3108"
"chr8","90625656","90625953","chr8","90622158","90622455","31","3498"
"chr8","90628277","90628394","chr8","71594199","71594315","19","19034078"
"chr8","90656977","90657255","chr8","90654040","90654319","19","2937"
"chr8","90727848","90728145","chr13","85683662","85683961","55","5044186"
"chr8","90744271","90744424","chr8","90742797","90742962","29","1474"
"chr8","90831970","90832092","chr8","90819183","90819314","16","12787"
"chr8","90841149","90841273","chr6","64065434","64065559","21","26775715"
"chr8","90850728","90851040","chr8","90836809","90837116","21","13919"
"chr8","91026706","91027001","chr8","90998933","90999235","42","27773"
"chr8","91189740","91190018","chr8","91162723","91163004","25","27017"
"chr8","91398957","91399251","chr8","91373228","91373521","19","25729"
"chr8","91633645","91633937","chr8","91607644","91607935","21","26001"
"chr8","91634466","91634644","chr1","218816649","218816824","46","127182183"
"chr8","91706621","91706889","chr1","196425214","196425471","68","104718593"
"chr8","91771557","91771861","chr5","152388149","152388456","60","60616592"
"chr8","91776597","91776816","chr8","91747499","91747700","34","29098"
"chr8","91777957","91778167","chr20","35094996","35095206","36","56682961"
"chr8","91925974","91926016","chr8","91889698","91889740","0","36276"
"chr8","91926081","91926221","chr8","91889793","91889933","7","36288"
"chr8","92014493","92014608","chr8","91980421","91980539","11","34072"
"chr8","92017858","92017953","chr8","91983813","91983902","12","34045"
"chr8","92023423","92023718","chr8","91989395","91989691","15","34028"
"chr8","92202168","92202367","chr8","92158173","92158366","23","43995"
"chr8","92205073","92205248","chr1","66592971","66593146","39","25612102"
"chr8","92208417","92208543","chr2","83802680","83802806","24","8405737"
"chr8","92209306","92209647","chr8","92164576","92164866","61","44730"
"chr8","92222306","92222600","chr8","92176326","92176621","31","45980"
"chr8","92262105","92262240","chr8","92223724","92223858","15","38381"
"chr8","92262547","92262720","chr8","92224166","92224317","29","38381"
"chr8","92293558","92293830","chr8","92257203","92257475","26","36355"
"chr8","92300472","92300768","chr8","92264343","92264646","21","36129"
"chr8","92306517","92306811","chr8","92270357","92270652","16","36160"
"chr8","92317337","92317652","chr19","26840418","26840720","80","65476919"
"chr8","92323119","92323422","chr8","92287117","92287441","36","36002"
"chr8","92331620","92331745","chr18","59375027","59375150","20","32956593"
"chr8","92355018","92355309","chr8","92319017","92319304","39","36001"
"chr8","92383757","92384087","chr8","92347950","92348260","42","35807"
"chr8","92390603","92390908","chr8","92354795","92355098","15","35808"
"chr8","92432623","92432933","chr20","42042273","42042584","56","50390350"
"chr8","92435352","92435671","chr8","92398180","92398464","53","37172"
"chr8","92454496","92454703","chr8","92417384","92417591","9","37112"
"chr8","92478968","92479222","chr8","92441257","92441510","23","37711"
"chr8","92514629","92514908","chr8","92485975","92486254","14","28654"
"chr8","92582802","92583108","chr8","92547631","92547941","27","35171"
"chr8","92599582","92599860","chr8","92565106","92565384","13","34476"
"chr8","92601088","92601392","chr8","92566600","92566903","17","34488"
"chr8","92608601","92608897","chr8","92574103","92574404","25","34498"
"chr8","92725613","92725861","chr8","92687825","92688073","15","37788"
"chr8","92743863","92744137","chr8","92712520","92712778","36","31343"
"chr8","92774501","92774803","chr8","92743583","92743895","26","30918"
"chr8","92796519","92796688","chr15","81490632","81490796","38","11305887"
"chr8","92796689","92796882","chr8","92766074","92766284","30","30615"
"chr8","92807338","92807615","chr8","92776592","92776866","32","30746"
"chr8","92829147","92829440","chr8","92798428","92798708","46","30719"
"chr8","92902106","92902398","chr8","92870681","92870970","21","31425"
"chr8","92909748","92910014","chr8","92877137","92877406","22","32611"
"chr8","92930516","92930828","chr8","92899011","92899323","19","31505"
"chr8","92938575","92938867","chr8","92907435","92907726","24","31140"
"chr8","92952598","92952720","chr8","92921267","92921383","15","31331"
"chr8","92956100","92956223","chr8","92924802","92924926","10","31298"
"chr8","92975802","92976100","chr8","92945778","92946077","17","30024"
"chr8","93025681","93025970","chr8","92992633","92992928","24","33048"
"chr8","93030110","93030429","chr5","97271534","97271831","81","4241424"
"chr8","93047182","93047398","chr8","93014132","93014338","37","33050"
"chr8","93047876","93048189","chr16","69768964","69769264","61","23278912"
"chr8","93060693","93060815","chr3","36373230","36373353","24","56687463"
"chr8","93061521","93061813","chr8","93028507","93028814","38","33014"
"chr8","93063616","93063916","chr8","93030633","93030931","22","32983"
"chr8","93064551","93064688","chr8","93031637","93031768","16","32914"
"chr8","93071919","93072213","chr14","19127734","19128033","61","73944185"
"chr8","93085993","93086300","chr13","9406810","9407104","57","83679183"
"chr8","93095783","93096084","chr19","41238990","41239301","62","51856793"
"chr8","93099441","93099675","chr9","15256531","15256742","61","77842910"
"chr8","93110534","93110839","chr8","93078115","93078425","32","32419"
"chr8","93128840","93129121","chr9","84086709","84086992","58","9042131"
"chr8","93132041","93132336","chr8","93090316","93090597","28","41725"
"chr8","93135438","93135751","chr8","93093710","93094022","21","41728"
"chr8","93140865","93141145","chr8","93099107","93099414","47","41758"
"chr8","93161081","93161361","chr8","93122187","93122469","25","38894"
"chr8","93162008","93162213","chr14","33131390","33131598","45","60030618"
"chr8","93162217","93162338","chr8","93120288","93120409","7","41929"
"chr8","93165199","93165459","chr1","166115739","166115999","55","72950540"
"chr8","93176868","93177121","chr8","93136462","93136743","61","40406"
"chr8","93187784","93187900","chr20","42862414","42862525","13","50325370"
"chr8","93190402","93190633","chr16","52205235","52205472","69","40985167"
"chr8","93209746","93209872","chr17","24194494","24194616","23","69015252"
"chr8","93209947","93210146","chr17","5938427","5938631","37","87271520"
"chr8","93501129","93501233","chr8","96949211","96949317","16","3448082"
"chr8","93506208","93506353","chr1","20192943","20193091","37","73313265"
"chr8","93526547","93526764","chr1","95147363","95147578","56","1620816"
"chr8","93527482","93527549","chr4","116963835","116963903","16","23436353"
"chr8","93529032","93529159","chr3","21290681","21290802","31","72238351"
"chr8","93529189","93529488","chr8","93236636","93236914","44","292553"
"chr8","93555312","93555440","chr3","47065972","47066100","21","46489340"
"chr8","93560962","93561163","chr8","93267859","93268055","17","293103"
"chr8","93569782","93570085","chr12","51802642","51802937","69","41767140"
"chr8","93585807","93585981","chrX","144540714","144540877","44","50954907"
"chr8","93596737","93597019","chr1","35294285","35294565","56","58302452"
"chr8","93598176","93598296","chr8","93307289","93307411","6","290887"
"chr8","93625472","93625741","chr8","93334395","93334661","26","291077"
"chr8","93632255","93632366","chr13","61497780","61497887","26","32134475"
"chr8","93676776","93677077","chr8","93387276","93387572","25","289500"
"chr8","93681018","93681321","chr15","80395159","80395459","59","13285859"
"chr8","93681325","93681447","chr11","113337897","113338020","13","19656572"
"chr8","93688255","93688550","chr8","93398535","93398818","29","289720"
"chr8","93729578","93729875","chr8","93441056","93441357","23","288522"
"chr8","93734964","93735247","chr8","93446437","93446717","19","288527"
"chr8","93764605","93764891","chr8","93476160","93476446","29","288445"
"chr8","93767835","93768134","chr8","93479371","93479668","12","288464"
"chr8","93780591","93780906","chr8","93492789","93493099","33","287802"
"chr8","93793987","93794271","chr8","93507833","93508106","48","286154"
"chr8","93794282","93794430","chr8","93508159","93508307","8","286123"
"chr8","93814568","93814658","chr3","40511111","40511199","15","53303457"
"chr8","93818874","93818981","chr8","93535448","93535565","15","283426"
"chr8","93819658","93819953","chr8","93536773","93537074","20","282885"
"chr8","93823044","93823332","chr1","60460972","60461260","51","33362072"
"chr8","93827581","93827889","chr8","93545809","93546123","20","281772"
"chr8","93831192","93831307","chr16","38853946","38854064","17","54977246"
"chr8","93831347","93831508","chr3","126621167","126621327","35","32789820"
"chr8","93831759","93832070","chr8","93549862","93550178","26","281897"
"chr8","93836705","93836987","chr8","93555147","93555428","23","281558"
"chr8","93845413","93845698","chr14","12540994","12541290","54","81304419"
"chr8","93851704","93851970","chr4","150165896","150166163","57","56314192"
"chr8","93856519","93856765","chr4","131185973","131186220","57","37329454"
"chr8","93858204","93858516","chr8","93577896","93578198","25","280308"
"chr8","93872716","93873022","chr8","93594963","93595261","29","277753"
"chr8","93880641","93880937","chr2","195639631","195639930","54","101758990"
"chr8","93884859","93885151","chr4","128415397","128415686","65","34530538"
"chr8","93901144","93901268","chr13","9638870","9638993","18","84262274"
"chr8","93909872","93910103","chr8","93630953","93631186","16","278919"
"chr8","93922121","93922249","chr8","93642975","93643107","11","279146"
"chr8","93934564","93934858","chr8","93655188","93655488","26","279376"
"chr8","93949105","93949388","chr10","19944741","19945017","69","74004364"
"chr8","93976075","93976360","chr1","93820100","93820384","58","155975"
"chr8","94044191","94044274","chr14","52954073","52954154","12","41090118"
"chr8","94145926","94146068","chr1","92962365","92962502","25","1183561"
"chr8","94188070","94188355","chr6","157603997","157604276","56","63415927"
"chr8","94552264","94552554","chr8","94288059","94288352","22","264205"
"chr8","94554843","94555178","chrX","64991673","64991978","89","29563170"
"chr8","94681727","94681852","chr8","94410304","94410433","11","271423"
"chr8","94764635","94764937","chrX","64991673","64991978","56","29772962"
"chr8","94806308","94806526","chr3","35639309","35639528","45","59166999"
"chr8","94842931","94843241","chr8","94645608","94645914","30","197323"
"chr8","94935978","94936060","chr4","57653291","57653374","11","37282687"
"chr8","94998586","94998874","chr2","104445382","104445669","55","9446796"
"chr8","95007860","95008145","chr8","94797724","94798016","26","210136"
"chr8","95008321","95008445","chr8","94798198","94798319","12","210123"
"chr8","95020716","95021000","chr8","94810683","94810972","23","210033"
"chr8","95032515","95032801","chr10","31897186","31897473","66","63135329"
"chr8","95076159","95076449","chr7","53545449","53545742","57","41530710"
"chr8","95088216","95088343","chr8","94921603","94921731","11","166613"
"chr8","95097561","95097840","chr8","94931221","94931516","32","166340"
"chr8","95134460","95134739","chr8","94966523","94966792","28","167937"
"chr8","95153335","95153602","chr8","94986176","94986489","58","167159"
"chr8","95177410","95177717","chr8","95012268","95012572","26","165142"
"chr8","95185980","95186290","chr8","95021039","95021355","30","164941"
"chr8","95225869","95225986","chr11","125160352","125160467","20","29934483"
"chr8","95226014","95226170","chr8","29653012","29653169","30","65573002"
"chr8","95310341","95310479","chr8","53328516","53328650","26","41981825"
"chr8","95352512","95352807","chr8","95188191","95188490","30","164321"
"chr8","95365894","95366176","chrX","125989015","125989296","46","30623121"
"chr8","95385992","95386289","chr8","95220527","95220827","20","165465"
"chr8","95416681","95416985","chr8","95251117","95251406","31","165564"
"chr8","95422913","95423122","chr3","164564149","164564349","66","69141236"
"chr8","95433835","95434112","chr8","95268482","95268747","26","165353"
"chr8","95445890","95446187","chrX","41541015","41541312","52","53904875"
"chr8","95449684","95449994","chr8","95291276","95291597","30","158408"
"chr8","95637961","95638258","chr14","122733616","122733911","51","27095655"
"chr8","95777277","95777580","chr8","95609513","95609814","25","167764"
"chr8","95801483","95801776","chr8","95633996","95634293","25","167487"
"chr8","95976258","95976545","chr8","95796853","95797146","26","179405"
"chr8","96144929","96145241","chr8","95957823","95958114","50","187106"
"chr8","96148515","96148808","chr8","95961218","95961522","28","187297"
"chr8","96244975","96245090","chr8","96060325","96060440","7","184650"
"chr8","96262941","96263061","chr8","96077286","96077409","14","185655"
"chr8","96267362","96267685","chr8","96082722","96083053","38","184640"
"chr8","96268156","96268486","chr8","96083527","96083867","27","184629"
"chr8","96271243","96271361","chr7","84972963","84973080","14","11298280"
"chr8","96300602","96300908","chr13","45053818","45054106","50","51246784"
"chr8","96369255","96369560","chr8","96162067","96162375","22","207188"
"chr8","96382671","96382848","chr8","96174565","96174745","23","208106"
"chr8","96401692","96401988","chr8","96192225","96192517","18","209467"
"chr8","96458772","96459091","chr8","96243966","96244264","62","214806"
"chr8","96463497","96463778","chr8","96249598","96249873","29","213899"
"chr8","96471088","96471211","chr4","73819458","73819584","28","22651630"
"chr8","96476113","96476272","chr8","96263140","96263299","6","212973"
"chr8","96477256","96477423","chrX","108571872","108572033","35","12094616"
"chr8","96501350","96501571","chr1","16316885","16317107","39","80184465"
"chr8","96502481","96502655","chr15","8180677","8180851","39","88321804"
"chr8","96504166","96504462","chr1","22929342","22929637","52","73574824"
"chr8","96507891","96508189","chr8","96292726","96293018","27","215165"
"chr8","96534902","96534987","chr19","12797500","12797577","20","83737402"
"chr8","96578361","96578509","chr8","96362210","96362341","28","216151"
"chr8","96578814","96578827","chr3","159381299","159381311","4","62802485"
"chr8","96579114","96579297","chr13","107549131","107549307","39","10970017"
"chr8","96593708","96593806","chr8","96392886","96392993","11","200822"
"chr8","96615086","96615381","chr9","82773372","82773665","63","13841714"
"chr8","96618310","96618456","chr8","96419665","96419809","10","198645"
"chr8","96618764","96618894","chr8","96420056","96420183","11","198708"
"chr8","96629125","96629418","chr8","96426451","96426745","27","202674"
"chr8","96643600","96643823","chr8","96441263","96441486","8","202337"
"chr8","96659335","96659609","chr6","176215617","176215901","63","79556282"
"chr8","96673848","96673965","chr8","96476522","96476639","5","197326"
"chr8","96679958","96680255","chr8","96481343","96481625","38","198615"
"chr8","96685948","96686240","chr5","146105476","146105774","54","49419528"
"chr8","96697321","96697634","chr8","96502515","96502831","28","194806"
"chr8","96698625","96698722","chr3","124769586","124769677","23","28070961"
"chr8","96699023","96699159","chr1","8814405","8814541","23","87884618"
"chr8","96699539","96699728","chr13","107549131","107549307","36","10849592"
"chr8","96700004","96700125","chr1","198395351","198395472","14","101695347"
"chr8","96709184","96709303","chr8","96518463","96518585","13","190721"
"chr8","96715983","96716254","chr8","96525882","96526169","28","190101"
"chr8","96762815","96763148","chr8","96575803","96576115","51","187012"
"chr8","96774853","96775140","chr8","96588383","96588665","29","186470"
"chr8","96787802","96787952","chr8","96600130","96600275","20","187672"
"chr8","96788251","96788438","chr20","28166833","28167010","37","68621418"
"chr8","96788524","96788829","chr8","96600829","96601132","36","187695"
"chr8","96810591","96810866","chr8","96623479","96623774","38","187112"
"chr8","96836043","96836333","chr8","96648963","96649265","40","187080"
"chr8","96883609","96883869","chr8","96696511","96696773","18","187098"
"chr8","96884423","96884546","chr8","96697646","96697769","12","186777"
"chr8","96888624","96888937","chr8","96701839","96702148","29","186785"
"chr8","96893372","96893506","chr8","96706904","96707037","7","186468"
"chr8","96894748","96894866","chr8","96708610","96708721","14","186138"
"chr8","96895791","96896020","chr8","96709594","96709843","42","186197"
"chr8","96903981","96904198","chr8","96714714","96714930","14","189267"
"chr8","96905203","96905488","chr8","96715962","96716243","28","189241"
"chr8","96916798","96916985","chr1","182889564","182889753","32","85972766"
"chr8","96917419","96917541","chr3","2150481","2150601","22","94766938"
"chr8","96922145","96922405","chrX","103046997","103047266","59","6124852"
"chr8","96925505","96925811","chr8","96738764","96739076","29","186741"
"chr8","96930256","96930525","chr8","96744234","96744486","33","186022"
"chr8","96930922","96931218","chr8","96744882","96745179","19","186040"
"chr8","96940838","96941128","chr8","96756362","96756665","28","184476"
"chr8","96960482","96960780","chrX","24534965","24535255","58","72425517"
"chr8","96965304","96965588","chr13","10443034","10443317","48","86522270"
"chr8","96973991","96974289","chr8","96791279","96791575","15","182712"
"chr8","97041352","97041655","chr8","96860847","96861151","23","180505"
"chr8","97050323","97050624","chr8","96869866","96870168","18","180457"
"chr8","97062356","97062652","chr19","1951603","1951893","58","95110753"
"chr8","97119559","97119710","chr2","102507593","102507742","36","5388034"
"chr8","97120017","97120155","chr8","96935405","96935548","12","184612"
"chr8","97133238","97133351","chr8","96949211","96949317","10","184027"
"chr8","97241383","97241672","chr8","97058351","97058649","23","183032"
"chr8","97361935","97362217","chr3","55299063","55299339","53","42062872"
"chr8","97391002","97391244","chr8","97214783","97215020","28","176219"
"chr8","97446517","97446839","chr8","97267947","97268230","57","178570"
"chr8","97448357","97448624","chr1","5819632","5819900","54","91628725"
"chr8","97461777","97462064","chr8","97283012","97283283","37","178765"
"chr8","97511114","97511388","chr8","97324195","97324474","21","186919"
"chr8","97525381","97525654","chr1","5819632","5819900","57","91705749"
"chr8","97564367","97564591","chr8","97359428","97359652","20","204939"
"chr8","97578070","97578367","chr8","97373644","97373923","45","204426"
"chr8","97591405","97591522","chr9","39009432","39009548","16","58581973"
"chr8","97604013","97604261","chr8","97399240","97399488","14","204773"
"chr8","97639440","97639670","chr2","45945040","45945260","48","51694400"
"chr8","97650696","97650956","chr8","97466249","97466509","11","184447"
"chr8","97657037","97657325","chr8","97485777","97486071","25","171260"
"chr8","97660873","97661073","chr8","97489622","97489813","22","171251"
"chr8","97664528","97664829","chr8","97493539","97493836","26","170989"
"chr8","97665845","97666140","chr11","108895131","108895429","62","11229286"
"chr8","97667260","97667574","chr8","97498742","97499069","31","168518"
"chr8","97668456","97668736","chr8","97504315","97504600","26","164141"
"chr8","97671559","97671706","chr2","49670759","49670898","41","48000800"
"chr8","97676200","97676534","chr8","97511735","97512061","42","164465"
"chr8","97689867","97690136","chr8","97525410","97525681","13","164457"
"chr8","97699235","97699524","chr8","97535678","97536000","50","163557"
"chr8","97721290","97721593","chrX","48162977","48163283","58","49558313"
"chr8","97731357","97731670","chr8","97574821","97575133","26","156536"
"chr8","97829573","97829683","chr6","55072213","55072319","24","42757360"
"chr8","97830672","97831014","chr8","97671724","97672052","64","158948"
"chr8","97857214","97857483","chr1","146544404","146544685","63","48687190"
"chr8","97941247","97941539","chr8","97778205","97778493","27","163042"
"chr8","97951304","97951523","chr8","97788229","97788451","19","163075"
"chr8","97951757","97951964","chr8","97788688","97788897","19","163069"
"chr8","97970010","97970300","chr20","18364888","18365184","67","79605122"
"chr8","98009733","98010016","chr8","97851606","97851891","19","158127"
"chr8","98087727","98087933","chr8","97941070","97941252","32","146657"
"chr8","98115589","98115886","chr15","49826638","49826928","58","48288951"
"chr8","98134784","98134977","chr3","74980640","74980834","46","23154144"
"chr8","98176153","98176435","chr8","98007225","98007514","30","168928"
"chr8","98264956","98265136","chr8","98097983","98098163","9","166973"
"chr8","98288799","98289109","chr8","98129280","98129561","49","159519"
"chr8","98348826","98349123","chr8","98186420","98186718","17","162406"
"chr8","98363776","98364033","chr8","98201397","98201669","41","162379"
"chr8","98387222","98387513","chr8","98227966","98228263","46","159256"
"chr8","98404065","98404356","chr8","98237242","98237533","19","166823"
"chr8","98409753","98410049","chr8","98250152","98250456","25","159601"
"chr8","98467091","98467353","chr11","123534948","123535208","58","25067857"
"chr8","98592767","98593061","chr8","98489019","98489318","27","103748"
"chr8","98616785","98616912","chr8","98513691","98513818","6","103094"
"chr8","98620046","98620223","chr8","98516964","98517129","16","103082"
"chr8","98627515","98627822","chr8","98524454","98524746","27","103061"
"chr8","98638614","98638838","chr19","19255078","19255305","44","79383536"
"chr8","98665003","98665310","chr8","98562335","98562631","52","102668"
"chr8","98677688","98677978","chr8","98574936","98575229","12","102752"
"chr8","98692766","98693044","chr8","98589955","98590233","14","102811"
"chr8","98699432","98699734","chr8","98596537","98596823","32","102895"
"chr8","98714830","98714935","chr8","98611950","98612061","10","102880"
"chr8","98720274","98720567","chr8","98617428","98617733","57","102846"
"chr8","98729916","98730202","chr8","98625026","98625321","30","104890"
"chr8","98740165","98740288","chr3","36373230","36373353","20","62366935"
"chr8","98756148","98756413","chr8","98645208","98645472","21","110940"
"chr8","98794661","98794786","chr8","98686676","98686806","10","107985"
"chr8","98813399","98813694","chr8","98709234","98709535","23","104165"
"chr8","98827218","98827361","chr6","93577303","93577440","37","5249915"
"chr8","98841729","98842028","chr11","118569447","118569730","65","19727718"
"chr8","98851368","98851665","chr8","98751173","98751462","26","100195"
"chr8","98859756","98860034","chr8","98759552","98759807","43","100204"
"chr8","98868434","98868716","chr8","98768729","98769013","21","99705"
"chr8","98874015","98874132","chr8","98774347","98774464","10","99668"
"chr8","98969971","98970191","chr8","98876879","98877095","20","93092"
"chr8","98972897","98973013","chr8","98880118","98880236","10","92779"
"chr8","98977235","98977359","chr8","98884409","98884533","8","92826"
"chr8","98981808","98982118","chr17","76613814","76614115","59","22367994"
"chr8","98988197","98988412","chr1","23426501","23426719","47","75561696"
"chr8","99001145","99001452","chr8","98909473","98909779","21","91672"
"chr8","99024935","99025060","chr8","98928081","98928206","8","96854"
"chr8","99025616","99025935","chr8","98928763","98929078","22","96853"
"chr8","99050160","99050277","chr8","98952850","98952967","4","97310"
"chr8","99060227","99060528","chr8","98962604","98962908","25","97623"
"chr8","99074207","99074328","chr8","98976514","98976635","9","97693"
"chr8","99080265","99080577","chr1","8981776","8982081","64","90098489"
"chr8","99081140","99081431","chr8","98983514","98983809","15","97626"
"chr8","99086406","99086694","chr8","98989053","98989336","22","97353"
"chr8","99146698","99146919","chr8","99049718","99049932","15","96980"
"chr8","99160093","99160381","chr6","144017468","144017757","54","44857375"
"chr8","99171100","99171412","chr8","99073040","99073317","55","98060"
"chr8","99200202","99200493","chr8","99103088","99103375","25","97114"
"chr8","99202181","99202303","chr8","99105080","99105202","6","97101"
"chr8","99221180","99221391","chr10","46704262","46704451","55","52516918"
"chr8","99247079","99247388","chr8","99143596","99143909","26","103483"
"chr8","99259377","99259574","chr8","99158404","99158642","51","100973"
"chr8","99282344","99282626","chr16","55700437","55700720","61","43581907"
"chr8","99313921","99314026","chr8","99209463","99209569","7","104458"
"chr8","99316866","99316995","chr8","99212533","99212662","6","104333"
"chr8","99348558","99348848","chr8","99240340","99240627","27","108218"
"chr8","99348877","99348888","chr7","125425834","125425844","2","26076957"
"chr8","99382831","99383077","chr2","88117897","88118141","62","11264934"
"chr8","99385306","99385430","chr14","32733275","32733398","14","66652031"
"chr8","99407974","99408250","chr8","99305263","99305568","48","102711"
"chr8","99441222","99441528","chr8","99334673","99334957","45","106549"
"chr8","99449381","99449679","chr1","166861689","166861988","57","67412308"
"chr8","99451222","99451516","chr8","99342636","99342937","30","108586"
"chr8","99451668","99451977","chr8","99343085","99343399","24","108583"
"chr8","99457696","99457989","chr12","38307089","38307382","68","61150607"
"chr8","99477671","99477935","chr8","99370940","99371236","46","106731"
"chr8","99485081","99485246","chr8","99381541","99381708","14","103540"
"chr8","99498824","99499073","chr8","99396270","99396519","14","102554"
"chr8","99504907","99505195","chr8","99402141","99402434","25","102766"
"chr8","99514159","99514449","chr8","99412859","99413155","28","101300"
"chr8","99514464","99514737","chr8","99413168","99413444","21","101296"
"chr8","99521756","99522024","chr8","99420390","99420663","19","101366"
"chr8","99543274","99543579","chr8","99441407","99441726","28","101867"
"chr8","99548962","99549236","chr8","99447268","99447541","15","101694"
"chr8","99549817","99549941","chr8","99448124","99448247","11","101693"
"chr8","99551950","99552257","chr8","32898554","32898859","60","66653396"
"chr8","99552305","99552425","chr2","61373245","61373374","26","38179060"
"chr8","99557455","99557766","chr8","99454479","99454744","57","102976"
"chr8","99558972","99559239","chr13","104640335","104640600","55","5081363"
"chr8","99562200","99562508","chr8","99459440","99459722","51","102760"
"chr8","99563555","99563859","chr8","99460769","99461064","26","102786"
"chr8","99571599","99571912","chr8","99471211","99471524","15","100388"
"chr8","99574695","99575005","chr8","99474298","99474609","29","100397"
"chr8","99588543","99588827","chr8","99489501","99489809","53","99042"
"chr8","99596630","99596893","chr8","99498693","99498975","32","97937"
"chr8","99606970","99607265","chr8","99509091","99509387","34","97879"
"chr8","99634431","99634717","chr8","99536804","99537074","36","97627"
"chr8","99637217","99637302","chr13","44849240","44849328","14","54787977"
"chr8","99663966","99664247","chr8","99565871","99566160","17","98095"
"chr8","99664896","99665187","chr8","99567108","99567383","40","97788"
"chr8","99716239","99716364","chr18","41255081","41255204","21","58461158"
"chr8","99717420","99717534","chr14","8294861","8294977","16","91422559"
"chr8","99717565","99717758","chr3","41517193","41517366","53","58200372"
"chr8","99722716","99723016","chr8","99634627","99634930","21","88089"
"chr8","99739097","99739384","chr8","99650929","99651218","19","88168"
"chr8","99745579","99745728","chr8","99657379","99657546","25","88200"
"chr8","99746024","99746158","chr8","99657828","99657962","16","88196"
"chr8","99771663","99771971","chr11","111305959","111306271","52","11534296"
"chr8","99789681","99789966","chr8","99699361","99699627","50","90320"
"chr8","99792166","99792244","chr3","138342699","138342772","16","38550533"
"chr8","99816472","99816732","chr18","24697354","24697609","64","75119118"
"chr8","99836535","99836810","chr8","99744029","99744325","57","92506"
"chr8","99844544","99844780","chr3","125699927","125700158","67","25855383"
"chr8","99867401","99867603","chr8","99774745","99774919","40","92656"
"chr8","99867895","99868029","chr8","99775223","99775358","7","92672"
"chr8","99884960","99885266","chr8","99792697","99793003","26","92263"
"chr8","99917132","99917404","chr8","99827294","99827576","30","89838"
"chr8","99930003","99930277","chr8","99840194","99840480","30","89809"
"chr8","99949759","99949891","chr8","99859860","99859993","11","89899"
"chr8","99950971","99951195","chr19","2956619","2956834","43","96994352"
"chr8","99955845","99956129","chr8","99865998","99866291","29","89847"
"chr8","99961200","99961475","chr8","99871356","99871631","16","89844"
"chr8","99969862","99970150","chr8","99880023","99880311","22","89839"
"chr8","99977615","99977918","chr8","99889045","99889341","28","88570"
"chr8","100032809","100033123","chr8","99942909","99943223","16","89900"
"chr8","100040084","100040344","chr8","99950212","99950495","33","89872"
"chr8","100046678","100046958","chr3","69427733","69428028","55","30618945"
"chr8","100056849","100057059","chr8","99966311","99966529","20","90538"
"chr8","100082583","100082706","chr8","99993329","99993452","6","89254"
"chr8","100098893","100099179","chr3","72383698","72383983","41","27715195"
"chr8","100112962","100113085","chr8","100024163","100024286","6","88799"
"chr8","100130625","100130930","chr8","100042126","100042437","26","88499"
"chr8","100213571","100213887","chr8","100125482","100125813","41","88089"
"chr8","100222898","100223226","chr8","100134850","100135163","31","88048"
"chr8","100283714","100283976","chr8","100187628","100187889","11","96086"
"chr8","100320181","100320477","chr14","126923787","126924083","63","26603606"
"chr8","100331005","100331129","chr1","223444164","223444286","17","123113159"
"chr8","100372768","100373033","chr8","100283579","100283849","21","89189"
"chr8","100403903","100404187","chr8","100314386","100314672","21","89517"
"chr8","100446939","100447199","chr8","100363979","100364242","27","82960"
"chr8","100504054","100504349","chr8","100408061","100408358","30","95993"
"chr8","100645094","100645394","chr8","100562332","100562631","25","82762"
"chr8","100683806","100684089","chr1","155141171","155141450","69","54457365"
"chr8","100836963","100837084","chr3","156434833","156434957","16","55597870"
"chr8","100837113","100837260","chr5","107460686","107460822","39","6623573"
"chr8","100866234","100866351","chr8","100772233","100772348","4","94001"
"chr8","101005586","101005875","chr8","100908496","100908805","40","97090"
"chr8","101027221","101027524","chr8","100930229","100930544","29","96992"
"chr8","101031490","101031765","chr8","100934927","100935202","8","96563"
"chr8","101031968","101032255","chr8","100935409","100935698","21","96559"
"chr8","101033607","101033901","chr8","100937049","100937327","26","96558"
"chr8","101045338","101045570","chr8","100949062","100949296","14","96276"
"chr8","101047422","101047705","chr8","100951167","100951463","36","96255"
"chr8","101076900","101077213","chr8","100978545","100978864","27","98355"
"chr8","101103874","101103998","chr2","44878801","44878925","20","56225073"
"chr8","101141310","101141573","chr8","101037269","101037524","34","104041"
"chr8","101172282","101172410","chr8","101071972","101072103","10","100310"
"chr8","101181313","101181655","chr8","101080887","101081231","26","100426"
"chr8","101197309","101197511","chr7","58944487","58944684","44","42252822"
"chr8","101215804","101215921","chrX","102128051","102128168","14","912247"
"chr8","101230999","101231220","chr8","101130319","101130538","16","100680"
"chr8","101240120","101240219","chr8","101138906","101139007","8","101214"
"chr8","101257475","101257775","chr8","101155180","101155439","56","102295"
"chr8","101259987","101260270","chrX","65751654","65751935","48","35508333"
"chr8","101273726","101273868","chr10","27921275","27921421","29","73352451"
"chr8","101274178","101274365","chr3","178654769","178654948","41","77380591"
"chr8","101280525","101280743","chr8","101178385","101178604","15","102140"
"chr8","101281746","101281871","chr4","158520972","158521093","17","57239226"
"chr8","101296448","101296538","chr8","101194590","101194681","11","101858"
"chr8","101300335","101300625","chr13","107407348","107407632","52","6107013"
"chr8","101301556","101301753","chr8","101198388","101198599","30","103168"
"chr8","101302041","101302169","chr19","17747669","17747796","16","83554372"
"chr8","101303790","101304085","chr3","41391456","41391747","65","59912334"
"chr8","101323636","101323750","chr6","120807239","120807353","20","19483603"
"chr8","101324046","101324222","chr3","41707631","41707811","40","59616415"
"chr8","101328060","101328186","chr8","101225515","101225642","4","102545"
"chr8","101337839","101338133","chr8","101235372","101235653","30","102467"
"chr8","101357729","101358002","chr19","35299256","35299528","52","66058473"
"chr8","101362809","101363113","chr8","101260733","101261028","22","102076"
"chr8","101369673","101369961","chr2","108974420","108974701","59","7604747"
"chr8","101379999","101380307","chr8","101278216","101278503","46","101783"
"chr8","101396865","101397069","chr8","101298367","101298566","20","98498"
"chr8","101408151","101408448","chr7","28113011","28113301","62","73295140"
"chr8","101438643","101438932","chr6","144017468","144017757","58","42578825"
"chr8","101482429","101482729","chr8","101384349","101384643","27","98080"
"chr8","101488260","101488549","chr8","101390052","101390342","14","98208"
"chr8","101496032","101496328","chr8","101397899","101398184","38","98133"
"chr8","101498306","101498599","chr8","101400129","101400432","30","98177"
"chr8","101531274","101531589","chr8","101434759","101435079","27","96515"
"chr8","101537010","101537223","chr3","10246745","10246967","45","91290265"
"chr8","101537225","101537441","chr1","160389426","160389648","60","58852201"
"chr8","101586136","101586445","chr8","101488164","101488472","17","97972"
"chr8","101598454","101598757","chr8","101501134","101501445","31","97320"
"chr8","101600061","101600364","chr8","101502746","101503041","28","97315"
"chr8","101625085","101625239","chr1","153250707","153250848","37","51625622"
"chr8","101628663","101628714","chr8","101541587","101541634","7","87076"
"chr8","101628917","101629034","chr3","125019580","125019695","15","23390663"
"chr8","101639048","101639327","chr8","101554128","101554429","48","84920"
"chr8","101647248","101647526","chr8","101562637","101562896","49","84611"
"chr8","101661568","101661908","chr8","101577512","101577845","37","84056"
"chr8","101693751","101694076","chr8","101614630","101614953","19","79121"
"chr8","101695988","101696294","chr8","101616858","101617185","50","79130"
"chr8","101719902","101719970","chr8","101640605","101640673","2","79297"
"chr8","101721307","101721625","chr7","166082955","166083260","77","64361648"
"chr8","101729978","101730274","chr8","101650793","101651094","38","79185"
"chr8","101745942","101746248","chr8","101670821","101671127","28","75121"
"chr8","101763179","101763342","chr8","101689814","101689974","12","73365"
"chr8","101775207","101775242","chr4","113362604","113362638","6","11587397"
"chr8","101776549","101776764","chr8","101704080","101704298","25","72469"
"chr8","101799185","101799483","chr8","101727791","101728096","33","71394"
"chr8","101818885","101819191","chr8","101745971","101746276","14","72914"
"chr8","101821921","101822234","chr19","36217538","36217862","67","65604383"
"chr8","101834283","101834583","chr8","101759668","101759954","28","74615"
"chr8","101847927","101848049","chr8","101773159","101773279","7","74768"
"chr8","101857714","101858018","chr1","7368800","7369093","54","94488914"
"chr8","101858768","101858928","chr20","21940845","21941005","39","79917923"
"chr8","101861143","101861457","chr8","101786081","101786413","39","75062"
"chr8","101873647","101873957","chr8","101798622","101798918","33","75025"
"chr8","101883104","101883430","chr3","123570746","123571070","62","21687642"
"chr8","101895903","101896174","chr8","101821062","101821333","14","74841"
"chr8","101912684","101912959","chr8","101842447","101842713","48","70237"
"chr8","101988295","101988612","chr8","101919853","101920153","46","68442"
"chr8","102023262","102023569","chr8","101945298","101945606","19","77964"
"chr8","102045345","102045651","chr9","118456767","118457079","55","16411422"
"chr8","102062137","102062347","chr8","101986052","101986235","37","76085"
"chr8","102071127","102071418","chr8","101995127","101995417","14","76000"
"chr8","102073379","102073677","chr8","101997041","101997341","16","76338"
"chr8","102085350","102085537","chr6","143883887","143884079","45","41798537"
"chr8","102121746","102122030","chr8","102045472","102045765","27","76274"
"chr8","102170818","102171104","chr8","102094626","102094915","36","76192"
"chr8","102175465","102175780","chr8","102099246","102099559","21","76219"
"chr8","102229483","102229782","chr8","102153768","102154064","63","75715"
"chr8","102249638","102249907","chr8","102173533","102173803","24","76105"
"chr8","102278904","102279210","chr5","49277173","49277476","60","53001731"
"chr8","102282337","102282495","chr19","8026553","8026714","28","94255784"
"chr8","102288331","102288563","chr8","102207398","102207631","9","80933"
"chr8","102293997","102294295","chr2","188426626","188426924","57","86132629"
"chr8","102301430","102301721","chrX","103046997","103047266","73","745567"
"chr8","102350639","102350812","chr8","102267953","102268109","27","82686"
"chr8","102373526","102373852","chr8","102293052","102293364","29","80474"
"chr8","102394548","102394717","chr19","28091011","28091179","37","74303537"
"chr8","102394744","102394859","chr7","154055978","154056093","20","51661234"
"chr8","102493462","102493746","chr8","102466521","102466805","11","26941"
"chr8","102497183","102497401","chr3","165295251","165295467","52","62798068"
"chr8","102599204","102599492","chr8","102569813","102570107","33","29391"
"chr8","102621135","102621374","chr8","102591281","102591544","32","29854"
"chr8","102630376","102630676","chr8","102599918","102600228","25","30458"
"chr8","102725467","102725560","chr15","4485622","4485717","23","98239845"
"chr8","102730651","102730807","chr8","102707098","102707255","10","23553"
"chr8","102733944","102734247","chr8","102710414","102710710","28","23530"
"chr8","102817991","102818264","chr8","102797882","102798172","36","20109"
"chr8","102820729","102820919","chr8","102800640","102800830","13","20089"
"chr8","102843701","102843988","chr8","102821162","102821451","29","22539"
"chr8","102859958","102860245","chr8","102835283","102835574","23","24675"
"chr8","102898664","102898838","chr2","45846632","45846805","43","57052032"
"chr8","102899149","102899290","chr8","102873981","102874103","43","25168"
"chr8","102901414","102901664","chr13","4217478","4217720","56","98683936"
"chr8","102910453","102910703","chr8","102886155","102886410","16","24298"
"chr8","102982807","102983085","chr8","102959944","102960229","19","22863"
"chr8","103041632","103041935","chr8","103025709","103026019","15","15923"
"chr8","103176464","103176774","chr8","103170909","103171223","22","5555"
"chr8","103220737","103221035","chr8","103215317","103215603","31","5420"
"chr8","103224053","103224314","chr8","103218624","103218885","13","5429"
"chr8","103233821","103234126","chr10","43220606","43220914","62","60013215"
"chr8","103261385","103261685","chrX","15902142","15902434","60","87359243"
"chr8","103498858","103499130","chr8","103488559","103488830","12","10299"
"chr8","103507273","103507586","chr8","103496997","103497290","43","10276"
"chr8","103786629","103786799","chr8","103766661","103766835","10","19968"
"chr8","103809659","103809884","chr8","103788986","103789216","19","20673"
"chr8","104148971","104149215","chr8","104187182","104187420","27","38211"
"chr8","104233164","104233370","chr4","123947702","123947897","61","19714538"
"chr8","104247233","104247525","chr8","104282670","104282974","32","35437"
"chr8","104259677","104259839","chr1","160912081","160912252","40","56652404"
"chr8","104261424","104261722","chr8","104297701","104298000","21","36277"
"chr8","104272164","104272473","chr10","37707166","37707474","62","66564998"
"chr8","104291541","104291654","chr1","31175608","31175721","19","73115933"
"chr8","104291694","104291874","chr5","56463004","56463162","47","47828690"
"chr8","104311353","104311661","chr8","104346236","104346541","14","34883"
"chr8","104326696","104326996","chr2","159920120","159920425","58","55593424"
"chr8","104515376","104515714","chr8","104557776","104558083","59","42400"
"chr8","104707937","104708160","chr8","104737685","104737908","9","29748"
"chr8","104723672","104723948","chr8","104753392","104753682","29","29720"
"chr8","104796755","104797032","chr3","7092558","7092844","67","97704197"
"chr8","104917826","104918107","chr8","104915957","104916263","35","1869"
"chr8","104938276","104938567","chr8","104936194","104936485","20","2082"
"chr8","105124810","105125102","chr8","105117688","105117999","51","7122"
"chr8","105163947","105164174","chr8","105149268","105149493","18","14679"
"chr8","105197310","105197428","chr12","27938949","27939073","28","77258361"
"chr8","105234685","105234995","chr8","105215698","105216011","19","18987"
"chr8","105287094","105287259","chr8","105267255","105267420","15","19839"
"chr8","105292795","105293087","chr8","105272626","105272919","20","20169"
"chr8","105393802","105394118","chr8","105375208","105375532","28","18594"
"chr8","105406997","105407198","chr8","105388423","105388621","14","18574"
"chr8","105444756","105444878","chr8","105426128","105426250","4","18628"
"chr8","105551753","105551803","chr8","101541587","101541634","11","4010166"
"chr8","105833077","105833370","chr8","105892915","105893208","18","59838"
"chr8","105891172","105891262","chr7","97028822","97028914","17","8862350"
"chr8","105891579","105891797","chr15","5304276","5304492","47","100587303"
"chr8","105903110","105903217","chr8","105961118","105961225","9","58008"
"chr8","106068122","106068432","chr8","106122770","106123081","32","54648"
"chr8","106133663","106133944","chr8","106187448","106187731","13","53785"
"chr8","106159123","106159404","chr9","17247450","17247739","67","88911673"
"chr8","106185918","106186229","chr8","106248906","106249216","26","62988"
"chr8","106225240","106225525","chr8","106289416","106289708","18","64176"
"chr8","106289851","106290146","chr8","106351932","106352221","22","62081"
"chr8","106418062","106418259","chr7","39621484","39621685","44","66796578"
"chr8","106579426","106579538","chr15","51369062","51369173","20","55210364"
"chr8","106696884","106697001","chr8","106737212","106737329","5","40328"
"chr8","106812829","106813119","chr8","106846875","106847161","22","34046"
"chr8","106819895","106820085","chr17","71133381","71133569","41","35686514"
"chr8","106820342","106820463","chr11","113373159","113373274","20","6552817"
"chr8","106882566","106882824","chr6","137241244","137241477","69","30358678"
"chr8","106888135","106888258","chr9","59032148","59032269","21","47855987"
"chr8","106929415","106929528","chr8","106948754","106948865","10","19339"
"chr8","106929576","106929754","chr8","106948905","106949082","11","19329"
"chr8","106975294","106975586","chr8","106977532","106977839","36","2238"
"chr8","107000988","107001091","chr7","30059294","30059393","24","76941694"
"chr8","107001119","107001316","chr12","82277360","82277547","55","24723759"
"chr8","107016542","107016838","chr8","107024698","107024992","21","8156"
"chr8","107028121","107028412","chr17","80083884","80084183","64","26944237"
"chr8","107048402","107048731","chr8","107054801","107055116","28","6399"
"chr8","107063862","107064154","chr8","107070604","107070885","32","6742"
"chr8","107069342","107069602","chr8","107076159","107076420","17","6817"
"chr8","107098749","107099009","chr8","107105495","107105759","26","6746"
"chr8","107182539","107182819","chr5","184090450","184090735","49","76907911"
"chr8","107186113","107186294","chrX","93152402","93152581","37","14033711"
"chr8","107197034","107197328","chr10","17312334","17312628","54","89884700"
"chr8","107219931","107219975","chr7","111884822","111884863","11","4664891"
"chr8","107222886","107223166","chr8","107227335","107227614","16","4449"
"chr8","107285144","107285458","chr3","164442156","164442461","66","57157012"
"chr8","107294085","107294365","chr3","39007741","39008023","63","68286344"
"chr8","107345104","107345400","chr8","107347064","107347362","19","1960"
"chr8","107497839","107498128","chr8","107513973","107514246","31","16134"
"chr8","107597856","107597979","chr8","107614658","107614779","12","16802"
"chr8","107687776","107688065","chr8","107699061","107699344","25","11285"
"chr8","107699835","107699977","chr8","107711192","107711334","10","11357"
"chr8","107807760","107807883","chr7","12743103","12743227","23","95064657"
"chr8","107837713","107837990","chr8","107852360","107852635","20","14647"
"chr8","107864582","107864878","chr6","58017234","58017530","53","49847348"
"chr8","107869167","107869313","chrX","117903669","117903812","36","10034502"
"chr8","107870567","107870734","chr1","22363611","22363777","44","85506956"
"chr8","107874785","107875078","chr8","107883119","107883419","24","8334"
"chr8","107928007","107928279","chr8","107936231","107936505","23","8224"
"chr8","107944734","107945036","chr8","107952081","107952385","25","7347"
"chr8","108047577","108047870","chr2","184143766","184144059","53","76096189"
"chr8","108078001","108078131","chr11","50179416","50179546","23","57898585"
"chr8","108155478","108155720","chr14","56607402","56607631","52","51548076"
"chr8","108163092","108163408","chr8","108185601","108185908","23","22509"
"chr8","108193438","108193738","chr3","124049597","124049892","57","15856159"
"chr8","108211000","108211294","chr8","108229614","108229907","36","18614"
"chr8","108300529","108300801","chr8","108321451","108321735","31","20922"
"chr8","108348331","108348454","chr13","95288408","95288530","20","13059923"
"chr8","108355028","108355325","chr8","108375572","108375885","39","20544"
"chr8","108418325","108418616","chr8","108441576","108441867","22","23251"
"chr8","108421115","108421234","chr8","108444391","108444515","22","23276"
"chr8","108421539","108421725","chr8","108444817","108445003","24","23278"
"chr8","108663314","108663602","chr8","108674721","108675014","30","11407"
"chr8","108698261","108698386","chrX","117966032","117966157","23","9267771"
"chr8","108707680","108707986","chr8","108762313","108762621","28","54633"
"chr8","108729677","108729868","chr8","108786033","108786225","8","56356"
"chr8","108731562","108731844","chr8","108788112","108788395","29","56550"
"chr8","108827529","108827819","chr8","108889198","108889490","18","61669"
"chr8","108891907","108892064","chr2","123495148","123495295","35","14603241"
"chr8","108935610","108935910","chr8","108998049","108998360","29","62439"
"chr8","108972662","108972877","chr8","109037691","109037907","20","65029"
"chr8","109103168","109103464","chr8","109165421","109165723","35","62253"
"chr8","109153009","109153299","chr8","109214284","109214565","36","61275"
"chr8","109205046","109205335","chr8","109272702","109273026","61","67656"
"chr8","109714488","109714724","chr19","31804372","31804611","72","77910116"
"chr8","109720703","109720817","chr8","109369400","109369522","20","351303"
"chr8","109755551","109755800","chr8","109405500","109405755","28","350051"
"chr8","109764643","109764931","chr8","109414592","109414881","27","350051"
"chr8","109862088","109862369","chr1","75130836","75131115","64","34731252"
"chr8","109862405","109862430","chrX","48756129","48756153","5","61106276"
"chr8","109913686","109913956","chr8","109560615","109560883","26","353071"
"chr8","110059527","110059649","chr2","44878801","44878925","27","65180726"
"chr8","110060374","110060651","chr8","109776418","109776692","27","283956"
"chr8","110072463","110072622","chr12","21323547","21323703","38","88748916"
"chr8","110072672","110072792","chr8","72245817","72245934","28","37826855"
"chr8","110158932","110159243","chr8","109899268","109899569","35","259664"
"chr8","110279120","110279418","chr3","9506822","9507112","71","100772298"
"chr8","110341355","110341514","chr3","104971579","104971733","39","5369776"
"chr8","110400216","110400534","chr8","110120995","110121325","38","279221"
"chr8","110404415","110404721","chr8","110124905","110125210","35","279510"
"chr8","110505140","110505238","chr8","110201583","110201681","4","303557"
"chr8","110653580","110653709","chr1","52563974","52564104","11","58089606"
"chr8","110691940","110692248","chr8","110428615","110428946","43","263325"
"chr8","110883905","110884194","chr8","110634146","110634447","34","249759"
"chr8","111051579","111051869","chr8","110846471","110846759","48","205108"
"chr8","111090177","111090351","chr8","110885902","110886060","31","204275"
"chr8","111090642","111090723","chr8","110886367","110886457","16","204275"
"chr8","111158456","111158723","chr8","110947874","110948141","13","210582"
"chr8","111161169","111161468","chr8","110945575","110945855","33","215594"
"chr8","111190710","111190982","chr8","111002606","111002886","30","188104"
"chr8","111324289","111324594","chr8","111145207","111145515","37","179082"
"chr8","111334557","111334859","chr8","111154459","111154758","43","180098"
"chr8","111368222","111368509","chr8","111188090","111188393","46","180132"
"chr8","111484140","111484443","chr8","111286283","111286593","32","197857"
"chr8","111496190","111496317","chr8","111298365","111298492","8","197825"
"chr8","111580193","111580483","chr16","17249129","17249404","72","94331064"
"chr8","111590995","111591320","chr8","111396530","111396858","30","194465"
"chr8","111631243","111631551","chr8","111437351","111437657","28","193892"
"chr8","111652937","111653275","chr8","111459529","111459882","78","193408"
"chr8","111687410","111687710","chr8","111495335","111495644","39","192075"
"chr8","111744984","111745204","chr8","111555544","111555747","42","189440"
"chr8","111749843","111750140","chr8","111560433","111560713","40","189410"
"chr8","111802229","111802580","chr4","27522792","27523117","108","84279437"
"chr8","111803348","111803468","chr8","111608688","111608806","14","194660"
"chr8","111818543","111818758","chr3","41305881","41306087","52","70512662"
"chr8","111909039","111909337","chr8","111715147","111715454","27","193892"
"chr8","111909351","111909473","chr3","155384568","155384692","24","43475217"
"chr8","112043800","112044053","chr8","111876942","111877232","67","166858"
"chr8","112469080","112469212","chr8","112328948","112329068","22","140132"
"chr8","112539958","112540074","chr8","112400136","112400252","6","139822"
"chr8","112742219","112742476","chr8","112604057","112604315","21","138162"
"chr8","112753562","112753835","chr8","112614675","112614941","22","138887"
"chr8","112830554","112830858","chr8","112687264","112687535","58","143290"
"chr8","112872205","112872408","chr8","112725497","112725701","9","146708"
"chr8","112932801","112933115","chr7","94050749","94051052","71","18882052"
"chr8","113020173","113020472","chr8","112883805","112884095","32","136368"
"chr8","113078182","113078296","chr8","112937314","112937437","15","140868"
"chr8","113078332","113078477","chr8","112937468","112937608","25","140864"
"chr8","113143019","113143307","chr8","112997229","112997538","40","145790"
"chr8","113236364","113236509","chr3","163992888","163993032","26","50756524"
"chr8","113236561","113236676","chr8","113084291","113084401","11","152270"
"chr8","113295417","113295693","chr8","113136226","113136484","45","159191"
"chr8","113300642","113300934","chr17","77027481","77027764","62","36273161"
"chr8","113303283","113303562","chr14","9095332","9095603","65","104207951"
"chr8","113374219","113374520","chr8","113207126","113207428","28","167093"
"chr8","113453642","113453950","chr8","113277454","113277764","26","176188"
"chr8","113491045","113491384","chr8","113313044","113313408","69","178001"
"chr8","113545151","113545279","chr8","113363803","113363924","15","181348"
"chr8","113565613","113565732","chr8","113392260","113392370","16","173353"
"chr8","113566033","113566205","chr4","8454525","8454703","43","105111508"
"chr8","113631760","113632034","chr8","113452740","113453025","37","179020"
"chr8","113844209","113844523","chr18","1158360","1158673","66","112685849"
"chr8","113884210","113884494","chr3","43308110","43308398","63","70576100"
"chr8","113889118","113889427","chr8","113768812","113769101","49","120306"
"chr8","113926365","113926665","chr8","113851542","113851839","28","74823"
"chr8","113942826","113942956","chr8","113871670","113871801","17","71156"
"chr8","113975879","113976222","chr8","113909228","113909514","74","66651"
"chr8","114030884","114031177","chr8","113961834","113962107","44","69050"
"chr8","114055439","114055726","chr8","114033324","114033612","28","22115"
"chr8","114196893","114197017","chr15","49029242","49029367","16","65167651"
"chr8","114285536","114285852","chr8","114266934","114267250","20","18602"
"chr8","114368077","114368359","chr12","83006376","83006658","51","31361701"
"chr8","114368471","114368747","chrX","44895836","44896116","52","69472635"
"chr8","114409035","114409332","chr8","114394888","114395197","40","14147"
"chr8","114644806","114645101","chr8","114613668","114613955","28","31138"
"chr8","114765034","114765305","chr8","114734345","114734633","33","30689"
"chr8","114815338","114815590","chr8","114786115","114786371","23","29223"
"chr8","114858869","114859155","chr8","114830410","114830689","19","28459"
"chr8","115059638","115059880","chr8","115018361","115018553","67","41277"
"chr8","115089047","115089171","chr8","115047726","115047850","7","41321"
"chr8","115129695","115129946","chr2","95221863","95222119","62","19907832"
"chr8","115164906","115165185","chr9","16857667","16857944","67","98307239"
"chr8","115315480","115315685","chr8","115276980","115277190","21","38500"
"chr8","115580043","115580342","chr8","115540125","115540411","32","39918"
"chr8","115721808","115722105","chr8","115703024","115703317","28","18784"
"chr8","115762737","115762870","chr8","115743120","115743253","4","19617"
"chr8","115763170","115763356","chr8","115743565","115743748","9","19605"
"chr8","115769378","115769676","chr8","115750060","115750373","44","19318"
"chr8","115776666","115776940","chr8","115757497","115757771","21","19169"
"chr8","115777509","115777792","chr8","115758337","115758619","29","19172"
"chr8","115800662","115800932","chr1","17354034","17354313","71","98446628"
"chr8","115803150","115803432","chr8","115784727","115784995","39","18423"
"chr8","115812656","115812953","chr8","115794790","115795086","18","17866"
"chr8","115813568","115813858","chr8","115795709","115796004","21","17859"
"chr8","115826241","115826357","chr8","115807755","115807864","11","18486"
"chr8","115890987","115891272","chr8","115871928","115872231","41","19059"
"chr8","115909324","115909608","chr8","115889623","115889928","37","19701"
"chr8","115958969","115959258","chr8","115938728","115939018","22","20241"
"chr8","116008637","116008928","chr8","115992121","115992408","45","16516"
"chr8","116011419","116011609","chr2","76010457","76010651","44","40000962"
"chr8","116025988","116026252","chr8","116009340","116009579","32","16648"
"chr8","116030455","116030736","chr8","116013796","116014064","31","16659"
"chr8","116073159","116073282","chr8","123829229","123829354","25","7756070"
"chr8","116118930","116119006","chr6","56473083","56473150","21","59645847"
"chr8","116270606","116270908","chr8","116257205","116257516","39","13401"
"chr8","116562074","116562323","chr8","116564633","116564866","37","2559"
"chr8","116585518","116585804","chr8","116587340","116587640","39","1822"
"chr8","116722729","116723016","chr8","116748488","116748790","31","25759"
"chr8","116816694","116816819","chr7","31804546","31804669","23","85012148"
"chr8","116833083","116833392","chr8","116859519","116859827","26","26436"
"chr8","116873679","116873961","chr8","116897707","116897989","17","24028"
"chr8","116905734","116905942","chr8","116932945","116933161","21","27211"
"chr8","116906089","116906161","chr8","116933314","116933381","12","27225"
"chr8","117040593","117040827","chr8","117064656","117064906","35","24063"
"chr8","117057901","117058039","chr8","117082490","117082619","15","24589"
"chr8","117069518","117069646","chr1","53704936","53705059","17","63364582"
"chr8","117080525","117080813","chr8","117104746","117105046","23","24221"
"chr8","117083958","117084269","chr8","117108172","117108484","21","24214"
"chr8","117133926","117134220","chr10","61686481","61686776","62","55447445"
"chr8","117176675","117176820","chr8","117199159","117199311","18","22484"
"chr8","117177101","117177254","chr8","117199624","117199754","30","22523"
"chr8","117182457","117182757","chr8","117205217","117205505","55","22760"
"chr8","117197058","117197368","chr8","117220941","117221211","58","23883"
"chr8","117212303","117212561","chr8","117236364","117236630","35","24061"
"chr8","117243077","117243337","chr8","117267592","117267879","41","24515"
"chr8","117247405","117247689","chr8","117271920","117272203","15","24515"
"chr8","117303962","117304251","chr8","117329659","117329962","43","25697"
"chr8","117316996","117317281","chr17","23688828","23689109","56","93628168"
"chr8","117339490","117339801","chr8","117365675","117365986","20","26185"
"chr8","117352729","117352999","chr8","117379851","117380161","59","27122"
"chr8","117353609","117353913","chr8","117380782","117381087","32","27173"
"chr8","117363307","117363592","chr8","117390530","117390834","40","27223"
"chr8","117374189","117374452","chr1","40364279","40364551","63","77009910"
"chr8","117552122","117552454","chr7","154858974","154859287","70","37306852"
"chr8","117611685","117611980","chr8","117632241","117632525","20","20556"
"chr8","117614176","117614467","chr8","117634705","117635003","23","20529"
"chr8","117616775","117617072","chr8","117637297","117637594","13","20522"
"chr8","117669501","117669749","chr7","106941402","106941653","62","10728099"
"chr8","117683679","117683979","chr8","117702336","117702640","19","18657"
"chr8","117849847","117850077","chr8","117859643","117859901","41","9796"
"chr8","117877784","117878074","chr8","25997476","25997770","61","91880308"
"chr8","117881294","117881566","chr9","13122470","13122738","65","104758824"
"chr8","117898267","117898536","chr8","117909677","117909948","25","11410"
"chr8","117957006","117957323","chr8","117964792","117965075","63","7786"
"chr8","117969034","117969331","chr8","117978588","117978888","40","9554"
"chr8","118236355","118236592","chr8","118227046","118227275","12","9309"
"chr8","118302269","118302557","chr8","118291769","118292049","35","10500"
"chr8","118392007","118392276","chr8","118380391","118380657","20","11616"
"chr8","118403880","118404169","chr8","118392385","118392699","44","11495"
"chr8","118453199","118453453","chr8","118437505","118437788","47","15694"
"chr8","118945652","118945856","chr8","118686340","118686536","15","259312"
"chr8","118990567","118990695","chr8","118730579","118730699","17","259988"
"chr8","119009946","119010212","chr8","118748327","118748606","24","261619"
"chr8","119067044","119067169","chr8","118812749","118812874","10","254295"
"chr8","119095208","119095322","chr14","107332193","107332309","19","11763015"
"chr8","119122255","119122534","chr8","118867437","118867723","26","254818"
"chr8","119147516","119147800","chr8","118893058","118893340","29","254458"
"chr8","119149164","119149455","chr1","45880575","45880862","54","73268589"
"chr8","119164864","119165114","chr11","64067300","64067550","50","55097564"
"chr8","119167341","119167632","chr8","118913918","118914204","14","253423"
"chr8","119230238","119230535","chr8","118980998","118981294","29","249240"
"chr8","119252875","119253195","chr8","119006666","119006981","24","246209"
"chr8","119260417","119260687","chr8","119014015","119014298","31","246402"
"chr8","119260878","119261160","chr15","93885420","93885709","62","25375458"
"chr8","119286355","119286650","chr8","119041119","119041401","40","245236"
"chr8","119292261","119292583","chr8","119047373","119047699","24","244888"
"chr8","119300196","119300484","chr8","119055290","119055593","39","244906"
"chr8","119309824","119310109","chr8","119069366","119069664","32","240458"
"chr8","119320666","119320967","chr8","119080547","119080808","63","240119"
"chr8","119327404","119327696","chr8","119087649","119087949","32","239755"
"chr8","119338673","119338978","chr1","10811316","10811617","58","108527357"
"chr8","119370626","119370915","chr10","25047921","25048219","60","94322705"
"chr8","119435880","119435998","chr20","19039356","19039474","21","100396524"
"chr8","119436019","119436303","chr8","119190783","119191066","18","245236"
"chr8","119460303","119460622","chr8","119218640","119218931","52","241663"
"chr8","119488093","119488206","chr19","49289171","49289285","19","70198922"
"chr8","119604344","119604656","chr7","45450102","45450409","68","74154242"
"chr8","119743924","119744220","chr1","195801657","195801957","56","76057733"
"chr8","119783758","119784091","chr8","119522561","119522860","51","261197"
"chr8","119848040","119848340","chr9","99101491","99101790","56","20746549"
"chr8","119882729","119883034","chr8","119632921","119633242","24","249808"
"chr8","119982140","119982448","chr8","119734372","119734677","31","247768"
"chr8","119984029","119984294","chr3","45262693","45262962","62","74721336"
"chr8","120024694","120024972","chr8","119774993","119775309","53","249701"
"chr8","120040265","120040388","chr8","119791936","119792059","11","248329"
"chr8","120049424","120049707","chr8","119812501","119812787","27","236923"
"chr8","120051283","120051467","chr8","119814371","119814560","19","236912"
"chr8","120051755","120051889","chr8","119814843","119814977","12","236912"
"chr8","120073403","120073727","chr8","119836269","119836593","29","237134"
"chr8","120099746","120100053","chr8","119859459","119859767","18","240287"
"chr8","120123672","120123843","chr16","49370592","49370752","37","70753080"
"chr8","120124088","120124208","chr11","121956782","121956906","25","1832694"
"chr8","120132999","120133303","chr8","119888436","119888759","36","244563"
"chr8","120160393","120160706","chr8","119914727","119915036","18","245666"
"chr8","120200361","120200623","chr13","46558142","46558405","55","73642219"
"chr8","120210745","120211018","chr14","75220310","75220575","65","44990435"
"chr8","120278986","120279288","chr8","120024565","120024866","19","254421"
"chr8","120333759","120334101","chr7","111708037","111708383","73","8625722"
"chr8","120368043","120368223","chr8","18395582","18395763","44","101972461"
"chr8","120451357","120451621","chr14","68590922","68591186","60","51860435"
"chr8","120533210","120533520","chr8","120239502","120239815","29","293708"
"chr8","120694198","120694466","chr8","120406663","120406932","21","287535"
"chr8","120755217","120755513","chr8","120464012","120464302","32","291205"
"chr8","120838434","120838741","chr1","30655457","30655757","58","90182977"
"chr8","120984497","120984783","chr6","136140477","136140767","66","15155980"
"chr8","121003056","121003351","chr8","120714281","120714567","32","288775"
"chr8","121007706","121008021","chr8","120718873","120719209","46","288833"
"chr8","121070871","121071174","chr8","120794820","120795115","46","276051"
"chr8","121115824","121116105","chr8","120839807","120840142","70","276017"
"chr8","121123633","121123912","chr8","120848448","120848728","13","275185"
"chr8","121130445","121130756","chr8","120853768","120854063","31","276677"
"chr8","121136931","121137245","chr8","120861284","120861604","48","275647"
"chr8","121225805","121226102","chr8","120947256","120947565","36","278549"
"chr8","121247744","121248057","chr8","120969131","120969413","54","278613"
"chr8","121392786","121393086","chr8","121122032","121122340","24","270754"
"chr8","121612934","121613123","chr8","121369054","121369231","27","243880"
"chr8","121742137","121742439","chr8","121484120","121484426","17","258017"
"chr8","121776743","121777056","chr14","21340239","21340560","59","100436504"
"chr8","121782983","121783265","chr8","121521628","121521889","33","261355"
"chr8","121792899","121793207","chr8","121531225","121531552","42","261674"
"chr8","121869097","121869329","chr14","22784146","22784375","48","99084951"
"chr8","122042194","122042370","chr8","121790995","121791171","14","251199"
"chr8","122139074","122139383","chr8","121890045","121890353","28","249029"
"chr8","122147031","122147299","chr8","121897998","121898292","44","249033"
"chr8","122151763","122152058","chr8","121902682","121902976","25","249081"
"chr8","122170171","122170481","chr9","110786043","110786351","71","11384128"
"chr8","122391034","122391331","chr8","122149933","122150230","32","241101"
"chr8","122404361","122404663","chr8","122163294","122163600","23","241067"
"chr8","122473551","122473670","chr8","122229047","122229166","5","244504"
"chr8","122481860","122482158","chr1","44516138","44516440","52","77965722"
"chr8","122497338","122497564","chr8","122254057","122254283","24","243281"
"chr8","122499755","122500000","chr8","22085064","22085297","56","100414691"
"chr8","122513821","122513936","chr8","122270699","122270820","18","243122"
"chr8","122555261","122555354","chr8","122314376","122314465","4","240885"
"chr8","122561498","122561818","chrX","14244580","14244891","74","108316918"
"chr8","122584620","122584819","chr2","93979931","93980136","45","28604689"
"chr8","122594178","122594471","chr8","122344226","122344533","27","249952"
"chr8","122625965","122626236","chr8","122373825","122374105","33","252140"
"chr8","122656381","122656508","chr8","122404659","122404783","8","251722"
"chr8","122673476","122673608","chr8","122422147","122422278","12","251329"
"chr8","122673902","122674080","chr2","50498150","50498324","42","72175752"
"chr8","122676498","122676803","chr8","122424845","122425149","25","251653"
"chr8","122692237","122692382","chr8","122439317","122439454","14","252920"
"chr8","122724177","122724477","chr8","122473841","122474135","23","250336"
"chr8","122733448","122733600","chr3","13044305","13044455","29","109689143"
"chr8","122740401","122740695","chr10","33736833","33737139","65","89003568"
"chr8","122790622","122790928","chr6","77260247","77260553","55","45530375"
"chr8","122800470","122800756","chr8","122552878","122553176","29","247592"
"chr8","122823389","122823551","chr3","126621167","126621327","40","3797778"
"chr8","122823844","122824000","chr1","5388921","5389059","39","117434923"
"chr8","122838708","122838879","chr8","122588383","122588561","18","250325"
"chr8","122839186","122839342","chr8","122588854","122588998","18","250332"
"chr8","122843723","122844010","chr8","122593789","122594061","40","249934"
"chr8","122849016","122849284","chr8","122598917","122599185","19","250099"
"chr8","122934623","122934938","chr8","122677915","122678222","25","256708"
"chr8","122939522","122939818","chr8","122682810","122683112","34","256712"
"chr8","122942078","122942366","chr8","122685373","122685657","25","256705"
"chr8","122956911","122957205","chr8","122700012","122700312","24","256899"
"chr8","122994789","122995089","chr8","122738177","122738459","49","256612"
"chr8","123004548","123004841","chr2","184911263","184911558","56","61906715"
"chr8","123029547","123029847","chr8","122774124","122774435","33","255423"
"chr8","123074293","123074599","chr8","122819172","122819464","27","255121"
"chr8","123172632","123172949","chr8","122917763","122918059","40","254869"
"chr8","123182226","123182528","chr8","122927524","122927831","21","254702"
"chr8","123193278","123193469","chr8","122938459","122938659","32","254819"
"chr8","123212630","123212723","chr15","108465059","108465154","26","14747571"
"chr8","123310230","123310486","chr8","123057072","123057328","25","253158"
"chr8","123319917","123320213","chr8","123066862","123067169","35","253055"
"chr8","123322649","123322861","chr8","123069644","123069854","26","253005"
"chr8","123364625","123364899","chr8","123111621","123111890","40","253004"
"chr8","123403992","123404306","chr8","17315066","17315367","74","106088926"
"chr8","123412737","123412977","chr5","145141209","145141446","49","21728472"
"chr8","123454261","123454549","chr8","123209908","123210167","56","244353"
"chr8","123470428","123470721","chr8","123226415","123226708","22","244013"
"chr8","123583250","123583546","chr8","123339489","123339808","46","243761"
"chr8","123596471","123596743","chr8","123352752","123353025","23","243719"
"chr8","123661147","123661463","chr8","123419915","123420215","35","241232"
"chr8","123687892","123688172","chr8","123451342","123451616","24","236550"
"chr8","123707238","123707447","chr8","123473573","123473774","20","233665"
"chr8","123755492","123755837","chr9","64222042","64222375","96","59533450"
"chr8","123846724","123846987","chr5","109550554","109550822","60","14296170"
"chr8","123847341","123847645","chr8","123614584","123614890","27","232757"
"chr8","123859460","123859655","chr8","123624152","123624343","15","235308"
"chr8","123859954","123860054","chr8","123624651","123624753","11","235303"
"chr8","123862028","123862160","chr1","8744078","8744207","23","115117950"
"chr8","123917001","123917230","chr8","123678935","123679150","23","238066"
"chr8","123939823","123940049","chr8","123701605","123701830","22","238218"
"chr8","123953279","123953576","chr8","123713626","123713920","29","239653"
"chr8","123973083","123973359","chr8","123733220","123733492","24","239863"
"chr8","123982332","123982631","chr12","84497573","84497873","68","39484759"
"chr8","123997038","123997168","chr8","123756411","123756541","10","240627"
"chr8","123997292","123997474","chr8","123756663","123756845","22","240629"
"chr8","124007473","124007735","chr8","123767063","123767316","27","240410"
"chr8","124034913","124035234","chr8","123794981","123795296","33","239932"
"chr8","124050741","124051023","chr8","123810680","123810978","48","240061"
"chr8","124069242","124069372","chr8","123829229","123829354","12","240013"
"chr8","124069907","124070036","chr8","123829229","123829354","23","240678"
"chr8","124081934","124082050","chr4","107106477","107106592","15","16975457"
"chr8","124082081","124082234","chr17","55742460","55742616","38","68339621"
"chr8","124083691","124083961","chr8","123843499","123843774","24","240192"
"chr8","124104569","124104871","chr8","123868386","123868703","34","236183"
"chr8","124137434","124137742","chr20","21525221","21525520","62","102612213"
"chr8","124264469","124264694","chr8","124028377","124028602","10","236092"
"chr8","124265910","124266213","chr8","124029827","124030141","31","236083"
"chr8","124287071","124287365","chr8","124053639","124053929","24","233432"
"chr8","124290076","124290379","chr8","124056441","124056744","15","233635"
"chr8","124335927","124336211","chr8","124115495","124115785","23","220432"
"chr8","124392235","124392457","chr1","23426501","23426719","45","100965734"
"chr8","124395869","124396164","chr8","124175264","124175566","21","220605"
"chr8","124403870","124404158","chr13","45053818","45054106","57","79350052"
"chr8","124406240","124406597","chr14","119292935","119293269","80","5113305"
"chr8","124417037","124417326","chr8","124254749","124255035","22","162288"
"chr8","124423197","124423493","chr6","140128245","140128544","55","15705048"
"chr8","124423853","124424153","chr2","160551205","160551504","54","36127352"
"chr8","124431243","124431549","chr8","124265999","124266293","36","165244"
"chr8","124456403","124456729","chr8","124292049","124292373","18","164354"
"chr8","124501649","124501967","chr8","124333148","124333446","36","168501"
"chr8","124531209","124531508","chr8","124363110","124363406","26","168099"
"chr8","124551871","124552079","chr3","124118064","124118255","59","433807"
"chr8","124566285","124566551","chr8","124402746","124403012","12","163539"
"chr8","124568888","124569061","chr11","111382295","111382470","35","13186593"
"chr8","124569374","124569505","chr2","61373245","61373374","31","63196129"
"chr8","124572367","124572680","chrX","96878513","96878823","61","27693854"
"chr8","124659816","124660151","chr8","124490529","124490835","47","169287"
"chr8","124723871","124723993","chr8","124553761","124553884","12","170110"
"chr8","124733420","124733688","chr8","124563127","124563409","26","170293"
"chr8","124742012","124742306","chr2","200415452","200415748","52","75673440"
"chr8","124769376","124769684","chr1","8981776","8982081","60","115787600"
"chr8","124770668","124770953","chr8","124599642","124599912","31","171026"
"chr8","124877415","124877516","chr9","15337716","15337814","19","109539699"
"chr8","124898689","124898983","chr8","124732011","124732314","25","166678"
"chr8","124907917","124908196","chr8","124741547","124741796","60","166370"
"chr8","124986829","124987142","chr8","124822180","124822486","32","164649"
"chr8","124996925","124997213","chr8","124832326","124832624","27","164599"
"chr8","125064304","125064581","chr8","124900436","124900712","20","163868"
"chr8","125096116","125096203","chr1","8232496","8232577","31","116863620"
"chr8","125096230","125096353","chr11","19875355","19875477","24","105220875"
"chr8","125145178","125145273","chr8","124981429","124981528","10","163749"
"chr8","125166807","125167104","chr7","21557750","21558053","52","103609057"
"chr8","125183741","125184003","chr8","125024545","125024816","29","159196"
"chr8","125250398","125250699","chr8","125089807","125090099","28","160591"
"chr8","125279259","125279555","chr8","125125672","125125988","57","153587"
"chr8","125341110","125341178","chr8","125184987","125185058","9","156123"
"chr8","125502853","125502943","chr8","125345342","125345432","5","157511"
"chr8","125512567","125512651","chr8","125355153","125355237","4","157414"
"chr8","125552971","125553241","chr4","156314409","156314679","60","30761438"
"chr8","125699242","125699376","chr8","125558721","125558872","26","140521"
"chr8","125702213","125702509","chr8","125561682","125561990","37","140531"
"chr8","125741791","125742068","chr8","125607253","125607541","30","134538"
"chr8","125809764","125810048","chr1","100754169","100754455","63","25055595"
"chr8","125881916","125882188","chr8","125737627","125737911","29","144289"
"chr8","125885110","125885384","chr8","125747448","125747749","57","137662"
"chr8","125887011","125887118","chrX","23672574","23672681","23","102214437"
"chr8","125919985","125920136","chr8","125790062","125790214","12","129923"
"chr8","125920171","125920189","chr3","30129142","30129159","4","95791029"
"chr8","125922249","125922538","chr8","125792339","125792629","19","129910"
"chr8","125934010","125934124","chr3","39517170","39517285","17","86416840"
"chr8","125950393","125950519","chr8","125826832","125826965","17","123561"
"chr8","125950814","125950990","chr8","125827259","125827439","13","123555"
"chr8","125952039","125952332","chr8","125828478","125828772","19","123561"
"chr8","125957492","125957619","chr14","108538894","108539022","19","17418598"
"chr8","126011082","126011201","chr8","125891509","125891628","11","119573"
"chr8","126016105","126016328","chr5","150925800","150926023","56","24909695"
"chr8","126019044","126019332","chr8","125899445","125899734","22","119599"
"chr8","126021323","126021613","chr8","125901217","125901505","24","120106"
"chr8","126023311","126023440","chr8","125903209","125903333","18","120102"
"chr8","126028990","126029291","chr8","125909593","125909882","36","119397"
"chr8","126066201","126066466","chr1","137723875","137724141","52","11657674"
"chr8","126069107","126069406","chr19","35633077","35633377","69","90436030"
"chr8","126076118","126076401","chr1","53106748","53107031","57","72969370"
"chr8","126181609","126181911","chr8","126075267","126075569","12","106342"
"chr8","126355025","126355304","chr8","126244237","126244527","41","110788"
"chr8","126399225","126399572","chr8","126349317","126349617","80","49908"
"chr8","126520971","126521278","chr8","126459138","126459449","27","61833"
"chr8","126522923","126523164","chr8","126460946","126461191","18","61977"
"chr8","126551944","126552237","chr13","55440018","55440311","58","71111926"
"chr8","126658700","126659020","chr9","54746154","54746466","69","71912546"
"chr8","126705393","126705666","chr6","178966828","178967109","54","52261435"
"chr8","126725079","126725379","chr8","126678337","126678646","23","46742"
"chr8","126929555","126929838","chr8","126879740","126880023","18","49815"
"chr8","126960127","126960423","chr8","126910258","126910518","50","49869"
"chr8","126961052","126961102","chr13","19012667","19012707","14","107948385"
"chr8","126980297","126980581","chr8","126934852","126935134","17","45445"
"chr8","127030293","127030484","chr8","126985645","126985839","16","44648"
"chr8","127071063","127071354","chr8","127026624","127026921","26","44439"
"chr8","127092908","127093208","chr8","127050197","127050492","37","42711"
"chr8","127100879","127101150","chr12","64290410","64290700","72","62810469"
"chr8","127101179","127101300","chr8","127059351","127059448","35","41828"
"chr8","127101535","127101645","chr8","127059736","127059834","20","41799"
"chr8","127112170","127112422","chr8","127069694","127069942","20","42476"
"chr8","127120460","127120513","chr14","19964531","19964585","12","107155929"
"chr8","127128751","127129057","chr8","127087108","127087402","33","41643"
"chr8","127146235","127146512","chr1","115636362","115636647","66","11509873"
"chr8","127146914","127147177","chr8","71255610","71255867","61","55891304"
"chr8","127160596","127160744","chr8","127118795","127118944","10","41801"
"chr8","127161049","127161222","chr8","127119248","127119405","28","41801"
"chr8","127178309","127178600","chr8","127134465","127134766","23","43844"
"chr8","127181143","127181451","chr8","127138966","127139273","17","42177"
"chr8","127181769","127181948","chr13","48458231","48458402","40","78723538"
"chr8","127203248","127203517","chr8","127161626","127161896","10","41622"
"chr8","127205716","127206024","chr20","57286075","57286381","67","69919641"
"chr8","127219977","127220254","chr8","127179759","127180069","51","40218"
"chr8","127235367","127235716","chr5","42141877","42142205","78","85093490"
"chr8","127238291","127238600","chr8","127199299","127199604","28","38992"
"chr8","127253341","127253652","chr8","127214278","127214574","37","39063"
"chr8","127372706","127373006","chr8","127328722","127329027","26","43984"
"chr8","127373493","127373556","chr8","127329530","127329592","5","43963"
"chr8","127374448","127374741","chr8","127330482","127330774","21","43966"
"chr8","127411462","127411763","chr8","127368148","127368464","34","43314"
"chr8","127418897","127419017","chr8","127376878","127376996","13","42019"
"chr8","127423805","127424111","chr8","127381809","127382113","14","41996"
"chr8","127465404","127465710","chr8","127423235","127423524","56","42169"
"chr8","127751939","127752248","chr8","127702707","127703016","31","49232"
"chr8","127762562","127762863","chr8","25337817","25338115","58","102424745"
"chr8","127830513","127830827","chr8","127778881","127779198","44","51632"
"chr8","127852106","127852397","chr8","127800457","127800772","39","51649"
"chr8","127864878","127865038","chr4","13627804","13627964","41","114237074"
"chr8","127977997","127978260","chr1","14264801","14265072","77","113713196"
"chr8","127991967","127992093","chr8","127938119","127938238","15","53848"
"chr8","128021750","128022057","chr8","127963267","127963575","31","58483"
"chr8","128071532","128071823","chr8","128011687","128012007","61","59845"
"chr8","128086524","128086741","chr8","128026650","128026867","29","59874"
"chr8","128310620","128310935","chr11","68656388","68656694","67","59654232"
"chr8","128574696","128574918","chr4","87659306","87659521","51","40915390"
"chr8","128805971","128806092","chr8","128746853","128746976","13","59118"
"chr8","128806105","128806369","chr8","128746991","128747251","18","59114"
"chr8","128830734","128830922","chr9","97029248","97029437","40","31801486"
"chr8","128830986","128831083","chr7","97206538","97206633","20","31624448"
"chr8","128871506","128871779","chr8","128821235","128821516","24","50271"
"chr8","128916833","128917169","chr11","123128489","123128808","79","5788344"
"chr8","128962277","128962405","chr2","44878801","44878925","16","84083476"
"chr8","128968345","128968663","chr8","128916247","128916542","59","52098"
"chr8","129024580","129024861","chr8","128969508","128969787","23","55072"
"chr8","129039344","129039635","chr8","128983693","128983994","38","55651"
"chr8","129043661","129043781","chr8","128988012","128988127","16","55649"
"chr8","129120935","129121056","chr8","129063534","129063653","10","57401"
"chr8","129138740","129139020","chr8","129083272","129083570","35","55468"
"chr8","129174707","129174998","chr1","139686230","139686517","61","10511523"
"chr8","129218427","129218718","chr3","124267629","124267922","60","4950798"
"chr8","129236708","129236822","chr8","129153763","129153878","6","82945"
"chr8","129238627","129238731","chr14","31562664","31562770","19","97675963"
"chr8","129263241","129263356","chr8","129180492","129180608","13","82749"
"chr8","129279795","129280093","chr8","129195259","129195543","37","84536"
"chr8","129293377","129293673","chr8","129208934","129209223","40","84443"
"chr8","129294065","129294301","chr4","160303957","160304185","56","31009892"
"chr8","129336801","129337072","chr2","61516901","61517180","63","67819900"
"chr8","129344986","129345119","chr3","126122510","126122645","21","3222476"
"chr8","129347706","129347999","chr8","129263830","129264106","28","83876"
"chr8","129360581","129360871","chr5","8246617","8246904","59","121113964"
"chr8","129386828","129387138","chr8","129305260","129305581","38","81568"
"chr8","129407329","129407498","chr8","129326350","129326518","21","80979"
"chr8","129431248","129431429","chr8","129349349","129349514","24","81899"
"chr8","129451744","129452086","chr8","129368934","129369243","61","82810"
"chr8","129461574","129461842","chr8","129378620","129378892","20","82954"
"chr8","129463447","129463733","chr8","129380495","129380777","27","82952"
"chr8","129468214","129468377","chr8","129384927","129385088","14","83287"
"chr8","129468673","129468737","chr8","129385392","129385456","5","83281"
"chr8","129480448","129480678","chr8","129403275","129403513","20","77173"
"chr8","129484094","129484381","chr8","129406935","129407221","30","77159"
"chr8","129510699","129510987","chr8","129433118","129433406","14","77581"
"chr8","129527146","129527426","chr8","129453053","129453337","27","74093"
"chr8","129539720","129539983","chr8","129465097","129465352","28","74623"
"chr8","129588759","129589043","chr8","129513917","129514215","28","74842"
"chr8","129594822","129595088","chr8","129519917","129520189","33","74905"
"chr8","129637119","129637405","chr8","129559752","129560035","30","77367"
"chr8","129663881","129664189","chr8","129586729","129587044","17","77152"
"chr8","129948178","129948501","chr8","129621434","129621756","26","326744"
"chr8","130000067","130000215","chr7","84537557","84537711","28","45462510"
"chr8","130000517","130000658","chr1","5388921","5389059","26","124611596"
"chr8","130034417","130034681","chr3","36424130","36424381","57","93610287"
"chr8","130055503","130055569","chr8","129760374","129760440","5","295129"
"chr8","130055876","130056089","chr8","129760748","129760948","26","295128"
"chr8","130067414","130067725","chr7","138266796","138267091","73","8199382"
"chr8","130074503","130074633","chr8","129779613","129779743","5","294890"
"chr8","130102033","130102319","chr8","129433118","129433406","56","668915"
"chr8","130115535","130115773","chr8","129822668","129822908","23","292867"
"chr8","130126117","130126259","chr1","45024808","45024932","39","85101309"
"chr8","130141590","130141889","chr8","129851358","129851664","23","290232"
"chr8","130187726","130187866","chr15","109869590","109869722","28","20318136"
"chr8","130279136","130279451","chr8","130001514","130001804","45","277622"
"chr8","130574710","130575014","chr1","160551781","160552083","58","29977071"
"chr8","130634855","130635141","chr8","130362107","130362399","27","272748"
"chr8","130735114","130735408","chr1","43902169","43902461","64","86832945"
"chr8","131024754","131024871","chrX","2890633","2890748","30","128134121"
"chr8","131134903","131135198","chr8","130826911","130827212","39","307992"
"chr8","131286767","131287062","chr8","130976398","130976708","34","310369"
"chr8","131330896","131331002","chr8","131015933","131016039","6","314963"
"chr8","131492580","131492744","chr8","131175578","131175735","10","317002"
"chr8","131535709","131535998","chr8","131216622","131216911","28","319087"
"chr8","131553019","131553180","chr12","83338561","83338720","37","48214458"
"chr8","131575662","131575957","chr8","131253023","131253303","33","322639"
"chr8","131817124","131817427","chr8","131485314","131485598","47","331810"
"chr8","131849868","131850161","chr8","131517787","131518082","29","332081"
"chr8","131999108","131999413","chr8","131664171","131664470","33","334937"
"chr8","132095586","132095662","chr5","25699893","25699964","20","106395693"
"chr8","132096002","132096162","chr10","27406902","27407056","30","104689100"
"chr8","132308227","132308396","chr2","134840996","134841164","40","2532769"
"chr8","132319452","132319713","chr8","131980236","131980504","30","339216"
"chr8","132330112","132330395","chr19","2507487","2507757","65","129822625"
"chr8","132408540","132408817","chr8","132070386","132070662","21","338154"
"chr8","132462851","132463150","chr8","132124445","132124762","36","338406"
"chr8","132522417","132522706","chr2","54929899","54930190","55","77592518"
"chr8","132675082","132675376","chr8","132343698","132344009","34","331384"
"chr8","132802964","132803092","chr5","5369120","5369247","23","127433844"
"chr8","132811628","132811820","chr3","127824309","127824498","42","4987319"
"chr8","132928331","132928537","chr5","153597130","153597339","44","20668799"
"chr8","132928541","132928647","chr19","42684924","42685033","29","90243617"
"chr8","132954591","132954888","chr8","132628331","132628628","13","326260"
"chr8","132986521","132986819","chr8","132659695","132660000","29","326826"
"chr8","133041226","133041545","chr8","132722925","132723224","52","318301"
"chr8","133061652","133061960","chr19","3962510","3962820","76","129099142"
"chr8","133088859","133089179","chr5","66648071","66648385","41","66440788"
"chr8","133118183","133118327","chr2","88726812","88726967","38","44391371"
"chr8","133164230","133164488","chr10","38948626","38948887","80","94215604"
"chr8","133218983","133219246","chr8","132898108","132898385","26","320875"
"chr8","133222592","133222888","chr8","132901796","132902100","40","320796"
"chr8","133224975","133225257","chr3","40783093","40783379","67","92441882"
"chr8","133272833","133273125","chr8","132951177","132951479","27","321656"
"chr8","133327474","133327811","chr8","133006704","133007017","44","320770"
"chr8","133367967","133368279","chr8","133047419","133047731","29","320548"
"chr8","133378226","133378489","chr8","133057723","133057989","33","320503"
"chr8","133398987","133399286","chr7","152336231","152336532","58","18937244"
"chr8","133443882","133444150","chr12","83658601","83658861","55","49785281"
"chr8","133468123","133468427","chr8","133146414","133146717","26","321709"
"chr8","133484935","133485058","chr8","133163634","133163754","16","321301"
"chr8","133520067","133520324","chr19","46063288","46063550","61","87456779"
"chr8","133597238","133597438","chr8","133287498","133287697","17","309740"
"chr8","133658740","133659074","chr8","133349022","133349334","40","309718"
"chr8","133697996","133698279","chr8","133387869","133388156","22","310127"
"chr8","133731186","133731486","chr6","148689664","148689955","62","14958478"
"chr8","133734324","133734629","chr8","133423942","133424251","20","310382"
"chr8","133778195","133778492","chr8","133465341","133465639","19","312854"
"chr8","133951455","133951750","chr8","133627935","133628229","16","323520"
"chr8","133995455","133995764","chr8","133671957","133672259","24","323498"
"chr8","134058355","134058645","chr8","133733881","133734160","26","324474"
"chr8","134162001","134162058","chr8","4304680","4304730","14","129857321"
"chr8","134168227","134168509","chr8","133848701","133848982","19","319526"
"chr8","134329104","134329409","chr8","134005364","134005651","37","323740"
"chr8","134360908","134361180","chr3","45047058","45047333","57","89313850"
"chr8","134396733","134397078","chr8","134068000","134068344","36","328733"
"chr8","134405084","134405286","chr8","134076455","134076668","21","328629"
"chr8","134410799","134411095","chr8","134082247","134082501","57","328552"
"chr8","134414692","134414964","chr8","134084622","134084895","24","330070"
"chr8","134500256","134500552","chr8","134173272","134173553","36","326984"
"chr8","134523616","134523932","chr8","134198290","134198607","34","325326"
"chr8","134539703","134540008","chr8","134213997","134214312","30","325706"
"chr8","134586069","134586302","chr8","134263895","134264112","29","322174"
"chr8","134587822","134588131","chr8","134265643","134265933","38","322179"
"chr8","134597728","134598038","chr14","21340239","21340560","70","113257489"
"chr8","134606656","134606964","chr13","104018636","104018943","74","30588020"
"chr8","134862944","134863245","chr8","134536010","134536305","30","326934"
"chr8","134872559","134872911","chr8","134545715","134546029","52","326844"
"chr8","135015759","135016043","chr8","134671955","134672241","18","343804"
"chr8","135186005","135186132","chr8","134848382","134848511","14","337623"
"chr8","135192673","135192913","chr2","150851207","150851432","56","15658534"
"chr8","135219368","135219500","chr8","134881029","134881152","15","338339"
"chr8","135219945","135220228","chr8","134881605","134881902","39","338340"
"chr8","135304699","135304825","chr8","134967923","134968051","12","336776"
"chr8","135337230","135337519","chr8","134996150","134996446","35","341080"
"chr8","135518738","135519025","chr8","135165026","135165316","37","353712"
"chr8","135563068","135563371","chr8","135213893","135214197","31","349175"
"chr8","135865293","135865591","chr8","12192316","12192615","59","123672977"
"chr8","135942055","135942347","chr8","135575443","135575732","30","366612"
"chr8","135954216","135954525","chr8","135588432","135588735","58","365784"
"chr8","136027228","136027532","chr8","135657426","135657740","29","369802"
"chr8","136044429","136044680","chr8","135679196","135679463","31","365233"
"chr8","136131042","136131166","chr8","135768177","135768303","14","362865"
"chr8","136224672","136224973","chrX","123667179","123667484","72","12557493"
"chr8","136230489","136230716","chr12","3137975","3138191","51","133092514"
"chr8","137111680","137111961","chr8","136644948","136645226","33","466732"
"chr8","137257324","137257647","chr8","136787716","136788025","37","469608"
"chr8","137880561","137880729","chr20","8901623","8901786","32","128978938"
"chr8","137995854","137996164","chr8","137536559","137536859","30","459295"
"chr8","138034892","138034995","chr7","67847204","67847302","21","70187688"
"chr8","138035024","138035191","chr1","63148358","63148520","45","74886666"
"chr8","138249578","138249747","chr6","163172089","163172253","42","24922511"
"chr8","138253839","138254115","chr8","137754647","137754916","35","499192"
"chr8","138329981","138330260","chr11","120878985","120879268","53","17450996"
"chr8","138350089","138350320","chr8","137850110","137850343","19","499979"
"chr8","138467770","138467998","chr8","137968186","137968409","23","499584"
"chr8","138476486","138476800","chr8","137976819","137977130","44","499667"
"chr8","138808608","138808899","chr8","138278527","138278810","34","530081"
"chr8","138923537","138923807","chr8","138395503","138395774","24","528034"
"chr8","139019516","139019689","chr6","152423795","152423966","31","13404279"
"chr8","139106999","139107289","chr8","138573901","138574206","34","533098"
"chr8","139222417","139222725","chr8","138684378","138684685","35","538039"
"chr8","139493185","139493473","chr8","138981589","138981871","26","511596"
"chr8","139636883","139637152","chr8","139126863","139127132","17","510020"
"chr8","139919948","139920244","chr8","139417513","139417815","23","502435"
"chr8","139966853","139966984","chr8","139467886","139468018","7","498967"
"chr8","139996290","139996552","chr16","69435481","69435747","59","70560809"
"chr8","140044002","140044279","chr8","29021743","29022036","59","111022259"
"chr8","140075585","140075762","chr1","221237138","221237313","42","81161553"
"chr8","140078526","140078826","chr8","139553556","139553862","25","524970"
"chr8","140116194","140116487","chr8","139593696","139594011","40","522498"
"chr8","140156460","140156777","chr8","139628946","139629270","33","527514"
"chr8","140174566","140174648","chr8","139639973","139640060","15","534593"
"chr8","140177972","140178295","chr8","139643246","139643554","56","534726"
"chr8","140195484","140195753","chr1","110194418","110194687","48","30001066"
"chr8","140196034","140196153","chr8","139667799","139667915","5","528235"
"chr8","140196154","140196359","chr8","139667916","139668120","9","528238"
"chr8","140218110","140218394","chr8","139691746","139692013","37","526364"
"chr8","140230030","140230298","chr8","139703865","139704135","26","526165"
"chr8","140250620","140250799","chr1","117748523","117748696","35","22502097"
"chr8","140260164","140260406","chr8","139727556","139727798","18","532608"
"chr8","140261325","140261482","chr13","97087144","97087305","32","43174181"
"chr8","140262053","140262065","chr19","34692802","34692813","4","105569251"
"chr8","140262354","140262574","chr20","42024153","42024345","74","98238201"
"chr8","140294016","140294327","chr8","139764297","139764600","28","529719"
"chr8","140308270","140308542","chr8","139778367","139778608","50","529903"
"chr8","140320568","140320813","chr20","72181115","72181360","60","68139453"
"chr8","140328996","140329293","chr8","139799300","139799600","22","529696"
"chr8","140333721","140333940","chr4","87659306","87659521","40","52674415"
"chr8","140347372","140347505","chr8","139820863","139820996","6","526509"
"chr8","140368435","140368731","chr8","139840960","139841268","39","527475"
"chr8","140383224","140383492","chr8","139855992","139856264","39","527232"
"chr8","140385516","140385733","chr8","139858246","139858445","39","527270"
"chr8","140393268","140393543","chr7","137856198","137856481","61","2537070"
"chr8","140394197","140394486","chr8","139867137","139867437","27","527060"
"chr8","140397780","140397892","chr7","135817817","135817934","25","4579963"
"chr8","140398175","140398419","chr20","19278324","19278572","85","121119851"
"chr8","140416397","140416689","chr20","8590111","8590405","54","131826286"
"chr8","140420251","140420365","chr8","139890471","139890585","5","529780"
"chr8","140444067","140444344","chr8","139913648","139913922","22","530419"
"chr8","140458117","140458427","chr8","139927709","139928008","24","530408"
"chr8","140478082","140478374","chr8","139947048","139947340","21","531034"
"chr8","140522757","140523056","chr8","139996912","139997216","30","525845"
"chr8","140532183","140532374","chr8","140007358","140007552","15","524825"
"chr8","140564231","140564478","chr8","48756908","48757164","64","91807323"
"chr8","140599694","140599964","chr8","140078365","140078639","22","521329"
"chr8","140620683","140620990","chr8","140099003","140099305","21","521680"
"chr8","140624860","140624991","chr1","144265240","144265370","19","3640380"
"chr8","140631146","140631507","chr8","58504583","58504914","111","82126563"
"chr8","140651153","140651446","chr20","10719806","10720100","57","129931347"
"chr8","140652267","140652541","chr15","46562677","46562961","56","94089590"
"chr8","140654472","140654762","chr8","140134143","140134430","32","520329"
"chr8","140690454","140690738","chr5","41182246","41182533","52","99508208"
"chr8","140694751","140694947","chr1","174113725","174113923","57","33418974"
"chr8","140700647","140700944","chr8","140186810","140187094","25","513837"
"chr8","140710419","140710726","chr8","140196849","140197124","53","513570"
"chr8","140715988","140716192","chr13","30070965","30071173","46","110645023"
"chr8","140716980","140717275","chr14","115049792","115050083","54","25667188"
"chr8","140744552","140744860","chr8","140224759","140225070","29","519793"
"chr8","140757130","140757422","chr8","140237579","140237870","15","519551"
"chr8","140784563","140784710","chr8","140264513","140264660","8","520050"
"chr8","140829476","140829747","chr8","140309651","140309890","51","519825"
"chr8","140842224","140842512","chr8","140318284","140318588","30","523940"
"chr8","140865389","140865692","chr8","140342617","140342917","23","522772"
"chr8","140900594","140900888","chr8","140376564","140376855","23","524030"
"chr8","140904098","140904383","chr8","140380002","140380287","19","524096"
"chr8","140911950","140912235","chr8","140388451","140388714","41","523499"
"chr8","140945241","140945407","chr1","212181878","212182031","51","71236637"
"chr8","141005825","141005988","chrX","104179297","104179437","46","36826528"
"chr8","141013608","141013883","chr8","140493494","140493754","35","520114"
"chr8","141028524","141028643","chr8","140505140","140505256","13","523384"
"chr8","141075456","141075667","chr8","140554084","140554288","21","521372"
"chr8","141089345","141089647","chr3","124467614","124467917","58","16621731"
"chr8","141241601","141241947","chr8","140726885","140727224","35","514716"
"chr8","141287965","141288276","chr8","140774627","140774932","22","513338"
"chr8","141381167","141381491","chr8","140873906","140874217","41","507261"
"chr8","141704508","141704792","chr8","141187139","141187446","60","517369"
"chr8","141723857","141724135","chr8","141206658","141206936","23","517199"
"chr8","141958049","141958339","chr8","141439501","141439791","23","518548"
"chr8","142025483","142025607","chr8","141508383","141508506","12","517100"
"chr8","142124502","142124804","chr8","141613504","141613792","29","510998"
"chr8","142156836","142157057","chr1","124972721","124972938","62","17184115"
"chr8","142179828","142179951","chr8","141666550","141666673","10","513278"
"chr8","142242235","142242532","chr2","160551205","160551504","53","18308970"
"chr8","142358212","142358337","chr8","141856854","141856978","10","501358"
"chr8","142393380","142393687","chr14","60276218","60276526","68","82117162"
"chr8","142416397","142416697","chr7","43264613","43264913","60","99151784"
"chr8","142418874","142419164","chr8","141922519","141922816","31","496355"
"chr8","142427685","142427944","chr8","141931690","141931944","22","495995"
"chr8","142474342","142474608","chr8","141979343","141979598","22","494999"
"chr8","142568997","142569294","chr8","142082898","142083221","42","486099"
"chr8","142679704","142679992","chr15","109974836","109975130","62","32704868"
"chr8","142793969","142794262","chr8","142284161","142284451","20","509808"
"chr8","142811262","142811381","chr11","110654980","110655102","19","32156282"
"chr8","142865802","142865971","chr3","35498090","35498256","33","107367712"
"chr8","142865997","142866116","chr7","43655643","43655763","18","99210354"
"chr8","142916063","142916189","chr8","142397344","142397467","12","518719"
"chr8","142935022","142935303","chr8","142417021","142417304","25","518001"
"chr8","142963737","142964043","chr8","142445215","142445499","42","518522"
"chr8","142996005","142996296","chr8","142471480","142471788","39","524525"
"chr8","143025906","143026033","chr8","142496660","142496788","8","529246"
"chr8","143058797","143059082","chr16","49265995","49266270","66","93792802"
"chr8","143060941","143061226","chr8","142533544","142533835","41","527397"
"chr8","143064343","143064470","chr3","40637514","40637640","24","102426829"
"chr8","143080689","143080912","chr8","20149077","20149310","60","122931612"
"chr8","143104785","143104876","chr5","2692174","2692258","34","140412611"
"chr8","143105325","143105451","chrX","2264384","2264523","31","140840941"
"chr8","143118651","143118912","chr8","142597538","142597799","23","521113"
"chr8","143119141","143119448","chr8","142598028","142598339","32","521113"
"chr8","143123126","143123424","chr20","34220772","34221074","59","108902354"
"chr8","143123504","143123641","chr8","142602341","142602479","9","521163"
"chr8","143123932","143124109","chr8","142602779","142602955","12","521153"
"chr8","143180054","143180367","chr3","50160004","50160296","63","93020050"
"chr8","143211055","143211324","chr8","142700042","142700300","31","511013"
"chr8","143222388","143222679","chr8","142711549","142711838","26","510839"
"chr8","143223369","143223662","chr8","142712517","142712810","21","510852"
"chr8","143290690","143290978","chr15","43687639","43687935","54","99603051"
"chr8","143332767","143332963","chr8","142820022","142820211","23","512745"
"chr8","143390793","143390927","chr3","44124652","44124790","32","99266141"
"chr8","143391225","143391389","chr12","21323547","21323703","27","122067678"
"chr8","143414202","143414495","chr8","142910221","142910530","40","503981"
"chr8","143414815","143415112","chr17","80083884","80084183","62","63330931"
"chr8","143423430","143423716","chr8","142918920","142919202","18","504510"
"chr8","143453067","143453364","chr8","142932607","142932901","28","520460"
"chr8","143454189","143454267","chr11","1488195","1488269","10","141965994"
"chr8","143497216","143497469","chr8","142983256","142983516","33","513960"
"chr8","143512607","143512919","chr14","20030401","20030708","64","123482206"
"chr8","143527742","143527990","chr8","143017049","143017297","18","510693"
"chr8","143535272","143535557","chr8","143025493","143025778","17","509779"
"chr8","143565057","143565146","chr8","143063530","143063616","12","501527"
"chr8","143611627","143611929","chr2","123645573","123645863","38","19966054"
"chr8","143617375","143617713","chr4","27191661","27191993","76","116425714"
"chr8","143658327","143658617","chr15","25409622","25409907","58","118248705"
"chr8","143714258","143714552","chr9","109131689","109131984","59","34582569"
"chr8","143757689","143757857","chr15","13634375","13634549","40","130123314"
"chr8","143758155","143758279","chr8","143257928","143258046","13","500227"
"chr8","143762347","143762563","chr1","125993819","125994042","53","17768528"
"chr8","143799996","143800121","chr1","64990576","64990704","40","78809420"
"chr8","143833220","143833519","chr8","143310202","143310508","28","523018"
"chr8","143859540","143859715","chr15","8429087","8429254","28","135430453"
"chr8","143860008","143860035","chr12","2610286","2610315","6","141249722"
"chr8","143881752","143881884","chr4","42994812","42994941","33","100886940"
"chr8","143901242","143901530","chr8","143383159","143383449","18","518083"
"chr8","143921893","143922033","chr8","143403702","143403849","15","518191"
"chr8","143922327","143922476","chr8","143404140","143404289","9","518187"
"chr8","143942713","143943021","chr8","143429705","143430011","22","513008"
"chr8","143955321","143955604","chrX","19238064","19238349","56","124717257"
"chr8","143976865","143977023","chr8","143465555","143465732","29","511310"
"chr8","143980961","143981240","chr1","146365442","146365728","54","2384481"
"chr8","143981254","143981512","chr20","20219234","20219493","59","123762020"
"chr8","144038406","144038440","chr4","161529528","161529566","8","17491122"
"chr8","144038471","144038630","chr1","53225263","53225421","28","90813208"
"chr8","144055845","144056095","chr2","61275500","61275760","60","82780345"
"chr8","144122462","144122561","chr3","125312955","125313048","24","18809507"
"chr8","144122869","144123061","chr3","43682713","43682905","42","100440156"
"chr8","144164093","144164269","chr6","152423795","152423966","42","8259702"
"chr8","144164592","144164716","chr8","143653758","143653877","11","510834"
"chr8","144305667","144305980","chr8","143826313","143826626","30","479354"
"chr8","144316989","144317289","chr8","143838705","143839030","77","478284"
"chr8","144319589","144319779","chr3","41266668","41266852","47","103052921"
"chr8","144327885","144328020","chr8","38103837","38103971","23","106224048"
"chr8","144328336","144328457","chr11","74789043","74789171","35","69539293"
"chr8","144357741","144358026","chr8","143878882","143879184","50","478859"
"chr8","144390629","144390932","chr3","166025954","166026259","68","21635325"
"chr8","144419270","144419573","chr8","143935673","143935965","30","483597"
"chr8","144461843","144462116","chr8","143984904","143985193","47","476939"
"chr8","144467688","144467974","chr8","143990711","143991001","31","476977"
"chr8","144476864","144477147","chr8","144000524","144000783","37","476340"
"chr8","144479044","144479213","chr5","63789544","63789715","39","80689500"
"chr8","144485188","144485300","chr8","144008221","144008340","12","476967"
"chr8","144497140","144497438","chr8","144021426","144021717","37","475714"
"chr8","144500456","144500749","chr8","144025162","144025451","18","475294"
"chr8","144532955","144533264","chr8","144058174","144058477","28","474781"
"chr8","144541672","144541747","chr8","144066630","144066703","3","475042"
"chr8","144554676","144554987","chr1","21062875","21063179","53","123491801"
"chr8","144589496","144589801","chr8","144115995","144116300","17","473501"
"chr8","144608253","144608414","chr2","173203245","173203398","41","28594992"
"chr8","144639260","144639519","chr2","29298724","29298985","65","115340536"
"chr8","144656470","144656763","chr8","144176536","144176824","20","479934"
"chr8","144657886","144658155","chr8","144177924","144178198","24","479962"
"chr8","144690773","144691044","chr8","144207856","144208126","30","482917"
"chr8","144700070","144700346","chrX","23374584","23374854","61","121325486"
"chr8","144708197","144708319","chr8","144224099","144224220","12","484098"
"chr9","16252719","16252979","chr15","68013647","68013937","52","51760928"
"chr9","19005319","19005605","chr11","124122142","124122422","55","105116823"
"chr9","114163684","114163798","chr20","23813948","23814064","18","90349736"
"chr9","130416603","130416905","chrX","126328105","126328399","56","4088498"
"chr9","182486","182701","chr15","84419769","84419988","12","84237283"
"chr9","187468","187749","chr15","84414347","84414628","17","84226879"
"chr9","232337","232617","chr15","84356551","84356844","37","84124214"
"chr9","245038","245329","chr15","84343588","84343880","13","84098550"
"chr9","263136","263444","chr11","109624796","109625101","57","109361660"
"chr9","268458","268735","chr7","127802025","127802307","64","127533567"
"chr9","288609","288941","chr15","84300288","84300626","33","84011679"
"chr9","304737","305018","chr15","84287764","84288046","20","83983027"
"chr9","315999","316294","chr15","84276372","84276681","33","83960373"
"chr9","332535","332801","chr15","84258281","84258547","14","83925746"
"chr9","340523","340815","chr3","40206060","40206351","57","39865537"
"chr9","346769","347071","chr15","84244067","84244380","28","83897298"
"chr9","357141","357448","chr15","84234062","84234363","49","83876921"
"chr9","362698","362980","chr15","84228173","84228467","32","83865475"
"chr9","371523","371821","chr9","99101491","99101790","60","98729968"
"chr9","407098","407247","chr15","84136002","84136134","27","83728904"
"chr9","429523","429830","chr7","140100928","140101221","68","139671405"
"chr9","473119","473405","chr15","84060730","84061024","44","83587611"
"chr9","489802","489993","chrX","4057388","4057588","41","3567586"
"chr9","492176","492482","chr15","84040532","84040856","40","83548356"
"chr9","508897","509028","chr8","71179092","71179225","17","70670195"
"chr9","513080","513370","chr15","84019414","84019705","25","83506334"
"chr9","521380","521677","chr15","84011142","84011435","32","83489762"
"chr9","525677","525971","chr17","81348456","81348750","54","80822779"
"chr9","534395","534687","chr3","177676366","177676657","46","177141971"
"chr9","553330","553497","chr3","41029820","41029993","35","40476490"
"chr9","553739","553872","chr3","47682607","47682736","21","47128868"
"chr9","577884","578189","chr15","83957321","83957626","21","83379437"
"chr9","597193","597462","chr15","83937743","83938019","22","83340550"
"chr9","611865","612087","chr1","30901256","30901477","45","30289391"
"chr9","615360","615642","chr15","83919849","83920150","43","83304489"
"chr9","627882","628010","chr15","83907759","83907888","11","83279877"
"chr9","818927","819217","chr15","83734799","83735106","47","82915872"
"chr9","821605","821889","chr15","83732157","83732450","37","82910552"
"chr9","826141","826450","chr20","42042273","42042584","51","41216132"
"chr9","828917","829047","chr13","43783878","43783984","37","42954961"
"chr9","831032","831254","chr15","83721875","83722080","39","82890843"
"chr9","840658","840946","chr15","83709572","83709867","24","82868914"
"chr9","841985","842123","chr15","83707103","83707236","13","82865118"
"chr9","842421","842585","chr15","83706626","83706794","9","82864205"
"chr9","858482","858776","chr20","58214912","58215201","57","57356430"
"chr9","865610","865912","chr15","83685959","83686248","30","82820349"
"chr9","879652","879950","chr6","107165254","107165549","64","106285602"
"chr9","886689","886981","chr15","83665176","83665476","28","82778487"
"chr9","903406","903702","chr15","83648815","83649094","41","82745409"
"chr9","911760","912049","chr15","83639953","83640239","31","82728193"
"chr9","919928","920260","chr15","83631681","83631977","51","82711753"
"chr9","925271","925460","chr1","189160630","189160823","46","188235359"
"chr9","937945","938126","chr15","83613278","83613438","28","82675333"
"chr9","952660","952936","chr1","94156764","94157033","83","93204104"
"chr9","1013392","1013677","chr15","83535169","83535470","42","82521777"
"chr9","1062351","1062719","chr15","83486805","83487171","35","82424454"
"chr9","1075329","1075539","chr15","83474289","83474503","13","82398960"
"chr9","1118202","1118485","chr15","83433031","83433313","17","82314829"
"chr9","1128719","1129012","chr15","83422609","83422907","28","82293890"
"chr9","1208637","1208939","chr15","83355662","83355969","17","82147025"
"chr9","1216561","1216688","chr15","83348065","83348192","10","82131504"
"chr9","1224154","1224420","chr6","72106273","72106537","62","70882119"
"chr9","1274812","1274887","chr12","114665945","114666020","18","113391133"
"chr9","1274928","1275096","chr19","5693782","5693937","41","4418854"
"chr9","1361557","1361869","chr15","83195188","83195487","61","81833631"
"chr9","1428506","1428805","chr15","83135595","83135897","34","81707089"
"chr9","1639133","1639430","chr15","82935957","82936254","15","81296824"
"chr9","1807235","1807319","chr1","119288424","119288508","23","117481189"
"chr9","1917692","1917957","chr15","82659346","82659611","20","80741654"
"chr9","2022951","2023244","chr15","82551746","82552043","20","80528795"
"chr9","2129295","2129581","chr15","82442684","82442987","41","80313389"
"chr9","2144424","2144589","chr15","82384123","82384289","12","80239699"
"chr9","2149114","2149417","chr11","68178189","68178486","65","66029075"
"chr9","2183079","2183368","chr15","82345244","82345535","26","80162165"
"chr9","2199974","2200275","chr15","82328842","82329151","29","80128868"
"chr9","2231260","2231569","chr15","82298746","82299055","42","80067486"
"chr9","2245856","2246062","chr15","82284244","82284450","17","80038388"
"chr9","2323304","2323566","chr15","82209623","82209886","12","79886319"
"chr9","2410994","2411128","chr15","82119548","82119682","6","79708554"
"chr9","2465421","2465689","chr15","82065685","82065943","33","79600264"
"chr9","2465693","2465810","chr15","82065564","82065681","7","79599871"
"chr9","2565046","2565341","chr15","81961842","81962138","17","79396796"
"chr9","2605892","2606151","chr12","61776548","61776809","64","59170656"
"chr9","2655804","2655942","chr15","81869644","81869781","2","79213840"
"chr9","2682842","2683136","chr4","2519086","2519378","59","163756"
"chr9","2729708","2729905","chr15","81797119","81797342","41","79067411"
"chr9","2759788","2760056","chr15","81766075","81766343","42","79006287"
"chr9","2777076","2777350","chr13","3372643","3372929","68","595567"
"chr9","2801060","2801363","chr14","10605997","10606297","57","7804937"
"chr9","2821786","2822083","chr15","81695849","81696144","23","78874063"
"chr9","2828882","2829180","chr15","81688540","81688830","33","78859658"
"chr9","2843073","2843205","chr15","81672501","81672635","5","78829428"
"chr9","2848913","2849203","chrX","40874514","40874798","59","38025601"
"chr9","2865449","2865748","chr13","87444010","87444299","63","84578561"
"chr9","2884207","2884482","chr15","81634407","81634681","17","78750200"
"chr9","2902835","2903121","chr3","39007741","39008023","70","36104906"
"chr9","2912344","2912470","chr15","81612883","81613011","18","78700539"
"chr9","2947939","2948055","chr20","31966306","31966423","15","29018367"
"chr9","2969772","2969819","chr15","81555496","81555543","0","78585724"
"chr9","3145749","3146041","chr15","81376650","81376959","32","78230901"
"chr9","3353462","3353544","chr15","81162932","81163014","7","77809470"
"chr9","3413953","3414090","chr15","81100744","81100886","19","77686791"
"chr9","3447112","3447399","chr15","81068828","81069109","24","77621716"
"chr9","3450885","3451149","chr15","81065047","81065311","15","77614162"
"chr9","3473352","3473663","chrX","64991673","64991978","56","61518321"
"chr9","3483319","3483633","chr15","81032247","81032590","72","77548928"
"chr9","3511710","3511959","chr15","81004081","81004330","20","77492371"
"chr9","3517911","3518198","chr15","80998219","80998524","48","77480308"
"chr9","3527753","3528059","chr15","80988333","80988639","24","77460580"
"chr9","3530106","3530359","chr15","80985996","80986240","29","77455890"
"chr9","3542045","3542253","chr14","30262847","30263066","77","26720802"
"chr9","3688625","3688850","chr3","41589467","41589690","49","37900842"
"chr9","3705335","3705492","chr7","80140173","80140333","32","76434838"
"chr9","3852359","3852646","chr15","80646417","80646709","23","76794058"
"chr9","3890829","3891116","chr15","80608688","80608975","20","76717859"
"chr9","3909610","3909901","chr2","158996852","158997141","67","155087242"
"chr9","3960943","3961269","chr15","80538291","80538611","46","76577348"
"chr9","4103466","4103749","chr15","80396689","80396958","61","76293223"
"chr9","4104982","4105283","chr15","80395159","80395459","19","76290177"
"chr9","4175047","4175371","chr14","5926151","5926480","79","1751104"
"chr9","4245877","4246190","chr15","80260542","80260853","24","76014665"
"chr9","4286861","4287139","chr15","80219751","80220054","44","75932890"
"chr9","4289022","4289302","chr15","80217613","80217902","30","75928591"
"chr9","4294184","4294474","chr15","80213068","80213331","41","75918884"
"chr9","4364008","4364304","chr15","80142942","80143225","36","75778934"
"chr9","4466070","4466387","chr15","80035969","80036286","15","75569899"
"chr9","4467766","4468052","chr15","80034282","80034577","33","75566516"
"chr9","4478426","4478718","chr15","80019494","80019796","26","75541068"
"chr9","4483863","4483971","chr15","80013896","80014014","16","75530033"
"chr9","4484013","4484183","chr15","80013671","80013844","17","75529658"
"chr9","4507844","4508115","chr15","79991604","79991877","18","75483760"
"chr9","4508809","4509105","chr5","153198809","153199105","58","148690000"
"chr9","4517518","4517808","chr15","79982690","79982979","23","75465172"
"chr9","4547248","4547356","chr15","79953330","79953438","4","75406082"
"chr9","4571287","4571567","chr15","79934801","79935083","21","75363514"
"chr9","4589302","4589581","chr15","79917370","79917633","38","75328068"
"chr9","4608433","4608730","chr15","79897286","79897577","38","75288853"
"chr9","4608923","4609224","chr15","79896796","79897092","25","75287873"
"chr9","4625383","4625506","chr15","79880579","79880702","3","75255196"
"chr9","4632840","4632972","chr9","28925694","28925823","36","24292854"
"chr9","4632973","4633235","chr19","25592605","25592869","57","20959632"
"chr9","4664999","4665284","chr15","79844187","79844476","34","75179188"
"chr9","4674520","4674634","chr2","42497705","42497821","19","37823185"
"chr9","4694009","4694298","chr15","79819233","79819522","14","75125224"
"chr9","4707291","4707590","chr15","79805400","79805697","16","75098109"
"chr9","4715075","4715233","chr15","79797772","79797914","23","75082697"
"chr9","4715373","4715675","chr15","79797307","79797615","17","75081934"
"chr9","4730510","4730793","chr15","79783023","79783305","21","75052513"
"chr9","4737255","4737552","chr15","79777352","79777636","38","75040097"
"chr9","4749998","4750118","chr15","79764412","79764531","15","75014414"
"chr9","4750782","4751082","chr15","79763554","79763861","34","75012772"
"chr9","4753158","4753466","chr15","79761185","79761457","60","75008027"
"chr9","4754112","4754359","chr15","79760298","79760544","22","75006186"
"chr9","4756343","4756457","chr4","68769437","68769549","19","64013094"
"chr9","4768409","4768697","chr20","26445288","26445555","70","21676879"
"chr9","4776960","4777262","chr15","79735832","79736135","15","74958872"
"chr9","4779260","4779545","chr15","79733551","79733833","32","74954291"
"chr9","4785071","4785326","chr15","79727646","79727900","19","74942575"
"chr9","4785882","4785998","chr15","79726960","79727074","10","74941078"
"chr9","4792786","4793068","chr15","79719554","79719857","31","74926768"
"chr9","4793471","4793660","chr15","79718957","79719146","11","74925486"
"chr9","4797926","4798203","chr15","79714789","79715072","17","74916863"
"chr9","4799404","4799620","chr1","95784420","95784633","41","90985016"
"chr9","4817328","4817624","chr15","79698120","79698424","24","74880792"
"chr9","4822073","4822379","chr16","67871463","67871758","68","63049390"
"chr9","4831517","4831739","chr15","79687573","79687793","24","74856056"
"chr9","4841530","4841652","chr13","88186895","88187018","23","83345365"
"chr9","4842926","4843221","chr15","79676929","79677211","32","74834003"
"chr9","4851869","4852071","chr15","79668034","79668238","19","74816165"
"chr9","4887556","4887596","chr14","52645848","52645891","8","47758292"
"chr9","4890406","4890707","chr17","24307072","24307369","58","19416666"
"chr9","4898473","4898761","chr1","211215809","211216098","60","206317336"
"chr9","4924734","4925031","chr14","122733616","122733911","49","117808882"
"chr9","4934770","4935077","chr15","79587495","79587799","21","74652725"
"chr9","4949611","4949706","chr9","49122527","49122619","23","44172916"
"chr9","4950062","4950376","chr15","79578492","79578801","26","74628430"
"chr9","4968134","4968434","chr15","79560595","79560865","45","74592461"
"chr9","4981690","4982003","chr15","79548964","79549264","35","74567274"
"chr9","5027389","5027695","chrX","30604149","30604445","54","25576760"
"chr9","5032229","5032524","chr15","79494084","79494374","30","74461855"
"chr9","5033686","5033939","chr15","79492677","79492930","11","74458991"
"chr9","5069763","5070069","chr15","79452505","79452807","25","74382742"
"chr9","5072487","5072748","chr15","79448761","79449037","37","74376274"
"chr9","5190054","5190315","chr15","79323974","79324242","41","74133920"
"chr9","5244604","5244900","chr15","79228328","79228619","32","73983724"
"chr9","5433143","5433342","chr13","75616065","75616265","40","70182922"
"chr9","5455719","5455837","chr1","184535369","184535484","22","179079650"
"chr9","5530368","5530655","chr15","78920736","78921016","25","73390368"
"chr9","5532310","5532608","chr19","35633077","35633377","55","30100767"
"chr9","5569598","5569890","chr3","124267629","124267922","44","118698031"
"chr9","5589094","5589390","chr15","78863810","78864116","25","73274716"
"chr9","5639741","5640014","chr5","139756441","139756723","59","134116700"
"chr9","5649848","5650073","chr15","78803834","78804063","21","73153986"
"chr9","5707978","5708272","chr15","78740070","78740370","32","73032092"
"chr9","5771582","5771879","chr19","46007915","46008205","57","40236333"
"chr9","5800347","5800630","chr15","78637035","78637340","35","72836688"
"chr9","5809721","5810028","chr15","78627070","78627373","36","72817349"
"chr9","5811279","5811395","chr15","78625235","78625356","15","72813956"
"chr9","5821724","5822031","chr10","73016951","73017260","60","67195227"
"chr9","5841244","5841541","chr15","78594869","78595158","35","72753625"
"chr9","5863626","5863857","chr11","120676371","120676596","58","114812745"
"chr9","5865036","5865329","chr15","78570638","78570935","20","72705602"
"chr9","5865336","5865643","chr15","78570324","78570631","9","72704988"
"chr9","5871445","5871753","chr15","78564444","78564752","13","72692999"
"chr9","5876046","5876355","chr15","78559703","78560014","29","72683657"
"chr9","5877908","5878200","chr7","128570799","128571088","59","122692891"
"chr9","5885792","5886105","chr15","78552230","78552526","34","72666438"
"chr9","5926240","5926447","chr15","78507760","78507969","12","72581520"
"chr9","6031321","6031505","chr15","78402368","78402546","26","72371047"
"chr9","6066396","6066605","chr15","78365754","78365959","21","72299358"
"chr9","6071539","6071828","chr15","78360562","78360846","22","72289023"
"chr9","6107880","6108150","chr15","78329091","78329361","14","72221211"
"chr9","6123771","6124056","chr15","78281477","78281762","17","72157706"
"chr9","6158799","6158955","chr15","78263018","78263167","14","72104219"
"chr9","6158983","6159122","chr15","78262839","78262981","12","72103856"
"chr9","6208820","6209046","chr19","5642965","5643188","49","565855"
"chr9","6213249","6213533","chr15","78201164","78201445","19","71987915"
"chr9","6218480","6218795","chr15","78195606","78195924","27","71977126"
"chr9","6227517","6227818","chr15","78186596","78186913","30","71959079"
"chr9","6241065","6241366","chr15","78167381","78167696","26","71926316"
"chr9","6297673","6297800","chr15","78121918","78122046","7","71824245"
"chr9","6313560","6313684","chr15","78096847","78096971","4","71783287"
"chr9","6314360","6314642","chr4","7575359","7575618","77","1260999"
"chr9","6337720","6338041","chr15","78075245","78075564","23","71737525"
"chr9","6426884","6427150","chr15","78004364","78004639","22","71577480"
"chr9","6455186","6455482","chr15","77976698","77976995","34","71521512"
"chr9","6479668","6479965","chr8","119069366","119069664","74","112589698"
"chr9","6503148","6503417","chr15","77921491","77921759","23","71418343"
"chr9","6519095","6519227","chr2","136103432","136103559","21","129584337"
"chr9","6537695","6537932","chr3","36424130","36424381","52","29886435"
"chr9","6542506","6542780","chr15","77886818","77887087","24","71344312"
"chr9","6572602","6572883","chr15","77854963","77855249","34","71282361"
"chr9","6582836","6583138","chr4","159565684","159565981","67","152982848"
"chr9","6585245","6585391","chr8","31559018","31559164","40","24973773"
"chr9","6587011","6587139","chr15","77834900","77835018","14","71247889"
"chr9","6604735","6605020","chr15","77817473","77817756","28","71212738"
"chr9","6621322","6621611","chr15","77801706","77802006","38","71180384"
"chr9","6647937","6648234","chr15","77775945","77776229","44","71128008"
"chr9","6648610","6648741","chr15","77775444","77775575","6","71126834"
"chr9","6650538","6650663","chr15","77773537","77773667","15","71122999"
"chr9","6661523","6661691","chr14","7002991","7003156","35","341468"
"chr9","6668528","6668828","chr20","24010200","24010492","55","17341672"
"chr9","6679958","6680161","chr15","77734506","77734714","11","71054548"
"chr9","6685071","6685235","chr3","40421992","40422160","36","33736921"
"chr9","6685547","6685672","chr3","178269661","178269783","25","171584114"
"chr9","6712516","6712646","chr17","19750361","19750492","26","13037845"
"chr9","6733347","6733484","chr15","77684192","77684330","11","70950845"
"chr9","6737929","6738026","chr13","48647277","48647379","28","41909348"
"chr9","6765987","6766156","chr6","68146972","68147145","35","61380985"
"chr9","6824438","6824731","chr7","140588016","140588306","57","133763578"
"chr9","6830403","6830687","chr15","77581304","77581583","28","70750901"
"chr9","6870136","6870272","chr15","77534758","77534895","10","70664622"
"chr9","6883193","6883387","chr15","77523153","77523347","8","70639960"
"chr9","6893018","6893183","chr15","77513042","77513210","17","70620024"
"chr9","6899419","6899716","chr16","1786474","1786763","53","5112945"
"chr9","6902499","6902600","chr15","77502851","77502963","15","70600352"
"chr9","6921431","6921720","chr15","77485776","77486069","32","70564345"
"chr9","6946443","6946560","chr20","36194671","36194790","25","29248228"
"chr9","6962240","6962356","chr15","77449824","77449946","11","70487584"
"chr9","6966662","6966970","chr15","77445228","77445518","41","70478566"
"chr9","6990529","6990799","chr2","84206125","84206386","64","77215596"
"chr9","6996765","6997063","chr15","77412013","77412309","19","70415248"
"chr9","7040263","7040512","chr15","77369799","77370051","32","70329536"
"chr9","7130693","7130816","chr1","200289163","200289285","19","193158470"
"chr9","7131073","7131345","chr15","77278368","77278620","39","70147295"
"chr9","7186843","7187086","chr1","8234582","8234819","56","1047739"
"chr9","7193408","7193705","chr15","77214072","77214371","27","70020664"
"chr9","7212344","7212434","chr12","43283820","43283911","16","36071476"
"chr9","7220836","7221136","chr15","77184957","77185257","29","69964121"
"chr9","7302514","7302814","chr15","77101983","77102266","47","69799469"
"chr9","7330964","7331188","chr15","77075397","77075617","24","69744433"
"chr9","7778329","7778608","chr15","76589732","76590012","26","68811403"
"chr9","7886160","7886464","chr15","76483680","76483994","32","68597520"
"chr9","7962935","7963101","chr15","76407836","76408017","27","68444901"
"chr9","7963389","7963534","chr15","76407378","76407524","16","68443989"
"chr9","7964620","7964765","chr15","76406134","76406280","10","68441514"
"chr9","7995879","7996176","chr15","76372915","76373211","27","68377036"
"chr9","7998015","7998143","chr2","165531071","165531193","20","157533056"
"chr9","8161055","8161358","chr15","76207876","76208172","24","68046821"
"chr9","8186251","8186334","chr4","7199953","7200034","17","986298"
"chr9","8361340","8361479","chr1","128720611","128720750","26","120359271"
"chr9","8361483","8361773","chr15","75997433","75997714","29","67635950"
"chr9","8388199","8388458","chr15","75969573","75969830","29","67581374"
"chr9","8412079","8412317","chr15","75945162","75945388","33","67533083"
"chr9","8430937","8431061","chr15","75925696","75925817","5","67494759"
"chr9","8456633","8456720","chr15","75900144","75900231","10","67443511"
"chr9","8457016","8457206","chr15","75899628","75899840","46","67442612"
"chr9","8479117","8479418","chr15","75877976","75878279","27","67398859"
"chr9","8480230","8480514","chr14","69165770","69166057","60","60685540"
"chr9","8524187","8524444","chr4","128903519","128903790","61","120379332"
"chr9","8542365","8542623","chr15","75815898","75816163","20","67273533"
"chr9","8622746","8623039","chr15","75733704","75734013","48","67110958"
"chr9","8701379","8701501","chr2","169133199","169133321","18","160431820"
"chr9","8745543","8745786","chr15","75613082","75613336","27","66867539"
"chr9","8762654","8762947","chr15","75594944","75595241","28","66832290"
"chr9","8810455","8810757","chr15","75545581","75545880","21","66735126"
"chr9","8821242","8821520","chrX","23305692","23305972","64","14484450"
"chr9","8850716","8851033","chr15","75502610","75502928","21","66651894"
"chr9","8934414","8934702","chr13","107408005","107408290","55","98473591"
"chr9","8954344","8954616","chr15","75398283","75398574","37","66443939"
"chr9","9047093","9047301","chr15","75306814","75307017","20","66259721"
"chr9","9071187","9071272","chr15","75280665","75280752","9","66209478"
"chr9","9227597","9227856","chr15","75129042","75129301","16","65901445"
"chr9","9232611","9232891","chr15","75123985","75124250","53","65891374"
"chr9","9240345","9240616","chr15","75116291","75116564","28","65875946"
"chr9","9409473","9409759","chr15","74887015","74887303","31","65477542"
"chr9","9782534","9782693","chr3","7457961","7458121","38","2324573"
"chr9","9791123","9791425","chr15","74460696","74460985","43","64669573"
"chr9","9854547","9854812","chr15","74396178","74396444","20","64541631"
"chr9","9870178","9870462","chr15","74378229","74378512","29","64508051"
"chr9","9905808","9906108","chr15","74328626","74328928","19","64422818"
"chr9","10013473","10013728","chr15","74216934","74217209","41","64203461"
"chr9","10066461","10066742","chr15","74164821","74165092","36","64098360"
"chr9","10245600","10245887","chr15","73977802","73978082","44","63732202"
"chr9","10248469","10248718","chr15","73974969","73975214","24","63726500"
"chr9","10371402","10371514","chr15","73852429","73852538","7","63481027"
"chr9","10375989","10376256","chr15","73848481","73848748","22","63472492"
"chr9","10525402","10525713","chr8","23324672","23324973","69","12799270"
"chr9","10622352","10622636","chr15","73605654","73605939","19","62983302"
"chr9","10642066","10642368","chrX","46711065","46711364","67","36068999"
"chr9","10687427","10687710","chr15","73539072","73539354","27","62851645"
"chr9","10727226","10727490","chr15","73504260","73504519","26","62777034"
"chr9","10770205","10770469","chr15","73458755","73459006","32","62688550"
"chr9","10811162","10811451","chr1","94000509","94000808","75","83189347"
"chr9","11319243","11319455","chr15","73191248","73191464","30","61872005"
"chr9","11326239","11326422","chr15","73184799","73184982","13","61858560"
"chr9","11494625","11494835","chr20","35094996","35095206","45","23600371"
"chr9","11567703","11567856","chr10","63504110","63504264","33","51936407"
"chr9","11567916","11568006","chr12","99065056","99065143","20","87497140"
"chr9","11573172","11573345","chr1","159500001","159500172","53","147926829"
"chr9","11888554","11888862","chr15","72537165","72537469","34","60648611"
"chr9","12064941","12065148","chr10","71004722","71004936","47","58939781"
"chr9","12322556","12322843","chr15","72109799","72110103","44","59787243"
"chr9","12759923","12760200","chr15","71591013","71591288","35","58831090"
"chr9","12877716","12878009","chr16","11545677","11545975","60","1332039"
"chr9","12882831","12883112","chr11","104856038","104856319","21","91973207"
"chr9","12927901","12928190","chr15","71428364","71428659","31","58500463"
"chr9","13010770","13010827","chr9","63673697","63673760","16","50662927"
"chr9","13075238","13075456","chr2","108165262","108165473","66","95090024"
"chr9","13233619","13233917","chr15","71083400","71083698","28","57849781"
"chr9","13332301","13332610","chr15","70992101","70992413","26","57659800"
"chr9","13364664","13364975","chr2","63122551","63122854","59","49757887"
"chr9","13369925","13370119","chr15","70948778","70948978","23","57578853"
"chr9","13404083","13404354","chr1","37317292","37317563","56","23913209"
"chr9","13508874","13509165","chr15","70810237","70810517","30","57301363"
"chr9","13549198","13549507","chr15","70771909","70772220","24","57222711"
"chr9","13549613","13549913","chr15","70771511","70771804","33","57221898"
"chr9","13582204","13582385","chr13","73995519","73995698","35","60413315"
"chr9","13587055","13587330","chr2","68173712","68173989","55","54586657"
"chr9","13587382","13587498","chr5","48530690","48530813","27","34943308"
"chr9","13663305","13663621","chr6","134870801","134871115","62","121207496"
"chr9","13663681","13663888","chr18","10676729","10676933","42","2986952"
"chr9","13663938","13664237","chr15","70722284","70722575","22","57058346"
"chr9","13683740","13684026","chr15","70701580","70701866","23","57017840"
"chr9","13698510","13698806","chr15","70692064","70692346","32","56993554"
"chr9","13750607","13750911","chr15","70640544","70640836","41","56889937"
"chr9","13857572","13857832","chr15","70532799","70533056","20","56675227"
"chr9","13972078","13972199","chr15","70418820","70418944","7","56446742"
"chr9","13995945","13996192","chr15","70395236","70395492","22","56399291"
"chr9","14308674","14308954","chr15","70080719","70080998","17","55772045"
"chr9","14332493","14332671","chr3","63871341","63871523","28","49538848"
"chr9","14385059","14385389","chr15","70007806","70008108","55","55622747"
"chr9","14385562","14385868","chr15","70007329","70007629","34","55621767"
"chr9","14393596","14393900","chr15","69998883","69999187","21","55605287"
"chr9","14409842","14409912","chr15","69979114","69979184","5","55569272"
"chr9","14409977","14410172","chr8","79680457","79680651","47","65270480"
"chr9","14454933","14455153","chr15","69933972","69934184","38","55479039"
"chr9","14482860","14483185","chr15","69906140","69906417","61","55423280"
"chr9","14520652","14520932","chr15","69869300","69869579","24","55348648"
"chr9","14572797","14573101","chr15","69754655","69754941","34","55181858"
"chr9","14576382","14576675","chr15","69750813","69751105","25","55174431"
"chr9","14598329","14598529","chr1","202980429","202980627","54","188382100"
"chr9","14604926","14605193","chr15","69720853","69721110","34","55115927"
"chr9","14712456","14712762","chr15","69613711","69613987","55","54901255"
"chr9","14727103","14727376","chr15","69601057","69601331","31","54873954"
"chr9","14757437","14757731","chr5","129145825","129146111","58","114388388"
"chr9","14788814","14789086","chr15","69530743","69531015","8","54741929"
"chr9","14837909","14838198","chr15","69484786","69485063","39","54646877"
"chr9","14973643","14973762","chr1","128870903","128871024","21","113897260"
"chr9","14973788","14973963","chr4","151423322","151423494","37","136449534"
"chr9","15083172","15083456","chr15","69233021","69233302","22","54149849"
"chr9","15142164","15142412","chr15","69173229","69173475","16","54031065"
"chr9","15202217","15202334","chr15","69114194","69114309","7","53911977"
"chr9","15228400","15228693","chr15","69094107","69094402","22","53865707"
"chr9","15240525","15240825","chr14","102404851","102405152","55","87164326"
"chr9","15280540","15280605","chr1","49598975","49599040","14","34318435"
"chr9","15286876","15287164","chr6","170629145","170629431","61","155342269"
"chr9","15302397","15302690","chr15","69021172","69021468","17","53718775"
"chr9","15320098","15320414","chr15","68998349","68998659","35","53678251"
"chr9","15340169","15340448","chr15","68980275","68980561","26","53640106"
"chr9","15357581","15357872","chr15","108815725","108816022","64","93458144"
"chr9","15376143","15376335","chr15","68943681","68943880","23","53567538"
"chr9","15458017","15458289","chr15","68862985","68863261","27","53404968"
"chr9","15463451","15463748","chr3","124267629","124267922","56","108804178"
"chr9","15470055","15470270","chr15","68853081","68853296","10","53383026"
"chr9","15471009","15471101","chr15","68852259","68852347","15","53381250"
"chr9","15499005","15499292","chr15","68816817","68817128","52","53317812"
"chr9","15519459","15519752","chr15","68795218","68795512","16","53275759"
"chr9","15590704","15590997","chr15","68720105","68720403","27","53129401"
"chr9","15639570","15639792","chr1","15847152","15847376","58","207582"
"chr9","15640175","15640225","chr15","68665843","68665899","8","53025668"
"chr9","15655760","15656032","chr15","68640046","68640324","29","52984286"
"chr9","15666745","15667048","chr15","68628881","68629175","22","52962136"
"chr9","15692583","15692879","chr15","68601049","68601349","39","52908466"
"chr9","15705470","15705534","chr15","68581416","68581485","9","52875946"
"chr9","15705538","15705690","chr15","68581259","68581415","15","52875721"
"chr9","15706546","15706842","chr13","14552089","14552371","54","1154457"
"chr9","15712092","15712335","chr19","12438308","12438546","62","3273784"
"chr9","15716110","15716388","chr15","68577321","68577602","27","52861211"
"chr9","15720940","15721226","chr15","68572415","68572716","56","52851475"
"chr9","15722772","15723073","chr4","48280543","48280852","67","32557771"
"chr9","15723800","15723916","chr8","142934040","142934158","17","127210240"
"chr9","15729710","15729991","chr15","68562568","68562844","18","52832858"
"chr9","15750814","15751116","chr15","68509500","68509794","34","52758686"
"chr9","15765624","15765904","chr15","68492217","68492495","25","52726593"
"chr9","15772371","15772544","chr15","68484705","68484871","28","52712334"
"chr9","15778037","15778334","chr15","68476700","68477001","19","52698663"
"chr9","15781866","15782154","chr7","19471164","19471448","57","3689298"
"chr9","15798498","15798770","chr15","68455104","68455373","20","52656606"
"chr9","15823827","15824101","chr15","68427243","68427527","39","52603416"
"chr9","15837601","15837885","chr15","68413396","68413704","39","52575795"
"chr9","15887205","15887496","chr15","68356982","68357276","18","52469777"
"chr9","15895384","15895677","chr15","68344564","68344862","28","52449180"
"chr9","15906025","15906315","chr15","68340687","68340988","26","52434662"
"chr9","15924066","15924355","chr15","68328136","68328424","17","52404070"
"chr9","15927808","15928099","chr15","68323496","68323786","37","52395688"
"chr9","15970618","15970759","chr2","150719894","150720026","27","134749276"
"chr9","15971117","15971320","chr14","66911348","66911552","43","50940231"
"chr9","15972991","15973101","chr15","68289824","68289929","20","52316833"
"chr9","15984466","15984755","chr15","68279165","68279447","30","52294699"
"chr9","15985586","15985745","chr15","68278160","68278316","12","52292574"
"chr9","15989822","15990074","chr15","68273823","68274071","21","52284001"
"chr9","15996845","15997127","chr15","68268494","68268775","22","52271649"
"chr9","15998468","15998755","chr10","28370409","28370703","67","12371941"
"chr9","16010609","16010896","chr15","68249860","68250153","24","52239251"
"chr9","16053080","16053378","chr5","169147487","169147792","58","153094407"
"chr9","16085475","16085566","chr15","68180125","68180216","4","52094650"
"chr9","16085792","16086110","chr15","68179595","68179893","39","52093803"
"chr9","16157310","16157408","chr15","68117184","68117282","8","51959874"
"chr9","16178310","16178630","chr15","68097258","68097578","28","51918948"
"chr9","16201681","16202000","chr15","68073888","68074208","36","51872207"
"chr9","16317480","16317761","chr15","67957591","67957872","16","51640111"
"chr9","16463155","16463463","chr15","67809822","67810129","22","51346667"
"chr9","16709953","16710125","chrX","113173870","113174044","35","96463917"
"chr9","16755400","16755674","chr15","67519333","67519607","20","50763933"
"chr9","16797691","16797902","chr15","67477911","67478135","30","50680220"
"chr9","16820719","16821014","chr15","67454610","67454917","37","50633891"
"chr9","16822999","16823294","chr15","67452348","67452645","33","50629349"
"chr9","16867459","16867749","chr15","34234250","34234544","58","17366791"
"chr9","16871858","16872141","chr19","2805453","2805724","75","14066405"
"chr9","16947661","16947955","chr15","67326860","67327159","24","50379199"
"chr9","16981607","16981757","chr15","67293170","67293320","11","50311563"
"chr9","17011559","17011799","chr15","67261286","67261529","17","50249727"
"chr9","17011824","17011909","chr15","67261176","67261261","7","50249352"
"chr9","17099143","17099268","chr15","67171730","67171852","10","50072587"
"chr9","17155212","17155313","chr15","67115627","67115729","9","49960415"
"chr9","17161794","17162026","chr15","67109359","67109590","22","49947565"
"chr9","17164358","17164644","chr15","67106742","67107017","25","49942384"
"chr9","17173010","17173300","chr15","67098847","67099169","57","49925837"
"chr9","17218214","17218442","chr15","67054060","67054290","21","49835846"
"chr9","17248626","17248871","chr15","67031858","67032103","14","49783232"
"chr9","17278002","17278308","chr15","66990979","66991275","33","49712977"
"chr9","17283665","17283971","chr15","66986037","66986338","30","49702372"
"chr9","17287500","17287798","chr15","66984393","66984704","32","49696893"
"chr9","17313288","17313457","chr15","66958104","66958282","21","49644816"
"chr9","17313745","17313867","chr15","66957688","66957815","14","49643943"
"chr9","17368698","17369006","chr7","165716105","165716404","61","148347407"
"chr9","17460207","17460500","chr15","66823966","66824235","44","49363759"
"chr9","17504753","17505029","chr5","140153210","140153489","54","122648457"
"chr9","17552972","17553256","chr15","66727559","66727849","32","49174587"
"chr9","17562996","17563309","chr20","42042273","42042584","57","24479277"
"chr9","17647756","17648055","chr15","66625617","66625906","28","48977861"
"chr9","17661333","17661465","chr15","66612297","66612429","8","48950964"
"chr9","17699807","17700006","chr15","66578152","66578355","23","48878345"
"chr9","17709201","17709495","chr15","66568632","66568929","16","48859431"
"chr9","17723384","17723481","chr7","85657806","85657902","19","67934422"
"chr9","17760141","17760432","chr15","66518613","66518900","26","48758472"
"chr9","17814232","17814531","chr10","38648492","38648793","57","20834260"
"chr9","17904816","17905105","chr15","66360732","66361020","25","48455916"
"chr9","18021078","18021378","chr2","48622768","48623061","57","30601690"
"chr9","18046476","18046767","chr15","66215727","66215994","35","48169251"
"chr9","18085204","18085480","chr15","66174465","66174759","40","48089261"
"chr9","18141982","18142284","chr8","58481167","58481473","60","40339185"
"chr9","18144252","18144532","chr15","66112515","66112810","38","47968263"
"chr9","18187884","18188077","chr15","66067464","66067676","32","47879580"
"chr9","18191456","18191756","chr9","106351847","106352148","68","88160391"
"chr9","18225367","18225490","chr15","66033475","66033598","3","47808108"
"chr9","18248468","18248755","chr1","155141171","155141450","67","136892703"
"chr9","18289132","18289285","chr14","18796224","18796353","54","507092"
"chr9","18358950","18359244","chr15","65904664","65904938","34","47545714"
"chr9","18457314","18457612","chr15","65808871","65809182","50","47351557"
"chr9","18583005","18583194","chr15","65696716","65696907","17","47113711"
"chr9","18583880","18583992","chr15","65695946","65696058","4","47112066"
"chr9","18620606","18620897","chr5","98777268","98777546","71","80156662"
"chr9","18651851","18651943","chr15","65641980","65642073","3","46990129"
"chr9","18663231","18663388","chr17","3933207","3933362","34","14730024"
"chr9","18663898","18664050","chr15","65629535","65629683","15","46965637"
"chr9","18732859","18733158","chr18","48350862","48351154","69","29618003"
"chr9","18735608","18735902","chr15","65563157","65563457","38","46827549"
"chr9","18764592","18764894","chr15","65534167","65534469","30","46769575"
"chr9","18844492","18844809","chr15","65451578","65451862","54","46607086"
"chr9","18991934","18992233","chr15","65308434","65308740","32","46316500"
"chr9","19032247","19032547","chr15","65273771","65274063","34","46241524"
"chr9","19100133","19100385","chr15","65192977","65193230","21","46092844"
"chr9","19146146","19146270","chr1","54908386","54908509","22","35762240"
"chr9","19190011","19190313","chr15","65121377","65121685","23","45931366"
"chr9","19219953","19220232","chr15","65096936","65097195","33","45876983"
"chr9","19262549","19262749","chr15","65061067","65061266","13","45798518"
"chr9","19269191","19269494","chr13","44811753","44812050","50","25542562"
"chr9","19300874","19301182","chr8","72325811","72326117","57","53024937"
"chr9","19328798","19328935","chr15","64992666","64992801","11","45663868"
"chr9","19329243","19329372","chr1","152295547","152295678","23","132966304"
"chr9","19359406","19359428","chr15","64965291","64965314","2","45605885"
"chr9","19359656","19359817","chr15","64964820","64964973","32","45605164"
"chr9","19364254","19364554","chr15","1554629","1554929","58","17809625"
"chr9","19369540","19369843","chr15","64954443","64954752","24","45584903"
"chr9","19374493","19374789","chr15","64949473","64949773","19","45574980"
"chr9","19379645","19379936","chr15","64944354","64944653","25","45564709"
"chr9","19388271","19388343","chr15","64935247","64935319","4","45546976"
"chr9","19389634","19389938","chr15","64933639","64933943","26","45544005"
"chr9","19390573","19390829","chr15","64932741","64932997","14","45542168"
"chr9","19401209","19401505","chr19","34783149","34783440","64","15381940"
"chr9","19413072","19413341","chr15","64911452","64911740","38","45498380"
"chr9","19415357","19415621","chr15","108764758","108765018","55","89349401"
"chr9","19420996","19421087","chr15","64902815","64902907","8","45481819"
"chr9","19438745","19438825","chr15","64881849","64881933","12","45443104"
"chr9","19446255","19446380","chr13","95288408","95288530","18","75842153"
"chr9","19463920","19464011","chr15","64865395","64865478","13","45401475"
"chr9","19471459","19471754","chr15","64857765","64858051","30","45386306"
"chr9","19478390","19478653","chr15","64846996","64847242","36","45368606"
"chr9","19498866","19499146","chr16","49265995","49266270","45","29767129"
"chr9","19503481","19503651","chr5","151024724","151024886","50","131521243"
"chr9","19503934","19504101","chr15","64810804","64810979","25","45306870"
"chr9","19504921","19505085","chr20","41986982","41987146","26","22482061"
"chr9","19505386","19505526","chr18","48607315","48607459","27","29101929"
"chr9","19505680","19505974","chr15","64808359","64808640","36","45302679"
"chr9","19506578","19506839","chr15","64807644","64807909","25","45301066"
"chr9","19510961","19511118","chr15","64801755","64801910","23","45290794"
"chr9","19511425","19511590","chr15","64801283","64801447","12","45289858"
"chr9","19512742","19513052","chr15","64800243","64800543","40","45287501"
"chr9","19513594","19513684","chr3","42599838","42599928","18","23086244"
"chr9","19513983","19514220","chr10","6291424","6291641","37","13222559"
"chr9","19529453","19529621","chr1","53921663","53921825","34","34392210"
"chr9","19535870","19536159","chr15","64776439","64776739","45","45240569"
"chr9","19551248","19551465","chr17","533424","533638","50","19017824"
"chr9","19557195","19557312","chr15","64748469","64748586","10","45191274"
"chr9","19562346","19562598","chr15","64747214","64747483","29","45184868"
"chr9","19563136","19563266","chr15","64746551","64746677","11","45183415"
"chr9","19568666","19568962","chr20","10719806","10720100","72","8848860"
"chr9","19577969","19578051","chr20","10734233","10734315","17","8843736"
"chr9","19581615","19581734","chr12","19203606","19203730","23","378009"
"chr9","19602318","19602415","chr15","64693152","64693251","3","45090834"
"chr9","19622914","19623194","chr15","64674744","64675024","21","45051830"
"chr9","19630873","19631186","chr15","64665952","64666261","30","45035079"
"chr9","19631341","19631602","chr15","10750349","10750617","62","8880992"
"chr9","19651140","19651369","chr15","64644971","64645200","13","44993831"
"chr9","19662228","19662400","chr15","64633229","64633406","19","44971001"
"chr9","19680162","19680290","chr15","64612311","64612426","21","44932149"
"chr9","19682057","19682138","chr15","64610293","64610374","7","44928236"
"chr9","19687009","19687317","chr15","64605129","64605442","34","44918120"
"chr9","19695651","19695939","chr15","64595891","64596183","59","44900240"
"chr9","19722733","19723048","chr15","64566384","64566696","27","44843651"
"chr9","19771575","19771860","chr15","64521216","64521515","51","44749641"
"chr9","19778952","19779128","chr15","64513910","64514098","22","44734958"
"chr9","19779130","19779445","chr15","64513608","64513895","50","44734478"
"chr9","19789416","19789575","chr15","64503449","64503624","29","44714033"
"chr9","19789655","19789938","chr1","11251860","11252129","71","8537795"
"chr9","19820201","19820480","chr15","64472397","64472685","27","44652196"
"chr9","19855665","19855955","chr15","64431571","64431862","45","44575906"
"chr9","19920153","19920443","chr15","64367542","64367832","22","44447389"
"chr9","19950344","19950568","chr15","64338084","64338310","21","44387740"
"chr9","20279158","20279473","chr15","64174085","64174397","30","43894927"
"chr9","20435911","20436199","chr15","63969665","63969950","20","43533754"
"chr9","20520054","20520348","chr15","63883628","63883926","24","43363574"
"chr9","20543088","20543385","chr15","63864154","63864461","26","43321066"
"chr9","20558102","20558259","chr10","73808570","73808731","38","53250468"
"chr9","20558299","20558420","chr3","39187033","39187156","25","18628734"
"chr9","20624529","20624765","chr15","63790266","63790527","45","43165737"
"chr9","20625392","20625558","chr19","40337846","40337998","38","19712454"
"chr9","20680996","20681087","chr15","63732405","63732496","9","43051409"
"chr9","20718100","20718375","chr15","63698203","63698481","21","42980103"
"chr9","20789499","20789785","chr15","63626581","63626876","27","42837082"
"chr9","20827839","20828129","chr15","63589410","63589696","17","42761571"
"chr9","20843220","20843548","chr15","63574046","63574331","71","42730826"
"chr9","20851838","20852112","chr15","63565393","63565643","43","42713555"
"chr9","20858256","20858547","chr15","63558942","63559232","24","42700686"
"chr9","20882782","20883097","chr15","63534514","63534822","26","42651732"
"chr9","20892107","20892398","chr19","29922724","29923008","68","9030617"
"chr9","20898574","20898788","chr15","63518430","63518634","29","42619856"
"chr9","20936912","20937195","chr15","63479402","63479701","47","42542490"
"chr9","20999368","20999664","chr15","63415329","63415628","21","42415961"
"chr9","21001307","21001600","chr15","63413404","63413700","41","42412097"
"chr9","21004409","21004696","chr9","6603091","6603370","58","14401318"
"chr9","21032576","21032886","chr15","63377124","63377433","19","42344548"
"chr9","21039530","21039827","chr15","63369515","63369816","24","42329985"
"chr9","21042261","21042572","chr15","63366430","63366740","32","42324169"
"chr9","21080814","21081122","chr15","63327508","63327800","44","42246694"
"chr9","21089548","21089845","chr15","63318454","63318793","61","42228906"
"chr9","21089880","21089894","chr5","145619087","145619099","2","124529207"
"chr9","21090220","21090429","chr15","63317913","63318118","10","42227693"
"chr9","21103531","21103814","chr15","63304329","63304614","28","42200798"
"chr9","21131884","21132222","chr3","36904507","36904821","79","15772623"
"chr9","21132457","21132592","chr1","27434443","27434574","21","6301986"
"chr9","21141753","21142044","chr15","63254456","63254747","28","42112703"
"chr9","21149650","21149919","chr15","63246503","63246764","24","42096853"
"chr9","21153523","21153792","chr15","63241638","63241912","17","42088115"
"chr9","21157320","21157611","chr15","63237874","63238171","31","42080554"
"chr9","21159861","21160173","chr15","63235338","63235636","47","42075477"
"chr9","21187625","21187941","chr2","107411533","107411833","60","86223908"
"chr9","21210276","21210400","chr3","36601902","36602026","21","15391626"
"chr9","21273512","21273805","chr15","63129110","63129404","21","41855598"
"chr9","21282154","21282441","chr15","63120428","63120710","26","41838274"
"chr9","21284933","21285221","chr15","63117619","63117904","21","41832686"
"chr9","21403986","21404284","chr15","63006096","63006400","27","41602110"
"chr9","21420741","21421026","chr15","62988143","62988424","31","41567402"
"chr9","21563562","21563840","chr15","62839651","62839929","16","41276089"
"chr9","21605969","21606257","chr15","62785886","62786162","36","41179917"
"chr9","21610161","21610437","chr2","98193250","98193524","70","76583089"
"chr9","21799508","21799796","chr15","62617763","62618053","33","40818255"
"chr9","21990755","21991045","chr15","62389135","62389429","27","40398380"
"chr9","21992116","21992385","chr15","62387781","62388022","52","40395665"
"chr9","22118111","22118402","chr15","62238726","62239024","29","40120615"
"chr9","22188914","22189188","chr7","167683223","167683492","65","145494309"
"chr9","22226184","22226488","chr15","62125941","62126231","49","39899757"
"chr9","22230227","22230523","chr15","62121843","62122142","21","39891616"
"chr9","22466926","22467231","chr11","122164387","122164686","55","99697461"
"chr9","22595590","22595895","chr15","61785881","61786185","24","39190291"
"chr9","22611999","22612098","chr15","1230401","1230506","15","21381598"
"chr9","22628593","22628890","chr4","17925503","17925807","62","4703090"
"chr9","22790719","22790941","chr15","61617665","61617892","16","38826946"
"chr9","22851656","22851968","chr15","61559208","61559519","25","38707552"
"chr9","22860431","22860698","chr15","61554340","61554580","39","38693909"
"chr9","22922631","22922914","chr15","61498452","61498746","43","38575821"
"chr9","22985246","22985531","chr15","61457771","61458057","26","38472525"
"chr9","23325833","23326015","chr15","61077969","61078164","26","37752136"
"chr9","23329419","23329699","chr11","64516550","64516828","72","41187131"
"chr9","23338005","23338285","chr15","61067053","61067375","62","37729048"
"chr9","23339233","23339521","chr15","61065854","61066145","23","37726621"
"chr9","23369460","23369752","chr15","61039780","61040073","14","37670320"
"chr9","23378379","23378607","chr15","61030989","61031217","19","37652610"
"chr9","23417968","23418259","chr15","60976992","60977272","38","37559024"
"chr9","23514836","23515009","chr15","60874814","60874993","30","37359978"
"chr9","23622317","23622626","chr15","60767963","60768276","21","37145646"
"chr9","23643386","23643663","chr15","60745611","60745882","21","37102225"
"chr9","23679127","23679437","chr8","42419384","42419688","69","18740257"
"chr9","23840304","23840578","chr15","14646159","14646430","57","9194145"
"chr9","23845296","23845570","chr15","60540318","60540592","22","36695022"
"chr9","23916034","23916337","chr3","47567768","47568083","58","23651734"
"chr9","23948836","23949169","chr4","27191661","27191993","85","3242825"
"chr9","23970362","23970462","chr15","60419545","60419645","6","36449183"
"chr9","23994604","23994720","chr16","61292718","61292835","22","37298114"
"chr9","23994747","23994922","chr19","9913610","9913785","34","14081137"
"chr9","24036856","24037117","chr15","60354040","60354292","24","36317184"
"chr9","24210116","24210420","chrX","19569478","19569782","68","4640638"
"chr9","24258290","24258601","chr15","60136841","60137154","30","35878551"
"chr9","24350272","24350572","chr15","60040833","60041145","36","35690561"
"chr9","24350687","24350771","chr15","13496162","13496246","18","10854525"
"chr9","24366277","24366470","chr15","60026037","60026234","20","35659760"
"chr9","24398161","24398332","chr15","59996243","59996427","34","35598082"
"chr9","24468397","24468701","chr15","59936186","59936489","40","35467789"
"chr9","24605553","24605854","chr15","59803050","59803355","30","35197497"
"chr9","24612857","24613163","chr15","59795469","59795778","50","35182612"
"chr9","24621110","24621391","chr15","59786805","59787087","17","35165695"
"chr9","24754878","24755152","chr15","59675093","59675372","29","34920215"
"chr9","24765314","24765646","chr15","59664155","59664480","39","34898841"
"chr9","24802437","24802728","chr15","59625906","59626197","15","34823469"
"chr9","24841269","24841587","chr15","59586359","59586683","25","34745090"
"chr9","24844728","24845031","chr7","58370727","58371021","72","33525999"
"chr9","24855336","24855654","chr15","59572064","59572380","30","34716728"
"chr9","24894015","24894295","chr15","59363198","59363482","22","34469183"
"chr9","25128913","25129194","chr15","102240591","102240872","62","77111678"
"chr9","25403981","25404279","chr15","58962283","58962588","24","33558302"
"chr9","25699582","25699899","chr15","58613838","58614152","35","32914256"
"chr9","25701097","25701401","chr15","58612007","58612313","23","32910910"
"chr9","25807865","25808145","chr11","53169887","53170172","68","27362022"
"chr9","25992484","25992774","chr15","93943566","93943854","72","67951082"
"chr9","26108041","26108287","chr15","58200582","58200837","44","32092541"
"chr9","26122154","26122450","chr15","58186641","58186938","31","32064487"
"chr9","26125543","26125836","chr15","58183276","58183575","43","32057733"
"chr9","26178473","26178734","chr15","58133297","58133570","42","31954824"
"chr9","26219670","26219970","chr15","58095860","58096151","30","31876190"
"chr9","26313375","26313682","chr15","57996214","57996523","28","31682839"
"chr9","26586570","26586721","chr2","13891863","13892015","33","12694707"
"chr9","26696530","26696608","chr15","57630441","57630519","2","30933911"
"chr9","26718872","26719166","chr15","57614704","57614994","18","30895832"
"chr9","26967156","26967432","chr15","57367986","57368255","28","30400830"
"chr9","27022653","27022978","chr15","57300347","57300628","63","30277694"
"chr9","27033116","27033272","chr10","26526029","26526178","42","507087"
"chr9","27130920","27131091","chr15","57198518","57198688","12","30067598"
"chr9","27190831","27191066","chr1","222943933","222944161","63","195753102"
"chr9","27206822","27207125","chr15","57125281","57125578","27","29918459"
"chr9","27225698","27225985","chr15","57108910","57109185","44","29883212"
"chr9","27239503","27239792","chr1","124488514","124488793","58","97249011"
"chr9","27254990","27255291","chr6","128761467","128761739","83","101506477"
"chr9","27272736","27272954","chr17","13758751","13758979","49","13513985"
"chr9","27327971","27328243","chr6","148012636","148012916","66","120684665"
"chr9","27331854","27332132","chr15","57006413","57006692","25","29674559"
"chr9","27378046","27378353","chr15","46079306","46079603","62","18701260"
"chr9","27387454","27387740","chr15","56948486","56948761","36","29561032"
"chr9","27391861","27392204","chr2","88897939","88898270","100","61506078"
"chr9","27397280","27397579","chr15","56940632","56940931","30","29543352"
"chr9","27415711","27415820","chr17","16391889","16391988","34","11023822"
"chr9","27443801","27444073","chr15","56895818","56896108","39","29452017"
"chr9","27458720","27459013","chr15","56873391","56873686","22","29414671"
"chr9","27469629","27469884","chr15","56863021","56863311","55","29393392"
"chr9","27482642","27482771","chr6","56973348","56973477","31","29490706"
"chr9","27510237","27510533","chr15","56815931","56816228","32","29305694"
"chr9","27553201","27553493","chr15","56774873","56775139","36","29221672"
"chr9","27602279","27602573","chr15","56724327","56724622","30","29122048"
"chr9","27611951","27612251","chr15","56714653","56714959","51","29102702"
"chr9","27616183","27616248","chr15","56710652","56710717","3","29094469"
"chr9","27616554","27616768","chr15","56710132","56710342","22","29093578"
"chr9","27636694","27636988","chr15","56687772","56688056","30","29051078"
"chr9","27645745","27646026","chr15","56678060","56678344","31","29032315"
"chr9","27650743","27651029","chr15","56673400","56673682","19","29022657"
"chr9","27663388","27663703","chr6","147497028","147497329","61","119833640"
"chr9","27692052","27692320","chr15","56632026","56632298","16","28939974"
"chr9","27805979","27806243","chr15","56525357","56525620","14","28719378"
"chr9","27811613","27811917","chr15","56519912","56520215","29","28708299"
"chr9","27912192","27912408","chr15","56417105","56417330","34","28504913"
"chr9","27923961","27924279","chr15","56404652","56404983","20","28480691"
"chr9","28118420","28118721","chr15","56208437","56208730","31","28090017"
"chr9","28124810","28124928","chr15","56201722","56201835","11","28076912"
"chr9","28260767","28261009","chr15","56059838","56060072","16","27799071"
"chr9","28437735","28438033","chr15","55833497","55833787","45","27395762"
"chr9","28496546","28496855","chr15","55777615","55777918","30","27281069"
"chr9","28499590","28499711","chr15","55774748","55774869","3","27275158"
"chr9","28521789","28522008","chr7","33789485","33789705","47","5267696"
"chr9","28862394","28862674","chr5","184162817","184163090","31","155300423"
"chr9","29026194","29026489","chr14","5218796","5219081","76","23807398"
"chr9","29264805","29265075","chr15","55162302","55162600","43","25897497"
"chr9","29316973","29317301","chr15","55099395","55099732","31","25782422"
"chr9","29427108","29427238","chr9","28925694","28925823","25","501414"
"chr9","29521746","29521853","chr15","54894256","54894362","7","25372510"
"chr9","29563402","29563533","chr15","54859180","54859311","9","25295778"
"chr9","29642395","29642679","chr1","95822843","95823146","76","66180448"
"chr9","29896975","29897246","chr15","54532352","54532625","17","24635377"
"chr9","29957753","29957983","chr15","54479922","54480153","19","24522169"
"chr9","29982549","29982672","chr15","54455300","54455424","9","24472751"
"chr9","30003419","30003695","chr15","54424138","54424405","29","24420719"
"chr9","30388301","30388612","chr1","10811316","10811617","82","19576985"
"chr9","30388634","30388751","chr15","104360931","104361048","16","73972297"
"chr9","30435054","30435122","chr15","53959780","53959861","17","23524726"
"chr9","30442490","30442815","chr15","53952143","53952471","61","23509653"
"chr9","30497336","30497636","chr15","53903698","53903979","43","23406362"
"chr9","30608215","30608497","chr1","138872834","138873119","54","108264619"
"chr9","30636598","30636918","chr15","53774470","53774808","35","23137872"
"chr9","30636989","30637284","chr15","53774135","53774399","58","23137146"
"chr9","30661162","30661459","chr15","53751706","53752005","33","23090544"
"chr9","30844693","30844976","chr15","53540781","53541061","18","22696088"
"chr9","30947394","30947659","chr15","53471180","53471429","65","22523786"
"chr9","31460094","31460374","chr15","52965664","52965930","35","21505570"
"chr9","31556673","31556843","chr15","52871564","52871732","15","21314891"
"chr9","31557155","31557301","chr15","52871103","52871241","19","21313948"
"chr9","31694302","31694628","chr15","52747479","52747748","70","21053177"
"chr9","31882015","31882271","chr7","107719390","107719638","59","75837375"
"chr9","32012498","32012797","chr15","52486604","52486901","23","20474106"
"chr9","32016773","32017051","chr15","52482333","52482624","28","20465560"
"chr9","32167239","32167533","chr15","52330730","52331006","54","20163491"
"chr9","32304504","32304805","chr15","52186480","52186787","28","19881976"
"chr9","32310558","32310852","chr15","52180284","52180577","22","19869726"
"chr9","32386081","32386363","chr15","52108187","52108448","34","19722106"
"chr9","32451751","32451892","chr15","52043360","52043494","14","19591609"
"chr9","32479428","32479684","chr12","3445340","3445596","69","29034088"
"chr9","32587209","32587523","chr19","29108741","29109042","62","3478468"
"chr9","32614873","32614947","chr15","51900969","51901042","4","19286096"
"chr9","32707151","32707267","chr15","51819644","51819760","6","19112493"
"chr9","32961204","32961481","chr15","51581692","51581966","28","18620488"
"chr9","32981812","32982100","chr7","140100928","140101221","49","107119116"
"chr9","32989545","32989841","chr6","161557509","161557798","54","128567964"
"chr9","33011195","33011499","chr7","165716105","165716404","55","132704910"
"chr9","33016343","33016637","chr15","51524960","51525253","22","18508617"
"chr9","33060480","33060742","chr15","51479114","51479402","46","18418634"
"chr9","33060887","33061160","chr15","51478727","51478999","19","18417840"
"chr9","33085454","33085518","chr15","51453190","51453254","3","18367736"
"chr9","33085519","33085720","chr15","51453005","51453189","23","18367486"
"chr9","33112005","33112227","chr8","123473573","123473774","60","90361568"
"chr9","33139281","33139411","chr15","51398059","51398189","9","18258778"
"chr9","33147190","33147489","chr15","51389726","51390027","30","18242536"
"chr9","33153175","33153469","chr15","51383601","51383895","32","18230426"
"chr9","33170639","33170761","chr10","27663251","27663372","15","5507388"
"chr9","33195077","33195400","chr15","51345242","51345573","32","18150165"
"chr9","33196195","33196308","chr15","51344224","51344337","9","18148029"
"chr9","33197495","33197799","chr15","51342736","51343031","27","18145241"
"chr9","33200683","33201003","chr15","51339531","51339834","37","18138848"
"chr9","33205600","33205673","chr8","17300112","17300170","21","15905488"
"chr9","33206444","33206742","chr15","51333641","51333942","29","18127197"
"chr9","33209224","33209530","chr15","51330197","51330492","27","18120973"
"chr9","33250300","33250519","chr15","51285279","51285485","26","18034979"
"chr9","33294001","33294268","chr15","51241535","51241796","23","17947534"
"chr9","33304592","33304862","chr15","51236890","51237150","25","17932298"
"chr9","33379986","33380122","chr15","9205702","9205836","40","24174284"
"chr9","33390045","33390334","chr15","51154580","51154851","52","17764535"
"chr9","33391618","33391930","chr15","51152639","51152954","24","17761021"
"chr9","33427893","33428165","chr2","44788884","44789158","59","11360991"
"chr9","33438206","33438517","chr15","63864154","63864461","59","30425948"
"chr9","33438616","33438881","chr1","137723875","137724141","54","104285259"
"chr9","33453820","33453951","chr15","51091076","51091207","10","17637256"
"chr9","33466323","33466615","chr15","51078359","51078651","18","17612036"
"chr9","33477691","33477958","chr15","51066291","51066558","15","17588600"
"chr9","33516081","33516293","chr1","94055009","94055207","48","60538928"
"chr9","33527699","33527993","chr15","51008847","51009136","32","17481148"
"chr9","33529111","33529407","chr15","51007410","51007719","29","17478299"
"chr9","33533793","33534093","chr15","51002476","51002779","22","17468683"
"chr9","33561017","33561320","chr15","50975001","50975308","21","17413984"
"chr9","33579690","33579980","chr9","12019426","12019718","59","21560264"
"chr9","33588834","33589142","chr15","50945835","50946133","24","17357001"
"chr9","33589549","33589672","chr15","50945299","50945422","9","17355750"
"chr9","33593139","33593436","chr15","50941513","50941805","43","17348374"
"chr9","33632710","33632825","chr11","78863129","78863241","15","45230419"
"chr9","33632852","33633027","chr8","64731321","64731495","33","31098469"
"chr9","33636742","33636868","chr15","50897121","50897247","9","17260379"
"chr9","33642749","33643049","chr15","50890454","50890755","35","17247705"
"chr9","33647206","33647336","chr1","67637888","67638021","33","33990682"
"chr9","33651349","33651642","chr19","35633077","35633377","57","1981728"
"chr9","33657000","33657119","chr15","12172497","12172619","25","21484503"
"chr9","33662400","33662700","chr8","83685738","83686033","59","50023338"
"chr9","33664255","33664371","chr15","50870839","50870955","8","17206584"
"chr9","33705273","33705584","chr4","2185273","2185588","63","31520000"
"chr9","33729418","33729568","chr15","50819032","50819177","17","17089614"
"chr9","33730692","33730990","chr15","50817608","50817903","16","17086916"
"chr9","33734591","33734843","chr15","50813763","50814036","32","17079172"
"chr9","33767674","33767957","chr15","50778645","50778933","19","17010971"
"chr9","33781326","33781627","chr10","47303639","47303937","58","13522313"
"chr9","33782282","33782579","chr15","50764866","50765163","28","16982584"
"chr9","33792348","33792650","chr5","185678151","185678451","52","151885803"
"chr9","33799897","33800178","chr15","50744331","50744614","11","16944434"
"chr9","33813993","33814266","chr15","50730876","50731157","23","16916883"
"chr9","33821824","33822113","chr15","50723062","50723344","27","16901238"
"chr9","33829381","33829555","chr15","50715278","50715460","19","16885897"
"chr9","33829886","33829988","chr15","50714871","50714966","11","16884985"
"chr9","33835401","33835678","chr15","50709131","50709413","27","16873730"
"chr9","33871634","33871932","chr15","50671958","50672255","38","16800324"
"chr9","33876453","33876727","chr15","50668648","50668920","23","16792195"
"chr9","33882864","33883153","chr9","32042924","32043200","58","1839940"
"chr9","33884913","33885208","chr20","28618222","28618522","57","5266691"
"chr9","33885839","33886076","chr15","50659274","50659513","12","16773435"
"chr9","33894418","33894719","chr15","50650066","50650347","40","16755648"
"chr9","33910180","33910313","chr3","124779313","124779446","25","90869133"
"chr9","33910601","33910778","chr19","14612970","14613142","42","19297631"
"chr9","33912652","33912929","chr15","50631056","50631357","40","16718404"
"chr9","33921763","33921853","chr15","50622129","50622219","9","16700366"
"chr9","33946367","33946709","chr11","27900299","27900628","72","6046068"
"chr9","33963234","33963527","chr1","109806160","109806457","56","75842926"
"chr9","33978325","33978500","chr15","50566754","50566939","25","16588429"
"chr9","33978794","33978943","chr15","50566021","50566155","21","16587227"
"chr9","34014454","34014715","chr15","50526320","50526593","31","16511866"
"chr9","34024153","34024474","chr15","50518832","50519150","17","16494679"
"chr9","34024820","34025126","chr15","50518171","50518483","33","16493351"
"chr9","34040704","34040967","chr15","50501716","50501959","34","16461012"
"chr9","34069386","34069623","chr15","50471173","50471410","14","16401787"
"chr9","34085181","34085474","chr17","20189129","20189420","32","13896052"
"chr9","34095876","34096193","chr17","31545337","31545654","49","2550539"
"chr9","34103653","34103941","chr8","41448593","41448866","54","7344940"
"chr9","34106395","34106681","chr11","125201626","125201907","63","91095231"
"chr9","34120860","34121152","chr15","44699461","44699755","27","10578601"
"chr9","34367024","34367084","chr14","78931299","78931359","9","44564275"
"chr9","34367122","34367294","chr5","165325417","165325590","38","130958295"
"chr9","34456244","34456490","chr2","172398914","172399164","55","137942670"
"chr9","34486904","34487104","chr2","150567599","150567793","60","116080695"
"chr9","34487402","34487521","chr9","99705197","99705312","26","65217795"
"chr9","34489392","34489685","chr11","95166258","95166554","53","60676866"
"chr9","34501638","34501921","chr15","50423230","50423519","30","15921592"
"chr9","34510040","34510310","chr5","109550554","109550822","58","75040514"
"chr9","34523555","34523855","chr15","50394159","50394473","40","15870604"
"chr9","34533319","34533612","chr6","73337111","73337413","58","38803792"
"chr9","34543437","34543624","chr15","50370817","50371007","23","15827380"
"chr9","34543909","34544011","chr15","50369836","50369938","6","15825927"
"chr9","34545956","34546160","chr15","50364774","50364971","20","15818818"
"chr9","34555437","34555705","chr20","1980986","1981248","56","32574451"
"chr9","34557515","34557701","chr15","50355573","50355749","12","15798058"
"chr9","34561844","34562122","chr15","50350755","50351039","19","15788911"
"chr9","34587565","34587699","chr19","36651821","36651951","22","2064256"
"chr9","34600222","34600490","chr15","50306797","50307070","25","15706575"
"chr9","34606015","34606283","chr15","50301004","50301260","35","15694989"
"chr9","34608886","34609173","chr11","94771477","94771758","75","60162591"
"chr9","34618183","34618469","chr15","50286281","50286574","36","15668098"
"chr9","34624844","34624968","chr1","78614990","78615114","17","43990146"
"chr9","34634085","34634396","chr10","15460316","15460612","61","19173769"
"chr9","34658928","34659239","chr15","50250330","50250644","37","15591402"
"chr9","34664640","34664906","chr15","50242817","50243083","14","15578177"
"chr9","34671641","34671711","chr15","50237918","50237988","4","15566277"
"chr9","34691527","34691796","chr6","9643866","9644144","60","25047661"
"chr9","34692234","34692516","chr15","50216706","50216985","44","15524472"
"chr9","34703093","34703207","chr16","16389727","16389844","14","18313366"
"chr9","34708053","34708367","chr15","50199020","50199333","32","15490967"
"chr9","34712935","34713116","chr14","100887541","100887728","40","66174606"
"chr9","34713747","34713871","chr15","50193724","50193848","8","15479977"
"chr9","34721841","34722129","chr15","50183028","50183328","28","15461187"
"chr9","34730620","34730907","chr15","50177492","50177790","31","15446872"
"chr9","34744190","34744491","chr15","50163388","50163706","46","15419198"
"chr9","34749004","34749309","chr5","78786375","78786670","72","44037371"
"chr9","34804826","34805106","chr15","50097622","50097898","23","15292796"
"chr9","34837490","34837614","chr9","54332676","54332800","29","19495186"
"chr9","34843188","34843311","chr6","64065434","64065559","19","29222246"
"chr9","34849667","34849836","chr15","50052474","50052641","10","15202807"
"chr9","34866480","34866653","chrX","28568128","28568294","43","6298352"
"chr9","34866654","34866935","chr5","86867827","86868121","55","52001173"
"chr9","34866936","34867071","chr20","23238356","23238485","31","11628580"
"chr9","34868826","34869127","chr15","50032835","50033128","27","15164009"
"chr9","34874148","34874406","chr15","50027179","50027439","18","15153031"
"chr9","34904530","34904831","chr19","3500436","3500734","55","31404094"
"chr9","34911454","34911768","chr15","49988755","49989067","14","15077301"
"chr9","34912199","34912491","chr15","49988046","49988333","20","15075847"
"chr9","34917005","34917188","chr7","92039014","92039198","39","57122009"
"chr9","34918721","34919010","chr1","30761063","30761352","59","4157658"
"chr9","34933633","34933934","chr15","49966975","49967283","14","15033342"
"chr9","34939676","34939960","chr2","44803783","44804082","67","9864107"
"chr9","34940928","34941091","chr9","122902830","122902998","33","87961902"
"chr9","34941401","34941534","chr10","5403791","5403920","23","29537610"
"chr9","34951665","34951950","chr15","49947045","49947308","45","14995380"
"chr9","34978074","34978388","chr15","49920748","49921057","23","14942674"
"chr9","34981313","34981620","chr18","45361942","45362253","56","10380629"
"chr9","34987484","34987788","chr16","51221973","51222278","57","16234489"
"chr9","35007236","35007365","chr15","49900763","49900892","6","14893527"
"chr9","35023142","35023436","chr15","49884937","49885232","24","14861795"
"chr9","35039265","35039399","chr7","16781339","16781468","22","18257926"
"chr9","35061261","35061451","chr15","49847193","49847413","40","14785932"
"chr9","35068082","35068345","chr15","49839763","49840031","15","14771681"
"chr9","35078117","35078241","chr15","49829801","49829925","11","14751684"
"chr9","35081488","35081785","chr15","49826638","49826928","24","14745150"
"chr9","35093077","35093376","chr15","49816064","49816372","25","14722987"
"chr9","35101272","35101397","chr16","7102010","7102127","30","27999262"
"chr9","35113679","35113989","chr15","49794762","49795074","26","14681083"
"chr9","35118434","35118727","chr15","49788693","49788980","18","14670259"
"chr9","35119557","35119841","chr15","49787597","49787883","13","14668040"
"chr9","35122802","35123042","chr15","49784048","49784263","37","14661246"
"chr9","35181915","35182221","chr1","195801657","195801957","55","160619742"
"chr9","35243861","35244149","chrX","47528048","47528325","59","12284187"
"chr9","35280370","35280687","chr15","49633098","49633395","42","14352728"
"chr9","35303269","35303584","chr15","49610142","49610451","28","14306873"
"chr9","35348846","35349089","chr2","48742332","48742571","51","13393486"
"chr9","35356008","35356297","chr15","49549896","49550183","28","14193888"
"chr9","35377865","35378162","chr15","49527498","49527793","36","14149633"
"chr9","35386923","35387054","chr1","155846166","155846296","16","120459243"
"chr9","35391445","35391748","chr15","49514742","49515047","20","14123297"
"chr9","35393769","35393883","chr1","221221545","221221660","17","185827776"
"chr9","35434097","35434408","chr15","49483696","49484006","23","14049599"
"chr9","35461211","35461474","chr15","49454292","49454560","18","13993081"
"chr9","35462637","35462745","chr15","49453024","49453128","8","13990387"
"chr9","35559286","35559534","chr15","49374227","49374467","18","13814941"
"chr9","35563030","35563185","chr15","49368816","49368972","4","13805786"
"chr9","35594445","35594571","chr15","49350817","49350944","10","13756372"
"chr9","35607247","35607480","chr15","49337679","49337912","15","13730432"
"chr9","35607706","35607991","chr13","96777559","96777844","64","61169853"
"chr9","35664277","35664395","chr15","49286915","49287035","8","13622638"
"chr9","35664468","35664760","chr15","49286543","49286855","35","13622075"
"chr9","35666676","35666771","chr15","49284571","49284656","15","13617895"
"chr9","35686030","35686298","chr15","49263386","49263653","11","13577356"
"chr9","35687101","35687294","chr15","49262269","49262468","17","13575168"
"chr9","35706104","35706384","chr9","102012638","102012918","54","66306534"
"chr9","35716235","35716532","chr15","49233369","49233669","30","13517134"
"chr9","35742304","35742434","chr15","49206792","49206918","10","13464488"
"chr9","35742507","35742759","chr15","49206460","49206716","22","13463953"
"chr9","35743548","35743833","chr15","49205428","49205690","36","13461880"
"chr9","35777388","35777698","chr15","49169727","49169999","52","13392339"
"chr9","35790955","35791265","chr19","45495569","45495860","72","9704614"
"chr9","35823296","35823591","chr15","49129706","49130001","14","13306410"
"chr9","35824078","35824350","chr15","49128958","49129213","29","13304880"
"chr9","35824447","35824729","chr8","129433118","129433406","59","93608671"
"chr9","35826701","35826988","chr13","24481774","24482062","61","11344927"
"chr9","35851447","35851751","chr15","49100595","49100896","25","13249148"
"chr9","35864142","35864504","chr6","158859659","158860029","93","122995517"
"chr9","35871938","35872228","chr15","49083984","49084279","19","13212046"
"chr9","35909848","35910055","chr15","49050459","49050671","20","13140611"
"chr9","35922201","35922321","chrX","95429259","95429380","20","59507058"
"chr9","35930792","35930916","chr15","49029242","49029367","7","13098450"
"chr9","35943111","35943230","chr5","65808805","65808929","21","29865694"
"chr9","35971211","35971374","chr3","40058358","40058518","36","4087147"
"chr9","35976041","35976327","chr15","48983543","48983830","13","13007502"
"chr9","35977601","35977899","chr1","220743035","220743333","62","184765434"
"chr9","35978049","35978183","chr15","48981672","48981800","18","13003623"
"chr9","35982804","35983081","chr15","48976744","48977023","21","12993940"
"chr9","36003586","36003857","chr15","48955746","48956033","33","12952160"
"chr9","36017335","36017653","chr15","48942052","48942369","16","12924717"
"chr9","36080177","36080476","chr16","11545677","11545975","57","24534500"
"chr9","36085482","36085783","chr15","48865874","48866169","19","12780392"
"chr9","36122613","36122737","chr15","48827886","48828010","11","12705273"
"chr9","36163404","36163592","chr15","48759867","48760055","9","12596463"
"chr9","36181453","36181775","chr15","48740878","48741206","24","12559425"
"chr9","36182424","36182716","chr15","48739949","48740235","13","12557525"
"chr9","36182830","36183097","chr15","48739562","48739826","10","12556732"
"chr9","36183122","36183244","chr13","61667412","61667534","21","25484290"
"chr9","36194469","36194751","chr15","48727951","48728234","3","12533482"
"chr9","36224873","36225172","chr15","48697592","48697895","30","12472719"
"chr9","36227797","36228142","chr15","48693623","48693948","48","12465826"
"chr9","36251239","36251546","chr15","48662227","48662513","44","12410988"
"chr9","36255811","36256105","chr15","48657765","48658055","22","12401954"
"chr9","36277349","36277660","chr11","51915925","51916234","67","15638576"
"chr9","36282499","36282807","chr15","48631449","48631744","35","12348950"
"chr9","36283545","36283857","chr8","42419384","42419688","57","6135839"
"chr9","36306276","36306574","chr15","48608783","48609081","22","12302507"
"chr9","36306603","36306895","chr15","48608151","48608444","20","12301548"
"chr9","36308235","36308479","chr6","106070662","106070896","53","69762427"
"chr9","36308499","36308788","chr15","48606395","48606649","50","12297896"
"chr9","36350780","36350939","chr10","27406902","27407056","33","8943878"
"chr9","36355797","36356063","chr15","48556262","48556542","29","12200465"
"chr9","36430924","36431024","chr7","37098048","37098147","17","667124"
"chr9","36519706","36519995","chr8","17762883","17763173","52","18756823"
"chr9","36543444","36543775","chr15","48364683","48364997","43","11821239"
"chr9","36565070","36565356","chr15","48342480","48342790","43","11777410"
"chr9","36572991","36573323","chr15","48300401","48300740","22","11727410"
"chr9","36584029","36584332","chr1","44516138","44516440","58","7932109"
"chr9","36599618","36599747","chr15","48273704","48273831","3","11674086"
"chr9","36631515","36631809","chr15","48250296","48250575","26","11618781"
"chr9","36638845","36639131","chr15","48243263","48243545","33","11604418"
"chr9","36669783","36670073","chr15","48152747","48153038","23","11482964"
"chr9","36676099","36676388","chr8","29021743","29022036","56","7654356"
"chr9","36679701","36679870","chr14","32139013","32139178","40","4540688"
"chr9","36679999","36680153","chr15","48143294","48143424","35","11463295"
"chr9","36685655","36685949","chr15","48136650","48136947","27","11450995"
"chr9","36735988","36736274","chr20","2954133","2954415","57","33781855"
"chr9","36736657","36736956","chr15","48084240","48084539","28","11347583"
"chr9","36782261","36782561","chr15","48039471","48039785","29","11257210"
"chr9","36784540","36784864","chr3","36669420","36669742","64","115120"
"chr9","36892977","36893288","chr15","47924922","47925228","22","11031945"
"chr9","36908929","36908999","chr15","47910283","47910353","9","11001354"
"chr9","36919575","36919865","chr15","47900500","47900790","16","10980925"
"chr9","36923665","36923943","chr15","47891093","47891389","41","10967428"
"chr9","36928108","36928413","chr15","47885832","47886137","16","10957724"
"chr9","36936458","36936711","chr10","61695759","61696020","59","24759301"
"chr9","36938560","36938621","chr14","78931299","78931359","10","41992739"
"chr9","36945420","36945711","chr15","47869736","47870026","18","10924316"
"chr9","36959045","36959323","chr15","47855867","47856141","13","10896822"
"chr9","36961445","36961533","chrX","17349647","17349738","22","19611798"
"chr9","36966293","36966461","chr15","47846415","47846571","29","10880122"
"chr9","36966699","36966835","chr15","47845972","47846108","10","10879273"
"chr9","36973406","36973625","chr15","47839552","47839748","35","10866146"
"chr9","36989387","36989682","chr15","47823153","47823442","28","10833766"
"chr9","37022889","37023193","chr15","47789437","47789727","42","10766548"
"chr9","37096116","37096358","chr3","125699927","125700158","62","88603811"
"chr9","37098856","37099136","chr15","47717726","47718027","62","10618870"
"chr9","37100144","37100297","chr1","22995824","22995974","34","14104320"
"chr9","37100594","37100695","chr6","135962569","135962666","24","98861975"
"chr9","37115798","37116102","chr15","47700322","47700631","30","10584524"
"chr9","37144191","37144315","chr15","47665060","47665184","6","10520869"
"chr9","37182423","37182722","chr9","40793973","40794268","51","3611550"
"chr9","37191328","37191604","chr15","47611779","47612055","23","10420451"
"chr9","37201096","37201239","chr12","32038354","32038493","31","5162742"
"chr9","37211617","37211770","chr1","110033968","110034121","30","72822351"
"chr9","37224596","37224812","chr19","39028175","39028394","40","1803579"
