"chr1","5721078","5721383","KN296311v1","7924000","7924299","38","2202922"
"chr1","6815903","6816192","KN295967v1","470774","471071","45","6345129"
"chr1","7860173","7860455","KN295941v1","1108709","1108994","34","6751464"
"chr1","8128702","8129005","KN295573v1","1644468","1644772","33","6484234"
"chr1","8235197","8235291","KN295112v1","593978","594084","18","7641219"
"chr1","8798960","8799039","KN297008v1","5130004","5130066","33","3668956"
"chr1","8893002","8893244","KN295439v1","247193","247443","51","8645809"
"chr1","9066020","9066311","KN295576v1","406337","406628","31","8659683"
"chr1","9775939","9776254","KN296913v1","140345","140647","44","9635594"
"chr1","9867784","9867969","KN296122v1","240387","240574","34","9627397"
"chr1","10179477","10179765","KN295576v1","406337","406628","33","9773140"
"chr1","10318653","10318962","KN294665v1","171883","172197","32","10146770"
"chr1","15696414","15696610","KN296287v1","108021","108221","49","15588393"
"chr1","16344016","16344145","KN295828v1","718942","719076","18","15625074"
"chr1","16545798","16545841","KN294526v1","71927","71974","10","16473871"
"chr1","19250786","19251092","KN294193v1","690006","690308","35","18560780"
"chr1","20220063","20220358","KN296296v1","160831","161126","27","20059232"
"chr1","20472551","20472854","KN295573v1","1644468","1644772","28","18828083"
"chr1","20963185","20963479","KN295315v1","992137","992431","27","19971048"
"chr1","21192288","21192596","KN295907v1","1531171","1531479","36","19661117"
"chr1","23117993","23118318","KN294703v1","42278","42595","48","23075715"
"chr1","23158891","23159191","KN295172v1","269190","269486","32","22889701"
"chr1","28928774","28928839","KN297046v1","1058980","1059042","22","27869794"
"chr1","29036267","29036570","KN295573v1","1644468","1644772","31","27391799"
"chr1","29311799","29312111","KN296921v1","822515","822822","38","28489284"
"chr1","31344187","31344266","KN296311v1","1646100","1646183","29","29698087"
"chr1","32405775","32406065","KN294705v1","1165437","1165726","33","31240338"
"chr1","32957245","32957389","KN294269v1","66171","66308","18","32891074"
"chr1","35612336","35612640","KN294420v1","890399","890698","37","34721937"
"chr1","35754985","35755186","KN295573v1","179759","179967","42","35575226"
"chr1","36242464","36242743","KN297415v1","635524","635813","38","35606940"
"chr1","36633268","36633449","KN296682v1","4866975","4867199","61","31766293"
"chr1","38608179","38608472","KN295576v1","406337","406628","29","38201842"
"chr1","39654267","39654555","KN295576v1","406337","406628","39","39247930"
"chr1","40612761","40613066","KN295586v1","818303","818604","31","39794458"
"chr1","40860629","40860935","KN294526v1","558418","558721","37","40302211"
"chr1","41194070","41194342","KN294713v1","906670","906972","49","40287400"
"chr1","42505538","42505595","KN297046v1","1058980","1059042","16","41446558"
"chr1","44779485","44779774","KN295576v1","406337","406628","33","44373148"
"chr1","45719099","45719424","KN295294v1","1273221","1273523","62","44445878"
"chr1","46237518","46237566","KN295601v1","571926","571977","10","45665592"
"chr1","46369762","46369898","KN294269v1","66171","66308","27","46303591"
"chr1","46831289","46831591","KN296541v1","476659","476959","33","46354630"
"chr1","52647894","52647947","KN295601v1","571926","571977","11","52075968"
"chr1","55835129","55835193","KN294831v1","135083","135138","16","55700046"
"chr1","58457034","58457331","KN295301v1","588399","588701","36","57868635"
"chr1","62807594","62807767","KN295717v1","1369230","1369404","32","61438364"
"chr1","68725559","68725863","KN296119v1","5266717","5267021","34","63458842"
"chr1","71140599","71140901","KN295573v1","1644468","1644772","34","69496131"
"chr1","71668179","71668488","KN294172v1","4419501","4419812","39","67248678"
"chr1","75714902","75715198","KN295287v1","40787","41080","31","75674115"
"chr1","76230880","76231173","KN294991v1","1107866","1108162","37","75123014"
"chr1","82521398","82521694","KN294685v1","1269570","1269869","34","81251828"
"chr1","87792422","87792721","KN295576v1","406337","406628","32","87386085"
"chr1","88169501","88169790","KN295576v1","406337","406628","37","87763164"
"chr1","88253668","88253962","KN297219v1","1714724","1715019","24","86538944"
"chr1","90069696","90069999","KN294193v1","690006","690308","33","89379690"
"chr1","94197577","94197701","KN294264v1","678105","678214","50","93519472"
"chr1","96553428","96553719","KN295576v1","406337","406628","27","96147091"
"chr1","96839080","96839218","KN297263v1","890000","890133","27","95949080"
"chr1","109676207","109676507","KN294665v1","171883","172197","48","109504324"
"chr1","110759587","110759669","KN296311v1","1646100","1646183","19","109113487"
"chr1","111288575","111288867","KN295721v1","13985","14280","28","111274590"
"chr1","112528952","112529265","KN294365v1","944056","944350","43","111584896"
"chr1","113843310","113843609","KN294193v1","690006","690308","31","113153304"
"chr1","119183570","119183870","KN294685v1","1269570","1269869","33","117914000"
"chr1","123829372","123829530","KN296470v1","174157","174317","39","123655215"
"chr1","124871089","124871153","KN297046v1","1058980","1059042","16","123812109"
"chr1","129295432","129295744","KN294685v1","1269570","1269869","37","128025862"
"chr1","132893612","132893720","KN295814v1","1288666","1288771","9","131604946"
"chr1","132898100","132898229","KN294420v1","516954","517082","16","132381146"
"chr1","135072364","135072663","KN296296v1","160831","161126","32","134911533"
"chr1","135519167","135519469","KN294526v1","558418","558721","31","134960749"
"chr1","137957502","137957653","KN296036v1","1088280","1088429","20","136869222"
"chr1","138131273","138131553","KN296665v1","24811","25083","51","138106462"
"chr1","139563048","139563111","KN294457v1","203850","203915","15","139359198"
"chr1","140997698","140998004","KN295573v1","1644468","1644772","40","139353230"
"chr1","141493560","141493840","KN294172v1","4372726","4373008","45","137120834"
"chr1","154504997","154505290","KN295576v1","406337","406628","33","154098660"
"chr1","158752185","158752488","KN297452v1","1683601","1683907","21","157068584"
"chr1","160419025","160419329","KN294526v1","558418","558721","33","159860607"
"chr1","161125389","161125689","KN296404v1","736642","736940","30","160388747"
"chr1","164200659","164200956","KN294685v1","1269570","1269869","40","162931089"
"chr1","172617629","172617925","KN295576v1","406337","406628","35","172211292"
"chr1","172622160","172622459","KN294470v1","1177614","1177910","34","171444546"
"chr1","177732875","177733180","KN294713v1","906670","906972","37","176826205"
"chr1","179159506","179159621","KN295315v1","1304753","1304876","25","177854753"
"chr1","180580433","180580729","KN297219v1","1714724","1715019","23","178865709"
"chr1","181877327","181877625","KN294420v1","890399","890698","28","180986928"
"chr1","181928047","181928330","KN296495v1","2052820","2053103","37","179875227"
"chr1","183799118","183799401","KN295576v1","406337","406628","29","183392781"
"chr1","184430103","184430404","KN294685v1","1269570","1269869","31","183160533"
"chr1","189065761","189066084","KN294665v1","171883","172197","44","188893878"
"chr1","190713809","190714098","KN294578v1","529845","530134","38","190183964"
"chr1","192065572","192065882","KN295202v1","417196","417507","43","191648376"
"chr1","192142038","192142346","KN294685v1","1269570","1269869","47","190872468"
"chr1","192553221","192553233","KN294326v1","685529","685541","8","191867692"
"chr1","192553458","192553477","KN294326v1","685529","685541","13","191867929"
"chr1","193360421","193360705","KN295576v1","406337","406628","47","192954084"
"chr1","209164754","209164837","KN296311v1","1646100","1646183","24","207518654"
"chr1","212136584","212136915","KN295576v1","406337","406628","63","211730247"
"chr1","212744044","212744353","KN294665v1","171883","172197","48","212572161"
"chr1","214289445","214289575","KN296040v1","489522","489654","14","213799923"
"chr1","215912467","215912747","KN296495v1","2052820","2053103","34","213859647"
"chr1","216038972","216039264","KN297219v1","1547695","1547989","148","214491277"
"chr1","217627827","217628131","KN294420v1","890399","890698","34","216737428"
"chr1","218935374","218935671","KN295315v1","992137","992431","31","217943237"
"chr1","228102920","228103206","KN295941v1","1108709","1108994","26","226994211"
"chr1","229763604","229763917","KN297313v1","927020","927329","45","228836584"
"chr3","4537860","4538172","KN295573v1","1644468","1644772","30","2893392"
"chr3","7487701","7488000","KN294685v1","1269570","1269869","38","6218131"
"chr3","9484727","9484879","KN295405v1","1830944","1831087","30","7653783"
"chr3","9541622","9541930","KN296387v1","301235","301539","32","9240387"
"chr3","10183254","10183531","KN296528v1","90077","90363","58","10093177"
"chr3","10708551","10708853","KN295172v1","269190","269486","26","10439361"
"chr3","11317285","11317298","KN294326v1","685529","685541","4","10631756"
"chr3","11317331","11317615","KN295941v1","1108709","1108994","33","10208622"
"chr3","24142671","24142746","KN295995v1","1901602","1901672","21","22241069"
"chr3","25616373","25616669","KN294685v1","1269570","1269869","27","24346803"
"chr3","26416144","26416455","KN294665v1","171883","172197","40","26244261"
"chr3","28165239","28165299","KN295136v1","33402","33464","15","28131837"
"chr3","28780419","28780724","KN296036v1","1090158","1090461","39","27690261"
"chr3","32261880","32262165","KN294613v1","30452","30742","45","32231428"
"chr3","32824508","32824780","KN296528v1","90077","90363","43","32734431"
"chr3","33762350","33762648","KN295633v1","731005","731302","34","33031345"
"chr3","38855157","38855440","KN294172v1","4372726","4373008","44","34482431"
"chr3","39472360","39472670","KN296387v1","301235","301539","33","39171125"
"chr3","40320179","40320475","KN297112v1","4703110","4703407","33","35617069"
"chr3","40646384","40646435","KN296682v1","4770996","4771052","20","35875388"
"chr3","43589919","43590221","KN296117v1","150360","150664","30","43439559"
"chr3","46713841","46714072","KN297259v1","2642198","2642414","33","44071643"
"chr3","46764256","46764554","KN294685v1","1269570","1269869","28","45494686"
"chr3","47931689","47932065","KN295596v1","2025229","2025530","195","45906460"
"chr3","48945501","48945810","KN297259v1","368593","368901","25","48576908"
"chr3","49389547","49389678","KN296990v1","49332","49458","29","49340215"
"chr3","49914900","49915034","KN296311v1","6037951","6038072","25","43876949"
"chr3","50065374","50065510","KN294269v1","66171","66308","16","49999203"
"chr3","50153077","50153187","KN296635v1","1811423","1811536","17","48341654"
"chr3","50275993","50276041","KN296849v1","913787","913837","12","49362206"
"chr3","50632844","50633148","KN294536v1","1833554","1833849","40","48799290"
"chr3","52762382","52762686","KN294526v1","558418","558721","36","52203964"
"chr3","58010119","58010261","KN294991v1","346166","346307","6","57663953"
"chr3","58995816","58996120","KN296387v1","301235","301539","33","58694581"
"chr3","61516423","61516734","KN297386v1","1388754","1389062","32","60127669"
"chr3","63018686","63018979","KN295573v1","1644468","1644772","33","61374218"
"chr3","66514106","66514407","KN294685v1","1269570","1269869","32","65244536"
"chr3","70528936","70529245","KN295205v1","907038","907347","41","69621898"
"chr3","75370645","75370944","KN294685v1","1269570","1269869","30","74101075"
"chr3","86304984","86305244","KN295439v1","247193","247443","51","86057791"
"chr3","92111885","92111990","KN297323v1","656594","656696","24","91455291"
"chr3","102486951","102487131","KN295717v1","1369230","1369404","28","101117721"
"chr3","104633018","104633201","KN294990v1","1","184","31","104633017"
"chr3","112100570","112100877","KN294172v1","4419501","4419812","30","107681069"
"chr3","113352508","113352580","KN296922v1","568825","568895","21","112783683"
"chr3","115089635","115089941","KN294693v1","1352700","1353006","30","113736935"
"chr3","125952122","125952420","KN296594v1","630492","630791","26","125321630"
"chr3","126415480","126415768","KN295576v1","406337","406628","28","126009143"
"chr3","127589039","127589332","KN294536v1","1833554","1833849","38","125755485"
"chr3","131869710","131870000","KN296634v1","1669748","1670034","36","130199962"
"chr3","132142164","132142461","KN294911v1","4958020","4958317","32","127184144"
"chr3","132149748","132149952","KN296505v1","400398","400602","38","131749350"
"chr3","134206328","134206632","KN297452v1","1683601","1683907","30","132522727"
"chr3","138007054","138007356","KN294193v1","690006","690308","33","137317048"
"chr3","143335432","143335724","KN295576v1","406337","406628","28","142929095"
"chr3","143423972","143424052","KN296922v1","568825","568895","21","142855147"
"chr3","146722657","146722951","KN294685v1","1269570","1269869","30","145453087"
"chr3","149476354","149476659","KN296119v1","5266717","5267021","38","144209637"
"chr3","151047599","151047904","KN294665v1","171883","172197","35","150875716"
"chr3","154075371","154075686","KN295441v1","640456","640765","43","153434915"
"chr3","155434559","155434639","KN296311v1","5980226","5980308","21","149454333"
"chr3","155493184","155493476","KN296620v1","581158","581456","36","154912026"
"chr3","157879940","157880248","KN294172v1","4419501","4419812","29","153460439"
"chr3","163160205","163160434","KN295202v1","512870","513091","33","162647335"
"chr3","165107147","165107295","KN297263v1","890000","890133","44","164217147"
"chr3","165677650","165677943","KN296191v1","251635","251928","32","165426015"
"chr3","177182827","177183155","KN294665v1","171883","172197","44","177010944"
"chr3","182173611","182173919","KN294685v1","1269570","1269869","41","180904041"
"chr3","182257388","182257698","KN296387v1","301235","301539","37","181956153"
"chr3","182494395","182494682","KN295416v1","44113","44401","41","182450282"
"chr3","182599568","182599879","KN295172v1","269190","269486","41","182330378"
"chr3","182605898","182606189","KN295576v1","406337","406628","33","182199561"
"chr3","182722283","182722576","KN295172v1","269190","269486","41","182453093"
"chr3","183372797","183372886","KN297323v1","656594","656696","27","182716203"
"chr3","186256302","186256599","KN294420v1","890399","890698","38","185365903"
"chr3","188168795","188169100","KN295573v1","1644468","1644772","32","186524327"
"chr3","188775240","188775515","KN296036v1","1402335","1402599","23","187372905"
"chr3","188980738","188980885","KN296119v1","5485404","5485553","18","183495334"
"chr3","189084278","189084576","KN294420v1","890399","890698","31","188193879"
"chr3","189847035","189847343","KN294685v1","1269570","1269869","49","188577465"
"chr3","191053733","191054005","KN296495v1","2052820","2053103","43","189000913"
"chr3","194321127","194321415","KN295941v1","1108709","1108994","32","193212418"
"chr3","194386780","194387078","KN294420v1","890399","890698","33","193496381"
"chr3","197528441","197528632","KN296290v1","476549","476739","12","197051892"
"chr3","197648322","197648613","KN294991v1","1107866","1108162","29","196540456"
"chr3","201321497","201321625","KN294614v1","295099","295217","34","201026398"
"chr3","203338926","203339103","KN295571v1","534235","534409","35","202804691"
"chr4","2578915","2579210","KN294685v1","1269570","1269869","30","1309345"
"chr4","11503580","11503895","KN297044v1","517135","517445","37","10986445"
"chr4","12328153","12328438","KN296743v1","2347268","2347551","51","9980885"
"chr4","12464176","12464489","KN294172v1","4419501","4419812","34","8044675"
"chr4","15392824","15393040","KN295430v1","12801","13030","44","15380023"
"chr4","20781116","20781249","KN294269v1","66171","66308","14","20714945"
"chr4","26273109","26273240","KN294269v1","66171","66308","15","26206938"
"chr4","27715146","27715231","KN294205v1","1346453","1346535","44","26368693"
"chr4","32208122","32208383","KN297028v1","684783","685041","45","31523339"
"chr4","40187531","40187744","KN296311v1","3342549","3342759","44","36844982"
"chr4","42116617","42116911","KN295576v1","406337","406628","26","41710280"
"chr4","42604764","42605076","KN295907v1","1531171","1531479","37","41073593"
"chr4","44375012","44375318","KN296387v1","301235","301539","65","44073777"
"chr4","47318337","47318633","KN296191v1","251635","251928","50","47066702"
"chr4","47706006","47706300","KN296110v1","161644","161937","40","47544362"
"chr4","51174617","51174852","KN295533v1","2708510","2708735","35","48466107"
"chr4","51355557","51355620","KN294457v1","203850","203915","14","51151707"
"chr4","52181730","52182031","KN294713v1","906670","906972","34","51275060"
"chr4","52905970","52906276","KN296541v1","476659","476959","25","52429311"
"chr4","54193230","54193515","KN296743v1","2347268","2347551","42","51845962"
"chr4","54290157","54290452","KN296110v1","161644","161937","33","54128513"
"chr4","55239680","55239989","KN294665v1","91019","91314","46","55148661"
"chr4","56844805","56844902","KN296825v1","1656571","1656656","27","55188234"
"chr4","59303292","59303589","KN295576v1","406337","406628","29","58896955"
"chr4","59907084","59907384","KN294685v1","1269570","1269869","34","58637514"
"chr4","71174631","71174908","KN294372v1","1494160","1494444","42","69680471"
"chr4","96650415","96650764","KN295592v1","1804108","1804419","69","94846307"
"chr4","112673988","112674291","KN297398v1","85283","85580","32","112588705"
"chr4","114160339","114160666","KN296974v1","258695","259015","44","113901644"
"chr4","115466796","115467098","KN296541v1","476659","476959","35","114990137"
"chr4","115707415","115707585","KN296290v1","476549","476739","46","115230866"
"chr4","119458358","119458417","KN294457v1","203850","203915","18","119254508"
"chr4","125478407","125478707","KN296541v1","476659","476959","33","125001748"
"chr4","126086935","126087221","KN295941v1","1108709","1108994","30","124978226"
"chr4","128942055","128942355","KN296311v1","7924000","7924299","37","121018055"
"chr4","131034277","131034584","KN295205v1","907038","907347","34","130127239"
"chr4","138749391","138749524","KN297263v1","890000","890133","28","137859391"
"chr4","139309736","139309788","KN294269v1","1390365","1390426","24","137919371"
"chr4","139459433","139459750","KN294685v1","1269570","1269869","48","138189863"
"chr4","141366610","141366675","KN294457v1","203850","203915","16","141162760"
"chr4","141844555","141844850","KN295576v1","406337","406628","31","141438218"
"chr4","142943533","142943822","KN295576v1","406337","406628","29","142537196"
"chr4","146191800","146192101","KN297083v1","743044","743342","32","145448756"
"chr4","153763728","153763825","KN297323v1","656594","656696","41","153107134"
"chr4","155102487","155102796","KN296119v1","5266717","5267021","41","149835770"
"chr4","155895734","155896039","KN294879v1","67464","67764","47","155828270"
"chr4","161258618","161258909","KN295854v1","1733121","1733418","40","159525497"
"chr4","161515780","161516074","KN296507v1","594831","595125","29","160920949"
"chr4","167188513","167188785","KN297112v1","2923769","2924046","38","164264744"
"chr4","169232120","169232423","KN296036v1","1090158","1090461","35","168141962"
"chr4","171661174","171661453","KN295576v1","406337","406628","40","171254837"
"chr4","172535231","172535525","KN295474v1","898764","899060","39","171636467"
"chr4","178730838","178731073","KN295294v1","3013800","3014046","36","175717038"
"chr4","186062892","186063194","KN294685v1","1269570","1269869","35","184793322"
"chr4","190476378","190476530","KN296470v1","174157","174317","24","190302221"
"chr4","192585406","192585702","KN294685v1","1269570","1269869","34","191315836"
"chr5","178257899","178258209","KN294685v1","1269570","1269869","45","176988329"
"chr5","2408783","2409095","KN295573v1","1644468","1644772","39","764315"
"chr5","3255761","3256042","KN295854v1","1733121","1733418","44","1522640"
"chr5","3580891","3581190","KN294685v1","1269570","1269869","38","2311321"
"chr5","4426356","4426646","KN294991v1","1107866","1108162","45","3318490"
"chr5","6655835","6655966","KN296040v1","489522","489654","16","6166313"
"chr5","9147633","9147928","KN296036v1","2050310","2050604","37","7097323"
"chr5","14226707","14226747","KN294471v1","360790","360827","19","13865917"
"chr5","28083597","28083896","KN296541v1","476659","476959","32","27606938"
"chr5","29717132","29717383","KN295439v1","247193","247443","50","29469939"
"chr5","31745572","31745867","KN295236v1","3481738","3482030","32","28263834"
"chr5","38278876","38278997","KN294527v1","22635","22759","23","38256241"
"chr5","41027318","41027614","KN295576v1","406337","406628","39","40620981"
"chr5","41487116","41487201","KN297217v1","1631","1713","18","41485485"
"chr5","41972607","41972850","KN295439v1","247193","247443","44","41725414"
"chr5","49825624","49825891","KN297028v1","684783","685041","51","49140841"
"chr5","49916874","49917161","KN296210v1","283065","283352","23","49633809"
"chr5","52194242","52194519","KN294345v1","136063","136342","32","52058179"
"chr5","52694631","52694932","KN296052v1","86362","86661","32","52608269"
"chr5","53265403","53265508","KN294581v1","238407","238513","10","53026996"
"chr5","58439786","58439927","KN294325v1","635905","636046","18","57803881"
"chr5","61890697","61890890","KN296470v1","174157","174317","72","61716540"
"chr5","62242139","62242433","KN296883v1","2444932","2445228","37","59797207"
"chr5","65041113","65041414","KN295721v1","13985","14280","27","65027128"
"chr5","69917213","69917344","KN296040v1","489522","489654","18","69427691"
"chr5","71856579","71856877","KN296495v1","1566946","1567248","31","70289633"
"chr5","72650403","72650627","KN297200v1","39391","39619","26","72611012"
"chr5","75714561","75714858","KN296201v1","478877","479164","29","75235684"
"chr5","76048730","76049032","KN296201v1","829989","830280","36","75218741"
"chr5","78366981","78367239","KN296743v1","2347268","2347551","52","76019713"
"chr5","78425935","78426228","KN295576v1","406337","406628","29","78019598"
"chr5","80619833","80620145","KN294665v1","171883","172197","33","80447950"
"chr5","83656670","83656935","KN295941v1","1108709","1108994","48","82547961"
"chr5","84199601","84199912","KN294172v1","4419501","4419812","37","79780100"
"chr5","100145587","100145890","KN294420v1","890399","890698","30","99255188"
"chr5","107190263","107190479","KN297341v1","187387","187612","36","107002876"
"chr5","109090484","109090697","KN297200v1","39391","39619","52","109051093"
"chr5","111898733","111899044","KN294526v1","558418","558721","36","111340315"
"chr5","112712126","112712427","KN294520v1","90499","90798","29","112621627"
"chr5","114388428","114388690","KN294647v1","144909","145144","61","114243519"
"chr5","117691356","117691646","KN295576v1","406337","406628","35","117285019"
"chr5","120198064","120198352","KN295576v1","406337","406628","36","119791727"
"chr5","120597102","120597234","KN295241v1","54708","54842","24","120542394"
"chr5","123676410","123676713","KN296541v1","476659","476959","34","123199751"
"chr5","125754171","125754466","KN294685v1","1269570","1269869","29","124484601"
"chr5","126095847","126096193","KN295294v1","1273221","1273523","72","124822626"
"chr5","126651337","126651650","KN294665v1","171883","172197","37","126479454"
"chr5","127902913","127903034","KN295315v1","1304753","1304876","22","126598160"
"chr5","128580152","128580197","KN296849v1","913787","913837","11","127666365"
"chr5","128680022","128680320","KN294954v1","166768","167066","26","128513254"
"chr5","132823996","132824125","KN294420v1","516954","517082","18","132307042"
"chr5","132975839","132976149","KN296921v1","822515","822822","35","132153324"
"chr5","133071013","133071147","KN295315v1","1304753","1304876","33","131766260"
"chr5","133528448","133528740","KN294911v1","4958020","4958317","31","128570428"
"chr5","133751908","133752191","KN296495v1","2052820","2053103","31","131699088"
"chr5","136036795","136036852","KN294758v1","2121332","2121387","13","133915463"
"chr5","136313066","136313137","KN296922v1","568825","568895","15","135744241"
"chr5","140443421","140443522","KN295096v1","1733611","1733710","15","138709810"
"chr5","142375519","142375807","KN295576v1","406337","406628","33","141969182"
"chr5","145800469","145800733","KN296495v1","2052820","2053103","52","143747649"
"chr5","151005120","151005234","KN295706v1","24918","25036","20","150980202"
"chr5","151157540","151157590","KN296308v1","697034","697090","12","150460506"
"chr5","152242905","152243204","KN296541v1","476659","476959","38","151766246"
"chr5","152388903","152389215","KN295090v1","503229","503541","41","151885674"
"chr5","152924588","152924887","KN294193v1","690006","690308","30","152234582"
"chr5","156058101","156058389","KN295077v1","496548","496840","35","155561553"
"chr5","159933860","159934160","KN295967v1","470774","471071","34","159463086"
"chr5","162209673","162209711","KN294471v1","360790","360827","8","161848883"
"chr5","162213323","162213616","KN295576v1","406337","406628","30","161806986"
"chr5","165661621","165661776","KN296154v1","1320280","1320426","26","164341341"
"chr5","165840961","165841258","KN295576v1","406337","406628","30","165434624"
"chr5","166316615","166316910","KN295576v1","406337","406628","32","165910278"
"chr5","172661725","172661858","KN295832v1","283853","283976","22","172377872"
"chr5","173497876","173498138","KN296665v1","24811","25083","58","173473065"
"chr5","174512743","174513052","KN294172v1","4419501","4419812","39","170093242"
"chr5","175216201","175216504","KN294552v1","673296","673605","71","174542905"
"chr5","178840696","178840986","KN295172v1","269190","269486","35","178571506"
"chr5","179292063","179292356","KN295576v1","406337","406628","29","178885726"
"chr5","183202330","183202420","KN296507v1","587287","587384","24","182615043"
"chr6","1752063","1752356","KN295576v1","406337","406628","31","1345726"
"chr6","8571435","8571743","KN296921v1","822515","822822","36","7748920"
"chr6","12376417","12376710","KN295172v1","269190","269486","37","12107227"
"chr6","15226427","15226562","KN294269v1","66171","66308","16","15160256"
"chr6","16841723","16842029","KN294685v1","1269570","1269869","42","15572153"
"chr6","19867955","19868262","KN294387v1","4385906","4386218","30","15482049"
"chr6","20721072","20721183","KN296635v1","1811423","1811536","18","18909649"
"chr6","21960709","21961005","KN295576v1","406337","406628","35","21554372"
"chr6","22678810","22679084","KN297327v1","439019","439302","41","22239791"
"chr6","23205880","23206180","KN294713v1","906670","906972","37","22299210"
"chr6","26578578","26578872","KN294536v1","1833554","1833849","45","24745024"
"chr6","27709016","27709295","KN295941v1","1108709","1108994","43","26600307"
"chr6","29143101","29143328","KN295533v1","2708510","2708735","34","26434591"
"chr6","29154725","29155035","KN294172v1","4419501","4419812","39","24735224"
"chr6","30445798","30446081","KN295576v1","406337","406628","40","30039461"
"chr6","31480728","31480858","KN296308v1","1041756","1041887","11","30438972"
"chr6","31518848","31519143","KN295474v1","898764","899060","31","30620084"
"chr6","35000383","35000675","KN295576v1","406337","406628","27","34594046"
"chr6","35499296","35499627","KN294693v1","1352700","1353006","54","34146596"
"chr6","36004450","36004758","KN294193v1","690006","690308","35","35314444"
"chr6","36069614","36069911","KN294526v1","558418","558721","41","35511196"
"chr6","36313706","36313840","KN294470v1","2658491","2658626","22","33655215"
"chr6","38041556","38041870","KN297313v1","927020","927329","33","37114536"
"chr6","44466107","44466414","KN296495v1","2154694","2155006","28","42311413"
"chr6","45958719","45959021","KN296970v1","257027","257330","30","45701692"
"chr6","49668087","49668381","KN295576v1","406337","406628","36","49261750"
"chr6","50850415","50850726","KN294693v1","1352700","1353006","41","49497715"
"chr6","51339239","51339533","KN297219v1","1547695","1547989","29","49791544"
"chr6","54517908","54518219","KN294172v1","4419501","4419812","41","50098407"
"chr6","65152506","65152788","KN295995v1","96471","96768","55","65056035"
"chr6","70733996","70734287","KN297219v1","1714724","1715019","35","69019272"
"chr6","74598391","74598686","KN297158v1","512906","513208","38","74085485"
"chr6","74651514","74651594","KN296311v1","1646100","1646183","22","73005414"
"chr6","74753718","74754027","KN294172v1","4419501","4419812","36","70334217"
"chr6","79459972","79460267","KN295172v1","269190","269486","36","79190782"
"chr6","80633776","80634077","KN296594v1","630492","630791","38","80003284"
"chr6","90929164","90929473","KN296487v1","155885","156190","36","90773279"
"chr6","94667437","94667734","KN295287v1","40787","41080","27","94626650"
"chr6","99098106","99098406","KN294685v1","1269570","1269869","39","97828536"
"chr6","104765237","104765447","KN296311v1","3342549","3342759","49","101422688"
"chr6","106412724","106412848","KN295315v1","1304753","1304876","17","105107971"
"chr6","108278952","108279251","KN296883v1","2444932","2445228","34","105834020"
"chr6","108962451","108962746","KN295576v1","406337","406628","31","108556114"
"chr6","109900423","109900488","KN296922v1","568825","568895","22","109331598"
"chr6","110418535","110418826","KN295077v1","496548","496840","38","109921987"
"chr6","110648325","110648631","KN295172v1","269190","269486","34","110379135"
"chr6","113029307","113029425","KN294446v1","507219","507341","17","112522088"
"chr6","113939094","113939326","KN294900v1","1359689","1359907","39","112579405"
"chr6","114462945","114463077","KN296040v1","489522","489654","20","113973423"
"chr6","118733604","118733903","KN297077v1","416198","416496","25","118317406"
"chr6","122443426","122443715","KN295315v1","992137","992431","37","121451289"
"chr6","124752910","124753120","KN294647v1","144909","145144","87","124608001"
"chr6","127412778","127413082","KN296496v1","794027","794330","29","126618751"
"chr6","130858748","130859093","KN296974v1","258695","259015","58","130600053"
"chr6","132084108","132084393","KN295205v1","747901","748198","53","131336207"
"chr6","134915437","134915501","KN294269v1","1390365","1390426","17","133525072"
"chr6","136732481","136732631","KN296470v1","174157","174317","28","136558324"
"chr6","138954944","138955239","KN297219v1","1714724","1715019","23","137240220"
"chr6","149107101","149107410","KN294239v1","364052","364364","46","148743049"
"chr6","152015860","152016154","KN296495v1","1709690","1709980","34","150306170"
"chr6","156366698","156367027","KN294665v1","171883","172197","50","156194815"
"chr6","158148517","158148798","KN294372v1","1494160","1494444","38","156654357"
"chr6","159430861","159431164","KN296496v1","794027","794330","40","158636834"
"chr6","162730566","162730690","KN295315v1","1304753","1304876","16","161425813"
"chr6","165443664","165443816","KN294325v1","635905","636046","28","164807759"
"chr7","2031819","2032123","KN294713v1","906670","906972","28","1125149"
"chr7","2457822","2458131","KN294685v1","1269570","1269869","39","1188252"
"chr7","6873685","6874001","KN294827v1","243670","243981","43","6630015"
"chr7","9434898","9435210","KN296356v1","841874","842188","39","8593024"
"chr7","21332294","21332605","KN294665v1","171883","172197","30","21160411"
"chr7","21420986","21421281","KN294991v1","1107866","1108162","37","20313120"
"chr7","23723072","23723356","KN294372v1","1494160","1494444","38","22228912"
"chr7","25370448","25370769","KN294665v1","171883","172197","44","25198565"
"chr7","27321839","27322138","KN294685v1","1269570","1269869","30","26052269"
"chr7","27955572","27955741","KN294458v1","1673985","1674148","25","26281587"
"chr7","31362841","31363152","KN296921v1","822515","822822","32","30540326"
"chr7","36049143","36049432","KN296541v1","476659","476959","45","35572484"
"chr7","38739545","38739645","KN295096v1","1733611","1733710","16","37005934"
"chr7","40466504","40466806","KN294685v1","1269570","1269869","39","39196934"
"chr7","42119210","42119356","KN294325v1","635905","636046","24","41483305"
"chr7","44328943","44329242","KN294685v1","1269570","1269869","28","43059373"
"chr7","45381948","45382068","KN295315v1","1304753","1304876","16","44077195"
"chr7","45717941","45718124","KN294458v1","1673985","1674148","42","44043956"
"chr7","47722249","47722376","KN297203v1","546013","546140","15","47176236"
"chr7","48306523","48306819","KN295077v1","496548","496840","34","47809975"
"chr7","50777553","50777864","KN296387v1","301235","301539","39","50476318"
"chr7","53299868","53300161","KN295753v1","255222","255516","38","53044646"
"chr7","53308398","53308692","KN295576v1","406337","406628","30","52902061"
"chr7","57135665","57135782","KN294446v1","507219","507341","22","56628446"
"chr7","63009460","63009748","KN296495v1","1709690","1709980","41","61299770"
"chr7","64129387","64129680","KN296883v1","2444932","2445228","35","61684455"
"chr7","73161295","73161435","KN296119v1","5513182","5513312","40","67648113"
"chr7","73161676","73161848","KN296470v1","174157","174317","64","72987519"
"chr7","73706829","73706965","KN294269v1","66171","66308","19","73640658"
"chr7","74784065","74784188","KN295315v1","1304753","1304876","17","73479312"
"chr7","75861575","75861708","KN296303v1","95275","95403","31","75766300"
"chr7","80416174","80416323","KN294325v1","635905","636046","31","79780269"
"chr7","81730644","81730950","KN296387v1","301235","301539","33","81429409"
"chr7","81828003","81828100","KN294457v1","346874","346962","20","81481129"
"chr7","82031982","82032135","KN296484v1","728553","728713","24","81303429"
"chr7","85606117","85606430","KN294172v1","4419501","4419812","42","81186616"
"chr7","89384427","89384728","KN297133v1","1008238","1008538","32","88376189"
"chr7","94450059","94450351","KN294420v1","890399","890698","34","93559660"
"chr7","97970819","97971130","KN295172v1","269190","269486","42","97701629"
"chr7","103072443","103072726","KN295576v1","406337","406628","30","102666106"
"chr7","111619507","111619821","KN296515v1","690174","690488","41","110929333"
"chr7","112599639","112599943","KN294526v1","558418","558721","30","112041221"
"chr7","113059601","113059897","KN294946v1","404366","404661","28","112655235"
"chr7","113085477","113085536","KN296849v1","913787","913837","15","112171690"
"chr7","114026916","114027196","KN295941v1","1108709","1108994","39","112918207"
"chr7","117137776","117137826","KN295601v1","571926","571977","11","116565850"
"chr7","117289683","117289790","KN296508v1","727224","727330","17","116562459"
"chr7","117442206","117442516","KN294193v1","690006","690308","35","116752200"
"chr7","119561606","119561816","KN294790v1","213980","214189","36","119347626"
"chr7","123274305","123274596","KN296201v1","829989","830280","39","122444316"
"chr7","129917052","129917355","KN295441v1","1459851","1460153","44","128457201"
"chr7","134097171","134097506","KN296387v1","301235","301539","57","133795936"
"chr7","135896188","135896484","KN295576v1","406337","406628","28","135489851"
"chr7","139225738","139225866","KN294614v1","295099","295217","28","138930639"
"chr7","139930227","139930509","KN296495v1","2052820","2053103","32","137877407"
"chr7","142211442","142211751","KN294685v1","1269570","1269869","31","140941872"
"chr7","142414413","142414723","KN296496v1","794027","794330","37","141620386"
"chr7","142655004","142655300","KN297219v1","1714724","1715019","43","140940280"
"chr7","144908984","144909242","KN296682v1","4866975","4867199","50","140042009"
"chr7","145649625","145649932","KN296119v1","5266717","5267021","33","140382908"
"chr7","148990637","148990940","KN294172v1","4419501","4419812","27","144571136"
"chr7","149518687","149518959","KN296528v1","90077","90363","43","149428610"
"chr7","149737698","149738008","KN294713v1","906670","906972","40","148831028"
"chr7","150053666","150053978","KN296486v1","499183","499482","52","149554483"
"chr7","152097280","152097582","KN294685v1","1269570","1269869","34","150827710"
"chr7","153482449","153482522","KN297159v1","1081621","1081688","21","152400828"
"chr7","155016615","155016926","KN294172v1","4419501","4419812","37","150597114"
"chr7","161769508","161769797","KN295172v1","269190","269486","48","161500318"
"chr8","1826027","1826341","KN295573v1","1644468","1644772","41","181559"
"chr8","3226882","3227177","KN295605v1","511648","511946","37","2715234"
"chr8","4641907","4642218","KN294665v1","171883","172197","42","4470024"
"chr8","4822208","4822347","KN297263v1","890000","890133","19","3932208"
"chr8","12052446","12052743","KN296541v1","476659","476959","37","11575787"
"chr8","21881429","21881724","KN296541v1","476659","476959","36","21404770"
"chr8","21941439","21941739","KN295172v1","269190","269486","31","21672249"
"chr8","24903160","24903455","KN295576v1","406337","406628","35","24496823"
"chr8","26770759","26770851","KN296635v1","3077277","3077373","15","23693482"
"chr8","31970015","31970324","KN295441v1","1090941","1091248","31","30879074"
"chr8","34686273","34686566","KN296110v1","161644","161937","27","34524629"
"chr8","35170635","35170980","KN295236v1","3375431","3375767","60","31795204"
"chr8","38208978","38209103","KN295315v1","1304753","1304876","16","36904225"
"chr8","38771325","38771533","KN297259v1","2642198","2642414","36","36129127"
"chr8","40023341","40023429","KN295893v1","2958721","2958798","37","37064620"
"chr8","40768822","40768952","KN296308v1","1041756","1041887","17","39727066"
"chr8","40860749","40860862","KN294351v1","53165","53278","5","40807584"
"chr8","43258307","43258602","KN294685v1","1269570","1269869","38","41988737"
"chr8","45124661","45124774","KN296635v1","1811423","1811536","14","43313238"
"chr8","46448805","46449107","KN296541v1","476659","476959","33","45972146"
"chr8","46755473","46755781","KN294526v1","558418","558721","34","46197055"
"chr8","47820112","47820245","KN296040v1","489522","489654","18","47330590"
"chr8","47832018","47832127","KN296508v1","727224","727330","17","47104794"
"chr8","48554897","48555183","KN295576v1","406337","406628","43","48148560"
"chr8","50500222","50500521","KN295172v1","269190","269486","33","50231032"
"chr8","59520859","59520987","KN294420v1","516954","517082","17","59003905"
"chr8","61137312","61137604","KN295576v1","406337","406628","31","60730975"
"chr8","63527673","63527970","KN294685v1","1269570","1269869","28","62258103"
"chr8","64858464","64858576","KN295112v1","593978","594084","20","64264486"
"chr8","64969010","64969246","KN294172v1","5339287","5339545","62","59629723"
"chr8","65388571","65388872","KN296117v1","150360","150664","28","65238211"
"chr8","69173600","69173883","KN297130v1","7468","7751","33","69166132"
"chr8","73114186","73114295","KN296316v1","167495","167598","18","72946691"
"chr8","78262671","78262959","KN295576v1","406337","406628","25","77856334"
"chr8","78445704","78446010","KN296387v1","301235","301539","32","78144469"
"chr8","85216941","85217258","KN296036v1","1090158","1090461","47","84126783"
"chr8","91287559","91287858","KN296541v1","476659","476959","32","90810900"
"chr8","92433676","92433970","KN297219v1","1714724","1715019","32","90718952"
"chr8","92797450","92797744","KN295576v1","406337","406628","31","92391113"
"chr8","96567004","96567078","KN294172v1","6135275","6135376","38","90431729"
"chr8","96905687","96905984","KN297112v1","4703110","4703407","31","92202577"
"chr8","101675459","101675767","KN294172v1","4419501","4419812","45","97255958"
"chr8","101757098","101757389","KN295576v1","406337","406628","26","101350761"
"chr8","104995334","104995641","KN294713v1","906670","906972","35","104088664"
"chr8","105909784","105910079","KN295576v1","406337","406628","34","105503447"
"chr8","113497969","113498267","KN297112v1","4703110","4703407","32","108794859"
"chr8","119352419","119352555","KN295744v1","576599","576728","32","118775820"
"chr8","119586502","119586798","KN294536v1","1833554","1833849","32","117752948"
"chr8","122197925","122197975","KN295601v1","571926","571977","6","121625999"
"chr8","122545695","122546026","KN296590v1","153446","153768","47","122392249"
"chr8","122741680","122741983","KN295592v1","1804108","1804419","27","120937572"
"chr8","123978717","123979026","KN296847v1","702702","703004","38","123276015"
"chr8","124285992","124286143","KN296119v1","5485404","5485553","24","118800588"
"chr8","127486915","127487215","KN294685v1","1269570","1269869","32","126217345"
"chr8","130020203","130020495","KN295576v1","406337","406628","40","129613866"
"chr8","130987210","130987506","KN297219v1","1714724","1715019","33","129272486"
"chr8","133543425","133543735","KN294552v1","673296","673605","39","132870129"
"chr8","138755111","138755394","KN296528v1","90077","90363","40","138665034"
"chr8","140036367","140036685","KN294703v1","42278","42595","39","139994089"
"chr8","140447971","140448284","KN297313v1","927020","927329","36","139520951"
"chr8","140609611","140609892","KN296495v1","2052820","2053103","29","138556791"
"chr8","142754771","142755065","KN296594v1","247516","247809","33","142507255"
"chr8","144160185","144160497","KN295573v1","1644468","1644772","33","142515717"
"chr8","144349010","144349160","KN296680v1","433827","433987","47","143915183"
"chr9","250934","251239","KN294685v1","1269570","1269869","26","1018636"
"chr9","374323","374471","KN296303v1","95275","95403","49","279048"
"chr9","4712154","4712441","KN294685v1","1269570","1269869","36","3442584"
"chr9","9774115","9774421","KN296541v1","476659","476959","41","9297456"
"chr9","19353122","19353412","KN295576v1","406337","406628","34","18946785"
"chr9","19394410","19394531","KN295967v1","680603","680725","6","18713807"
"chr9","19591114","19591409","KN295967v1","470774","471071","26","19120340"
"chr9","22058845","22059153","KN294193v1","690006","690308","36","21368839"
"chr9","27390498","27390796","KN294526v1","558418","558721","38","26832080"
"chr9","27804762","27805060","KN294685v1","1269570","1269869","31","26535192"
"chr9","29510332","29510633","KN294685v1","1269570","1269869","33","28240762"
"chr9","33547911","33548084","KN294375v1","773447","773616","24","32774464"
"chr9","34255895","34255992","KN297323v1","656594","656696","20","33599301"
"chr9","35776252","35776574","KN294239v1","2247547","2247856","40","33528705"
"chr9","36960392","36960690","KN295022v1","773263","773572","50","36187129"
"chr9","37114563","37114694","KN295705v1","644351","644482","15","36470212"
"chr9","37337409","37337515","KN296508v1","727224","727330","9","36610185"
"chr9","38308872","38309155","KN296508v1","1581573","1581854","25","36727299"
"chr9","39208280","39208379","KN297323v1","656594","656696","20","38551686"
"chr9","70330640","70330868","KN295430v1","12801","13030","18","70317839"
"chr9","70757836","70757922","KN296311v1","5980226","5980308","14","64777610"
"chr9","72043550","72043749","KN296505v1","400398","400602","69","71643152"
"chr9","72535434","72535584","KN296680v1","433827","433987","20","72101607"
"chr9","77737898","77738161","KN296495v1","2052820","2053103","47","75685078"
"chr9","78303424","78303711","KN295356v1","1515935","1516219","32","76787489"
"chr9","81069139","81069465","KN296590v1","153446","153768","46","80915693"
"chr9","82692039","82692336","KN294685v1","1269570","1269869","38","81422469"
"chr9","87488438","87488724","KN296495v1","2052820","2053103","35","85435618"
"chr9","88314911","88315196","KN295576v1","406337","406628","37","87908574"
"chr9","90570329","90570646","KN295907v1","1531171","1531479","35","89039158"
"chr9","95437137","95437441","KN296036v1","1090158","1090461","33","94346979"
"chr9","95918883","95919195","KN295315v1","719182","719484","42","95199701"
"chr9","100515294","100515544","KN295439v1","247193","247443","36","100268101"
"chr9","106599503","106599747","KN294172v1","5339287","5339545","58","101260216"
"chr9","115808957","115809235","KN297327v1","439019","439302","41","115369938"
"chr9","124688179","124688516","KN294470v1","2760850","2761198","58","121927329"
"chr9","128264082","128264381","KN295576v1","406337","406628","35","127857745"
"chr9","128270436","128270743","KN294685v1","1269570","1269869","31","127000866"
"chr9","129564444","129564515","KN295995v1","1901602","1901672","15","127662842"
"chr9","130879496","130879805","KN295576v1","406337","406628","45","130473159"
"chr9","130884282","130884583","KN295090v1","2732978","2733280","30","128151304"
"chr9","133120668","133120963","KN297008v1","4810218","4810528","33","128310450"
"chrX","643163","643288","KN294420v1","516954","517082","22","126209"
"chrX","1749967","1750094","KN294420v1","516954","517082","19","1233013"
"chrX","2197734","2197801","KN295995v1","1901602","1901672","20","296132"
"chrX","2198092","2198153","KN294758v1","2121332","2121387","22","76760"
"chrX","2466377","2466679","KN295735v1","1764721","1765028","27","701656"
"chrX","2483080","2483131","KN296538v1","670031","670081","18","1813049"
"chrX","6924141","6924207","KN296093v1","140233","140299","16","6783908"
"chrX","8488202","8488507","KN296387v1","301235","301539","32","8186967"
"chrX","12322020","12322323","KN295753v1","255222","255516","27","12066798"
"chrX","16074743","16075056","KN295441v1","640456","640765","35","15434287"
"chrX","16747943","16748234","KN295576v1","406337","406628","34","16341606"
"chrX","37228858","37229154","KN296541v1","476659","476959","28","36752199"
"chrX","42261233","42261534","KN295573v1","1644468","1644772","36","40616765"
"chrX","43820048","43820359","KN294592v1","95187","95496","62","43724861"
"chrX","45050018","45050321","KN296496v1","794027","794330","27","44255991"
"chrX","46521637","46521951","KN294879v1","67464","67764","38","46454173"
"chrX","49313787","49314073","KN295366v1","287911","288215","37","49025876"
"chrX","51881890","51882185","KN295576v1","406337","406628","30","51475553"
"chrX","54331479","54331792","KN295202v1","417196","417507","33","53914283"
"chrX","69478279","69478580","KN294685v1","1269570","1269869","26","68208709"
"chrX","70822057","70822353","KN294665v1","91019","91314","29","70731038"
"chrX","73157779","73158081","KN297219v1","1714724","1715019","41","71443055"
"chrX","73177191","73177499","KN295439v1","224659","224976","41","72952532"
"chrX","73307896","73307940","KN296849v1","913787","913837","14","72394109"
"chrX","73343500","73343660","KN296470v1","174157","174317","19","73169343"
"chrX","73760278","73760492","KN294172v1","5013237","5013438","42","68747041"
"chrX","73769691","73769998","KN296387v1","301235","301539","40","73468456"
"chrX","77487429","77487652","KN296682v1","4866975","4867199","38","72620454"
"chrX","84125539","84125822","KN296528v1","90077","90363","43","84035462"
"chrX","87538146","87538455","KN295404v1","120485","120796","40","87417661"
"chrX","91524788","91525093","KN294713v1","906670","906972","34","90618118"
"chrX","92823741","92824038","KN295172v1","269190","269486","32","92554551"
"chrX","97027069","97027379","KN294292v1","218461","218771","28","96808608"
"chrX","103309866","103310174","KN294172v1","4419501","4419812","40","98890365"
"chrX","113205864","113206156","KN296541v1","476659","476959","36","112729205"
"chrX","114260925","114261232","KN296387v1","301235","301539","33","113959690"
"chrX","114347363","114347658","KN296883v1","2444932","2445228","30","111902431"
"chrX","115027585","115027879","KN297219v1","1547695","1547989","28","113479890"
"chrX","115600287","115600599","KN296495v1","2154694","2155006","40","113445593"
"chrX","118826536","118826845","KN295592v1","1804108","1804419","34","117022428"
"chrX","119242958","119243083","KN295315v1","1304753","1304876","19","117938205"
"chrX","120072621","120072926","KN296847v1","702702","703004","33","119369919"
"chrX","123309562","123309857","KN296541v1","476659","476959","37","122832903"
"chrX","124057266","124057395","KN296119v1","5485404","5485553","39","118571862"
"chrX","127023907","127024211","KN295172v1","269190","269486","45","126754717"
"chrX","128152247","128152348","KN295112v1","593978","594084","13","127558269"
"chrX","131180004","131180308","KN296487v1","155885","156190","32","131024119"
"chrX","133920739","133921056","KN296117v1","150360","150664","42","133770379"
"chrX","136403703","136404001","KN294665v1","91019","91314","22","136312684"
"chrX","137105806","137106091","KN296119v1","1892024","1892327","41","135213782"
"chrX","137969705","137970000","KN294685v1","1269570","1269869","35","136700135"
"chrX","142895323","142895619","KN296883v1","2444932","2445228","33","140450391"
"chrX","150190996","150191279","KN295941v1","1108709","1108994","36","149082287"
"chrX","151794794","151795027","KN295096v1","3235522","3235754","39","148559272"
"chr10","3929956","3930242","KN295803v1","210008","210291","35","3719948"
"chr10","5769704","5770006","KN296387v1","301235","301539","38","5468469"
"chr10","10753929","10754232","KN296079v1","2352268","2352570","36","8401661"
"chr10","11926494","11926806","KN295202v1","417196","417507","34","11509298"
"chr10","12012175","12012474","KN295633v1","731005","731302","32","11281170"
"chr10","13864297","13864591","KN295576v1","406337","406628","35","13457960"
"chr10","17985560","17985850","KN294420v1","890399","890698","41","17095161"
"chr10","25022534","25022833","KN295523v1","1158105","1158404","33","23864429"
"chr10","25181358","25181482","KN295449v1","1018798","1018918","24","24162560"
"chr10","25455330","25455386","KN296682v1","4770996","4771052","25","20684334"
"chr10","28943149","28943466","KN294685v1","1269570","1269869","43","27673579"
"chr10","29503720","29504013","KN295077v1","496548","496840","34","29007172"
"chr10","31421164","31421451","KN295576v1","406337","406628","34","31014827"
"chr10","32154156","32154455","KN296913v1","140345","140647","31","32013811"
"chr10","35893352","35893655","KN295205v1","907038","907347","36","34986314"
"chr10","35966583","35966884","KN295480v1","2482108","2482407","34","33484475"
"chr10","38336074","38336373","KN295573v1","1644468","1644772","32","36691606"
"chr10","42734189","42734443","KN297028v1","684783","685041","42","42049406"
"chr10","49988804","49989101","KN295166v1","148690","148995","50","49840114"
"chr10","62077363","62077671","KN294989v1","18998","19310","31","62058365"
"chr10","66399818","66400102","KN294446v1","1222506","1222788","24","65177312"
"chr10","66887586","66887890","KN295441v1","1459851","1460153","32","65427735"
"chr10","67537994","67538287","KN294446v1","299255","299553","30","67238739"
"chr10","67628077","67628375","KN296119v1","5266717","5267021","32","62361360"
"chr10","68033723","68034016","KN295601v1","1374186","1374483","33","66659537"
"chr10","72529821","72530106","KN297046v1","2750328","2750614","25","69779493"
"chr10","73465252","73465558","KN297046v1","3415344","3415650","29","70049908"
"chr10","74522936","74523243","KN295573v1","1644468","1644772","29","72878468"
"chr10","75356151","75356463","KN294552v1","673296","673605","47","74682855"
"chr10","78186109","78186408","KN296119v1","1892024","1892327","37","76294085"
"chr10","81171309","81171604","KN295854v1","1733121","1733418","33","79438188"
"chr10","84612285","84612591","KN294685v1","1269570","1269869","32","83342715"
"chr10","86505401","86505709","KN295573v1","1644468","1644772","36","84860933"
"chr10","86881595","86881720","KN296990v1","49332","49458","36","86832263"
"chr10","91912918","91913227","KN294713v1","906670","906972","40","91006248"
"chr10","92062031","92062340","KN295573v1","1644468","1644772","30","90417563"
"chr10","92188661","92188938","KN296665v1","24811","25083","51","92163850"
"chr10","92532361","92532654","KN295576v1","406337","406628","27","92126024"
"chr10","93374693","93375004","KN296495v1","2154694","2155006","34","91219999"
"chr10","99376181","99376476","KN296138v1","431259","431551","34","98944922"
"chr10","100342437","100342518","KN295433v1","119691","119771","41","100222746"
"chr10","100772558","100772617","KN296308v1","697034","697090","18","100075524"
"chr10","101812561","101812715","KN296119v1","5485404","5485553","29","96327157"
"chr10","103306752","103307044","KN297219v1","1714724","1715019","32","101592028"
"chr10","108853931","108854230","KN296594v1","630492","630791","33","108223439"
"chr10","112427925","112428223","KN294685v1","1269570","1269869","37","111158355"
"chr10","114632322","114632623","KN294713v1","906670","906972","26","113725652"
"chr10","122251687","122251880","KN295929v1","255688","255882","31","121995999"
"chr10","125251249","125251548","KN295854v1","1733121","1733418","34","123518128"
"chr10","125672697","125672997","KN294790v1","2748723","2749032","36","122923974"
"chr10","125682395","125682579","KN295929v1","255688","255882","42","125426707"
"chr10","133211244","133211342","KN296153v1","2777116","2777220","24","130434128"
"chr11","3900166","3900460","KN295576v1","406337","406628","31","3493829"
"chr11","4564888","4565168","KN296119v1","6442175","6442445","40","1877287"
"chr11","7125609","7125906","KN296110v1","161644","161937","33","6963965"
"chr11","7771298","7771608","KN295441v1","640456","640765","39","7130842"
"chr11","9146564","9146694","KN296308v1","1041756","1041887","18","8104808"
"chr11","9563832","9564127","KN295287v1","40787","41080","32","9523045"
"chr11","9735287","9735603","KN294193v1","690006","690308","41","9045281"
"chr11","11494234","11494531","KN294685v1","1269570","1269869","30","10224664"
"chr11","12832349","12832607","KN297028v1","684783","685041","46","12147566"
"chr11","14237542","14237833","KN295576v1","406337","406628","26","13831205"
"chr11","16884249","16884534","KN296594v1","247516","247809","44","16636733"
"chr11","17013307","17013601","KN296883v1","2444932","2445228","26","14568375"
"chr11","21165708","21165851","KN297008v1","2343505","2343644","28","18822203"
"chr11","32174497","32174592","KN294457v1","346874","346962","16","31827623"
"chr11","32626975","32627258","KN294685v1","1269570","1269869","38","31357405"
"chr11","32849801","32850111","KN295592v1","1804108","1804419","41","31045693"
"chr11","33895570","33895873","KN294685v1","1269570","1269869","33","32626000"
"chr11","33906447","33906752","KN295172v1","269190","269486","44","33637257"
"chr11","36603136","36603418","KN294187v1","1420593","1420876","28","35182543"
"chr11","40108373","40108681","KN296387v1","301235","301539","46","39807138"
"chr11","40705147","40705442","KN295576v1","406337","406628","35","40298810"
"chr11","43840658","43840977","KN294172v1","4419501","4419812","49","39421157"
"chr11","46992937","46993228","KN295576v1","406337","406628","29","46586600"
"chr11","47280251","47280326","KN294457v1","203850","203915","23","47076401"
"chr11","47781650","47781937","KN296795v1","204395","204684","42","47577255"
"chr11","56410281","56410333","KN294182v1","217125","217170","13","56193156"
"chr11","57838000","57838303","KN295576v1","387614","387918","34","57450386"
"chr11","60761921","60762219","KN295596v1","2025229","2025530","32","58736692"
"chr11","61030941","61031237","KN295576v1","406337","406628","37","60624604"
"chr11","62512793","62512927","KN294456v1","621752","621886","7","61891041"
"chr11","62919220","62919283","KN296153v1","1877072","1877139","15","61042148"
"chr11","63751302","63751600","KN296541v1","476659","476959","32","63274643"
"chr11","64215717","64215934","KN295533v1","2708510","2708735","35","61507207"
"chr11","64217882","64217984","KN295610v1","471437","471537","17","63746445"
"chr11","66006767","66007059","KN296883v1","2444932","2445228","41","63561835"
"chr11","68640840","68641042","KN294790v1","213980","214189","38","68426860"
"chr11","72194611","72194904","KN295576v1","406337","406628","25","71788274"
"chr11","77122213","77122507","KN295576v1","406337","406628","26","76715876"
"chr11","84670545","84670847","KN294193v1","690006","690308","31","83980539"
"chr11","84920742","84920825","KN296311v1","1646100","1646183","34","83274642"
"chr11","85948727","85949014","KN295941v1","1108709","1108994","30","84840018"
"chr11","87939568","87939659","KN294873v1","1891816","1891917","29","86047752"
"chr11","90236457","90236749","KN295576v1","406337","406628","29","89830120"
"chr11","97060521","97060614","KN295433v1","119691","119771","28","96940830"
"chr11","97200012","97200303","KN295576v1","406337","406628","39","96793675"
"chr11","97952233","97952529","KN295576v1","406337","406628","32","97545896"
"chr11","102943941","102944244","KN296387v1","301235","301539","36","102642706"
"chr11","105947308","105947604","KN294685v1","1269570","1269869","29","104677738"
"chr11","106297475","106297781","KN294193v1","690006","690308","29","105607469"
"chr11","106746451","106746727","KN296665v1","24811","25083","51","106721640"
"chr11","108968213","108968504","KN295172v1","206196","206508","48","108762017"
"chr11","109028303","109028594","KN295172v1","269190","269486","32","108759113"
"chr11","112633109","112633228","KN295449v1","1018798","1018918","33","111614311"
"chr11","112799644","112799789","KN296119v1","5485404","5485553","38","107314240"
"chr11","115204337","115204639","KN296847v1","702702","703004","26","114501635"
"chr11","115393524","115393826","KN296594v1","630492","630791","27","114763032"
"chr11","116118033","116118142","KN295171v1","1536039","1536129","35","114581994"
"chr11","117808318","117808611","KN297219v1","1714724","1715019","35","116093594"
"chr11","117847785","117848085","KN295172v1","269190","269486","33","117578595"
"chr11","121204584","121204868","KN296495v1","2052820","2053103","21","119151764"
"chr11","123337633","123337763","KN296303v1","95275","95403","34","123242358"
"chr11","123357977","123358105","KN294614v1","295099","295217","26","123062878"
"chr11","127511812","127512120","KN295441v1","1459851","1460153","34","126051961"
"chr12","466058","466130","KN297042v1","21503","21573","23","444555"
"chr12","635532","635809","KN295576v1","406337","406628","50","229195"
"chr12","739824","740092","KN297112v1","4847613","4847901","57","4107789"
"chr12","1305905","1306222","KN294172v1","4419501","4419812","38","3113596"
"chr12","1788267","1788333","KN294457v1","203850","203915","18","1584417"
"chr12","1830141","1830433","KN295576v1","406337","406628","28","1423804"
"chr12","3007383","3007744","KN295967v1","504334","504633","161","2503049"
"chr12","6300085","6300368","KN296495v1","2052820","2053103","35","4247265"
"chr12","6643874","6644188","KN294420v1","890399","890698","46","5753475"
"chr12","7808560","7808858","KN296541v1","476659","476959","37","7331901"
"chr12","8020242","8020336","KN296153v1","2777116","2777220","30","5243126"
"chr12","8130971","8131283","KN295573v1","1644468","1644772","30","6486503"
"chr12","8294660","8294791","KN296040v1","489522","489654","20","7805138"
"chr12","14713853","14713954","KN295610v1","471437","471537","17","14242416"
"chr12","14984097","14984399","KN294536v1","1833554","1833849","36","13150543"
"chr12","15627671","15627732","KN296315v1","1221615","1221676","4","14406056"
"chr12","17762231","17762316","KN296311v1","1646100","1646183","19","16116131"
"chr12","18071020","18071183","KN296680v1","433827","433987","25","17637193"
"chr12","20338720","20339026","KN295705v1","322751","323056","32","20015969"
"chr12","20443911","20444136","KN295202v1","512870","513091","22","19931041"
"chr12","31701833","31702124","KN296296v1","160831","161126","34","31541002"
"chr12","31792979","31793274","KN294685v1","1269570","1269869","32","30523409"
"chr12","32518881","32519021","KN294269v1","66171","66308","15","32452710"
"chr12","32546520","32546763","KN297028v1","684783","685041","44","31861737"
"chr12","35702866","35702903","KN295739v1","419","454","19","35702447"
"chr12","38350673","38350723","KN295667v1","1785470","1785517","7","36565203"
"chr12","39167509","39167595","KN295623v1","383534","383623","27","38783975"
"chr12","40474489","40474784","KN296594v1","630492","630791","36","39843997"
"chr12","43823524","43823814","KN295576v1","406337","406628","33","43417187"
"chr12","47095045","47095315","KN296743v1","2347268","2347551","50","44747777"
"chr12","47650219","47650393","KN295987v1","190077","190249","24","47460142"
"chr12","50507205","50507496","KN295576v1","406337","406628","29","50100868"
"chr12","54773704","54774001","KN294685v1","1269570","1269869","32","53504134"
"chr12","55594639","55594894","KN295294v1","3013800","3014046","47","52580839"
"chr12","56229934","56230241","KN296726v1","733034","733337","33","55496900"
"chr12","57000689","57000997","KN296743v1","731892","732206","34","56268797"
"chr12","58269753","58270061","KN295573v1","1644468","1644772","37","56625285"
"chr12","60442784","60442819","KN294377v1","1352018","1352054","17","59090766"
"chr12","63971384","63971713","KN297390v1","188314","188648","53","63783070"
"chr12","69262300","69262339","KN296880v1","361571","361626","18","68900729"
"chr12","75953387","75953487","KN295171v1","1536039","1536129","31","74417348"
"chr12","83117259","83117553","KN295576v1","406337","406628","28","82710922"
"chr12","84977493","84977813","KN294703v1","42278","42595","44","84935215"
"chr12","85616146","85616463","KN296726v1","733034","733337","50","84883112"
"chr12","90440148","90440442","KN295576v1","406337","406628","24","90033811"
"chr12","95029089","95029382","KN294536v1","1833554","1833849","33","93195535"
"chr12","95586179","95586476","KN295523v1","2674466","2674763","32","92911713"
"chr12","95867723","95867941","KN296686v1","60808","61035","44","95806915"
"chr12","96730067","96730366","KN295287v1","40787","41080","35","96689280"
"chr12","99467952","99468249","KN294879v1","67464","67764","34","99400488"
"chr12","99516835","99517113","KN296036v1","1402335","1402599","48","98114500"
"chr12","105301547","105301850","KN295573v1","1644468","1644772","29","103657079"
"chr12","107540005","107540118","KN295112v1","593978","594084","24","106946027"
"chr12","109913130","109913221","KN296635v1","3077277","3077373","21","106835853"
"chr12","111042144","111042497","KN294470v1","2760850","2761198","55","108281294"
"chr12","111141069","111141205","KN294470v1","2658491","2658626","18","108482578"
"chr12","111572592","111572902","KN295586v1","818303","818604","34","110754289"
"chr12","111698037","111698341","KN295441v1","640456","640765","40","111057581"
"chr12","112307875","112308002","KN296063v1","1071241","1071375","20","111236634"
"chr12","112754126","112754278","KN296470v1","174157","174317","28","112579969"
"chr12","112872615","112872758","KN296119v1","5485404","5485553","33","107387211"
"chr12","119244455","119244757","KN294685v1","1269570","1269869","29","117974885"
"chr12","119338728","119338864","KN294269v1","66171","66308","21","119272557"
"chr12","119867742","119867828","KN296311v1","1646100","1646183","15","118221642"
"chr12","120529372","120529647","KN296495v1","2052820","2053103","33","118476552"
"chr12","120880803","120881137","KN297294v1","19447","19756","53","120861356"
"chr12","121528549","121528858","KN294526v1","558418","558721","38","120970131"
"chr12","122264010","122264319","KN295907v1","1531171","1531479","30","120732839"
"chr12","122528315","122528617","KN296594v1","247516","247809","31","122280799"
"chr12","123360636","123360924","KN294172v1","4372726","4373008","54","118987910"
"chr12","123385803","123386104","KN294420v1","890399","890698","37","122495404"
"chr12","124474634","124474786","KN294325v1","635905","636046","28","123838729"
"chr12","124572472","124572769","KN294685v1","1269570","1269869","28","123302902"
"chr12","124814540","124814596","KN296315v1","1221615","1221676","13","123592925"
"chr12","125369087","125369399","KN294172v1","4419501","4419812","40","120949586"
"chr12","126944475","126944766","KN295576v1","406337","406628","32","126538138"
"chr12","128907012","128907308","KN294536v1","1833554","1833849","37","127073458"
"chr12","135053987","135054281","KN295576v1","406337","406628","33","134647650"
"chr12","135167517","135167806","KN295576v1","406337","406628","35","134761180"
"chr13","18784546","18784843","KN295753v1","255222","255516","47","18529324"
"chr13","19300895","19301184","KN297327v1","439019","439302","59","18861876"
"chr13","20814614","20814742","KN294269v1","66171","66308","21","20748443"
"chr13","21089307","21089585","KN297130v1","7468","7751","34","21081839"
"chr13","22414771","22414971","KN295929v1","255688","255882","49","22159083"
"chr13","22415279","22415417","KN294269v1","66171","66308","18","22349108"
"chr13","22434276","22434556","KN296495v1","2052820","2053103","34","20381456"
"chr13","26413523","26413816","KN297219v1","1547695","1547989","34","24865828"
"chr13","32808161","32808453","KN295576v1","406337","406628","35","32401824"
"chr13","36270558","36270854","KN294685v1","1269570","1269869","27","35000988"
"chr13","36585347","36585658","KN294172v1","4419501","4419812","33","32165846"
"chr13","38415812","38415895","KN294205v1","1346453","1346535","12","37069359"
"chr13","41061038","41061333","KN297219v1","1547695","1547989","29","39513343"
"chr13","46395303","46395622","KN297112v1","4703110","4703407","61","41692193"
"chr13","47999641","47999958","KN295596v1","3388446","3388766","41","44611195"
"chr13","49356797","49357088","KN296528v1","90077","90363","32","49266720"
"chr13","51838486","51838765","KN296495v1","2052820","2053103","41","49785666"
"chr13","51916027","51916325","KN297219v1","1714724","1715019","28","50201303"
"chr13","51935517","51935806","KN297112v1","4703110","4703407","36","47232407"
"chr13","52381481","52381779","KN296747v1","24096","24398","28","52357385"
"chr13","55787109","55787404","KN295287v1","40787","41080","32","55746322"
"chr13","62093612","62093908","KN297219v1","1547695","1547989","30","60545917"
"chr13","63097734","63098033","KN294713v1","906670","906972","37","62191064"
"chr13","66276502","66276799","KN295441v1","1210326","1210620","47","65066176"
"chr13","69523578","69523900","KN295907v1","1531171","1531479","43","67992407"
"chr13","70112195","70112486","KN295576v1","406337","406628","32","69705858"
"chr13","72935936","72936229","KN296201v1","829989","830280","34","72105947"
"chr13","73462986","73463056","KN296495v1","2169486","2169556","11","71293500"
"chr13","78812206","78812516","KN296387v1","301235","301539","38","78510971"
"chr13","80539365","80539675","KN294172v1","4419501","4419812","32","76119864"
"chr13","80874310","80874460","KN295319v1","718049","718208","27","80156261"
"chr13","81907845","81908153","KN294172v1","4419501","4419812","35","77488344"
"chr13","85405792","85406102","KN295708v1","2824095","2824410","41","82581697"
"chr13","99914418","99914560","KN294325v1","635905","636046","16","99278513"
"chr13","100369318","100369610","KN295576v1","406337","406628","41","99962981"
"chr13","103158022","103158319","KN297112v1","4703110","4703407","30","98454912"
"chr13","104896331","104896585","KN296311v1","5339016","5339257","59","99557315"
"chr13","105742115","105742412","KN294989v1","18998","19310","41","105723117"
"chr13","108654517","108654602","KN296311v1","1646100","1646183","24","107008417"
"chr14","18547945","18548244","KN295172v1","269190","269486","36","18278755"
"chr14","20092727","20093026","KN296496v1","794027","794330","34","19298700"
"chr14","23264459","23264535","KN296311v1","5980226","5980308","24","17284233"
"chr14","23292537","23292832","KN294685v1","1269570","1269869","33","22022967"
"chr14","30295188","30295489","KN294685v1","1269570","1269869","31","29025618"
"chr14","31153976","31154098","KN294446v1","507219","507341","21","30646757"
"chr14","34550903","34551038","KN294167v1","327383","327516","21","34223520"
"chr14","36744093","36744390","KN294685v1","1269570","1269869","27","35474523"
"chr14","39552502","39552705","KN295573v1","179759","179967","55","39372743"
"chr14","45594140","45594434","KN295315v1","992137","992431","33","44602003"
"chr14","47995730","47996040","KN294526v1","558418","558721","46","47437312"
"chr14","48662864","48663161","KN294665v1","91019","91314","36","48571845"
"chr14","52452352","52452660","KN296921v1","822515","822822","38","51629837"
"chr14","53902736","53903030","KN295753v1","255222","255516","26","53647514"
"chr14","57065214","57065519","KN295705v1","246519","246825","40","56818695"
"chr14","57622865","57623172","KN295172v1","269190","269486","41","57353675"
"chr14","63192342","63192433","KN295112v1","593978","594084","25","62598364"
"chr14","64843034","64843131","KN295171v1","1536039","1536129","26","63306995"
"chr14","69822597","69822914","KN295892v1","94578","94892","25","69728019"
"chr14","72616723","72617032","KN294739v1","780175","780485","39","71836548"
"chr14","72787397","72787703","KN294172v1","4419501","4419812","42","68367896"
"chr14","72943508","72943650","KN294269v1","66171","66308","25","72877337"
"chr14","74970737","74971046","KN294172v1","4419501","4419812","39","70551236"
"chr14","76335952","76336249","KN294991v1","1107866","1108162","37","75228086"
"chr14","76457230","76457537","KN294239v1","2247547","2247856","35","74209683"
"chr14","76635341","76635652","KN296487v1","155885","156190","37","76479456"
"chr14","81294112","81294423","KN294827v1","243670","243981","33","81050442"
"chr14","85271888","85272197","KN296387v1","301235","301539","40","84970653"
"chr14","88596917","88597195","KN294536v1","1833554","1833849","42","86763363"
"chr14","89706465","89706763","KN295576v1","406337","406628","35","89300128"
"chr14","90406719","90407014","KN297158v1","512906","513208","27","89893813"
"chr14","93092255","93092554","KN295523v1","1158105","1158404","34","91934150"
"chr14","93889245","93889537","KN295576v1","406337","406628","30","93482908"
"chr14","94656661","94656968","KN295480v1","2482108","2482407","50","92174553"
"chr14","94744358","94744419","KN296495v1","2169486","2169556","19","92574872"
"chr14","102392503","102392668","KN294458v1","1673985","1674148","26","100718518"
"chr14","102526704","102526984","KN296495v1","2052820","2053103","35","100473884"
"chr14","102606647","102606945","KN294713v1","906670","906972","33","101699977"
"chr14","102616045","102616097","KN296261v1","233403","233455","12","102382642"
"chr14","102769507","102769816","KN297313v1","927020","927329","30","101842487"
"chr14","104094131","104094415","KN297327v1","439019","439302","42","103655112"
"chr14","104101840","104102004","KN297171v1","2860345","2860509","31","101241495"
"chr14","104206536","104206835","KN295172v1","269190","269486","30","103937346"
"chr14","105359078","105359389","KN295586v1","818303","818604","39","104540775"
"chr15","28289498","28289778","KN296844v1","1012757","1013034","41","27276741"
"chr15","28863805","28864113","KN294827v1","243670","243981","28","28620135"
"chr15","30882240","30882533","KN295576v1","406337","406628","29","30475903"
"chr15","38388487","38388644","KN296119v1","5485404","5485553","21","32903083"
"chr15","39594016","39594123","KN294581v1","238407","238513","24","39355609"
"chr15","40577457","40577494","KN296117v1","275581","275608","14","40301876"
"chr15","40873525","40873776","KN295294v1","3013800","3014046","41","37859725"
"chr15","41276071","41276380","KN297452v1","1683601","1683907","35","39592470"
"chr15","42518355","42518669","KN295753v1","255222","255516","53","42263133"
"chr15","43113166","43113466","KN294685v1","1269570","1269869","28","41843596"
"chr15","47765130","47765422","KN295576v1","406337","406628","35","47358793"
"chr15","47801485","47801549","KN296922v1","568825","568895","17","47232660"
"chr15","47979011","47979319","KN294665v1","171883","172197","35","47807128"
"chr15","52692349","52692429","KN297042v1","21503","21573","22","52670846"
"chr15","52708765","52709062","KN294685v1","1269570","1269869","29","51439195"
"chr15","52731466","52731741","KN296296v1","160831","161126","53","52570635"
"chr15","56641894","56642199","KN295404v1","120485","120796","37","56521409"
"chr15","56848209","56848524","KN295090v1","503229","503541","41","56344980"
"chr15","61338862","61339162","KN296547v1","406578","406877","30","60932284"
"chr15","62111360","62111650","KN295576v1","406337","406628","30","61705023"
"chr15","64481108","64481199","KN296969v1","66576","66675","16","64414532"
"chr15","65122364","65122658","KN295753v1","255222","255516","24","64867142"
"chr15","69294178","69294217","KN296036v1","2314125","2314170","19","66980053"
"chr15","73547842","73548134","KN297112v1","4703110","4703407","33","68844732"
"chr15","73913582","73913875","KN297415v1","635524","635813","41","73278058"
"chr15","76896521","76896629","KN296508v1","727224","727330","19","76169297"
"chr15","77091942","77092253","KN294685v1","1269570","1269869","35","75822372"
"chr15","78838478","78838776","KN294685v1","1269570","1269869","28","77568908"
"chr15","81245969","81246256","KN295576v1","406337","406628","34","80839632"
"chr15","82561518","82561673","KN296503v1","684847","685005","11","81876671"
"chr15","85929033","85929140","KN297323v1","656594","656696","25","85272439"
"chr15","88583916","88584209","KN295172v1","269190","269486","34","88314726"
"chr15","90006204","90006495","KN294827v1","243670","243981","49","89762534"
"chr15","90653481","90653781","KN296795v1","204395","204684","33","90449086"
"chr15","90672830","90672869","KN294377v1","1352018","1352054","19","89320812"
"chr15","91252891","91253007","KN297133v1","1145841","1145970","41","90107050"
"chr15","91826965","91827168","KN296311v1","3342549","3342759","35","88484416"
"chr15","96881634","96881766","KN294269v1","66171","66308","16","96815463"
"chr15","99175517","99175737","KN296682v1","4866975","4867199","34","94308542"
"chr15","99755654","99755949","KN294665v1","91019","91314","30","99664635"
"chr16","617454","617752","KN296079v1","1094036","1094332","36","476582"
"chr16","3178106","3178410","KN294420v1","890399","890698","43","2287707"
"chr16","3579584","3579877","KN295576v1","406337","406628","30","3173247"
"chr16","4168608","4168906","KN294685v1","1269570","1269869","33","2899038"
"chr16","4512974","4513176","KN295202v1","512870","513091","45","4000104"
"chr16","4579839","4580115","KN297112v1","2923769","2924046","34","1656070"
"chr16","9194583","9194882","KN295172v1","269190","269486","43","8925393"
"chr16","10801285","10801580","KN294536v1","1833554","1833849","32","8967731"
"chr16","12197633","12197821","KN296287v1","108021","108221","37","12089612"
"chr16","19458804","19459117","KN294493v1","1360399","1360706","34","18098405"
"chr16","22668212","22668518","KN294172v1","4419501","4419812","32","18248711"
"chr16","26815411","26815704","KN295753v1","255222","255516","37","26560189"
"chr16","30555816","30556108","KN295576v1","406337","406628","30","30149479"
"chr16","30765013","30765311","KN295854v1","1733121","1733418","33","29031892"
"chr16","45438301","45438476","KN295573v1","1406449","1406635","33","44031852"
"chr16","45984325","45984588","KN295439v1","247193","247443","49","45737132"
"chr16","45996434","45996552","KN297442v1","2078812","2078938","27","43917622"
"chr16","46564643","46564916","KN294289v1","383542","383816","38","46181101"
"chr16","46734075","46734378","KN294879v1","67464","67764","32","46666611"
"chr16","52230152","52230444","KN295576v1","406337","406628","29","51823815"
"chr16","52888461","52888750","KN295202v1","417196","417507","62","52471265"
"chr16","53631096","53631405","KN294827v1","243670","243981","32","53387426"
"chr16","54256946","54257247","KN294911v1","4958020","4958317","33","49298926"
"chr16","63906798","63906956","KN296503v1","684847","685005","29","63221951"
"chr16","63907043","63907335","KN295077v1","496548","496840","32","63410495"
"chr16","67313368","67313509","KN296036v1","1088280","1088429","27","66225088"
"chr16","67925872","67926181","KN294172v1","4419501","4419812","46","63506371"
"chr16","68699099","68699246","KN296096v1","695999","696146","19","68003100"
"chr16","69041637","69041822","KN294458v1","1673985","1674148","38","67367652"
"chr16","71393870","71394178","KN296387v1","301235","301539","36","71092635"
"chr16","71679644","71679773","KN294420v1","516954","517082","20","71162690"
"chr16","73452954","73453125","KN295987v1","190077","190249","28","73262877"
"chr16","75342618","75342700","KN295433v1","119691","119771","41","75222927"
"chr16","75556183","75556493","KN294665v1","171883","172197","31","75384300"
"chr16","75648843","75649157","KN294172v1","4419501","4419812","44","71229342"
"chr16","76297087","76297369","KN294279v1","389678","389959","33","75907409"
"chr16","77998850","77999137","KN295941v1","1108709","1108994","37","76890141"
"chr16","78015980","78016276","KN296825v1","2070464","2070757","35","75945516"
"chr16","83888658","83888958","KN296541v1","476659","476959","34","83411999"
"chr16","84705570","84705885","KN295441v1","640456","640765","40","84065114"
"chr16","84914235","84914530","KN296879v1","916075","916377","35","83998160"
"chr16","87652958","87653140","KN296503v1","684847","685005","50","86968111"
"chr16","88473684","88473981","KN296743v1","2347268","2347551","46","86126416"
"chr17","445303","445385","KN297133v1","346018","346100","6","99285"
"chr17","531973","532281","KN296387v1","301235","301539","32","230738"
"chr17","990574","990724","KN295405v1","1830944","1831087","26","840370"
"chr17","1035777","1035913","KN296682v1","4718382","4718517","11","3682605"
"chr17","1079721","1079858","KN296261v1","630427","630565","22","449294"
"chr17","1204167","1204383","KN295202v1","512870","513091","37","691297"
"chr17","2615047","2615099","KN294172v1","5604325","5604370","23","2989278"
"chr17","6403129","6403173","KN296849v1","913787","913837","19","5489342"
"chr17","6637934","6638259","KN294172v1","4419501","4419812","49","2218433"
"chr17","7197993","7198294","KN294526v1","558418","558721","32","6639575"
"chr17","7462434","7462566","KN296484v1","729438","729569","19","6732996"
"chr17","8391721","8392020","KN294526v1","558418","558721","55","7833303"
"chr17","9390402","9390707","KN296541v1","476659","476959","31","8913743"
"chr17","10061975","10062274","KN294536v1","1833554","1833849","39","8228421"
"chr17","11307596","11307893","KN294536v1","1833554","1833849","34","9474042"
"chr17","12392860","12393162","KN294193v1","690006","690308","32","11702854"
"chr17","13601011","13601299","KN294685v1","1269570","1269869","43","12331441"
"chr17","14262598","14262700","KN294264v1","678105","678214","28","13584493"
"chr17","14584106","14584398","KN294536v1","1833554","1833849","30","12750552"
"chr17","15657145","15657222","KN296311v1","5980226","5980308","25","9676919"
"chr17","15799263","15799492","KN296686v1","60808","61035","52","15738455"
"chr17","15983993","15984049","KN296315v1","1221615","1221676","14","14762378"
"chr17","17983360","17983439","KN297046v1","1058980","1059042","29","16924380"
"chr17","20014855","20014986","KN295828v1","718942","719076","18","19295913"
"chr17","26990349","26990648","KN294713v1","906670","906972","32","26083679"
"chr17","28213499","28213799","KN295967v1","470774","471071","36","27742725"
"chr17","29364445","29364758","KN296921v1","822515","822822","38","28541930"
"chr17","35302917","35303196","KN296743v1","333819","334110","45","34969098"
"chr17","35470098","35470389","KN295576v1","406337","406628","29","35063761"
"chr17","37237494","37237622","KN297442v1","2078812","2078938","29","35158682"
"chr17","37308496","37308804","KN296496v1","794027","794330","29","36514469"
"chr17","37893393","37893699","KN295573v1","1644468","1644772","31","36248925"
"chr17","37905920","37906235","KN295172v1","206196","206508","41","37699724"
"chr17","43472353","43472598","KN295791v1","56975","57210","65","43415378"
"chr17","46245473","46245771","KN295441v1","868719","869012","25","45376754"
"chr17","46280068","46280340","KN296665v1","24811","25083","45","46255257"
"chr17","46315556","46315852","KN296495v1","1709690","1709980","27","44605866"
"chr17","46821048","46821170","KN294588v1","633209","633334","19","46187839"
"chr17","46924521","46924815","KN294739v1","956532","956826","34","45967989"
"chr17","48105767","48105899","KN296484v1","729438","729569","14","47376329"
"chr17","49621041","49621347","KN294239v1","2247547","2247856","39","47373494"
"chr17","51826480","51826779","KN294446v1","1314524","1314819","41","50511956"
"chr17","52010897","52011042","KN296119v1","5485404","5485553","25","46525493"
"chr17","54285335","54285455","KN294874v1","1223812","1223932","22","53061523"
"chr17","58059754","58060048","KN295576v1","406337","406628","28","57653417"
"chr17","58365947","58366249","KN295705v1","322751","323056","35","58043196"
"chr17","60068458","60068574","KN295706v1","24918","25036","21","60043540"
"chr17","61135078","61135373","KN295633v1","731005","731302","35","60404073"
"chr17","61301922","61302227","KN295633v1","555294","555607","33","60746628"
"chr17","63634492","63634782","KN295441v1","1210326","1210620","38","62424166"
"chr17","65132193","65132482","KN294613v1","501900","502191","44","64630293"
"chr17","65265918","65266223","KN296117v1","150360","150664","34","65115558"
"chr17","66759178","66759464","KN296119v1","1892024","1892327","49","64867154"
"chr17","67125004","67125315","KN295977v1","210123","210432","36","66914881"
"chr17","67719536","67719633","KN296635v1","3077277","3077373","15","64642259"
"chr17","68778472","68778546","KN296153v1","1877072","1877139","16","66901400"
"chr17","68979334","68979633","KN295576v1","406337","406628","33","68572997"
"chr17","69702397","69702694","KN297112v1","4703110","4703407","27","64999287"
"chr17","73912871","73913110","KN297028v1","684783","685041","83","73228088"
"chr17","74621801","74622103","KN295172v1","269190","269486","38","74352611"
"chr17","74968393","74968520","KN296040v1","489522","489654","15","74478871"
"chr17","77827539","77827609","KN295725v1","637412","637480","9","77190127"
"chr17","77947796","77947892","KN295623v1","298261","298354","22","77649535"
"chr17","78391265","78391398","KN294269v1","66171","66308","21","78325094"
"chr17","78407134","78407426","KN296948v1","332463","332766","44","78074671"
"chr17","79613979","79614290","KN296117v1","150360","150664","34","79463619"
"chr18","4432207","4432336","KN295315v1","1304753","1304876","16","3127454"
"chr18","6927841","6928117","KN294187v1","1420593","1420876","42","5507248"
"chr18","7035008","7035312","KN295523v1","2674466","2674763","35","4360542"
"chr18","7883153","7883445","KN295576v1","406337","406628","34","7476816"
"chr18","8959133","8959429","KN295576v1","406337","406628","36","8552796"
"chr18","9024726","9025039","KN297008v1","4810218","4810528","37","4214508"
"chr18","13028507","13028727","KN296686v1","60808","61035","39","12967699"
"chr18","13244102","13244404","KN297158v1","512906","513208","38","12731196"
"chr18","15753238","15753531","KN295576v1","406337","406628","33","15346901"
"chr18","16492011","16492087","KN294457v1","203850","203915","20","16288161"
"chr18","16523589","16523654","KN294269v1","1390365","1390426","19","15133224"
"chr18","17900147","17900443","KN296541v1","476659","476959","37","17423488"
"chr18","20524488","20524699","KN295533v1","2708510","2708735","34","17815978"
"chr18","28869074","28869106","KN296836v1","996598","996635","11","27872476"
"chr18","31966705","31966997","KN295576v1","406337","406628","30","31560368"
"chr18","32445516","32445815","KN294685v1","1269570","1269869","35","31175946"
"chr18","33731998","33732120","KN294588v1","633209","633334","13","33098789"
"chr18","40429891","40430197","KN294193v1","690006","690308","31","39739885"
"chr18","40509102","40509406","KN294526v1","558418","558721","35","39950684"
"chr18","43818275","43818584","KN294703v1","42278","42595","44","43775997"
"chr18","49411570","49411846","KN297028v1","684783","685041","45","48726787"
"chr18","55704097","55704218","KN297133v1","966805","966921","35","54737292"
"chr18","59527463","59527762","KN297219v1","1714724","1715019","30","57812739"
"chr18","59848306","59848605","KN294685v1","1269570","1269869","27","58578736"
"chr18","60465077","60465392","KN295441v1","640456","640765","41","59824621"
"chr18","60493015","60493321","KN295573v1","1644468","1644772","34","58848547"
"chr18","72984488","72984788","KN295523v1","1158105","1158404","33","71826383"
"chr18","73196993","73197273","KN296495v1","2052820","2053103","37","71144173"
"chr18","73461881","73461986","KN297323v1","656594","656696","23","72805287"
"chr18","75566546","75566675","KN296308v1","1041756","1041887","22","74524790"
"chr19","1070271","1070400","KN294420v1","516954","517082","17","553317"
"chr19","1655518","1655641","KN296311v1","6037951","6038072","30","4382433"
"chr19","3850112","3850225","KN296635v1","1811423","1811536","31","2038689"
"chr19","4240140","4240244","KN296507v1","587287","587384","21","3652853"
"chr19","4512832","4512904","KN296153v1","2362414","2362489","12","2150418"
"chr19","4561848","4561888","KN296036v1","2023591","2023626","21","2538257"
"chr19","4808747","4809055","KN295573v1","1644468","1644772","39","3164279"
"chr19","6279025","6279330","KN296387v1","301235","301539","33","5977790"
"chr19","6877388","6877538","KN294458v1","1673985","1674148","27","5203403"
"chr19","7335879","7336002","KN295449v1","1018798","1018918","25","6317081"
"chr19","7723064","7723316","KN295096v1","3235522","3235754","49","4487542"
"chr19","7980480","7980775","KN294536v1","1833554","1833849","31","6146926"
"chr19","8745678","8745979","KN296119v1","5266717","5267021","33","3478961"
"chr19","9321630","9321702","KN297008v1","5130004","5130066","24","4191626"
"chr19","9337860","9338171","KN294172v1","4419501","4419812","36","4918359"
"chr19","10918435","10918516","KN297133v1","346018","346100","21","10572417"
"chr19","11371504","11371802","KN296296v1","160831","161126","30","11210673"
"chr19","11404305","11404418","KN296311v1","6037951","6038072","22","5366354"
"chr19","14088129","14088223","KN296969v1","66576","66675","23","14021553"
"chr19","14789757","14789873","KN294874v1","1223812","1223932","24","13565945"
"chr19","14945076","14945374","KN295236v1","3205485","3205777","38","11739591"
"chr19","15444154","15444455","KN294685v1","1269570","1269869","36","14174584"
"chr19","15475220","15475333","KN295708v1","2781761","2781847","48","12693459"
"chr19","16978416","16978731","KN295236v1","1464013","1464325","28","15514403"
"chr19","18198797","18199065","KN295526v1","1077411","1077700","51","17121386"
"chr19","18546897","18546978","KN296311v1","1646100","1646183","24","16900797"
"chr19","19519550","19519619","KN297404v1","104803","104861","20","19414747"
"chr19","19751138","19751434","KN295474v1","898764","899060","31","18852374"
"chr19","20204900","20204997","KN296507v1","587287","587384","18","19617613"
"chr19","21692835","21693141","KN295596v1","2025229","2025530","41","19667606"
"chr19","21928978","21929027","KN295601v1","571926","571977","8","21357052"
"chr19","21937056","21937341","KN297046v1","2750328","2750614","34","19186728"
"chr19","21998507","21998817","KN296922v1","536894","537215","45","21461613"
"chr19","23047607","23047645","KN295739v1","419","454","18","23047188"
"chr19","23047720","23047770","KN294269v1","1390365","1390426","19","21657355"
"chr19","23702197","23702526","KN295633v1","731005","731302","65","22971192"
"chr19","24017877","24018245","KN295172v1","269190","269486","139","23748687"
"chr19","24184129","24184430","KN296138v1","431259","431551","38","23752870"
"chr19","38371749","38372043","KN296138v1","431259","431551","30","37940490"
"chr19","38582483","38582779","KN294685v1","1269570","1269869","36","37312913"
"chr19","40776641","40776733","KN296635v1","3077277","3077373","15","37699364"
"chr19","41307023","41307330","KN296036v1","1090158","1090461","36","40216865"
"chr19","41490102","41490359","KN294445v1","503886","504168","52","40986216"
"chr19","41490389","41490414","KN296117v1","275581","275608","6","41214808"
"chr19","41882020","41882324","KN296921v1","822515","822822","33","41059505"
"chr19","44450220","44450526","KN295573v1","1644468","1644772","36","42805752"
"chr19","46206231","46206521","KN295236v1","3205485","3205777","42","43000746"
"chr19","46787080","46787377","KN297219v1","1714724","1715019","29","45072356"
"chr19","52284986","52285115","KN296303v1","95275","95403","12","52189711"
"chr19","52477816","52478114","KN295576v1","406337","406628","30","52071479"
"chr19","52648871","52648954","KN295725v1","637412","637480","25","52011459"
"chr19","53474331","53474623","KN295576v1","406337","406628","29","53067994"
"chr19","54030920","54031078","KN296119v1","5485404","5485553","24","48545516"
"chr19","54743300","54743345","KN297133v1","1000384","1000432","19","53742916"
"chr19","54844769","54845076","KN294703v1","42278","42595","36","54802491"
"chr19","55306138","55306434","KN296486v1","285322","285618","38","55020816"
"chr19","55505482","55505779","KN296119v1","1892024","1892327","40","53613458"
"chr19","55545291","55545601","KN296387v1","301235","301539","34","55244056"
"chr19","57896804","57897097","KN295236v1","437139","437427","37","57459665"
"chr19","58483558","58483695","KN294269v1","66171","66308","22","58417387"
"chr19","58483942","58484240","KN295077v1","496548","496840","39","57987394"
"chr19","58708728","58709038","KN295708v1","2824095","2824410","39","55884633"
"chr19","58723271","58723626","KN294536v1","1833554","1833849","158","56889717"
"chr19","58984343","58984464","KN296303v1","95275","95403","30","58889068"
"chr19","58993135","58993425","KN295236v1","437139","437427","33","58555996"
"chr19","59120673","59120802","KN296154v1","1320280","1320426","37","57800393"
"chr19","59911024","59911316","KN295576v1","406337","406628","27","59504687"
"chr19","61052908","61053206","KN296303v1","374680","374977","34","60678228"
"chr19","63222134","63222238","KN295112v1","593978","594084","21","62628156"
"chr19","63581165","63581366","KN296505v1","400398","400602","33","63180767"
"chr19","63705171","63705274","KN296969v1","66576","66675","35","63638595"
"chr19","63985140","63985375","KN296311v1","5339016","5339257","44","58646124"
"chr20","1761004","1761322","KN296387v1","301235","301539","40","1459769"
"chr20","2615254","2615442","KN294990v1","1","184","25","2615253"
"chr20","3292436","3292500","KN297404v1","104803","104861","16","3187633"
"chr20","3916353","3916562","KN296505v1","400398","400602","33","3515955"
"chr20","4796544","4796833","KN295576v1","406337","406628","29","4390207"
"chr20","5416068","5416369","KN297112v1","4703110","4703407","34","712958"
"chr20","5435543","5435624","KN297133v1","346018","346100","18","5089525"
"chr20","6260949","6261256","KN294526v1","558418","558721","33","5702531"
"chr20","11542503","11542754","KN296311v1","5339016","5339257","45","6203487"
"chr20","21166970","21167062","KN296316v1","167495","167598","30","20999475"
"chr20","25541790","25541940","KN296036v1","1088280","1088429","18","24453510"
"chr20","31119093","31119184","KN296635v1","3077277","3077373","13","28041816"
"chr20","31891331","31891564","KN297259v1","2642198","2642414","41","29249133"
"chr20","33090650","33090959","KN295441v1","640456","640765","32","32450194"
"chr20","34546662","34546959","KN297219v1","1714724","1715019","32","32831938"
"chr20","36738640","36738936","KN294685v1","1269570","1269869","28","35469070"
"chr20","41037256","41037542","KN294420v1","890399","890698","61","40146857"
"chr20","41930169","41930432","KN296809v1","884049","884326","50","41046120"
"chr20","47560162","47560276","KN295112v1","593978","594084","22","46966184"
"chr20","47582011","47582314","KN295366v1","287911","288215","36","47294100"
"chr20","48261384","48261676","KN295576v1","406337","406628","31","47855047"
"chr20","48371164","48371473","KN295523v1","3962105","3962411","36","44409059"
"chr20","49646861","49647158","KN295172v1","269190","269486","28","49377671"
"chr20","51504961","51505260","KN295172v1","269190","269486","34","51235771"
"chr20","52051378","52051674","KN295605v1","511648","511946","30","51539730"
"chr20","54013566","54013876","KN294172v1","4419501","4419812","37","49594065"
"chr20","61506278","61506458","KN295717v1","1369230","1369404","42","60137048"
"chr20","61824894","61825198","KN295573v1","1644468","1644772","32","60180426"
"chr21","21079007","21079324","KN294703v1","42278","42595","40","21036729"
"chr21","23502406","23502651","KN295439v1","247193","247443","54","23255213"
"chr21","24653047","24653333","KN295941v1","1108709","1108994","44","23544338"
"chr21","24870844","24870964","KN294588v1","633209","633334","23","24237635"
"chr21","25380097","25380390","KN295077v1","496548","496840","26","24883549"
"chr21","29607379","29607510","KN296982v1","350696","350830","19","29256683"
"chr21","32299564","32299864","KN294420v1","890399","890698","30","31409165"
"chr21","33505240","33505520","KN295941v1","1108709","1108994","24","32396531"
"chr21","36067825","36068125","KN294685v1","1269570","1269869","31","34798255"
"chr21","41692040","41692166","KN295705v1","644351","644482","19","41047689"
"chr21","43664904","43665206","KN294879v1","67464","67764","36","43597440"
"chr21","45922411","45922708","KN297112v1","4703110","4703407","33","41219301"
"chr22","16188811","16189117","KN295573v1","1644468","1644772","35","14544343"
"chr22","16194667","16194962","KN294345v1","1804038","1804336","35","14390629"
"chr22","16464813","16465112","KN297313v1","927020","927329","48","15537793"
"chr22","16701362","16701489","KN296303v1","95275","95403","28","16606087"
"chr22","18098510","18098805","KN295576v1","406337","406628","31","17692173"
"chr22","20250763","20250887","KN296303v1","95275","95403","22","20155488"
"chr22","20306233","20306490","KN295430v1","12801","13030","51","20293432"
"chr22","21968786","21969072","KN295576v1","406337","406628","39","21562449"
"chr22","22425978","22426101","KN295315v1","1304753","1304876","16","21121225"
"chr22","23295121","23295410","KN296594v1","630492","630791","39","22664629"
"chr22","27463604","27463692","KN296507v1","587287","587384","28","26876317"
"chr22","27491881","27492180","KN294420v1","890399","890698","33","26601482"
"chr22","27638931","27639232","KN294665v1","91019","91314","26","27547912"
"chr22","27782518","27782802","KN294372v1","1494160","1494444","29","26288358"
"chr22","28205967","28206273","KN295573v1","1644468","1644772","37","26561499"
"chr22","28772981","28773287","KN294842v1","1377815","1378119","45","27395166"
"chr22","29367450","29367745","KN295576v1","406337","406628","29","28961113"
"chr22","29855034","29855297","KN294578v1","529845","530134","62","29325189"
"chr22","30679698","30679984","KN295941v1","1108709","1108994","35","29570989"
"chr22","30875233","30875358","KN294457v1","122220","122347","22","30753013"
"chr22","31035963","31036116","KN296470v1","174157","174317","45","30861806"
"chr22","31488677","31488840","KN295586v1","521155","521317","25","30967522"
"chr22","31992444","31992756","KN294665v1","171883","172197","37","31820561"
"chr22","37293432","37293566","KN294420v1","516954","517082","20","36776478"
"chr22","40190729","40190798","KN297008v1","5130004","5130066","14","35060725"
"chr22","40741512","40741584","KN294269v1","407624","407690","15","40333888"
"chr22","40991816","40992126","KN294387v1","4385906","4386218","27","36605910"
"chr22","41170971","41171081","KN296508v1","727224","727330","25","40443747"
"chr22","43779077","43779208","KN296040v1","489522","489654","14","43289555"
"chr22","43898448","43898731","KN296495v1","2052820","2053103","31","41845628"
"chr22","49299382","49299681","KN294420v1","890399","890698","29","48408983"
"chr2A","4380328","4380636","KN294193v1","690006","690308","36","3690322"
"chr2A","8344349","8344497","KN294325v1","635905","636046","18","7708444"
"chr2A","8727300","8727511","KN296311v1","3342549","3342759","38","5384751"
"chr2A","11411885","11412181","KN295576v1","406337","406628","36","11005548"
"chr2A","14569629","14569925","KN294387v1","1945421","1945717","37","12624208"
"chr2A","23954954","23955250","KN296883v1","2444932","2445228","30","21510022"
"chr2A","24935301","24935606","KN296541v1","476659","476959","39","24458642"
"chr2A","25806717","25807032","KN295705v1","322751","323056","43","25483966"
"chr2A","25963990","25964285","KN297404v1","65826","66118","35","25898164"
"chr2A","26145471","26145606","KN294269v1","66171","66308","13","26079300"
"chr2A","26965912","26966207","KN295236v1","3205485","3205777","31","23760427"
"chr2A","27232374","27232705","KN297180v1","680074","680399","43","26552300"
"chr2A","28558532","28558821","KN296495v1","2052820","2053103","34","26505712"
"chr2A","28558857","28558883","KN296117v1","275581","275608","11","28283276"
"chr2A","29384871","29385171","KN294193v1","690006","690308","31","28694865"
"chr2A","34125792","34126096","KN296948v1","332463","332766","24","33793329"
"chr2A","37698894","37699188","KN296110v1","161644","161937","30","37537250"
"chr2A","39896000","39896289","KN294520v1","90499","90798","41","39805501"
"chr2A","40699112","40699406","KN295666v1","1831328","1831616","27","38867784"
"chr2A","42870631","42870919","KN295576v1","406337","406628","37","42464294"
"chr2A","42964242","42964546","KN294193v1","690006","690308","28","42274236"
"chr2A","43580487","43580785","KN294420v1","890399","890698","34","42690088"
"chr2A","44597811","44598107","KN296110v1","161644","161937","34","44436167"
"chr2A","45147016","45147211","KN296290v1","476549","476739","35","44670467"
"chr2A","47969625","47969925","KN297008v1","5066230","5066524","34","42903395"
"chr2A","47976367","47976667","KN296496v1","794027","794330","31","47182340"
"chr2A","48417704","48417834","KN295705v1","644351","644482","14","47773353"
"chr2A","48727898","48728211","KN294665v1","171883","172197","38","48556015"
"chr2A","48996656","48996950","KN295705v1","26958","27263","37","48969698"
"chr2A","55059313","55059610","KN294536v1","1833554","1833849","32","53225759"
"chr2A","55765165","55765456","KN296496v1","794027","794330","40","54971138"
"chr2A","62390554","62390849","KN294457v1","638774","639067","37","61751780"
"chr2A","65261030","65261333","KN294713v1","906670","906972","29","64354360"
"chr2A","65427361","65427453","KN295096v1","1733611","1733710","17","63693750"
"chr2A","65890261","65890551","KN295576v1","406337","406628","34","65483924"
"chr2A","70582141","70582458","KN296200v1","554001","554328","42","70028140"
"chr2A","70658674","70658966","KN297112v1","4703110","4703407","37","65955564"
"chr2A","71380906","71381197","KN295576v1","406337","406628","46","70974569"
"chr2A","72755890","72756197","KN295294v1","1273221","1273523","34","71482669"
"chr2A","72966719","72966990","KN295941v1","1108709","1108994","44","71858010"
"chr2A","74453224","74453478","KN295294v1","3013800","3014046","31","71439424"
"chr2A","80108479","80108762","KN295576v1","406337","406628","36","79702142"
"chr2A","84245293","84245602","KN295172v1","206196","206508","41","84039097"
"chr2A","84722717","84722997","KN297130v1","7468","7751","41","84715249"
"chr2A","88268647","88268960","KN294665v1","171883","172197","37","88096764"
"chr2A","89401176","89401308","KN296990v1","49332","49458","38","89351844"
"chr2A","89459394","89459701","KN295592v1","1804108","1804419","37","87655286"
"chr2A","96173034","96173242","KN295315v1","258284","258494","20","95914750"
"chr2A","97257900","97258205","KN295315v1","719182","719484","25","96538718"
"chr2A","97640023","97640318","KN295315v1","992137","992431","28","96647886"
"chr2A","105974827","105975134","KN296847v1","702702","703004","37","105272125"
"chr2A","109861078","109861386","KN294365v1","944056","944350","45","108917022"
"chr2A","110326299","110326604","KN295441v1","1459851","1460153","33","108866448"
"chr2A","110365899","110366211","KN294172v1","4419501","4419812","33","105946398"
"chr2A","110587162","110587239","KN295995v1","1901602","1901672","18","108685560"
"chr2A","110619409","110619530","KN296311v1","6037951","6038072","22","104581458"
"chr2A","110796659","110796791","KN296761v1","1003802","1003933","19","109792857"
"chr2A","111240922","111241084","KN295319v1","718049","718208","31","110522873"
"chr2A","111396189","111396353","KN296484v1","728553","728713","24","110667636"
"chr2A","113042551","113042860","KN295967v1","470774","471071","40","112571777"
"chr2A","114037480","114037787","KN295667v1","385505","385818","37","113651975"
"chr2A","114303308","114303610","KN296002v1","53282","53587","31","114250026"
"chr2B","120524239","120524541","KN294685v1","1269570","1269869","46","119254669"
"chr2B","125198231","125198539","KN294536v1","1833554","1833849","47","123364677"
"chr2B","127779704","127779925","KN295533v1","2708510","2708735","19","125071194"
"chr2B","128456738","128456867","KN295449v1","1018798","1018918","35","127437940"
"chr2B","130567937","130568251","KN297313v1","927020","927329","39","129640917"
"chr2B","132340758","132341063","KN296387v1","301235","301539","36","132039523"
"chr2B","144836473","144836773","KN296541v1","476659","476959","27","144359814"
"chr2B","146552515","146552814","KN296119v1","1892024","1892327","43","144660491"
"chr2B","147679603","147679913","KN297313v1","927020","927329","33","146752583"
"chr2B","148430441","148430734","KN295576v1","406337","406628","34","148024104"
"chr2B","153176724","153177029","KN294665v1","171883","172197","38","153004841"
"chr2B","155069806","155070094","KN295576v1","406337","406628","32","154663469"
"chr2B","155880765","155881076","KN294193v1","690006","690308","34","155190759"
"chr2B","156562599","156562893","KN295576v1","406337","406628","32","156156262"
"chr2B","162501371","162501483","KN294588v1","633209","633334","26","161868162"
"chr2B","163614540","163614702","KN296119v1","5485404","5485553","29","158129136"
"chr2B","163950626","163950931","KN294693v1","1352700","1353006","39","162597926"
"chr2B","174342483","174342643","KN294420v1","516954","517082","45","173825529"
"chr2B","175787449","175787747","KN296702v1","625511","625814","40","175161938"
"chr2B","176875021","176875331","KN294713v1","906670","906972","35","175968351"
"chr2B","178066346","178066517","KN295987v1","190077","190249","22","177876269"
"chr2B","178898175","178898477","KN294685v1","1269570","1269869","27","177628605"
"chr2B","179162454","179162592","KN296119v1","5485404","5485553","23","173677050"
"chr2B","179901318","179901600","KN295576v1","406337","406628","36","179494981"
"chr2B","192466555","192466616","KN295601v1","571926","571977","15","191894629"
"chr2B","194683738","194684039","KN296541v1","476659","476959","27","194207079"
"chr2B","194747386","194747691","KN295441v1","640456","640765","32","194106930"
"chr2B","197119504","197119796","KN296594v1","247516","247809","32","196871988"
"chr2B","202313591","202313903","KN296387v1","301235","301539","41","202012356"
"chr2B","202859908","202860227","KN296528v1","90077","90363","77","202769831"
"chr2B","206287029","206287318","KN296883v1","2444932","2445228","36","203842097"
"chr2B","207795874","207796168","KN297219v1","1714724","1715019","37","206081150"
"chr2B","207844414","207844497","KN296311v1","1646100","1646183","21","206198314"
"chr2B","207853784","207854083","KN297112v1","4703110","4703407","32","203150674"
"chr2B","208639206","208639261","KN295601v1","571926","571977","9","208067280"
"chr2B","210446575","210446830","KN297028v1","684783","685041","37","209761792"
"chr2B","211589506","211589789","KN295576v1","406337","406628","39","211183169"
"chr2B","213346119","213346418","KN294526v1","558418","558721","38","212787701"
"chr2B","215320185","215320490","KN295573v1","1644468","1644772","30","213675717"
"chr2B","221422469","221422766","KN294536v1","1833554","1833849","30","219588915"
"chr2B","224377269","224377555","KN296594v1","630492","630791","39","223746777"
"chr2B","224389414","224389506","KN296507v1","587287","587384","24","223802127"
"chr2B","229085822","229086129","KN295573v1","1644468","1644772","32","227441354"
"chr2B","230560147","230560446","KN294685v1","1269570","1269869","31","229290577"
"chr2B","237279818","237280117","KN296387v1","301235","301539","31","236978583"
"chr2B","238769011","238769311","KN294172v1","4419501","4419812","45","234349510"
"chr2B","239843560","239843862","KN294193v1","690006","690308","34","239153554"
"chr2B","243506904","243507024","KN296266v1","1311","1438","23","243505593"
"chr2B","244910382","244910674","KN295576v1","406337","406628","34","244504045"
"chr2B","245056551","245056694","KN296261v1","630427","630565","33","244426124"
"chr2B","247140206","247140523","KN294713v1","906670","906972","47","246233536"
"chrUn_NW_014014883v1","1","75","KN294457v1","346874","346962","27","346873"
"chrUn_NW_014015545v1","258","569","KN294172v1","4419501","4419812","36","4419243"
"chrUn_NW_014015551v1","280","579","KN295172v1","269190","269486","31","268910"
"chrUn_NW_014016419v1","538","835","KN295576v1","406337","406628","37","405799"
"chrUn_NW_014016667v1","1","131","KN296761v1","1003802","1003933","18","1003801"
"chrUn_NW_014016877v1","103606","103915","KN295573v1","1644468","1644772","32","1540862"
"chrUn_NW_014017148v1","609","902","KN295573v1","1644468","1644772","47","1643859"
"chrUn_NW_014017330v1","77440","77578","KN296303v1","95275","95403","22","17835"
"chrUn_NW_014017366v1","1807","1944","KN296040v1","489522","489654","23","487715"
"chrUn_NW_014018071v1","268","573","KN294193v1","690006","690308","30","689738"
"chrUn_NW_014018119v1","149","432","KN296495v1","2052820","2053103","29","2052671"
"chrUn_NW_014018421v1","354","486","KN296484v1","729438","729569","11","729084"
"chrUn_NW_014018421v1","487","503","KN294613v1","501853","501863","14","501366"
"chrUn_NW_014018421v1","961","1106","KN294365v1","2020015","2020167","28","2019054"
