"chr1","5721078","5721383","KN296311v1","7924000","7924299","38","2202922","GGCCAAGAGCGGTGGCTCACGACTGTAACTCCAGCACTTTGGGAGGCCAAGGCAGGTGGATCACCTGAGGTCAGGAGTTCCAGACCAGCCTGGCCAATATAGTGAAACCCCGTCCCTACTAAAAATACAAAAAGTTAGCCAGGCGTGGTGGCATGTGCCTGTAATCCCAGCTACTAGGGAGGCTGAGGCAGGAGAATCGCTTGAACCCAGGAGACAGAGGTTGCCGTGAGCCGAGATTGCGCCATCGCACTCCAGCCTGGGCGACAAAGGCAAGGCTTTGTTCTCAAAAAATAAAAATAAAATAAA","GGCCAGGCGCGGTGGCTCACACCTGTAATCCCAGCACTTTGGGAGGCTGAGGCAGGTGGATCGCCTGAGGTCAGGAGTTCTAGACCAGCCTGGCCAACATGGTGAAACCCCGTCTCTACTAAAAATACAAAAATTAGCCAGGTGTAGTGGCAGGCACCTGTAATCCCAGCTACTCAGGAGGCTGAGGCAGGAGAATTGCTTGAACCCAGGAGGCAGAGGTTGCAGTGAGCCGAGATCGCACCATCGCACTCCAGCCTGGGGCAGAAGAAATCTTTTTTCTTAAAAAAAAAAAAAAAGAAA"
"chr1","6815903","6816192","KN295967v1","470774","471071","45","6345129","GGCTGGGTGCGGTAGCTCACGCCTGTAATCCCAGCACTTTGGGAGGCCGAGGTGGGTGAATCACCTGAGGTCAGGAGTTCAAGACCAGCCTGGCCAACATGGTGTCTCAACTAAAAATACAAAAATTAGCCCAGCGTGGTGTTCAGCGCCTGTAATCCTAGCTACTTGGGGGGCGAGGCAGGAGAATCGCTTGAACCGAGGCGGCGGAGGTTGCAATGAACCAAGATCGCGCCATCGCACTGCAGCCTGGGGGACAGGAGCAAGATTTTGTCTACAAAAAAAAAAAAAAA","GCTGGGAGCGGTGGCTCACGCCTGTAATCCCAGCACTTTGGGAGGCTGAGGCAGGTAGATCACCTGAGATCAGGAGTTCAAGATCAGCCTGGCCAACATGGTGAAACCCCATCTCAACTAAAAATACAAAAATTAGCCGGGCATGGTGGCAGGTGCCTGTAATCCCAGCTACTTGGGGGGTCAAGGCAGGAGAATCGCTTGAACCCAGGAGGCAGAGGTTGAAGTGAGCCGAGATCATGCCATTGCACTCCAGCCTGGGGGACAAGAGCGAGACTTTCTCTCAAAAAAAAAAAAAAAA"
"chr1","7860173","7860455","KN295941v1","1108709","1108994","34","6751464","GACCAGGCACGGTAGCTCATGCCTGTGATCCCAGCACTTTGGGAGGCCGAGGCGGGCGGACCACCTGAGGTCAGAAGTTCGAGACCAGCCTGGCCAACATGGTGAAACCCTGTCTCTACTAAAAATACAAAAATTAGCTGGGCGTGGTGGCACCTGTAATCCTAGCTACTCGGGAGACTGAGGCAGGAGAATCGCTTGAACCCGGGAGGCAGAGGTTGCAGTGAGCCGAGATCACGCCACTGCACTCCAGCCTGGGGGACAAGAATGAGACTTCATCTCAAAA","GCCGGGTGCTTTGGCTCACGCCTGTAATCCCAGCACTTTGGGATGCCGAGGCGGGTGGATCACCTGAGGTCAGGAGTTTGAGACCAGCCTGGCCAACATGGTGAAACCCTGTCTCTACCAAAAATACAAAAATTAGCCGGGCGGGGTGGCAGGCGCCCGTAATCCCAGCTACTCGGAAGGCTGAGGCAGGATAATCGCTTGAACCTGGGAGGCGGAGGTTGCAGTGAGCCGAGATCGCACCATTGCACTCCAGCCTGGGGGACAAGAGCGAGACTTCGTCTCAAAA"
"chr1","8128702","8129005","KN295573v1","1644468","1644772","33","6484234","GGCCAGGCACAGTGGCTCATGCCTGTAATCCCAGCACTTGGGAGGCCAAGGCAGGTGGATCACCTGAGGTCAGGAGTTCGAGACCAGCCTGGCCAACATGGTGAAACCCTGTCTCTACTAAAAATACAAAAATTAGCTGGGCATGGTGGCAGGCGCCTGTAATCCCAGCTACTTGGGAGGCTGAGGCAGGAGAATCGCTTCAAACTGGGTGGCGGAGGTTGCAGTGAGCCTAGATTGCGCCATTGCACTCCAGTCTTGGGGACAAGAGTGAGACTTCGTCTCCAAATAAATAAATAAATAAAAA","GGCCGGGCACAGTGGCTCACACCTGTAATCCCAGCACTTTGGGAGTCTGAGGCAGGCGGATCACCTGAGGTCAGGAGTTCGAGACCAGCCTGGCCAACATGGAGAAACCCCCGTCTCTACTAAAAATACAAAAATTAGCTGGGCATGATGGCAGGAGCCTGTAATCCCAGATACTCAGGAGGCTGAGGCAGGAGAATGGCTTGAACCCGGGAGGCAGAGGTTGCAGTGAGCCAAGGTCGCGCCATTGCACTCCAGCCTGGGGGACAAGAGCGAGACTTCGTCTCAAAAAAAAAAAAAAAAAAAAA"
"chr1","8235197","8235291","KN295112v1","593978","594084","18","7641219","TTGAACCTGGGAGGCAAAGGTTGCAGTGAGCCGAGATCACGCCATTGCACTCCAGCCTGGGGGACAAGAGCGAGACTCCGTCTAAAAAAAAAAAA","TTAAAGAACCCAGGAGGCAGAGATTGCAGTGAGCCGAGATCACGCCATTGCACTCCAGTCTGGGGGACAAGAGCGAGACTTCGTCTCAAAAAAAAAAAGGAAAAAAA"
"chr1","8798960","8799039","KN297008v1","5130004","5130066","33","3668956","TTCCAGACCAGCCTGGTCAACATGGTGAAACCTCACCTCTACTAAAAATACAAAATTAGCCAGGCATGGTGGCAGGCGCC","GGAAATCCAGACCAGCCTGGCCAACATGGTGAAATCCTGTCTCTATTAAAAATATAAAAATTA"
"chr1","8893002","8893244","KN295439v1","247193","247443","51","8645809","CTGAGGTCAGGAGTTCTAGACCAGCCTGGCCAACATGGTGAAACCCCGCTTCTACTAAAAATACAAAAATTAGCCACGCATGGTGGTGGGCGCCTGTAATCCCAGCTACTTGAGGGGGCGAAGCAGGAGAATTGCTTGAATCCGGGAGACAGAGGTTGCAGTGAGCCAAGATGGCAACACTGCATTCCAGCCTGGGGGAGAAGAGCAAGACTTTGTCTCAAAAAAAATAAAATAAAAAAATAA","GGATCACCTGAGGTCAGGAGTTCAAGACCAGCCTTGCCAACATGGTGAAACCCCGTCTCTACTAAAAGATACAAAAATTAGCCAGTTGTGGTGGCAGGACTTAATCCCAGCTACTTGGGAGGCAGAGGCAAGAGAATTGTTTGAATCCAGGAGGCGGAGGTTGCAGTGAGCCGAGACTGAGCCATTGCACTCAAACCTGGGGGACAAGAGGGAGACTTCTCTCAAAAAAAAAAAAAAGAAAAGAAAAGAAA"
"chr1","9066020","9066311","KN295576v1","406337","406628","31","8659683","GCCAGGCGCGGTGGCTCACGCCTGTAATCCCAGCACTTTGGGAGGCCGAGGTGGGTGGATCACCTCAGGTCAGGAGTTCGAGACCAGCCTGACCAACATGGTGAAACCCCGTTTCTACTAAAAATACAAAAATTAGCCGGGCGTGGTGGCAGGTGCCTGTAATCCCAACTACTCGGGAGGTTGAGGCAGGAGAATCACTTGAACTTGGGAGGCCGAGGTTACAGTGAGTTGAGATCATGCCATTGCACTCCAGCCTGGGGGACAAGAGTGAGACTTCATCTCAAAAAAAAAA","GGCCGGGCGCGGTGGCTCACGCCTGTAATCCCAGCACTTTGGGAGGCCGAGGCGGGCGGATCACCTGAGGTAAGGAGTTCGAGAACAGCCTGGCCAGCATGGTGAAACCCCATCTCTACTAAAAATACAAAAATTAGCCGGGCATGGTGGCAGGTGCCTGTAATCCCAGCTACTCGGGAGGCTGAGGCAGAAGAATCGCTTGAACCCAGGAGGCGGAGGTTGCAGTGAGCCGAGATTGCGCCATTGCACTCCAGCCTAGGGGAGAAGAGCGAGACTTCGTCTCAAAAAAAAA"
"chr1","9775939","9776254","KN296913v1","140345","140647","44","9635594","GGCCGGATGCGGTGGCTCACGCCTGTAATCTTAGCACTTTGGGAGGCCAAGGCGGGTGGATCACCTGAGGTCAGGAGTTCGAGACCAGCCTGGCCAACATGGTAAAACCCCGTCTGTACTAAAAAAAAAAAATTACAAAAATTAGCCGGGCGTGGTGGCAGGCGTCTGTAATACCAGCTACTCAGGAGGCTGAGGCAGGAGAATCGCTTGAACCCAGGAGGCAGAGGTTGCAGTGTACCAAGACCGTGCCATTGCACTCCAGCCTGGGAGAGAAGCAAGAGACTTCGTCTCAAAAAAAAAAAAAGAAGAAGAAGAA","GGCCGGCTGCGGTGGCTCACGTCTGTAATCCCAGCACTTTGGGAGGCCGAGGAGGGTGGATCACCTGAGGTCAGGAGTTCGAGACTAGCCTGGCCAACATGGTGAAACCCTGTCTCTACTAAAAATAACAAAAATTAGCCAGGCGCGGTAGCAGACGCCTGTAATCCCAGCTACTCAGGAGGCTGAGGCAGGAGAATCGCTTGAACCCAGGAGGCAGAGGTTGCAGTGAGCCAAGATCATGCCATTGTACTCCAGCCTGGGGGACAAGAGTCAGATTTCGTCTCAAAAGAAGAAAAAAGAAAA"
"chr1","9867784","9867969","KN296122v1","240387","240574","34","9627397","GGCCGTGTACGGTGGCTCACACCTGTAATCCCAGCATTTTGGGAGGCCAAGGCAGGTGGATCACCTGAGGTCAGGAGTTCTAGACCAGCCTGACCAACGTGGCGAAACCCCATCTCTACTAAAAATACAAAAGTTAGCTGGGCGTGGTAGCATGCAGGTGTAATCCCAGCTACTTGGGAAGCCAAG","GCTGGGCACAATGGCTCACACCTATAATCCCAGCACTTTGGGAGGCCAAGGCGGGTGGATTACTTGAGGTCAGGAGTTCCAGACCAGCCTGGCCAATATGGTGAAACCCCCCCATCTCTATTACAAATACAAAAATTGGCTGGACGTGGTAGCAGGCGCCTGTAGACCCAGCTACCTGGGGAGCTGAG"
"chr1","10179477","10179765","KN295576v1","406337","406628","33","9773140","GGCCAGGCGTGGTGGCTCACGCCTGTAATCCCAGCACTTTGGGAGGCCAAGGCAGGTGTATCGTCTGAGGTCAGGAGTTCTAGACCAGCCTGGCCAACATGGTGGAACCCCATCTCAACTGAAAATACAAAAATTAGCTGGGCGTGATGGTGGGTGCCTATAATCCCAGCTACTCGGGGGGCCGAGGCAGGAGAATTGCTTGAACCCAGGAGGTGGAGGTTGCAGTGAGCTGAGATTGCGCCATCGCACTCCAGCCTAGGGGACAAGAGTGAGACTTCGTCTCAAAAAA","GGCCGGGCGCGGTGGCTCACGCCTGTAATCCCAGCACTTTGGGAGGCCGAGGCGGGCGGATCACCTGAGGTAAGGAGTTCGAGAACAGCCTGGCCAGCATGGTGAAACCCCATCTCTACTAAAAATACAAAAATTAGCCGGGCATGGTGGCAGGTGCCTGTAATCCCAGCTACTCGGGAGGCTGAGGCAGAAGAATCGCTTGAACCCAGGAGGCGGAGGTTGCAGTGAGCCGAGATTGCGCCATTGCACTCCAGCCTAGGGGAGAAGAGCGAGACTTCGTCTCAAAAAAAAA"
"chr1","10318653","10318962","KN294665v1","171883","172197","32","10146770","GGGCCGGGTGGCTCACGTCTGTAATCCCAGCACTTTGGGAGGCCGAGGCAGGTGGGTCACCTGAGGTCAGGAGTTCGAGACCAGCCTGGCCAACATGGTGAAACCCCGTCTCTACTAAAAATACAAAATTTAGCCAGGCGTGGTGGCAGGCGCCTGTAATCCCAGCTACTCGGGGGCGCCGAGGCAGTAGAATCGCTTGAACCCAGGAGGTGAAGGTTGCAGTGAGCCGAGATCGCACCATTGCACTCCAGCCTGGGGGACAAGAGCAAGACTTTGTCTCAAGAGAAAAAAGAAAAAAAAAAAAGAAAAA","GCCGGGCATGGTGGCTCATGCGTGTAATCCCACCACTTTGGGAGTCCGAGGCAGGTGGATCACCTGAGGTCAGGAGTTCGAGACCAGCCTGGCCAACATGGTGAAACCCCCGTCTCTACTAAAAATACAAAAATTAGCTGGGCATGGTGGCAGGCGCCTGTAATCCCAGCTACTCGGGAGGCTGAGGCAAGAGAATCGCTTGAACCCGGGAGATGGAGGTTGCAGTGAGCCGAGATCGCACCATTGCACTCCAGCCTGGGGGACAAAAGAGAGACTTTGTCTCAAAAAAAAAAAAAAAAAAAAAAAAAAGAAAAA"
"chr1","15696414","15696610","KN296287v1","108021","108221","49","15588393","AAACCCTATCTCTACTAAAAATACAAAAATTAAGCCAGGCATGGTGACAGGTGCCTGTAATCCCAGCTACTCAGGAGGCTGAGGCAGGAGAATTGCTTGAACCTGGGACGCGGAGGTTGCAGTGATCCCCAGATTGAGCCTGGGGGACAAGAGCAAGACTTTGTCTCAAAAAAAAAAAAAAGTAAAAAATAAAAAAA","TCTCTGCTAAAAATATAAAAATTAGCTGGGCATGGTGGCAGGCACCTGAAATCCCAGCTACTGGGGAGGCTGAGGCAGGAGAATCACTTGAACTCAGGAGACGGAGGTTGCAGTGAGCCGAGATCGCACCATTGCACTCCAGCCTGGGAGACAAGAGCGAGACTTTGTCTCAAAAAATAAACAAACAAAAAACAAAACAAA"
"chr1","16344016","16344145","KN295828v1","718942","719076","18","15625074","GGCCGGGCACGGTGGCTTACGCCTGTAATCCCAGCACTTTGGGAGGCCAAAGTGGATCCCCTGAGGTCAGGAGTTCTAGACCAGCCTGGCTAACATGGTGAAACCCTGTCTCTACTAAAAACACAAAAAT","GGCCGGGTGTGGTGGCTCACTCCTGTAATCCCCGCACTTTGGGAGGCCAAGGTGGGTGGATCCCCTGAGGTCAGGAGTTCCTGACCAGCCTGGCCAACATGGTGATACCCTGTCTCTACTAAAAATACAAGAATT"
"chr1","16545798","16545841","KN294526v1","71927","71974","10","16473871","AGCCTGGGGAACAAGAGCGAGACTTTGTCTCAAAAAAAAAAAGA","GCCTGGGGCATCAGAGCAAGACTTTGTCTCAAAATAAAAGAAAAGAAA"
"chr1","19250786","19251092","KN294193v1","690006","690308","35","18560780","GTCGGGCGTGGTGACTCACGCCTTTAATCCCAACACTTTGGAAGGCCGAGGCGGGTGGATCACTTGAGGTCAGGATTTCGAGACCAGCCTGGCCAACATGGTGAAACCCCATGTCTACTAAAAATACAAAAAAATTAGCCGGGTGTGGTGGCAGGTGCCTGTAATCCCAGCTACTCGGGAAGCTGAGGTAGGAGAATCGCTTGAACCTGGGAGGTGGAGGTTGCAGTGAGCTGAGATTGCACCATTGCACTCCAGCCTGGGGGACAAGAGTGAGACTTCGTCTCAAAAAAAGAAAAAAAAAAAGAAA","GGCTGGGCGCGGTGGCTCACGCCTGTAATCCCAGCACTTTGGAAGGCGAGGCAGGCGGATCACCTGAGATCAGGAGTTCGAGACCAGCCTGGCCAACATGGTGAAACCCCATCTCTACTAAAAATACAAAAATTAGTCGGGTGTGGTGGCAGGCGCCTGTAATCCCAGCCACTCGGGAGGCGGAGGCAGGAGAATCGCTTGAACCCGGCAGGCGGAGGTTGCAGTGAGCCGAGGTGGCGCCATTGCACTCCAGCCTGGGGGACAAGAGCAAGACTTCGTCTCAAAAACAAAGAAACAAAAAAA"
"chr1","20220063","20220358","KN296296v1","160831","161126","27","20059232","GGCCGGGTGCGGTGGCTCACGCCTGTAATCCCAGCACTTTGGGAAGCCGAGTCGGGTGGATCACCTGAGGTCAGGAGTTCGAGACCAGCCTGGCCAACATGGTAAAACCCCATCTCTACTAAAAATACAAAAATTAGCCGGGCGTGGTGGCAGGCGCCTGTAATCCCAGCTACTCGGGGGGCCGAGGCAGGAGAATCACTTGAATCCGGGAGTCAGAGGTTGCAGTGAGCCGAGATTGTGCCATCACACTCCAGCCTGGGGGACAAGAGCGAGACTTTGTCTCAAAAAAAAAAGAA","GGCTGGATGCAGTGGCTCACGCCTATAATCCCAGCACTTTGGGAGGTCTAGGCGGGTGGATCACCTGAGGTCAGGAGTTCGAGACCAGCCTGGCCAACATGGTGAAACCCTATCTCTACTAAAAATACCAAAACTAGCCAGGCGTGGTGGCGGGTGCCTGTAATCCCAGCTACTATGGAGGCTGAGGCAGGAGAATCACTTGAACCCGGGAGGCGGAAGTTGCAGTGAGCCGAGATAGTGCCATCGCATTCCAGCCTGGGGGGCAAGAGCGAGACTTTGTCTCAAAAAAAAAAGAA"
"chr1","20472551","20472854","KN295573v1","1644468","1644772","28","18828083","GGCCGGGCGTGGTGGCTCACGCCTGTAATCCTAGCACTTTGGGAGGCCAAGGCAGGCGGATCACCTGAGGTCAGGAGTTCGAGACCAGCCTTGCCAACATGGTGAAATCCCCATCTCTACTAAAAATACAAAAATTAGTTGGGCATGGTGGCAGTCGCCTGTAATCCCAGCTACTCGGGAGGCTGAGGCAGGAGAATTGCTTGAACTCGTGAGGCGGAGGTTGCAGTGAGCCAAGATCGTGCCATTGCGCTCCAGCCTGGGGCACAAGAGCGAGACTTCGTCTCAAAAAAAAAAAAAAAAAAGA","GGCCGGGCACAGTGGCTCACACCTGTAATCCCAGCACTTTGGGAGTCTGAGGCAGGCGGATCACCTGAGGTCAGGAGTTCGAGACCAGCCTGGCCAACATGGAGAAACCCCCGTCTCTACTAAAAATACAAAAATTAGCTGGGCATGATGGCAGGAGCCTGTAATCCCAGATACTCAGGAGGCTGAGGCAGGAGAATGGCTTGAACCCGGGAGGCAGAGGTTGCAGTGAGCCAAGGTCGCGCCATTGCACTCCAGCCTGGGGGACAAGAGCGAGACTTCGTCTCAAAAAAAAAAAAAAAAAAAAA"
"chr1","20963185","20963479","KN295315v1","992137","992431","27","19971048","GGCCGGGCGCAGTGGCTCATGCCTGTAATCCCACCACTTTGGGAGGCTGAGGTGGGTGGATGACCTGAGGTCAGGAGTTTGAGACCAGCCTGGCCAACATGGTGAAACCCTGTCTCTACTAAAAATACAAAAATTAGCTGGGTGCGATGGCAGGCACCTGTAATCCCAGCTACTTGGGAGATTGAGGCAGGAGAATCGCTTGAACCCAGGAGGCAGAGGTTGCAGTGAGCTGAGATCACGCCACTGCACTCCAGCCTGGGGGAAAAGAGCGAGACTTTGTCTCAAAAAAAAAGAA","GGCTGGCCGCGGCGGCTCATGCCTGTAATCCCAGCACTTTGGGAAGCTGAGGCGGGTGGATCACCTGAGGTCAGGAGTTCGAGAGCAGCCTGGCCAACGTGGTGAAACTGTGTCTCTACTAAAAATACAAAAATTAGCTGGGCGTGGTGGCAGGCACCTGTAATCCCAGCTACTTGGGAGACTGAGGCAGGAGAATCGCTTGAACCCAGGAGGTGGAGGTTGCAGTGAGCCGAGATCACGCCATTGTACTCCAGCCTGGAGGATAAGAGTGAGACTTCGTCTCAAAAAAAAAAAA"
"chr1","21192288","21192596","KN295907v1","1531171","1531479","36","19661117","GGCTGGGCGCGGTGGCTCATGCCTGTAATCCCAGCACGTTGGGAGGCCAAGGCGTGTGGATCACCTGAGGTCAGGAGTTCGAGACCAGCCTGGCCAACATGGTGAAACCCTGTCTCTACTAAAATTACAAAAATTAGCCGGGCCTGGTGGTAGGCACCTGTAATCCCAGCTACTAGGATGCTGAGGTAGGAGAATCGCTTGAACCTGGGAGGTGGAGGTTGCAGTGAGCCGAGATCGCGCCATTGCACTCCAGCCTGTGGGACAAGAGTGAGACTTCGTCTCAAACAACAACAACAACAACAAAAAAAA","GGCTGGGCGTGGTGGGTCATGCCTATAATCCAAGCACTTTGGGAGGCCGAGATGGGTGGATCACCTGAGGTCAGGAGTTCGAGACCAGCCTGGCCAACATGGTGAAACCCTGTCTCTACTAAAAATACAAAAATTACCGGGCATGGTGGCACACGCCTGTAATCCCAGCTACTCGGGAGGCTGAGGCAGGAGAATCGCTTGAACCCAGGAGGCGGAGGTTACATTGAGCTGAGATCGTGCCATTGTACTCCAGCCTAGGGGACAAGAGTGAGACTTCGTCTCAAAAAAAAAAAAAAAAAAAAAAAAAAA"
"chr1","23117993","23118318","KN294703v1","42278","42595","48","23075715","GGCCAGTCGTGGTGGCTCACGCTTGTAATCCCAGCACTTTGGGAGGCTGAGGTGGGCGGATCACCTGAGGTCAGGAGGCCGAGACCAGCCTGGCCAAAATGATGAAACCCTGTCTCTACTTAAAAAAAACACAAAAATTAGCCAGGCGTGGTAGCAGGCGCCTGTAATCCCAGCAGGCACCTGTAATCGGGAGGCTGAGGCAGGAGAATTGCTTGAACCCGGGAGGCGGAGGTTGCAGTGAGCCGAGATCGCGCCATTGCACTCCAGCTTGGGGGACAAGAGCGAGACTTCATCTGAAAACAAACAAACAAAAAAAAGGAAAAAAA","GCTGGGCGCAGTGGCTCACGCCTGTAATCCCAGCACTTTGGGATGCTGAGGCGGGCGGATCACCTGAGGTCAGGAGTTCGAGACCAGTCTGGCCAACATGGTGAAACCCTGTCTCTACTAAAAATACAAAAAAAAAAAATTAGCTGGGCATGGTGGCAGGCACCTGTAATCCCAGCTACTTGGGAGGCTGAGGCAGGAGAATCGCTTGAACCCGGAAGGCAGAGGTTGCAGTGAGCCGAGATGGTGCCATTGCACTCCAGCCTGGGGGACAAGAGCGAGACTTCGTCTGAAAAAAAAAAAAAAAAAGAAAGCAAAAAA"
"chr1","23158891","23159191","KN295172v1","269190","269486","32","22889701","GCCAGGCACGGTGGCTCATGCCTGTAATCCCAGCACTTTGGGAGGCCGAGGTGGGTGGATCACCTGAGGTCAGGAGTTCTAGACCAGCCTTACCAACATGGTGAAACCCGTCTCTGCTGAAAATACAAAAATTAGCTGGGCGTGGTGGCAGGTGCCTGTAATCCCAGCTACTCTGAGGGCTGAGGCAGAAGAATCGCTTGAACCTGGGAGGCGGAGGTTGCAATGAGCCGAGATCACACCATTGCACTCCAGCCTGAGGGAAAAGAGTGAGACTTCATCTCAAAAAAAAAAAAAAAAAAAA","GCCGGGCACGGTGGCTCACGCCTGTAATCCAGCACTTTGGGAGGCCGAGGCGGTGGATCACCTGAGGTCAGGAGTTCTAGACCAGCCTGGCCAACATGGTAAAACCCCATCTCTACTAAAAATACAAAAATTAGCTGGGCGTGATGGCAGGCACCTGTAATCCCAGCTACTTGGGGGGCCAAGGCAGGAGAATCGCTTGAACCCTGGAGGCGGAGGTTGCAGTGAGCTGAGATCACACCATCGCACTCCAGCCTGGGGGAGAAGAGCGAGACTTCATCTAAAAAAAAAAAAAAAAAA"
"chr1","28928774","28928839","KN297046v1","1058980","1059042","22","27869794","CCTGTAATCCCAGCTACTTGGGAGGCTAAGGCAGAAGAATTGCTTGAACTCGGGATGCAGAGGTTG","CGCCTGTAATCCTAGCTATTCAGGGGACCGAGGCAGGAGAATTACTTGATCCCAGGAGGTGGA"
"chr1","29036267","29036570","KN295573v1","1644468","1644772","31","27391799","GGCCAGGCACGGTGGATCACGCCTGTAATCCCAGCACTTTGGGAGGCCGAAGCGGGCGGATCACCTGAGGTCAGGAGTTCGAGACCAGCCTGGCCAACACCGTGAAACCCCGTCTCTACTAAAAATACAAAAAATTAGCTGGGCTTGGTGGCAGGCACCTGTAATCCCAGCTACTCGGGAGGCTGAGGCAGGAGAATCGCTTGAACCCGGGAGGCAGAGGTTGCAGTCAGCAGAGATCGCGCCATTGCACTCCAGCCTGGGGGACAACAGCGAGACTTCCTCTCTCACAAAAAAAAAAAAACAA","GGCCGGGCACAGTGGCTCACACCTGTAATCCCAGCACTTTGGGAGTCTGAGGCAGGCGGATCACCTGAGGTCAGGAGTTCGAGACCAGCCTGGCCAACATGGAGAAACCCCCGTCTCTACTAAAAATACAAAAATTAGCTGGGCATGATGGCAGGAGCCTGTAATCCCAGATACTCAGGAGGCTGAGGCAGGAGAATGGCTTGAACCCGGGAGGCAGAGGTTGCAGTGAGCCAAGGTCGCGCCATTGCACTCCAGCCTGGGGGACAAGAGCGAGACTTCGTCTCAAAAAAAAAAAAAAAAAAAAA"
"chr1","29311799","29312111","KN296921v1","822515","822822","38","28489284","GGCCAGTTGCAGTGGCTCACGCCTGTAATCCCAGCACTTTGGGAGGCTGAGGCAGGTGGATCACCTGAGGTCAGGAGTTAGAGAGCAGCCTGGCCAACATGGTGAAACCCCTTCTGTACTTAAAATACAAACATTAGCTGGGCATGGTGGCAGGCACCTGTAATCCCAGCTACTGGGGAGGCTGAGGCAGGAGAATCGTTTGAACCTGGGAGGTGGAGGTTGCAGTGAGCTGAGATCATGCCATTGCACTCCAACCTGGGGGACAAGAGCAAGACTTCGTCTGAAAAAAATAAAATAAAATAAATAAATAAAA","GGCGCGGTGGCTCACACCTGTAATCCCAGCACTTTGGGAGGCCGAGGTGGGTGGATCACCTGAGGTCAGGAGTTCGTAGACCAGCCTGGCCAACATGGTGAAACCCCATCTCTACTAAAAATACAAACATTAGCTGGGCGTGGTAGCAGGTGCCTGTAATCCCAGCTACTCAGGAGACTGAGGCAGGAGAATCGTTTGAACCCAGGAGGCGGAGGTTGCAGTGAGCCGAGATCATGCCATTGCACTACAGCCTGGGGACAAGAGCAAGACTTCGTCTCAAAAAAAAAAAAAAAAAAGGAAAATAAAAA"
"chr1","31344187","31344266","KN296311v1","1646100","1646183","29","29698087","GAGGCGGAGCTTGCAGTGAGCCGACATCATGCAATTGCACTCCAGCCTGGGGGACAAGAGCAAGACTCCATCTTAAAAAA","CAGAGGTTGCAGTGAGCCGAGATCGTGCCACCCCACTCCAGCCTGGGAGACGAGCAAGAGTTCGAGAAAGAAAAGAAAAGAAAA"
"chr1","32405775","32406065","KN294705v1","1165437","1165726","33","31240338","GGCCCGGCGCGGTGGCTCAAGCCTGTAATCCCAGCACTTTGGGGGCGGGCGGATCACCTGAGGTAAGGAGTTCAAGACCAGCCTAGCCAACATGGTTGAAACACCGTCCCTAGTAAAAATACAAAAATTAGCCAGGCGTGGTGGCAGGCGCCTGTAATCCCAGCTACTCGGGGGGCCGAGGCAGGAGACTCGCTTGAACTCGGGAGGCAGAGTGTGCAGTGAGCCGAGATCGCGCCATCGCACTCCAGCCTGGGGGGACAAGAGCGAGACTGCGTCTACAAAAAAAAAAAA","GGCCGGGCGCGGTGGCTCAAGCCTGTAATCCCAGCACTTGGGGGGGGGGTGGCGGATCCCCTGAGGTGGGGGGTTGGGTACCAGCCTGGCCAACATGGTGAAACCCCCATCTCTAGTAAAAATACAAAAATTAGCCAGGCATGGTGGCAGGCACCTGTAATCCCAGCTACTCGGGGGGCCGAGGCAGGAGAATCGCTTGAATCCGGGAGGCAGAGTTTGCAGTGAGCCGAGATCGCGCCATCACACTCCAGCCTGGGGGACAAGAGCGAGACTTCGTGTCAAAAAAAAAA"
"chr1","32957245","32957389","KN294269v1","66171","66308","18","32891074","GGCCGGGCATGGTGGCTCACGCCTGTAATCCCAGCACTTTGGGAGGCCGAGGCAGGTGGATCACCTGAGATCAGGAGTTCCAGACCAGCCTGGCTAACCTGGTGAAACCTCGTCTCTATTAAAAATACAAAAAAATTAGCTGAGC","GGCCAGGTGCAGTGGCTCACGCCTGTAATCCCAGCACTTTTGGAGGCCGAGGCAGGTGGATCACCTGAGATCAGGAGTTCCAGACTAGCCTGGCCAACATGGTGAAACCCCATCTCTACTAAAAATACAAAAATTAGC"
"chr1","35612336","35612640","KN294420v1","890399","890698","37","34721937","GGCCAGGCACGGTGGCTCACGCCTGTAATCCCAGCTCTTTGGGAGGCTGAGGTGGGTGGATCACCTGAGGTCAGGAGTTCAAGACCAGCCTGACCAACATGGTGAAACCCTGTCTCAACTAAAAATACAAAAATTAGCCAGGTGTGGTGGCAGGAGCCTGTAATCACAGCTACTTGGGGGGCCGAGGCAGGAGAATCGCTTGAATCTGGGAGGTGGAGGTTGCAGTGAGCTGAGATCGCACCATTGCACTCCAGCCTGGGGGACAAGAGCACGACCTGGTTTAAAAAAAAAAACGTAAAATAAAT","GGCCAGGCACGGTGGCTCACGCCTGTAATCCCAGCACTTTGGGAGGCTGAGGTGGGCGGATCACCTAAGGTCAGGAGTTCTAGATCAGCCTGGCCAACATGGTGAAATCCCGTCTCTACTAAAAATACAAAAATTAGCCAGGCATGGTGGCAGGCGCCTGTAATCACAGCTACTCAGGAGGCTGAGGCAGGAGAATCACTTGAACCCAGGAGGCGGAGTTTGCAGTGAGCTGAGATTGCACCATTGCAGTCCAGCCTGGGGGACAAAAGCAAGACTCCATCTCAAAAAAAAAAAAAAAAA"
"chr1","35754985","35755186","KN295573v1","179759","179967","42","35575226","CCAGCCTGGGTGATATCGAGATTCCATCTCAAAAAAATTAAAAACATTAGCCGGGTGTGGTGGCAGGCGCCTGTAATCCCAGCTACTTGGGAGGCTGAGGCAGATGAATCACTTGAACCCGGGAGGTGGAGGTTGCAGTGAGCCGAGATTGCACCATTGCACTCCAGCCTGGGGGACAGAAGCAAGACTTCGTCTCAAAAAA","CCAGGCCAACATGGGGAAACCCCATCTCTATTAAAAATACCAAAAAACTAGCCAGGTGTGGTGGCGGGTGCCTGTAATCTCAGCTACTCGGCGGGGGCTGAGGCAGGCGAATCACTTGAACCCGGGAGGTGGAGGTTGCAGTGAGCCGAGATCGCACCAACACACTGCAGCCTGGGGGACACGAGCGAGACTTCGTCTCAAAAAAACAA"
"chr1","36242464","36242743","KN297415v1","635524","635813","38","35606940","GCTGGGCGCGGTGGCTCACGCCTGTAATCCCAGCACTTTGGGAGGCCGAGGCAGGTGGATCACCTGAGGTCAAGAGTTCTAGACCAGCCTGGCCAACATGGTAAAACCTCGTCCCTACTAAAAATACAAAAATTAGCCAGGCATGGTGGCAGGTGCCTGTAATCTCAGCTACTCGGGGGGCTGAGGCAGGAGAATCTCTTGAACTCGGTTGCAGTGAGCCGACATCGCACCATCGCACTCCAGCCTGGGGCACAAGAGCAAGACTTTATCTCAAAAAAAA","GGCCGGGTGCAGTGGCTCACGCCTGTAATCCCAGCACTTTGGGAGGCCGAGGCGGGTAGATCACCTGAGATCAGGAGTTCTAGACCAGCTTGGCCAACATGGTAAAACCCCGTCTCTACTAAAAATAAAAAAAATTGCCGGGCATGGTGGCAGGCACCTGTAATCTCAGCTACTCGGGGGCCGAGGCAGGAGAATCACTTGAACCGGGAGGCGGAGGTTGAAGTGAGCGGAGATCGCACCATCGCACTCCAGTCTGCGGGACAAGAGCAAGACTTCATCTCAAAAAAAAA"
"chr1","36633268","36633449","KN296682v1","4866975","4867199","61","31766293","GGAGGCTGAGGCGGGTGGATCACTTGAGGTCAGGAGTTCTAGACCAGCCTGGCCAACATGGTGAAATCCTGTCTCTACTAAAACTACAAAAATTAGCCGGGTGTGGCGGCAGGCACCTGTAGTCCCAGCTATTCAGGAGGCTGAGGCAGCAGAATCGCTTGAACTCGAGAGGCGGAGGTTGC","GGCCAGGCGCGGTGGCTCACGCCTGTAATCCTGGCACTTTGGGAGGACGAGGTGGGTGGATCACCTGAGGTTAGGAGTTCGAGACCAGCCTGGCCAACATGGTGAAACCCCATCTCTACTAAAAATACAAAAAATTAGCCGGGCATGGTGGCAGGCGCCTGTAATCCCAGCTACTCAGAGGGGCCGAGGCAGGAGAATCGCTTGAACCCGGGAGGCGGAGGTTGC"
"chr1","38608179","38608472","KN295576v1","406337","406628","29","38201842","GGCTGGGCACGGTGGCTCACGCCTGTAATCCCAGCACTTTGGGAGGCCGAGGTGGGTGGATCACCTGAGGTCGGGAGTTCAAGACCAGCCTGGCCAACATAGTGAAACTCAACCTCTACTAAAAATACAAAAATTAGCCAGGCATGGTGGCATGTGCCTGTAATCCCAGCTACTCAGGAGGCTGAGGCAAGAGAATCACTTGAACCTGGGAGGTGGAGGTTGCAGTGAGCCGAGATTGCGCCATTGCACTCCATCCTGGGGGACAAGAGTGAGACTTTGTCTCAAAAAAAAGAA","GGCCGGGCGCGGTGGCTCACGCCTGTAATCCCAGCACTTTGGGAGGCCGAGGCGGGCGGATCACCTGAGGTAAGGAGTTCGAGAACAGCCTGGCCAGCATGGTGAAACCCCATCTCTACTAAAAATACAAAAATTAGCCGGGCATGGTGGCAGGTGCCTGTAATCCCAGCTACTCGGGAGGCTGAGGCAGAAGAATCGCTTGAACCCAGGAGGCGGAGGTTGCAGTGAGCCGAGATTGCGCCATTGCACTCCAGCCTAGGGGAGAAGAGCGAGACTTCGTCTCAAAAAAAAA"
"chr1","39654267","39654555","KN295576v1","406337","406628","39","39247930","GGCCAGGCACGGTGGCTCATGCCTGTGATCCCACTACTTTGGGAGGCCGAGGGGGGCGGATCACCTGAGGTCTGGAGTTCAAGACCAGCCTGGCCAGCATGGTGAAATCCCGTTTCTACTAAAAATACAAAAATTAGCCAGGCGTGGTGGCAGGTGCCTATAATCCCAGCTACTCGGGAGGCTGAGGTACGCGAATCGCCTGAACCTGGGAGGCAGAGGCTACAGTGAGACGAGGTGGCGCCATCACACACCAGCCTAGGGGACAAGAGTGAGACTTTGTCTCAAAAAA","GGCCGGGCGCGGTGGCTCACGCCTGTAATCCCAGCACTTTGGGAGGCCGAGGCGGGCGGATCACCTGAGGTAAGGAGTTCGAGAACAGCCTGGCCAGCATGGTGAAACCCCATCTCTACTAAAAATACAAAAATTAGCCGGGCATGGTGGCAGGTGCCTGTAATCCCAGCTACTCGGGAGGCTGAGGCAGAAGAATCGCTTGAACCCAGGAGGCGGAGGTTGCAGTGAGCCGAGATTGCGCCATTGCACTCCAGCCTAGGGGAGAAGAGCGAGACTTCGTCTCAAAAAAAAA"
"chr1","40612761","40613066","KN295586v1","818303","818604","31","39794458","CCGGGCACGGTGGCTCACGCCTGTAATCCCAGCATTTTGGGAGGCCGAGGCAAGTGGATCATCTGAGGTCAGGAGTTCGAGACCAGCCTGGCCAACATGGTGAAACCCCATCTCTACTAAAAAGTACAAAAATTAGCCAGGCATGTTGGCAGGCGCCTTAATCCCAGCTACTTGGGAGGCAGAGACAGGAGAATCATTTGAACCCGGGAGGCGGAGGTTGTAGTGAGCCAAGATAAAGCCATTGCACTCAAACCTGGGGGACAAGAGCAAGACTTCTCTCAAAAAAAGAAAAGAAAAGAAAAAGAA","GGCCGGGCGCGGTGGCTCATGCCTGTAATCCCAGCACTTTGGGAGGCTGAGGCGGGTGGATCATCTGAGGTCAGGAATTCGAGACCAGCCTGGCCAACATGGTGAAACCCCATCTCTATTAAAAAACACAAAAATTAGCCGGGCGTGGTGACAGGCACCTTAATCCCAGCTACTTGGGAGGCAGAGGCAGGGGAATCATTTGAACCCGGGAGGTGGAGGTTGCAGTGAGCTGAGATAAAGCCATTGTACTCAAACCTGGGGGACAAGAGCGAGACTTCTCTCAAAAAAAAAAAAAAAAAAAA"
"chr1","40860629","40860935","KN294526v1","558418","558721","37","40302211","GCTGGGCACAGTGGCTCATGCCTGTAATCCCAGCACTTTGGGAGGCCGAGGTGGGTGGATCACCTGAGGTCAGAAGTTCGAGACCAGCCTGGCCAACATGGTGAAACCCTGTCTCTACTTAAAATACAAAACATTAGCTGGGTGTGGTGGTATGCGCCTGTAATCCCAGCTACTCGGGAGGGTGAGGCAGGAGAATTGCTTGAACCTGGGAGGCAGAGGTTGCAGTGAGCCGAAATTGCACCATTGCACTCCAGACTAGGGGACAAGAGCAAGACTTCATCTCAAAATAAATAAATAAATAACAAAA","GGCCAGGCGCAGTGGCTCATGCCTGTAATCCTAGCACTTTGGGAGGCCGAGGTGGGTTGATCACTTGAGGTCAGGAGTTCGAGCCCAGCCTGGCCAATATGGTGAAACCCCGTCTCTACTAAAAATACAAAAATTAGCCGGACGTGATGGCAGGCACCTGTAATCCCAGCTACTCAGGAGGCTGAGGCAGGAGAATTGCTTGAACCCGGGAGGCGGAGGTTACAGTGAGCTGAGATCGCGCCATTGCACTCCAGCCTTGGGTACAAGAGCAAGACTTCATCTCAAAAAAAAAAAAAAAAAAAAA"
"chr1","41194070","41194342","KN294713v1","906670","906972","49","40287400","GGCCGGGTGCAGTGGCTCACGCCCGTAATCCCAGCATTTTGGGAGGCTGAGGTGGGTGGATCACGTGAGGTCAGGAGTTCTAGACCAGCCTGGCCAACATGGTGAAACCCCCTCTCTGCTAAAAATACACAAATTAGCCGGGCATGGTGGCAGGTGCCTGTAATCCCAGCTACTCGGGGGGCTGAGGCAGGAGAATCGCTTGAACCCGGGAGGCCATCGCACTCCACCTGGGGGACAAGAGTGAGACTTCATCTCAAAAAAAAAAAAAAAGAA","GGCCGGGTGCAGTGGCTCAAGCCTGTACTCCCAGCACTTTGGGAGGCCGAGGCGGGCGGATCACCTGAGGTCGGGAGTTCGAGACCAACCTGGTCAACATGGTGAAACCCCTTCTCTACTAAAAACACAAAAATTAGCCGGTCATGGTGGCAGGTGCCTGTAATCCCAGCTACTCGGGAGGCTGAGGCAGGAGAATCGCTTGAACCCTGGAGGCAGAGATTGCAGTGAGCCGAGATCGCACCATTGCACTCCAGCCTGGGGGACAAGAGTGAGACTTCATCTCAAAAAAAAAAAAAAAAAAAA"
"chr1","42505538","42505595","KN297046v1","1058980","1059042","16","41446558","CACCTGTAATCCCAGCTACTCGGGAGGCCAAGGCAGGAGAATCACTTGAACCTGGGAG","CGCCTGTAATCCTAGCTATTCAGGGGACCGAGGCAGGAGAATTACTTGATCCCAGGAGGTGGA"
"chr1","44779485","44779774","KN295576v1","406337","406628","33","44373148","GCCAGGCGCGGTGGCTCACACCTGTAATCCCAGCACTTTGGGAAGCCGAGGCGGGTGGATAACCTAAGGTCAGGAGTTCGAGACCAGCCTGGCCAAAACGGTGAAACCCTGTCTCTACTTAAAATACAAAAATTAGCTGGGCATGGTGGCAGGTGCCTGTAATCCCAGCTACTTGGGAGGCTGAGGCAGGAGAATTGCTTGAACCCAAGAGGCGGAGGTTGCAGTGACCCAAGATCATGCCATTGCACTCCAGCTTGGGGAACAAGAGCGAGACTTTGTATGAAAAAAAA","GGCCGGGCGCGGTGGCTCACGCCTGTAATCCCAGCACTTTGGGAGGCCGAGGCGGGCGGATCACCTGAGGTAAGGAGTTCGAGAACAGCCTGGCCAGCATGGTGAAACCCCATCTCTACTAAAAATACAAAAATTAGCCGGGCATGGTGGCAGGTGCCTGTAATCCCAGCTACTCGGGAGGCTGAGGCAGAAGAATCGCTTGAACCCAGGAGGCGGAGGTTGCAGTGAGCCGAGATTGCGCCATTGCACTCCAGCCTAGGGGAGAAGAGCGAGACTTCGTCTCAAAAAAAAA"
"chr1","45719099","45719424","KN295294v1","1273221","1273523","62","44445878","GCCAGCCATGGTGGCTCACGCCTGTAATCCCAGCACTTTGGGAGGCCAAGGCGAGTGCATCACCTGAGGTCAGGAGTTCTAAACAAACCTAGCCGACATGGTGAAACCTCATCTCTACTAAAAATACAAAAATTAGCCGGGCATGGTGGCGGATGCCTGTAATCCCAGCTACTGGGGTTGGGGGTGGGGTGCGAGGGGGGGCGCTGAGGCCGGAGAATTGCTTGAACTCAGGAGGTGGAGGTTGCAGCAGTGAGCCAAGATCGCCCCATCTCACTCCAGCTTGGGGGGCAAGAGCGAGACTTTGTCTACAAAAAAAAAAAAAAAAA","GGCCAGGCATGGTGGCTCATGCCTGTAATCCCAGCACTTTGGGAGGCCGAGGCAGGTGCATCACCTGAGGTCAGGGGTTCTAGACCAGCCTGGCCAATATGGTGAAACCCCATCTCTACTAAAAATACAAAAATTAGCCGGGTGTGGTGGCAGGCGGCTGTAATCCCAGCTACTCGGGGAGGTGGGGGGTGGGGGGAGGCAGGATAATCGCTTGAACCCGGGAGGTGGAGGTTGCAGTGAGCTGAGATTGCGCCTTCGCACTCCAGCCTGGGGGACAAGAGCAAGACTTGTCTCCAAAAAAAA"
"chr1","46237518","46237566","KN295601v1","571926","571977","10","45665592","AGCCTGGGGGACAAGAATGAGACTTCATCTCAAAAAACAAACAAAAAAA","CAGCCTGGGGGACAAGAGCGAGACTGTGTCTCAAAAAAAAAAAAAAAAAAAA"
"chr1","46369762","46369898","KN294269v1","66171","66308","27","46303591","GGCCAGGCATGGTGTCTCACACCTATAATCCCAGCACTTTGGGAGGCCAGGGTCGGGGGAATCACTCAAGGTCAGGAGTTCTAGACTGGCCTGACCAACATGGTGAAACCTCAGCTTTACAAAAAATACAAAAATTA","GGCCAGGTGCAGTGGCTCACGCCTGTAATCCCAGCACTTTTGGAGGCCGAGGCAGGTGGATCACCTGAGATCAGGAGTTCCAGACTAGCCTGGCCAACATGGTGAAACCCCATCTCTACTAAAAATACAAAAATTAGC"
"chr1","46831289","46831591","KN296541v1","476659","476959","33","46354630","GGCCAGGCGCGGTGGCTCGCGCCTGTAATCCTAGCACTTTGGGAGGCTGAGGCTGGTGGATCACCTGAGGTCAGGAGTTTGAGACCAGCCTGGCCAATATGGTGAAGCCCCGCCTCTACTAAAAATACAAAAATTAGCCAGGCTTGGTGGCAGGTACCTGTAATCCCAGCTACTTGGGAGGCTGAGGCAAGAGAATCGCTTGAACCTGGGAGGCAGAGGTTGCAGTGAGCCGAGATCATGCCATTGCACTCCAGCCTGGGGGACAAGAGCTAGACTTTGTCTCAAAACAAACAAACAAACAAA","GGGCTGACGTGGTGACTCATGCCTGTAATCCCAGCACTTTGGGAGGCCGAGGCAAGTGGATCACCTGAGGTCAGGAGTTCGAGACCAGCCTGGCCAACATGGTGAAACCCAGTCTCTACTAAAAATACAAAAATTAGCCAGGCGTGGCGGTAGGCACCTGTAATCCCAGCTACTCGGGAGGCTGAGGCAGGAGAATCACTTGAACTCGGGAGGCGGAGGTTGCAGTGAGCCGAGATCACGCCATTGCACTCCAGCCTGGCGGACAAGAGCGAGACTTTGTCTCAAAAAAAAAAAAAAAAAA"
"chr1","52647894","52647947","KN295601v1","571926","571977","11","52075968","TCCAGCCCGGGTGACAAGAGCAGGACTTCATCTCAAAAAAAAAACAACAAAAAA","CAGCCTGGGGGACAAGAGCGAGACTGTGTCTCAAAAAAAAAAAAAAAAAAAA"
"chr1","55835129","55835193","KN294831v1","135083","135138","16","55700046","GCCATTGCACTCCAGCCTGGGTGACAAGAGCAAGACTTTGTCTCAAAACAAAAAAAAAAAGAAAA","ACTCCAGCCTTGGAGACAAGAGCAAAACTCTTGTCTAAAAAAAAAAAAAAAAAAGA"
"chr1","58457034","58457331","KN295301v1","588399","588701","36","57868635","GGCCGGTGCGGTGGCTCACGCCTGTAATCCCAGCACTTTGGGAGGCCGAGGCGGGTGGGTCACCTGAGGTCAGGAGTTCAAGACCAGCCTGGCCAGCATGGTGAAACCCTGTCTCTACTAAAAATACAAAAATTAGCCGGGCGTGGTGGCAGGCACCTCCCAGCTACTTGGGAGGCTGAGGCAGGACAATTGCTTGAATCTGGGAGGTGGAGGTTGCAATGAGCCAAGATCATGCCATTGCACTCCAGCCTGGGGGACAAGGACAAGACTTTGTAGTAAAAAAAAAAAAAAAAAGAAA","GGCCCGGCGCGGTGGCTCACGCCTGTAATCCCAGCACTTTGGGAGGCTGAGGCGGGTGGATCACCTGAGGTCAGGAGTTCAAGACCAGCTTGGCCAACATGGTGAAACCCCATCTCTACTAAAAATGAAAAAATTAGCTGAGCGTGGTGGCAGGCTCCTGTAATCCCAGCTACTTGGGAGGTTGAGGCAGGAGAATCGCATGAACCTGGGAGGTGGAGGTTGCGGTGAGCCAAGATCGTGTCATTGCACTCCAGCCTGGGACACAACAGCGAGACTTTGTAAAAAAAAAAAAAAAAAAAAAAA"
"chr1","62807594","62807767","KN295717v1","1369230","1369404","32","61438364","CAAAAATTAGCCAGGTGTGGTGGCAGGCGCCTAGTAATCCCAGCTACACAGGAGGCTGAGGCAGGAGAATTGCTTGACCCCGGGAGGTGGAGGTTGCAGTGAGCTGAGATCGCGCCATAGCACTCCAGCCTGGAATGCAAGACTTTGTCTCAAGAAAAAAAAAGAAAAAGAAAA","CAAAAATTAGCTGAGCGTGGTGGCAGGTGCCTGTAATCCCAGCTACTCAGGAGGCTAAGGCAGGAGAATTGCTTGAACCCAGGAGGCAGAGGTTGCAGTGAGCCAAGATTGTGCCATTGCACTCTAGCCTAGGGGACCAGAGTAAGACTCCGTCTAAAAAAAAAAAAAAAAGAAA"
"chr1","68725559","68725863","KN296119v1","5266717","5267021","34","63458842","GGCCAGGTGTGGTGGTTCACATCTGTAATCCCAGCACTTTGGGAGGCCAAGGCAGGTGGATCACCTGGAGTCAGGAGTTCGAGACCAGCCTGGCCAAGATGGTGAAACCCCGTTTCTACTTAAAATACAAAAAATTAGCCAGGTGTGGTGGTACGCACCTGTAATCCAGCTACTCAGGAGGCTGAGACAGGAGAATTGCTTGAACTCGGGAGGCAGAGGTTGCAGTGAGCTGAGATCGTGCCATTGCACTCCAGCCTGGGGGACAAGAACGAGACTTCATCTCAAAAAAATAAAAAATAAAAGAA","GGCCAGGTGCGGTGGCTCACGCCTGTAATCCTAGCACTTTAGAAGGCCAAGGCGGGTGGATCACCTGAGGTCAGGAGTTCGAGACCAGCCTGGCCAACATGGTGAAACCCTGTCTCTACTTAAAATACAGAAAATTAGCTGGGTGTGGTGGTACGCACCTGTAATCCCAGCTACTTGGGAGGCCGAGGCAGGAGAATCGCTTGAACCCGGGAGGCAGAGGTTGCAGTGAGCTGAGATCGCGCCATTGCACTCCAGACTGAGGAACAAGAGCGAGACTTCGTCTCAAAAAACAAACAAACAAAAAA"
"chr1","71140599","71140901","KN295573v1","1644468","1644772","34","69496131","GCTGGGCATGGTGGCTCATGCCTGTAATCCCAGCAGTTTGGGGAGCCGAGGCAGGTGGATCACCTGAGGTCAGGAGTTCGAGACCAGCCTGGCCAACATGGTGAAACCCCCGTCTCTACTAAAAATACAAAAATTAGCCAGGCATGATGGCAGGTGCCTGTAATCCCAGCTACTCAGGAGGTTGAGGCAGGAGAATTGCTTGAATCTGGGAGGCAGAGGATGCAGTGAGCCGAGATAGTGCCATCGCACCCCAGCCTGGGGGACAAGAGTGAGAATTCGTCTCAAACAAACAAACAAAACAAA","GGCCGGGCACAGTGGCTCACACCTGTAATCCCAGCACTTTGGGAGTCTGAGGCAGGCGGATCACCTGAGGTCAGGAGTTCGAGACCAGCCTGGCCAACATGGAGAAACCCCCGTCTCTACTAAAAATACAAAAATTAGCTGGGCATGATGGCAGGAGCCTGTAATCCCAGATACTCAGGAGGCTGAGGCAGGAGAATGGCTTGAACCCGGGAGGCAGAGGTTGCAGTGAGCCAAGGTCGCGCCATTGCACTCCAGCCTGGGGGACAAGAGCGAGACTTCGTCTCAAAAAAAAAAAAAAAAAAAAA"
"chr1","71668179","71668488","KN294172v1","4419501","4419812","39","67248678","CCGGGTGTGGTGGTTCATGCCTGTGATCCCAGCACTTCGGGAGGCCAAGGCAGGCGGATCGCCTGAGGTCAGGAGTTCGAGACCAGCCTGGTCAACAGGGTGAAACCCCATCTCTACTAAAAATACAAAAATTAGCTGGGCGTGGTGGCAGGCGCCTGTAATCCCAGCTACTCAGGAGGCTGAGACAGGAGAATAGCTTGAACCCGGGAGGCAGAGGTTACAGTGAACCGAGATCACGTCACTGCACTCCAGCCTGGGGGACAAGAGTGAGACTTCGTCTCAAAAATATAAAAATAAATAAATAAATAAA","GGCTGGGCGCAGTGGCTCACGCCTGTAATCCCAGCACTTTGGGAGGCCGAGGCAGGCGGATCACCTGAGGTCAGGAGTTTCAGACCAGCCTGGCCAACATGGTGAAACCCCGTCCCTACTAAAAATACAAAAATTAGCCGGGCGTGGTGGCAGGCACCTGTAATCCCAGCTACTCAGGAGGCTGAGGCAGGAGAATCACTTGAACCCCGGAGGCAGGGGTTGCGGTGAGCCGAGATCGCGCCACTGCACCCCAGCCTGGGGGACAAGAGCAAGACTTCATCTCAAAAATAAATAAATAAATAAAAATAAAAA"
"chr1","75714902","75715198","KN295287v1","40787","41080","31","75674115","GGCTGGGCACGGTAGCTCACGCCTGTAATCCCAGCACTTTGGGAGGCCAAGGCAGATGGATCACCTGAGGTCAGGAGTTCCAGACCAGCCTGGCCAACATGGTGAAACTCTGTTTCTACTAAAGATACAAACATTAGCTGGGCATGGTGGCAGACGCCTGTAATTCCAGCTACTTGGGAGGCTGAGGCAGGAGAATCACTTGAACCTGGGAGGCAGAGGTTGCAGTGAGCCAAGATCGCATCATTGTACTCCAGCCTGGGGGACAAGAGTGAGACTTCGTCTCAAAAAAGAAAAAAA","GGCAGGGCACGGTGGCTCACGCCTGTAATCTCAGCATTTTGGGAGGCCGAGGCAGATGGATCACCTGAGGTTGGGAGTTCGAGACCAGCCTGGCCAATATGGTGAAACCCCATCTCTACTAAACATACAAAAATTAGCTGGGCGTGGTGGCAGGCACCTGTAATCCCATTACTTGAGAGGCTGAGGCAGGAGAATCACTTGAACCCAGGAGGCGGAGGTTGCAGTGAGCCAAGATCGCACCATTGCACTCCAGCCTGGGGGATAAGAGTGAGACTTCATCTCAAAAAAAAAAAA"
"chr1","76230880","76231173","KN294991v1","1107866","1108162","37","75123014","GGCCAGGTGCAGTGGCTCACACCTGTAATCCAGCACTTTGGGCGGCCAAGGTGGGTGGGTCACCTGAGGTCAGGAGTTCAAGATCAGCCTGGCCAACATGCTGAAACCCCATCTCTACTAAAAATACAAAAAGTAGCCAGGCGTGGTGGCAGGCACCTGTAATCCCAACTACTCAGGCGGCTGAGGCAGGAGAATTGCTTGAATCCAGGAGGCAGAGGTTGCAGTGAACTGAGATCACACCATTGCACTCCAGCCTGGGGGAAAAGAGTGAGACTTCATCTCAAAAAAATAAAA","GGCCGGGTGCAGTGGCTCACGCCTGTAATCCCAGCCCTTTGGGAGGTCGAGGCAGGTGGATCACCTGATGTCAGGAGTTCGAGACCAACCTGGCCAACATGGTGAAACCCCATCTCTACTAAAAATACAAAAATTAGCCAGGCGTGGTGGCAGGCACCTGTAATCTCAGCTACTAGGGAGGCTGAGGCAAAAGAATCACTTGAACCCAGGAGGCAGAGGTTGCAGTAAGCTGAGATCACACCACTGCACTCCAACTTGGGGGACAAGAGTGAGACTTTGTCTCAAAAAACAAAAAAA"
"chr1","82521398","82521694","KN294685v1","1269570","1269869","34","81251828","GGCTGGGCATGGTGGCTCACACCTGTAATCCCAGCACTTTGAGAGGCCGAGGCGGGTGGATCACCTGAGGTCAGGAGTTTGAGACCAGCCTGGCCAGCATGATGAAACCCTGTCTCTACCAAAAATACAAAAATCAGCCAGGCGTGGTGGCAGGCGCCTGTAATCCCAGCTACTTGGGAGGCTGAGGCAGGAGTATCACTTGAACCTGGGAGGTGGAGGTTCCAGTGAGCTGAGATCAGGCCATTGCACTTGAGCCTGGGGGACAAAAGCTAGACTTTGTCTCAAAAAAAAAGAAAA","GGCTGGGTGTGGTGGCTTAGGCCTGTAATCCCAGCACTTTGGGAGGCCAAGGCGGGCGGATCACCTGAGGTCAGGAGTTCGAGACCAGCCTGGCCAACATGGTGAAACCCCGTCTCTACTAAAAATACAAAAACTAGCCAGGCGTGGTGGCAGGTGACTGTAATCCCAGCTACTCGGGAGGCTGAGGCAGGAGAACTGCTTGAACCTGGGAGGCGGAGGTTGCAGTGAGCTGAGATCACACCATTGCACTCCAGCCTGGGGGACAAGAGCGAGACTTTGTCTCAAAAATAAAAAAAAAAA"
"chr1","87792422","87792721","KN295576v1","406337","406628","32","87386085","GCCGGGCGCGGTGGCTCATGCCTGTAATCCCAGCACTTTGGGAGGCTGAGGTGGGCTGATCACCTGAGGTCAGGAGTTCGAGACCAGCCTGGCCAAACATGGTGAAACCCCATCTTTGCTAAAAAATACAAAAATTAGCTAGGGCATGGTGGCAGGTGCCTGTAATCCCAGCTACTCAGGAGGCTGAGGCAGGAGAATCGCTTGAACCTGGGAGGTGGAGGTTGCAGTGAGCCGAGATCGTGCCATCGCACTCCAGCCTGGGGAACAAGAGCAAGACTTCGTCTCCAAAAAAAAAAAAAA","GGCCGGGCGCGGTGGCTCACGCCTGTAATCCCAGCACTTTGGGAGGCCGAGGCGGGCGGATCACCTGAGGTAAGGAGTTCGAGAACAGCCTGGCCAGCATGGTGAAACCCCATCTCTACTAAAAATACAAAAATTAGCCGGGCATGGTGGCAGGTGCCTGTAATCCCAGCTACTCGGGAGGCTGAGGCAGAAGAATCGCTTGAACCCAGGAGGCGGAGGTTGCAGTGAGCCGAGATTGCGCCATTGCACTCCAGCCTAGGGGAGAAGAGCGAGACTTCGTCTCAAAAAAAAA"
"chr1","88169501","88169790","KN295576v1","406337","406628","37","87763164","GGCCTGGCACGGTGACTCACACCTCTAATCCCAGCACCTTGGGAGGCTGAGGCAGGTGGATCACCTGAGGTCAGGAATTCGAGACCAGCCTGGCCAACATGGTAAAACCCCATCTCTACTAAAAATACAAAAAACTAGCCAGGCGTGGTGGCAGGCACCTGTAATCCCAGCTACTCAGAGGGCAGAGGCAGGAGAATTGCTTGAACCCAGGATGCGGAGGTTGCAGTGAGCCTAGATCGCACCATCGCACTCTAGCCTGGGGGACAAGAGCGAGACTTCGTCTCAAAAAA","GGCCGGGCGCGGTGGCTCACGCCTGTAATCCCAGCACTTTGGGAGGCCGAGGCGGGCGGATCACCTGAGGTAAGGAGTTCGAGAACAGCCTGGCCAGCATGGTGAAACCCCATCTCTACTAAAAATACAAAAATTAGCCGGGCATGGTGGCAGGTGCCTGTAATCCCAGCTACTCGGGAGGCTGAGGCAGAAGAATCGCTTGAACCCAGGAGGCGGAGGTTGCAGTGAGCCGAGATTGCGCCATTGCACTCCAGCCTAGGGGAGAAGAGCGAGACTTCGTCTCAAAAAAAAA"
"chr1","88253668","88253962","KN297219v1","1714724","1715019","24","86538944","GACTGGGTGCAGTGGCTCACGCCTGTAATTCCAGCACTTTGGGACGCTGAGGTGGGCGGATCATCTGAGGTCAGGAGTTCGAGACCAGCCTGGCCAACATGGTGAAACCCTGTCTCTACTAAAAAATACAAAAATTAGCTGGGTGTGGTGGCAGGCGCCTTAATCCCAGCTGCTTGGGAGGCAGAGGCAGGAGAATTGTTTGAACCCAGGAAGCGGAGGTTGCAGTGAGCTGAGATAAAGCCATTGCACTCAAACCTGGGGGACAAGAGCGAGACTTCTCTCAAAAAAAAAAAAA","GACCGGGCTCAGTGGCTCACCCCTGTAATCCCAGCACTTTGGGAGGCCGAGGTGGGTGGATCACCTGAGGTCAGGAGTTCGAGACCAGCCTGGCCAACATGGTGAAACCCCATCTCTACTAAAAAATACAAAAATTAGCTGTGCGTGGTGGCAGGTGCCTTAATCCCAGCTACTTGGGAGGTAGAGGCAGGAGAATCATTTGAACCCAGGAGGCGGAGGTTGCAGTGAGCTGAGATAAAGCCATGGCACTGAAACCTGGGGGACAAGAGTGAGACTTCTCTAAAAAAAAAAAGAAA"
"chr1","90069696","90069999","KN294193v1","690006","690308","33","89379690","GGCTGGGCGCCGTGGCTCATGCCTATAATCCCAGCACTTTGGGAGGCTGAGGTGGGCGGATCACCTGAGGTCAGGAGTTCGAGACCAGCCTGGCCAACATGGTGAAACCCCATCTCTACTAAAAATTCAAAAATTAGCCAGGCGTGGTGGCAGGCTCCTGTAATCCTAGCTACTCAGGAGGCTGAGGCAAGAAAATCTCTTGAACCCGGGAGGCGGAGGTTGCAGTGAACCAACATCGCGCCATTGCACTCCAGCCTAGGGGACAAGAGCAAGACTTCATTTCAGAAAAAAAAACACAAAAAAA","GGCTGGGCGCGGTGGCTCACGCCTGTAATCCCAGCACTTTGGAAGGCGAGGCAGGCGGATCACCTGAGATCAGGAGTTCGAGACCAGCCTGGCCAACATGGTGAAACCCCATCTCTACTAAAAATACAAAAATTAGTCGGGTGTGGTGGCAGGCGCCTGTAATCCCAGCCACTCGGGAGGCGGAGGCAGGAGAATCGCTTGAACCCGGCAGGCGGAGGTTGCAGTGAGCCGAGGTGGCGCCATTGCACTCCAGCCTGGGGGACAAGAGCAAGACTTCGTCTCAAAAACAAAGAAACAAAAAAA"
"chr1","94197577","94197701","KN294264v1","678105","678214","50","93519472","AGCAGGTTGAAAGGTTGGGTTGGGTTTCTGTCATATGCAATCAAGAGTCCTGACCAGCCTGGGCAACAACGTGAGACCCCGTCTCTAAAAAAACTAAAAATAAAAATTTAGCTGAGCATGGTGGC","CATTTTGGGGGCCGGGCGAGTGGATCACCTGAGGTCAGGAGTTCTAGACCAACCTGGCCAACAAGGCAAAACCTCATGTCTATTAAAAATACAAAAATTAGCGGGGTGTG"
"chr1","96553428","96553719","KN295576v1","406337","406628","27","96147091","GGCCGGGCGCAGTGGCTCATGCCTGTAATCCCAGCACTCTGGGAGGCCGAGGCGGGTGGATCACCTGAGGTCAGGAGTTCGAGACCAGCCTGCCAACATAGTGAAACCCCATCTCTACTAAAAAATACAAAAATTAGCCGGGCATGGTGGCAGGTGCCGGTAATCCCAACTACTTGGGAGGCTGAGGCAGGAGAATCGCTTGAACCTGGGAAGTGGAGGTTGCAGTGAGCCAAGATCACGCTATTGCACTCCACCCTGGGGGACAAGAGCGAGACTTTGTCTGAAAAAAAAA","GGCCGGGCGCGGTGGCTCACGCCTGTAATCCCAGCACTTTGGGAGGCCGAGGCGGGCGGATCACCTGAGGTAAGGAGTTCGAGAACAGCCTGGCCAGCATGGTGAAACCCCATCTCTACTAAAAATACAAAAATTAGCCGGGCATGGTGGCAGGTGCCTGTAATCCCAGCTACTCGGGAGGCTGAGGCAGAAGAATCGCTTGAACCCAGGAGGCGGAGGTTGCAGTGAGCCGAGATTGCGCCATTGCACTCCAGCCTAGGGGAGAAGAGCGAGACTTCGTCTCAAAAAAAAA"
"chr1","96839080","96839218","KN297263v1","890000","890133","27","95949080","ATCCCAGCTACTTGGGAGGCTGAGGCAGGAGAATTGCTTGAACCTGGGAGGCGGAGGTTGCAGTGAGTCGAGATTGCGCCCATTGCACTCCGGCCTGGGAGACAAGAGTGAGATTCCATCTCCAAAAAAAAAAACAAAA","AGCTATTCAGGAGGCTGAGGCAGGAGAATCGCTTCAACCCGGGAGGCAGAGGTTGCAGTGAGCCGAGATCGCACCATCACACTCCAGCCTTGGGGACAAGAGCGAGACTTCATCTCAAAAAAAAAAAAAAAAAA"
"chr1","109676207","109676507","KN294665v1","171883","172197","48","109504324","GGCCAGGCACGGTGGCTCATGCCTGTAATCCCAGCACTTTGGGAGGCTGAGGCAGGTGGATCACGAAGTCAGGAGATCGAAACCAGCCTGGCCAACATGGTGAAACCCCATCTCTACTAAAAATACAAAAATTAGCTGGGTGTTGTGGCAGTCTTCTGTAATCCCAGCTACTCGGGAGTCTGAGGCAGGAGAATCACTTGAACCCAGGAGTTGGAGGTTGCAGTGAGACGAGATTGTGCCATCCTGGGGGACAAGAGCGAGACTTCATCTCAAAAAAAAAAAGAAAGAAAAGAGAAAGAAA","GCCGGGCATGGTGGCTCATGCGTGTAATCCCACCACTTTGGGAGTCCGAGGCAGGTGGATCACCTGAGGTCAGGAGTTCGAGACCAGCCTGGCCAACATGGTGAAACCCCCGTCTCTACTAAAAATACAAAAATTAGCTGGGCATGGTGGCAGGCGCCTGTAATCCCAGCTACTCGGGAGGCTGAGGCAAGAGAATCGCTTGAACCCGGGAGATGGAGGTTGCAGTGAGCCGAGATCGCACCATTGCACTCCAGCCTGGGGGACAAAAGAGAGACTTTGTCTCAAAAAAAAAAAAAAAAAAAAAAAAAAGAAAAA"
"chr1","110759587","110759669","KN296311v1","1646100","1646183","19","109113487","GAGGTTGCAGTGAGCTGAGATCGTGCCATTGCACTCCAGCCTGGGGGACAAGGTGAGACTTCATCTAGAAAAAAAAAAAAAAA","CAGAGGTTGCAGTGAGCCGAGATCGTGCCACCCCACTCCAGCCTGGGAGACGAGCAAGAGTTCGAGAAAGAAAAGAAAAGAAAA"
"chr1","111288575","111288867","KN295721v1","13985","14280","28","111274590","GGCCAGGAGTGGTGGCTCACGCCTGTAATCCCAACACTTCGGGAGGCCGAGGAGGGTGGATCACCTGAGGTCAGGAGTTCGAGACCAGCCTGGCCAACATGGTGAAATCCCATTTCTACTAAAAATACAAAAATTAGCCAGGCATGGTGGCAGGCGCCTGTAATCCCAGCTACTCAGGAGGCTGAGGCAGGAGAATCACTGGAACCCGGGAGGCAGAGGCTGCAGTGAGCCAAGATGGCACCATTGCACTCCAGCCTGAGGGACAAGAGCAAGACTTTGTCTCAAAAAAAAAA","GGCTGGGAGTGGTGGCTCACACCTGTAATCCCAACACTTTGGGAGGCTGAGGCGAGTGGATCATCTGAGGTCAGGAGTTCGAGACCAGCCTGGCCAACATGGTGAAACTCCATTTCTACTAAAAATACAAAAATTAGCCGGGCATGGTGGCAGACGCCTGTAATCCCAGCTACTCAGAGGCTGAGGCAGAAGAATCGCTGGAACCCAGGAGACGGAGATTGCAGTGAGCCAAGATTGCGCCATTTGCACTCCAGCCTGAGGGACAAGAGCGAGACTTCGTCTCAAAAAAAGGAAAA"
"chr1","112528952","112529265","KN294365v1","944056","944350","43","111584896","GGCCGGGCGCGGTGGCTCACACCTGTAATCCCAGCACTTTGGGAGGACGAGGCGGGTGGATCACCTGAGGTCAGGAGTTCTAGACCAGCCTGGCCAACATGGTGAAACCCCGTCTCTACTAAAAATACAAAAATTAGCTGGGCTTGGTGGCTGGTGCCTGTAATCCCAGCTACTCAGGGGCGGGATGGGGGTAGGGCGCCGAGGGTGGAGAATCGCTTGAACCCGAGAGGCGGAGGTTGCAGTGAGCCGAGATCGCACCATCACACTCCAGCCTGGGGGACAAGAGCGAGACTTCATCTAAAAAAAAAAAAGAA","GGCCGGGCGCGGTGGCTCACGCCTGTAACCCCAGCACTTTGGGAGGCCCAGGCGGGTGGATCACCTGAGGTCAGGGGTTCGAGACCAGCCTGGCCAACATGGTGAAACCCCATCTCTAAAAATACGAAGATTAGCTGGGCATGGTGGCAGGTGCCTGTAATCCCAGCTACGTGGGGGGCTGAAGCAGGAGAATCGCTTGAACCCGGAAGGCAGAGCTGGCAGTGAGCCGAGATCACACCATCACACTCCAGCCTGGAGGACAAGAGCGAGACTTCATCTCAAAAAAAAAAAAGAA"
"chr1","113843310","113843609","KN294193v1","690006","690308","31","113153304","GGCGGGGCGTGGTGGCTCACGCCTGTAATCCCAGCACTTTGGGAGGCCCAGGCAGGTGGATCACCTGAGGTCAGGAGTTCGAGACCAGCCTGGCCAACATGGTGAAACTCCATCTCTACTAAAAATACAAAAATTAGCTGGGCGTGGTGGCGGGCGCCTATAATCCCAGCTACTCAGAAGGCTGAGGCAGGAGAATCGCTTGAACCCAGGAGGCAGAGGTTGCAGTGAGCCGAGATCGCGCCATTTCACTCCAGCCTGGGGGACAAGAGCAAGACTTCGTCTCAAAAATAATAATAAGAA","GGCTGGGCGCGGTGGCTCACGCCTGTAATCCCAGCACTTTGGAAGGCGAGGCAGGCGGATCACCTGAGATCAGGAGTTCGAGACCAGCCTGGCCAACATGGTGAAACCCCATCTCTACTAAAAATACAAAAATTAGTCGGGTGTGGTGGCAGGCGCCTGTAATCCCAGCCACTCGGGAGGCGGAGGCAGGAGAATCGCTTGAACCCGGCAGGCGGAGGTTGCAGTGAGCCGAGGTGGCGCCATTGCACTCCAGCCTGGGGGACAAGAGCAAGACTTCGTCTCAAAAACAAAGAAACAAAAAAA"
"chr1","119183570","119183870","KN294685v1","1269570","1269869","33","117914000","GGCCAGCTGTGGTGGCTCACTCCTGTAATCCCAGCACTTTGGGAGGCCTACACGGGTGGGTCACCTGAGGTCAGGAGTTCTAGACCAGCCTGGCCAACATGGTGAAACCCCGTCTCTACTAAAAATACAAAAATTAGCCGGGCGTGGTCGCAGGTGCCTGTAGTCCCAGCTACTCAGGGGGCCAAGGCAGGAGAATCGCTTGAACCTGGGAGGCGGAGGTTTCAGTGAGCCGAGATCACGCCATCGCACTCCAGCTTGGGGAACAAGAGCGAGACTTCGTCTTAAAAAAAAAAAAAAAAAA","GGCTGGGTGTGGTGGCTTAGGCCTGTAATCCCAGCACTTTGGGAGGCCAAGGCGGGCGGATCACCTGAGGTCAGGAGTTCGAGACCAGCCTGGCCAACATGGTGAAACCCCGTCTCTACTAAAAATACAAAAACTAGCCAGGCGTGGTGGCAGGTGACTGTAATCCCAGCTACTCGGGAGGCTGAGGCAGGAGAACTGCTTGAACCTGGGAGGCGGAGGTTGCAGTGAGCTGAGATCACACCATTGCACTCCAGCCTGGGGGACAAGAGCGAGACTTTGTCTCAAAAATAAAAAAAAAAA"
"chr1","123829372","123829530","KN296470v1","174157","174317","39","123655215","GCTGGGCATGGTNNNNNNNNNNNNNNNNNNNNACTTGGGAGGCTGAAGGCAGGAGAATTGCTTGAACCCGGGAGGCGAAGGTTGCAGTGAGCCGAGATTGTGCCACTCCACTCAAGCCTGGGGGACAAGAGCAAGACTTCATCTCCAAAAAAAAAAAAA","GCTGGGCGTGGTGGCAAGTATCTATAATCCCAGCTACTTGGGAGGCTGAGGCAGGAGAATCGCTTGAACCCGGGAGGTGGAGGTTGCAGTGAGCCGAGATCATGCCATTGCACTCCAGCCTGGGGGATAAGAGCGAGACTTTGTCTCAAAAAAAAAGAAAA"
"chr1","124871089","124871153","KN297046v1","1058980","1059042","16","123812109","GCGCCTGTAATCCCAGCTACCTGGAGGGTGAGGCAGGAGAATCTCTTGAACCCAGGAGGCAGAGG","CGCCTGTAATCCTAGCTATTCAGGGGACCGAGGCAGGAGAATTACTTGATCCCAGGAGGTGGA"
"chr1","129295432","129295744","KN294685v1","1269570","1269869","37","128025862","GGCTGGGTGTGGTGGCTCACACCTGTAATCCCAGCACTTTGGGAGACAGAGGCGGGTGGATCACCTGAGGTCAGGAGTTCGAGACCAGCTTGGCCAACATGGTGAAACCCCGTCTCTACTAAAAATACCAAAACTAGCCAGGCGTGGTGGCAAGTGCCTGTAATCCCAGCTACGCGGGGGGCTGAGGCAGGAGAATCACTTGAACCTGGGAGGCGGAGGTTGCAGTGAGCCGAGATCATGCCACTGCACTCCAGCTTGGGGGACAAGAGCGAGACATCGTCTCAAACAAACAAACAAACAAAAAACAGAAAAA","GGCTGGGTGTGGTGGCTTAGGCCTGTAATCCCAGCACTTTGGGAGGCCAAGGCGGGCGGATCACCTGAGGTCAGGAGTTCGAGACCAGCCTGGCCAACATGGTGAAACCCCGTCTCTACTAAAAATACAAAAACTAGCCAGGCGTGGTGGCAGGTGACTGTAATCCCAGCTACTCGGGAGGCTGAGGCAGGAGAACTGCTTGAACCTGGGAGGCGGAGGTTGCAGTGAGCTGAGATCACACCATTGCACTCCAGCCTGGGGGACAAGAGCGAGACTTTGTCTCAAAAATAAAAAAAAAAA"
"chr1","132893612","132893720","KN295814v1","1288666","1288771","9","131604946","TTGGGAGGCCGAGGCAGGAGAATTGCTTGAGCTTAGGAGTTAGAGGCTGCAGTGACCTAGGATTGCACCACTGCGTTCCAGCCTTGGGGATAAAACACAACCTTGTTTC","TTGGGAGGCCAAGGCAGGAGAATTGCTTGAGCTTAGGAGTTAGAGGCTGCAGTGACCTAGGATTGTACTGCACTTCAGCCTTGGGGATAGAACACAACCTTGTTTC"
"chr1","132898100","132898229","KN294420v1","516954","517082","16","132381146","GGCTGGGTGTGGTGGCTCACACCTGTAATCCCAGCACTTTGGGAGGCTGAGGTGGGTGGATCGCCTGAGGTCAGCAGTTCCAGACCAGCCTGGCCAGCGTGGTGAAACCCTGTCTCTACTAAAAATACAA","GGCCTGGCATCATGGTTCACACCTGTAATCCCAGCACTTTGGGAGGCCGAGGCAGGTGGATCACTTGAGGTCAGCGTTCTAGACCAGCCTGGCCAACATGGTGAAACCCTGTCTCTACTAAAAATACAA"
"chr1","135072364","135072663","KN296296v1","160831","161126","32","134911533","GGCCAGGCGCGGTGGCTCATGCCTATAATCCCAGCACTTTGAGAGGTCGAGGCGGGTGGAGCACCTGAGGTCAGGAGTTCGAGACCAGCCTGGCCAACATGGTGAAACCCCATCTCTACTAAAAATACCAAAACTAGCCGGGCGTGGTGCTGGGTGCCTGTAATCCCAGCTACTGCGGGGGCTGAGGCAGGAGAATTGCTTGAACCTGGGAGGCGGAGGTTGCAGTGAGCCGAGATAGTGCCATCACACTCCAGCCTGGGGGATAAGAGCAAGCTTTTGTCTCAAAAAAAAAAAAAAAAA","GGCTGGATGCAGTGGCTCACGCCTATAATCCCAGCACTTTGGGAGGTCTAGGCGGGTGGATCACCTGAGGTCAGGAGTTCGAGACCAGCCTGGCCAACATGGTGAAACCCTATCTCTACTAAAAATACCAAAACTAGCCAGGCGTGGTGGCGGGTGCCTGTAATCCCAGCTACTATGGAGGCTGAGGCAGGAGAATCACTTGAACCCGGGAGGCGGAAGTTGCAGTGAGCCGAGATAGTGCCATCGCATTCCAGCCTGGGGGGCAAGAGCGAGACTTTGTCTCAAAAAAAAAAGAA"
"chr1","135519167","135519469","KN294526v1","558418","558721","31","134960749","GCCAGGCGCGGTGGCTCATGCCTATAATCCCAGCACTTTGGGAGGCTGAGGTGGGTGGATCACCTGAGGTCAGGAGTTCGAGACCAGCCTGGCTAACGTGGTGAAACCCCGTCCCTACTAAAAATACAAAAATTAGCTGGGTGTGGTGGCAGGCACCTGTAATCCCAGCTGCTCAGGAGGCTGAGGCAGGAGAATTGCTTGAACCCAGGAGGCAGAGGTTTCAGTGAGCCGAGATTGTGCCATTGCCCTCCAGCCTGGGGGACAAGAGCGAGACTTCATCTACAAAAAAAAAAAAAAAGAGAA","GGCCAGGCGCAGTGGCTCATGCCTGTAATCCTAGCACTTTGGGAGGCCGAGGTGGGTTGATCACTTGAGGTCAGGAGTTCGAGCCCAGCCTGGCCAATATGGTGAAACCCCGTCTCTACTAAAAATACAAAAATTAGCCGGACGTGATGGCAGGCACCTGTAATCCCAGCTACTCAGGAGGCTGAGGCAGGAGAATTGCTTGAACCCGGGAGGCGGAGGTTACAGTGAGCTGAGATCGCGCCATTGCACTCCAGCCTTGGGTACAAGAGCAAGACTTCATCTCAAAAAAAAAAAAAAAAAAAAA"
"chr1","137957502","137957653","KN296036v1","1088280","1088429","20","136869222","GTGCCTGTAATCCCAGCTACTTGGGAGGCTGAGGCAGGAGAATGGCTTGAACTCGGGAGGCAGCGGTTGCAGTGAGCTGAGATCGCGCCATTGCACTCCAGCCTGGGGGACAAGAGCAAGACGTCATCTACAAAAAAAAAAACAAAAAAAAA","GCACATGTAATCCCAGCTACTCGGTGGGGCTGAGGCAGGAGAATCGCTTGAACCCAGGAGACGGAGGTTGCAGTGAGCCGAGATCGCGCCATTGCACTCCAGCGTGGGGGACAAGAGCGAGACTTCATCTCAAAAAAAGAAAAAAAAAAA"
"chr1","138131273","138131553","KN296665v1","24811","25083","51","138106462","GCACTTTGGGAGGCTGAGGTGGGTGGATCATCTGAGGTCAGGAGTTCGAGACCAGCCTGGCCAACATGGTGAAACCCTGTCTCTACTAAAAATACAAAAACTTAGCCTTTCGTGGTGGCAGGCACCTGTAGTCTCAGCTACTTGGGAGCCTGGGGTAGGAGAATCGCTTGAGCCTGGGAGGCAGTGGTTGCAGTAAGCCAAGACCGTGCCATTACACTCCAGCCTGGGGGACAAGAGCAAGACTCTGAATCAAAAAATAAAGAAATAAATAAACAAACAAA","CTTTGGGAGGCACAGGCGGGAGGATCACCTGAGGTCAGAAGTTCGAGACCAGCCTGGCCAAATGGTGAAACACCCAATCTGTACTAAAAATACAAAAATTAGCCGGGCGTGGTGGCGGGCACCTGTAATCCCAGCTACTTGGGAGGCTGAGGCAGGAGAATCGCTTGAACCCAGGAGGTGGAGGTTGCAGCGAGCCAAGATCGCACCATTGCACTCCAGCCTGGGGCACAAGAGCATGACTTTGTCTCAAACAAACAAACAAACAAACAAAAA"
"chr1","139563048","139563111","KN294457v1","203850","203915","15","139359198","GAGATTGCGCCATTGCACTCCACCCTGGGGTACAAGAGCGAGACTTCGTCTCAAAAAAAAAAAA","GATCACTCCATTGCACTCCAGCCTGGGGGATTAGAGCAACACTTCGTCTCAAAAAAATAAAATAAA"
"chr1","140997698","140998004","KN295573v1","1644468","1644772","40","139353230","GGCCGGGCGCAGTGTCTCACACCTGTAATCCCAAGCACTTTGTGGGGCCGAGGCAGGTGGATAACCTGAGGTCAGAAGTTCGAGACCAGCCTGGCCAACATGGTGAAACCCTGTCTCTACTAAAAATACAAAAATTAGCCGGGTGTGGTGGCAGGTGCCTGTAATCCCAGGTACTCGGGAGGCTGAGGAGGCAGGAGAATTGCTTGAAGCCAGGAGGCGGAGGTTGCAGTGAGCCGAGATCATGCCATTGCACTCCAGCCTGGTAGACAAGAAAGAGAGTTCGTCTCCAAAAAAAAAAGAACAAAAA","GGCCGGGCACAGTGGCTCACACCTGTAATCCCAGCACTTTGGGAGTCTGAGGCAGGCGGATCACCTGAGGTCAGGAGTTCGAGACCAGCCTGGCCAACATGGAGAAACCCCCGTCTCTACTAAAAATACAAAAATTAGCTGGGCATGATGGCAGGAGCCTGTAATCCCAGATACTCAGGAGGCTGAGGCAGGAGAATGGCTTGAACCCGGGAGGCAGAGGTTGCAGTGAGCCAAGGTCGCGCCATTGCACTCCAGCCTGGGGGACAAGAGCGAGACTTCGTCTCAAAAAAAAAAAAAAAAAAAAA"
"chr1","141493560","141493840","KN294172v1","4372726","4373008","45","137120834","GGCCGGGTGTGGTGGCTCACGCCTGTAATCCAAGCACTTTGGGAGGCTGGGGCGGGCAGATCACCAGTCTGGCCAAAATGGTGAAACCCCGTTTCTACTTAAAATACAAAAATTAGCCGGGCATGGTGGCAGGTGCCTGTAATCCCAGCTGCTCAGGAGGCTGAGGCAGGAGAATTGCTTGAACGTGGGAGGCAGAGGTTGCAGTGAGCTGAGATTGCACCATTGCACTCCAGCCTGGGGGACAAGAGTGAGACTTCATCTGGAAAAAATAAAAATAAAAA","GGCCGGGCGCAGTGGCTTACACCTATAATCCCAGCACTTTGGGAGGCTGAGGTCAGGAGTTCCAGACCAGCCTGGCCAACATGGTGAAACCCCATCTCTACTAAAGATACAAAAATTTGCCGGTGGTTTCAGGTGCCTGTAATCCCAGCTACTCGGGAGGCTGAGGCAGGAGAATCGCTTGAACCCGGGAGGCAGAGGTTACAGTGAGCCGAGATCGCACCATCGCACTCCAGTCTGGGGGACAAGAGCGAGACTTCGTCTCAAAAAAAAAAAAAAATAATAA"
"chr1","154504997","154505290","KN295576v1","406337","406628","33","154098660","GGCCAGGCGTGGTGGCTCACACCTGTAATCTCAGCACTTTGGGAGGCCGAGGCAGGAGGATCACCTGAGGTCAGGAGTTCAAGACCAGCCTGGCCAACATGGTGAAACCCCGTCTTTACTAAAAATACAAAAGTTAGCCCAGCGTGGTGGCAGCCATCTGTATTCCTAGCTACTCGGGAGGCTGAGGCAGAAGAATCGCTTGAACCTGGGAGGCAGAGGTGCAGTGAGCCGAGATCGCGCCATTGCACTCCAGCCTGGGGGACAAGAACGAGACTTCGTCTCAAAAAAAAAGAA","GGCCGGGCGCGGTGGCTCACGCCTGTAATCCCAGCACTTTGGGAGGCCGAGGCGGGCGGATCACCTGAGGTAAGGAGTTCGAGAACAGCCTGGCCAGCATGGTGAAACCCCATCTCTACTAAAAATACAAAAATTAGCCGGGCATGGTGGCAGGTGCCTGTAATCCCAGCTACTCGGGAGGCTGAGGCAGAAGAATCGCTTGAACCCAGGAGGCGGAGGTTGCAGTGAGCCGAGATTGCGCCATTGCACTCCAGCCTAGGGGAGAAGAGCGAGACTTCGTCTCAAAAAAAAA"
"chr1","158752185","158752488","KN297452v1","1683601","1683907","21","157068584","GCTGGGCGTGGTGGCTCATGCCTGTAATCCCAGCACTTTGGGAGGCTGAGGCGGGCGGATCACCTGAGGTCAGGAGTTCGAGACCAGCCTGGCCAACATGGTGAAACCCCGTCTCTACTAAAAATACAAAAATTAGCTGGGCATGGTGGCAGGCTCCTGTAATCTCAGCTACTCAGGAGGCTGAGGCAAGAGAATCACTTGAACCTGGGAGGCAGAGGTTGCAGTGAGCCAAGATTGCGCCATTGCACTCTAGCCTGGGGGACAAGAGCGAGACTTGCTCTCAAAAAAAAAAAAAAAAAAAAAA","GGCCGGGCGTGGTGGCTCATGCCTGTAATCCCAGCACTTTGGGAGGCTGAGGCGGGCGGATCACCTGAGGTCAGGAGTTCGAGACCAGCCTGGTCAACATGGTGAAACCCCGTCTCTACTAAAAATACAAAAATTAGCTGGGTGTAGTGGCAGGCGCCTGTAATCTTAGCTACTCGGGAGGCTGAGGCAAGAGGATCACTTGAACCTGGGAAGCAGAGGTTGCAGTGAGCCAAGATCACGCCATCGCACTCCAGCCTGGGGGACAAGCGTGAGATTTGCTCTTAAAAAAAAAAAAAAAAAAAAAAAA"
"chr1","160419025","160419329","KN294526v1","558418","558721","33","159860607","GGCCAGGCAGAGTGGCTCATGCCTGTAATACCAGCACTTTGGGAGGCCAAGGCGGGTGGATCACCTGAGGTCAGGAGTTCGAGACCAGCATGGCCAGCATGGTGAAACCCCGTCTCTACTAAAAATAAACAATTAGCCGGGCGTAGTGGCAGGTGCCTGTAATCCCAGCTACTCGGGAGGCTGAGGCAGGAGAAGTGCTTGAAGCCAGGAGGCTGAGGGTGCAGTGAGCTGAGATCGCACCATTGCACTGCAGCCTGGGGGACAAGAGCAAGACTTCATCTCAAAAAAATAAAATAAAAATAAAA","GGCCAGGCGCAGTGGCTCATGCCTGTAATCCTAGCACTTTGGGAGGCCGAGGTGGGTTGATCACTTGAGGTCAGGAGTTCGAGCCCAGCCTGGCCAATATGGTGAAACCCCGTCTCTACTAAAAATACAAAAATTAGCCGGACGTGATGGCAGGCACCTGTAATCCCAGCTACTCAGGAGGCTGAGGCAGGAGAATTGCTTGAACCCGGGAGGCGGAGGTTACAGTGAGCTGAGATCGCGCCATTGCACTCCAGCCTTGGGTACAAGAGCAAGACTTCATCTCAAAAAAAAAAAAAAAAAAAAA"
"chr1","161125389","161125689","KN296404v1","736642","736940","30","160388747","GCCAGGCTCAGTGGCTCACACCTGTAATCCCAGTACTTTGGGAAGCCGAGGCAGGTGGATCACTTGAGGTCAGGAGTTCCAGACCAGCCTGGCCAACATGGTGAAACCCAGTCTCAACTGAAAATGCAAAAATTAGCCAGGCGTGGTGGCAGGTGCCTGTAATCCCAGCTACTTGGGGGCGAGGCAGGAGAATCACTTGAATCTGGGAGGAGGAGGTTGCAGTGAGCCAAGATCCTGCCATTGCACTCCAGCCTAGGGGACAAGAGTGAGACTTCATCTCAAAAATAATAAATAAATAAAA","GCCAGGCATGGTGGCTCACGCCTGTAATCCCAGCACTTTGGGAAGCTGAGACAGGTGGATCACCTGAGGTCAGGAGTTCTAGACCAGCCTGGCCAACATGGTGAAACCCAGTCTCAACTGAAAATACAAAACTTAGCCAGGCATGGTGGCAGATGCCTGTAATCCCAGCTACTCGGGGGCGAGGCAGGAAAATCGCTTGAACCTAGGAGAAGGTGGCAGTGAGCTGAGATCGCGCCATCGCACTCCAGCCCAGGGGACAAGAGCGAGACTTCATCTCAAAAATAAATAAATAAATAAAA"
"chr1","164200659","164200956","KN294685v1","1269570","1269869","40","162931089","GGCTGGGCATGGTGGCTCATGTCTGTAATCCTAGCACTTTGGGAAACCAAGGCAGGTGGATCACTTGAGGCCAGGAGTTCAAGACCAACCTGGCCATCATAGTGAAACCCCATCTCTACTAAAAATACAAAAATTAGCCAGACGTGGTGACAGGTGCCTGTAATCCCAGCTACTCAGGAGGCTGAGGCAGGAGAATTGCTTAAACCTGGAGGCGGAGGTTGCAGTGAGCCGAGATCACGCCATTGCACTCCGGCCTGGGGGACAAGAGCAAGACTCAAAACAAACAAACAAATGAAAA","GGCTGGGTGTGGTGGCTTAGGCCTGTAATCCCAGCACTTTGGGAGGCCAAGGCGGGCGGATCACCTGAGGTCAGGAGTTCGAGACCAGCCTGGCCAACATGGTGAAACCCCGTCTCTACTAAAAATACAAAAACTAGCCAGGCGTGGTGGCAGGTGACTGTAATCCCAGCTACTCGGGAGGCTGAGGCAGGAGAACTGCTTGAACCTGGGAGGCGGAGGTTGCAGTGAGCTGAGATCACACCATTGCACTCCAGCCTGGGGGACAAGAGCGAGACTTTGTCTCAAAAATAAAAAAAAAAA"
"chr1","172617629","172617925","KN295576v1","406337","406628","35","172211292","GGCCGGGCGCAGTGGCCCACGCCTGTAATCCCAGCACATTGGAAGGCCAAGGTGGGCGGATCAGCTGAAGTCAGGGGTCCGAGACCAGCTTGGCCAACATGGTGAAAACCCGTCTCTACTAAAAATACAAAAATTAGCCAGGCATGGTGGCAGACGCCTGTAATCTCAGCTAGTCAGGAGGCTGAGGCAGGAGAATCGCTTGAACCCAGGAGGCGGAGGTTGCAGTGCGCCGAGATGGCGCCATTACACTCCAGCCTGGGGAACAAGAGTGAGACTTCGTCTACAAAAAAAAAAAAA","GGCCGGGCGCGGTGGCTCACGCCTGTAATCCCAGCACTTTGGGAGGCCGAGGCGGGCGGATCACCTGAGGTAAGGAGTTCGAGAACAGCCTGGCCAGCATGGTGAAACCCCATCTCTACTAAAAATACAAAAATTAGCCGGGCATGGTGGCAGGTGCCTGTAATCCCAGCTACTCGGGAGGCTGAGGCAGAAGAATCGCTTGAACCCAGGAGGCGGAGGTTGCAGTGAGCCGAGATTGCGCCATTGCACTCCAGCCTAGGGGAGAAGAGCGAGACTTCGTCTCAAAAAAAAA"
"chr1","172622160","172622459","KN294470v1","1177614","1177910","34","171444546","GGCTGGGTGCGGTGGCTCAGGCCTGTAATCCCAGCACTTTGGGAGGCCGAGGTGGGTGGATCACCTGAGGTCAGGAGTTCTAGACCAGCCTGGCCAACATGGTAAAACCCCGTCTCTACTAACAATACAAAAATTAGCCAGGGGTGGTGGCAGGCGCCTATAATCCCAGCTACTCAGGGGCCGAGGCAGGAGAATCACTTGCACCCGGGAGGCAGACGTTGCAGTGAGCTGTGAGATCGTGCCATCGCACTCCAGTCTGGGGGACAAGAGCGAGACTTCATCTCAAAAAAAAAAAATAAA","GACTGGGTGCAGTGGCTCATGCCTATAATCCCAGCACTTTGGGAGGCCGAGATGGGTGGATTGCCTGAGGTCAGGAGTTCATGACCAGCCTGGCCAACATGGTGAAACCCCATCTCTACTAAAAATACGAAAATTAGCCGGGCATGGTGGCAGGCGCCTATACTCCCAGCTACTCGGGAGCCTGAAGCAGGAGAATCCCTTGAACCCGGGAGGCAGAAGTTGCAGTGGGCCAAGATCATGCCATCGCACTCCAGTCTGGGGGACAAGAGCGAGACTGTCTCAAAAAAAAAAAAAAAA"
"chr1","177732875","177733180","KN294713v1","906670","906972","37","176826205","GCCGGGCACAGTGGCTCATGCTTATAATCCCAGCACTTTAGGAGGCCGAGGCAGGCAGAGCGCCTGAGGTCAGGAGTTCTAGACTGGCCTGGCCAAAATGGTGAAACCCCCTCTCTACTAAAAATACAAACATTAGCCTGGTGTGGTGGCAGGTGCCTGTAATCCCAGCTACTCAGGAGGCTGAGGCAGGAGAATCACTTGAACCCAGGAGGCAGAGGTTGCAGTGAGCCGAGATTGCACCATTGCATTCCAGCCTGGGAGACAAGAGAGAGACTTCATCTCAAAATAAAGAAAAGAAAAGAAAAA","GGCCGGGTGCAGTGGCTCAAGCCTGTACTCCCAGCACTTTGGGAGGCCGAGGCGGGCGGATCACCTGAGGTCGGGAGTTCGAGACCAACCTGGTCAACATGGTGAAACCCCTTCTCTACTAAAAACACAAAAATTAGCCGGTCATGGTGGCAGGTGCCTGTAATCCCAGCTACTCGGGAGGCTGAGGCAGGAGAATCGCTTGAACCCTGGAGGCAGAGATTGCAGTGAGCCGAGATCGCACCATTGCACTCCAGCCTGGGGGACAAGAGTGAGACTTCATCTCAAAAAAAAAAAAAAAAAAAA"
"chr1","179159506","179159621","KN295315v1","1304753","1304876","25","177854753","GGCCGAGTGTGTTGGCTCACACCTGTAATCCCATAACTTTGGGAGGCCGAGGCCAGTGGATTGCCAGAGCTCAGGAGTTCCAGACCAGCCTGGGCCATGGTGAAACCCTGTCTCTA","GGGCGGGCGCGGAGGCTCACACCTGTAATCCCAGCACTTTGGAAGGCTGAGGCAGGTGGATCACCTGAGGTCAGGAGTTCCAGACCAGCCTGGCCAACATGGTGAAACCCTGTCTCACTAACAA"
"chr1","180580433","180580729","KN297219v1","1714724","1715019","23","178865709","GACCAGGCGTGGTGGCTTATGCCTGTAATCCCAGCACTTTGGGAGGCCGAGGCGGGTGGATCATCTGAGGTCAGGAGTTCGAGACCAGCCTGGCCAACATGGTGAAACCCCATCTCTACTAAAAAATACAAAAATTAGCTGGTCGTGGTGGCAGGCACCTTAATCCCAGCTACTTGGGAGGCAGAGGCAGGAGAATCGTTTGAACCCAGGAGGCGGAAGTTGCAGTGAGCCAAGATAAAGCCATTGCACTCAAACATGGGGGACAAGAGCGAGACTTCTCTCAAAAAAAAAAAGAAA","GACCGGGCTCAGTGGCTCACCCCTGTAATCCCAGCACTTTGGGAGGCCGAGGTGGGTGGATCACCTGAGGTCAGGAGTTCGAGACCAGCCTGGCCAACATGGTGAAACCCCATCTCTACTAAAAAATACAAAAATTAGCTGTGCGTGGTGGCAGGTGCCTTAATCCCAGCTACTTGGGAGGTAGAGGCAGGAGAATCATTTGAACCCAGGAGGCGGAGGTTGCAGTGAGCTGAGATAAAGCCATGGCACTGAAACCTGGGGGACAAGAGTGAGACTTCTCTAAAAAAAAAAAGAAA"
"chr1","181877327","181877625","KN294420v1","890399","890698","28","180986928","GGCCTGGCACAGTGGCTCATGCCTGTAATCCCAGCACTTTGGGAGGCCGAGGCAGGCGGATCACCTGAGGTCAGGAATTCGAGACCAGCCTGACCAACATGGTGAAACCCCGTCTCTACTTAAAATACAAAAATTAGCCAGGCATGGTGGCAGGCGCCTGTAATCCCAGCTACTCAGGAGGCTGGGGCAGGAGAATTGCTTGAACCCGGGAGGCGGGGGTTGCAGTGAGCCGAGATCGCACCATTGCACTCCAGCCTGGGGGACAAGAGCGAGACTTCATCTCAAAAAAAAAAAAAGAA","GGCCAGGCACGGTGGCTCACGCCTGTAATCCCAGCACTTTGGGAGGCTGAGGTGGGCGGATCACCTAAGGTCAGGAGTTCTAGATCAGCCTGGCCAACATGGTGAAATCCCGTCTCTACTAAAAATACAAAAATTAGCCAGGCATGGTGGCAGGCGCCTGTAATCACAGCTACTCAGGAGGCTGAGGCAGGAGAATCACTTGAACCCAGGAGGCGGAGTTTGCAGTGAGCTGAGATTGCACCATTGCAGTCCAGCCTGGGGGACAAAAGCAAGACTCCATCTCAAAAAAAAAAAAAAAAA"
"chr1","181928047","181928330","KN296495v1","2052820","2053103","37","179875227","GGCCGGGCATGGTGGCGCACACCTATAAATCCCGCACTTTGGGAGGCGGAGGCGGGTGGATCACCTAAGGTCAGGAGTTCGAGACAAACCTGGCTAACATGGTGAAATCCCCTCTCTACTAAAAATACAAAAATTAGCCTGGCGTGGTGACGGGCACCTGTAATCCCAGCTACTCGGGAGGCTGAGGTAGGAGAATTGCTTGAACGCGGGAGGTGGAGGTTGCAGTGAGCCTAGATCGCGCCATTGCACTCCAGCCTGGGGGAAAAGAGCGAGGCTTCGTCTCA","GGCTGGGCACGGTGGCTCACGCCTGTCAATCCCAGCACTTTGGGAGGCTGAGGCAGGTGGATCACCTGAGGTCAGGAGTTCGAGACCAGCATGGCCAACATGGTGAAACCCTGTCTCTACTAAAAATACAAAAATTAGCTGGGCGTGGTGGTAGGCACCTGTAATCCCAGTTACTCGGGAGGCTGAGGCAGGAGAATCGCTTGAACCCAGGAGGTGGAGGTTGCAGTGAGCTGAGATTGCGCCATTGCACTGCAACCTGGGGCACAAGAGCGAGACTTCATCTC"
"chr1","183799118","183799401","KN295576v1","406337","406628","29","183392781","GCCGGGCACAGTGGCTCACGCCTGTAATCCCAGCACTTTGGGAGGCCAAGGCGGGTGGATCACCTGAGGTCAGGAGTTCAAGGCCAGCCTGGCCAAGGTGAAACCCCATTTCTACTAAAAGTACAAAAATTAGCCAGGCATGGTGGCAGGCACCTGTAATCCCAGCTACCCGGGAGGCTGAGGCAGGAGAATCGCTTGAACCTGGGAGGCGGAGGTTGCAGTGAGCCGAGATTGCGCCATTGCACTCCAGCCTGGAGGACAAGAGCGAGACTTTGTCTCAAAAA","GGCCGGGCGCGGTGGCTCACGCCTGTAATCCCAGCACTTTGGGAGGCCGAGGCGGGCGGATCACCTGAGGTAAGGAGTTCGAGAACAGCCTGGCCAGCATGGTGAAACCCCATCTCTACTAAAAATACAAAAATTAGCCGGGCATGGTGGCAGGTGCCTGTAATCCCAGCTACTCGGGAGGCTGAGGCAGAAGAATCGCTTGAACCCAGGAGGCGGAGGTTGCAGTGAGCCGAGATTGCGCCATTGCACTCCAGCCTAGGGGAGAAGAGCGAGACTTCGTCTCAAAAAAAAA"
"chr1","184430103","184430404","KN294685v1","1269570","1269869","31","183160533","GGCTGGGCATGGTGGCTCATGCTTGTAATCCTAGCACTTTGGGAGGCTGAGGCAGGCGGATCACCTGAGGTCAGGAGTTCGAGACCAGCCTGGCCAACATGGTGAAACACTGTCTATATTAAAAATACAAAAATTAGCCTGACATGGTGGCAGGCGCCTGTAATCCCAGCTACTCGGGAGGCTGAGGCAGGATAATTGCTTGAACCCGGGAGGCAGAGGTTGCAGTGAGCCGAGATCGCGCCATTGCCCTCCAGCCTGGGGGACAAGAGCAAGACTTTGTCTCAAAAAACAAACAAAAAAAA","GGCTGGGTGTGGTGGCTTAGGCCTGTAATCCCAGCACTTTGGGAGGCCAAGGCGGGCGGATCACCTGAGGTCAGGAGTTCGAGACCAGCCTGGCCAACATGGTGAAACCCCGTCTCTACTAAAAATACAAAAACTAGCCAGGCGTGGTGGCAGGTGACTGTAATCCCAGCTACTCGGGAGGCTGAGGCAGGAGAACTGCTTGAACCTGGGAGGCGGAGGTTGCAGTGAGCTGAGATCACACCATTGCACTCCAGCCTGGGGGACAAGAGCGAGACTTTGTCTCAAAAATAAAAAAAAAAA"
"chr1","189065761","189066084","KN294665v1","171883","172197","44","188893878","GCCGGGCACAGTGGCTCACGCCTGTAATCCCAGCACTTTGGGAGGCCAAGGCAAGTGAATCACATGAGGTCAGGAGATCGAGACCAGCCTGGCCAACATGGTGAAACTCTATCTCTACTAAAAATACAAAAATTAGCCAGGCATGGTGGCGGGTGCCCATAATCCCAGCTACTCGGGAGGCTGAGGCAGGAGAATCGCTTGAACTCAGGAAGCAGAGGTTGCAGTGAGCTGAGATCACACCATTGCACTCCAGCCTGGGGGACAAGAGCAAGACTTTGTCTCAAAAAAACAAAACAAAACAAAAAATAACAACAACAACAAAAA","GCCGGGCATGGTGGCTCATGCGTGTAATCCCACCACTTTGGGAGTCCGAGGCAGGTGGATCACCTGAGGTCAGGAGTTCGAGACCAGCCTGGCCAACATGGTGAAACCCCCGTCTCTACTAAAAATACAAAAATTAGCTGGGCATGGTGGCAGGCGCCTGTAATCCCAGCTACTCGGGAGGCTGAGGCAAGAGAATCGCTTGAACCCGGGAGATGGAGGTTGCAGTGAGCCGAGATCGCACCATTGCACTCCAGCCTGGGGGACAAAAGAGAGACTTTGTCTCAAAAAAAAAAAAAAAAAAAAAAAAAAGAAAAA"
"chr1","190713809","190714098","KN294578v1","529845","530134","38","190183964","GGCTGGGCACGGTGGCTCATGCCTGTAATCTCAGCACTTTGGGAAGCCAAGGCAGGTGGATCATGAGATCAGGATATCTACAGCGGCCTGGCCAACATGATGAAACCCCGTTTCTACTAAAAATACAAAACTTAGCTGGGCATGGTGGCAGGTGCCTGTAATCCCAGCTACTTGGGAGGCTGAGGCAGGAGAATCGCTTGAACCCGGGAGGCAAAGGTTGCAGTGAGCCAAGATCGTGCGCTTGCACTTCAGCCTGGGAGACAAGAGTGAGACTTCATCTCAAAAAAAAA","GCTGGGCACAGTGGCTCATGCCTGTAATCCCAGCACTTTGGGAGGCCAAGGCAGGCAGATCACGAGGTCAGGAGATCTAGAGCAGCCTGGCCAACATGGTGAAACTCCATCTCTACTAAAAATACAAAAATTAGCCAGGCATGGTGACAGGTACCTGTAATCCCAGTTACTCAGGAGGCTAAGTCAGGAGAATCGCTTGAACCCAGAGGCAGAGGTTGCAGTGAGCCAAGATTGTGCCATTGCACTCCAGCCTGGGGAACAAGAATAAGACTTCATCTCAAAAAAAAAAA"
"chr1","192065572","192065882","KN295202v1","417196","417507","43","191648376","GGCCAGGCACAGTGGCTCACGCCTGTGATCCCAGCACTTTGGGAGGCTGAGGCGGGTGGATCATGAGGTCAGCAGTTCAAGACCAGCCTGACCGAAATGGTAAAACCCCGTCTCTACTAAAAATACAAAAATTAGCCGGGTGTGGTGGCAGGCACCTGTAATCCCAGCTACTCAGAAGGCTAAGGCAGGAGAATCGCTTGAACCTGGGAGGCGGAAGTTGTAGTGAGCCGAGATTGCGCCATTGCACTCCAGTCTGGGGGACAAGAACCAGACTTTGCTTCAAAAAAAAAAGAAAAGAAAAGAAAGGAAAA","GGCTGGACACGGTGGCTCACACCTGTAATCCCAGCACTTTGGGAGGCTGAGGCGGGTAGATCACCTGGGATCAGGAGTTCAAGAACAGCCTGGCCAACATGATGAAACCCCGTCTCTACTAAAAATACAAAAATTAGCCAGGCATGGTGGCAGGCACCTGTAATCCCAGCTACTCAGGGGGCTGAGGCAGGGGAATCCATTGAACCCAGGAGGCGGAGGTTGCAGTGAGCCAAGATCGCGCCATCGCACTCCAGCCTGGGGGACAAGAGTGAGACTTTGTCTCAAAAAAAAAAAAAAAAAAAGAAAAGAAAA"
"chr1","192142038","192142346","KN294685v1","1269570","1269869","47","190872468","GGCCAGGTATGGTGGCTCATGCCTGGGCTGGGATTACCAGCACTTTGGGAGGCTGAGGCGGGTGGATCCCCTGATGTCAGGAGTTCAAGACCAGCCTGGCCAAAATGGTGAAACCCCGTCTCTACAAAAAAAATACAAAAATTAGCTGGGCGTGGTGGCAGATGCCTGGAATTTCAGCTACTCGGGAGGCTGATGCAGGAGAACTTGAACCCGGGAGGCGGAGGTTGCAGTGAGCCGAGATTGCGCCATTGCACTCCAGCCTGGGGGACAAGAATGAGACTTTGTCTCAAAAAAGAAAAAGAAAAAAAA","GGCTGGGTGTGGTGGCTTAGGCCTGTAATCCCAGCACTTTGGGAGGCCAAGGCGGGCGGATCACCTGAGGTCAGGAGTTCGAGACCAGCCTGGCCAACATGGTGAAACCCCGTCTCTACTAAAAATACAAAAACTAGCCAGGCGTGGTGGCAGGTGACTGTAATCCCAGCTACTCGGGAGGCTGAGGCAGGAGAACTGCTTGAACCTGGGAGGCGGAGGTTGCAGTGAGCTGAGATCACACCATTGCACTCCAGCCTGGGGGACAAGAGCGAGACTTTGTCTCAAAAATAAAAAAAAAAA"
"chr1","192553221","192553233","KN294326v1","685529","685541","8","191867692","CAGGAGTTCTACA","AATTAAAAATAAA"
"chr1","192553458","192553477","KN294326v1","685529","685541","13","191867929","CAGCCTGGCCAACATGGTGA","AATTAAAAATAAA"
"chr1","193360421","193360705","KN295576v1","406337","406628","47","192954084","GCTGGGTGTGGTGGCTTACTCCTGTAATCCCAGCACTTTGGGAGACTGAGATGGGTGGATCACCTGAGGTCAGGAGTTCTAGACCAGCCTGACCAATATGGTGAAACCCCATCTCTACTAAAAATACAAAAATTAGCTGGATGTGGTCATGGGTGCCTGTAATATCAGCTACTCGAGAGGCTGAGGCAGGAGAATTGCTAGAACCCAGGAGGCAGAGGTTGCAGTGAGCTGAGATCGCACCATTGCACTCCAGCCTGAGGGACAAAGACTCCAATTAAAAAAAAA","GGCCGGGCGCGGTGGCTCACGCCTGTAATCCCAGCACTTTGGGAGGCCGAGGCGGGCGGATCACCTGAGGTAAGGAGTTCGAGAACAGCCTGGCCAGCATGGTGAAACCCCATCTCTACTAAAAATACAAAAATTAGCCGGGCATGGTGGCAGGTGCCTGTAATCCCAGCTACTCGGGAGGCTGAGGCAGAAGAATCGCTTGAACCCAGGAGGCGGAGGTTGCAGTGAGCCGAGATTGCGCCATTGCACTCCAGCCTAGGGGAGAAGAGCGAGACTTCGTCTCAAAAAAAAA"
"chr1","209164754","209164837","KN296311v1","1646100","1646183","24","207518654","GGAGGCGGAAGTTGCAGTGAGCCAAGATCGCGCCATTGCACTCCAGCCTGGGAGACAAGAGCGAGACTTTGGGAAAAAAAGAAA","CAGAGGTTGCAGTGAGCCGAGATCGTGCCACCCCACTCCAGCCTGGGAGACGAGCAAGAGTTCGAGAAAGAAAAGAAAAGAAAA"
"chr1","212136584","212136915","KN295576v1","406337","406628","63","211730247","GGCCGGGCACGGTGGCTCCCGCCTGTAATCCCAGCACTTTGGGAGGCTGAGGTGGGTGGATTGCCTGAGCTTAGGNNNNNNNNNNNNNNNNNNNNGATCACCTGAGGTCAGGAGTTCGAGACCATCCTGGCCAACATGGCGAAACCCCATCTCTACTAAAATACAAAAATATTAGCCGGGTGTGGTGGCAGGAGCCCGTAATCCCAGCTACTCGGGAGGCTGAGGCAGGAGAATCGCTTGAATCCAGGAGCCGAAGGTTGCAGTGAGCCGAGATCGCACCATTGCACTCCAGCCTGGGGGACAAGAGCGAGACTTCGTCTACAAAAAAAAAA","GGCCGGGCGCGGTGGCTCACGCCTGTAATCCCAGCACTTTGGGAGGCCGAGGCGGGCGGATCACCTGAGGTAAGGAGTTCGAGAACAGCCTGGCCAGCATGGTGAAACCCCATCTCTACTAAAAATACAAAAATTAGCCGGGCATGGTGGCAGGTGCCTGTAATCCCAGCTACTCGGGAGGCTGAGGCAGAAGAATCGCTTGAACCCAGGAGGCGGAGGTTGCAGTGAGCCGAGATTGCGCCATTGCACTCCAGCCTAGGGGAGAAGAGCGAGACTTCGTCTCAAAAAAAAA"
"chr1","212744044","212744353","KN294665v1","171883","172197","48","212572161","GGCCAGGCATGGTGGCTCACGCCTGTAATACCAGCACTTTGGGAGGCCAAGGTGGGTGGATCACCTGAGGTCAGGAGTTCAAGACCAGCCTGGCCAACATGGCGAAACCCCGTCTCTACTAAAAATACAAAAATTAGCTGGGTGTGGTCGCAGGTGCCTGTAATCCCAGCTACTTCAGAGGCTGATGCAGGAGAATCACTTGAACCCGGGAGGTGGAGGTTGCAGTGATCGTGCCATTGCATTCCAGTCTAGGGGGCAAGAGTGAGGCTTTGTTCTCAAAAAATACCACAAAACAAACAAACAAAAAAAA","GCCGGGCATGGTGGCTCATGCGTGTAATCCCACCACTTTGGGAGTCCGAGGCAGGTGGATCACCTGAGGTCAGGAGTTCGAGACCAGCCTGGCCAACATGGTGAAACCCCCGTCTCTACTAAAAATACAAAAATTAGCTGGGCATGGTGGCAGGCGCCTGTAATCCCAGCTACTCGGGAGGCTGAGGCAAGAGAATCGCTTGAACCCGGGAGATGGAGGTTGCAGTGAGCCGAGATCGCACCATTGCACTCCAGCCTGGGGGACAAAAGAGAGACTTTGTCTCAAAAAAAAAAAAAAAAAAAAAAAAAAGAAAAA"
"chr1","214289445","214289575","KN296040v1","489522","489654","14","213799923","GCTGGGCATGGTGGCTCACACCTGTAATCCCAGCACTTTGGAAGGCTGAAGCGGGTGGATCACCTGAGATCAGGAGTTCCAGACCAGCCTGGCCAACATGGTGAAACCCCGTCTCTACTAAAAATACAAAA","GGCTGGGCGCAGGGGCTCACACCTGTAATCCCAGCACTTTGGGAGGCTGAGGTGGGTGGATCACCTGAGGTCAGGAGTTCCAGACCAGCCTGGACAACATGGTGAAATCCCATCCCTACTAAAAATACAAAAA"
"chr1","215912467","215912747","KN296495v1","2052820","2053103","34","213859647","GCTGGGCGCAGTGGCTCATGCCTGTAATCCCAGCACTTCGGGAGGCCGAGGGAGGTGGATCACCTGGGGTCAGGAGTTTGAGACCAGCCTAGCCAATATAGTGAAACCCCGTCTCTACTAAAAATATAAAAAGTAGCCGGGTGTGGTGGCAGGTGCCTGTAATCCCAGCTACTTGGGAGGCTGAGGCAGGAGAATCGCTTGAACCCAGGAGGCAGAGGTCGCAGTGAGCCGAGATCGCGCCACTGCACTCCAGCCTGGGGGACAAGAGCGAGACTTCATCT","GGCTGGGCACGGTGGCTCACGCCTGTCAATCCCAGCACTTTGGGAGGCTGAGGCAGGTGGATCACCTGAGGTCAGGAGTTCGAGACCAGCATGGCCAACATGGTGAAACCCTGTCTCTACTAAAAATACAAAAATTAGCTGGGCGTGGTGGTAGGCACCTGTAATCCCAGTTACTCGGGAGGCTGAGGCAGGAGAATCGCTTGAACCCAGGAGGTGGAGGTTGCAGTGAGCTGAGATTGCGCCATTGCACTGCAACCTGGGGCACAAGAGCGAGACTTCATCTC"
"chr1","216038972","216039264","KN297219v1","1547695","1547989","148","214491277","GGCCGGGCGCGGTGGNNNNNNNNNNNNNNNNNNNNNNNNNNNNNNNNNNNNNNNNNNNNNNNNNNNNNNNNNNNNNNNNNNNNNNNNNNNNNNNNNNNNNNNNNNNNNNNNNNNNNNNNNNNNNNNNNNNNNNNNNNNNCCAGGTGTGCTGGCAGGCGACTGTCAGCTACTCGAGAGGCTGAGGCAAGAGAATCGCTTGAACCCCCGAGGCAGATGTTGCAGTGAGCCGAAATCACGCCATCGCACTCCAGCCTGGGGGACAAGAGCAAGACTTCGTCTCAAAAAAAAAAAAA","GCCAGGCGCAGTGGCTCACACCTGTAATCCCTGCACTTTGGGAGGCCAAGGTGGGCGGATTACCTGAGGGCAGGAGTTTCAGACCAGCCTGGCCAACATGGTGAAACGCCGTCTCTACTAAAAACATAAAAATTATCTGGGTGTGGTGGCAGGCGCCTGTAATCCCAGCTACTCGGGAGCCTGAGGCAGGAGAATTGCTTGAACCCAGGAGGCAGAGGTTGCAGTGAGCCGAGATCGCGCCATTGCACTCCAGCCTGGGGGACAAGAGCGAGACTTGGTCTCAAAAAAAAAAAAA"
"chr1","217627827","217628131","KN294420v1","890399","890698","34","216737428","GGCCGGGCAGGGTGGCTCATGCCTGTAATCCCAGCACTTTGAGAGGCTGAGGCGGGTGGATCACCTGAGGTCAGGAGTTCGAGACCAGCCTGGCCAACATAGTGAAACCTCGTCTCTACTAAAAATAGAAAAATTAGCCAAACATGGTGACAGGTGCCTGTAATCCCAGCTACTCAGGAGGCTGAGGCAGGAGAATCGCTTGAATCCAGGAGGCAGAGGTTGCAGTGAGCCGAGATAGCACCATTGCACTCCAGCCTAGGGGACAAGAGCAAGACTTCGTCTCAAAAAAAAGACAAAAATGAAAA","GGCCAGGCACGGTGGCTCACGCCTGTAATCCCAGCACTTTGGGAGGCTGAGGTGGGCGGATCACCTAAGGTCAGGAGTTCTAGATCAGCCTGGCCAACATGGTGAAATCCCGTCTCTACTAAAAATACAAAAATTAGCCAGGCATGGTGGCAGGCGCCTGTAATCACAGCTACTCAGGAGGCTGAGGCAGGAGAATCACTTGAACCCAGGAGGCGGAGTTTGCAGTGAGCTGAGATTGCACCATTGCAGTCCAGCCTGGGGGACAAAAGCAAGACTCCATCTCAAAAAAAAAAAAAAAAA"
"chr1","218935374","218935671","KN295315v1","992137","992431","31","217943237","GGCTGGGTGCAGTGGCTCATGCCTGTAATCCCAGCACTTTGGGAGGCTGAGGTGGATGGATCACCTGAGGTCAGGAGTTCGAGACCAGCCTGGCCAACATGGTGAAACCCTGTCTGTACTAAAAATACAAAAATTAGCTGGGCATGGTAGCAGGCACCTGTAATCCCAGCTACTTGGGAGGCTGAGGCAGGAGAATTGCTTGAACCCGGGAGGTGGAGGTTGCAGTGAGCTGAGGTCACGCTATTGGACTCCAGCCTGGGGTACAAGAGCAAGACTTCATCTTAAAAAAAAAAAAAAA","GGCTGGCCGCGGCGGCTCATGCCTGTAATCCCAGCACTTTGGGAAGCTGAGGCGGGTGGATCACCTGAGGTCAGGAGTTCGAGAGCAGCCTGGCCAACGTGGTGAAACTGTGTCTCTACTAAAAATACAAAAATTAGCTGGGCGTGGTGGCAGGCACCTGTAATCCCAGCTACTTGGGAGACTGAGGCAGGAGAATCGCTTGAACCCAGGAGGTGGAGGTTGCAGTGAGCCGAGATCACGCCATTGTACTCCAGCCTGGAGGATAAGAGTGAGACTTCGTCTCAAAAAAAAAAAA"
"chr1","228102920","228103206","KN295941v1","1108709","1108994","26","226994211","GGCAGGGCGCAGTGGCTCACGCCTGTAATCCCAGCACTTTGGGAGGCCAAGGCGGGTGGATCACCTGAGGTCAGGAGTTCGAGACCAGACTGGCCAATATGGTAAAACCCTGTCTCTACTAAAAATACAAAAATTAGCCTGGTGTGGTGGCAGGCGCCTGTAATCCCAGCTACTCGGGAGGCTGAGGCAGCAGAATCGCTCGAACCCGGGAGGTGGAGGTTGCAGTGAGTCAAGATCGCGCCATTGCACTCCAGCCTGGGGGACAAGAGCGAGACTTCGTCTTAAAA","GCCGGGTGCTTTGGCTCACGCCTGTAATCCCAGCACTTTGGGATGCCGAGGCGGGTGGATCACCTGAGGTCAGGAGTTTGAGACCAGCCTGGCCAACATGGTGAAACCCTGTCTCTACCAAAAATACAAAAATTAGCCGGGCGGGGTGGCAGGCGCCCGTAATCCCAGCTACTCGGAAGGCTGAGGCAGGATAATCGCTTGAACCTGGGAGGCGGAGGTTGCAGTGAGCCGAGATCGCACCATTGCACTCCAGCCTGGGGGACAAGAGCGAGACTTCGTCTCAAAA"
"chr1","229763604","229763917","KN297313v1","927020","927329","45","228836584","GTCGGGTGCAGTGGCTCACACCCGTGATCCTAGCACTTTGGGTGGCCGAGGCAGGCAGATCACCTGAGGTCAGGACTTCATAGACCAGCCTGGCCAACATGGTGAAACCTCATCTCTATTAAAATACAAAGATTAGTCGGGCATGGTGGCCGGTGCCTGTAAAATTCCAGCTACTCAGGAGGCTGAGGAAGGAGAATCGCTTGAACTTGAGAGGCGGAGGTTGCAGTGAGCTGAGATCGTGCCATTGCACTCCAGCCTGGGGGACAAGAGTAAGACTTCGTCTCAAAAAACAACAAAACAAAACAAGAAAAAAA","GCCGGGTGCGGTGGCTCACACCTGTAATCCCAGCACTTTGGCAGGCCAAGGCGGGTGGATCACCTGAGGTCAGGAATTTGAGACCAGCCTGGCCAACATGGTGAAACCCAGTCTCTACTAAAAATACAAAAATTAGCTGGGCATGATGGCAGGTGCCTGTAATCCCAGCTACTCGGGAGGCTGAGGCAGGAGAATCGCTTGAATCCGGGAAGTGGAGGTTGCAGTGAGCCGAGATCGTGCCATTACACTCCAGCCTGGGGGACAAAAGAGACTTCGTCTCAAAAAAAAAAAAAAAAAAAAAAAAAAAAAA"
"chr3","4537860","4538172","KN295573v1","1644468","1644772","30","2893392","GGCCGGGCGCGGTGGCTCACTCCTGTAATCCCGTAACCCCAGCACTTTGGGAGGCTGAGGCCGGTGGAACACCTGAGGTCAGGAGTTCGAGACCAGCCTGGCCAACATGGTGAAACCCCGTCTCTACTAAAAATACAAAAATTAGCTGGGCATGGTGGCAGGCGCCCGTAATCCCAGCTACTCGGGAGGCTGAGGCAGGAGAATCGCTTGAACCCAGGAGGCGGAGGTTGCAGTGAGCCGAGGTTGCGCCATTGCACTCCAGCCTGGGGGACAAGAGTGAGACTTCGTCTACAAAAAAAAAAAAAAAAAGAAA","GGCCGGGCACAGTGGCTCACACCTGTAATCCCAGCACTTTGGGAGTCTGAGGCAGGCGGATCACCTGAGGTCAGGAGTTCGAGACCAGCCTGGCCAACATGGAGAAACCCCCGTCTCTACTAAAAATACAAAAATTAGCTGGGCATGATGGCAGGAGCCTGTAATCCCAGATACTCAGGAGGCTGAGGCAGGAGAATGGCTTGAACCCGGGAGGCAGAGGTTGCAGTGAGCCAAGGTCGCGCCATTGCACTCCAGCCTGGGGGACAAGAGCGAGACTTCGTCTCAAAAAAAAAAAAAAAAAAAAA"
"chr3","7487701","7488000","KN294685v1","1269570","1269869","38","6218131","GGCTGGACGTGGTGGCTCACACCTGTAATCCCAGCACTTTTGGGAGGCTGAGGTGGGCGGATCACCTGAAGTCAGGAGTTCTAGACCAGCCTGGCCAACATAGTGAAACCCCATCTCTACTAAAAATACAAAACTTAGCCGGGCGTGGTGGTGTGTGCCTGTAATCCCAGTTGCTCGGGGGGCCAAGGCAGGAGAATTGCTTGAACCCAGGAGGCAGAGGTTGCAGTGAGATGAGATTGCACCATCGCACTGCAGCCTGGCGGACAAGAGTGAGACTTGGTCTCAAAAAAAAAAAAAAAA","GGCTGGGTGTGGTGGCTTAGGCCTGTAATCCCAGCACTTTGGGAGGCCAAGGCGGGCGGATCACCTGAGGTCAGGAGTTCGAGACCAGCCTGGCCAACATGGTGAAACCCCGTCTCTACTAAAAATACAAAAACTAGCCAGGCGTGGTGGCAGGTGACTGTAATCCCAGCTACTCGGGAGGCTGAGGCAGGAGAACTGCTTGAACCTGGGAGGCGGAGGTTGCAGTGAGCTGAGATCACACCATTGCACTCCAGCCTGGGGGACAAGAGCGAGACTTTGTCTCAAAAATAAAAAAAAAAA"
"chr3","9484727","9484879","KN295405v1","1830944","1831087","30","7653783","GGCCAGGCATGCTGGCTCACGCCTGTAATCCCAGCGCTTTGGGAGGCTGAGGTGGGTGGATCACTTGAGGTCAGGGGTTCTAGACTACCATGATCAACGTGGTAAAACCCCATCTCTACTAAAAAATACAAAAAAATTAGCCAGGCTTGATGG","GCCAGGCACGGTGGCTCACGCCTTTAATCCCAGCACTATGGGAGGCTGAGGTGGGAGGATCACCTGAGGTCAGGAGTTCCAGATCAGCCTGGCCAACATGGTGAAACCCCGTCACTACTAAAAATACAAAACAACTAGCCAGGC"
"chr3","9541622","9541930","KN296387v1","301235","301539","32","9240387","GGCTGGGCACGGTGGCTCATGCCTATAATCCCAGCACTTTGGGAGGGCAAGGTGGGCGGATCACCTGAGGTAAGGAGTTCGAGACTAGCCTGGCCAACATGGTAAAACCCCGTCTCTACTAAAAATACAAAAACTAGCCAGGTGTGGTGGCAGGCGCCTGTAATCCCAGCTACTTGGGAGGCTGAGGCAGGAGAATTGCTTGAACCCAGGAGGCAGAGGTTGCAGTGAGCCAGGATCGCGCCATTGCACTTCAGCCTCAGGGGAGAAGAGTGAGACTTTGTCTACAAAAAAAAAAAAGAAAAGAAAAAA","GGCTGGGCGCGGTGGCTCACACCTGTAATCCCAGCACTTTGGGAGGCCGAGGTGGGTGAATCACCTGAGGTCAGGAGTTCGAGACCAGCCTGGCCAACATGGTGAAACCCCATATCTACTAAAAATACAAAAATTAGCCAGGTGTGGTGGCAGGCGCCTATAATCCCAGCTGCTTGGGAGCCTGAGGCAGGAGAATCGCTTGAACCTGGGAGGCGGAGGTTGCAGTGAGCCAAGATCGTGCCATTGCACTCCAGCCTAGGGGACAAGAGTGAGACTAATCTCAAAAAAAAAAAAAAAAAAAAAAA"
"chr3","10183254","10183531","KN296528v1","90077","90363","58","10093177","CTCACACCTTTAATCCCAGGACTTTGGGAGGCCGAGGTGGGTGGATCACTTGATCTCAGGAGTTCGAGACCAGCCTGGGCAACATGGTGAAATCCCGTCTCTACTAAAAATACAAAAATTAGCCAGGTGTGGTGGGTTCCTGTAACCCCAGCTACTTGGGTGGCTGAGGCAAGAGAATCGCTTGAACCAGGGAGGCAGAAGTTGCAGTAAGTCGAGATTGTGCCACTGCACTCCAGCCTGGGGGACAGAGTGCAGAGTGAGACTTTGTCTCAAAATAA","GGTGGCCTTCGCCTGTAATCCTAGCACTTTGGGAGGCCAAGGCGGGTGGATCCCCTGAGGTCAGGAGTTTGAGACCAGCCTGGCCAACATGGTGAAACCCTGTCTCTACTAAAAATACAAAAATTAGCCGGGTGTGGTGGCAGGCGCCTGTAATCCCAGCTACTTGAGAGGCTAAGGCAGGAGAATCGTTTGAACCCAGGAGGTGGAGGTTGCAGTGAGCTGAGATCGTGCCATTGCACTCTAGCCTGGGGGACAAGAGTGAGACTTTGTCTCAAAAAAAAAAAAAA"
"chr3","10708551","10708853","KN295172v1","269190","269486","26","10439361","GGCCGGGCGTGGTGGCTCACACCTGTAATCCCAGCACTTTGGGAGGCCGAGGCGGGTGGATCACCTGAGGTCAGGAGTTCTAGACCAGCATGGCCAACATGGTGAAACCCCATCTCAACTAAAAATACAAAAATTAGCCAGGCGTGGTGGCAGGCACCAGTAACCCCAGCTACTCAGGGGGCCGAGGCAGGAGAATCGCTTGAAGCCGGGAGGCGGAGGTTGCAGTGAGCCAAGATCACCACCATCGCACTCCAGCCTGGGGGACAAGAGCGAGACTTCGTCTACAAAAAAAAAAAAAAGAAA","GCCGGGCACGGTGGCTCACGCCTGTAATCCAGCACTTTGGGAGGCCGAGGCGGTGGATCACCTGAGGTCAGGAGTTCTAGACCAGCCTGGCCAACATGGTAAAACCCCATCTCTACTAAAAATACAAAAATTAGCTGGGCGTGATGGCAGGCACCTGTAATCCCAGCTACTTGGGGGGCCAAGGCAGGAGAATCGCTTGAACCCTGGAGGCGGAGGTTGCAGTGAGCTGAGATCACACCATCGCACTCCAGCCTGGGGGAGAAGAGCGAGACTTCATCTAAAAAAAAAAAAAAAAAA"
"chr3","11317285","11317298","KN294326v1","685529","685541","4","10631756","GAAAGAAAAAGAAA","AATTAAAAATAAA"
"chr3","11317331","11317615","KN295941v1","1108709","1108994","33","10208622","GCCGGACACGGTGGCCCATGCCTGTAATTCCAGCACTTTGGGAGGCCGAGGTGGGAGGATCACCTGAGGTCAGGAGTTCGAGACCAGCCTAGCCAACATGGTGAAACTCCGTCTCTACTAAAAATATAAAAATTAGCCAGGTGTGGTGGCAGGCGCCTGTAATCCCAGCTACTTGGGAGGCTGAGGCAGGAGAACTGCTTGAACCTGGGAGGTGGAGGTTGCAGTGAGCCGAGATTGTGCCATTGTACTCCAGCCTGGGGAACAAGAGCGAGACTTCGTCTCAAA","GCCGGGTGCTTTGGCTCACGCCTGTAATCCCAGCACTTTGGGATGCCGAGGCGGGTGGATCACCTGAGGTCAGGAGTTTGAGACCAGCCTGGCCAACATGGTGAAACCCTGTCTCTACCAAAAATACAAAAATTAGCCGGGCGGGGTGGCAGGCGCCCGTAATCCCAGCTACTCGGAAGGCTGAGGCAGGATAATCGCTTGAACCTGGGAGGCGGAGGTTGCAGTGAGCCGAGATCGCACCATTGCACTCCAGCCTGGGGGACAAGAGCGAGACTTCGTCTCAAAA"
"chr3","24142671","24142746","KN295995v1","1901602","1901672","21","22241069","GGAGAATCACTTGAACCCAGGAGGTGGAGGCTGCATTGAGGTGAGATCGCATCACTATACTCCGGCCTGGGAGACA","AGAATCACTTGAACCTGGGAGGCAGAGGTGGCAGTGAGCCGAGATTGGCCAGTGCACTCCAGCCTGGGAGA"
"chr3","25616373","25616669","KN294685v1","1269570","1269869","27","24346803","GGCTGGGCACGGTGGCTCACGCCTGTAATCCCAGCACTTTGGGAGGCCGAGGCGAGCGGATCATCTGAGGTCAGGAGTTCGCGACCAGTCTGGCCAACATGGTGAAACCCCGTCTCTACTTAAAAAAAACAAGACTTAGCCAGGCGTGGTGGCAGGCACCTGTAATCCCAGCTACTCGGGAGGCTGAGGCAGGAGAATTGCTTGAACCTGGAAGGCGGAGGTTGCAGTGAGCTGAGATCACACCATTGCACTCCAGCCTGGGGGACAAGAGTGAGACTTTGTCTCAAAAAAAAAAAA","GGCTGGGTGTGGTGGCTTAGGCCTGTAATCCCAGCACTTTGGGAGGCCAAGGCGGGCGGATCACCTGAGGTCAGGAGTTCGAGACCAGCCTGGCCAACATGGTGAAACCCCGTCTCTACTAAAAATACAAAAACTAGCCAGGCGTGGTGGCAGGTGACTGTAATCCCAGCTACTCGGGAGGCTGAGGCAGGAGAACTGCTTGAACCTGGGAGGCGGAGGTTGCAGTGAGCTGAGATCACACCATTGCACTCCAGCCTGGGGGACAAGAGCGAGACTTTGTCTCAAAAATAAAAAAAAAAA"
"chr3","26416144","26416455","KN294665v1","171883","172197","40","26244261","GGCCGGGCGTAGTAACTCACGCCTGTAATCCCAGCACTTTGGGAGGCCAAGGCGGGTGGATCACCTGATGTCTGGAGTTTGAGACCACCCTGACCAACATGGGGAAACCCCATCTCTACTAAAAATACAAAAATTATCCGGGCGTGGTGGCAGGCACCTGTAATCCCAGCTACTCGGGAGGCTGATGTAGGAGAATCGCTTGGACCCGGGAGGTGGAGGTTGCAGTGAGCCACTATCGCGCCATTGCACTCCAGCCTGAGGGACAAGAGCGAGACTTTGTCTCAAAAAGCAAAAAAAAAAAAAAAAAAAAAA","GCCGGGCATGGTGGCTCATGCGTGTAATCCCACCACTTTGGGAGTCCGAGGCAGGTGGATCACCTGAGGTCAGGAGTTCGAGACCAGCCTGGCCAACATGGTGAAACCCCCGTCTCTACTAAAAATACAAAAATTAGCTGGGCATGGTGGCAGGCGCCTGTAATCCCAGCTACTCGGGAGGCTGAGGCAAGAGAATCGCTTGAACCCGGGAGATGGAGGTTGCAGTGAGCCGAGATCGCACCATTGCACTCCAGCCTGGGGGACAAAAGAGAGACTTTGTCTCAAAAAAAAAAAAAAAAAAAAAAAAAAGAAAAA"
"chr3","28165239","28165299","KN295136v1","33402","33464","15","28131837","CATTGCACTCCAGCCTGGGGGACATAGTGAGACTGTTTCTGAAAAACAAACAAAAAAAGAA","ATTGCATTCCAGCCTGGGGGGGCAGAATGAGACTCCATCTCAGCAAACAATCAAAACAAGAAA"
"chr3","28780419","28780724","KN296036v1","1090158","1090461","39","27690261","CCGGGCATGGTGGCTCATGCCTGTAATCCCAGCACTTTGGGAGGCCGAGGCGGGTGGATCACCTGAGGTCAGGAGTTCTAGACCAGCCTAGCCAACATGGTGAAACCCCGTCTCAACTAAAAAAAATGCAAAAATTAGCCAGGCATGGTTAGCAGGCGCCTGTAATCCCAGCTGCTTCGGGGGACCCCGGCAGGAGAATCGCTTGCACCCCGGAGGCGGAGGTTGCAGTGGGCCAAGATCGCGCCATTGCAGTCCAACCTGCAGAACAAGAGCGAGACTTCATCTCCAAAAAAAAAAGAAAGAAAA","GGCCGGGCACGGTGGCTCACACCTGTAATCCCAGCACTTTGGGAGGCTGAGGCGGATGGATCACCTGAGGTCAAGAGTTCTAGACCAGCCTGGCCAACATGGTGAAACCCTGTCTCTACTAAAAATACAAAAATTAGCCAGGCATGGTGGCAGGCGCATGTAATCCCAGCTGCTCGGTGGGGCCGAGGCAGGAGAGTCGCTTGAACCCAGGAGACGGAGGTTGCAGTGAGCCGAGATAGTGCCATTGCACTCCAACGTGGGGGACAAGAGCGAGACTTCATCTCAAAAAAAAAAAAAAAAAAAA"
"chr3","32261880","32262165","KN294613v1","30452","30742","45","32231428","GGCCGGGCACGGTAGCTCATGCCTGTAATCCCAGCACTTTGGGAGGCCGAGGCAGGTGGTCAGGAGTTCTAGACCAGCCTGGGCAACATGGTAAAACCCTGTCTCTACTAAAAATACAAAAATTCGCCTGGCATGGTGGCAGGTGCGTGTAATCCCAGCTACTGGGGGGGTTGAGGCAGGACTTGAACCTGGGAGGTGGAGGTTGCAGTGAGCCAAGATCATGCCATCGCACTCCAGCCTGAGGGACAAGAGTGAGACTTTGTCTCAAAAAAACAACAACAAAAAA","GGCCAGGTGCGGCAGCTCACGCCTGTAATCCCAGCACTTTAGGAGGCCGAGGCAGGCGAGGTCAGAAGTTCGAGACCAGCCTGGCCAACTTGGTGAAACCCTGTCTTTACTAAAGATACAAAAATTAGCTGGGCGTGGTGGCAGGCACCTGTAATCTCAGCTACTCGGGAGGTTGAGGCAAGAGAATTGCTTGAACCTGAGGCAAAGGTTGCAGTGGGCCAAGATCATGCCATTGCACTCCAGCCTGGGGGACAAGAGTGAGACTTAATCTCAAAAAAAAAAAAAAAAAAA"
"chr3","32824508","32824780","KN296528v1","90077","90363","43","32734431","ACACCTGTAATCCCAGCACTTTGGGAGGCTGAGGCGGGTGGATCACCTGAGGTCAGGAGTTCAAGACCAGCCTGGCCAACATGGTGAAACCCCATCTCTACTAAAAATACAAAATTAGCCAGGTGTGGTGGCAGGCACCTGTAATCCCAGCTACTCTGGAGACCAAGGCAGGAGAATCGCTTGAACCCGGGAAGCAGAAGTTGCAGTGAGCTGAGATTGCGCCATTGCACTCCAGCCTGAGGGACAAGAGCGAGACTTCATCTCAAAAAAAAA","GGTGGCCTTCGCCTGTAATCCTAGCACTTTGGGAGGCCAAGGCGGGTGGATCCCCTGAGGTCAGGAGTTTGAGACCAGCCTGGCCAACATGGTGAAACCCTGTCTCTACTAAAAATACAAAAATTAGCCGGGTGTGGTGGCAGGCGCCTGTAATCCCAGCTACTTGAGAGGCTAAGGCAGGAGAATCGTTTGAACCCAGGAGGTGGAGGTTGCAGTGAGCTGAGATCGTGCCATTGCACTCTAGCCTGGGGGACAAGAGTGAGACTTTGTCTCAAAAAAAAAAAAAA"
"chr3","33762350","33762648","KN295633v1","731005","731302","34","33031345","GGCTGGGTGCAGTGGCTCACGCCTGTAATCCCAGCACTTTGGGAGGCCGAGGTGGGCGGATCACCTGAGGTCAGGAGTTCGAGACCAGCCTGCGCAACATGGTGAAACCCCATCTTTACTAAAAATACAAAAATTAGCCGGGTGTGGTGGCCGGCGCCTGTAATCCCAGCTACTCAGGAGGCTGAGGCAGGAGAATCAGTTGAACTCGGGAGGCAGAGGTTGCAGTGAGCCGAGATCACGCCATCACATTCCAGCCTGGGGGAGAAGAGTGAGATTTCGTCTCCAAAAAAAAGAAAAAA","GGCTGGGTGTGGTGGCTCACACCTGTAATCCCAGCACTTTGGGAGGCCAAGGTGGGCGGATCACCTGAGGTTAGGAGTTCGAGACCAGCCTGGTCAACAGGGTGAAACCCCATCTCTACTAAAAATACAAAAATTAGCCAGGTGTGGTGGCAGGCACCTGTAATCGCAGGTACTTGGGAGGCTGAGGCAGGAGGATCACTTGAACTCCAGAAGTGGAGGTTGCAGTGAGCCGAGATTGCGCCATTGCACTCCAGCCTGGGGGACAAGAGCGAGACTTCGTTGCAAAAAAAAAAAAAAA"
"chr3","38855157","38855440","KN294172v1","4372726","4373008","44","34482431","GGCCGGGCGTGGTGGCTCACGCCTGTAATCCCAGCACTTTGGGAGACCTAGGCGGGAGTTTGAGACCAGCCTGGCCAACATGGCGAAACCCTGTCTGTACTTAAAATACAAAAATTAGCCAGGTGTGGTGGCAGGCACCTGTAATCCCAGCTACTCGGGAGGCTGAGGCAGGAGAATTGCTTGAACCTGGGAGGCGGAGGTTGCAGTGAGCCGAGATTGTGCCATTGCACTCCAGCCTGGGGCACAAGAGTGAGACTTCGTCTGAAAACAAACAAACAAACAAA","GGCCGGGCGCAGTGGCTTACACCTATAATCCCAGCACTTTGGGAGGCTGAGGTCAGGAGTTCCAGACCAGCCTGGCCAACATGGTGAAACCCCATCTCTACTAAAGATACAAAAATTTGCCGGTGGTTTCAGGTGCCTGTAATCCCAGCTACTCGGGAGGCTGAGGCAGGAGAATCGCTTGAACCCGGGAGGCAGAGGTTACAGTGAGCCGAGATCGCACCATCGCACTCCAGTCTGGGGGACAAGAGCGAGACTTCGTCTCAAAAAAAAAAAAAAATAATAA"
"chr3","39472360","39472670","KN296387v1","301235","301539","33","39171125","GGCCGGGAGCGGTGGCTCACACCTGTAATCCCAGCACTTTGGGAGGCTGAGGCGGGTGGATCACCTGAGGTCAGGAGTTCAAGACCAGTCTGGCCAACATGGTGAAACCTCATGTCTACTAAAAACACAAAAATTAGCGGGGCATGGTGGCAGGTGCCTGTAATCCCAGCTACTTGGGAGGCTGAGGCAAGAGAATCACTTGAACCTGGGAGGCGGAGGTTGCAGTGAGCCAAGATCGCACCATTGCACTCCAGCCTGGGGGACAAGGGTGAGACTGTCTCAAAAAAAAAAGAAAAAAAAGAAAAAAAAAA","GGCTGGGCGCGGTGGCTCACACCTGTAATCCCAGCACTTTGGGAGGCCGAGGTGGGTGAATCACCTGAGGTCAGGAGTTCGAGACCAGCCTGGCCAACATGGTGAAACCCCATATCTACTAAAAATACAAAAATTAGCCAGGTGTGGTGGCAGGCGCCTATAATCCCAGCTGCTTGGGAGCCTGAGGCAGGAGAATCGCTTGAACCTGGGAGGCGGAGGTTGCAGTGAGCCAAGATCGTGCCATTGCACTCCAGCCTAGGGGACAAGAGTGAGACTAATCTCAAAAAAAAAAAAAAAAAAAAAAA"
"chr3","40320179","40320475","KN297112v1","4703110","4703407","33","35617069","GGCCGGGTGCGGTGGCTTATGCCTGTAATCCCAGCACTTTGGGAGGCTGAGGCAGGCGGATCACTTGAGGTCAGGAGTTCGAGACCAGCCTGACCAACATGGTAAAACCCCGTCTCTACTAAAAAATACAAAAATGAGCCCGGTGTGGTGGCAGGCGCCTTAATCCTAGCTACTTGGGAGGCAGAGGCAGGAGAATCATTTGAACCTGGGAGGCAGAGGTTGCAATGAGCAGAGATCGAGCCATTGCACTCAAGCCTGGGGGACAAGAGCAAGACTTCTCTCAAAAAAAAAAAAAAA","GGCTGGGTGCGGTGGCTCATGCCTGTAATCCCAGCACTTTGGGAAGCCAAGGCAGGCGGATCACCTGAGGTCAGGAGTTCGAGACCAGCCTGGCCAACATGAAAACCCTGTCTCTACTAAAAATACAAAAATTAGCCGGGTGTGGTGGCAGGCGCCTGTAGTGCCAGCTACAAGGGAGGCTGAGGCAGGAGAATCACTTGAACCCGGGAGGCAGAGGTTGCAGTGAGCCGAGATAGTGCCATTGCACTCCAGCCTGGGGGACAAGAGTGAGACTTTGTCTCAAAAAAAAAAAAAAAAA"
"chr3","40646384","40646435","KN296682v1","4770996","4771052","20","35875388","CAGTGAGCCAAGGTTGCATCATCGCACTCCAGCTTGGGCGACGAAGACAAGA","AAGCTGCAGTGAGTTATGATCACATCACCACATTCAGCTTGGGAGACAAGAGTGAGA"
"chr3","43589919","43590221","KN296117v1","150360","150664","30","43439559","GGCCGGGTGCGGTGGCTCAAGCCTGTAATCCCAGCAATTTGGGAGGCCGAGGCAGGTGGATCACCTGAGGTCAGGAGTTCAAGACTAGCCTCGCCAACATGGTGAAACCTCGTCTCTACTAAAAATACAAAAATTAGCCGGGCGTGGTGGCAGGCGCCTGTAATCCCAGCTACTCAGGAGGCTGAGGCAAGAGAATCACTTGAACCCGGGAGGCGGAGCTTGCAATGAGCCAAGATTGCGCCATTGCACTCCAGCCTGGGGGACAAGAGCCAGACTTTGTCTCAAAAAAAAAAAAAAAAAAAA","GGCCGGGCGCGGTGGCTCACACCTGTAATCCCAGCACTTTGGGAGGCCGAGGCTGGTGAATCACCTGAGGTCAGGAGTTCTAGACCAGCCTGGCCAACACGGTAAAACCTCGTCTCTACTAAAAATAAAAAAATTAGCCAGGCATGGTGGCAGGCGCCTGTAATCCCAGCTACTTGAGAGGCTGAGGCAGGAGAATCACTTGAACCCAGGAGGCAGAGGTTGCAGTGAGCCATGATCGCGCCACTGCACTCCAGCCTGGGGGACAAGAGCAAGATGTTGTCTCAAAAAAAAAAAAAAAAAAAAAA"
"chr3","46713841","46714072","KN297259v1","2642198","2642414","33","44071643","TGAGGTTAGGAGTTCAGTCAAGACCAGCCTGGCCAACATGGTGAAACCCTATCTCTACTAAAAATACAAAAATTAGCCAGGCATGGTGGCAGGTGCCTGTAATCCCAGCTACTCAGGAGGCTGAGGCAGGAGAATCGCTTGAACCTGGGAGGCGGAGGTTGCAGTGAGCAGAGATTGCGCCATTGCACTCCAGCCTGGGGCACAAGAGCGAGACTTCGTCTCAAAAAAAAAA","GAGGTTAGGCGTTCAAGACCAGCCTGGCCAACATGGTGAAACCCCATCTCCACTGAAAATATAAAAATTAGCCAGGCATGGTGGCAGGCGCCTGTAATCCCTGCTACTCAGGAGGCTGAGGCAGGAGAACAGCTTGAACCTAGGAGGTGGAGGTTGCAGTGAGCGGAGATCGTGCCATTGCACTCCAGCCTGGGGGACAAGAGCAAGACTTCATCCC"
"chr3","46764256","46764554","KN294685v1","1269570","1269869","28","45494686","GGCTGGGTGCGGTGGTTCACGCCTGTAATCCCAGCACTTTGGGAGGCTGAGGCGGGTAGATCACCTGATGTCAGGAGTTCGAGACCAGCCTGGCCAAGATGGTGAAACCCCGTCTCTACTAAAAATAGAAAAATTAGCTGGGCATGGTGGCAGGCGCCTGTAATCCCAGCTACTTGGGAGGCTGAGGCAGGAGAATCGCTTGAACCTGGGAGGCGGAGGTTGCAGTGAGCAGAGGTCATGCCATCGCACTCCAGCCTGGGGGACAAGAGCGAGACTTTGTCTCAAAAAAATCAAAAAAA","GGCTGGGTGTGGTGGCTTAGGCCTGTAATCCCAGCACTTTGGGAGGCCAAGGCGGGCGGATCACCTGAGGTCAGGAGTTCGAGACCAGCCTGGCCAACATGGTGAAACCCCGTCTCTACTAAAAATACAAAAACTAGCCAGGCGTGGTGGCAGGTGACTGTAATCCCAGCTACTCGGGAGGCTGAGGCAGGAGAACTGCTTGAACCTGGGAGGCGGAGGTTGCAGTGAGCTGAGATCACACCATTGCACTCCAGCCTGGGGGACAAGAGCGAGACTTTGTCTCAAAAATAAAAAAAAAAA"
"chr3","47931689","47932065","KN295596v1","2025229","2025530","195","45906460","GGCTGGGCATGGTGGCTCACACCTGTAATTCCAACACTTTGGGAGGCCGAGGCGGGTGGATCACCTGAGGNNNNNNNNNNNNNNNNNNNNNNNNNNNNNNNNNNNNNNNNNNNNNNNNNNNNNNNNNNNNNNNNNNNNNNNNNNNNNNNNNNNNNNNNNNNNNNNNNNNNNNNNNNNNNNNNNNNNNNNNNNNNNNNNNNNNNNNNNNNNNNNNNNNNNNNNNNNNNNNNNNNNNNNNNNCAGCTACTCAGGAGGCTGAGGCAGGAGAATCACTTGAACCTGGGAGGCAGAGGTTGCAGTGAGCCGAGATGGTGCCACTGCACTCCAGCCTGGGCGAGAACAGCAAGACTCCATCTCAAAAAAAAAAAAGAGAGAGA","GGCTGGGCACAGTGGTTCACACCTGTAATCTCAGCACTTTGGGAGGCTGAGGCGGGCGGATCACCTGAGGTCAGGAGTTCGAGACCAGCGTGGCCAACATGGTGAAACTCTGTCTCCACTAAAAATACAAAAATTAGCCTGGCATGGTGGCAGGAGCCTGTAATCCCAGCTACTCAGGAGGCTGAGGCAGGAGAATGGCTTGAATCCGGGAGGCGAAGGTTGCAGTGAGCCAAGATTGTGCCACTGCACTCCAGCCTGGAGGACAAGAGCAAGACTTCATCTCAAAAAAAAAAAAAAAAAAA"
"chr3","48945501","48945810","KN297259v1","368593","368901","25","48576908","GGCCGGGTGCAGTGGTTCATGCCTGTAATCCCAGCACTTTGGGAGACTGAGGCGGGCGGATCACCTGAGGTCAGGAGTTCGAGACCATCCTGGCCAACATGGTGAAACCTCGTCTCTACTAAAAATACAAAAATTAACTGGGCATGGTGGCAGGCGCCTGTAATCCCAGCTACTCAGGAGGCTGAGGCACGAGAATCGCTTGAACCCGGGAGGCAGAGGTTGCAGTGAGCTGAGATTGTGCCATCGCGCTCCAGCCTGGGGGACAAGAGTGAGACTTCGTCTCAAAAAAAAAAAAAAAAAAGAAGAAAAA","GACCGGGTGCAGTGGTTCACGCCTGTAATCCCAGCACTTTGGGAGACAGAGGTGGGCGAATCACTTGTGGTAAGGAGTTCGAGACCATCCTGGCCAACATGGTGAAACCTCGTCTCTACTAAAAATACAAAAATTAGCCAAGCATGTTGGCAGGCGCCTGTAATCCCAGCTACTCAGGAGGCTGAGGCAGGAGAATCTCTTGAACCCAGGAGGCAGAAGTTGCAGTGAGCTGAGATCGTGCCATCGCACTCCAGCCTGGGAGACAAGAGCGAGACTTCGTCTCAAAAAAAAAAAGAAGAAAAAGGAAAA"
"chr3","49389547","49389678","KN296990v1","49332","49458","29","49340215","CTGAGGCAGGAGAATCACTTGAACCCAGGAGGTGGAGGTTGCAGTGAGCCAAGATCATGCCATCGCACTCCAGCCTGGAGGACAAGAGCGAGACTTCGTCTAAAAAAAAAAGAAGAAGAAGAAGAAGAAGAA","GCTAAAGGAGGAGAATCACTTGAACCCCAGAGGCAGAGGTTGTAGTGAGCCAAGGTCATGCCATTGCATCCAGCCTCTGGGACTACAGCAAAACTCTGTCAAAAAAAAAAAAAAAAAAAAAAAAAAA"
"chr3","49914900","49915034","KN296311v1","6037951","6038072","25","43876949","GGTGGCTCACACCCATAATCCCAGCACTTTGGGAGGCTGAGGTGGGTGGATCACCTGAGGTCGGGAGTTCCAGACCAGCCTGGCCAACATGGTCGAAAAACCCATCTCTACTAAAAATAACAAAAATTAGCCGGG","GGTAGCTCATGCCTGTAATCCCAGCATTTGGGAGGCCGAGGCGGGTGGATCACCTGAGATCAGGAGTTCCAGACCAGCCTGGCCAACATGGTGAAACCCCGTCTTTACTAAAAATACAAAAA"
"chr3","50065374","50065510","KN294269v1","66171","66308","16","49999203","GGCTGGGTATGGTGGCTCACGCCTATAATCCCAGCACTTTGGGAGGCCGAGGCCAGTGGATCACCTGAGGTCAGGAGTTTTGGACCAGCCTGGCCAACATGGTGAAACCCCGTCTCTACTAAAAATACAAAAATTAG","GGCCAGGTGCAGTGGCTCACGCCTGTAATCCCAGCACTTTTGGAGGCCGAGGCAGGTGGATCACCTGAGATCAGGAGTTCCAGACTAGCCTGGCCAACATGGTGAAACCCCATCTCTACTAAAAATACAAAAATTAGC"
"chr3","50153077","50153187","KN296635v1","1811423","1811536","17","48341654","GCTGGGCACAGTGGCTCATGCCTGTAATCTCAGCACTTTGGGAGGACAAGGTAGGTGGATCACCTGAGGTCAGAAGTTCCATACCAGCCTGGCCAACATGGTGAAACCCCG","GCCAGGCACAGTGGCTCATGCCTGTAATCCCAGCACTTGGGGAGGCCAAGGCAGGCGGATCACCTCAGGTCAGGAGTTCTAGACCAGCCTGGATAACATCGTGAAACCCCGTCT"
"chr3","50275993","50276041","KN296849v1","913787","913837","12","49362206","GCACTCCAGCCTGGGGGACAAAGCGAGACTTCATCTACAAAAAAATAAA","ATTGCACTGCAGCCTGGGGGTAAGAGCAAGACTCCATCTCAAAAAATAAAA"
"chr3","50632844","50633148","KN294536v1","1833554","1833849","40","48799290","GGCCAGTGGCGGTGGCTCACGCCTATAATCCCAGCACTTTGGGAGGCCGAGGCGGATGGATTACCTGAGGTCAGGAGTTTGAGACCAGCCTGGCTGGCCAACATGGTGAAACCCCGTCTCAACTAAAAATACAAAAATTAGCTGGGCGTGACACGGCAGGCGCCTGTAATCCCAGCTACTCTGGGGGCGGAGGCAGGAGAATCGCTTGAACTCGGGAGGCGAAGGTTGCAGTGAGCCGAGATTGCGCCATCGCACTCCAGCCTGGGGAACAAGAGCGAGACTTTGTCACAAAAAAAAAAAAAGAA","GGCCGGGCGTGGTGGCTCATGCCTGTAATCCCAGCACTTTGGGAGGCCGAGGCAGGTGGATCACCCGAGGTCAGGAGTTCGAGACCAGCCTGGCCAATATGGTGAAACCCCGTCTCAGCTAAAAATACAAAAATTAGCCGGGCATGGTGGCAGGCACCTGTAATCCCAGCTGCTTGGGGGGGTAGAGGCAGGAGAATCGCTTGAACCCGGGAGGCGGAAGTTGCAGTGAGCTGAGATTGCGCCATCGCACTCCAGCCTGGGGGACAAGAGCGAGACTTTGTCTCAAAAACAAAAAA"
"chr3","52762382","52762686","KN294526v1","558418","558721","36","52203964","CCGGGTGCAGTGGCTCACGCTTATAATCCCAACACTTTGGGAGGCCGAGGCGGGCGGATCAGTTGAGGTCAGGAGTTCGAGACCAGCCTGGCCAACATGGTGAAACCCCATTTCTACTAAAAATACAAAAATTAGCCGGGTGTGGTGGCAGGCGCCTATAATCCCAGCTACTTGGGAGGCTGAGACAGGAGAATTGCTTGAACCCAGGAGGCGGAGGTTACAGTGAGCCGAGATCGCGCTATTGCACTCCAGCCTGGGGGACAAGAGCAAGACTTCATTTAAAAAAAAAAACAATGAAGAAAAAA","GGCCAGGCGCAGTGGCTCATGCCTGTAATCCTAGCACTTTGGGAGGCCGAGGTGGGTTGATCACTTGAGGTCAGGAGTTCGAGCCCAGCCTGGCCAATATGGTGAAACCCCGTCTCTACTAAAAATACAAAAATTAGCCGGACGTGATGGCAGGCACCTGTAATCCCAGCTACTCAGGAGGCTGAGGCAGGAGAATTGCTTGAACCCGGGAGGCGGAGGTTACAGTGAGCTGAGATCGCGCCATTGCACTCCAGCCTTGGGTACAAGAGCAAGACTTCATCTCAAAAAAAAAAAAAAAAAAAAA"
"chr3","58010119","58010261","KN294991v1","346166","346307","6","57663953","GCTGGGCATGATGGTTCACACACCTGTAATCCCAGGATTTTGGGAGGCTGAGGTGGGTGGATTGCCTGAGCTCAGGAGTTCCAGACCAGCCTGGGTAACATGGCGAAACCCTGTCTCTATTAAAAATAACAAAAATTAGCCAG","GCTGGGCACGATGGTTCACACACCTGTAATCCCAGCATTTTGGGAGGCTGAGGTGGGTGGATTGCCTGAGCTCAGGAGTTCCAGACCAGCCTGGGTAACATGGCAAAACACTGTCTCTATTAAAAATGCAAAAATTAGCCAG"
"chr3","58995816","58996120","KN296387v1","301235","301539","33","58694581","GGCCAGGCGCGGTGGCTCACGCCTGTAATCCCAGCCCTTTGGGAAGGCCAAGGTGGGCAGATCACCTGAGGTCAGGAGTTCGAGACCAACCTGGCCAACACAGTGAAACCCCATCTCTACTAAAAATACAAAAATTAGCCAGGTGTGGTGGCAGGCGCCTGTAATCCCAGCTACTGGGGAGGCTGAGGCAGGAGAATCACTTGAACCCAGGAGGTGGAGGTTGCAGTGAGCCAAGATCGCGCCATCACACTCCAACTTGGGGGACAAGAGCGAGACTTCATCTCAACAAAAAAAAAAAAAAAAAA","GGCTGGGCGCGGTGGCTCACACCTGTAATCCCAGCACTTTGGGAGGCCGAGGTGGGTGAATCACCTGAGGTCAGGAGTTCGAGACCAGCCTGGCCAACATGGTGAAACCCCATATCTACTAAAAATACAAAAATTAGCCAGGTGTGGTGGCAGGCGCCTATAATCCCAGCTGCTTGGGAGCCTGAGGCAGGAGAATCGCTTGAACCTGGGAGGCGGAGGTTGCAGTGAGCCAAGATCGTGCCATTGCACTCCAGCCTAGGGGACAAGAGTGAGACTAATCTCAAAAAAAAAAAAAAAAAAAAAAA"
"chr3","61516423","61516734","KN297386v1","1388754","1389062","32","60127669","GGCTGGGCGCGGTGGCTCACACCTGTAATCCCAGCACCTTAGGAGGCCGAGGAGGGTGGATCACCTGAGGTCAGGAGTTCTAGACCAGCCTGGCCAACATGGAGAAACGCTGTAACAACTAAAAATACAAACATTAGCCAGGCATAGCAGCAGGGAGCTGTAATCCCAGCTACTCAGGGGGCTGAGGCAGGAGAATCACTTGAACCCAGAAGGCAGAAGTTACAGTTAGCCAAGATCGCACCATTCCACTCCAGCCTGGGGGACAAGAATGAGACTTTGTCTCAAAAAAACAAAAACAAACAAACAAAAAAA","GGCTGGGCGTGGTGGCTCACACCTGTAATCCCAGCACTTTAGGAGGCTGAGGTGGGTGGATCACCTGAGGTTAGGAGTTCTAGACCAGCCTGGCCAACATGGTGAAACCCTGTCTCAACTAAAAATACAAAAGTTAGCTGGGCATAGTGGCAGGGAGCTGTAATCCCAGCTACCCAGTGGGCTGAGGCAGAAGAATCGCTTGAACCCAGGAGGTGAAGTTGCAGTGAGCCGAGATCACGCCATTGCACTCCAGCCTAGGGGACAAGATTGAGACTTTGTCTCAAAAAACAAAAACAAACAAACAAAAAA"
"chr3","63018686","63018979","KN295573v1","1644468","1644772","33","61374218","GGCCGGGCACAGTGGCTCACCCCTGTAATCCCAACACTTTGGGAGGCTGAGGCGGGTGGATCACCTGAGGTCAGGAGTTCGAGACCAGCCTGGCCAACATGGTGAAACCCCATCTCTACTAAAAATACAAAAATTAGCTGGGCGTGGTAGCGCCTGTAATTCCAGCTACTCAGGAGGCTGAGGCAGGAGAATCGCTTGAACCCCGGAGGCGGAGGTGGCAGTGAGCCAAGATTGTGCCATTGCATTTCAGCCTGGGGGACAAGAGCGAGACTTCATCTCGAAAAAAAAAAAAAA","GGCCGGGCACAGTGGCTCACACCTGTAATCCCAGCACTTTGGGAGTCTGAGGCAGGCGGATCACCTGAGGTCAGGAGTTCGAGACCAGCCTGGCCAACATGGAGAAACCCCCGTCTCTACTAAAAATACAAAAATTAGCTGGGCATGATGGCAGGAGCCTGTAATCCCAGATACTCAGGAGGCTGAGGCAGGAGAATGGCTTGAACCCGGGAGGCAGAGGTTGCAGTGAGCCAAGGTCGCGCCATTGCACTCCAGCCTGGGGGACAAGAGCGAGACTTCGTCTCAAAAAAAAAAAAAAAAAAAAA"
"chr3","66514106","66514407","KN294685v1","1269570","1269869","32","65244536","GGCTGGGCGTGGTGGCTCATGCCTGTTATCCCAGGACTTTGGGAGGCTGAGGCGGGTGGATCACCTGAGGTCAGGAGTTTGAGACCAGCCTGGCCAACATGGTGAAACCCCGTCTCTACTAAAAATACAAAAATTAGCCATGCGTGGTGGCAGGCGCTTATAATCCCAGCTACTTAGGACGCTGAGGCAGCAGAATCGCTTGAACCCGGGAGGCGGAGGTTGCAGTGAGCCGAGATGGCACCTTTGCACTCCAGCCTGGGGGATAAGAGAGAGACTTCGTCTACAAAAAAAAAAAAAAAAAA","GGCTGGGTGTGGTGGCTTAGGCCTGTAATCCCAGCACTTTGGGAGGCCAAGGCGGGCGGATCACCTGAGGTCAGGAGTTCGAGACCAGCCTGGCCAACATGGTGAAACCCCGTCTCTACTAAAAATACAAAAACTAGCCAGGCGTGGTGGCAGGTGACTGTAATCCCAGCTACTCGGGAGGCTGAGGCAGGAGAACTGCTTGAACCTGGGAGGCGGAGGTTGCAGTGAGCTGAGATCACACCATTGCACTCCAGCCTGGGGGACAAGAGCGAGACTTTGTCTCAAAAATAAAAAAAAAAA"
"chr3","70528936","70529245","KN295205v1","907038","907347","41","69621898","CCGGGTGCAGTGGCTTAGCCTATAATCCCAGCGCTTTGGGAGGCCAAAGCAGGGGGATCACCTGAGGTCAGGAGTTCAAGACCAGCCTGACCAACATGTGAAACCCCGTCTCTACTAAAAATACAAAAATTAGCTGGCTGTGGTGGCAGACACCTGTAATCCCAGCTACTCAGGAGGCTGAGGCAGGAGAATCACTTGAACCCAGGAGGCGGAAGATGCAGTGAGCAGAGATCGCGCCATTGCACTCCAGCCTGGGGGACAAGAGTGAGACTTTGTCTACAAAAAAAAGAAAAGAAAAAGAAAGAAAGAA","CCGGGTGCAGTGGCTCACACCTGTAATCCCAGCACTTGGGGAGGCCGAGGTAGGTGGATCACTTGAGGTCAGGAGTTCAAAACCAGGCTGGCCAACATGGTGAAACCCTGTCTCTACTAAAAGTACAAAAATTAGCTGGGCATGGTGGCAGGCACCTGTAATCCCAGCTACTCAGGAGGCTGAGGTAGGAGAATCACTTGAACCCAGGAGACGGAGGTTGCAGTGAGCCAAGATTGCACCACTGCACTCTAGCCTGGGGGACAAGAGCGAGACTTCATCTCAAAAAAAAAAAAAAAGAGAAAAAGAAAAA"
"chr3","75370645","75370944","KN294685v1","1269570","1269869","30","74101075","GGCCGGGCACGGTGGCTCATGCCTGTAATCCCAGCACTTTGGGAGGCCAAGGCGGGCGGATCACCTGAGGTCAGGAGTTGAGACCAGCCTGGCCAACATGGTGAAACCCCATCTCTACTAAAAATACAAAAATTATCCAGGCATGTGGTGGCAGGTGCCTGTAATCCCAGCTACTCGGGAGGCTGAGGGAGGAGAATCACTTGAACTCGGGAAGCAGAGGTTGCTGTGAACTGAGATCTCACCATTGCACTCCAGCTTGGGGGACAAGAGCGAGACTTCGTCTCCAAAAAAAAATGAAAA","GGCTGGGTGTGGTGGCTTAGGCCTGTAATCCCAGCACTTTGGGAGGCCAAGGCGGGCGGATCACCTGAGGTCAGGAGTTCGAGACCAGCCTGGCCAACATGGTGAAACCCCGTCTCTACTAAAAATACAAAAACTAGCCAGGCGTGGTGGCAGGTGACTGTAATCCCAGCTACTCGGGAGGCTGAGGCAGGAGAACTGCTTGAACCTGGGAGGCGGAGGTTGCAGTGAGCTGAGATCACACCATTGCACTCCAGCCTGGGGGACAAGAGCGAGACTTTGTCTCAAAAATAAAAAAAAAAA"
"chr3","86304984","86305244","KN295439v1","247193","247443","51","86057791","CGGGTGGATCACCTGAGGTCAGGAGGTCGAGACCAGCCTGGCCAACATGGTGAAACCTCGTCTCTACTAAAAATACCAAAACTAGCCAGGCATGGTGTCAGGTGCCTGTAGTCCCAGCTACTTGGGAGGCTGAGGCAGGAGAACCATTTGAACCTGGGAGGCAGAAGTTGCAGTGAGCTGAGATCACGCCATCGCACTCCAGCCTGAGGGACAAGAGCAAGACTTTGTCTCAAAAAACACAAAATAAAATAAAATAAAAAA","GGATCACCTGAGGTCAGGAGTTCAAGACCAGCCTTGCCAACATGGTGAAACCCCGTCTCTACTAAAAGATACAAAAATTAGCCAGTTGTGGTGGCAGGACTTAATCCCAGCTACTTGGGAGGCAGAGGCAAGAGAATTGTTTGAATCCAGGAGGCGGAGGTTGCAGTGAGCCGAGACTGAGCCATTGCACTCAAACCTGGGGGACAAGAGGGAGACTTCTCTCAAAAAAAAAAAAAAGAAAAGAAAAGAAA"
"chr3","92111885","92111990","KN297323v1","656594","656696","24","91455291","GCTTGAACCTGGGAGGTGGAGGTTGCAGTGAGCCAAGATTGCACCATTGCACTCGAGACAAGAGCCTGGGGGACAAGAGCGAGACTTCGTCTAAAAAAAAAAAAAA","AATCCCTTGAATCCGGGAGGTGGAGGCTGCAGTGAGCCGAGATCACACCACTGCACCCCAGCCTGGGGACTAGAGAGAGACTTCGTCTGAAAAAAAAAAAAAA"
"chr3","102486951","102487131","KN295717v1","1369230","1369404","28","101117721","AAAAATTAGACCGGGCGATGGTGGCAGGTGCCTGTAATCCCAGCTACTCGGGAGGCTNAGGCAGGNGAATTGCTTGAAGCCGGGAGGTGGATGTCGCAGTGAGCCGAGATCGTGCCATTGCACTCCAGCCTGGGGGACAAGAATAAGACTTTGTCTCAAAAAAAAAAAAAAAAAAAAAAAA","CAAAAATTAGCTGAGCGTGGTGGCAGGTGCCTGTAATCCCAGCTACTCAGGAGGCTAAGGCAGGAGAATTGCTTGAACCCAGGAGGCAGAGGTTGCAGTGAGCCAAGATTGTGCCATTGCACTCTAGCCTAGGGGACCAGAGTAAGACTCCGTCTAAAAAAAAAAAAAAAAGAAA"
"chr3","104633018","104633201","KN294990v1","1","184","31","104633017","AATACAAAAATTAGCCAGGCATGGTGGCAGGTGCCTGTAATCTCAGCTACTCAGGAGGCTGAGGCAGGAGAATCGCTTGAACCCAGGAGGCAAAGGTTGCAGTGAGCCGAGATCGCACCCATCACACTCCAGCCTGGGAGACAAGAGCAAACTCCATCTCAAAAAACAAAAACAAAAACAAAAA","ACAAAAATTAGCCAGGCATGGTGACAGGCGCCTGTAATCTCAGCTCCTTGGAAGGCTGAGGTGGGAGAATCGCTTGAACCCAGGAGGCGGAGGTTGCAGTGAGCCGAGATCACACCAGTGCACTCCAGCCTAGGGGACAAGAGTGAAACTCGTCTCAAAAAAAAAAAGAAAAAGAAAAGAAAAA"
"chr3","112100570","112100877","KN294172v1","4419501","4419812","30","107681069","GGCTGGGTGCGGTGGCTTACGCCTGTAATCCCAGCACTTTGGGAGGCCCAGGCAGGTGGATCACCTGAGGTCAGGAGTTCAAGACCAGCCTGGCCAACATGGTGAAACCCTGTCTCTACTAAAAATGCAAAAATTAGCCGGGCATGGTGGCAGGCACCTGTAATCCCAGCTACTCAGGAGGCTGACGCAGGAGAATCGCTTGAACCTGGGAGGCAGAGGTTGCAGTGAGCTGAGATCCTGCTATTGCACTCCAGCCTGGGGGACAAGAGTGAGATTTCATCTCAAAAAAATAAATAAATAAATAAAAA","GGCTGGGCGCAGTGGCTCACGCCTGTAATCCCAGCACTTTGGGAGGCCGAGGCAGGCGGATCACCTGAGGTCAGGAGTTTCAGACCAGCCTGGCCAACATGGTGAAACCCCGTCCCTACTAAAAATACAAAAATTAGCCGGGCGTGGTGGCAGGCACCTGTAATCCCAGCTACTCAGGAGGCTGAGGCAGGAGAATCACTTGAACCCCGGAGGCAGGGGTTGCGGTGAGCCGAGATCGCGCCACTGCACCCCAGCCTGGGGGACAAGAGCAAGACTTCATCTCAAAAATAAATAAATAAATAAAAATAAAAA"
"chr3","113352508","113352580","KN296922v1","568825","568895","21","112783683","GATCTCATCATTGTACTCCAGCCTGGCGGACAAGAATAGAGACCCAACTACTCAAAAANAAAAAAAAAAGAAA","AGATCGTGCCATTGTACTCCAGCCTGGGGAGCAAGAGCGAGACTTTGTCTCAAAATAAATAAATAAATAAA"
"chr3","115089635","115089941","KN294693v1","1352700","1353006","30","113736935","GGCCGGGCGCTGTGGCTCACGCCTGTAATCCCAGCACTTTGGGAGGCCGAGGCGGGTGGATCACCTGAGGTCAGGAGTTCTAGACCAGCCTGGCCAACATGGTAAAACCCTGTCTCTACTAAAAATACAAAAATTAGCCGGGCGTGGTGGCAGGCACCTGTAATCCCAGCTACTCGGGGAGCTGAGGCAGGAGAATCGCTTGAACCTGGGAGGCAGAGGTATCAGTGAGCTGAGATGGCGCTATCGCACTCCAGCCTGGGGCACAAGAGGGAGACTTCATCTCAAAAAAAAAAAAAAAAAAAAAGAA","GGCCAGGTGTGGTGGCTCACGTCTATAATCCCAGCATTTTGGGAGGCCAAGGCGGGTGGATCACCTGAGGTCAGGAGTTCTAGACCAGCCTGGCCAACATGGTAAAACTCCATCTCTACTAAAAAATACAAAAATTAGCCGGGCGTGGTGGCAGGCACCTGTAATCTCAGCTACTCGGAGGGCTGAGACAGGAGAATTGCTTGAACCTGGGAGGCGGAGGTTGCAGTGAGCCAAGATTGCGCCATCCCACTCCAGCCTGGGGGACGAGAGGGAGACTTCCTCTCAAAAAAAGAAAAAAAAAAAAAAA"
"chr3","125952122","125952420","KN296594v1","630492","630791","26","125321630","GGCCAGGCACAGTGGCTCACGCCTGTAATCCCAGCACTTTGGGAGGCTGAGACAGGTGGATCACCTGAGGTCAGGAGTTCGAGACCAGCCTGGCCAACATGGTGAAACCGTGTCTCTACTAAAAGTACAAAAATTAGCCAGGTGTGATGGCAGGTGCCTGTAATCCCAGCTACTCGGGAGGCTGAAGCAGAAGAATTGCTTGAACCCGGGAGGCAGAGGTTGCAATGAGCCGAGATCACGCCATCACACTCTAGCCTGGGGGACAAGAGTGAGACTTCATCTAAGAAAAAAAAAAAGAA","GCTGGGCACGGTGGCTCACGCCTGTAATCCCAGCACTTTGGGAGGCCGAGACAGGTAGATCATCTGAGGTCAGGAGTTCGAGACCAGCCTGGCCAACAGAGTGAAACCCCGTCTCTACTAAAAATACAAAAATTAGCCTGGTGTGATGGCAGGTGCCTGTAATCCCAGCTACTTGGGAGGCTGAGGCAGAAGAATCGCTTGAACCCGGGAGGCGGAGGTTGCAGTGAGCTGAGATCGCGCTATTACACTCTAGCCTGGGGGACAAGAGCGAGACTTCATCTCAAAAAAAAAAAAAAAGAA"
"chr3","126415480","126415768","KN295576v1","406337","406628","28","126009143","GGCTGGGCACGATGGCTCACGCCTGTAATCCCAGCACTTTGGGAGGCCGAGGCGGGTGGATCACCTGAGGTCAGGAGTTCTAGACCAGCCTGGCCAACATGGTGAAGCCCCTTCTCAACTAAAAATACAAAAATTAGCCGGGCTTGGTGGCAGGCGCCTGTAATCCCAGCTACTCAGGGGGCTGAGGCAGGAGAATCGCTTGAACCCAGGAGGCAGAGGTTGCAGTGAGCCGAGATTGTGCCATCACACTCTAGCCTGAGGGACAAGAGCGAGACTTCATCTCAAAAAA","GGCCGGGCGCGGTGGCTCACGCCTGTAATCCCAGCACTTTGGGAGGCCGAGGCGGGCGGATCACCTGAGGTAAGGAGTTCGAGAACAGCCTGGCCAGCATGGTGAAACCCCATCTCTACTAAAAATACAAAAATTAGCCGGGCATGGTGGCAGGTGCCTGTAATCCCAGCTACTCGGGAGGCTGAGGCAGAAGAATCGCTTGAACCCAGGAGGCGGAGGTTGCAGTGAGCCGAGATTGCGCCATTGCACTCCAGCCTAGGGGAGAAGAGCGAGACTTCGTCTCAAAAAAAAA"
"chr3","127589039","127589332","KN294536v1","1833554","1833849","38","125755485","GTCGGGTGTGGTGGTTCATGCCTATAATCCCAGCATTTTGGGAGGCCGAGGCGGGTGGATCACCTGAGGTCAGGAGTTCGAAACCAGCCTGGCGAACATGGCAAAATCCCGTCTCTACTAAACATACAAAAATTAGCCAGGCGTGGGGGCAGGCACCTGTAATCCCAGCTACTTGGAAGGCTGAGGCAGGAGAATTGCTTGAACCTGGGAGGCGGAGGTTGCAGTGAGCCAAGAGTGTGCCATTGCACTCCAGTCTGGGGGACAAGAGCAAGACTTCGTCTCCAAAAAAAAAAA","GGCCGGGCGTGGTGGCTCATGCCTGTAATCCCAGCACTTTGGGAGGCCGAGGCAGGTGGATCACCCGAGGTCAGGAGTTCGAGACCAGCCTGGCCAATATGGTGAAACCCCGTCTCAGCTAAAAATACAAAAATTAGCCGGGCATGGTGGCAGGCACCTGTAATCCCAGCTGCTTGGGGGGGTAGAGGCAGGAGAATCGCTTGAACCCGGGAGGCGGAAGTTGCAGTGAGCTGAGATTGCGCCATCGCACTCCAGCCTGGGGGACAAGAGCGAGACTTTGTCTCAAAAACAAAAAA"
"chr3","131869710","131870000","KN296634v1","1669748","1670034","36","130199962","GGCCAGGTGCGATGGCTCATGCCTGTAATCCCAGCACTTTGGTAGGCCGAGGTGGGTGGATCACCTGAGTTCGAGACCAGCCTGGTCAACGTGATGAAACCCCGTCTCTACTAAAAATACAAAAATTAGCCGGGTGTGGTGGCAGGTGCCTGTAATCCCAGCTACTTGGAAGGCTGATGCAGGAGAATCACTTGAACCTGGGAGGTGAAGGTTGCAGTGAGCCGAGATCACGCCATTGCACTCCAGCCTGGGGGACAAGAGCGAGACTTCATCTACAAAAAAAAAAAGAAA","GGCACGGTGGCTCACGCCTGTAATTCCAGTACTTTGGGAGGCCGAGGTGGGTGGATCGCCTGAGTTCGAGACCAGCCTGGCCAACATGGTGAAACCCCCTCTCTACTAAAAAAACAAAAATTAGCCGGGTATGGTGGCAGGCACCTGTAATCCCAGCTACTTGGGAGACCGAAGCAGGAGAATCACTTGAACCCGGGAGGCAGAGGTTGCAGTGAGCCGAGATCACGCCATTGCACTCCAGCTGGGAGACAAGAGTGAGACTTTGTCTAAAAAAAAAAAAAAAAAAA"
"chr3","132142164","132142461","KN294911v1","4958020","4958317","32","127184144","GGCCAGGCGCAGTGGCTCACACCTGTAATCCCAGCACTTTGGGAGGCCAAGGCAGGTGGGTCACCTGAGGTCAGGAGGTTGAGACCAGCCTGGCCAACACGGTGAAACCCCGTCTGTACTAAAAATACAAAAATTAGCTGGGCGTGGTGGCAGGCACCTGTAATCCCAGCTACTTAGGAGGCTGAGGCAGGACAATCACTTCAACCCGGGAGGCGGAGGTTGCAGTGAGCCAAGATTGCACCATCACACTCCAGCCTGGGGGACAAGAGCAAGACTTCGTCTCAAAAAAAATGAAGAA","GGCCAGGCGCCGTGGCTCACGCCTGTAATCCCAGCACTTTGAGAGGCCGAGGCAGGTGGATGACTTGAGGTCAGGAGTTCTACACCAGCCTGGCCAAAATGTTGAAACCCCGTCTCTACTAATAATACAAAAATTAGCTGGGCATGGTGGCAGGCGCCTGTAATCCCAGCTACTTGGGAGGCTGAGACAAGATAATCACTTGAACCCGGGAGGCGGAGGTTACAGTGAGCCAAGATTGTGCCATTGCACTCCAGCCTGGGGGACAAGAGCGAGACTTCGTCTCAAAAAAAAACAAAAA"
"chr3","132149748","132149952","KN296505v1","400398","400602","38","131749350","GCCAGGTGCAGTGGCTCACGCCTGTAATCCCAGCACTTTGGGAGGCCAAGGCAGGTGGATTGCCTAAGGTCAGGAGTTCTAGACCAGCCTGACCAACATGGTGAAACCCCATCTCTAGTAAAAATACAAAACTAGCCAGGCCTGATGGCAAGCGCCTGTAATCCCAGCTACTCAGGCGGCTGAGGCAGGAGAATCGCTTGAACCC","GGCTGGGCACAGTGGCTCACACCTATAATCCCAGCATTTTGGGAGGCCAAGGTGGAAGGATCACTTGAGGTCAGGAGTTCTAAACCAGCCTGGCCAATATGGTGAAACCCCGTCTCTACTAAAAATACAAAAATTAGCTGGGCATAGTGGCTGGCACCTGTAATCCCAGCTACTTGGGAGGCTGAGGCAGGAGAATCACTTAAAC"
"chr3","134206328","134206632","KN297452v1","1683601","1683907","30","132522727","GGCTGGGCATGGTGGCTCATGCCTGTAATCCCAGCACTTTGGGAGGCTGAGCGGGCGGATCACCTGAGGTCAGGAGTTCGAGACCAGCCTGACCAACATGGTGAAACCCCATGTCTACTAAAAATACAAAAATTAGCTGGGTGTGGTGGCAGGCGCCTGTAATCCCAGCTACTCGGGAGGCTGAGGCAGGAGAATTGCTTGAACCTGGGAGGCAGAGGTTGCAATCAGCTGAGACCATGCCATTGCACTCCAGCCTGGGGGACAAGAGCGAGACTTCGTCTACAAAAAAAAAGAAAAAAAAAAAA","GGCCGGGCGTGGTGGCTCATGCCTGTAATCCCAGCACTTTGGGAGGCTGAGGCGGGCGGATCACCTGAGGTCAGGAGTTCGAGACCAGCCTGGTCAACATGGTGAAACCCCGTCTCTACTAAAAATACAAAAATTAGCTGGGTGTAGTGGCAGGCGCCTGTAATCTTAGCTACTCGGGAGGCTGAGGCAAGAGGATCACTTGAACCTGGGAAGCAGAGGTTGCAGTGAGCCAAGATCACGCCATCGCACTCCAGCCTGGGGGACAAGCGTGAGATTTGCTCTTAAAAAAAAAAAAAAAAAAAAAAAA"
"chr3","138007054","138007356","KN294193v1","690006","690308","33","137317048","GACCGGGCGCGGTGGCTCACGCCTGAAATCCCAGCACTTTGGGAAGCTGAAGCCGGCGGATCAACTGAGGTCAGGATTTCGAGACCAGCCTGGCCAACATGGAGAAACCCCATCTCTACTAAAAATACAAAAATTAGCCGGGCATGGTGGCAGGCGCCTGTAATCTCAGCTACTCGGGAGGCTGAGGCAGGAGAATTGCTTGAACCTGGGAGGCAGAGGTTGCGGTGAGCTGAGATCGCACCATCGCACTCCAGCCTGGGGGACAAGAGCAAGACTTCATCTCAAAACAAAACAAACAAAAAA","GGCTGGGCGCGGTGGCTCACGCCTGTAATCCCAGCACTTTGGAAGGCGAGGCAGGCGGATCACCTGAGATCAGGAGTTCGAGACCAGCCTGGCCAACATGGTGAAACCCCATCTCTACTAAAAATACAAAAATTAGTCGGGTGTGGTGGCAGGCGCCTGTAATCCCAGCCACTCGGGAGGCGGAGGCAGGAGAATCGCTTGAACCCGGCAGGCGGAGGTTGCAGTGAGCCGAGGTGGCGCCATTGCACTCCAGCCTGGGGGACAAGAGCAAGACTTCGTCTCAAAAACAAAGAAACAAAAAAA"
"chr3","143335432","143335724","KN295576v1","406337","406628","28","142929095","GGCCAGGCGCGGTGGCTCACGCCTGTAATCCCAGCACTTTGGGAGGCCGAGGCGGGTGGATCACCTGATGTCAGGAGTTCGAAACCAGCCTGGCCAACGTGGTAAAACCCTGTCTCTACTAAAAATACAAAAATTAGCTGGGCGTGGTGGCAGGCGCCTGTAATCCCAGCTACTTGGGAGGCTGAGGTAGGAGAATCACTTGAACCCGGGAGCAGAGGTTGCAGTGAGCCGAGATCGTGCCATTGCACTCCAGCCTGGGGGACAAGAGCGAGACTTCCTCTCAAAAAAAAAAA","GGCCGGGCGCGGTGGCTCACGCCTGTAATCCCAGCACTTTGGGAGGCCGAGGCGGGCGGATCACCTGAGGTAAGGAGTTCGAGAACAGCCTGGCCAGCATGGTGAAACCCCATCTCTACTAAAAATACAAAAATTAGCCGGGCATGGTGGCAGGTGCCTGTAATCCCAGCTACTCGGGAGGCTGAGGCAGAAGAATCGCTTGAACCCAGGAGGCGGAGGTTGCAGTGAGCCGAGATTGCGCCATTGCACTCCAGCCTAGGGGAGAAGAGCGAGACTTCGTCTCAAAAAAAAA"
"chr3","143423972","143424052","KN296922v1","568825","568895","21","142855147","AGCCCAGATCGTGCCATTGCACTCCAGACTGGGGGAAAAGAGAGAGACTTCGTCTCAAAAAAAAAAAACAACAAAAAAAAA","AGATCGTGCCATTGTACTCCAGCCTGGGGAGCAAGAGCGAGACTTTGTCTCAAAATAAATAAATAAATAAA"
"chr3","146722657","146722951","KN294685v1","1269570","1269869","30","145453087","GGCCAGGCACGGTGGCTCACGCCTGTAATCCCAGCACTTTGGGAGGCCAAGGTGGGCGGATCACCTGAGGTCAGGAGTTCGAGACCAGCCTGGCCAACATGGTGAAATCCCGTCTCTACTAAAAATACAAAAAGTAGCCAGGCGCGGTGACAGACGCCTGTAATTCCAGCTACTCGGGAGGCTGAGGCAGGAGAATCCCTTGAACCTGGGAGGCAGAGGTTGCAGTAAGCTGAGATTACCCCATTGCACTCCAGCCTGGGGGACAAGAGCGAGACTTCGTCTCAAGAAAAAAAAA","GGCTGGGTGTGGTGGCTTAGGCCTGTAATCCCAGCACTTTGGGAGGCCAAGGCGGGCGGATCACCTGAGGTCAGGAGTTCGAGACCAGCCTGGCCAACATGGTGAAACCCCGTCTCTACTAAAAATACAAAAACTAGCCAGGCGTGGTGGCAGGTGACTGTAATCCCAGCTACTCGGGAGGCTGAGGCAGGAGAACTGCTTGAACCTGGGAGGCGGAGGTTGCAGTGAGCTGAGATCACACCATTGCACTCCAGCCTGGGGGACAAGAGCGAGACTTTGTCTCAAAAATAAAAAAAAAAA"
"chr3","149476354","149476659","KN296119v1","5266717","5267021","38","144209637","GGGTGTGGTGTTTCACACCTGTAATCCCAGCACTTTGAGAGGCCAAGGCAGGTGGATCACCTGAGATCAGGAGTTTGAGACCAGCCTGGCCAACATGGTGAAACCCTGTCTCTACTAAACACAAAAAAATTAGCTGGGTGTGGTAGCAGGTGCCTGTAATCCCAGCTACTTGGGAGGCCGAGGCAGGAGAATCGCTTGAACCCGGGAGGCAGAGGTTGCAGTGAGCCGAGACTGCGCCATTGCACTCCAGGCTGGAGGACAAGAGCAAGACTTCATCTCAAAACAAACAAACAAACAAACAAAAAA","GGCCAGGTGCGGTGGCTCACGCCTGTAATCCTAGCACTTTAGAAGGCCAAGGCGGGTGGATCACCTGAGGTCAGGAGTTCGAGACCAGCCTGGCCAACATGGTGAAACCCTGTCTCTACTTAAAATACAGAAAATTAGCTGGGTGTGGTGGTACGCACCTGTAATCCCAGCTACTTGGGAGGCCGAGGCAGGAGAATCGCTTGAACCCGGGAGGCAGAGGTTGCAGTGAGCTGAGATCGCGCCATTGCACTCCAGACTGAGGAACAAGAGCGAGACTTCGTCTCAAAAAACAAACAAACAAAAAA"
"chr3","151047599","151047904","KN294665v1","171883","172197","35","150875716","GGCCGGGCACGGTGGCTTATGTAATCCCAGCACTTTGGGAGGCCGAGGCGGGCGGATCACCCGAAGTCAGGATTTCGAGACCAGCCTGGCCAACATGGTGAAACCCCGTCTCTACTAAAAATACAAAAATTAGCCAGGCATGGTGGCAGGCGCCTGTAATCCCAGCTACTTGGGAAGCTAAGGCAAGAGAATCCCTTGAACCCGGGAACAGGAGGTTGCAGTGAGCGGAGATCGCACCATTGCACTCCAGCCTGGGGGACAAGAGCAAGACTTTGTCTACAAAAAAAAAAAAAAGAAAAAAGAAAA","GCCGGGCATGGTGGCTCATGCGTGTAATCCCACCACTTTGGGAGTCCGAGGCAGGTGGATCACCTGAGGTCAGGAGTTCGAGACCAGCCTGGCCAACATGGTGAAACCCCCGTCTCTACTAAAAATACAAAAATTAGCTGGGCATGGTGGCAGGCGCCTGTAATCCCAGCTACTCGGGAGGCTGAGGCAAGAGAATCGCTTGAACCCGGGAGATGGAGGTTGCAGTGAGCCGAGATCGCACCATTGCACTCCAGCCTGGGGGACAAAAGAGAGACTTTGTCTCAAAAAAAAAAAAAAAAAAAAAAAAAAGAAAAA"
"chr3","154075371","154075686","KN295441v1","640456","640765","43","153434915","GGCCAGGCACAGTGGCTCACGCCTGTAATCCCAACACTTTGGGAGGTTAAGGCAGGCAGATCACCTGAGGTCAGGAGTTCGAGACCAGCCTGGCCAACATGATGAAACCCCATCTCTAACAAAAATACAAAAAAAATTAGCCGAGCATGGTGGCAAGCACTTGTAATCCCAGCTACTCGGGAGGCTAAGGCAGGAGAATTGCTTGTACCCAAGAGGTGGAGGTTGCAGTGAGCTGAGATTGCATCATCTCACTCCAGCCTGGGGGACAAGAGCGAGACTTTGTCTCAAAAAAACAAAATAGAACAAAACAAAAAAA","GACCGGGCACGGTGGCTCATGACTGTAATCCCAGCACTTTGGGAGGCTGAGGTGGGTGGATCACCTGAGGTCAGGAGTTCGAGACCAGCCTGGCCAACATGGTGAAACCCCATCTCTACTAGAAATACAAAATTAGCCGGGTGTGGTGGCAGGCACCTGTAATCCCAGCTACTCGGGAGGCCGAGGCAGGAGAATTGCTTGAACCCAGGAGGCGGAGATTGCGGTGAGCTGAGATCACACCATTGCACTCCAGCCTGGGGTACAAGAGTGAGACTTTGTCTCAAAAACAAAACAAAACAAAACAAAAAAA"
"chr3","155434559","155434639","KN296311v1","5980226","5980308","21","149454333","GGCTGGGCACAGTGGTTCACACCTTTAATCCCAGCACTTTGGGAAGCTGAGGTGGCTGGATCTCATGAGTGAGTTCCAGAC","GGCCAGGCACAGGGGCTCATGCCTGTAATCCCAGCACTTCGGGAGGCTGAGGCGGGTGTATCACCTGAGGTCAGGAATTCCAG"
"chr3","155493184","155493476","KN296620v1","581158","581456","36","154912026","GGCCGGGTGCAGTGGCTCACGCCTATAATCTCAGCACTTTGGGAGGCCAAGGCAGGCGGATCACCTGTGGTCAGGAGTTCGAGACCAGCCTGGCCAACATGGTGAAACCCTATCTCTACTAAAAAAAAAAAAAAAAAAATACAAAAAATTAGCTGGGTGTAATCCCAGCTACTCGGGAGGCCGAGGCAGGAGAATCACTTGAACCCGGGAGGCGGAGGTTGCAGTGAGCCGAGATCATGCCATTGCACTCCAGCCTTGGGGACAAGAGTGAGACTTCGTTGCAAAAAAAAAAA","GGCCAGGCACAGTGGCTCACACCTGTAATCCCAGCACTTTGGGAGGCCGAGGCAGGCTGATCACCTGAGGTCAGGAGTTCGAGACCAGCCTGGCTAACATGGTGAAACCCTGTCTCTACTAAAAAAAAGAAAAAAAAAATTAGCCAGGTGTGCTGGCAGGTGCCTGTAATACCAGCTACTCAGGAGGCTGAGGCAGGAGAATCACTTGAACCTGGGAGGCGGAGGTTGCAGTGAGCCAAGATTATGCCATTGCACTCCAGCCTGGGGGACAAGAGCGAGACTTCATTGCAAAAAAAAAA"
"chr3","157879940","157880248","KN294172v1","4419501","4419812","29","153460439","GGCCGGGCGCAGTGGCTCACACCTGTAATCCCAGCACTTTGGGAGGCCGAGACAGGCAGATCACCTGAGGTCAGGAGTTCGAGACCAGCCTGGCCAACATGTTGAAACCCCGTCTCCACTAAAAACACAAAAATTAGCCGGGCATGGTGGCAGGCACCTGTAATCTCAGCTACTTGGGAGGCTGAGGCAGAAGAATCGCTTGAACCCAGGAGGCAGAGGTTGCAGTGAGCCGAGATCACGCCATTACACTCCAGCCTGGGGGACAAGAGTGAGACTTCATCTCAAAAAATAAATAAATAAATATAAAAA","GGCTGGGCGCAGTGGCTCACGCCTGTAATCCCAGCACTTTGGGAGGCCGAGGCAGGCGGATCACCTGAGGTCAGGAGTTTCAGACCAGCCTGGCCAACATGGTGAAACCCCGTCCCTACTAAAAATACAAAAATTAGCCGGGCGTGGTGGCAGGCACCTGTAATCCCAGCTACTCAGGAGGCTGAGGCAGGAGAATCACTTGAACCCCGGAGGCAGGGGTTGCGGTGAGCCGAGATCGCGCCACTGCACCCCAGCCTGGGGGACAAGAGCAAGACTTCATCTCAAAAATAAATAAATAAATAAAAATAAAAA"
"chr3","163160205","163160434","KN295202v1","512870","513091","33","162647335","ACCAGCCTGGCCAATATGGTGAAACCCCATGTCTACTTAAAGTACAAAAAATTAGCCGGGCGTGGTGGTACGCACCTGTAATCCCAGCTACTCGGGAGGCTGAGGCAGGAGAATCACTTGAACCTGGGAGAGGGAGGTTGCAGTGAGCTGAGATCGTGCCATTGCACTCCACCCTGGGGGACAAGAGCGAGACTTTTTCTCAAAAAAATAAAAATAAAAATAAATAAAAA","GACCAGCCTGGCCAACATGGTGAAACCATCTCTACTAAAAATATAAAAATTAGCTGGGCGTTGTGGCACGTGTCAGTAATCCCAGCTACTCGGGAGGCTGAGGCAGGAGAATCACTTGAATCCGGGAGGCGGAGGTTGAAGTGAGCCCAGATCGCGCCATTGCACTCCAGCCTGGGGACAAGAGCCAGACTTTATCTCAAAAAAAAAAAAAAAAAAAAAAAA"
"chr3","165107147","165107295","KN297263v1","890000","890133","44","164217147","ACCCCGGTTTCTAAGGGGACCGAGGAGGAAAGTACGTACTTTCGTAAGACTGGAGGCGANAGGACTGCAGTCAGCTGAGATTGCACCATACGCATTCCAGCCTGCGACGAGAGCAAGAACTACCATACTCAAANAAAAAAAAAAAAGAA","AGCTATTCAGGAGGCTGAGGCAGGAGAATCGCTTCAACCCGGGAGGCAGAGGTTGCAGTGAGCCGAGATCGCACCATCACACTCCAGCCTTGGGGACAAGAGCGAGACTTCATCTCAAAAAAAAAAAAAAAAAA"
"chr3","165677650","165677943","KN296191v1","251635","251928","32","165426015","GCCTGGCATGGTGGCTTACGCCTGTAATCCCAGCACTTTGGGAGGCCAAGGTGGGTGGATCACCTGGGGTCAGGAGTCCAAGACCAGCCTAGCCAACATGGTGAAACCCTGTCTCTACTAAAAAGACAAAAATTAGCCTGGCGTGGTGGCAGGCGCTTGTAATCCCAGCTACTCAGGAGGCTGAGGCAGGAGAATCGCTTGAACCCAGGAGGCAGAGGTTGCAGTGAGCCAAGATCGTGCCATTGCACTCCAGCCTGGGGGACAAGAGCAAGACTTCATCTCAAAAAAAAAAAA","GGCCAGGCACGGTGGCTCATGCCTGTAATCCCAGCACTTTGGGAGACTGAGGTGGGTGGATCACCTGAGGTCAGGAGTTTGAAACCAGCCTGGCCAGCATGGTGAAACCCTGTCTCTACTAAAAATACAAAAATTAACCAGGCGTGGTGGCAGGCGCCTGTAATCACAGCTACTCAGGAGGTTGAGGCAGGAGAATCACTTGAACCCAGGAGGCAGAGGTTGCAGTGAGCCGAGATCGTGCCATTGCACTCTAGCCTAAGGGACAAAAATAAGACTTTGTCTCAAAAAAAAAAA"
"chr3","177182827","177183155","KN294665v1","171883","172197","44","177010944","GGCTGGGCATGGTGGCTCACGCCTGTAATCCCAGCACTTAGGGAGGCCGAGGCAGGCAAATCACCTGAGGTCAGGAGCTCGAGACCAGCCTGGCCAACATGGTGAAATCCCGTCTCTACTAAAAACACAAAAATTAGCCGGGTGTGGTGGCAGGCGCCTGTAATCCCAGCTACTCAGGAGGCTGAGGCAGGAGAATCGCTTGAACCCAGGAGGTGGAGGTTGCAGTGAGCCGAGATTGCGCCATCACACTTCAGCCTGGGGGACAAGAGCAAGACTTTGTCTCAAAAATAAATAAATAAATAAATAAATAAATAAATAAATAAAATAAA","GCCGGGCATGGTGGCTCATGCGTGTAATCCCACCACTTTGGGAGTCCGAGGCAGGTGGATCACCTGAGGTCAGGAGTTCGAGACCAGCCTGGCCAACATGGTGAAACCCCCGTCTCTACTAAAAATACAAAAATTAGCTGGGCATGGTGGCAGGCGCCTGTAATCCCAGCTACTCGGGAGGCTGAGGCAAGAGAATCGCTTGAACCCGGGAGATGGAGGTTGCAGTGAGCCGAGATCGCACCATTGCACTCCAGCCTGGGGGACAAAAGAGAGACTTTGTCTCAAAAAAAAAAAAAAAAAAAAAAAAAAGAAAAA"
"chr3","182173611","182173919","KN294685v1","1269570","1269869","41","180904041","GGCTGGGCACAGTGGCTCACACCTGTAATCCCAGCACTTTGGGAGGCTGAGGCGGGTGGATCACCTGAGGTCAGGAGTTCTAGACCAGCCTGGCCAACATGGTGAAACCCCATCTCCCCCATCTCTACTAAAAATACAAAAATTAGCCAGGCTTGGTGGCAGGTGCCTGTAATCCCAGCTACTCAGGGGCGCTGAAGCAGAAGAACTGCCTGAACCCAGGAGGCAGAGGTTGCAGTGAGCTGAGATCACGCCATTGCACTCCAGCCTAGGGAACAAGAGCAAAACTTAGTCTCAAGAAAAAAAAAAAAA","GGCTGGGTGTGGTGGCTTAGGCCTGTAATCCCAGCACTTTGGGAGGCCAAGGCGGGCGGATCACCTGAGGTCAGGAGTTCGAGACCAGCCTGGCCAACATGGTGAAACCCCGTCTCTACTAAAAATACAAAAACTAGCCAGGCGTGGTGGCAGGTGACTGTAATCCCAGCTACTCGGGAGGCTGAGGCAGGAGAACTGCTTGAACCTGGGAGGCGGAGGTTGCAGTGAGCTGAGATCACACCATTGCACTCCAGCCTGGGGGACAAGAGCGAGACTTTGTCTCAAAAATAAAAAAAAAAA"
"chr3","182257388","182257698","KN296387v1","301235","301539","37","181956153","GGCCGGGCATGGTGGCTCACACCTGTAATCCCAGCACTTTGGGAGGCCAAGGCGGGTGGATGACCTGAGGTCAGGAGTCTGGGACCAGCCTGGCCAACATGGTGAAACTCCATCTCTACTAAAAATACCAAAACTAGCCGGGTGTGGTGGCAGGCACCTATAATCCCAGCTACTCATGGGGCTGAGGCAGGAGAATCGCTTGAACCCAGGAGGCGGAGGTTGCAGTTAGCCGAGATCGTGCCATCGCACTCCAGCCTGGGGCACAAGAGCGAGACCTCGTCTCAAAAAAATAAATAAAAATGAAAAATAAA","GGCTGGGCGCGGTGGCTCACACCTGTAATCCCAGCACTTTGGGAGGCCGAGGTGGGTGAATCACCTGAGGTCAGGAGTTCGAGACCAGCCTGGCCAACATGGTGAAACCCCATATCTACTAAAAATACAAAAATTAGCCAGGTGTGGTGGCAGGCGCCTATAATCCCAGCTGCTTGGGAGCCTGAGGCAGGAGAATCGCTTGAACCTGGGAGGCGGAGGTTGCAGTGAGCCAAGATCGTGCCATTGCACTCCAGCCTAGGGGACAAGAGTGAGACTAATCTCAAAAAAAAAAAAAAAAAAAAAAA"
"chr3","182494395","182494682","KN295416v1","44113","44401","41","182450282","GGCCAGGCGCGGTGGCTCATGCCTGTAATCCCAGCACTTTGGTAGGCCAAGGAGAGGGGATCACCTGAGGTCAGGAGTTCGAGACCAGCCTGGCCAACATGGTGAAACCCTGTCTCTACTAAAAATACAAAAATTAGCCGGGCATGGTGGCACGACACCTGTAGTCCCAGGCTGAGGCAGGAGAATCGCTTGAACCCGGGAGGCGGAGGTTGCAGTGAGCCGAGATCGCGCCATTGCATTCTAGCTTGGGGGACAAGGACGAGACTTAATCTCAAAAAAAAAAAAAAA","GGTCGGGTGCAGTGGCTCATGCCTGTAATCCCAGCACTTTAGGAGGCCGAGGTGGGTGGATCACCTGAGGTCAGGAGTTCGAGACCAGCCTGGCCAACATGGTGAAACCCCATCTCTACTTAAAATACAAAAATTAGCCAGACATGGTGGTACACACCTGTAATCTCAGCTACTCGGGAGGCAGGAGAATCACTTGAACCCAGGAGGCAGAGGTTGCAGTGAGCTGAGATCGCACCATTGTACTCCAGCCTGGGGGACAAGAGTGAGACTTCATCAAAAAAAAAAAAAA"
"chr3","182599568","182599879","KN295172v1","269190","269486","41","182330378","CCGGGCACAGTGGCTCACGCCCGTAATCCCAGCACTTTGGGAGGCCGAGGCTGGTGGATCATCTGAGGTCAGAAGTTCTGGATCAGCCTGGCCAACATGGGGAAACCCTATCTCTACTAAAAATACAAAAATTAGCCGGGCCTGGTGGCAGGCACCTGTAATCCCAGCTACTCAGGGAGGCCAAGGCAGGTGAATCACTTGAACCTGGGAGGCGGAGGTTGCACGTGAGCCGAGATAGCACCATCGCACTCCAGCCTGGGGGACAAGAGCGAGACTTTGTCTCAAAACAAACAAACAGACAAACAAAAAGAA","GCCGGGCACGGTGGCTCACGCCTGTAATCCAGCACTTTGGGAGGCCGAGGCGGTGGATCACCTGAGGTCAGGAGTTCTAGACCAGCCTGGCCAACATGGTAAAACCCCATCTCTACTAAAAATACAAAAATTAGCTGGGCGTGATGGCAGGCACCTGTAATCCCAGCTACTTGGGGGGCCAAGGCAGGAGAATCGCTTGAACCCTGGAGGCGGAGGTTGCAGTGAGCTGAGATCACACCATCGCACTCCAGCCTGGGGGAGAAGAGCGAGACTTCATCTAAAAAAAAAAAAAAAAAA"
"chr3","182605898","182606189","KN295576v1","406337","406628","33","182199561","GGCCAGACGCGGTGGCTCACTCCTGTAATCCCAGCACTTTGGGGGGTTGAGGCGGGAGGATCACCTGAGGACAGGAGTTCGAGACCAGCCTGGCCAACATGGTGAAACTCTGTCTCTACTTAAAATACAAAAATTAGCCGAGCGTGGTGGCACATGCCTGTAATCCCAGCCACTCAGGAGGCTGAGGCATGAGAATCGCTTGAACCTGGGAGGTGGAGGTTGCAGTGAGCCAAGATCGCGCCATTGCACTCCAGCCTGGGGGATAAGAGCTAGACTTCATCTCAAAAACAAA","GGCCGGGCGCGGTGGCTCACGCCTGTAATCCCAGCACTTTGGGAGGCCGAGGCGGGCGGATCACCTGAGGTAAGGAGTTCGAGAACAGCCTGGCCAGCATGGTGAAACCCCATCTCTACTAAAAATACAAAAATTAGCCGGGCATGGTGGCAGGTGCCTGTAATCCCAGCTACTCGGGAGGCTGAGGCAGAAGAATCGCTTGAACCCAGGAGGCGGAGGTTGCAGTGAGCCGAGATTGCGCCATTGCACTCCAGCCTAGGGGAGAAGAGCGAGACTTCGTCTCAAAAAAAAA"
"chr3","182722283","182722576","KN295172v1","269190","269486","41","182453093","GGCTGGAAGCGGTGGCTCACGCCTGTAATCCCACACTTTGGGAAGCCGAGGCGTGTGGATCACCTAAGGTCAGGAATTCAAGACCACTGTGGCCAACATGGTGAAACCCCATCTCTACTAAAAATACAAAAATTAGCCAGGTGTGGTGGCACATACCTGTAATCCCAGCTACTGGGGAGGCCAAGGCAGGAGAATCGTTTGAACCCTGGAAGGGGAGGTTGCAGAGGGCTGAGATCACGCCATGGCACTCCAGCCTGGGGGACAAGAGCTAGACTTCGTATACAAAAAAAAAAA","GCCGGGCACGGTGGCTCACGCCTGTAATCCAGCACTTTGGGAGGCCGAGGCGGTGGATCACCTGAGGTCAGGAGTTCTAGACCAGCCTGGCCAACATGGTAAAACCCCATCTCTACTAAAAATACAAAAATTAGCTGGGCGTGATGGCAGGCACCTGTAATCCCAGCTACTTGGGGGGCCAAGGCAGGAGAATCGCTTGAACCCTGGAGGCGGAGGTTGCAGTGAGCTGAGATCACACCATCGCACTCCAGCCTGGGGGAGAAGAGCGAGACTTCATCTAAAAAAAAAAAAAAAAAA"
"chr3","183372797","183372886","KN297323v1","656594","656696","27","182716203","ACCTGGGAAGCCGAGGTTGCAGTGAGCCGAGATCACACCATTTCACTCCAGTCTGGGAAACAAGAGTGAGACTTCGTCTAAGAAAAAAAA","AATCCCTTGAATCCGGGAGGTGGAGGCTGCAGTGAGCCGAGATCACACCACTGCACCCCAGCCTGGGGACTAGAGAGAGACTTCGTCTGAAAAAAAAAAAAAA"
"chr3","186256302","186256599","KN294420v1","890399","890698","38","185365903","GCCAGGTGCAGTGGCTCACGCCTGTAATCCCAGCACTTTGGGAGGCTGAGGTGGGTGGATCACCTGAGGCCAGGAGATCTAGACCAGCCTGGCCAACATGGTGAAACTCGTCTCTACTAAAAGTAAAAAAAATTAGCCGGGCGTGGTGGCACATGCCTTTAATCCCAGCTACTCAAGAGGCTGAAGCAGGAGAATCGCTTGAACTCGGGAGGCGGAGGTTGCAGTGAGCTGAGATCATGCCATTGCACTCTAGCCTGGGAGACAAGAGCAAGACTTCATCTCAAAAAAAAAAAGAAAA","GGCCAGGCACGGTGGCTCACGCCTGTAATCCCAGCACTTTGGGAGGCTGAGGTGGGCGGATCACCTAAGGTCAGGAGTTCTAGATCAGCCTGGCCAACATGGTGAAATCCCGTCTCTACTAAAAATACAAAAATTAGCCAGGCATGGTGGCAGGCGCCTGTAATCACAGCTACTCAGGAGGCTGAGGCAGGAGAATCACTTGAACCCAGGAGGCGGAGTTTGCAGTGAGCTGAGATTGCACCATTGCAGTCCAGCCTGGGGGACAAAAGCAAGACTCCATCTCAAAAAAAAAAAAAAAAA"
"chr3","188168795","188169100","KN295573v1","1644468","1644772","32","186524327","GGCTGGGCACAGTGGCTCACGCCTGTAATCCCAGCACCTTGGGAGGCCCAGGCGGGAGGATCACCTGAAGTCAGGAGTTCAAGACCAGCCTGCCCAACATGGTGAAACCCCGTCTCTACTAAAAATACAAAAATTAGCCAGGCATGGTGGCAGGTGCCTGTAATCCCAGCTACTCGGGAGGCTGAGGCAGAAGAACTGCTTGAACCCGGGAGGCAGAGGTTGCAGTGAGCCAAGATCACATCATCACACTCCAGCCTGGGGGACAAGAGCGAGGCTTCATCTCCAAAAAAAAAAAAAAAAAAAAAA","GGCCGGGCACAGTGGCTCACACCTGTAATCCCAGCACTTTGGGAGTCTGAGGCAGGCGGATCACCTGAGGTCAGGAGTTCGAGACCAGCCTGGCCAACATGGAGAAACCCCCGTCTCTACTAAAAATACAAAAATTAGCTGGGCATGATGGCAGGAGCCTGTAATCCCAGATACTCAGGAGGCTGAGGCAGGAGAATGGCTTGAACCCGGGAGGCAGAGGTTGCAGTGAGCCAAGGTCGCGCCATTGCACTCCAGCCTGGGGGACAAGAGCGAGACTTCGTCTCAAAAAAAAAAAAAAAAAAAAA"
"chr3","188775240","188775515","KN296036v1","1402335","1402599","23","187372905","GCCGGGTGCGGTGGCTCATGCCTGTAATCCCAGCACTTTGGGAGGCCAAGGCGGATGGATCACCTGAGGTCAGCAGTTCTAGACCAGCCTGGCCAACATGGTAAATCTCCGTCTCTACTGAAAAATACAAAAATTAGCCGGGCGTGGTGGCAGGCGCCTGTAATCTGAACCCAGGAGGCAGAGGTTGCAGTGAGCCGAGATTGTGCCATCGCACTCCAGCCTGGGGGGACAAGAGCAAGACTTTGTCTCAAAAAAAAAAAAGAAAGAAAGAAAAAA","GCCGGGTGTGGTGGCTCATGCCTGTAATCCCAGCACTTTGGGAGGCCAAGGCTGATGGATCACCTGAGGTCAGGAGTTCTAGACCAGCCTGGCCAACATGGTAAAACTCCATCTCTACTAAAAATACAAAAATTAGCTGGGCGTGGTGGCGGGCGCCTGTAATCTGAATCCAGGAGGCAGAGGTTGCAGTGAGCCGAAATCATGCCATCGCACTCCAGCCTGGGGGGACAAGAGCGAGACTTTGTCTCAAAAAAAAAAAAAAAAA"
"chr3","188980738","188980885","KN296119v1","5485404","5485553","18","183495334","CCTGTAATCCCAGCTACTTGGAAGGCTGAGGCAGGAGAATCACTTGAACCCGGGAGGCAGAGGTTGCAGTGAGCCAAGATCACTCCATGGTACTCCAGCCTGGGGGAAAAGAGTGAGACTTTGTCTCAAAAAAAAAAAAGGAAAAGAA","CTGTAATCCCAACTACTCGGGAGGCTGAGGCAGGAGAATCGCTTGAACCCGGGAGGCGGAGGTTGCAGTGAGCCGAGATCATGCCATCGCACTCCAGCCTGGGGGACAAGAGTGAGACTTTGTCTCTAAAAAATAAAAAAAAAAAAAAAA"
"chr3","189084278","189084576","KN294420v1","890399","890698","31","188193879","GGCTGGGCATAGTGGCTCACGCCTGTAATCCCAGCACTTTGGGAGGCCGAGGCGGGTGGATCACCTGAGGTCAGGAGTTCTAGACCAGCCTGGCCAACATGGTGAAAACCCGTCTCTACTAAAAATACAAAAATTAGCCAGGCACGGTGGCAGGGGCCTGTAATCCCAGCTACTCGGGGGGCCGAGGCAGGAGAATCCCTTGAACCCAGGAAGCAGAGGTTGCAGTGAGCCGAGATTGCGTCACTGTACTCCAGCCTGGGGGACAAGAGCAAGACTTCATCTGAAAAAAGAAAAAAAAA","GGCCAGGCACGGTGGCTCACGCCTGTAATCCCAGCACTTTGGGAGGCTGAGGTGGGCGGATCACCTAAGGTCAGGAGTTCTAGATCAGCCTGGCCAACATGGTGAAATCCCGTCTCTACTAAAAATACAAAAATTAGCCAGGCATGGTGGCAGGCGCCTGTAATCACAGCTACTCAGGAGGCTGAGGCAGGAGAATCACTTGAACCCAGGAGGCGGAGTTTGCAGTGAGCTGAGATTGCACCATTGCAGTCCAGCCTGGGGGACAAAAGCAAGACTCCATCTCAAAAAAAAAAAAAAAAA"
"chr3","189847035","189847343","KN294685v1","1269570","1269869","49","188577465","GGCCGGGTGTGGTGGCTCACCCCTGTAATCCCTGCACTTTGGGAGGCCAAGGTGGGTTGGATTCCTTAGAGGATCACGTGAGGTTGGGAGTTCTAGACCAGCCTGGCCAACATGGTGAAACCCTGTCTCTACTAATAATACAAAAATTAGCCAGGCGTGGTGGCGCAGTAATCCCAGCTACTCGGGGGGCTGAGGCAGGAGAACTGCTTGAACCCGGGAGGTGGAGGTTGCAGTGAGCCGAGATCGTGCCATTGCACTCCAGCCTGGGTGACAAAAGCAAAACTGTCTCAAAAAAAAAACACCAAAAAA","GGCTGGGTGTGGTGGCTTAGGCCTGTAATCCCAGCACTTTGGGAGGCCAAGGCGGGCGGATCACCTGAGGTCAGGAGTTCGAGACCAGCCTGGCCAACATGGTGAAACCCCGTCTCTACTAAAAATACAAAAACTAGCCAGGCGTGGTGGCAGGTGACTGTAATCCCAGCTACTCGGGAGGCTGAGGCAGGAGAACTGCTTGAACCTGGGAGGCGGAGGTTGCAGTGAGCTGAGATCACACCATTGCACTCCAGCCTGGGGGACAAGAGCGAGACTTTGTCTCAAAAATAAAAAAAAAAA"
"chr3","191053733","191054005","KN296495v1","2052820","2053103","43","189000913","GCCAGGCATGCTGGCTCAAGCTTGTAATCCTAGCACTTTGGGAGGCGGAGGCAGGTGGATTACCTGAGGTCAGGAGTTCGAGACCAGCCTGGTCAACACAGTGAAACCCTGTCTCTACTGAAAATATAAAAATTAGCTGGGCGTGGTGGCATGCACCTATAATCCCAGCTACATGGGAGGCTGAGGCAGGAGAATCACTTGAACCTGGGAGGTGGAGGTTGCAGTGAGCTGAGACCATGCCATTGCACTCCAGCCTGGGGGACAAGAGTGAGA","GGCTGGGCACGGTGGCTCACGCCTGTCAATCCCAGCACTTTGGGAGGCTGAGGCAGGTGGATCACCTGAGGTCAGGAGTTCGAGACCAGCATGGCCAACATGGTGAAACCCTGTCTCTACTAAAAATACAAAAATTAGCTGGGCGTGGTGGTAGGCACCTGTAATCCCAGTTACTCGGGAGGCTGAGGCAGGAGAATCGCTTGAACCCAGGAGGTGGAGGTTGCAGTGAGCTGAGATTGCGCCATTGCACTGCAACCTGGGGCACAAGAGCGAGACTTCATCTC"
"chr3","194321127","194321415","KN295941v1","1108709","1108994","32","193212418","GGCCAGGCACAGTGGCTCATGCCTGCAATCCCAGCACTTTGGGAGGCTGAGGTGGGTGGATCACCTGAGGTCAGGAGTTCAAGACCAGCCTAGCCAACATGGTGAAACCCTGTCTCTAATAAAAATACAAAAATATTAGCCGGGCACGGTGGCAGGTGCCTGTAATCCCAGCTACTCGGGAGGCTGAGGCAGGAGAATTGCTTGAACCCAGGAGGCAGAGGTTGCAGTGAGCTGAGATCGCACCATTGCACTCCAGCCTGGGGGATGAGAGCAAGACTTCGTCTCAAAA","GCCGGGTGCTTTGGCTCACGCCTGTAATCCCAGCACTTTGGGATGCCGAGGCGGGTGGATCACCTGAGGTCAGGAGTTTGAGACCAGCCTGGCCAACATGGTGAAACCCTGTCTCTACCAAAAATACAAAAATTAGCCGGGCGGGGTGGCAGGCGCCCGTAATCCCAGCTACTCGGAAGGCTGAGGCAGGATAATCGCTTGAACCTGGGAGGCGGAGGTTGCAGTGAGCCGAGATCGCACCATTGCACTCCAGCCTGGGGGACAAGAGCGAGACTTCGTCTCAAAA"
"chr3","194386780","194387078","KN294420v1","890399","890698","33","193496381","GGCTGGGCATGGTGGCTCACGCCTGTAATCCCAGCACTTCGTGAGGCCGAGGTGGGTGGATCACCTGAGGTCAGGTGTTCTAGACCAGCCTGGCCAACATGGTGAAACCCTGTCTCTACTAAAAATACAAAAATTAGCTGGGTGTGGTGGCAGGTGCCTGTAATCTCATCTACTCAGGGGGGCTGAGGCAGGAGAATCACTTGAACCCGGGAGGTGGAGGTTGCAGTGAGCTGAGATTGCACCATTGCACTCCAGCCTGGGGAACAAGAGCGAGACTTCCTCTCAAAAGAAAAAAAAAA","GGCCAGGCACGGTGGCTCACGCCTGTAATCCCAGCACTTTGGGAGGCTGAGGTGGGCGGATCACCTAAGGTCAGGAGTTCTAGATCAGCCTGGCCAACATGGTGAAATCCCGTCTCTACTAAAAATACAAAAATTAGCCAGGCATGGTGGCAGGCGCCTGTAATCACAGCTACTCAGGAGGCTGAGGCAGGAGAATCACTTGAACCCAGGAGGCGGAGTTTGCAGTGAGCTGAGATTGCACCATTGCAGTCCAGCCTGGGGGACAAAAGCAAGACTCCATCTCAAAAAAAAAAAAAAAAA"
"chr3","197528441","197528632","KN296290v1","476549","476739","12","197051892","GGCTGGGTGTGGTGGCTCACTCCTGTAATCCCAGCACTTTGGGAGGCTGAGGTGGGTGGATCACCTGAGGTCAGGAATTCTAGACCAGCCTGGCCAACATGACAAAACCCCTTCTCTACTAAAAATACAAAAAATTAGCCAGGCATGGTGGCAGATGCCTGTAATCCCAGCTACATGGGAGGCTGAGGCAGG","GCCAGGTGTGGTGGCTCATGCCTGTAATCCCAGCACTTTGGGAGGCTGAGGTGGGTGGATCACCTGAGGCCAGGAATTCTAGACCAGGCTGGCCAACATGACAAAACCCCATCTCCACTAAAAATACAAAAAATTAGCCAGTCATGGTGGCAGGTGCCTGTAATCCCAGCTACTTGGGAGGCTGAGGCAGG"
"chr3","197648322","197648613","KN294991v1","1107866","1108162","29","196540456","GGCGGAGTGCGGTGGCTCACGCCTGTAATCCCAGCACTTTGGGAGGCCAAGGCAGGTGGATCACCTGAGGTCAGGAGTTCAAGACCAGCCTGGCCAACATGGTGAAACCCCATCTCTACTAAAAATACAAAAATTAGCCAGGAGTGGTGGCAGGCACCTGTAATTCCAGCCACTCGGGAGGTGAGGCAGGAGAATCGCCTGAACCCAGGAGGCAGAAGTTGCAGTGAGCCGAGATCACACCATTGCACTCCAGCCTGGGGGACAAGAGTGAGACTTTGTCTCAAAAAAAAAA","GGCCGGGTGCAGTGGCTCACGCCTGTAATCCCAGCCCTTTGGGAGGTCGAGGCAGGTGGATCACCTGATGTCAGGAGTTCGAGACCAACCTGGCCAACATGGTGAAACCCCATCTCTACTAAAAATACAAAAATTAGCCAGGCGTGGTGGCAGGCACCTGTAATCTCAGCTACTAGGGAGGCTGAGGCAAAAGAATCACTTGAACCCAGGAGGCAGAGGTTGCAGTAAGCTGAGATCACACCACTGCACTCCAACTTGGGGGACAAGAGTGAGACTTTGTCTCAAAAAACAAAAAAA"
"chr3","201321497","201321625","KN294614v1","295099","295217","34","201026398","CACTTAGAACCTGGAGGTGGAGATGCAGTGAGCCAAGATCATGCCCTGCACTCCAGCCGTGGGTGGGTGGACAAGAGGTAGGTAAACTACTTGTCTAACAAAAAAAAAAAAAGAAAGAAAAAAAAAAAA","ATCGCTTGGACCTGGGAGGTGGAGGTTGCCATGAGCCAAGATCGTGCCATCGCACTCCAGCTCGGGGGACAAGAGCGAGACTTTGTCTCAAAAAAAAAAAAAAAAAAGAAAGAAAGAAA"
"chr3","203338926","203339103","KN295571v1","534235","534409","35","202804691","CTGGGCATGGTGGCACACGCCTGTAATCCCAGCTACCTGGGGAGCCGAGGCAGGAGAATCGCTTAAAGCTGGGAGGTGGAGGTTGCAGTGAGCCGAGATCATGTCATTGCATTCCAGCCTGGGGGACAAGAGCGAGACTTCATCTCTCAAAAAAAATAAAATAAAAATAAAAATAAAA","GCTGGGTGTGATGGCAGTCGACTTAATCCCAGCTATTTGGGAGACAGAAGCAGGAGAATCATTTGAACCCAGGAGGTGGAGGTTGCAGTGAGCTGAGATCAAGCCATTGCACTCACATCTGGGGGATAAGAGCGAGACTTCTCTCAAAAAAAAAAAAAAAAAAAAAAAAAAAAAA"
"chr4","2578915","2579210","KN294685v1","1269570","1269869","30","1309345","GCCAGGCGTGGTGGCTCACGCCTGTAATCCCAGCACTTTGGGAGGCCGAAGCGGGTGGATCACCTGAGGTCAGGAATTCGAGACCAGCCTGGCCAACATGGTGAAACTCTGTCTCTGCTAAAAATAGAAAAATTAGCCAAGCATGGTGGCAGGTGCCTGTAATCCCAGCTACTCAGGAGGCTGAGGCAGGAGAATTGCTTGAACCCAGGAGGTGGAGGTTGCAGTGAGCTGAGATCACACCATTGCACTCCAGCCTGGGGGACAAGAGTGAGACTTCGTCTCCAAAAAGAAAAAAA","GGCTGGGTGTGGTGGCTTAGGCCTGTAATCCCAGCACTTTGGGAGGCCAAGGCGGGCGGATCACCTGAGGTCAGGAGTTCGAGACCAGCCTGGCCAACATGGTGAAACCCCGTCTCTACTAAAAATACAAAAACTAGCCAGGCGTGGTGGCAGGTGACTGTAATCCCAGCTACTCGGGAGGCTGAGGCAGGAGAACTGCTTGAACCTGGGAGGCGGAGGTTGCAGTGAGCTGAGATCACACCATTGCACTCCAGCCTGGGGGACAAGAGCGAGACTTTGTCTCAAAAATAAAAAAAAAAA"
"chr4","11503580","11503895","KN297044v1","517135","517445","37","10986445","GGCTGGGCACAGTGGGTTCACACCTGTAATCTCAGCACTGTGGGAGGCCGAGGCGGGCTGATCACTTGTGGTCAGGAGTTCGAAACCAGCCTGGCCAACATGATGAAACCCAGTCTCTACTAAAATACACACAAATTAGCTGGGGGTGGTGGCAGGCAACTTAATCCCAGCTACTTGGGAGGCAGAGGCAGGAGAATCATTTGAACCCAGGAGGCGACAGTTGCAGTGAGCCAAGATCGAGCCATTGCACTGAAACCTGGGGGGGATAAGAGCAAGACTTCTCTACAAAAAAAAAAAAAAAAAAAAAAAAAAAAAA","GGCTGGGCGCAGTGGCTCATTCCTGTAATCCCAGCACTTTGGGAGGCCGAGGTGAGCGGATCACTTGAGGTCAGGAGTTCGAAACCAGCCTGGCCAACATGGTGAAACCCCGTCTCTACTAAAATATACAAAAATTAGCTGTGCGTGTGGCAGGCAACTTAATCCCAGCTACTTGGGAGGCAGAGGCGGGAGAATCGTTTGAACCCGGGAGACAGAAATTGCAGTGAGCTGAGATCGAGCCATTGCACTCGAACCTGGGGGATAAGAGCTAGACTTCTCTCAAAAAAAAAAAGAAAAGAAAAGAAAAGAAA"
"chr4","12328153","12328438","KN296743v1","2347268","2347551","51","9980885","GGCCGGGCACGGTGGCTGACGCCTGTAATCCCAGCACTTTGGGAGGCTGAGGCAGGTGGATCACCTGAGATCAGGAGTTCTAGACCAGCCTGGCCAACATGGTGAAACCCAGTCTCTACTAAAAACACAAAAATTAGCCAGGCATGCTGGCAGGTGCCTGTAATCCCAGCTACTTGGGAGGCCAAGGCAGGAGAATTGCTTGAGCCGAGATTGCACCATCACACTCCGGCCTGGGGGACAAGAGCGAGATTTCGTCTCAAAAAACAAAAAAAGAAAGAAAACAAAA","GGCCAGGCACGGTGACTCATGCATGTAATCCCAGCACTTTGGGAGGCCGAGGTGGGCGGATCACCTGAGGTCAAGAGTTCGAGACCAGCCTGGCCAACATGGTAAAACCCTGTTTCTACTAAAAATACAAAAATTAGCCAGGTGTGGTGGCAGTCGCCTGTAATCCCAGCTACTAGCTTGAATTTGGGAGGCGGAGGTTGCAGTAAGCTGAGATCGCACCATTGTACTCCAGCCTGGGGGACACGAGCGAGACTTCGTCTCAAAAAAAAAAAAAAAAAAAAAAA"
"chr4","12464176","12464489","KN294172v1","4419501","4419812","34","8044675","GGCCGGGCAGGGTGGCTCACGCCTGTAATCCCAGCACTTTGGGAGGCTGAGGTGGGCGAATCACCTGAGGTCAGGAGTTCGAGACCACCCTGGCCAACATTGGTGAAACCCTGTCTCTACTAAAAATACAAAAATTAGCTGGGCGTGGTGGCAGGCGCCTGTAATCCCAGCTACTCGGGAGGCTGAGGCAGGAGAATCGCTTGAACCCGGGAGCCGGAGGTTGCAGTGAGCCAAGATCGCACCATTGTACTCCAGCCTGGGGGACAAGAGCAAGAATTCATCTCCAAAATAAAAAATAAATAAATAAAAATAAA","GGCTGGGCGCAGTGGCTCACGCCTGTAATCCCAGCACTTTGGGAGGCCGAGGCAGGCGGATCACCTGAGGTCAGGAGTTTCAGACCAGCCTGGCCAACATGGTGAAACCCCGTCCCTACTAAAAATACAAAAATTAGCCGGGCGTGGTGGCAGGCACCTGTAATCCCAGCTACTCAGGAGGCTGAGGCAGGAGAATCACTTGAACCCCGGAGGCAGGGGTTGCGGTGAGCCGAGATCGCGCCACTGCACCCCAGCCTGGGGGACAAGAGCAAGACTTCATCTCAAAAATAAATAAATAAATAAAAATAAAAA"
"chr4","15392824","15393040","KN295430v1","12801","13030","44","15380023","GCAGTGTGCAGTGGCTCACATCTGTAGTCCCAGCACGCTGGGAGGCCGAGGCTAGTGGATCACTTGAGGTCAGGAGTTCTAGACCAGCCTGGCCAACATAGTGAAAACCTGTCTCTACTAAAAATATAAAAATTAGCCAGACATAGTGGCAGGCGCCTGTAATCCCAGCTGAGGCAGGAGAATTGCTTGAACCTGGGAGGCGGAGGTTGCAGTGAGC","GACCAGGTGTGGTGGCTCACACCTGTAATCCCAGCACTTTGGGAGGCCGAGAAGGGTGGATCACCTGAGGTCAGGTGTTCCAGACCAGCCTGGCCAACATGGTGAAACCCCATCTCTACTAAAAATACAAAAATTAGCCAGGCGTGGTGGCAGACACCTGTAGTCCCAGCTACTCCAGGGGCTGAGGCAGGAGAATCACTTGAACCTGGGAGGCAGAGGTTTGCAGTTAG"
"chr4","20781116","20781249","KN294269v1","66171","66308","14","20714945","GGCCAGGTGCAGTGGCTCACGCCTGTAATCCCATCACTTTGGGAGGCCGAGGCAGGTGGATCACCTGAGGTCAGGAGTTCCAGACCAACTGGGCCAACATGATGAAACCCCATGTCTACTAAAAACACAAAAAT","GGCCAGGTGCAGTGGCTCACGCCTGTAATCCCAGCACTTTTGGAGGCCGAGGCAGGTGGATCACCTGAGATCAGGAGTTCCAGACTAGCCTGGCCAACATGGTGAAACCCCATCTCTACTAAAAATACAAAAATTAGC"
"chr4","26273109","26273240","KN294269v1","66171","66308","15","26206938","GGCCAGGCGCAGTGGCTCACGCCTGCAATCCCAGCACTTTGGGAGGCTGAGGCGGGAGGATCACCTGAGATCAGGAGTTCCAGACCGCCTGGCCAACATGGTGAAACCCCGTCTCTACTAAAAAAAAAAAAA","GGCCAGGTGCAGTGGCTCACGCCTGTAATCCCAGCACTTTTGGAGGCCGAGGCAGGTGGATCACCTGAGATCAGGAGTTCCAGACTAGCCTGGCCAACATGGTGAAACCCCATCTCTACTAAAAATACAAAAATTAGC"
"chr4","27715146","27715231","KN294205v1","1346453","1346535","44","26368693","CCAACATGGTGAGAGCCCATCTCTACTAAAAATACAAAAATTAGCTGGGTGTGGTGGCAGACATCTGTAATCCCAGCTACTCTGGG","GTTGAGCACAGTGGCTCCTGCCTATAATTCCAGCACTTTAAAAGGCCAAGGTGGGTGGATCATTTGAGATCAGGAGTTCTAGA"
"chr4","32208122","32208383","KN297028v1","684783","685041","45","31523339","TTTGGGAGGCCGAGGAGGGCGGATCACCTGAAGTCAGGAGTTCGAGACCACCCTGGCCAACATGGTGAAACCCCGTCTCTGCTAAACATACAAAAATTAGCCAGGCATGTTGGCAGGCACCTGTAATCCCAGCTACTAGGTGGGCTGAGGCAAGAGAATCACTTGAACCTGGGAGGCGGAGGTTGCAGTGAGCCAAAATCACGCCATTGCACTGCAGCCTGGGGGACAAGAGTGAAACTTTGTCTCAAAAAAGAAAAAAAAA","GAGGCCAAGGTGGGCGGATCACCTGAGGTCAGGAGTTCGAGACCGGTCTGCCCAGCATGGTGAAACCCTGTCTTTACTAAAAATACAAAAATTAGCTGGCCTTGGTGGCTGGCGCCTGTAATCCCAGCTACTCAGGAGGCTGAGGCAGGAGAATCATTTGAACCTGGGAGACGGAGATTGCAGTGAGCCGAGATCATGCCATCGCATTCCAGCCTAGGGGACAAGAGCAAGATTTTGTCTCCAAAAAAAAGAAAAAAAA"
"chr4","40187531","40187744","KN296311v1","3342549","3342759","44","36844982","TTCGAGACCAGCCTGGCCAACACGGTGAAACCCTGTCTCTACTAAAAAATACAAAAATTAGCCAGGCGTGGTGGAAGGCACCTTAATCCCAGCTACTTGGGAGGCAGAGGCAGGAGAATCGTTTGATCCCAGGAGGCAGAAGTTGCAGTGAGCCGAGATCAAGCCATTGCACTCAAACCTGGGGGACAAGAGCAAGACTTCTCTCAAAAAAAAA","AGACCAGCCTGGCCAAAACCCTGTCTCTACTAAAAATACAAAAATTAGCCCGGCATGGTGGCAGGCACCTGTAACCCAACCCCAGCTACTTGGGGGGCTGAGGCAGGAGAATCGCTTGAACCCGGGAGGTGGAGGGTGCAGTGAGCCGAGATCGCGTCATTGCACTCCAGCCTGGGGATCAGGAGCAAGACTTCATCTCAAAAAAAAAAAA"
"chr4","42116617","42116911","KN295576v1","406337","406628","26","41710280","GGCCGGGCGCGGTGACTCACACCTGTAATCCCGGCACTTTGGGAGGCCGAGGTGGGTATATCACCTGTGGTAAGGAGTTCGAGACCAGCCTGGCCAACATGGTGAAAACCCGTCTCTACTAAAAATACAAAAATTAGCTGGGCGTGGTGGCAGGCGCCTATAATCCCAGCTACTCGGGAGGCTGAGGCAGGAGAATCGCTTGAACCCAGGAGGTGGAGGTTGCAGTGAGCCAAGATCACGCCATTGCACTCCAGCCTGGGGGAGAAGAGTGAGACTTCGTCTCAAAAAAAAAGAA","GGCCGGGCGCGGTGGCTCACGCCTGTAATCCCAGCACTTTGGGAGGCCGAGGCGGGCGGATCACCTGAGGTAAGGAGTTCGAGAACAGCCTGGCCAGCATGGTGAAACCCCATCTCTACTAAAAATACAAAAATTAGCCGGGCATGGTGGCAGGTGCCTGTAATCCCAGCTACTCGGGAGGCTGAGGCAGAAGAATCGCTTGAACCCAGGAGGCGGAGGTTGCAGTGAGCCGAGATTGCGCCATTGCACTCCAGCCTAGGGGAGAAGAGCGAGACTTCGTCTCAAAAAAAAA"
"chr4","42604764","42605076","KN295907v1","1531171","1531479","37","41073593","GGCTGGGCGTGGTGGCTCACGCCTGTAATCCCAGCACTTTGGGAGGCCAAGATGGGTGGATCACCTGAGGTCAGGAGTTCGAGACCAGCCTGGCCAACACGGCAAAAACCCATCTCTACTAAAAATACAAAAATTGGCTGGGCGTGGTGGCGGGCACCTGTAATCCCAGCTACTCAGGAGGCTGAGGCAGGACAATAGCTTGAACCCAGGAAGTGGAGGTTGCAGTGAGCTGAGATCACGCCATTGTACTCCAGCCTGGGGGACAAGAGCGAGACTTCATCTCAAAAAACAAACAAACAAACAAACAACAAAA","GGCTGGGCGTGGTGGGTCATGCCTATAATCCAAGCACTTTGGGAGGCCGAGATGGGTGGATCACCTGAGGTCAGGAGTTCGAGACCAGCCTGGCCAACATGGTGAAACCCTGTCTCTACTAAAAATACAAAAATTACCGGGCATGGTGGCACACGCCTGTAATCCCAGCTACTCGGGAGGCTGAGGCAGGAGAATCGCTTGAACCCAGGAGGCGGAGGTTACATTGAGCTGAGATCGTGCCATTGTACTCCAGCCTAGGGGACAAGAGTGAGACTTCGTCTCAAAAAAAAAAAAAAAAAAAAAAAAAAA"
"chr4","44375012","44375318","KN296387v1","301235","301539","65","44073777","GCTGGGGGCAGTGGCTCACACCTATAATCCCAACACTTTGGGAGGCCAAGGTGGGTTGATCACCTGAGGTCAGGAGTTCGACCAGCTTGACCAACATGACGAAATTCCATCTCTACTAAAAATACAAAAATTAGCTGAGTGTGGAGGCAGGCGCTTGTAATCCCAGCTACCTGGGAGAACTGCTTGAACCCAGGAAGTGGAGGTTGCAGTAAGCCAAGATCGTGCCATTGTACTCCAGCCTGGGCTGGAGTACAGCCCAGGAGCAAGACTCTATCTCAAAAAAAAAAACAAGGAATAAAAAAATAAA","GGCTGGGCGCGGTGGCTCACACCTGTAATCCCAGCACTTTGGGAGGCCGAGGTGGGTGAATCACCTGAGGTCAGGAGTTCGAGACCAGCCTGGCCAACATGGTGAAACCCCATATCTACTAAAAATACAAAAATTAGCCAGGTGTGGTGGCAGGCGCCTATAATCCCAGCTGCTTGGGAGCCTGAGGCAGGAGAATCGCTTGAACCTGGGAGGCGGAGGTTGCAGTGAGCCAAGATCGTGCCATTGCACTCCAGCCTAGGGGACAAGAGTGAGACTAATCTCAAAAAAAAAAAAAAAAAAAAAAA"
"chr4","47318337","47318633","KN296191v1","251635","251928","50","47066702","GCCAGGCGCAGTGGCTCACATCTGTAATCCCAGCACTTTGAGAGGTCTGNNNNNNNNNNNNNNNNNNNNCGAGGTCAGGAGTTCGAGACCAGCCTGGCCAACATGGTGAAACCTGTCTCTACTAAAAATACAAAAATTAGCCAGGCGTGGTGGCAGCTGCCTGTAATCCCAGCTACTCGGGAGGCTGAGGCAGGAGAATCACTTGAACCCAGGAGGCAGAGGTTGCAGTGAGCTGAGATCGCGCCATTGCACTCCAGTCTGGGGGACAAGAGTGAGACTTTGCCTCAAAAAAAAAAA","GGCCAGGCACGGTGGCTCATGCCTGTAATCCCAGCACTTTGGGAGACTGAGGTGGGTGGATCACCTGAGGTCAGGAGTTTGAAACCAGCCTGGCCAGCATGGTGAAACCCTGTCTCTACTAAAAATACAAAAATTAACCAGGCGTGGTGGCAGGCGCCTGTAATCACAGCTACTCAGGAGGTTGAGGCAGGAGAATCACTTGAACCCAGGAGGCAGAGGTTGCAGTGAGCCGAGATCGTGCCATTGCACTCTAGCCTAAGGGACAAAAATAAGACTTTGTCTCAAAAAAAAAAA"
"chr4","47706006","47706300","KN296110v1","161644","161937","40","47544362","GGCCGGGCACAGTGGCTCACGCCTGTAATCCCAGCACTTTGGGAGGCTGAGGTGGGTGGATCACCTGAGGTCAGGAGTTCTAGACCAGCCTGGCCAACATGGTGAAACCCCATCTCAAACTAAAAAAAAAAAAAAAAAATTAGCTGGGCGTGGTGGCAGGCGCCTGTAATCCCAGTTACTTGGGGGGCCAAGGCAGGAGAATCACTTGAACCCGGGAGGCGGAGGTTGCAGTGAGCCAAGATCGCGCCATCGCACTCCAGCCTGAGGGAAAAGAGTGAGACTTTGTAAAAATAAA","GGCCGGGCGCAGTGGCTCACGCCTGTAATCCCAGCACTTTGGGAGGCTGAGGTGGGTGGATCACCTGAGGTCAGGAGTTCTAGACCAGCCTGGCCAACATGGTAAAACCCGGTTTCTACTAAAAATACAAAAATTAGCCGGGCATGGTGGCAGGTGCCTATAATCCCAGCTACTCGGGGGGCCGAGGCAGGGGAATCGCTTGAACCAGGGAGTCGGAGGTTGCAGTGAGCCAAGATCATACCATCGCACTCCAGCTTGGGGGACAAGAGCGAGATTTCATCTCAAAAAAAAAAA"
"chr4","51174617","51174852","KN295533v1","2708510","2708735","35","48466107","GAGTTCGAGACCAGCCTGCCAACATGGTGAAACCCCATCTCCACTAAAAGTACAAAAATTAGCTGGGTGTGGTGGCAGGCCCCTGTAATCCCAGCTACTTGGGAGGCTGAGGCAGGAGAATGGCTTGAACCCAGGAGGCGGAGGTTGAAGTGAGCCGAGATCGTGCTATTGCACTCCAGCCTGGGGGACAAGAGTGAGACTTCATCTCAAAAAAATAAATAAATAAAAAATAAAAA","GCCTGGCCAACATGGTGAAACCCCATCTCTACTAAAAATACAAAAATTAGCTGGGTGTGGTGGCGGGCGCCTGTAATCCCAGCTACTCAGATGGCTGAGGCAGGAGAATGGCGTGAACCCGGGAGGCGGAGGTTGCAGTGAGCCGAGATCAAGCCATTGCACTCCAGCCTGGGGGACGAGAGCGAGACTTTGTCTCAAAAAAAAATAAATAAATAAAAATAAATAA"
"chr4","51355557","51355620","KN294457v1","203850","203915","14","51151707","GAGATCACGCCATTGCACTCCAGCCTGGGGGACAAGAGTGAGACTCCATCTCAAAAAAAAAAAA","GATCACTCCATTGCACTCCAGCCTGGGGGATTAGAGCAACACTTCGTCTCAAAAAAATAAAATAAA"
"chr4","52181730","52182031","KN294713v1","906670","906972","34","51275060","GGCCGGGTGCGGTGGCTCACGCCTGTAATCCCAGCACTTTGGGAGGCCGAGGCGGGTGGATTGCCTGAGGTCAGGAGTTCGAGACCAGCCTGGCCAACATTGTGAAACCCCATCTCTACTAACAATACAAAAATTAGCCGGGCATAGTGGCAAGAGCCTGTAATCCCAGCTCCTTGGGCGGCTGAGGCAGGAGAATCACTTGAACCCAGGAGGTGGAGGTTACAGTGAGCCAAGATCACGCCACTGCACTCCAGCCTGGGGGACAAGAGAGAGACTTCATCTCAAAAAAAGAAAAAAAGAAA","GGCCGGGTGCAGTGGCTCAAGCCTGTACTCCCAGCACTTTGGGAGGCCGAGGCGGGCGGATCACCTGAGGTCGGGAGTTCGAGACCAACCTGGTCAACATGGTGAAACCCCTTCTCTACTAAAAACACAAAAATTAGCCGGTCATGGTGGCAGGTGCCTGTAATCCCAGCTACTCGGGAGGCTGAGGCAGGAGAATCGCTTGAACCCTGGAGGCAGAGATTGCAGTGAGCCGAGATCGCACCATTGCACTCCAGCCTGGGGGACAAGAGTGAGACTTCATCTCAAAAAAAAAAAAAAAAAAAA"
"chr4","52905970","52906276","KN296541v1","476659","476959","25","52429311","GGCCGGGCGCAGTGGCTCATGCCTGTAATCCCAACACTTTGGGAGGCCGAGGCGGGTGGATCACCTGAGGTCAGGAGTTCGAGACCAGCCTGGCCAACATGGTGAAACCCTGTCTCTACTAAAAAATACAAAAATTAGCCAGGCGTGGTGGTAGGCATCTGTAATCTCAGCTACTCGGGAGGCTGAGGCAGGAGAATCACTTGAACTCAGGAGGCAGAGGTTGCAGTGAGCCGAGATCGCGCCATTGCACTCTAGCCTGGGGGACAAGAGCGAGACTTCGTCTACAAAAAAAAAAAAAGAAGAAGAA","GGGCTGACGTGGTGACTCATGCCTGTAATCCCAGCACTTTGGGAGGCCGAGGCAAGTGGATCACCTGAGGTCAGGAGTTCGAGACCAGCCTGGCCAACATGGTGAAACCCAGTCTCTACTAAAAATACAAAAATTAGCCAGGCGTGGCGGTAGGCACCTGTAATCCCAGCTACTCGGGAGGCTGAGGCAGGAGAATCACTTGAACTCGGGAGGCGGAGGTTGCAGTGAGCCGAGATCACGCCATTGCACTCCAGCCTGGCGGACAAGAGCGAGACTTTGTCTCAAAAAAAAAAAAAAAAAA"
"chr4","54193230","54193515","KN296743v1","2347268","2347551","42","51845962","GGCCGGGTGCAGTGGCTCACGCCTGTAATCCCTGCACTTTGGGAGGCCGAGGTGGGCGGATCACCTGAGGTGAGGAGTTCGAGACCAGTCTGGCCAACATGGTGAAACTCCATCTCTACTAAAAATACAAAAATTAGCCAGGCGTGGTGGCAGGCGCCTGTAATCCCAGCTACTCAGGAGCTCTGAACCCGGGAGGCGGAGGCTGCAGTAGGCTGAGTTTGCACCATTGCACTCCAGCCTGGGGGACAAGAGCGAGACTTTGTCTTTAAGAAAAAAGTTAAAAAAA","GGCCAGGCACGGTGACTCATGCATGTAATCCCAGCACTTTGGGAGGCCGAGGTGGGCGGATCACCTGAGGTCAAGAGTTCGAGACCAGCCTGGCCAACATGGTAAAACCCTGTTTCTACTAAAAATACAAAAATTAGCCAGGTGTGGTGGCAGTCGCCTGTAATCCCAGCTACTAGCTTGAATTTGGGAGGCGGAGGTTGCAGTAAGCTGAGATCGCACCATTGTACTCCAGCCTGGGGGACACGAGCGAGACTTCGTCTCAAAAAAAAAAAAAAAAAAAAAAA"
"chr4","54290157","54290452","KN296110v1","161644","161937","33","54128513","GGCCGGGCGCAGTGGCTCACGCCTGTAATCCCAGCACTTTCGGAGGCCGAGGCGGGTGGATCACCTGAAGTCAGGAGCTCTAGACGAGCTTGGCCAATATGGTGAAACCCTGTCTCTACTAAAAATACTAAAATTAGCCGGGCATGGTGGCAGGTGCCTGTAATCCCATCTTTTCAGGGGGGCCGAGGCAGTAGAATCACTTGAACCCAGGAGGCGGAGGTTGCAGTGAGCCGAGATCGCATTGTCGCACTCCAGCCTGGGGGACAAGAGCGAGACTTCGTCTCAAAAAAAAAAAA","GGCCGGGCGCAGTGGCTCACGCCTGTAATCCCAGCACTTTGGGAGGCTGAGGTGGGTGGATCACCTGAGGTCAGGAGTTCTAGACCAGCCTGGCCAACATGGTAAAACCCGGTTTCTACTAAAAATACAAAAATTAGCCGGGCATGGTGGCAGGTGCCTATAATCCCAGCTACTCGGGGGGCCGAGGCAGGGGAATCGCTTGAACCAGGGAGTCGGAGGTTGCAGTGAGCCAAGATCATACCATCGCACTCCAGCTTGGGGGACAAGAGCGAGATTTCATCTCAAAAAAAAAAA"
"chr4","55239680","55239989","KN294665v1","91019","91314","46","55148661","GCCGGGCATGGTTGCTCACGCCTGTAATCCCAGCACTTTGGGAGGCCGAGGTGGATCTCCTGAGGTCAGGAGTTCGAGACCAGTCTAGCCAACATGGTGAAACCCCATCTCTACTAAAAAAAACCACAAAAAATTAGCTGGGTGTGGTGGCAGGTGCCTGCAATCCCCAGCTACTTGGGAGGCTGAGACAGGAGAATTGCTTGAACCTGGAGGCAGAGGTTGCAGTGAGCAGAGATCACGCCATTGCACTCCAGCCTGGGGGACAAGAGCAAGATTTTGTCTCAAAAAAAATAAATAAATAAAAATAAAA","CTGGGCACGGTGGCTCATGCCTGTAATCCCAGCATTTTGGGAGGCCGAGGCGGATCACCTGAGGTCAGGAGTTCGAGACCAGCCTGGCCAACATGGTGAAACCCTGTCTCTACTAAAAAATACAAAAATCAGCCGGGTGTGGTGGCAGGCGCCTTAATCCCAGCTACTTGGGAGGCATAGGCAGGAGAATCGTTTGAACCCAGGAGGCAGAGGTTGCAGTGAGTCGAGATCAAGCCATTGCACTCAAACCTGGGGGACAAGAGCGAGATTTCTCTCAAAAAAAAAAAAAGAAAAAA"
"chr4","56844805","56844902","KN296825v1","1656571","1656656","27","55188234","GCAGAGGTTGCTGTGAGCCAAGATAGCGCCATTGCACTCACGCCTGGAGGGACGAACAAGAGACTAGTACCTTCCTCTACAAAAAAAAAAAAAAAAAA","GGCGGAGGTTGCAGTGAGCTGAGATCGCGCCACTGCACTGGGGGACAAGAGCGAGACTTCGTCTCAAAAAAAAAAAAAAAAAAAAA"
"chr4","59303292","59303589","KN295576v1","406337","406628","29","58896955","GGCCAGGCACGGTGGCTCATGCCTGTAATCCCAGCACTTTGGGAGGCCGAGGCGGGTGGATCACCTGAGGTCAGGAGTTCGAGACCAGCCTGGCCAATATGGTGAAACCCCGCCTCTACAAAAAATACAAAAAAAATTAGCCAGGCATGGTGGCAGGCGCCTGTAATCCCAGTTACTCGGGAGGCTGAGGCAAGAGAATCGCTTGAACCCAGGAGGCAGAGGTTGCAGAGAGCCGAGATTGCGCCATTGCACTCTTGCCTGGGGGACAAGAGCGAGACTTCATCTCAAAAAAACAAAA","GGCCGGGCGCGGTGGCTCACGCCTGTAATCCCAGCACTTTGGGAGGCCGAGGCGGGCGGATCACCTGAGGTAAGGAGTTCGAGAACAGCCTGGCCAGCATGGTGAAACCCCATCTCTACTAAAAATACAAAAATTAGCCGGGCATGGTGGCAGGTGCCTGTAATCCCAGCTACTCGGGAGGCTGAGGCAGAAGAATCGCTTGAACCCAGGAGGCGGAGGTTGCAGTGAGCCGAGATTGCGCCATTGCACTCCAGCCTAGGGGAGAAGAGCGAGACTTCGTCTCAAAAAAAAA"
"chr4","59907084","59907384","KN294685v1","1269570","1269869","34","58637514","GGCTGGGCACGGTGGCTCATGCCTGTAATGCCAGCACTTTGGGAGGCCGAGGCGGGTGGATCACCTGAGGTTAGGAGTTTGAGACAAGCCTGGCCAACATGGTGAAACCCCGTCTCTACTAAAAATACAAAAATTATCCAGGCATGGTGGCAGGTGCCTGTAATCCCAGCTACTCGGGAGGCTGAAGCAGGAGAATCACTTGAACCCGGAAGGTGGAGGTTGCAGTCAGCCAAGATCATGCCATTGCTGCACTCCAGCCTGGGGGACAAGAGTGAGACTTTCTCAAAAAAAAAAAAAAAAA","GGCTGGGTGTGGTGGCTTAGGCCTGTAATCCCAGCACTTTGGGAGGCCAAGGCGGGCGGATCACCTGAGGTCAGGAGTTCGAGACCAGCCTGGCCAACATGGTGAAACCCCGTCTCTACTAAAAATACAAAAACTAGCCAGGCGTGGTGGCAGGTGACTGTAATCCCAGCTACTCGGGAGGCTGAGGCAGGAGAACTGCTTGAACCTGGGAGGCGGAGGTTGCAGTGAGCTGAGATCACACCATTGCACTCCAGCCTGGGGGACAAGAGCGAGACTTTGTCTCAAAAATAAAAAAAAAAA"
"chr4","71174631","71174908","KN294372v1","1494160","1494444","42","69680471","GACCAGGCATGGTGGCTCACACATGTAATTCCAGCACGTTGGGAGGCCAAGGCAGATGAATCACCTGAGGTCAGAAGTTCGAGACCAGCCTGGCCAACATAGTGAAACCCCGTCTCTACTAAAAATACAAAAATTAGCCAGGCGTGGTGGCGGGCACTTGTAATCCCAGCTACTCCGGAGGCTGAGGCAGGAGAATCACTTGAACCCGGGAGGCGGAAGTTGCACTGAGCCGAGATCGCGACATTAAAATCCAGCCTGGGGGACAAGAGCGAGACTTC","GGCCAGGCGTGGTGGCTCACACGTATAATCCCAGCACTTTGGGAGGCCGAGGCGGGTGGATCACCTGAGGTCAGGAGTTTGAGACCAGCCTGACCAACATGGTGAAACCCCATCCCAACTAAAAATACAAAAATTAGCTGGGCGTGGTGGCAGGCGCCTGTAATCCTAGCTACTCTGGGGGCCGAGGCAGGAGAATCGCTTGAACCCGGGAGGCGGAGGTTGCAGTGAGCCAAGATAGCACCATTACAAACCAGCCTGGGGGACAAGAGCGAGACTTCCTCTCAA"
"chr4","96650415","96650764","KN295592v1","1804108","1804419","69","94846307","GGTGGGGCGCAATGGCTCACGCCTGTAATCCCAGCACTTTGGGAGGCTGAGGCAGGCAAATCACCTGAGGTCAGGAGTTCGAGACCAGCCTGGCCAACATGGTGAAACCCTGTCTCTACTAAAAATATAAAAATTAGCCAGACGTGGTGGCAGGCGCCTGTAATCTCAGCTACTCGGGAGGCTGAGGCAGGATAATCNNNNNNNNNNNNNNNNNNNNGGGCTGAGGCAGGATAATCACTTGAACTCAGGAGGCAGAGGTTGCAGTTAGCCAAGATTGTGCCATTGCACTCCAGCCTAGGGGACAAAAGCAAGACTTCATCTCAAAAAAAAAAAAGAAAGAAAGAAAGAAA","GCTGGGCACAGTGGCTCACACCTGTAATCCCAGCACTTTGGGAGGCTGAGGTGGGTGGATCACCTGAGGTCAGGAGTTTGAGACCAACCTGGCCAACATGGTGAAACCCCGTCTCTACTAAAAATGCAAAAATTAGCCAGGCATGGTGGCAGGTGCCTGTAATCCCAGCTACTCGAGAGGCTGAGGCCCTGAGGAGAATCACTTGAACCCAGGAGGTGGAGGTTGCAGTGAGCCGAGATTGTGCCATCGCACTCCAGCCTGGGGGACAAGAGCAAGACTTCGTCTCAAAAAAAAAGAAAAAAAAAAAAAAAA"
"chr4","112673988","112674291","KN297398v1","85283","85580","32","112588705","GGCCGGGCATGGTGGCTCATGCCTGTAATCCCAGCACTTTGGGAGGCCAAGGCAGGTGGATCACCTGGGGTCTGGAGTTTGAGAACAGCCTGGCCAACTTGGTGAAACCCTGTCTCTACTTAAAATACAAAAATTAGCCGGGCGTGGTGGCAAGCACCTGTAATCCCAGCTACTCAGGAAGCTGAGACAGGAGAATTGCTTGAACCCGAGAGGCAGAGGTTGCAGTGAGCCAAGATCGCGCCATTGCACTCCAGCCTGGGGGACAAGAGTGAGACTTTGAGAAGAAAAAAAGAAAGAAAGGAAA","GGCTGGGCATGGTGGCTCATGCCTGTAATCCCAGCACTTTGGGAGGCCGAGGCAGGTGGATCACCTAGGGTCAGGAGTTCGAGACCAGCCTGGCCAACATGGTGAAACCCAGTCTCCACTTAAAATACAAAAACTAGCCACGCATGGTGGCAGGCACCTGTAATCCTAGCTACTCGGGAGGCTGAGACAGGAGAATTGCTTGAACCCGGGAGGCGAAGGTTGCAGTGAGCCAAGATCGTGCCATTGCACTCCAGCCTGGGGGACAAGAGCAATACTTTGAGGAGAAAGAAAAGAAAAA"
"chr4","114160339","114160666","KN296974v1","258695","259015","44","113901644","GGCCAGGCGCGGTGGCTCACGCCTGTAATCCCAGCACTTTGGGAGGCCTAGGCCAGTGGATCACCTGAGGTCAGGAGTTCTAGAACAGCATAGCCAACATGGTGAAACCCCGTCTCTACTAAAAATACTAAAATGAGCCAGGCGTGGTGTCAGGCGCCTGCAATCCCAGCTACTCGGGGATGGAGCGGGTGGGGGGCCGAGGCAGGAGAATCGCTTGAACCCGGGAGGCGGAGGTTGCAGTCAGCTGAGATCGCGCCTTCGCACTCCAGCCTGGGGGACAAGAGCAAGACTTCGTCTCAAAAAAAAAAAGAAAAGAAAACAAAANAAA","GACTGGGCGCGGTGGTTCACGCCTGCAATCCCAGCACTTTGGGAGGCCGAGGTGGGTGGATCACCTGAGGTCAGGAGTTCTAGACCAGCCTGGCCAACATGGTGAAAGCCCATCTCTACTAAAAATACAAAAATTAGCCAGGCGTGGTGGCAGGTGCTTGTAATGCCAGCTACTCAGGTTGGGGGAGGGGCAGGGCCGGAGAATTGCTTGAACCCGGGAGGCGGAGGTTGCAGTAAGCTGAGATCACGCCATTGCACTCCAGCCTGGGGGACAAGAGCGAGACTTCATCTCAAAGAAAAAAAAGAAAGAAAAAAAAAAAAA"
"chr4","115466796","115467098","KN296541v1","476659","476959","35","114990137","GGCCAGGCACTATGGCTCATGCCTGTAATCCCAGCACTTTGGGAGGCCGAAGCGGGTGGATCACCTGAGGTCAGGAGTTCGAGACCAGCCTGGACAACATGATGAAACCCCATCTCTACTGAAAACTACAAAAATTAGCCAGGCGTGGTGGCAGCCGCCTGTAATCCCAGCTACTTAGGAGGCTGAGGCAGGAGAATCACTTGAACTCCGGAGGTGGAAGTTGCAGTGAGGTGAGATCACGCCATTGTACTCCAGCCTGGGGCACAAGATCAAGACTTCGTCTACAAAAAAAAAAAAAAAAAA","GGGCTGACGTGGTGACTCATGCCTGTAATCCCAGCACTTTGGGAGGCCGAGGCAAGTGGATCACCTGAGGTCAGGAGTTCGAGACCAGCCTGGCCAACATGGTGAAACCCAGTCTCTACTAAAAATACAAAAATTAGCCAGGCGTGGCGGTAGGCACCTGTAATCCCAGCTACTCGGGAGGCTGAGGCAGGAGAATCACTTGAACTCGGGAGGCGGAGGTTGCAGTGAGCCGAGATCACGCCATTGCACTCCAGCCTGGCGGACAAGAGCGAGACTTTGTCTCAAAAAAAAAAAAAAAAAA"
"chr4","115707415","115707585","KN296290v1","476549","476739","46","115230866","GCCAGGTGCGGTGGCTCAAACCTCTAATCCCAGCACTTTGGGAGGGCGAGGAGGGAGGATCACCAGAGGTCAGCCTGGCCAACATGGCAAAGCCCCTTCTCTACTAAAAATATAAAAATTGCCTGGTGCAGTGGCTCATGTCTGTAATCCCAGCACTTTGGGGGGCCAAGG","GCCAGGTGTGGTGGCTCATGCCTGTAATCCCAGCACTTTGGGAGGCTGAGGTGGGTGGATCACCTGAGGCCAGGAATTCTAGACCAGGCTGGCCAACATGACAAAACCCCATCTCCACTAAAAATACAAAAAATTAGCCAGTCATGGTGGCAGGTGCCTGTAATCCCAGCTACTTGGGAGGCTGAGGCAGG"
"chr4","119458358","119458417","KN294457v1","203850","203915","18","119254508","GATTGTACCACTACACTTCAGCCCAGGGGATAGAGAGACACTTGGTCTCAAAAAAAAAAA","GATCACTCCATTGCACTCCAGCCTGGGGGATTAGAGCAACACTTCGTCTCAAAAAAATAAAATAAA"
"chr4","125478407","125478707","KN296541v1","476659","476959","33","125001748","GGCTGGGCGTGGTGACTCATGCCTGTAATCCCAGCACTTTGGGAGGCCGAGGCAGGTGGATCACTTGAGGTCAGGAGTTCGAGACCAGCCTGGCCAACATGGTGAAACCCTGTCTCTACTAAAAATACAAAAAAAAAAAATATGTCGGGTGTGGTGGCAGGCACTTGTAATCCCAGCTACTCGGGAGGCTGAGGCAGGAGAATCACTTGAACCCGGGAGGCAGAGTTTGCAGTGAGCTGAGATCACGCCATTGCGCTCCAGCCTGGGGGACAAGAGCGAGACTTTGTCTCAAAAAAAAAAA","GGGCTGACGTGGTGACTCATGCCTGTAATCCCAGCACTTTGGGAGGCCGAGGCAAGTGGATCACCTGAGGTCAGGAGTTCGAGACCAGCCTGGCCAACATGGTGAAACCCAGTCTCTACTAAAAATACAAAAATTAGCCAGGCGTGGCGGTAGGCACCTGTAATCCCAGCTACTCGGGAGGCTGAGGCAGGAGAATCACTTGAACTCGGGAGGCGGAGGTTGCAGTGAGCCGAGATCACGCCATTGCACTCCAGCCTGGCGGACAAGAGCGAGACTTTGTCTCAAAAAAAAAAAAAAAAAA"
"chr4","126086935","126087221","KN295941v1","1108709","1108994","30","124978226","GGCTGGGTGCGATGGCTCACGCCTGTAATCCCAGCACTTTGGGAGGCCAAGGCGGGTGGATCACCTAAGGTCAGGAGTTCGAGACCAGCCTGGACAACATGGTGAAACCCCATCTCTACTAAAAATACAAAAAGTAGCCAGCCGTGGTGGCAGGCACCTGTAATCCCAGCTACTTGGGGGGCTGAGGCAGGAGAATCGCTTGAACTTGGGAGGCGGAGGTTGCAGTGAGCCGAGATCGTGCTATTGCACTCCAGCCTGGTGGACAAGAGTGAGACTTTGTCTGAAAA","GCCGGGTGCTTTGGCTCACGCCTGTAATCCCAGCACTTTGGGATGCCGAGGCGGGTGGATCACCTGAGGTCAGGAGTTTGAGACCAGCCTGGCCAACATGGTGAAACCCTGTCTCTACCAAAAATACAAAAATTAGCCGGGCGGGGTGGCAGGCGCCCGTAATCCCAGCTACTCGGAAGGCTGAGGCAGGATAATCGCTTGAACCTGGGAGGCGGAGGTTGCAGTGAGCCGAGATCGCACCATTGCACTCCAGCCTGGGGGACAAGAGCGAGACTTCGTCTCAAAA"
"chr4","128942055","128942355","KN296311v1","7924000","7924299","37","121018055","GGCCAGGCACGGTGGCTCATGCCTGTAATCCCAGCACTTTGGGAGGCTGAGGCGGGTGGATCACCTGAGGTCAGGAGTTCTAGACCAGCCTGGCCAACATGGTAAAACCCCATCTCTACTAAAAATACAAAAATTAGCTGGGTGTAGTTGTATTCGCCTGTAATCCCAGCTACTCAGGAGGCTAGGGTAGGAGAATCCTTTGAACCTGGGAGGCAGAGGTTGCAGTAAGCCAAGATCGTGCCATTGCACTCCAGCCTGGGGACAAGAGAGAGACTTTATAGTCAAAAAAAAAAAAAAAGAA","GGCCAGGCGCGGTGGCTCACACCTGTAATCCCAGCACTTTGGGAGGCTGAGGCAGGTGGATCGCCTGAGGTCAGGAGTTCTAGACCAGCCTGGCCAACATGGTGAAACCCCGTCTCTACTAAAAATACAAAAATTAGCCAGGTGTAGTGGCAGGCACCTGTAATCCCAGCTACTCAGGAGGCTGAGGCAGGAGAATTGCTTGAACCCAGGAGGCAGAGGTTGCAGTGAGCCGAGATCGCACCATCGCACTCCAGCCTGGGGCAGAAGAAATCTTTTTTCTTAAAAAAAAAAAAAAAGAAA"
"chr4","131034277","131034584","KN295205v1","907038","907347","34","130127239","GGGTGCAGTGGCTCACACCTGTAATCCTAGCACATTGGGAGGCCGAGGTGGGTGGATCACCTGAGGTCAGGAGTTCTAGACCAGCCTGGCCAACATGGTGAAACCCCGTCTCAACTAAAAATACAAAAATTAGCTGGGCATGGTGGCAGGCACCTGTAATCCCAGCTACTCAGGGGGCCGAGGCAGGAGAATCACTTGAACCTGAGAGGCAGAGGTTGCAGTGAGCCAAGATTGTGCCATAGCACTCCAGCCTAGGGACAAGAGCAAGACTTCATCTCTAAAAAAAAAAAAAAAAAGCAGAAAGAAAA","CCGGGTGCAGTGGCTCACACCTGTAATCCCAGCACTTGGGGAGGCCGAGGTAGGTGGATCACTTGAGGTCAGGAGTTCAAAACCAGGCTGGCCAACATGGTGAAACCCTGTCTCTACTAAAAGTACAAAAATTAGCTGGGCATGGTGGCAGGCACCTGTAATCCCAGCTACTCAGGAGGCTGAGGTAGGAGAATCACTTGAACCCAGGAGACGGAGGTTGCAGTGAGCCAAGATTGCACCACTGCACTCTAGCCTGGGGGACAAGAGCGAGACTTCATCTCAAAAAAAAAAAAAAAGAGAAAAAGAAAAA"
"chr4","138749391","138749524","KN297263v1","890000","890133","28","137859391","CTACTTGGGAGGCAAAGGCAGGAGAATCGTTTGAACCCAAGAGGTGGAGTTTGCAGTGAGCCGAGATCGATCGAGCCATTGCACTCAAGCCTGGAGGACAAGAGCAAGACTTCTAAAAAAAAAAAAAAAAAAAA","AGCTATTCAGGAGGCTGAGGCAGGAGAATCGCTTCAACCCGGGAGGCAGAGGTTGCAGTGAGCCGAGATCGCACCATCACACTCCAGCCTTGGGGACAAGAGCGAGACTTCATCTCAAAAAAAAAAAAAAAAAA"
"chr4","139309736","139309788","KN294269v1","1390365","1390426","24","137919371","GTGGCTGACACCTCTAATCTCAGAACTTTGGGAGGAAGAGGCAACAATCACCT","GACCAGGTGCTGTGGCTCATGCCTGTAATCCCAGCACCTTGGGAGGCTGAGGCGGATTCACC"
"chr4","139459433","139459750","KN294685v1","1269570","1269869","48","138189863","GGCTGGGCACGGTGGCTCACGCCTGTAATCCCAGCACTTTGGGAGGCCAAGTGGGTGGATCACCTGAGGTCAGGAGTTCGAGATCAGCCTGGCCAACATGGTGAAACCTCATCTCTACTAAAAATACAAAAAAAAAAAAAACCAAAAAAAATTAAGCCAGGCGTGGTGGCAGGTGCCTGTAATCCCAGTTACTCGGGAGGCTGAGGCAGGAGGATTGCTTAAACCCAGGAGGTTGAGGTTGCGGTGAGCTGAGATCACGCCATTGCACTCCAGCCTGGGGGACAAGAGTGAGACTTCATCTAAAAAAAAAAGAAAAAA","GGCTGGGTGTGGTGGCTTAGGCCTGTAATCCCAGCACTTTGGGAGGCCAAGGCGGGCGGATCACCTGAGGTCAGGAGTTCGAGACCAGCCTGGCCAACATGGTGAAACCCCGTCTCTACTAAAAATACAAAAACTAGCCAGGCGTGGTGGCAGGTGACTGTAATCCCAGCTACTCGGGAGGCTGAGGCAGGAGAACTGCTTGAACCTGGGAGGCGGAGGTTGCAGTGAGCTGAGATCACACCATTGCACTCCAGCCTGGGGGACAAGAGCGAGACTTTGTCTCAAAAATAAAAAAAAAAA"
"chr4","141366610","141366675","KN294457v1","203850","203915","16","141162760","GCGCCACTGCACTCCAGCCTGGGGGACACAGAGCAAGACTCCGTCTCAAAAAAAAAAAAAAAAAAA","GATCACTCCATTGCACTCCAGCCTGGGGGATTAGAGCAACACTTCGTCTCAAAAAAATAAAATAAA"
"chr4","141844555","141844850","KN295576v1","406337","406628","31","141438218","GGTCCGGCACGGTGGCTCATGCCTGTAATCCCAGCACTTTGGGAGGCTGAGGCGGGCGAATCACCTGAGGTCAGGAATTCGAGATCAGCCTGGCCAACATGGTGAAACCCTGTCTCAACTAAAAATACAAAAATTAGCCGGGCGTGGTGGCAGGCGCCTGTAATCCCAGCTACTCGGGAGGCTGAGGCAGGAGAATCACTTGAACCCAAGGGGCAGAAGCTGCAGTGAGCCAAGATCGCATCATTGCACTCCAGCCTAGGGGACAAGAGCGAGACTTCGTCTACAAAAAAAAAAAA","GGCCGGGCGCGGTGGCTCACGCCTGTAATCCCAGCACTTTGGGAGGCCGAGGCGGGCGGATCACCTGAGGTAAGGAGTTCGAGAACAGCCTGGCCAGCATGGTGAAACCCCATCTCTACTAAAAATACAAAAATTAGCCGGGCATGGTGGCAGGTGCCTGTAATCCCAGCTACTCGGGAGGCTGAGGCAGAAGAATCGCTTGAACCCAGGAGGCGGAGGTTGCAGTGAGCCGAGATTGCGCCATTGCACTCCAGCCTAGGGGAGAAGAGCGAGACTTCGTCTCAAAAAAAAA"
"chr4","142943533","142943822","KN295576v1","406337","406628","29","142537196","GGCCAGGCATGGTGGCTCACATCTGTAATCTCAGCACTTTGGGAGGCCGAGGCGGGTGGATCACCTGAGGTCAGGAGTTCGAGACCAGCCTGGCCAACATGGTGAAACCTCATCTCTACTAAAAATACAAAAATTAGTCGGGCGTGGTGGCAGGCGCCTGTAATCCCAGCTGCTCAGGGGGCTGAGGCAGGAGAATCGCTTGAACCCAGGAGGCAGAGGTTGCAGTGAGATGAGATTGCGCCATCGCACTCCAGCCTGGGGGACAAGAGTGAGACTTTGTCTCAAATAAA","GGCCGGGCGCGGTGGCTCACGCCTGTAATCCCAGCACTTTGGGAGGCCGAGGCGGGCGGATCACCTGAGGTAAGGAGTTCGAGAACAGCCTGGCCAGCATGGTGAAACCCCATCTCTACTAAAAATACAAAAATTAGCCGGGCATGGTGGCAGGTGCCTGTAATCCCAGCTACTCGGGAGGCTGAGGCAGAAGAATCGCTTGAACCCAGGAGGCGGAGGTTGCAGTGAGCCGAGATTGCGCCATTGCACTCCAGCCTAGGGGAGAAGAGCGAGACTTCGTCTCAAAAAAAAA"
"chr4","146191800","146192101","KN297083v1","743044","743342","32","145448756","GGCCAGGTGCAGTGGCTCATGCCTGTAATCCCAGCACTTGGGAGGCCGAGGCAAGTGGATCACCTGAGGTCAGGAGTTCTAGACTAGCCTGGCCAACATGGTGAAACCCCGTCTCTACCAAAAATACAAAAACTAGCTGGGAATGGTGGCAGGCGCCTGTAATCCCAGCTACTCAGGAGGCTGAGCCAGGAGAATCACTTGAACCCAGGAGGTGGAGGTTGCAGTGAGCCGAGATTGTGCCATCACACTCCAGCCTGGGGGACAAGAGGGAGAGTTCGTCTCAAAAAAAAAAAAAAAAGAAA","GGCCAGGCGCAATGGCTCATGCCTGTAATCCAGCACTTTAGGAGACCGAGGTGGGCGGATCACCTGAGGTCAGGAGATCAAGACCAGCCTGGCCAACATAGTGAAACCCCGTCTCTACTAAAAATACAAAAATTAGCCGGGCATGGTGGCAGGCGCCTGTAATCTCAGCTACGCGGGAGGATGAGGCAAGAGAATCGCTTGAACCCAGGAGATGGAGGTTGCAGTGAGCCGAGATTGCGCCATCACACTCCAGCCTGGGAGACAAGAGTGAGAGTTCGTCTCAAAAAAAAAAAAAAAAA"
"chr4","153763728","153763825","KN297323v1","656594","656696","41","153107134","GAGGATCTTTTGAACACAAGAGTTTAAGGCTACAAGGAACTTTGATCATGCCACTACACTTCAGCTTGGGGACACAGCAAGGCTGTGTCTCTAAAAAA","AATCCCTTGAATCCGGGAGGTGGAGGCTGCAGTGAGCCGAGATCACACCACTGCACCCCAGCCTGGGGACTAGAGAGAGACTTCGTCTGAAAAAAAAAAAAAA"
"chr4","155102487","155102796","KN296119v1","5266717","5267021","41","149835770","GGCCAGGCGCGGTGGCTCATGCCTGTGATCTCAGCACTTTGGGAGGCCAAGGCGGGTGGATCACCTAAGGTCAGGGGTTCGAGACCACCCTGGCCAACATGGTGAAACCCCGTCTCTACTAAAAATACAAAAAATTAGCCGGGTGTGGAGGCCGGCGCCTGTAATCCCAGCTACTTGGGAGGCTAAGGCAGGGGAATCTCTCGAACCCGGGAGGTGGAGGTTGCAGTGAGCCACGATCACGCCACTGCACTCCAGCCTGAGGGACGAGAGCGAGAGGTCGTCTCAAAAAACAACAACAACAACAACAAAA","GGCCAGGTGCGGTGGCTCACGCCTGTAATCCTAGCACTTTAGAAGGCCAAGGCGGGTGGATCACCTGAGGTCAGGAGTTCGAGACCAGCCTGGCCAACATGGTGAAACCCTGTCTCTACTTAAAATACAGAAAATTAGCTGGGTGTGGTGGTACGCACCTGTAATCCCAGCTACTTGGGAGGCCGAGGCAGGAGAATCGCTTGAACCCGGGAGGCAGAGGTTGCAGTGAGCTGAGATCGCGCCATTGCACTCCAGACTGAGGAACAAGAGCGAGACTTCGTCTCAAAAAACAAACAAACAAAAAA"
"chr4","155895734","155896039","KN294879v1","67464","67764","47","155828270","GGCTGGGCTCAGTGGCTCATGCCCATAATTCCAGAACTTTGGGAGGCTGAGATGGGTGGATCACTTGAGGTCAGGAGTTCCAGACCAGACTGACCAACAGGATGAAACTCCATATCTAATAAAAATACAAAAATTAGGAGGGCGTGGTGGCAGGCGCCTGTAATCCCAGCTACTTGGGAGGCTGAGGCAGAAGAATCGCTTGAACCCAGGAGGCGGAGGTTGCAGTGAGTCAAGATCATGCCATTGCTCTCCAGCCTGGGAGATAGAGCAAGAGTAAGACTCTGCTTAAAAAAAAAAAGAAAAAAA","GGCCAGGCGCAGTGGCTCATGCCTATAATCCCAGCACTTTGGGAGGCTGAGGTGGGGGGATCACCTGAGGTCAGGAGTTCTAGATCAGCCTGGCCAACATGGTGAAACCCCGTCTCTACTAAAAATACAAAAATTAGCTGGGCGTGGTGGAAGGCACCTGTAATCCCAGCTACTCGCGGGGGCCGAGGCAGGAGAATTGCTTGAACCCAGGAGGCGGAAGTTGCAGTGAGCCAAGATCACGCCATGGCAGTCCAGCCTGGGAGACAAGAGCGAGACTTTGTCTCAAAAAAAAAAAAAAAAA"
"chr4","161258618","161258909","KN295854v1","1733121","1733418","40","159525497","GCCGGGCACACTGGCTCATGCCCGTAATCCCAGCACTGGGAGGCTGAGGCGGGTGAATTGCCTGAGGTCAGGAGTTCGAGACCAGCCTGGCCACAATGGTGAAACCCCGTCTCTACTAAAAATACAAAAATTAGCCAGGCATCATGGCAGGTGCCTGTAATCCCAGCTCCTTGGGAGGCTGACGCAGGAGAATCGCTTGAACCTGGGAGGCGGAGGTTGCAGTGAGCCGAGATCCTGCCACTGCTTTCCAGCCTGGGGGACAAGAGTGAGACTGTCTCAAAAAAAAAAAAAA","GGCCAGGCACAGTGGCTCACGCCTGTAATCCCAGCACTTTGGGAGGCTGAGGCAGGAGGATCACCTGAGGTCAGGAGTTCCAGACCAGCCTGACCAACATGGTAAAACCCCATCTCTACTAAAAATACAAAAATTAGCCGGGCATGGTGGCGGGCGCCTGTAATCCCAGCCACTTGGGAGGCTGAAGCAAGAGAATCACTTGAACCCGAGAGGCAGAGGTTGCAGTGAGCGGAGATCGCGCCACTGCACTCCAGCCTGGGGGATAAGAGTGAGACTCCGTCTCAAAAAAAAAAAAAAA"
"chr4","161515780","161516074","KN296507v1","594831","595125","29","160920949","GGCCGGGCACAGTGGCTCACGCCTGTAATCCCAGCACTTTGGGAGGCCAAAGCAGGTGGATCACCTGAGGTCAGGAGTTCAAGACCAGCCTGGCCAACATGGTGAAACCCCATCTCTACTAAAAATACAAAAATTAGCCAGGCGTGGTGGCACGTGCCTGTAATCCCAGCTACTCAGGAGGCTGAGGCAGGAGAATTGCTTGAAGCCAGGAGGCAGAAGTTGCAGTGAGCCGAGATCATGCCATTGCACTCCAGCCTGGGGGACAAGAACGAGACTTCATGTCAAAAAAAAAAAA","GGCTGGGCCCGATGGCTCACTCCTGTAGTCCCAGCACTTTGGGAGGCCAAGGCAGGTGGATCGCCTGAGGTCAGGAGTTCAAGACCAGCCTGGCCAACATGGTGAAACTCCGTCTCTATTAAAAATACAAAACTTAGCCAGGCGTGGTGGCAGGCGCCTGTAATCCCAGCTACTGGGGAGGCAGAGGCAGGAGAATCGCTCGAAGCCGGGAGGCGGAAGTTGCAGTGAGCCAAGATCGTGCCATTGCACTCCAGCCTTGGGGATGAGAGAGAGACTTCATCTCAAAAAAAAAAAA"
"chr4","167188513","167188785","KN297112v1","2923769","2924046","38","164264744","GGCTGGGCGCGGTGGCTCATGCCTGTAATCCCAGCACTTTAGGAGGTGAGGCGGGCGGATCACCTGAGGTCAGGGGTTCAAGACCAGCCTGGCCAACATAGTGAAACTCCGTCTCTACTAAAAATACAAAAATTAGCCAGGTGTGGTGGCAGGCACCTGTAATCCCAGCCACTCAGGGGGCTGAGGCAAGAGAATCGCTTCAACCCAGGAGGCAGAGGTTGCAGTGAACCGAGATTGTGCCATCGCACTACAGCCTGGGGGACAAAAGCGAGA","GGCCGAGAGCAGCGGCTCATGTCTGTAATCCCAGCACTTTGGGAGGCCGAGGCGGGTGGGTCACCTGAGGTCAGGAGTTCAAGACCAGCCTGGCCAACATGGTGAAACCCCATCTCTACTAAAAATATAAAAATCAGCCGGGTGTGGTGGCAGGGGCCTGTAATCCCAGCTACTCAGGAGGCTGAGGCAGGAGAACTGCTTAAACCCGAAAGGCAGAGGTTGCAGTGAGCCGAGATTGTGCCATTGCACTCCAGCCTGGGGGACAAGAGCAAGACTTC"
"chr4","169232120","169232423","KN296036v1","1090158","1090461","35","168141962","GCCGGGCGTGGTGGCTGACGCCTGTAATCCCAGCACTTTGGGAGGCTGAGGCAGGTGGATCACCTGAGGTCAGGAGTTCGAGACTAGCCTGGCCAACATGGTGAAACCCTGCCTCTACTAAAAATACAAAAATTAGCCGGGCATGGTGGCAAGCGCCTGTAATCCCAGCTACACGGGAGGCTGTGGCAGGAGAGTCACTTGAACCCGGGAGCTGGAGGTTGTAGTGAGCCGAGATGGCGCCATCGCACTCAAGCCTGGAGGACAAGAGCGAGACTTCATCTCAAAAAGAAAAAAAAAATGAAAA","GGCCGGGCACGGTGGCTCACACCTGTAATCCCAGCACTTTGGGAGGCTGAGGCGGATGGATCACCTGAGGTCAAGAGTTCTAGACCAGCCTGGCCAACATGGTGAAACCCTGTCTCTACTAAAAATACAAAAATTAGCCAGGCATGGTGGCAGGCGCATGTAATCCCAGCTGCTCGGTGGGGCCGAGGCAGGAGAGTCGCTTGAACCCAGGAGACGGAGGTTGCAGTGAGCCGAGATAGTGCCATTGCACTCCAACGTGGGGGACAAGAGCGAGACTTCATCTCAAAAAAAAAAAAAAAAAAAA"
"chr4","171661174","171661453","KN295576v1","406337","406628","40","171254837","GTGGCTCACACCTATAATCCCAGCACTTTGGGAGGCCGAGGTGAACGGATCACCTGAGGTCAGGAGTTCGAGACCAGCCTGGCCAGCATGGTGAAACCCCATCTCTACCTAAAATACAAAAATTAGCCAGCTGGTGGCAGGAGCCTGTAATCCCAGCTACTCGGGAGGCTGAGGCAGGAGAATTGCTTGAACCCGGGAGCAGAGGTTGCAGTGAGCTGAGATCGCACTATTGCGCTCCAGCCTGGGGGACAGGAGCGAGACTTCGTCTGAAAAAAAAAAA","GGCCGGGCGCGGTGGCTCACGCCTGTAATCCCAGCACTTTGGGAGGCCGAGGCGGGCGGATCACCTGAGGTAAGGAGTTCGAGAACAGCCTGGCCAGCATGGTGAAACCCCATCTCTACTAAAAATACAAAAATTAGCCGGGCATGGTGGCAGGTGCCTGTAATCCCAGCTACTCGGGAGGCTGAGGCAGAAGAATCGCTTGAACCCAGGAGGCGGAGGTTGCAGTGAGCCGAGATTGCGCCATTGCACTCCAGCCTAGGGGAGAAGAGCGAGACTTCGTCTCAAAAAAAAA"
"chr4","172535231","172535525","KN295474v1","898764","899060","39","171636467","GACCGGGCGTGATGGGTCATACCTATAATCCCAGCACTTTGGGAGGCCGAGATGGACGGATCACCTAGGTCAGAAGTTCGAGACCAGCCTGGCCAACATGGTGAAACCTGCCTCTACTAAAAATACAAAAATTAGCCGGGCGTGGTGGCAGGTGCCTGTAATCCCAGCTATTCAGGAAGTTGAGGCAGAAGAATCGCTTGAACCCGGGAGGTGGAGGTTGCAGTGAGCCGAGATCGTGCCATCGCACTCTAGCCTGGGGGACAAGAGCAAGACTTTGTCTACAAAAAAAAAAAAA","GGCTGGGCATGGTGGCTCACGCCTGTAATCCCAGCGCTTTGGGAGGCCCAGGTGGGCGGATTACCTGAGGTCAGGAGTTCGAGACCAGCCTGGCTAACATGGTGAAACCCAGTCTCTACTAAAAATACAAAAATTAGTCGGACATGGTGGCAGGTGCCTGTAATCCCAGCTACTCAGGAGGCTGAGGCAGGAGAATCGCTGGAATACGGGAGGCGGAGGTTGCAGTGAGCCGAGATCATACCATTGCACTCCAGCCTGGAGGACAAGAGCGAGTCTTTGTCTCAAAAAAAAAAAAAA"
"chr4","178730838","178731073","KN295294v1","3013800","3014046","36","175717038","TGGGAGGCCGAGGCGGGAGGATCACCTGAGGTCAGGAGTTCGTAGACCATCCTGGCCAACATGGTGAAACCCCGTCTCTACTAAAAATACAAAAATTAGCCAGGCGTGGTGGCAGGCACCTGTAATCCCAGCTACTCGGGAGGCTGAGACAGGAGAATCACTTGAACCTGGGAGGTGGAGGTTGCAGTGAGCCAAGATCGCGCCATTGCACTGCAGCTGGGGAACAAGACGAGACT","CTTTGGGAGGCCGAGGCAGGTGGATCACCTGAGGTTAGGAGTGCTAGACCAGCCTGGCCAACATGGTGAAATGCCGTCTCAACTAAAAATACAAAAATAACCCGGGCGTGGTGGCAGGTGCCTGTAATCCCAGCTACTCGGGGGACCGAGGCAGGAGAATCACTTGAACCTGGGAGGTGGAGGTTGCAGTGAACCAAGATCGCGCCATTGCACTCCAGCCTGGAGGACAAGAGCGAGAAAAAAAAAA"
"chr4","186062892","186063194","KN294685v1","1269570","1269869","35","184793322","GGCCAGTTGTGGTGGCTCACGCCTGTAATCCCAGCACTTTGGGAGGCCAAGGCGGGTGGATCACCTGAGGTCAGGAGTTTGAGACCAGCCTGGCCAACACAGTGAAACCCCGTCTCTACTAAAAATACAAAAATTGGCCAGGCATGGTGGCAGGCCCCTGTAATCCCAGCTACTTGGGAGGCTGAGGCCGGAGAATCGCTTGAACCCAGGAGGCAGAGGTTGCAGTGGGCCGAGATCACGCCAGTGTACTCCAGCCTGGGGGACAAGAGCAAGACTTATTCTCAAAATAAATAAATAAATAAA","GGCTGGGTGTGGTGGCTTAGGCCTGTAATCCCAGCACTTTGGGAGGCCAAGGCGGGCGGATCACCTGAGGTCAGGAGTTCGAGACCAGCCTGGCCAACATGGTGAAACCCCGTCTCTACTAAAAATACAAAAACTAGCCAGGCGTGGTGGCAGGTGACTGTAATCCCAGCTACTCGGGAGGCTGAGGCAGGAGAACTGCTTGAACCTGGGAGGCGGAGGTTGCAGTGAGCTGAGATCACACCATTGCACTCCAGCCTGGGGGACAAGAGCGAGACTTTGTCTCAAAAATAAAAAAAAAAA"
"chr4","190476378","190476530","KN296470v1","174157","174317","24","190302221","GCCGGATGTGGTGGCAGACACCTGTAATCCCAGCTACTTGGGAGGCTGAGGCAGGAGAAGCTTGAACCTGGGAGGCGGAGGTTGCAGTGAGCTGAGATCATGCCATTGCACTCCAGCCTGGGGGACAGGAGGGAAACTGTCTCAAAAAATAAA","GCTGGGCGTGGTGGCAAGTATCTATAATCCCAGCTACTTGGGAGGCTGAGGCAGGAGAATCGCTTGAACCCGGGAGGTGGAGGTTGCAGTGAGCCGAGATCATGCCATTGCACTCCAGCCTGGGGGATAAGAGCGAGACTTTGTCTCAAAAAAAAAGAAAA"
"chr4","192585406","192585702","KN294685v1","1269570","1269869","34","191315836","GGCCAGGCATGGTGGCTCATGCCTGTAATCCCAGCACTTTGGGAGGCCAAGGAGGGTGGATCACGAGGTCAAGAGTTCGAGACCAGCCTGACCAACATGGTGAAACCCCATCTCTACTAGAAATACAAACATTAGCCGGGCATGGTGGCAGGTGCCTGTAATCCCAGCTACGTGGGAGGCTGAGGCAGGAGAATCGCTTAAACTCGGGAGGCGGAGGTTGCAGTGAGCAGAGATCATGCCATTGCACTCCAGCCTGGGGGACAAGAGAGAGAATTCCTCTCAAAAAAAAAAAAAAAA","GGCTGGGTGTGGTGGCTTAGGCCTGTAATCCCAGCACTTTGGGAGGCCAAGGCGGGCGGATCACCTGAGGTCAGGAGTTCGAGACCAGCCTGGCCAACATGGTGAAACCCCGTCTCTACTAAAAATACAAAAACTAGCCAGGCGTGGTGGCAGGTGACTGTAATCCCAGCTACTCGGGAGGCTGAGGCAGGAGAACTGCTTGAACCTGGGAGGCGGAGGTTGCAGTGAGCTGAGATCACACCATTGCACTCCAGCCTGGGGGACAAGAGCGAGACTTTGTCTCAAAAATAAAAAAAAAAA"
"chr5","178257899","178258209","KN294685v1","1269570","1269869","45","176988329","GGCCTGGCATGGTGGCTTACACCTGTAATCCCAGCACTTTGGGAGGCCAAGATGGGTGGATCACCTGAGGTCAGGAGTTCAAGACCAGCCTGGCCAACATGGTGAAACCCTGTCTCTACTTAAAATACAGAAATTAGCCGGGCGTGGTGGCAGGTGCCTCTAATCCCAGCTACTCAGGAGGCCGAGGCAGGAGAATTGCTTGAACCCGGGAGGCGGAGGTTGCAGGGTTGCAGTGAGCCGAGATCGTGCCATTGCACTCTTGTGCTGGGGGATAAGAGTGAGACTTCGTCTGGAAATTTAAAAAAAAAAAA","GGCTGGGTGTGGTGGCTTAGGCCTGTAATCCCAGCACTTTGGGAGGCCAAGGCGGGCGGATCACCTGAGGTCAGGAGTTCGAGACCAGCCTGGCCAACATGGTGAAACCCCGTCTCTACTAAAAATACAAAAACTAGCCAGGCGTGGTGGCAGGTGACTGTAATCCCAGCTACTCGGGAGGCTGAGGCAGGAGAACTGCTTGAACCTGGGAGGCGGAGGTTGCAGTGAGCTGAGATCACACCATTGCACTCCAGCCTGGGGGACAAGAGCGAGACTTTGTCTCAAAAATAAAAAAAAAAA"
"chr5","2408783","2409095","KN295573v1","1644468","1644772","39","764315","GGCCGGGTGCGGTGGCTCATGCCTGTAATCCCAGCACTTTGGGAGGCTGAGGCAGGCGGATCACCCGAGGTCAGGAGTTCTATACCAGCCTGGCCAACATGGTAAAACCCCGTCTCTACTAAAAATACAAAAATTAGCTGGGAATGGTGGCAGGTGCCTGTAATCCCAGCTACTCAGGGGGCCGAGGCAGGAGAATCGCTTGACCCCGGGAGGCAGAAGTTGCAGTGAGCTGAGATCGTGCCATCGCACTCCAGCCTGGGGACCAAGAGTGAGACTGCGTCTCAAAAACAAACAAACAAACAACAACAAAAAA","GGCCGGGCACAGTGGCTCACACCTGTAATCCCAGCACTTTGGGAGTCTGAGGCAGGCGGATCACCTGAGGTCAGGAGTTCGAGACCAGCCTGGCCAACATGGAGAAACCCCCGTCTCTACTAAAAATACAAAAATTAGCTGGGCATGATGGCAGGAGCCTGTAATCCCAGATACTCAGGAGGCTGAGGCAGGAGAATGGCTTGAACCCGGGAGGCAGAGGTTGCAGTGAGCCAAGGTCGCGCCATTGCACTCCAGCCTGGGGGACAAGAGCGAGACTTCGTCTCAAAAAAAAAAAAAAAAAAAAA"
"chr5","3255761","3256042","KN295854v1","1733121","1733418","44","1522640","GGCCGGGCACAGTGGCTCACGCCTGTAATCCCAGCACTTTGGGAGGCTGAGGTGAGTGGATGACCTGAGGTCAGGAGTTCGAAACCAGCCTGGCCAACATGGTGAAACCCCATCTCTACTAAAAATACAAAAATTAGCCAGTTGAGGTGGCAGGCGTCGGTAATCCCAGCTACTCAGGAGGCTGAGGCATGAGAATCTCTTGAAGCCGAGAGGCAGAGGTTGCAGTGAGCTGAGACCGTGCCTGGGGGATAAGAGTGAGACTTGGTCTAAAAAAAAAAAAAA","GGCCAGGCACAGTGGCTCACGCCTGTAATCCCAGCACTTTGGGAGGCTGAGGCAGGAGGATCACCTGAGGTCAGGAGTTCCAGACCAGCCTGACCAACATGGTAAAACCCCATCTCTACTAAAAATACAAAAATTAGCCGGGCATGGTGGCGGGCGCCTGTAATCCCAGCCACTTGGGAGGCTGAAGCAAGAGAATCACTTGAACCCGAGAGGCAGAGGTTGCAGTGAGCGGAGATCGCGCCACTGCACTCCAGCCTGGGGGATAAGAGTGAGACTCCGTCTCAAAAAAAAAAAAAAA"
"chr5","3580891","3581190","KN294685v1","1269570","1269869","38","2311321","GGCCAGGCACGATGTCTTATGCCTGTAATCCCAGCACTTTGGGAGGCCAAGGTGGGTGAATCACCTGAGGTCAGGAGTTCGAAACCAGCCTAGCCAACATAGTGAAACCCCCGTCTCTGCAAAAAATACAAAAATTAGCTGGTGTGGTGGCAGGTGCCTGTAATCCCAGCTACACAGGAGGCTGAGGCAGGAGAATCACTTGAACCTGGGAGACGGAGGTTGCGGTGAGCCGAGATCACGCCATTGCACTCCAGCCTGGGGGAAAAGAACAAGACTTCGTCTCAAAACAAAGAAAAAAAA","GGCTGGGTGTGGTGGCTTAGGCCTGTAATCCCAGCACTTTGGGAGGCCAAGGCGGGCGGATCACCTGAGGTCAGGAGTTCGAGACCAGCCTGGCCAACATGGTGAAACCCCGTCTCTACTAAAAATACAAAAACTAGCCAGGCGTGGTGGCAGGTGACTGTAATCCCAGCTACTCGGGAGGCTGAGGCAGGAGAACTGCTTGAACCTGGGAGGCGGAGGTTGCAGTGAGCTGAGATCACACCATTGCACTCCAGCCTGGGGGACAAGAGCGAGACTTTGTCTCAAAAATAAAAAAAAAAA"
"chr5","4426356","4426646","KN294991v1","1107866","1108162","45","3318490","GGCTGGGCGTGGCGGCTCACCCCTGTAATCCCAGCACTTTGGGAGGCTGAGGTGGGTGGATCACCAGGAGTTCCAGACCAGCCTGGCTCACATGATGAAACCCTATCTCTATTAAAAATACAAAAATCAGCCAGGTGTGGTCGTGGGCACCTGTAATCCCACCTACTCGGGAGGCTGAGGCAGGAGAATCACTTGAACCCAGGAGGCAGAGTTTGCAGTGAGCTGAGATCGCACCACTGCACTCCAGCCTGTGAGACAAGAGCGAGACTTAGTCTCAAAAAAACAAAAAAA","GGCCGGGTGCAGTGGCTCACGCCTGTAATCCCAGCCCTTTGGGAGGTCGAGGCAGGTGGATCACCTGATGTCAGGAGTTCGAGACCAACCTGGCCAACATGGTGAAACCCCATCTCTACTAAAAATACAAAAATTAGCCAGGCGTGGTGGCAGGCACCTGTAATCTCAGCTACTAGGGAGGCTGAGGCAAAAGAATCACTTGAACCCAGGAGGCAGAGGTTGCAGTAAGCTGAGATCACACCACTGCACTCCAACTTGGGGGACAAGAGTGAGACTTTGTCTCAAAAAACAAAAAAA"
"chr5","6655835","6655966","KN296040v1","489522","489654","16","6166313","GGCTGGGTGCCATGGCTCACACCTGTAATCCCAGCACTTTGGGAGGCCGAGAGAGGTGGATCACCTGAGGTCAGGAATTCCACACCAGCCTAGCCAGCATAGTGAAACCCCATCCCTACTAAAAATACAAAA","GGCTGGGCGCAGGGGCTCACACCTGTAATCCCAGCACTTTGGGAGGCTGAGGTGGGTGGATCACCTGAGGTCAGGAGTTCCAGACCAGCCTGGACAACATGGTGAAATCCCATCCCTACTAAAAATACAAAAA"
"chr5","9147633","9147928","KN296036v1","2050310","2050604","37","7097323","GGCTGGGCACAGTGGCTCACACCTGTAATCCCAGCACTTAAGGAGGCCAAGGCAAGCGGATCACCTGAAGTCAGGAGTTCGAGACCAGCCTGGCCAACATGGTAAAACACCGTCTCTACTAAAAAAAATACAAAAATTAGCCAGGCGGGGTGGCAGGTGCCTGTAATCTCAGCTACTCGGGAGGCTGAGGCAAGAGAATTGCTTGAACCCAGGAGGCAGAGGTTGCTGTGAGCTGATTGCGCCATCGCACTCCAGCCTAGGAGACAAGAGCAAGATTTCGTCTCAAAAAAAAAAAA","GGCTGGGCGCAGTGGCCCATGCCTGTAATCCCAGCACTTTGGGAGGCCCAGGCAGGCGGTTCACCTGAGGTCAGGAGTTCGAGACCAGCCTGGCCAACGTGGTGAAACTCCGTCTCTACTAAAAATACAAAAATTAGCTGGGCATGGTGGCAGGTGCCCATAATCCCAGCTATTCGGGAGGCTGAGGCAGGAGAAATGCTTGAAACCAGGAGGCAGAGGTTGCAGTGAGCTGAGATGACACCATCACACTCCAGCCTAGAAGACAAGAGCGAGACTTCATCTCAAAAAAAAAAAA"
"chr5","14226707","14226747","KN294471v1","360790","360827","19","13865917","GATTGCACCATCGCACTCCAGCCTGGAGAAAGAGAGCGAAA","AGGCAGAGATTGCAGTGAGCCGAGATAGCACGATTACA"
"chr5","28083597","28083896","KN296541v1","476659","476959","32","27606938","GGCCAGGCACGGTGGCTCAAGCCTGTAATCCCAGCACTGCGGGAGGCCGAGGCAGGTGGATCACCTGAGGTCAGGAGTTCGAGACCAGCCTGGCCAACATGGTGAAACGCTGTCTCTAATAAAAATACAAAAATTAGCCAGGTGTGGTGGCAGGCACCTGAAATCCTAGCTACTTGGGAGGCTGAGGCAGGAGAATCACTTGAACCCTGGAAGTGGAGGTTGCAGTGAGCCAAGATTGCACCATCGCACTCCAGCCTGGGGGACAAGAGTGAGATTTTGTCTCAAAAAAAAAAAAAAAAA","GGGCTGACGTGGTGACTCATGCCTGTAATCCCAGCACTTTGGGAGGCCGAGGCAAGTGGATCACCTGAGGTCAGGAGTTCGAGACCAGCCTGGCCAACATGGTGAAACCCAGTCTCTACTAAAAATACAAAAATTAGCCAGGCGTGGCGGTAGGCACCTGTAATCCCAGCTACTCGGGAGGCTGAGGCAGGAGAATCACTTGAACTCGGGAGGCGGAGGTTGCAGTGAGCCGAGATCACGCCATTGCACTCCAGCCTGGCGGACAAGAGCGAGACTTTGTCTCAAAAAAAAAAAAAAAAAA"
"chr5","29717132","29717383","KN295439v1","247193","247443","50","29469939","CACCTGTGGTCAGGAGTTCGAGACAAGCCTGGGCCTGGCCAACATGGTGAAACCCCCGTCTCTACTAAAAAGTACAAAAATTAGCCGGGCATGGTGGCAGGCGCCTTAATCCCAGCTACTTGGGAGGCAGAGGCAGGAGAATCATTTGAACCTGGGAGGCAGAGGTTGCAGTGAGCCGAGATCGAGCCATTGCACTGAAGCCTGGGGGACAAGAGCAAGAGCAAGACTTCTCTCAAAAAAAAAAAAAAAGAA","GGATCACCTGAGGTCAGGAGTTCAAGACCAGCCTTGCCAACATGGTGAAACCCCGTCTCTACTAAAAGATACAAAAATTAGCCAGTTGTGGTGGCAGGACTTAATCCCAGCTACTTGGGAGGCAGAGGCAAGAGAATTGTTTGAATCCAGGAGGCGGAGGTTGCAGTGAGCCGAGACTGAGCCATTGCACTCAAACCTGGGGGACAAGAGGGAGACTTCTCTCAAAAAAAAAAAAAAGAAAAGAAAAGAAA"
"chr5","31745572","31745867","KN295236v1","3481738","3482030","32","28263834","GGCCGGGTGCAGTGGCTCACGCCTGTAATCCCAGCATTTTGGGAGGCCGAGGCAGGTGGATCACCTGAGGTCAGGAGTTAGAGACCAGCCTGGCCAACATGGTGAAACCCTATCTCTACTAAAAATACAAAAATTAACTGGGCGTGGTGGCAGATGCCTGTAATCCCAACTATTCAGGAGGCTGAGGCAGGAGAATCACTTGAACCTGGGGGGCGGAAGTTGCAGTGAGCCGAGATCGCCCCATTGCACTCCAGCCTGGGGGGACAAGAGCAAGACTTCATCTAAAAAAAAAAAAA","GGCCGGGCGCGGTGGCTCACGCCTGTAATCCCAGCATTTTGGGAGGCCAAGGCAGGTGGATCACCTGAGGTCAGGAGTTCGAGACCAGTCTGGCCAACATGGGGAAACCCGTCTCTACTAAAAATACAAAAATTAGCCGGGCGTGGTGGCAGGCGCCTATAATCCCAGCTATTCAGAAGGCTGAGACAGGAGAATCACTTGAACCCGGGAGGCGGAGGTTGCAGTGAGCCTTGATTGCACCATTGCAGTCCAGTTGGGAGATGAGAGCAAGACTTCATCTCAGAAAAAAAAAA"
"chr5","38278876","38278997","KN294527v1","22635","22759","23","38256241","GTCCGGTGCAACGGCTCATGCCTGTAATCCCAGCACTTTGGGAGGCCAAGGTGGGTGGATTACTTGAGGTCAGGAGTTCTAGACCAGCCTGGCCAACATGGTGAAACCCNCTNTCTATAAAA","GGTCAGACATGGTGGCTCACACCTGTAATCCCAGCACTTTGGGAGGCCAAGGCGGGTGGATCACTTGAGGTCAGGTGTTCTAGACCAGTCGGGCCCACATGCTGAAACCCTGTCTCTACTTAAAA"
"chr5","41027318","41027614","KN295576v1","406337","406628","39","40620981","GGCTGGGTATGGTGGCTCACACCTGTAATCCCAGCATTTTGGGAGGAGGAGGCGGGTGGATCACCTGAGGTCAGGAGTTCAAGACCAGCCTGACCAACATGGTGAAACCCCATCTCTACTAAAAATACAAAAATTAGCCAGGCAAGGTGGCAGGTACCTGTAATCCCAGCTACTTGGGAGGCTGAGGCAGGAGAATTGCTTAAAGCTGGGAGGCGAAGGTTGCAGTGAGCTGAGATCGTGCCATCGCACTCACTCCAGCCTGGGGGACAAGAGTGAGACCTCATCTCAAAAAAAAAA","GGCCGGGCGCGGTGGCTCACGCCTGTAATCCCAGCACTTTGGGAGGCCGAGGCGGGCGGATCACCTGAGGTAAGGAGTTCGAGAACAGCCTGGCCAGCATGGTGAAACCCCATCTCTACTAAAAATACAAAAATTAGCCGGGCATGGTGGCAGGTGCCTGTAATCCCAGCTACTCGGGAGGCTGAGGCAGAAGAATCGCTTGAACCCAGGAGGCGGAGGTTGCAGTGAGCCGAGATTGCGCCATTGCACTCCAGCCTAGGGGAGAAGAGCGAGACTTCGTCTCAAAAAAAAA"
"chr5","41487116","41487201","KN297217v1","1631","1713","18","41485485","CTGGGTGCAGTGGCTCACACCTATAATCCTAGCATTCTGGAAGGCTGAGGTGGGTGGATCACCTGAGGTCAGGAGTTCTAGGCCAG","GGGCGCCGTGGCTCACGCCTGTAATCCCAACACTTTGGCAGGCTGAGGTGAGTGGATCATCTAAGGTCAGGAGTTCCAGATCA"
"chr5","41972607","41972850","KN295439v1","247193","247443","44","41725414","GGATCACCTGAAGTCAGGAGTTCGAGACCAGCCTGGCCAACATGGCGAAACCCCGTCTCTACTAAAAATACAAAAATTAGCCAGGCATGGTGGCAGGCGCCTGTAATCCCAGCTACTCGAGAGGCTGAGGCAGGAGAATTGCTTGAACCTGGGAGGCGGAGGTTACAGTGGGCCGAGATCGTGTCACTGCACTCCAGCCTGGGGGACAAGAGCGAGACTTCGTCTCAAAAAATAAATAAATAAA","GGATCACCTGAGGTCAGGAGTTCAAGACCAGCCTTGCCAACATGGTGAAACCCCGTCTCTACTAAAAGATACAAAAATTAGCCAGTTGTGGTGGCAGGACTTAATCCCAGCTACTTGGGAGGCAGAGGCAAGAGAATTGTTTGAATCCAGGAGGCGGAGGTTGCAGTGAGCCGAGACTGAGCCATTGCACTCAAACCTGGGGGACAAGAGGGAGACTTCTCTCAAAAAAAAAAAAAAGAAAAGAAAAGAAA"
"chr5","49825624","49825891","KN297028v1","684783","685041","51","49140841","AGGCCGGGCGCGGTGGATCACCTGAGGTCCGGAGTTTGAGACCAGCCTGGCCAACATGGTGAAACCCCCGTCTCTACTAAAAACACAAAAATTAGCCGCGCATGGTGGCAGGTGCCTGTAATCCCAGCTACACAGGACGCTGAGGCAGGAGAATTGCTTGAACCCGGGAGGCGGAGGTTGCAGTGAGCTGAGATCGTGCCATCACACTCCAGCATGGGAGACAAGAGCGAGACTTCGTCTCAAAAAAATAAAAATAAAAAAAACAAAA","GAGGCCAAGGTGGGCGGATCACCTGAGGTCAGGAGTTCGAGACCGGTCTGCCCAGCATGGTGAAACCCTGTCTTTACTAAAAATACAAAAATTAGCTGGCCTTGGTGGCTGGCGCCTGTAATCCCAGCTACTCAGGAGGCTGAGGCAGGAGAATCATTTGAACCTGGGAGACGGAGATTGCAGTGAGCCGAGATCATGCCATCGCATTCCAGCCTAGGGGACAAGAGCAAGATTTTGTCTCCAAAAAAAAGAAAAAAAA"
"chr5","49916874","49917161","KN296210v1","283065","283352","23","49633809","GGCTGGGCACAGTGGCTCATGCCTGTAATCCCAGCACTTTGGGAGGCCGAGGCGGGTGGATCACCTGAGGTCAGGCATTCAAGACCAGCCTGGCCAACATGGTGAAACCTTGTCTCGACTAAAAATACAAAAATTTGTATTCCAGCTACTCAAGGGGCCAAGGCGGGAGAATCACTTGAACCTGGGAGGTGGAGGTTACAGTGAGCCAAAATCATGCCATTGCACTCCAGTCTGGGTGAGAGAGCAAGACTTCGTTTCAAAAAAAAGAGAAAAGAAAAGAAAAGAAAA","GGCTGGGCACAGTGGCTCATGCCTGTAATCCCAGCACTTTGGGAGGCCGAGGTGGGTGGATCACCTGAGGTCAGGAGTTCAAGACCAGCCTGGCCAACATGATGAAACCTTGTCTGTACTAAAAATACAAAAATTTTTATTCCAGCTACTCAGGGGAACAAGGCAAGAGAATCACTTGAACCTGGGAGGCAGAGGTTACAGTGAGCCAAAATCATGCCATTGCACTCCTGTCTGGGTGAAAGAACAAGACTTCGTCTCAAAAAAAAAAAAAAAAAAAAAAAAAAAAAA"
"chr5","52194242","52194519","KN294345v1","136063","136342","32","52058179","GGCCAGGCGCAGTGGTTCACGCCTGTAATCCCAGCACTTTGGGAGGCTGAGGCGGGTGGATTACCTGAGGTCAGGAGTTTGAGACCAGTCTGGCCAAAATGGTGAAACCCCGTCTCTACTAAAAATACAAAAATTAGCCTGGCATGGTGGCAGGTGCCTCTAATCCCAGCTACTTGGGAGATTGAGACAGGAGAATCGCTAGAACCTGGGTGGTGGAGGTTGCAGTTAGCCAAGATCTCACCATAGCACTCCAGCCTGGGGGACAAGAGCGAGACTTC","GCCAGGCATAGTGGTTCACGCCTGTAATCCCAGCACTTTGGGAGGCTGAGGCGGGTGGGTTACCTGAGGTCAGGAGTTCAAGACCAGCCTGGCCAAAATAGTGAAACCCCCACCTCTACTAAAAATACAAAAATTAGCTGGGCATGGTGGCAGGTGCCTGTAATCCCAGCTACTCGGGAGACTGAGGCAGGAGGATTGCTATAACCTGAGTGGCAGAGGTTGCGGTGAGCCAACATCTCACCATCACACTCCAGCCTGAGGGACAAGAGTGAGACTTCAT"
"chr5","52694631","52694932","KN296052v1","86362","86661","32","52608269","GGCCAGGAGTGGTTGCTCATGCGTGTAATCCCAGCACTTTGGGAGGCCAAGGTGGGCGGATCACCTGAGGTCAGGAGTTCGAGACCAGCCTCGCCAACATGTTGAAACCCTGTCTCTACTAAAAATACAAAGATTAGCCAGGCTTGGTGACAGGCACCTGTAATCCCAGCTATTCAGGAGGCTGAGGCAGAAGAATCACCTGAACCCTGGAGACAGAGGTTGCAGTGAGCTGAGATGGCACCACTGCACTCCAGCCTGGGGGACAAGAGCGAGAGTTCATCTCAAAGAACAAACAAACAAAA","GGCCAGAAGTGGTCACCCATGCCTGTAATCCCAGCACTTTGGGAGGCCGAGGTGAGTGGATCACCTGAGGTCAGGAGTTAGAGACCAGCCTCGCAAACATGGTGAAACCCTGTCTCTACTAAAAATATAAAAATTAGCCAGGTGTGGTGGCAGGCGCCTGTAATTCCAGCTACTTGGGAGGCTGAGGCAGAAGAATCACTTGAACCTGGGAGGCAGAGGTTGCAGTGAGGTGAGATCGCACCATTGCACTCCAGCCTGGGAGACAAGAGCGAGACTTCATCTCAAAAACAAACAAACAAA"
"chr5","53265403","53265508","KN294581v1","238407","238513","10","53026996","GGCCGGGCGTGGTGGCTCACACCTGTAATCCCAGCACTTTGGGAGGCGGAGGCTGGTGGATCACCTGAGGTTGAGAATTCCAGACCAACCTGGCCAAGTGGTGAAA","GGCTGGGCGTGGTGGGTTACACCTGTACTCCCAGCACTTTGAGAGGCAGAGGCTGGTGGATCACCTGAGGTTAAGAATTCTAGACCAACCTGGCCACTGTGGTGAAA"
"chr5","58439786","58439927","KN294325v1","635905","636046","18","57803881","GGCCAGGCGCGATGGCTCCCGCCTGTAATCCCAGCACTTTGAGAGGCTGACGTGGGTGGATCACCTGAGGTCAGGAGTTCTAGACCAGCCTGGCCAACATGGCAAAACCCCATCTCTACTAAAAATACAAAAACTTAGCTGG","GGCCAGGCGCAGTGGCTCATGCCTGTAATCCCAACACTTTGGGAGGCCGAGGCGGGTGGATCACCTGAGGTCAGGAGTTCCAGACCAGTCTGGCCAACATGGCGAAACCCCGTCTCTACTAAAAATACAAAAGTTGGGTGGG"
"chr5","61890697","61890890","KN296470v1","174157","174317","72","61716540","GCCAGGCATGGTGGTGCGTGCCTATAGTCCCAGCTACTTGGGAGGCTCAGGCGAGGATATCTTGAGTCAGGAGCTTAAGGCTATAGTGAGCTGTGATTTTGCCACTGCACTCCAGCCTGGGTAACAGTAAGATCCTGTACTANNNNNNNNNNNNNNNNNNNNAATACTCGTCTCAAAAANAAAAAAAAAAAAAA","GCTGGGCGTGGTGGCAAGTATCTATAATCCCAGCTACTTGGGAGGCTGAGGCAGGAGAATCGCTTGAACCCGGGAGGTGGAGGTTGCAGTGAGCCGAGATCATGCCATTGCACTCCAGCCTGGGGGATAAGAGCGAGACTTTGTCTCAAAAAAAAAGAAAA"
"chr5","62242139","62242433","KN296883v1","2444932","2445228","37","59797207","GGTTGGGGGTGGTGGCTCATGCCGGTAATCCCAGCACTTTGGGAGTCCAAGGCGGGTGGATCACCTGATGTCAGAAGTTCAAGACCAGCCTGGCCAACATGTTGAAACCCCATCTCTACTAAAAATACAAAAATTAGCAGAGCTTGGTGGCAGGCGCCTGTAATCCCAGCTACTCGGGAGGCTGAGGCAGGAGAATAACTTGAACCCGGGAAGCAGAGGTTGCAGTTAGCCAAGATCATCCCATTGCACTCCAGCCTGGGGGACAAGAGCAAGACTTCATCTTAAAAAAAAAAAA","GGCCGGGCACGGTGGCTCATGCCTGTAATCCCAGCACTTTGGGAGGCCAAGGCGGGTGGATCACCTGAGGTCAGGAGTTCTAGACCAGACTGGCCAACATGGTGAAACCCCATCTCTACTAAAAATACAAAAATTAGCCAGATGTGGTGGCAGGCTCCTGTAATCTCAGCTACTCGGGGGGCCAAGGCAGGAGAATTGCTTGAACCCAGGATGCAGAGGTTGCAGTGAGCCAAGATCACGCCATCGCATTCCAGCCTGGGAGACAAGAGTGAGACTTCATATCAAAAAATAAAAAAA"
"chr5","65041113","65041414","KN295721v1","13985","14280","27","65027128","GGCTGGGAGTGGTGGCTCACACCTGTAATCCCAACACTTTGGGAGGCCGAGGCAGGTGGATCACCTGAGGTCAGGAGTTCGAGACCAGCCTGGCCAACATGGTGAAATCCCATTTCTACTAAAAATACAAAAATTAGCCAGGCATGGTGGCAGATGCCTGTAATCCCAGCTACTCAGGAGGCTGAGGCAGGAGAATCACTGGAACCCAGGAGGCAGAGGTTGCAGTGAGCCAAGATGGCACCATTGCACTCCAGCCTGAGGGACAAGAGCTAGACTTCATCTACAAAAAAAAAAAAAAAGAA","GGCTGGGAGTGGTGGCTCACACCTGTAATCCCAACACTTTGGGAGGCTGAGGCGAGTGGATCATCTGAGGTCAGGAGTTCGAGACCAGCCTGGCCAACATGGTGAAACTCCATTTCTACTAAAAATACAAAAATTAGCCGGGCATGGTGGCAGACGCCTGTAATCCCAGCTACTCAGAGGCTGAGGCAGAAGAATCGCTGGAACCCAGGAGACGGAGATTGCAGTGAGCCAAGATTGCGCCATTTGCACTCCAGCCTGAGGGACAAGAGCGAGACTTCGTCTCAAAAAAAGGAAAA"
"chr5","69917213","69917344","KN296040v1","489522","489654","18","69427691","GCCGGGTGTCGTGGCTCACATCTGTAATCCCAGCACTTTGGGAGGCCGAGGCAGGAGGATCATCTGAGGTCAGGAGTTCCAGACCAGCCTGATCAACATGGTGAAACCCCATCTCTACTAAAAAAAAAAAAA","GGCTGGGCGCAGGGGCTCACACCTGTAATCCCAGCACTTTGGGAGGCTGAGGTGGGTGGATCACCTGAGGTCAGGAGTTCCAGACCAGCCTGGACAACATGGTGAAATCCCATCCCTACTAAAAATACAAAAA"
"chr5","71856579","71856877","KN296495v1","1566946","1567248","31","70289633","GGGTGCGGTGGCTCACACCTGTAATCCCAGCATTGTGGGAGGCCAAGGTGAGTGGATCACCTAAGGTCAGGAGTTCGAGACCAGCCTGGCCAACATGATGAAACCCCATCTCTACTAAAAATACAAAAATTAGCCGGGCGTGGTGGTAGGCGCCTGTAATCCCAGCTACTCAGGAGGCTGAGGCAGGAGAATCACTTGAACCAGGAAGGCAGAGGTTGCAGTGAGCCGAGATCATGCCATTGCACTCCAGCCTGGGGGACAAGAGCAAGACTTCATCTCAAAAATAAAAAATAAAAAAA","CAGACGTGGTGGCTCACACCTGTAATCCCAGCACTTTGGGAGGCCAAGGCGGGTGGATCACCTGAGGTCAGGAGTTCAAGACCAGCCTGGCCAACATGTTGAAACCCCATCTCTACTAAAAATACAAAAAAATTAGCGGGGCGTGGTGGCAGGCGCCTGTAATCCCAGCTACTCGGGAGGCTGAGGCAGAAGAATCGCTTGAACCCGAGAGGTGGAGGTTGTAGTGAGCCGAGATCATGCCATTGCACTCCAGGCTGGGGGACAAGAGCGAGACTTCGTCTCAAAAAAAAAAAGTAAAAGAAA"
"chr5","72650403","72650627","KN297200v1","39391","39619","26","72611012","AGACCAGCCTGGCCAACATGGTGAAACCCCATCTCTACTAAATATACAAAAATTAGCCGGGCATGGTGGTGCATGCCTGTAATCCCAGCTACTCGGGGGCCGAGGCAGGAGAATAGCTTGAACCCAGGAGGGGGAGGTTGCAGGGAGCCAAGATCGTGCCATCGCACTCCAGCCTGGGGGTCAAGAGCAAGACTTCATCTCAATAAAAAAAAAAAAGAAGAAGAA","AGACCAGCCTGGCCAACATGGTGAAACCCCATCTCTACTAAAAATACAAACATTAGCCAGGCGTGGTGGTACGCGCCTGTAATCCCAGCTACTCAGGGGCACAGGAAGGAGAATAGCTTGAACCCGGGAGGCGGAGGTTGCAGGGATCCAAGATCGCACCATCGCACTCCAGCCTGGAGGACAAGAGCGAGACTTCATCTCAATACTTTAAAAAAAAAAAAAAAAAAAA"
"chr5","75714561","75714858","KN296201v1","478877","479164","29","75235684","GGCCGGGAGCAGTGGCTCACGCCTGTAATCCCAGCACTTTGGGAGGCCGAGGTGGGTGGATCACCTGAGGTCAGGAGTTCGAGACCAGCCTGACCAACATGGTGAAACCCCAGCTCTACTAAAAATACCAAAAAATTATCCGGGCGTGGTGGCAGGCTCCTGTAATCCCAGCTACGCAGGGGACTGAGGCAGGAGAATTGCTTGAACCCGGGAGGCAGAGGTTGTAGTGAGCCGAGATAATGCCATCGCACTGCAGCCTGGGGGACAAAAGCGAGACTTTGTCTACAAAAAAAAAAAA","GGCCAGGATCGGTGGCTCACGCCTATAATCCCAGCACTTTGGGAGGCGGAGGTGGATGGATCACCTGAGGTTAGGAGTTTGAGACCAGCCTGACCAACATGGTGAAACCCCAGATCTACTAAAAATACCAAAAAATTATCCGGGTGTGGTGGCATGCTCCTGTACGTGGGGGACTGAGGCAGGAGAATTGCTTGAACCCGGGAGGCAGGGGTTGTAGTGAGTGGAGATAGTGCCATCGCACTCCAGCCTGGGGGACAAAAGTGAGACTTTGTCTCAAAAAAAAAAAAA"
"chr5","76048730","76049032","KN296201v1","829989","830280","36","75218741","GGCTGGGCGTGGTGGCTCACGCCTGTAATCCCAGCACTTTGGGAGGCCGAGGCTGGCGAATCATCTGAGGTCAGGAATTTGAGACCAGCCTAGCCAACATGGTGAAACCCCCCCATCTCTACTAAAAATACAAAAATTAGCTGGGTGTGGTGGCAGGCGCCTGTAATCTCAGCTACTTGGGAGGCTGAGGCAGGAGAATTGCTTGAACCCGGGAGGCAGAGGTTGCAGTGAGCCGAGATCGCTCTGTCCCACTCCAGCCTGGGGGACAAGAGTGAGATTTTGTTTCAAAAACAAACAAACAAA","GGCTGGGCATGGTGGCTCATGCCTGTAATCCCAGCACTTTGGGAGGCCGAGGCGGGTGAATCACCTGAGGTCAGGAGTTCAAGACCAGCCTGGCCAACATGGTGAAACCCTGTCTCTACTAAAAATACAAAAATTAGCTGGGCGTGGTGGCAGGCGCCTGTAATCTCAGTTACTCGGGAGGCTGAGGCAGGAGAATTGCTTGAACCCAGGAAGCGGAGGTTGCAGTAAGCCGAGATTGTGCTGTCACACTCCAGCCTGGGGGACAAGAGCAAGATTTTGTCTCAAAAACAAA"
"chr5","78366981","78367239","KN296743v1","2347268","2347551","52","76019713","GGCCAGGCACGGTGGCTCAAGCCTGTAATCCCAGCACTTTGGGATGCCAAGGTCAGGAGTTCAAGACCAGCCTGGCCAACAAGGTGAAACCCCATCTCTACTAAAAATACAAAAATTAGCCAGGTGTGGTGGTGGGCGCCTGTAATCCCAGCTACAGGGAGCTGAGGCGGAGGTTGCAGTGAGCCGAGATCGCACCATTCCACCCCAGCCTGGGGGACAAGAGCAAGACTTCGTCTCAAAAACAACAACAAAAGAAAAA","GGCCAGGCACGGTGACTCATGCATGTAATCCCAGCACTTTGGGAGGCCGAGGTGGGCGGATCACCTGAGGTCAAGAGTTCGAGACCAGCCTGGCCAACATGGTAAAACCCTGTTTCTACTAAAAATACAAAAATTAGCCAGGTGTGGTGGCAGTCGCCTGTAATCCCAGCTACTAGCTTGAATTTGGGAGGCGGAGGTTGCAGTAAGCTGAGATCGCACCATTGTACTCCAGCCTGGGGGACACGAGCGAGACTTCGTCTCAAAAAAAAAAAAAAAAAAAAAAA"
"chr5","78425935","78426228","KN295576v1","406337","406628","29","78019598","GGCCGGGCGTGGTGGCTCACGCCTATAATCCCAACACTTTGGGAGGCTGAAGCGGGCGGATCACCTGAGGTCAGGAGTTCTAGATCAGCCTGGCCAACATGGTGAAACCCCATCTCTACTAAAAATACAAAAATTAGCCAAGCGTGGTGGCAGGCGCCTGTAATCCCAGCTACTCGGGGGGCTGAGGCAGGAGAATCTACTTGAACCCAGGAGGCGGAGGTTGCAGTGAGCCGAGATTGCATCATCGCACTCCAGCCTGGGGGACAAGAGTGTACTCCATCTCAAAAAAAAAAA","GGCCGGGCGCGGTGGCTCACGCCTGTAATCCCAGCACTTTGGGAGGCCGAGGCGGGCGGATCACCTGAGGTAAGGAGTTCGAGAACAGCCTGGCCAGCATGGTGAAACCCCATCTCTACTAAAAATACAAAAATTAGCCGGGCATGGTGGCAGGTGCCTGTAATCCCAGCTACTCGGGAGGCTGAGGCAGAAGAATCGCTTGAACCCAGGAGGCGGAGGTTGCAGTGAGCCGAGATTGCGCCATTGCACTCCAGCCTAGGGGAGAAGAGCGAGACTTCGTCTCAAAAAAAAA"
"chr5","80619833","80620145","KN294665v1","171883","172197","33","80447950","GGCCGGGCACGGTGGCTCACGCATGTAATCCCAGCACTTTGGGAGGCCAAGGCGGGCGGATCACCTGAAGTCAGGAGTTCGAGACCAGCCTGGCCAAAATGGTGAAGCCCGGTCTCTACTAAAAATACAAAAATTAGCTGGGCGTGGTAGCAGGCACCTGTAATCCCCGCTACTCGGGAAGCTGAGGCAGGAGAATCGCTTGAACCCGGGAGGCGGAGGTTGCAGTGAGCCGAGATCGCGCCATTGCACTCCAGTCTGGGGGACAAGAGTGAGACTTTGTCTCAAAAAAACAATACATAAATAAAAAAGAAAA","GCCGGGCATGGTGGCTCATGCGTGTAATCCCACCACTTTGGGAGTCCGAGGCAGGTGGATCACCTGAGGTCAGGAGTTCGAGACCAGCCTGGCCAACATGGTGAAACCCCCGTCTCTACTAAAAATACAAAAATTAGCTGGGCATGGTGGCAGGCGCCTGTAATCCCAGCTACTCGGGAGGCTGAGGCAAGAGAATCGCTTGAACCCGGGAGATGGAGGTTGCAGTGAGCCGAGATCGCACCATTGCACTCCAGCCTGGGGGACAAAAGAGAGACTTTGTCTCAAAAAAAAAAAAAAAAAAAAAAAAAAGAAAAA"
"chr5","83656670","83656935","KN295941v1","1108709","1108994","48","82547961","GGCCGGGCTCTGTGGCTCACGCCTGTAATCCCAGCACTTTGGGAGGCCAAGGCGGGTGGATCGCCTAGACCAGTCTGGCCAACATGGGTAAAACCCTGTCTCTACTAAAAATATAAAAATTAGCTGGGCATGGTGGCAGGCGCCTGTAATCCCAGCTACTCGGGGCCGAGGCAGGAGAATTGTTTGAACCTGGGAGGCGGAGGTTGCAGTGAGCCGAGATAGCACCATCACACTCCAGCCTGGGGGACAAAAGCAAGACTTGGTCT","GCCGGGTGCTTTGGCTCACGCCTGTAATCCCAGCACTTTGGGATGCCGAGGCGGGTGGATCACCTGAGGTCAGGAGTTTGAGACCAGCCTGGCCAACATGGTGAAACCCTGTCTCTACCAAAAATACAAAAATTAGCCGGGCGGGGTGGCAGGCGCCCGTAATCCCAGCTACTCGGAAGGCTGAGGCAGGATAATCGCTTGAACCTGGGAGGCGGAGGTTGCAGTGAGCCGAGATCGCACCATTGCACTCCAGCCTGGGGGACAAGAGCGAGACTTCGTCTCAAAA"
"chr5","84199601","84199912","KN294172v1","4419501","4419812","37","79780100","GCCAGGAGCAGTGGCTCACACATGTAATCCCAGCACTTTAGGAGGCTGAGGCAGGCAGATCACCTGAGGTCAGCAGTTCGAGACCAGCCTGACCAACATGGTGAAACCCCATCTCTACTAAAAATACAAAAATTAGCCGGGCGTGGTGGCAGGTGCCTGTAATCCCAGCTACTCAGGAGGCTGAGACAGGAGAATCACTTGAACCCGGGAGGCAGAGGTTGCACTGAGCCGAGATCGCGCCATCACACTCCAGCCTGGGGGACAAAAGCAAGACTTTGTCTCCAAAAAACAAAAAACAAAAAAAACAAAAAA","GGCTGGGCGCAGTGGCTCACGCCTGTAATCCCAGCACTTTGGGAGGCCGAGGCAGGCGGATCACCTGAGGTCAGGAGTTTCAGACCAGCCTGGCCAACATGGTGAAACCCCGTCCCTACTAAAAATACAAAAATTAGCCGGGCGTGGTGGCAGGCACCTGTAATCCCAGCTACTCAGGAGGCTGAGGCAGGAGAATCACTTGAACCCCGGAGGCAGGGGTTGCGGTGAGCCGAGATCGCGCCACTGCACCCCAGCCTGGGGGACAAGAGCAAGACTTCATCTCAAAAATAAATAAATAAATAAAAATAAAAA"
"chr5","100145587","100145890","KN294420v1","890399","890698","30","99255188","GGCCGGGCGCGGTGGCTCACGCCTGTAATCCCAGCACTTTGGGAGGCTGAGGCGGGCGGATCACCTGAGGTCAGGAGTTCGAGACTAGCCTGGCCAATATGGTGAAATGCCGTCTCTACTAAAAATACAAAAATTAGCCAGGCATTGTGGCAGGTGCCTGTAATCCCAGCTACTAGGGAGGCTGAGGCAGGAGAATCACTTCAACCCAGGAGGCGGAGGTTGCAGTGAGCCGAGATCGTGCCATTGCACTCCAGCCTGGGGGACAAGAGCGAGACTTCGTACTAAAAAAAAAAAAAGAAAGAAA","GGCCAGGCACGGTGGCTCACGCCTGTAATCCCAGCACTTTGGGAGGCTGAGGTGGGCGGATCACCTAAGGTCAGGAGTTCTAGATCAGCCTGGCCAACATGGTGAAATCCCGTCTCTACTAAAAATACAAAAATTAGCCAGGCATGGTGGCAGGCGCCTGTAATCACAGCTACTCAGGAGGCTGAGGCAGGAGAATCACTTGAACCCAGGAGGCGGAGTTTGCAGTGAGCTGAGATTGCACCATTGCAGTCCAGCCTGGGGGACAAAAGCAAGACTCCATCTCAAAAAAAAAAAAAAAAA"
"chr5","107190263","107190479","KN297341v1","187387","187612","36","107002876","TGGCCAACATGGTGGAACCCCATTTCTACTAAAAATACAAAAAAGATTAGCTGGGCATGGTGGCAGGCGCCTGTAACCCTAGCTACTTGGGAGGCTGAAGCAGGAGAATTGCTTGAACCTGGGAGGCAGAGGTTGCAGTGAGCCAAGATCACGCCATCGCGCTTCCAGCCTGGGGGACAAGAGTGAGACTTCGTCTCAAAAAAAAAAAAAAAAAAAA","TGATCAACATGGTGAAACCCCATTTCCACTAAAAATAAAGAAAAAAAAATTAGCTGGGCTTGGTGGCAGGCACCTGTAATCCCAGCTACTTGGGAGGCTGAGATAAGAGATTTGCTTGAACCTGGGAAGCAGAGGTTACAGTGAGCCAAGATTGTGCCACTGCACTCCAGCCTGGGGAACAAGAGTGAGACTTTGTCTCAAAAAAAAAAAAAAAAAAAAAAAAAAA"
"chr5","109090484","109090697","KN297200v1","39391","39619","52","109051093","CATCCTGGCCAACGTGGTGAAACTCCATCACTGCTAAAAATACAAAAATTAGTCAGGCATGGTGGCAGGCGCCTTTAATCTCTGCTACTCAGGAGTCTATGGTAGGAGAATTGCTGGAACCCGGGAAGCAGAGGTTGCAGTGAGCCAAGGTCGCGCCATTGCACTCCAGCCCAGGTGACAACAGCGAGACTCTTATCTCAAAAAGAAAAATAAA","AGACCAGCCTGGCCAACATGGTGAAACCCCATCTCTACTAAAAATACAAACATTAGCCAGGCGTGGTGGTACGCGCCTGTAATCCCAGCTACTCAGGGGCACAGGAAGGAGAATAGCTTGAACCCGGGAGGCGGAGGTTGCAGGGATCCAAGATCGCACCATCGCACTCCAGCCTGGAGGACAAGAGCGAGACTTCATCTCAATACTTTAAAAAAAAAAAAAAAAAAAA"
"chr5","111898733","111899044","KN294526v1","558418","558721","36","111340315","GGCCAGGCACAGTGGCTCATGCCTTTAATCCCAGCACTTTGGGAGGCCGAGGTGGGTGGATCACCTGAGGTCAGGAGTTCGAGATCAGCCTGGCCAACATGGTGAAACCCTGTCTCTACCAAAAATACAAAAATTAGCCAGGCGTGGTGGCAGGCACCTGTAATCCCAGGTACTCGGGAGGCTGAGGCGGGAGAATCGCTTGAACCGAGGAGGTGGAGGTTGCAATGAGCCGAGATCGCTCCATTGCACTCCAGCCTGGGGGACAAAAGCGAGACTTCATCTCAAAAAATAATAATAAAATAAAATAAAGAA","GGCCAGGCGCAGTGGCTCATGCCTGTAATCCTAGCACTTTGGGAGGCCGAGGTGGGTTGATCACTTGAGGTCAGGAGTTCGAGCCCAGCCTGGCCAATATGGTGAAACCCCGTCTCTACTAAAAATACAAAAATTAGCCGGACGTGATGGCAGGCACCTGTAATCCCAGCTACTCAGGAGGCTGAGGCAGGAGAATTGCTTGAACCCGGGAGGCGGAGGTTACAGTGAGCTGAGATCGCGCCATTGCACTCCAGCCTTGGGTACAAGAGCAAGACTTCATCTCAAAAAAAAAAAAAAAAAAAAA"
"chr5","112712126","112712427","KN294520v1","90499","90798","29","112621627","GGCCGGGCGCGGTGGCTCACGCCTGTAATCCCAGTACTTTGGGAGGCCGAGGTGGGTGGATCACCTGAGGTCAGGAGTTCGAGACCAGCCTGGCCAACATGATAAAACCCCATCTCTACTGAAAATACAAAACCTAGCCAGGCATGGTGGCAGGCGCCTATAATCCCAGCTACTCGGGGGGCTGAGGCAGAAGAATCGCTTGAACCCGGGAGGCAGAGGTTGCAGTAAGCCGAGATAGCACCATCGCACTCCAGCCTGGGGGACAAGAGCAAGACTTCATCTCAAAAAAAAAACAAAAAGAA","GGCCGGGCGCCGTGGCTCACGCCTGTAATCCCAGCATTTTGAGAGGCTGAGGTGGGTGGATCACCTGAGGTCAGGAGTTCAAGACCAGCCCGGCCAACATGGTGAAACCCCATCTCTACTAAAAATATAAAAACTAGCCAGGCGTGGTGGCAGGCGCCTGTATAATCCCAGTTACTCGGAGGGCTGAGGCAGGAGAATCGCTTGAACCCAGGAGGCAAAGGTTGCAGTGAGCCGAGATCGCACAATCACACTCCAGCCTGGGGTACAAGAGCAAGACTTCATCTCAAAAAAAAAAAAAAA"
"chr5","114388428","114388690","KN294647v1","144909","145144","61","114243519","GGCCAGGCGTGGTGGCTCATGACTATAATCCCAGCACTTTGGAAGGCCAAGGCAGGCGGATCACTTGAGGCCAGGGGTTCCAGACCAGCCTGGCCAGCATGGCAAAACCCTGTCTCTATTAAAAATACAAAACAAATTAGCCAGGTGCGGTGGCAGGTGCCTGTAATTCCAGCTACACAGGGGGCTGAGGCTGGAGAATTGCTTGAACCCGCAAGGCGAAGGTTGCAGTGAGCCACAATTGTGCCACCATACTCCAGCCTGGG","GGTCAGGCATGGTGGCTTATGCCTGTAGTCCCAGCACTTTGGGAGGACAAGGCAGTTGGATCACTTGAGTTCAGGAGTTCTAGACCAGCCTGGCCAACATGGCGAAACCCCATCTCTACTAAAAATACAAAAAATTAGCCAGGTGTGGTGGCAGACACCTGTAATCCCAGCTACCTGGGAGGCTGAGGCAGGAGAATTGATTGAACCCAGGAGACGGAGGTTGCAGTGAGCCAAGA"
"chr5","117691356","117691646","KN295576v1","406337","406628","35","117285019","GGCCAGGCACGTGGGTCATGCCTGTAATCCCAGCACTTTGGGAGGCTGAGGTGGGTGGATCACCTGAGGTCAGGAGTTCTAGACAAGCCTGGCCAACATGGTCAAATCCCATCTCTACTAAAAATACAAAAATTACCCGGGCGTGGTGGCAGGCACCTGTAATCCCAGCTACTTGGGAGGCTGAGTCAGGAGAATTGCTTGAACCTGGGAGGTGGAGGTTGTAGTGAGCCAAGATTGCGCCACTGCACTCCAGCCTGGGGGACAAGAGCAAAACTTCATCTTAAAAAAAAA","GGCCGGGCGCGGTGGCTCACGCCTGTAATCCCAGCACTTTGGGAGGCCGAGGCGGGCGGATCACCTGAGGTAAGGAGTTCGAGAACAGCCTGGCCAGCATGGTGAAACCCCATCTCTACTAAAAATACAAAAATTAGCCGGGCATGGTGGCAGGTGCCTGTAATCCCAGCTACTCGGGAGGCTGAGGCAGAAGAATCGCTTGAACCCAGGAGGCGGAGGTTGCAGTGAGCCGAGATTGCGCCATTGCACTCCAGCCTAGGGGAGAAGAGCGAGACTTCGTCTCAAAAAAAAA"
"chr5","120198064","120198352","KN295576v1","406337","406628","36","119791727","GGCCGGGTGCGGTGGCTCATGCCTGTAATCCCAGCACTTTGGGAGGCCAAGGCGGGTGGATCACCTGAGGACAGGAGTTCTAGACCAGCCTGGCCAACGTAGTAAAATCCCATCTCTACTAAAAATACAAAAATTAGCCTGGCGTGGTGGCAGGCACCTATAATCCCAGCTACTCGGGGGGCCAAGGCAGAAGAATTGCTTGAACCCAAGAGGTAGAGGTTGCAGTGAGCCGAGATTGCACCATCACACTCCAGTCAGGGGTACAAGAGCAAGACTTCGTCTCAAAAAA","GGCCGGGCGCGGTGGCTCACGCCTGTAATCCCAGCACTTTGGGAGGCCGAGGCGGGCGGATCACCTGAGGTAAGGAGTTCGAGAACAGCCTGGCCAGCATGGTGAAACCCCATCTCTACTAAAAATACAAAAATTAGCCGGGCATGGTGGCAGGTGCCTGTAATCCCAGCTACTCGGGAGGCTGAGGCAGAAGAATCGCTTGAACCCAGGAGGCGGAGGTTGCAGTGAGCCGAGATTGCGCCATTGCACTCCAGCCTAGGGGAGAAGAGCGAGACTTCGTCTCAAAAAAAAA"
"chr5","120597102","120597234","KN295241v1","54708","54842","24","120542394","GGCCAGGTGTGGTGGCTCACATCTGTAATCCCTGCTCTTTAGGAGACTGAGGCAGGTGGATCACCTGAGGATAGGAGTTTTAGACCAGCCTGGCCAAGACGGTGAAACCCTGCCTCTATTAAAAATACAAAAA","GGCTGGGCATGGTGACTCACACCTGTAATCTCAGCACTTTAGGAGACGGAGGCGGGTGGATCACCTGAGGTCAGGAGTCCTGGACCAGCCTGGCCAAGATGGCGAAACCCCGTCTCTACTAAACATACAAAAATT"
"chr5","123676410","123676713","KN296541v1","476659","476959","34","123199751","GGCCAGGTACAGTGGCTCATGCCTGTAATCCCAGCACTTTGGGAGGCCAGCATGGGTGGATCATCTGAGGTCAGGAGTTCGAGACCAGCCTGGCCAACATGGTGAAACCCCATCTCTACTAAAAATACAAAAAATAGCCAGGCATGGTGGCAGGCACCTGTAATCCCAGCTACTCGGGAGGCTGAGGCAGGAGAATCACTTGAACCCAAGAGGCGGAGGTTCCAGTGAGTCGAGATCGTGCCATTTGCACTCCAGCCTGGGGGACAAGAGAGAGACTTTGTCTAAAAACAAAACAAAACAAAAA","GGGCTGACGTGGTGACTCATGCCTGTAATCCCAGCACTTTGGGAGGCCGAGGCAAGTGGATCACCTGAGGTCAGGAGTTCGAGACCAGCCTGGCCAACATGGTGAAACCCAGTCTCTACTAAAAATACAAAAATTAGCCAGGCGTGGCGGTAGGCACCTGTAATCCCAGCTACTCGGGAGGCTGAGGCAGGAGAATCACTTGAACTCGGGAGGCGGAGGTTGCAGTGAGCCGAGATCACGCCATTGCACTCCAGCCTGGCGGACAAGAGCGAGACTTTGTCTCAAAAAAAAAAAAAAAAAA"
"chr5","125754171","125754466","KN294685v1","1269570","1269869","29","124484601","GGCCGGGCGCGGTGGCTCATGCCTATAATCCCAGCACTTTGGGGGGCCGAGGTGGGTGGATCACCTGAGGTCAAGAGTTTGAGACCAGCCTGGCCAACATGGTGAAACCCTGTCTCTACTAAAAATACAAAAATTAGCCAGGCGTGGTGGCAGGTGCCTGTAATCCCAGCTACTCGGGAGGCCGAGGCAGGATAATTGATTGAACCCAGGAGGCAGAGGTTGCAGTGAGCTGAGATCACGCCATTGCACTCCAGCCTGGGGGACAAGAGTGAGACTTGGTCTCAAAAAAAAAAAAA","GGCTGGGTGTGGTGGCTTAGGCCTGTAATCCCAGCACTTTGGGAGGCCAAGGCGGGCGGATCACCTGAGGTCAGGAGTTCGAGACCAGCCTGGCCAACATGGTGAAACCCCGTCTCTACTAAAAATACAAAAACTAGCCAGGCGTGGTGGCAGGTGACTGTAATCCCAGCTACTCGGGAGGCTGAGGCAGGAGAACTGCTTGAACCTGGGAGGCGGAGGTTGCAGTGAGCTGAGATCACACCATTGCACTCCAGCCTGGGGGACAAGAGCGAGACTTTGTCTCAAAAATAAAAAAAAAAA"
"chr5","126095847","126096193","KN295294v1","1273221","1273523","72","124822626","GGCCGGGCATGGTGGCTCACGCCTGTAATCCCAGCACTTTGGGAGGCTAAGGCGGGTGGATCACCTGAGGTCAGGAGTTGTGGATCACCTGAGGTCAGGATTTCTAGACCAGCCTGGCCAACATGGTGAAACCCTGTCTCTACTAAAAAAACAAAAATTAGCCGGGTGTGGTGACAGGCACCTGTAATCCCAGCTATTGGGGTGGTGGCGGGGGGTGGTGGTGGTGGGGCGAGGCAGGAGAATCACTTGAACCCAGGAGGTGGAGATTGCAGTGAGCCGAGATCGTGCCATCGCACTCCAGCCTGGGGGACAGGAGCGAGACTTCATCTACAAAAAAAAAAAAAAAA","GGCCAGGCATGGTGGCTCATGCCTGTAATCCCAGCACTTTGGGAGGCCGAGGCAGGTGCATCACCTGAGGTCAGGGGTTCTAGACCAGCCTGGCCAATATGGTGAAACCCCATCTCTACTAAAAATACAAAAATTAGCCGGGTGTGGTGGCAGGCGGCTGTAATCCCAGCTACTCGGGGAGGTGGGGGGTGGGGGGAGGCAGGATAATCGCTTGAACCCGGGAGGTGGAGGTTGCAGTGAGCTGAGATTGCGCCTTCGCACTCCAGCCTGGGGGACAAGAGCAAGACTTGTCTCCAAAAAAAA"
"chr5","126651337","126651650","KN294665v1","171883","172197","37","126479454","GGCCAGGTGCAGTAGCTCATGCCTGTAAGCCCAACACTTTGGGAGGCCAAGGTGGGTGGATCACCTGAGGTCAGGAGTTCGAGACCTGCCTGGCCAACATGGTGAAACCTCGTTTCTACTGAAAATACAAACATTAGCCGGGCATGGTGGCAGGCACCTGTAATCCCAGCTACTCAGGAGGCCGAGGCAAGAGAATTGCTTGAACCCGGGAGGCGAAGGTTGCAGTGAGCCAAGATCACACCATTGCACTCCAGCCTGGGGGACAAGAGCAAGACTTCGTCTACAAAAAAAAAAAAAAAAAAACAAAAAAAAAA","GCCGGGCATGGTGGCTCATGCGTGTAATCCCACCACTTTGGGAGTCCGAGGCAGGTGGATCACCTGAGGTCAGGAGTTCGAGACCAGCCTGGCCAACATGGTGAAACCCCCGTCTCTACTAAAAATACAAAAATTAGCTGGGCATGGTGGCAGGCGCCTGTAATCCCAGCTACTCGGGAGGCTGAGGCAAGAGAATCGCTTGAACCCGGGAGATGGAGGTTGCAGTGAGCCGAGATCGCACCATTGCACTCCAGCCTGGGGGACAAAAGAGAGACTTTGTCTCAAAAAAAAAAAAAAAAAAAAAAAAAAGAAAAA"
"chr5","127902913","127903034","KN295315v1","1304753","1304876","22","126598160","GTCGGGTGTGGTGGCTCATGCCTGTAATCCCAGCACTTTGGGAGGCCAAGGCAGGTAGATCACCTGAGGCCAGGAGTTCTAGACCAGCTTAGCCAACATGGTAAAGCCTCATCTCTTAAAAA","GGGCGGGCGCGGAGGCTCACACCTGTAATCCCAGCACTTTGGAAGGCTGAGGCAGGTGGATCACCTGAGGTCAGGAGTTCCAGACCAGCCTGGCCAACATGGTGAAACCCTGTCTCACTAACAA"
"chr5","128580152","128580197","KN296849v1","913787","913837","11","127666365","CACTCCAGCCGTGGGGGACAAACAAGACTCCATCTCAAAAAAAAAA","ATTGCACTGCAGCCTGGGGGTAAGAGCAAGACTCCATCTCAAAAAATAAAA"
"chr5","128680022","128680320","KN294954v1","166768","167066","26","128513254","GGCCCAGTGCGGTGGCTCACACCTGTAATCCCAGCACTTTGGGAGGCAGAGGTGGGCGGATCACCTGAGGTCAGGAGTTCGAGACCAGCCTGACCAATATAGTGAAACCCCGCCTCTACTAAAAATACAAGAATTAGCCGGGCATGGTTGCAACTGCCTGTAATCTCAGCTACTCAGGAGGCTAAGGCAAGAGAATCGCTTGAACCCGGGAGGCGGAGGTTGCAGTGAGCCAAGATCGCGCCATTGCACTCCAGCTTGGGGGACAAGAGCGAGACTTCATCTACAAAAAAAAAAGAAAA","GGCCCAGTGTGGTGGCTCACGCCTGTAATCCCAGCACTTTGGGAGGCAGAGGCAGGCGGATCACCTGAGGCCAGGAGTACGAGACCAGCCTGCCCAACATGGTGAAACCCCATCTCTACTAAACATACAAGAATTAGCAGGGCATAGTTGCAAATGCCTGTAATCCCAGCTATTCGGGAAGCTAAGGCAAGAGAATGGCTTGAACCCGGGAGCCGGAGGTTGCAGTGAGCCAAGATTGCGCCATTGCACTCCAGCTTGGGGGACAAGAGCGGGACTTCATCTCAAAAAAAAAAAAAAAA"
"chr5","132823996","132824125","KN294420v1","516954","517082","18","132307042","GGCAAGGTACAGTGGCTCACGCCTGTAATCTCAGCACTTTGGGAGACTCAGGCAGGTGGATCACTTGAGGTCAGGAGTTCTAGACCACCCTGGCCAACATGGTGAAACCCCATCTCTACTAAAATACAAA","GGCCTGGCATCATGGTTCACACCTGTAATCCCAGCACTTTGGGAGGCCGAGGCAGGTGGATCACTTGAGGTCAGCGTTCTAGACCAGCCTGGCCAACATGGTGAAACCCTGTCTCTACTAAAAATACAA"
"chr5","132975839","132976149","KN296921v1","822515","822822","35","132153324","GGCCGGATGTGGTGGCTCACGCCTGTAATCCCAGCACTTTGGGAGGCCGAGGCGGGTGGATCACCTGAGGTCAAGAGTTCGAGACCAGCCTGGCCAACACGGTGAAACCCCGTCTCTACCAAAAATACAAAAATTAGCCAGGCGTGGTAGCAGGTGCCTTAATCCCAGCTACTTGGGAGGCAGAGACAGGAGAATCGTTTGAACCCAGGAGGCGGAGGTTGCAGTGAGCCGAGATCGAGCCATTGCACTCAAGCCTGGGGAACAAGAGCGAGACTTCTCTCAAAAAAACAAAAACAAAACAAAACAAAAAA","GGCGCGGTGGCTCACACCTGTAATCCCAGCACTTTGGGAGGCCGAGGTGGGTGGATCACCTGAGGTCAGGAGTTCGTAGACCAGCCTGGCCAACATGGTGAAACCCCATCTCTACTAAAAATACAAACATTAGCTGGGCGTGGTAGCAGGTGCCTGTAATCCCAGCTACTCAGGAGACTGAGGCAGGAGAATCGTTTGAACCCAGGAGGCGGAGGTTGCAGTGAGCCGAGATCATGCCATTGCACTACAGCCTGGGGACAAGAGCAAGACTTCGTCTCAAAAAAAAAAAAAAAAAAGGAAAATAAAAA"
"chr5","133071013","133071147","KN295315v1","1304753","1304876","33","131766260","GTGCGGTAGCTCAAACCTGTAATCCCAGCACTCTGTGAGGCTGAGGCGCGTGGATCACCTGAGGTCAGGAGTTCCAAGTCAGGAGTTCCAGACCAGCCTGGCCAACATGGTGAAACCCTGTCGCTACTAAAAATA","GGGCGGGCGCGGAGGCTCACACCTGTAATCCCAGCACTTTGGAAGGCTGAGGCAGGTGGATCACCTGAGGTCAGGAGTTCCAGACCAGCCTGGCCAACATGGTGAAACCCTGTCTCACTAACAA"
"chr5","133528448","133528740","KN294911v1","4958020","4958317","31","128570428","GGCCAGGCACGGTGGCTCACGCCTATAATCCCAGCACTTTGAGAGGCCAGAGCAGGTGGATGACTTGAGGTCAGGAGTTCGAGACCAGCCTGGCCAACATGGTGAAACCCCGTCTCTACTAAAAATACAAAATTTAGCTGGGTGTGGTGGCAGGTGCCTGTAATCCCAGCTACTCAGGAGGCTGAGACAAGAGAATCGCTTGAACCCAGGAGGCGGAGGTTGCAGTGAGCCAAGATTGTGTACACTCCAGCCTGGGGGACAACAGTGAGACTTCATCACAAAAAAAAAAAGAA","GGCCAGGCGCCGTGGCTCACGCCTGTAATCCCAGCACTTTGAGAGGCCGAGGCAGGTGGATGACTTGAGGTCAGGAGTTCTACACCAGCCTGGCCAAAATGTTGAAACCCCGTCTCTACTAATAATACAAAAATTAGCTGGGCATGGTGGCAGGCGCCTGTAATCCCAGCTACTTGGGAGGCTGAGACAAGATAATCACTTGAACCCGGGAGGCGGAGGTTACAGTGAGCCAAGATTGTGCCATTGCACTCCAGCCTGGGGGACAAGAGCGAGACTTCGTCTCAAAAAAAAACAAAAA"
"chr5","133751908","133752191","KN296495v1","2052820","2053103","31","131699088","GGCCAGGCATGGTGGCTCACGCCTGTAATCCCAGCACTTTGGGAGGCCCAGGCAGGCGGATCACCTGAGGTCAGGAGTTCGAGACCAACCTGGCCAACATAGTGAAACCCCATCTCTACTAAAAATACAAAAATTAGCCAGGCGTGGTGGCAGGCGCCTGTAATACCAGCTACTTGGGAGGCTGAGGCAGGAGAATCGCTTGAACCTGGGAGGCGGAGGTTGCAGTGAGCTGAGATCGTGCCACTGCACTCCAGCCTGGGGGACAAGAGCGAGACTTTGTCTCA","GGCTGGGCACGGTGGCTCACGCCTGTCAATCCCAGCACTTTGGGAGGCTGAGGCAGGTGGATCACCTGAGGTCAGGAGTTCGAGACCAGCATGGCCAACATGGTGAAACCCTGTCTCTACTAAAAATACAAAAATTAGCTGGGCGTGGTGGTAGGCACCTGTAATCCCAGTTACTCGGGAGGCTGAGGCAGGAGAATCGCTTGAACCCAGGAGGTGGAGGTTGCAGTGAGCTGAGATTGCGCCATTGCACTGCAACCTGGGGCACAAGAGCGAGACTTCATCTC"
"chr5","136036795","136036852","KN294758v1","2121332","2121387","13","133915463","AACCCAGGAGGCGGAACTTGCCGTGAGCGGAGATCACGCCATCGCACTCCAGCTTAGG","AACCCAGGAGTTGGAGGTTGCAGTGAACTGAGATCACGCCATTATACTCCAGCATG"
"chr5","136313066","136313137","KN296922v1","568825","568895","15","135744241","AGATTGCACCATTGCACACCAGCCTGGGAGACAAGAGCAAGACTTCATCTCAAAAAAAAAAAAAAAAAAAAA","AGATCGTGCCATTGTACTCCAGCCTGGGGAGCAAGAGCGAGACTTTGTCTCAAAATAAATAAATAAATAAA"
"chr5","140443421","140443522","KN295096v1","1733611","1733710","15","138709810","GGTCGGGTGTGGTGGCTCATGCCTGTAATCCCAACACTTTGGGAGGCTGAGGTGGGTGGATCACCTGAGGTCAGGAGTTCCAGAGGAGCCTGGCTAACATGG","GCCGGGCATGGTGGCTCATGCCTGTAATTCCAGCACTTTCGGAGTCTGAGGCAGGTGGATCACCTGAGGTCAGGAGTTCCAGACCAGCCTGCCCAACATG"
"chr5","142375519","142375807","KN295576v1","406337","406628","33","141969182","GGCCAGGCGCAGTGGCTCACGCCTGTAATCCCAGCACGTTGGGAGGCCGAGGCAGGCGGATCACCTGAGGTCAGGAGTTCGAGACCAGCCTGGCCAACATGGAGAAACCCTGTCTCTACTTAAAATACAAAAATTAGCTAGGCCTGGTGACAGGCGCCTGTAATCCCAGCTACTCGGGAGGCTGAGGCAGGATAATTGTTGAGCCCGGGAGGCAGAGGTTGCAGTGAGCCAAGATCGCGCCATTGCACTCCAGCCTGGGGTACAAGAGTGAGACTTTGTCTGAAAAAAA","GGCCGGGCGCGGTGGCTCACGCCTGTAATCCCAGCACTTTGGGAGGCCGAGGCGGGCGGATCACCTGAGGTAAGGAGTTCGAGAACAGCCTGGCCAGCATGGTGAAACCCCATCTCTACTAAAAATACAAAAATTAGCCGGGCATGGTGGCAGGTGCCTGTAATCCCAGCTACTCGGGAGGCTGAGGCAGAAGAATCGCTTGAACCCAGGAGGCGGAGGTTGCAGTGAGCCGAGATTGCGCCATTGCACTCCAGCCTAGGGGAGAAGAGCGAGACTTCGTCTCAAAAAAAAA"
"chr5","145800469","145800733","KN296495v1","2052820","2053103","52","143747649","GGCTGGGCACAGTGGCTCACGCCTGTAATCCCAGCACTTTGGGAGGCTGAGTCGGGAGGATCACCTGAGGTCAGGAGTTCGAGACCCGCCTGGCTAACATGGTGAAACCTCGTCTCTACTAAAAATATAAAAATTAGCCAGATGTGGTGTCAAGCACCTGCAATCCCAGCTACTTGGGAGGCTGAAGCAGGCGAATCGCTTGAACTGGGGAGGTGGAAGTTGCAGTGAGCCGAGATCGCACCATCGCACTCTAGCCTGGGGGACA","GGCTGGGCACGGTGGCTCACGCCTGTCAATCCCAGCACTTTGGGAGGCTGAGGCAGGTGGATCACCTGAGGTCAGGAGTTCGAGACCAGCATGGCCAACATGGTGAAACCCTGTCTCTACTAAAAATACAAAAATTAGCTGGGCGTGGTGGTAGGCACCTGTAATCCCAGTTACTCGGGAGGCTGAGGCAGGAGAATCGCTTGAACCCAGGAGGTGGAGGTTGCAGTGAGCTGAGATTGCGCCATTGCACTGCAACCTGGGGCACAAGAGCGAGACTTCATCTC"
"chr5","151005120","151005234","KN295706v1","24918","25036","20","150980202","GGCCGGGCGCGGTGGCTCATGCCTGTAATCCTAGCCCTTTGGGATGCTGAGGTGGGTGGATCACCTGAGATCAGGAGTTCCAGACCAGCCTGACCAACATGGTGAAACCCCATCT","GGCCGGGCACAGTGGTTCACGCCTGTAATCCCAGAACTTTGGGAGGCAGAGGCAGGTGAATCACCTGTGGTCAGGAGTTCCAGACCAGCCTGGCTAACATGGTGAAACCCCATCGCTGC"
"chr5","151157540","151157590","KN296308v1","697034","697090","12","150460506","GCACTCCAGCCTGGGGACAAGAGCGAGACTTCATCTCAAAAAAAAAAAGAA","GCACTCTAGCCTGGGGATCCAGAGTGCGACTTCGTCTCAAAAAAATAAAGAAATAAA"
"chr5","152242905","152243204","KN296541v1","476659","476959","38","151766246","GGCCAGGCACGGTGGCTTATGCCTGTAATCCCAGCACTTTGGGAGACCGAGGCAGATCACCTGAGGTCGGGAGTTTGAGACCAGCCTGGCCAACATGGTGAAACCCTGTCTCTACTGAAAATACAAAAATTAGTCTGGCGTGGTGGCAGGTGCCTGTAATCCCAGCTACTCGGGAGGCTGAGGGAGGAGAATCACATGAACCTGGGAGGCCAAGGTTGCGGTGAGCCGAGATCGTGCTATTGCACTACAGCCTGGGGGACAAGAGCGAGACTTCGTCTCAAAAAAATAAAAATAAAAAAA","GGGCTGACGTGGTGACTCATGCCTGTAATCCCAGCACTTTGGGAGGCCGAGGCAAGTGGATCACCTGAGGTCAGGAGTTCGAGACCAGCCTGGCCAACATGGTGAAACCCAGTCTCTACTAAAAATACAAAAATTAGCCAGGCGTGGCGGTAGGCACCTGTAATCCCAGCTACTCGGGAGGCTGAGGCAGGAGAATCACTTGAACTCGGGAGGCGGAGGTTGCAGTGAGCCGAGATCACGCCATTGCACTCCAGCCTGGCGGACAAGAGCGAGACTTTGTCTCAAAAAAAAAAAAAAAAAA"
"chr5","152388903","152389215","KN295090v1","503229","503541","41","151885674","GGCCGGATGTGGTGGCTCATGCCTGTAATCCCAGCACTTTGGGAGGCCAAGGGGGGCGTGGATCACCCGATGTCAGGAGTTCCAGACCAGCCTGGCCAACATGGTAAAACCCTGTCTCTACTAAAAATACAAAAATTAGCCAGGCTTGGTGGCAGGCGCCTGTAATCCCAGCTACTCAGGAGGCCGAGGCAGGAGAATCACTTGAATCTGGGAGGCAGAGTTTGCAGTGAGCCAAGATCATGCCATTGCACTCCAGCCTGGGTGACAAAAGTGAGCCTTCCTCTAAACAAAAACAAAAACAAAAACAAACAAA","GGCCAGGTGTGGTGGCTCACGCCTGTAATCCCAGCACTTTGGAAGGCCAAGGTAGGCGGATCACCTGAGGTCAGGAGTTCAAAACCAGTCTGGCCAAGATGGTGAAACTCTGTCTCTACTAAAAAGAAAAAAATTAGCCAGGCGTGGTGGCAGGTGCCTGTAATCCCAGCTACTCGGGAGGCTAAGGCAGGAGAATCACTTGAACTTGGGAAGCAGAGGTTGCAGTGAGCCAAGATCGTGCCATTGCACTCCAGCCTGGGGGACAAGAGTGAGACTTCATCTCAAAAAAAAAAAAAAAAAACAAAAATTAAAA"
"chr5","152924588","152924887","KN294193v1","690006","690308","30","152234582","GGCCGTGCGCAGTGGCTCACGCCTGTAATCCCAGCACTTTGGGAGGCCGAGGTGGGTGGATCACCTGAGGTCAGGAGTTTGAGACCAGCCTGGCCAACATGGTGAAACCCCGTCTCTACTAAAAATACAAAAATTAGTCGGGCGTGGTGGCAGGCGCCTGTAATCCCAGCTACTTAGGAGGCTGAGGCAGAGAATCGCTTGAACCCAGGAGGTGGAGGTTGCAGTGAGCCGAGACTGCACCATTGTACTCCAGCCTGGGGGATTAGAGCAAGACTTCGTCTCAAAAAAAAGAAAAAAAAA","GGCTGGGCGCGGTGGCTCACGCCTGTAATCCCAGCACTTTGGAAGGCGAGGCAGGCGGATCACCTGAGATCAGGAGTTCGAGACCAGCCTGGCCAACATGGTGAAACCCCATCTCTACTAAAAATACAAAAATTAGTCGGGTGTGGTGGCAGGCGCCTGTAATCCCAGCCACTCGGGAGGCGGAGGCAGGAGAATCGCTTGAACCCGGCAGGCGGAGGTTGCAGTGAGCCGAGGTGGCGCCATTGCACTCCAGCCTGGGGGACAAGAGCAAGACTTCGTCTCAAAAACAAAGAAACAAAAAAA"
"chr5","156058101","156058389","KN295077v1","496548","496840","35","155561553","CACGGTGGCTCACACCTGTAATCCCAGCACTTTGGGAAGCTGAGGTGGGTGGATCACCTGAGGTCAGGAGTTCTAGACTAGCCTGGCCAACATGGTGAAACCCTGTCTCTACTAAAAATACAAAATTAGCCAGGAGTGGTGGCAGGCGCCTGTAATCCCAGCTACTTGGGGGAGCTGAGGCAGGAGAACCGCTTGAACCCGGGAGGCGGAGGTTGCAGTGAGCCGAGATAGCGCCATCGCACTCCAGCCTGGGGAACAAGAGCAAGACTTCGTCTCAAAAAAAAAAAAA","GGCCGGGCATGGGGGCTCACACCTGTAATCCCTGCACTTTGGGAGGCTGAGGTGGGTGGATCACCTGAGGTCAGGAGTTCGAGACAAGCCTGGCCAACATGGTGAAACCCTGTCTCTACTAAAAATACAAAAATTAGCTGGGTGTGGTGGCAGGCGCCTGTAATCCCAGCTACTCAGGAGGCTGAGGCAGGAGAACCGCTTGAACCTGGGAGGCGGAGGTTGCAGTGAGCCAAGAATATGCTATTGCACTCCAGTCTGGGGCACAAGAGCGAGACTTTGTCTCAAAAAAAAAA"
"chr5","159933860","159934160","KN295967v1","470774","471071","34","159463086","GGCCAGGCGCGGTGGCTCACGCCTGTAATCCCAGCACTTTGGGAGGCCGAGGCAGGTGGATCACTGCAGGTCAGGAATTCTAGACGAGCCTGGCCAACGTGGTGAAACCCCGTTTCTACTAAAAATACAAAAATTAGCCAGGCATGGTGGCAGGTGCCTGTAATCCCAGCTATTCCGGGGAGCCAAGGCAGGAGAATCGCTTGAATCCAGGAGGCAGAAGTTGCAGTGAGCCGAAATCGCACCATTGCACTCCAGCCTGGGGGACAAGAGCGAGACTTCATCTCAAAAGAAAAAAAAGAAA","GCTGGGAGCGGTGGCTCACGCCTGTAATCCCAGCACTTTGGGAGGCTGAGGCAGGTAGATCACCTGAGATCAGGAGTTCAAGATCAGCCTGGCCAACATGGTGAAACCCCATCTCAACTAAAAATACAAAAATTAGCCGGGCATGGTGGCAGGTGCCTGTAATCCCAGCTACTTGGGGGGTCAAGGCAGGAGAATCGCTTGAACCCAGGAGGCAGAGGTTGAAGTGAGCCGAGATCATGCCATTGCACTCCAGCCTGGGGGACAAGAGCGAGACTTTCTCTCAAAAAAAAAAAAAAAA"
"chr5","162209673","162209711","KN294471v1","360790","360827","8","161848883","AGGCAGAGGTTGCAGTGAGCCGAGATTGTGCCACCACAC","AGGCAGAGATTGCAGTGAGCCGAGATAGCACGATTACA"
"chr5","162213323","162213616","KN295576v1","406337","406628","30","161806986","GGCCAGGCACAGTGGCTCACTCCTGTAATCCCAGCACTTTGAGAGGCCAAGGCGGGCAGATCACCTGAGGTCAGGAGTTCGAGACCAGCCTGGCCAACATGGTGAAACTCCGTCTATACTAAAAATACAAAAATTAGCTGGGCGTGGTGGCAGGCGCCTGTAATCCCAGCTACTGGGGAGGCTGAGGCAGGAGAATCACTTGAACCCAGGAGGCGGAGGTTGCAGTGAGCCGAGATCATGCCATCGCACTCCAGCCTGGGGGACAGAAGCGAGACTTCATCTCAAAAAAAAAAA","GGCCGGGCGCGGTGGCTCACGCCTGTAATCCCAGCACTTTGGGAGGCCGAGGCGGGCGGATCACCTGAGGTAAGGAGTTCGAGAACAGCCTGGCCAGCATGGTGAAACCCCATCTCTACTAAAAATACAAAAATTAGCCGGGCATGGTGGCAGGTGCCTGTAATCCCAGCTACTCGGGAGGCTGAGGCAGAAGAATCGCTTGAACCCAGGAGGCGGAGGTTGCAGTGAGCCGAGATTGCGCCATTGCACTCCAGCCTAGGGGAGAAGAGCGAGACTTCGTCTCAAAAAAAAA"
"chr5","165661621","165661776","KN296154v1","1320280","1320426","26","164341341","GTAATCTCAGCTACTCGGGAGGCTGAGGCAGGAGAATCGCTAGAACCCAGGAGGCGGAGGTTGTAGTGAGCCGAGATCGCACAACTGCACTCCAGCCTGGGGGACACGAGCTAGACTTCATCTCAAAACAAACAAACAAACAAAAAACCAAAAAAA","GTAATCTCAGCTACTCAGGAGGCTGAGGCAGGAGAATCGCTTGAACGCGAGAGGTGGAGGTTGTAGTGAGCTGAGATTGCACCATCGCACTCCAGTCTGGGGAACAAGAGCGAGACTTCGTCTCAAAAAAACAAACAAAAAAGAAAA"
"chr5","165840961","165841258","KN295576v1","406337","406628","30","165434624","GGCTGGGTGCGGTGGCTCACTCCTGTAATCCCAGCACTTTGGGAGGCCGAGGCGGGCAGATCACCTGAGGTCAGGAGTTCGAGACCAGCCTGGCCAACATGGTGAAACCCCATCTCTACTTAAAATACAAAAAATTAGCCAGGCATGGTGGTATGCACCTGCAATCCCAGCTACTCGGGGGGCTGAGGCAGGAGAATCACTTGAACCTGGGAGGCAGAGGTTGCAGTGAGCCGAGATTGTGCCATTGCACTCCAGACTTGGGGACAAGAGCGAGACTTCGTCTCAAAAAAAAAAAGAA","GGCCGGGCGCGGTGGCTCACGCCTGTAATCCCAGCACTTTGGGAGGCCGAGGCGGGCGGATCACCTGAGGTAAGGAGTTCGAGAACAGCCTGGCCAGCATGGTGAAACCCCATCTCTACTAAAAATACAAAAATTAGCCGGGCATGGTGGCAGGTGCCTGTAATCCCAGCTACTCGGGAGGCTGAGGCAGAAGAATCGCTTGAACCCAGGAGGCGGAGGTTGCAGTGAGCCGAGATTGCGCCATTGCACTCCAGCCTAGGGGAGAAGAGCGAGACTTCGTCTCAAAAAAAAA"
"chr5","166316615","166316910","KN295576v1","406337","406628","32","165910278","GGCCGGGCGTGGTGGCTCATGCCTGTAATCCCAGCACACTGGGAGGCCGAGGTGGGAGGATCACCTGAGCTCAGGAGTTCGAGACCAGCCTGGCCAACATGGTGAAACCCCATCTCTTCTAAAAATACAAAAATTAGCCGGGCTTGGTGGCAGGTGCCAGTAATCCCAGCTACTCGGGAGGCTGAGGCAGGAGAATCACTTGAACCAGGGAGGTGGAGGCTGCAATGAGCTGAGATCATGCCATTGCACTCCAGCCTGGGGGACAAGAGCAAGACTTCGTCCCAAAAAAAAAAAAA","GGCCGGGCGCGGTGGCTCACGCCTGTAATCCCAGCACTTTGGGAGGCCGAGGCGGGCGGATCACCTGAGGTAAGGAGTTCGAGAACAGCCTGGCCAGCATGGTGAAACCCCATCTCTACTAAAAATACAAAAATTAGCCGGGCATGGTGGCAGGTGCCTGTAATCCCAGCTACTCGGGAGGCTGAGGCAGAAGAATCGCTTGAACCCAGGAGGCGGAGGTTGCAGTGAGCCGAGATTGCGCCATTGCACTCCAGCCTAGGGGAGAAGAGCGAGACTTCGTCTCAAAAAAAAA"
"chr5","172661725","172661858","KN295832v1","283853","283976","22","172377872","GGCCAGGCGTGGTGGCTCACACCTGTAATACCAGCACTTTGGGAGGCCGAGGCCGGGAATCACCTGAGGTCAGGAGTTCTAGACCAGCCTAATCATCATGGCGGAAACCGAATTTCTACTAAAAATAAAAAAAT","GGCCAGGTTTGGTGGCTCACGCCTGTAATACCAGCACTTTGGGAGGCCGAGGCCAGCGAATCACCTGAGGTCAAGAGTTCTAGACCAGCCTGGCCATCATGGGGGAAACCCAATTTCTACTAAA"
"chr5","173497876","173498138","KN296665v1","24811","25083","58","173473065","GGTGGCTCACGCCTGTAATCCCAGCACTTTGGAGTTCGAGACCAGCTTGGCCAACATGGTGAAACCCCATCTCTACTAAAAATACAAAACTTAGCCAGGTGTGGTGGCAAGCGCCTGTAATCCAAGCTACTCGGGAGGCCGAGGCAGGAGAATCACTTGAACCTGGAAGGCAGAGGTTGCAGCGAGCAGAGATCATACCATTGCACGCCAGCCTGGGGCACAAGAGCAACACTTGCCAGAAAAAAAAAATCCCACAAAAAAAA","CTTTGGGAGGCACAGGCGGGAGGATCACCTGAGGTCAGAAGTTCGAGACCAGCCTGGCCAAATGGTGAAACACCCAATCTGTACTAAAAATACAAAAATTAGCCGGGCGTGGTGGCGGGCACCTGTAATCCCAGCTACTTGGGAGGCTGAGGCAGGAGAATCGCTTGAACCCAGGAGGTGGAGGTTGCAGCGAGCCAAGATCGCACCATTGCACTCCAGCCTGGGGCACAAGAGCATGACTTTGTCTCAAACAAACAAACAAACAAACAAAAA"
"chr5","174512743","174513052","KN294172v1","4419501","4419812","39","170093242","GGCTGGGCCCGGTGGCTCATGCCTGTAATCCCAGCACTTTGAGAGGCTGAGGCAGGCAGATCACCTGAGGTCAGGAGTTCATAGACCAGCCTGGCCAACATGGTGAAACCCGTCTCTACTAAAAATACGAAAATTAGCCGGGCGTGGTGGCAGGTGCCTGTAATCTCAGCTACTCGGGAGGCTGAGGCATGAGAATCGCTTGAACCCCGGAGTTGGAGGTTGCAATGAGCTGAGATCACGCCATTGCACTCCATCCTGAGGGACTAGAGCAAGACTTCGTCTCAAAAAAGAAAAAAAAAAGAATACAAAA","GGCTGGGCGCAGTGGCTCACGCCTGTAATCCCAGCACTTTGGGAGGCCGAGGCAGGCGGATCACCTGAGGTCAGGAGTTTCAGACCAGCCTGGCCAACATGGTGAAACCCCGTCCCTACTAAAAATACAAAAATTAGCCGGGCGTGGTGGCAGGCACCTGTAATCCCAGCTACTCAGGAGGCTGAGGCAGGAGAATCACTTGAACCCCGGAGGCAGGGGTTGCGGTGAGCCGAGATCGCGCCACTGCACCCCAGCCTGGGGGACAAGAGCAAGACTTCATCTCAAAAATAAATAAATAAATAAAAATAAAAA"
"chr5","175216201","175216504","KN294552v1","673296","673605","71","174542905","GCCAGGTGTGGTGGTGGGCGCCTGTAGTCCCAGCTACTCCGGAGGCTGAGGCAGGAGAATGGCGTGAACCCNNNNNNNNNNNNNNNNNNNNAACATGGTGAAACCCCATCTCTACTAAAAATACAAAAAATAGCTGGGCGTGGTGGCAGGCACCTGTAATCCCAGCTACTCAGGAGGCTAAGGCAAGGAGAATCGCTTGAACCTGGAAGGCAGAGGTTTCAGTGAGCTGAGATCGCACCATTGCACTCCAGCCTGGGGGACAAAGCGAGACTCCGTCTCAAAAAAAAAAAAAGAAAAGAAGAAA","GGCTGGGCGTGGTGGTTCACGCCTGTAATCCCAGCACTTTGGGAGGCTGAGGCAGTGGATCACCTGAGGTCAAGAACTCAAGACCAGCCTGGCCAACATGGTGAAACCCCATCTCTACTAAAAATGCAAAAATTAGCCGGGCGTGGTGGCAGGTGCCTGTCATCCCAGCTACTCAGGAGGCTGAGGCAGGAGAATTGCCTGAACCCAGGAGGTGGAGGTTGCAGTGAGCCGAGATGGCGCCATTGCACTCCAGCCTGGGGGACAAGAGCGAGACTTTGTCTAAAAAAAAAAAAAAAAAGAAAGAAAGAAA"
"chr5","178840696","178840986","KN295172v1","269190","269486","35","178571506","GGCCGGGCACGGTGGCTCACGCCTGTAATCCCAACACTTTGGGAGGCCGAGGCGGGTGGATCACCTGAGGTGAGGAGTTCGAGACCAGCCTGGTGAAACCCCGTCTCTACTAAAAATACAAAAACTAGCCAGGCGTGGTGGCAGCCACCTGTAATCCCAGCTACTTGGGGAGCCAAGGCAGGAGAATCACTTGAACCCAGGAGGCGCAGGTTGCAGTGAGCCGAGACCGCACCATTGCACGCCAGCCTGGGGGACAAGAGCGAGACTTCGTACTAAAAAAAAAAAAAAGAA","GCCGGGCACGGTGGCTCACGCCTGTAATCCAGCACTTTGGGAGGCCGAGGCGGTGGATCACCTGAGGTCAGGAGTTCTAGACCAGCCTGGCCAACATGGTAAAACCCCATCTCTACTAAAAATACAAAAATTAGCTGGGCGTGATGGCAGGCACCTGTAATCCCAGCTACTTGGGGGGCCAAGGCAGGAGAATCGCTTGAACCCTGGAGGCGGAGGTTGCAGTGAGCTGAGATCACACCATCGCACTCCAGCCTGGGGGAGAAGAGCGAGACTTCATCTAAAAAAAAAAAAAAAAAA"
"chr5","179292063","179292356","KN295576v1","406337","406628","29","178885726","GGCCGGGCACGGTGGCTCACGCCTGTAATCCCAGCACTTTGGGAGGCCAAGGCAGGTGGATCACCTGAGGTCAGGAAGTCAAGACCAGCCTGGCCAACATGGCGAAACCCCATCTCTACTAAAACTACAAAAATTAGCCAGGCATGGTGGCAGGTGCCTGTAATCCCAGCTACTCAGGAAGCTGAGGCAGGAGAATCGCTTGAACCTGGGAGGCGGAGGTTGCGGTGAGCCGAGATCGTACCACTGCACTCCAGCCTGGGGGACAAGAGTGAGAATTCGTCTCAAAAAAAAGAA","GGCCGGGCGCGGTGGCTCACGCCTGTAATCCCAGCACTTTGGGAGGCCGAGGCGGGCGGATCACCTGAGGTAAGGAGTTCGAGAACAGCCTGGCCAGCATGGTGAAACCCCATCTCTACTAAAAATACAAAAATTAGCCGGGCATGGTGGCAGGTGCCTGTAATCCCAGCTACTCGGGAGGCTGAGGCAGAAGAATCGCTTGAACCCAGGAGGCGGAGGTTGCAGTGAGCCGAGATTGCGCCATTGCACTCCAGCCTAGGGGAGAAGAGCGAGACTTCGTCTCAAAAAAAAA"
"chr5","183202330","183202420","KN296507v1","587287","587384","24","182615043","GTTGCAGTGAGCCGAGATCATTCCATTGCACTCCAGCCTGAGTGACAAAACCGAGACTTCCTCTCAAAAAAGAAAAAAGAAAAGAAAGAGA","GAGGTTGCAGTGAGCCAAGATCACACCACTGCACCACAGCCTGAGCGAGAAGAGCGAGACTTGGTCTCAAAAAAAATAAAAAATAAAATAAAATAAAA"
"chr6","1752063","1752356","KN295576v1","406337","406628","31","1345726","GGCTGGGTGCAGTGGCTCATGCCTGTAATCCCAGCACTTTGGGAGGCCGAGGCGGGTGGATCACCTGAGGTCAGGAGTTCGAGACCATCCTGGCCAACATGGTGAAACCCTGTCTCTATTGAAAATACAAAAATTAGCCAGGCGTGGTGGCAGGTACCTGTAATCCCAGCTACTCGGGAGGCTGAGGCAGGAGAATCACTTGAATCCAGGAGGCGGAGGTTACAGTGAGCTGAGATGGTGCCATTCCACTCTAGCCTGGGGGACAAGAGTGAGACTTCATCTACAAAAAAAAAA","GGCCGGGCGCGGTGGCTCACGCCTGTAATCCCAGCACTTTGGGAGGCCGAGGCGGGCGGATCACCTGAGGTAAGGAGTTCGAGAACAGCCTGGCCAGCATGGTGAAACCCCATCTCTACTAAAAATACAAAAATTAGCCGGGCATGGTGGCAGGTGCCTGTAATCCCAGCTACTCGGGAGGCTGAGGCAGAAGAATCGCTTGAACCCAGGAGGCGGAGGTTGCAGTGAGCCGAGATTGCGCCATTGCACTCCAGCCTAGGGGAGAAGAGCGAGACTTCGTCTCAAAAAAAAA"
"chr6","8571435","8571743","KN296921v1","822515","822822","36","7748920","GGCCAGGCACGGTGACTGACACCTGTAATCCCACCACTTTGGGAGGCCGAGGTGGGTGGATCACCTGAGGTCAGGAGTTCGAGACCAGGCTGGTCAACATGGTGAAAACCCGTCTCTACTAAAAATACCAAAATTAGCCGGGCATGGTGGCAGGTGCCTGTAATCCCAGCTACTAGGGAGGCTGAGGCAGGAGAATCGCTTGAACTCAGGTAGCAGAGGTTGCAGTGAGCCGAGATCATGCCATTGCACTCCAACCTGCGGGACAAGAGCGAGACTTCGTCTCAAAAAAAAAAAGAAAAGAAAAAGAAA","GGCGCGGTGGCTCACACCTGTAATCCCAGCACTTTGGGAGGCCGAGGTGGGTGGATCACCTGAGGTCAGGAGTTCGTAGACCAGCCTGGCCAACATGGTGAAACCCCATCTCTACTAAAAATACAAACATTAGCTGGGCGTGGTAGCAGGTGCCTGTAATCCCAGCTACTCAGGAGACTGAGGCAGGAGAATCGTTTGAACCCAGGAGGCGGAGGTTGCAGTGAGCCGAGATCATGCCATTGCACTACAGCCTGGGGACAAGAGCAAGACTTCGTCTCAAAAAAAAAAAAAAAAAAGGAAAATAAAAA"
"chr6","12376417","12376710","KN295172v1","269190","269486","37","12107227","GGTCGGGCACGGTGGCTCACGCCTGTAATCCCAACAATTTAGGAGGCCGAGGCAGGTGGATCACCTGAGGTCAGGAGTTCGAGATCAGCCTGGCCAACATGGTGAAACTCCATCTCTACTAAAAATACAAAAATTAGCCGGGCATGATGGCAGGCACCTGTAATCCCAGCTACTTGGGAAGCTGAGGCAAGAGAATCGCTTGAATCTGGAGGTGGACGTTCCGGTGAGCCGAGATCAGTCATCACACTCCAGCCTGGGGGACAAGAGCGAGACTTCGTTTCAAAAAAAAAAAAA","GCCGGGCACGGTGGCTCACGCCTGTAATCCAGCACTTTGGGAGGCCGAGGCGGTGGATCACCTGAGGTCAGGAGTTCTAGACCAGCCTGGCCAACATGGTAAAACCCCATCTCTACTAAAAATACAAAAATTAGCTGGGCGTGATGGCAGGCACCTGTAATCCCAGCTACTTGGGGGGCCAAGGCAGGAGAATCGCTTGAACCCTGGAGGCGGAGGTTGCAGTGAGCTGAGATCACACCATCGCACTCCAGCCTGGGGGAGAAGAGCGAGACTTCATCTAAAAAAAAAAAAAAAAAA"
"chr6","15226427","15226562","KN294269v1","66171","66308","16","15160256","GCCAGGTGCAGTGGCTCATGCAGGTAATCCCAGCACTTTGGGAGGCTGAGGTGGGTGGATCTCTTGAGATCAGGAGTTCTAGACCAGCCTGGCCAACATGGTGAAACCCCGCCTCTAATAAAAATACAAAAATTAG","GGCCAGGTGCAGTGGCTCACGCCTGTAATCCCAGCACTTTTGGAGGCCGAGGCAGGTGGATCACCTGAGATCAGGAGTTCCAGACTAGCCTGGCCAACATGGTGAAACCCCATCTCTACTAAAAATACAAAAATTAGC"
"chr6","16841723","16842029","KN294685v1","1269570","1269869","42","15572153","GGTTGGGCGTGGTGGCTCGCACCTGTCATCCCAGCACTTTGGGAGGCCGAGGTGGGCAGATCACCTGAGGTCAGGAGTTTGAGACCAACCTGGCCAACATGGTGAAACCCTGTCTCTACTCAAAATACAGAAATTAGCCAGGCGTGGTGGCAGGTTCCTGTAATCCCAGCTACTTGGGAGGCTGGGGGCAGGAGGATCGCTTGAACCCAGGAAGCAGAGGTTGCAGTGAACTGAGATTACATCATCACACTCCAGCCTGGGGGATGAGAGCGAGACTTTGTCTCAAGAAAAAAAAAAAAAAAAAAAA","GGCTGGGTGTGGTGGCTTAGGCCTGTAATCCCAGCACTTTGGGAGGCCAAGGCGGGCGGATCACCTGAGGTCAGGAGTTCGAGACCAGCCTGGCCAACATGGTGAAACCCCGTCTCTACTAAAAATACAAAAACTAGCCAGGCGTGGTGGCAGGTGACTGTAATCCCAGCTACTCGGGAGGCTGAGGCAGGAGAACTGCTTGAACCTGGGAGGCGGAGGTTGCAGTGAGCTGAGATCACACCATTGCACTCCAGCCTGGGGGACAAGAGCGAGACTTTGTCTCAAAAATAAAAAAAAAAA"
"chr6","19867955","19868262","KN294387v1","4385906","4386218","30","15482049","GGCCAGGCACAGTGGCTCACGCCTGTAATCCCAGCACTTTGGGAGGCCGAGGCGGGCGGATCACCTGAGGTCAGGAATTCGAGACCAGCCTGGCCAACATGGTGAAACCCCGTCTCTACTAAAATATAAAAAAATTATCCAGGCGTGTTGGCAGGCGACTTAATCCCTGCTACTTGGGAGGCAGAGGCAGGAGAATCATTTGAACCTGGGAGGCGGAGGTTGCAGTGAGCCGAGATCCAGCCATTGCACTCAAACTTGGGGGATAAGAGCGAGACTTCTCTACAAAAAAAAAAAAAAAAAAGAAGAAA","GGCCAGGTGCAGTGACTCATGCCTGTAATCCCAGCACTTTGGGAGGCCGAGGTGGGTGGATCACCTGAGGTCAGGAGTTTGAGACCAGCCTGGCCAACATGATGGAAACCCCGTCTCTACTAAAATATACAAAAAATTACCTGGCGTGGTGACAGGCGACTTAATCCCAGCTACTTGGGAGGCAGAGGCAGGAGAATCGTTTGAACCCGGGAGGCAGAGGTTGCAGTGAGCTGAGATGGAGCCATTGCACTCAAATCTGGGGGATAAGAGTGAGACTTCTCTCAAAAAAAAAAAAAAAAAAAAAGAAAAGAAA"
"chr6","20721072","20721183","KN296635v1","1811423","1811536","18","18909649","GGCCAGGCGCAGTGGCTCATGCCTGTAATCCCAGCACTTTGGGAGGCCAAGGCAGGTAAATCACCTGAGATCAAGAGGTCTAGACTAGCCTGGCTACCATGGCGAAACCCCG","GCCAGGCACAGTGGCTCATGCCTGTAATCCCAGCACTTGGGGAGGCCAAGGCAGGCGGATCACCTCAGGTCAGGAGTTCTAGACCAGCCTGGATAACATCGTGAAACCCCGTCT"
"chr6","21960709","21961005","KN295576v1","406337","406628","35","21554372","GACCGGGTGTGGTGGCTCACACCTGTAATCCCAGCACTTTGGGAGGCCGGGGCGGGGGTGGATCACCTGAGGTCAGGAGTTCAAGACCAGCCTGGCCAAGATGGTGAAACCCCATCTCTACTAAAAATATAAAAATTAGCTGGGCGTGGTGGCAGGTACCTGTAATCCCAGCTACTCGGGAGGCCGAGGCAGGAGAATTGCTTGAACCCGGGAGGCGGAGGTTTCAGGGAGTGGAGATTGTGCCACTGCACTCCAGCCTGGGGGACATGAGTGAGACTTTGTCTCAAAAAAAAAAAA","GGCCGGGCGCGGTGGCTCACGCCTGTAATCCCAGCACTTTGGGAGGCCGAGGCGGGCGGATCACCTGAGGTAAGGAGTTCGAGAACAGCCTGGCCAGCATGGTGAAACCCCATCTCTACTAAAAATACAAAAATTAGCCGGGCATGGTGGCAGGTGCCTGTAATCCCAGCTACTCGGGAGGCTGAGGCAGAAGAATCGCTTGAACCCAGGAGGCGGAGGTTGCAGTGAGCCGAGATTGCGCCATTGCACTCCAGCCTAGGGGAGAAGAGCGAGACTTCGTCTCAAAAAAAAA"
"chr6","22678810","22679084","KN297327v1","439019","439302","41","22239791","GGCCAGGCACGGTGGCTCATGTCTGTAATCCCAGCACTGCAGGAGGCCGAGGCGGGAGTTCAAGACCAGCCTGGCCAATATGGTGAAACCCCCATCTCTACTAAAAATACAAAAATTAGCCGGGTGTGGTGGCAGGCACCTGTATTCCCAGCTACTCGGAGGCTGAGGCAGGAAAATTACTTGAACCCAGGAGGCAGAGGATGCAGTGAGCTGAGATCGCGCCATTGCACTCCAGCCTGGGGGACAAGAGTGAGACTTCGTCCAAAAAAAAAAAA","GGCCAGTCACGGTGGCTCACACCTGTAATCCCAGCACTTTGGGAGGCCAAGGCGGGTGGATCACCTGAGACCAGCCTGGCCAACATGGTGAAACCCCGTCTCTACTAAAAATACAAAAATTAGCCGGGCGTGGTGGCAGGAGCCTGTAGTCCCAGCTACTCAGGAGACTGAGGCAGGAGAATCGCTTGAGCCCGGGAGGCAGACGTTGCAGTGAGCCAAGATCACGCCACTGCATTCCAGCCTGGGGGACAAGAGCGAGACTTCGTCTCAAAAAAAAAAAAAAA"
"chr6","23205880","23206180","KN294713v1","906670","906972","37","22299210","GGCCGGTGAGGTGGCTCACGCCTGTAATCTCAGCACTTCGGGAGGCCGAGGTGGGCGGATCACCTGAGGTTGAGAGTTCAAGACCAGCCTGGCCAACATGGAGAAACCCCATCTCTACTAAAAATACAAAAATTAGCTGGACATAGTGGCAGGCACCTGTAATCCCAGCTACTCGGGAGGTTGAGGTAGGAGAATTGCTTGAACCTGGGAGGCAGAGGTTGCAGTGAGCCGAGATCACACCATCACACTCCAGCCTGGGGGACGAGAGCGAGACTTCATCTCCAAAAAGAAAAGAAAGAAA","GGCCGGGTGCAGTGGCTCAAGCCTGTACTCCCAGCACTTTGGGAGGCCGAGGCGGGCGGATCACCTGAGGTCGGGAGTTCGAGACCAACCTGGTCAACATGGTGAAACCCCTTCTCTACTAAAAACACAAAAATTAGCCGGTCATGGTGGCAGGTGCCTGTAATCCCAGCTACTCGGGAGGCTGAGGCAGGAGAATCGCTTGAACCCTGGAGGCAGAGATTGCAGTGAGCCGAGATCGCACCATTGCACTCCAGCCTGGGGGACAAGAGTGAGACTTCATCTCAAAAAAAAAAAAAAAAAAAA"
"chr6","26578578","26578872","KN294536v1","1833554","1833849","45","24745024","GGCCCAGCTCAGTGGCTCACGCTTGTAATCCCAGCACTTTGGGCGGCCGAGGAAGGCAGATCACCTGAGATCAGGGGTTCGAGACCAGCCTGGCCAACATGGTGAAACCCCGTCTTTACTAAAAATACAAAAATTAGCCGGGCGTGATAGCAGGCAACTGTAATCCCAGCTACATTAGAGAGAGATTAGGAGAATCGCTTGAACCCAGGAGGCGGAGGTTGCAGTGAGCTAAGATCGTGCCATCGAACTCCAGCATGGGAGACAAGAGCAAGACTTCATCTACAAAAAAAAAAAA","GGCCGGGCGTGGTGGCTCATGCCTGTAATCCCAGCACTTTGGGAGGCCGAGGCAGGTGGATCACCCGAGGTCAGGAGTTCGAGACCAGCCTGGCCAATATGGTGAAACCCCGTCTCAGCTAAAAATACAAAAATTAGCCGGGCATGGTGGCAGGCACCTGTAATCCCAGCTGCTTGGGGGGGTAGAGGCAGGAGAATCGCTTGAACCCGGGAGGCGGAAGTTGCAGTGAGCTGAGATTGCGCCATCGCACTCCAGCCTGGGGGACAAGAGCGAGACTTTGTCTCAAAAACAAAAAA"
"chr6","27709016","27709295","KN295941v1","1108709","1108994","43","26600307","GACCGGGCGCGGTGGTTCACGTCTGTAATCCAAGCACTTTGGGAGGCCGAGGCGCTCTGATCACCTTAGGTCAGGAGTTCGAGACCAGCCTGGCCGACATGGTGAAACCCCGTCTCTACTTAAAATACAAAAATTATCCGAGCGTGGTGGCAGGCGCCTGTATTACTAGCTACTCGGGAGGCTGAGGCAAGAGAATTGCTTGAACCCGGGAAGCGGAGGTTGCAGTGAGCCGAAATCGCGCCATTGTCCTCCAGCCTGGGGGACAAGAGCGAGAATTCGT","GCCGGGTGCTTTGGCTCACGCCTGTAATCCCAGCACTTTGGGATGCCGAGGCGGGTGGATCACCTGAGGTCAGGAGTTTGAGACCAGCCTGGCCAACATGGTGAAACCCTGTCTCTACCAAAAATACAAAAATTAGCCGGGCGGGGTGGCAGGCGCCCGTAATCCCAGCTACTCGGAAGGCTGAGGCAGGATAATCGCTTGAACCTGGGAGGCGGAGGTTGCAGTGAGCCGAGATCGCACCATTGCACTCCAGCCTGGGGGACAAGAGCGAGACTTCGTCTCAAAA"
"chr6","29143101","29143328","KN295533v1","2708510","2708735","34","26434591","CCTGCCTGGCCAACACGGTGAAACCCCGTCTCTACTAAAAATACATAAATTAGCGAGGTGTGGTGGCAGGCGCCTGTAATCTCAGCTACTTGGGAGGCTGAGGCAGAAGAATCGCTTGAATCCGCGAGGCGGAGGTTGCAGTGAGCGAGATCGCGCCATTGCACTCCAGCCTAGGGGACAAGAGAGAGACTTCGCCTACAAAAAAAAAAAAAAAAAAGAAAAGAAAAA","GCCTGGCCAACATGGTGAAACCCCATCTCTACTAAAAATACAAAAATTAGCTGGGTGTGGTGGCGGGCGCCTGTAATCCCAGCTACTCAGATGGCTGAGGCAGGAGAATGGCGTGAACCCGGGAGGCGGAGGTTGCAGTGAGCCGAGATCAAGCCATTGCACTCCAGCCTGGGGGACGAGAGCGAGACTTTGTCTCAAAAAAAAATAAATAAATAAAAATAAATAA"
"chr6","29154725","29155035","KN294172v1","4419501","4419812","39","24735224","GGCTGGGTGTGGGGGCTCACACCTGTAATCCCAGCACTTTGGGAGGCCGAGGCGGGTGGATCACCTGAGGTCAGGAGTTCAAGACCAGCATGACCAATGTGGTGAAACCCTGTCTCTACTAAAAATACAAAATTAGCCAGTCGTGGTGGCAGGCACCTGTAATCCCAGCTACTCAGGGAGGCCCAGGCAGAAGAATCACTTGAACCCAGGAGGCGGAGGTTGCAATGAGCTGAGATCGCGCCATTGAACTCCAGCCTGGGGGAGAAGAGCGAGACTTCATCTCAAAACAAACAAACAAACAAAAACAAAAA","GGCTGGGCGCAGTGGCTCACGCCTGTAATCCCAGCACTTTGGGAGGCCGAGGCAGGCGGATCACCTGAGGTCAGGAGTTTCAGACCAGCCTGGCCAACATGGTGAAACCCCGTCCCTACTAAAAATACAAAAATTAGCCGGGCGTGGTGGCAGGCACCTGTAATCCCAGCTACTCAGGAGGCTGAGGCAGGAGAATCACTTGAACCCCGGAGGCAGGGGTTGCGGTGAGCCGAGATCGCGCCACTGCACCCCAGCCTGGGGGACAAGAGCAAGACTTCATCTCAAAAATAAATAAATAAATAAAAATAAAAA"
"chr6","30445798","30446081","KN295576v1","406337","406628","40","30039461","GGCTGGGCGCGGTAGCTCATGCCTGTAATCCCACCTTTGGGAGGCCGAGGCCGGTGGATCACCTGAGGTCAGGAGTTCTAGACCATCCTGGCCAACATGGCAAAACCCCGTCTCTATTAAAAATACAAAAATTAGCCAGGCGTCATGTCAGGTGCCTGTAATCCCAGCTACTCGGGGGGCCAAGGCAGGAGAATCACTTGAACACAGAAGGCAGAGGTTGCAGTGAGCCGAGATCACGCCATTGCACTCCAGCCTAGGGGACAAGAGCAAGACTTTGTCAAAAA","GGCCGGGCGCGGTGGCTCACGCCTGTAATCCCAGCACTTTGGGAGGCCGAGGCGGGCGGATCACCTGAGGTAAGGAGTTCGAGAACAGCCTGGCCAGCATGGTGAAACCCCATCTCTACTAAAAATACAAAAATTAGCCGGGCATGGTGGCAGGTGCCTGTAATCCCAGCTACTCGGGAGGCTGAGGCAGAAGAATCGCTTGAACCCAGGAGGCGGAGGTTGCAGTGAGCCGAGATTGCGCCATTGCACTCCAGCCTAGGGGAGAAGAGCGAGACTTCGTCTCAAAAAAAAA"
"chr6","31480728","31480858","KN296308v1","1041756","1041887","11","30438972","GCTGAGCACGGTAGCTCACACCTGTAATCCCAGCACTTTGGGAGGCTGATGTGGGTGGATCACCTGAGGTTAGGAGTTCCAGACCAGCCTGGCCAACATGGTGAAACCCCATCTCTACTAAAAATATAAAA","GGCTGAGCGCAGTGGCTCATGCCTGCAATCCCAGCACTTTGGGAGGCCTATGTGGGTGGATCACCTGAGGTTAGGAGTTCCACACCAGCCTGGCCAACATGGTGAAACCCCATCTCTACTAAAAATACAAAA"
"chr6","31518848","31519143","KN295474v1","898764","899060","31","30620084","GGCTGGGCACGGTGGCTCACGCCTGTAATCCCGACACTTTGGGAGGCCGAGGTGGGTGGATCACCCGAGATCAGGAATTCGAGACCAGCCTGGCCAACATGGTGAAACCCATCTCTCCTAAAAATACAAAAATTAGCCGGGCGTGGTGGCAGGCGCCTATAAGCCCAGCTACTCGGGAGGCTGAGGCAGGAGAATCGCTGGAACCCGGGAGGTGGAGTTTGTAGTGAGCTGAGATCGTACCATTGCACTCCAGCCTGGGGGACAAGAGCGAGACTTTGTCTAACAAAAAAAAAAAA","GGCTGGGCATGGTGGCTCACGCCTGTAATCCCAGCGCTTTGGGAGGCCCAGGTGGGCGGATTACCTGAGGTCAGGAGTTCGAGACCAGCCTGGCTAACATGGTGAAACCCAGTCTCTACTAAAAATACAAAAATTAGTCGGACATGGTGGCAGGTGCCTGTAATCCCAGCTACTCAGGAGGCTGAGGCAGGAGAATCGCTGGAATACGGGAGGCGGAGGTTGCAGTGAGCCGAGATCATACCATTGCACTCCAGCCTGGAGGACAAGAGCGAGTCTTTGTCTCAAAAAAAAAAAAAA"
"chr6","35000383","35000675","KN295576v1","406337","406628","27","34594046","GGCTGGGCACGGTGGTTCACGCCTGTAATCTCAGCACTTTGGGAGGCCAAGGCAGGCGGATCACCTGAGGTCAGGAGTTCGAGACCAGCCTGGCCAACATGGGGAAACCCCGTCTCTACTAAAAATACAAAAATTAGCCAGGCGTGGTGGCAGGCGCCTGTAATCCCAGCTACTCGGCAGGCTGAGGCAGGAGAATCGCTTGAACCCGGGCGGTGGAAGTTGCAGTGAGCTGAGATCGCGCCATTGCACCCCAGCCTGGGGGATAAGAGCGAGACTTCATCTCAAAAAAAAAA","GGCCGGGCGCGGTGGCTCACGCCTGTAATCCCAGCACTTTGGGAGGCCGAGGCGGGCGGATCACCTGAGGTAAGGAGTTCGAGAACAGCCTGGCCAGCATGGTGAAACCCCATCTCTACTAAAAATACAAAAATTAGCCGGGCATGGTGGCAGGTGCCTGTAATCCCAGCTACTCGGGAGGCTGAGGCAGAAGAATCGCTTGAACCCAGGAGGCGGAGGTTGCAGTGAGCCGAGATTGCGCCATTGCACTCCAGCCTAGGGGAGAAGAGCGAGACTTCGTCTCAAAAAAAAA"
"chr6","35499296","35499627","KN294693v1","1352700","1353006","54","34146596","GGCCAGGCTTGGTGGCTCACTTGTGTAATCCCAGCAGTTTGGGATGCCAAAGGCGGGTGGGTCACCTGAGGTCAGGAGTTTGAGACCAGCCTGGCCAACATGGTGAAACCCCGTCTCTACTTAAAAAAAAAAGAAAAAGAAAAAAATACAAAAATTAGCTGGGCGTGGTGGCAGGCACCTGTAATCCCAGCTACATGGGAGGCTGAGGCCGGAGAATTGCTTGAACCCAGGAGGTGGAGGTTGCAGTGAGCCAAGATTGCACCATCGCACTCCAGCCTGGGGGACAAGAGCGAGACTTCGTCTCAAAAAATAAATAAATAAATAAATAAAAA","GGCCAGGTGTGGTGGCTCACGTCTATAATCCCAGCATTTTGGGAGGCCAAGGCGGGTGGATCACCTGAGGTCAGGAGTTCTAGACCAGCCTGGCCAACATGGTAAAACTCCATCTCTACTAAAAAATACAAAAATTAGCCGGGCGTGGTGGCAGGCACCTGTAATCTCAGCTACTCGGAGGGCTGAGACAGGAGAATTGCTTGAACCTGGGAGGCGGAGGTTGCAGTGAGCCAAGATTGCGCCATCCCACTCCAGCCTGGGGGACGAGAGGGAGACTTCCTCTCAAAAAAAGAAAAAAAAAAAAAAA"
"chr6","36004450","36004758","KN294193v1","690006","690308","35","35314444","GGCCAGGTGCGGTGGCTCACGCCTGTAATCCCAGCACTTTGGGAGGCTGAGGAAGGCGGATCACCTGAGGTCAGGAGTTCCAGACCAGCCTGGCCAACATGGTGAAACCCCATCTCTACTAAAAATACAAAAATTAGCCGGGCGTGGTGGCAGGTGCCTATAATCCCAGCTACTTGGGAGGCTGAGACAGGAGAAGCACTTGAACCCAGGAGAAGGAGGTGGCAGTGAGCCAAGATCATGCCATTGCACTCCAGTCTGGGGGACAAGAGCAAGACTTCGTCTCAAAAACAAACAAACAAACAAACAAAA","GGCTGGGCGCGGTGGCTCACGCCTGTAATCCCAGCACTTTGGAAGGCGAGGCAGGCGGATCACCTGAGATCAGGAGTTCGAGACCAGCCTGGCCAACATGGTGAAACCCCATCTCTACTAAAAATACAAAAATTAGTCGGGTGTGGTGGCAGGCGCCTGTAATCCCAGCCACTCGGGAGGCGGAGGCAGGAGAATCGCTTGAACCCGGCAGGCGGAGGTTGCAGTGAGCCGAGGTGGCGCCATTGCACTCCAGCCTGGGGGACAAGAGCAAGACTTCGTCTCAAAAACAAAGAAACAAAAAAA"
"chr6","36069614","36069911","KN294526v1","558418","558721","41","35511196","GGCCGGGCACAGTGGCTCATGCCTGTAATCCCAGCACTTTGGGAGGCCAAGGTGGGTGGATCACCTGAGGTCAGGAATTCGAGACCAGCCCGGCCAACATGGTGAAACCCCATCTCTACTAAAAATACCAAAAAAACTAGCTGGGCGCCTGTAATCCCAGCTACTCGGGGGCTGAGGCAGGAGAATCGCTTGAACCCGGAGGCAGAAGTTGCAGTGAGCTGAGATCGCGCCATTGCACTCCAGCCTGGGGAACGAAAAGACGAGACTTCATCTCAACAAAAAAAAAAAAACAAAAAAA","GGCCAGGCGCAGTGGCTCATGCCTGTAATCCTAGCACTTTGGGAGGCCGAGGTGGGTTGATCACTTGAGGTCAGGAGTTCGAGCCCAGCCTGGCCAATATGGTGAAACCCCGTCTCTACTAAAAATACAAAAATTAGCCGGACGTGATGGCAGGCACCTGTAATCCCAGCTACTCAGGAGGCTGAGGCAGGAGAATTGCTTGAACCCGGGAGGCGGAGGTTACAGTGAGCTGAGATCGCGCCATTGCACTCCAGCCTTGGGTACAAGAGCAAGACTTCATCTCAAAAAAAAAAAAAAAAAAAAA"
"chr6","36313706","36313840","KN294470v1","2658491","2658626","22","33655215","GGCTGGTTGCTGTGGCTGACGCCTGTAATCCCAGCACTTTGGGAGCCCAAGTCCAGTGGATCACCTGAGGTCAGGAGTTCTAGACCAGCCTGGGCAATATAGTGAGATCCCATCTCTATTAAAAATACAAAAATT","GGCTGGATGCAGTGGCTGATGCCTGTAATTCCAGCACTTTGGGAGGTCAAGGTGGGAGGATCACCTGAGGTCAGGCGTTCTAGACCAGCCTGGCCAACATGGTGAAACCCTGTCTCCACTAAAAATACAAAAATTA"
"chr6","38041556","38041870","KN297313v1","927020","927329","33","37114536","GGCTAGGCACGGTGGCTCACACCTGCAATCCCAGCACTTTGGCAGGCCAAGGCGGGTGGGTCACCTGAGGTCAAGAGTTCGAGATCAGCCTGGCCAACATGGTGAAACCCTGTCTCTACTAAAAATGCAAAAATTAGCCAGGCGTGGTGGCAGGTGCCTGTAATCCCAGCTACTTGGGAGGCTGAGGCAGGAGAATCGCTTGAACCCTGGAGGCAGAGGTTGCAGTGAGCTGAGATAGTGCCATTGCACTCCAGCCTGGGGGACAAGAGCGAGACTTCATCTCAAAAAAAAAAAAAACCAAAAAAAAAAACAAAA","GCCGGGTGCGGTGGCTCACACCTGTAATCCCAGCACTTTGGCAGGCCAAGGCGGGTGGATCACCTGAGGTCAGGAATTTGAGACCAGCCTGGCCAACATGGTGAAACCCAGTCTCTACTAAAAATACAAAAATTAGCTGGGCATGATGGCAGGTGCCTGTAATCCCAGCTACTCGGGAGGCTGAGGCAGGAGAATCGCTTGAATCCGGGAAGTGGAGGTTGCAGTGAGCCGAGATCGTGCCATTACACTCCAGCCTGGGGGACAAAAGAGACTTCGTCTCAAAAAAAAAAAAAAAAAAAAAAAAAAAAAA"
"chr6","44466107","44466414","KN296495v1","2154694","2155006","28","42311413","GGCCGGATGTGGTGGCTCACGCCGGTAATCCCAGCAGTTGGGGAGGCCGAGGTGGGTGGATCACCTGAGGTCAGGAATTCGAGATCAGCCTGGCCAACATGGTGAAACCCTGTCTCTACTAAAAATACAAAAAAATTCACCAGGCGTGGTGGCAGGCGCCTGTAATCCCAGCTACTTGGGAGGCTGAGGCAGGAGAATCGCTTGAACCCGGGAGGTGGAGGTTGCAGTGAGGCGAGATGCCACTATTGCACTCCAGCCTGGGAGACAAGAGCGAGACTTCATCTCGAAAAACAAGAAAAAAAAGAAAA","GGCTGGGTGTGGTGGCTCATGCCTGTAATCCCAGCACTTTGGGAGGCCAAGATGGGAGGATCACCTGAGGTCAGGAATTCGAGATCAGCCTGGCCAACATGGTGAAACCCCGTCTCTACTAAAAATATTAAAAAATTCGCCGGGCATGGTGGCAGGCGCCTGTAATCCCAGCTACTTGGGAGGCTGAGGCAGGAGAATCGCTTGAACCCAGGAGGCGGAGGTTGCAGTGAGGCAAGATCCCGCTATTGCACTCCAGCCTGGGGGACAAGAGCGAGACTTCATCTCAAAAAGAAAAAGAAAAGAACCAAGAAAA"
"chr6","45958719","45959021","KN296970v1","257027","257330","30","45701692","GGCCGGGTGCAGTGGCTCACACCTGTAATCCCAGCATTTGGGAGGCCGAGGCGGGTGCATCACCTGAGGTCAGGAGTTCTAGACCAGCCTGGCCAACATGGTGAAACCCTGTCTCTACTAAAAATACAAAAACTAGCCAGGTGTGGTGGCAGGCACCTGTAATCCCAGCTACTTGGGGGACCGAGGCAGGAGAATTACTTGAACCTGTGAGTTGGAGGTTCCAGTGAGCTGAGATTGTGCCATTGCACTCCAGCCTGGGGAACAACGGTGAGACTTCGTCTACAAAAAAAAAAAAAAAAAAAA","GGCCAGGTGCGGTGGCTCACGCCTGTCATCCCAGCACTTTGGGAGGCCGAGGCAGGTGGATCACCTGAGGTCAGGAGCTCTAGACCAGCCTGGCCAACATGGTGAAACCATGTCTCTACTAAAAATACAAAAACTAGCTGGGCGTGCTGGTAGGTACCTGTAATCCCAGCTACTCGGGGGGCCGAGGCAGGAGAATTACTTGAAACTGGGAGGTGGAGGTTCCATTGAGCTGAGATCGTGCCATTGCACTCCAGCCTGGGGAACAAGAGTGAGACTTCATCGCAAAACAAAACAAAACAAAAAA"
"chr6","49668087","49668381","KN295576v1","406337","406628","36","49261750","GGCCAGGTGCAGTAGTCCATGCCTATAATCCCAGCACTTTGGGAGGCTGAGGCGGGCAGATTACCTGAGGTCAGGAGTTCGAGACCAGCCTGGCCAAAATGGTCAAACCCCATCTCAACTAAAAATACAAAAATTAGCTTGGCATGGTGGCAGTCGCCTGTAATCCTAGCTACTCAGGAGGCTGAGGCAGGAGAATTGCTTGAACCTGGGAGGCGGAGATTGCAGTGAGCTGAGATTGCACCATTACACTCCAGCCTGGGGGAGAAGAGCGAGACTTCATCTCAAAAAAAAGAAA","GGCCGGGCGCGGTGGCTCACGCCTGTAATCCCAGCACTTTGGGAGGCCGAGGCGGGCGGATCACCTGAGGTAAGGAGTTCGAGAACAGCCTGGCCAGCATGGTGAAACCCCATCTCTACTAAAAATACAAAAATTAGCCGGGCATGGTGGCAGGTGCCTGTAATCCCAGCTACTCGGGAGGCTGAGGCAGAAGAATCGCTTGAACCCAGGAGGCGGAGGTTGCAGTGAGCCGAGATTGCGCCATTGCACTCCAGCCTAGGGGAGAAGAGCGAGACTTCGTCTCAAAAAAAAA"
"chr6","50850415","50850726","KN294693v1","1352700","1353006","41","49497715","GGCCAGATGTGGTGGCTCACACCTGTAATTCCAGCACTTTGGGAGGCTGAGGCGGGTGGATCACCTGAGGTCAGGAGTTCTAGATCAGACTGGCTAACATGGTGAAACAACCCCGTCTCTACTAAAAATACAAAAATTAGCCGGCCATGGTGGCAGGCACCTGTAATCCCAGCTACTCGGGGGTCCAAGGCAGGAGAATCGCTTGAACTTGGGAGGCAGAGGTTGCAATGAGCCAAGATTGTACCATTGCACTCCAGCCTGGGGTAAAAGAGCGAGACTTCCTCTACAAAAAAAAAAAAAAAGAAAAAGAAA","GGCCAGGTGTGGTGGCTCACGTCTATAATCCCAGCATTTTGGGAGGCCAAGGCGGGTGGATCACCTGAGGTCAGGAGTTCTAGACCAGCCTGGCCAACATGGTAAAACTCCATCTCTACTAAAAAATACAAAAATTAGCCGGGCGTGGTGGCAGGCACCTGTAATCTCAGCTACTCGGAGGGCTGAGACAGGAGAATTGCTTGAACCTGGGAGGCGGAGGTTGCAGTGAGCCAAGATTGCGCCATCCCACTCCAGCCTGGGGGACGAGAGGGAGACTTCCTCTCAAAAAAAGAAAAAAAAAAAAAAA"
"chr6","51339239","51339533","KN297219v1","1547695","1547989","29","49791544","GCCAGGCGCAGTGGCTCACACCTGTAATCCCAGCACTTTGGGAGGCCGATGTGGGTGGATCACCTGAGGTCAGGAGTTTGAGACCAGCCTGGCCAACATGGTGAAACCCCGTCTCTACTAAAAATACAAAAATTAGCTGAGCGTGGTGGCAGGCACCTGTAATCCCAGCTACTCAGGAGGCTGAGGTAGAAGAATCACTTGAACCTGGGAGGCGGAGGTTACAGTGAGCTGAGATTGCACCATTGCACTCCAGCCTGGGGGACAAGAGTGAGACTTTGTCTCAAAAAAAAAAAAA","GCCAGGCGCAGTGGCTCACACCTGTAATCCCTGCACTTTGGGAGGCCAAGGTGGGCGGATTACCTGAGGGCAGGAGTTTCAGACCAGCCTGGCCAACATGGTGAAACGCCGTCTCTACTAAAAACATAAAAATTATCTGGGTGTGGTGGCAGGCGCCTGTAATCCCAGCTACTCGGGAGCCTGAGGCAGGAGAATTGCTTGAACCCAGGAGGCAGAGGTTGCAGTGAGCCGAGATCGCGCCATTGCACTCCAGCCTGGGGGACAAGAGCGAGACTTGGTCTCAAAAAAAAAAAAA"
"chr6","54517908","54518219","KN294172v1","4419501","4419812","41","50098407","GGTCAGGTGCAGTGGCTCATGCCTGTAATCCCAGGACTTTGGGAGGCTGAGGCGGGTGGATCACCTGAGGTCAGGAGTTCGAGACCAGCCTGGCCAACATGGTGAAACCCCGTCTCTACTAAAAATAGAAAAATTAGCCGGGCGTGGTAGTAGGCACCTGTAATCCCAGCTACTCGGGAGGTTGAGGCAGGAGAATTGCTGGAACCCAGAAGGCAGAGGTTGCAGTGAGTCGAAATCATGCCATCGCACTCAGCCTGGGGGACAAGAGCAAGACTTCGTCTCAGAAAAAAATAAGAAATAAAAAAGAGAGAA","GGCTGGGCGCAGTGGCTCACGCCTGTAATCCCAGCACTTTGGGAGGCCGAGGCAGGCGGATCACCTGAGGTCAGGAGTTTCAGACCAGCCTGGCCAACATGGTGAAACCCCGTCCCTACTAAAAATACAAAAATTAGCCGGGCGTGGTGGCAGGCACCTGTAATCCCAGCTACTCAGGAGGCTGAGGCAGGAGAATCACTTGAACCCCGGAGGCAGGGGTTGCGGTGAGCCGAGATCGCGCCACTGCACCCCAGCCTGGGGGACAAGAGCAAGACTTCATCTCAAAAATAAATAAATAAATAAAAATAAAAA"
"chr6","65152506","65152788","KN295995v1","96471","96768","55","65056035","GCCTGTAATCCCAGCACTTTGGGAGGCCGAGGAGGGCGGATCACCTGAGGTCAGGAGTTCTAGACCAGCCTGGCCAAGATGGTGAAACCCCATCTCTACTAAAAATACAAAAATTAGCCGGGTATGGTGGTGTGTGCCTGTAATCCCAGCGACTCTGGGGGCCAAGGCAGGATAATTGCTTGAACCTGGGAGGCGGAGTTTGCAATGAGTCAAGATTGTGCCATCAAACTCCAGCCTAGGGGACAAGAGCGAGACTTCGTCTTGAAAAAAAAAAAAAAAAAAA","TCAAACCTGTAATCCCAGCACTTTGGGAGGCTGAGGCAGGTGGATCACCCGAGGTCAGGAGTTCTAGACCAGCCTGGTCAACATGGCGAAACCCCATCTCAACTAAAAATACAAAAAAAAAAATTAACCAGGCATGGTGGCAGGCGCCTGTAATCCCAGTTACTTGGGGGGCCAAGGCAGGAGAATTGCTTGAACCCGGGAGGCGGAGGTTGCAGTGAGCTGAGATCGCGCTACTGCACTCCAGCCTGGGGGACAAAAGCGAGACTTTGTCTCAAAAAAAAAAGTTAAAAAAGAAAAA"
"chr6","70733996","70734287","KN297219v1","1714724","1715019","35","69019272","GGCTGGGTGCAGTGGCTCACGCCTGTAATCCCAGCACTTTGGGAGGCCAAGGAGGGCGGATCACCTGAGATCAGGAGTTCGAGACCAGCCTGGCCAGCATGGTGAAACCCTATCTCTACTAAAAATACAAAAATTAGCTGGGCGTGGTGGCAGACCCCTTAATCCCAGCTACTTGGGCGGCTGAAGTAGGAGAATCATTTGAACCCAGGAGGTGGAGGTTGCAGTGAGCTGAGATCCAGCCATTGCACCCAAGCATGGGGGACAAGAGCAAGACTTCTCTCAAAAAAAAAAA","GACCGGGCTCAGTGGCTCACCCCTGTAATCCCAGCACTTTGGGAGGCCGAGGTGGGTGGATCACCTGAGGTCAGGAGTTCGAGACCAGCCTGGCCAACATGGTGAAACCCCATCTCTACTAAAAAATACAAAAATTAGCTGTGCGTGGTGGCAGGTGCCTTAATCCCAGCTACTTGGGAGGTAGAGGCAGGAGAATCATTTGAACCCAGGAGGCGGAGGTTGCAGTGAGCTGAGATAAAGCCATGGCACTGAAACCTGGGGGACAAGAGTGAGACTTCTCTAAAAAAAAAAAGAAA"
"chr6","74598391","74598686","KN297158v1","512906","513208","38","74085485","GGCCAGGCACGGTGGCTCACGCCTGTAATCCCAGCACTTTGGGAAGCCGAGGCAGGCGGATCACCTGAGGTCAGGAGTTCGAAACCAGCTTGGCCAACATGGTGAAACCTCGTCTCTACTAAAAAATACAAAAATTTTCCAGGCGTGGTGGCAGACATCTTAATCCCAGCTACTTGGGAGGCAGAGGCAGGAGAATTGTTTGAACCTGGGAAGCGGAGGTTGCAGTGAGCCAAGATCAAGCCATTGCACCCAAACCTGAGGGACAAGAGTGAGACTTCTCTCAAAAAAAAAGAAAA","GCCAGGCACGGTGGCTCATGCCTGTAATCCCAGCACTTTGGGAGGCCAAGGCGGGCGGATCACCTGAGGTCAGGATTTCGAGACCAGCCTGGCCAACATGGTGAAACCCCATCTCTACTAAAAAAAAAATACAAAAATTAGCCGGGCGTGGTGGCAGGTGCCTTAATCCCAGCTACTTGGGAAGCAGAGGCAGGAGAATGGTTTGAACCTGGGAGGCAGAGGTCTCAGTGAGCCGAGATCGAGCCATTGCGCTCAAGCCTGGGGGACAAGAGTGAGACTTCTCTCAAAAAAAAAAAAAAAAAA"
"chr6","74651514","74651594","KN296311v1","1646100","1646183","22","73005414","GGAGTGCAGTGAGCCAAGATCGTGCTACTGCACTCCAGCCTGGAGGACAAGAGCAAGACTTCATCTCAAAATATAAAAAAA","CAGAGGTTGCAGTGAGCCGAGATCGTGCCACCCCACTCCAGCCTGGGAGACGAGCAAGAGTTCGAGAAAGAAAAGAAAAGAAAA"
"chr6","74753718","74754027","KN294172v1","4419501","4419812","36","70334217","GGCCAGGCACGGTGGCTCACGCCTGTAATCCCAGCACTTTGGGAGGACGAGGTGGGCGGATCACCTGAGGTCAGGAGTTTGTAGACCAGCCTGGCCAACAAGGTGAAACCCCGTCTCTACTAAAAATACAAAAATTAGCCGGGCGTGGTGGCAGGCACTTGTAATCCCAGCTACTCGGGAGGTTGAGGCAGGAGACTCGCTTGAACCCGGGAGGTGGAGGTTGCAGTGAGCCGAGATCACGCCATCGCACTCCAGCCTGGCAGACAAGAGCGAGACTTCGTCTCACAAAAAAAAAAAAAGAAAAGAAAAA","GGCTGGGCGCAGTGGCTCACGCCTGTAATCCCAGCACTTTGGGAGGCCGAGGCAGGCGGATCACCTGAGGTCAGGAGTTTCAGACCAGCCTGGCCAACATGGTGAAACCCCGTCCCTACTAAAAATACAAAAATTAGCCGGGCGTGGTGGCAGGCACCTGTAATCCCAGCTACTCAGGAGGCTGAGGCAGGAGAATCACTTGAACCCCGGAGGCAGGGGTTGCGGTGAGCCGAGATCGCGCCACTGCACCCCAGCCTGGGGGACAAGAGCAAGACTTCATCTCAAAAATAAATAAATAAATAAAAATAAAAA"
"chr6","79459972","79460267","KN295172v1","269190","269486","36","79190782","GCCGGGCACGGTGGCTCATGCTTGTAATCCCAGCACTTTGGGAGGCTGAGGCAGGTGGATCACCTGAGGTCAGGAGTTCGAGACCAGCTTGGCCAACATGGCGAAACCCTATCTCTACTAAAAATTCAAAAATTAGCGGGGCGTGGTGGTGCACACCTGTAATCCCAGCTACTCGGGAGGCTGAGGCAGGAGAATCACTTGAACCCGGGAGGTGGAGGTTGCCGTGAGCCAAGATCGCCCCATCATACTCCAGCCTGGGGGACAAGAGTGAGACTTCATCTAAAAAAAAAAAAAAA","GCCGGGCACGGTGGCTCACGCCTGTAATCCAGCACTTTGGGAGGCCGAGGCGGTGGATCACCTGAGGTCAGGAGTTCTAGACCAGCCTGGCCAACATGGTAAAACCCCATCTCTACTAAAAATACAAAAATTAGCTGGGCGTGATGGCAGGCACCTGTAATCCCAGCTACTTGGGGGGCCAAGGCAGGAGAATCGCTTGAACCCTGGAGGCGGAGGTTGCAGTGAGCTGAGATCACACCATCGCACTCCAGCCTGGGGGAGAAGAGCGAGACTTCATCTAAAAAAAAAAAAAAAAAA"
"chr6","80633776","80634077","KN296594v1","630492","630791","38","80003284","GGCTGGGCACGGTGGCTCATGCCTGTAATCCCAGTACTTTGGGAGGCCGAGGTGGGTGGATCACCTGAGGTCAGGAGACGGAGACCAGCCTGGCCAACATGGTGAAACCCTGTCTCTACTAAAAACACACAAAAAAATTAGCCGGGCATGGTGGCAGGTGCCTGTAATCCTAGCTACTTGGGAGGCTGAGGCAGGACAATCGCTTGAACCCGGGAGGCAGAGGTTGCAGTGAGCCGAGACCGTGCCATCACACGCCAGCCTCGGGGACAAGAGCGAGACTTCATCTCAAAAAAAAAAAAAAA","GCTGGGCACGGTGGCTCACGCCTGTAATCCCAGCACTTTGGGAGGCCGAGACAGGTAGATCATCTGAGGTCAGGAGTTCGAGACCAGCCTGGCCAACAGAGTGAAACCCCGTCTCTACTAAAAATACAAAAATTAGCCTGGTGTGATGGCAGGTGCCTGTAATCCCAGCTACTTGGGAGGCTGAGGCAGAAGAATCGCTTGAACCCGGGAGGCGGAGGTTGCAGTGAGCTGAGATCGCGCTATTACACTCTAGCCTGGGGGACAAGAGCGAGACTTCATCTCAAAAAAAAAAAAAAAGAA"
"chr6","90929164","90929473","KN296487v1","155885","156190","36","90773279","GGCCGGGTGCAGTGGCTCACGCCTGTAATCCCAGCACTCTGGGAGGCTGACGTGGGTGGATCACTTGAGGTCAGGAGATCGAGACCAGCCTGGCCAACATGGTGAAACCTCGTCTCTACTAAAAATACAAAAATTAGCCAGGGGTGGTGGCAGGTGCCTGTAACCCCAGCTACTCGGGAGGCTGAGGCAAGAGAATCGCTTGAACCCAGAAGGTGGAGGCTGCAGTGAGCTGAGATCACACCACTGCACTCCAGCCTTGGGGACAAGAGCGAGAGACTTCGTCTCAAAAAAAAAAAAAAACAAAAAAGAA","GGCCGGGTGCAGTGGCTCACACCTGTAATCCCAGCACTTTGGGAGGCTGAGGTGGGTGTATCACCGGAGGTCAGGGGATCAAGACCAGCCTGGCCAACATGGTGAAACCCCGTCTCTACTAAAAATACAAAAATTAGCCAGGCATGGTGGCAGGCACCTGTAATCCCAGCTGCTCAGCAGGGGCTGAGGCAGGAGAATCACTTGAACCCAAGAGGCAGAGGTTGCAGTGAACTGAGATCACGCCATTGCACTCCAGCCTGGGGGACAAGAGCAAGACTTCGTCTCAAAAAAAAAAAAAAAAAAGAA"
"chr6","94667437","94667734","KN295287v1","40787","41080","27","94626650","GGCCAGGGACAGTGGTTAACACCTGTAATCCCAGCACTTTGGGAGGCCGAGGCAGGTGGATCACCTGAGGTCAGGAGTTCGAGACCACCAGCCTGGCCAACATGGTGAAACCCCATCTCTACTAAAAATACAAAAATTAGCCAGGCGTGGTGGCAGGCACCTGTAATCTCAGCTACTCGCAAGGCTGAGGCAGGAGAATCGCTTGAACCCAGGAGGCGGAGGTTGCAGTGAGCCAAGATGGCACCATTGCACTCCAGCCTGGGGGACAAGAGTGAGACTTCATCTCAAAAAAAAAAAA","GGCAGGGCACGGTGGCTCACGCCTGTAATCTCAGCATTTTGGGAGGCCGAGGCAGATGGATCACCTGAGGTTGGGAGTTCGAGACCAGCCTGGCCAATATGGTGAAACCCCATCTCTACTAAACATACAAAAATTAGCTGGGCGTGGTGGCAGGCACCTGTAATCCCATTACTTGAGAGGCTGAGGCAGGAGAATCACTTGAACCCAGGAGGCGGAGGTTGCAGTGAGCCAAGATCGCACCATTGCACTCCAGCCTGGGGGATAAGAGTGAGACTTCATCTCAAAAAAAAAAAA"
"chr6","99098106","99098406","KN294685v1","1269570","1269869","39","97828536","GGCCAGGCGTGGTGGCTCACGCCTGTAATCCCAGCACTTTGGGAGACCGAGGTGGGTGGATCACCTGAGGTCAGGAGTTCGAGACCAGCCTGGCCAACATGGTGAAACCCCCTGTCTACTAAAACTACAAAAACTAATGGCATGGTGGTGGCAGGCGCATGTAATCCCAGCTACTCAGGAGGCTGAGGCAGGAGAATTGCTTGAACCCAAAAGGCGGAGGTTGCGGTGAGTCAAGATCACGCCACTGCACTCCAACCTGGGGGACAAGAGCGAGGCTTCATCTCAAAACAGAAAAAAAAAA","GGCTGGGTGTGGTGGCTTAGGCCTGTAATCCCAGCACTTTGGGAGGCCAAGGCGGGCGGATCACCTGAGGTCAGGAGTTCGAGACCAGCCTGGCCAACATGGTGAAACCCCGTCTCTACTAAAAATACAAAAACTAGCCAGGCGTGGTGGCAGGTGACTGTAATCCCAGCTACTCGGGAGGCTGAGGCAGGAGAACTGCTTGAACCTGGGAGGCGGAGGTTGCAGTGAGCTGAGATCACACCATTGCACTCCAGCCTGGGGGACAAGAGCGAGACTTTGTCTCAAAAATAAAAAAAAAAA"
"chr6","104765237","104765447","KN296311v1","3342549","3342759","49","101422688","AGACCAGCCTGGCCAACACGGTGAAACTCCGTCTCTACTAAAAAAATAGAAAAATTAGCCAGGTGTGGTGGCAGGCACCTTAATCCCAGCTACTTGGGAGGCAGAGGCAGGAGAATCATTTGAACTTGGGAGGCAGAGGTTACAGTGAGCTGAGATTGAGCCATTGCATTCAAGCCTGGGAGACAAGAGCAAGATTTTTCTCGAAAAAAAA","AGACCAGCCTGGCCAAAACCCTGTCTCTACTAAAAATACAAAAATTAGCCCGGCATGGTGGCAGGCACCTGTAACCCAACCCCAGCTACTTGGGGGGCTGAGGCAGGAGAATCGCTTGAACCCGGGAGGTGGAGGGTGCAGTGAGCCGAGATCGCGTCATTGCACTCCAGCCTGGGGATCAGGAGCAAGACTTCATCTCAAAAAAAAAAAA"
"chr6","106412724","106412848","KN295315v1","1304753","1304876","17","105107971","GGCCGGGCGCGGTGGCTCAGGCCTGTAATCCCAGCACTTTGGGAGGCCGAGGCAGGCGGATCACCTGAGGGCAGAAGTTCTAGATGAGCCTGGCTAACATGGTGAAACCCCGTTTCCACTAAAAA","GGGCGGGCGCGGAGGCTCACACCTGTAATCCCAGCACTTTGGAAGGCTGAGGCAGGTGGATCACCTGAGGTCAGGAGTTCCAGACCAGCCTGGCCAACATGGTGAAACCCTGTCTCACTAACAA"
"chr6","108278952","108279251","KN296883v1","2444932","2445228","34","105834020","GCCAGGTGCGGTGGCTCACGCCTGTAATCCCAGCACTTTGGGAGGCCGAGACGGGTGGATCACCTGAGGTCAGGAGTTCGAGACCAGCCTGGCCAACATGGTGAAACCCCGTCTCTACTAAAAATATAAAAAATTAGCTGGACGTGGTAGCGGGCGGGCACCTGTAATCCCAGCTACTTGGGTGGCCAAGGCAGGAGAATTGCTTGAACCCCGGAGGCAGAGGTTGCAGTGAGCCAAGATCGTGCCATCGCACTCCAGCCTGGGGTACAAGAGTGAGACTTCGTCTCAAAAAAAAAAAAA","GGCCGGGCACGGTGGCTCATGCCTGTAATCCCAGCACTTTGGGAGGCCAAGGCGGGTGGATCACCTGAGGTCAGGAGTTCTAGACCAGACTGGCCAACATGGTGAAACCCCATCTCTACTAAAAATACAAAAATTAGCCAGATGTGGTGGCAGGCTCCTGTAATCTCAGCTACTCGGGGGGCCAAGGCAGGAGAATTGCTTGAACCCAGGATGCAGAGGTTGCAGTGAGCCAAGATCACGCCATCGCATTCCAGCCTGGGAGACAAGAGTGAGACTTCATATCAAAAAATAAAAAAA"
"chr6","108962451","108962746","KN295576v1","406337","406628","31","108556114","GGCTGGGCGCGGTGGCTCACACCTGTAATCCCAGCACTTCGGGAGGCCAGTGCGGGCGGATCACCTGAAGTCAGGAGTTCGAGACCAGCCTGGCCAACATGGTGAAACCCCCGTCTCTACTAAAAATACAAAAATTAGCCTGGCGTGGTGGCAGGCGCCTGTAATCCCAGCTACTCAGGAGGCTGAGGCAGGAGAATCACTCGAACCCGGGAGGAGGAGGTTACAGTGAGCCGAGATGGCGCCATCACACTCCAGCCTGGAGGACAAGAGCAAGACTTCGTCTCCAAAAAAAAAAA","GGCCGGGCGCGGTGGCTCACGCCTGTAATCCCAGCACTTTGGGAGGCCGAGGCGGGCGGATCACCTGAGGTAAGGAGTTCGAGAACAGCCTGGCCAGCATGGTGAAACCCCATCTCTACTAAAAATACAAAAATTAGCCGGGCATGGTGGCAGGTGCCTGTAATCCCAGCTACTCGGGAGGCTGAGGCAGAAGAATCGCTTGAACCCAGGAGGCGGAGGTTGCAGTGAGCCGAGATTGCGCCATTGCACTCCAGCCTAGGGGAGAAGAGCGAGACTTCGTCTCAAAAAAAAA"
"chr6","109900423","109900488","KN296922v1","568825","568895","22","109331598","CTGAGATCGTGGCACTGCACTCCAGCCTGAGGGACAAGAGTGAGACTCTATTTCCAAAAAAAAGAA","AGATCGTGCCATTGTACTCCAGCCTGGGGAGCAAGAGCGAGACTTTGTCTCAAAATAAATAAATAAATAAA"
"chr6","110418535","110418826","KN295077v1","496548","496840","38","109921987","GCTGGGCACAGTGGTTCACGCCTGTAATACCAGCACTTTGGTAGGCTGAGGCGGGAGCATCACCTGAGGTGAGGAGTTTGAGACCAGCCTGGCCAACATGGTGAAATCCCGTCTCTACTAAAAATACAAAAAATTAGCTGGGTGTGGTGGCTGGCGCCTGTAATCCCAGCTACTCAGGAGGCCGAAGCAGGAGAATCGCTTGAACCCGGGAGGTGGAGGTTGCAGTGAGCCAAGATCACACCATTTTACTCCAGCCTGGGGGACAAGAGCAAGACTTCGTCTCAAAAATAAA","GGCCGGGCATGGGGGCTCACACCTGTAATCCCTGCACTTTGGGAGGCTGAGGTGGGTGGATCACCTGAGGTCAGGAGTTCGAGACAAGCCTGGCCAACATGGTGAAACCCTGTCTCTACTAAAAATACAAAAATTAGCTGGGTGTGGTGGCAGGCGCCTGTAATCCCAGCTACTCAGGAGGCTGAGGCAGGAGAACCGCTTGAACCTGGGAGGCGGAGGTTGCAGTGAGCCAAGAATATGCTATTGCACTCCAGTCTGGGGCACAAGAGCGAGACTTTGTCTCAAAAAAAAAA"
"chr6","110648325","110648631","KN295172v1","269190","269486","34","110379135","GGCCGGGCACGGTGGCTCATGCCTGTAATCCCAGCACTTTGGGAGGCCAAGGCAGGTGGATCACCTGAGGTGAGGAGTTCTAGACCATCCTGGCCAACATGGTGAAACCCCATCAGTACTAAAAGTACAAAAATTAGCCGGGCGTGGTGGCAGGCATCTGTAATCCCAGCTACTTGGGAAGCTGAGGCAGGAGAATTGCTTGAACCTGGGAGGTGGAGGTTGCAGTGAGCTGAGATTGCGCCATCACACTCCAGCCTGGGGGACAAGAGCGAGACTTCATCTCAAACAAAAACAAACAAACAACAAA","GCCGGGCACGGTGGCTCACGCCTGTAATCCAGCACTTTGGGAGGCCGAGGCGGTGGATCACCTGAGGTCAGGAGTTCTAGACCAGCCTGGCCAACATGGTAAAACCCCATCTCTACTAAAAATACAAAAATTAGCTGGGCGTGATGGCAGGCACCTGTAATCCCAGCTACTTGGGGGGCCAAGGCAGGAGAATCGCTTGAACCCTGGAGGCGGAGGTTGCAGTGAGCTGAGATCACACCATCGCACTCCAGCCTGGGGGAGAAGAGCGAGACTTCATCTAAAAAAAAAAAAAAAAAA"
"chr6","113029307","113029425","KN294446v1","507219","507341","17","112522088","GGCCAGGTGTGGTGACTCACGCCTGTAATCCCAGCCTTTGGGAGGCCGAGGTGGGTGGATCACCTGAGGTCAGGAGTTCCAGACCAGCCTGGCCAACATGGTGAAACCCCATCTCTCCT","GGCCAGGCGCGGTGGCTCACGCCTATAATACCAGCACTTTGGGAGACCGAGGCAGATGGATCACCTGAGGTCAGGAGTTCCAGATCAGCCTGGCCAACATAGTGAAACCCCATCTCTTTTAAA"
"chr6","113939094","113939326","KN294900v1","1359689","1359907","39","112579405","AGCCTGGCCAATATGATGAAATCCTGTCTCTGCTAAAAAAAAAAAAAGACACAAAAATTAGCCGGGTGTGGTGGCGGGCGCCTGTAATCCCAGCTGCTTGGGAGGCTGAGGCAGGAGAATCGCTTGAACCTGGGAGGCGGAGGTTGCAGTGAGCCGAGATCGTACCATTGCACTCCAGCCTGGGGGACAAGAGTGAGACTTATTCTCAAAAAAAAAAAAGATTAAAAATAAAA","AGTCTGGCCAATATGGTGAAATCCCATCTCTACTAAAAAAAAAAAAAGATACAAAAATTAGCTGGGCGTGGTGGCGGGTACCTGTAATCCAAGTTACTTGGGAGGCCAAGGCGGGAGAATTGCTTGAACCTGGGAGGCAGAGGTTGCAGTGAGGGGAGATCGCACCATTGCACTCCAGCCTGGGGGACAAGAGCAAGACTTCGTCTCAAAAAAAGAAAA"
"chr6","114462945","114463077","KN296040v1","489522","489654","20","113973423","GACGGGGAGCAGTGGCTTACCACTGTAATCCCAGGACTTTGGGAGGCTGAGACAGGTGGATCACCTGAGGTCAAGAGTTTTAGACCAGCCTGGCCAGCATGGTGAAAACCTATCTCTACTAAAAATACCAAAA","GGCTGGGCGCAGGGGCTCACACCTGTAATCCCAGCACTTTGGGAGGCTGAGGTGGGTGGATCACCTGAGGTCAGGAGTTCCAGACCAGCCTGGACAACATGGTGAAATCCCATCCCTACTAAAAATACAAAAA"
"chr6","118733604","118733903","KN297077v1","416198","416496","25","118317406","GGCGGGGTGTGGTGGCTCAGGCCTGTAATCCCAGCACTTTGGGAAGCCAAGATGGGTGGATTACCTGAGGTCAGGAGTTTGAGACCAGCCTGCCCAACATGGTGAGACCCCCATCTCTACTAAAAATACAAACAAAATTAGCCGGGCATGGTGGCATGTGCCTGTAATCCCAGCTACTAGGGAGGCTGAGGCAGGATAATCGCTTGAACCAGGGAGGCAGAGGTTGCAGTGAGCCGAGATTGCGCCATTGCACTCCAGCCTGGGGGACAAGAGCGAGACTTCATCTCAAAAAAAAAGAAA","GGCCAGGCACGTTGGCTCAGGCCTGTGACCCCAGCACTTTAGGAAGCTAAGATGGGTGGCTCACCTGAGGTCAGGAGTTCGAGGCCAGCCTGCCCAACATGGTGAGACCCCCGTCTCTACTAAAAATACAAACAAAATTAGCCGGGCGTGGTGGCATGTGCCTGTAATCCCAGCTACTCGGGAGGCTGAGGCAGGAGAATAACTTGAACCAGGAAGGCAGAGGTTGCAGTGAGCCAAGATCGCGCCATTGCACTCCAGCCTGGGGGACAAGAGCGAGACTTCGTCTCAAAAAAAAGAAA"
"chr6","122443426","122443715","KN295315v1","992137","992431","37","121451289","GGCAGGGCGTGGTGGCTCACACCTGTAATCCCAGCACTTTGAGAGACTGAGGCGTTTGGATCACCTGAGGTCAGGAGTTCCAGACCAGCCTGACCAACATGGTGAAACTGTCTCTACTAAAAAAACAAAAATTAGCTGGACATGGTGGCAGGCACCTGTAATCCCAGCTGCTCGGGAGGCTGAGGCAGGAAAATCGCTAGAATCCGGGAGGCAGAGGTTGCAGTGAGCCGAGATCGTGCCATTGTACTCCAGCCTTGGGGAAAGAGTGAGATTCTGTCAAAAAAAAAAAA","GGCTGGCCGCGGCGGCTCATGCCTGTAATCCCAGCACTTTGGGAAGCTGAGGCGGGTGGATCACCTGAGGTCAGGAGTTCGAGAGCAGCCTGGCCAACGTGGTGAAACTGTGTCTCTACTAAAAATACAAAAATTAGCTGGGCGTGGTGGCAGGCACCTGTAATCCCAGCTACTTGGGAGACTGAGGCAGGAGAATCGCTTGAACCCAGGAGGTGGAGGTTGCAGTGAGCCGAGATCACGCCATTGTACTCCAGCCTGGAGGATAAGAGTGAGACTTCGTCTCAAAAAAAAAAAA"
"chr6","124752910","124753120","KN294647v1","144909","145144","87","124608001","GGCACGGCTCAGTGGCTTATGCCTGTAATCTCAGCACTTTGGGAGGCTGAGGCAGGTGGATCATCTGAGCTCAGCCTGGGCAACATAGTGAAACCTCATCTCTACAAAAATTTTTTTAAAAAAACTACTTAGAAGGCTGAGGTGGGAGGATTGCTTGAGCCTGGGAGGTGGATGGTGCAGTGAGCCAAGATCACGCTATTACACTCCAGCC","GGTCAGGCATGGTGGCTTATGCCTGTAGTCCCAGCACTTTGGGAGGACAAGGCAGTTGGATCACTTGAGTTCAGGAGTTCTAGACCAGCCTGGCCAACATGGCGAAACCCCATCTCTACTAAAAATACAAAAAATTAGCCAGGTGTGGTGGCAGACACCTGTAATCCCAGCTACCTGGGAGGCTGAGGCAGGAGAATTGATTGAACCCAGGAGACGGAGGTTGCAGTGAGCCAAGA"
"chr6","127412778","127413082","KN296496v1","794027","794330","29","126618751","GGCCGGGCGCGGTGGCTCACACCTGTAATCCCAGCACTTTGGGAGGCTGAAGCGGGTGGATCACCTGAGGTCAGGAATTTGAGACCAGCCTGGCCAACATGGTGAAACCCTGTCTCTACAAAAAATACAAAAATTAGCTGGGCATGGTGGCAGGCACCTGTAATCCCAGCTACTCGGGAGGCCGAGGCAAGAGAATCGCTTGAACCCAGGAGGTGGAGGTTGCAGTGAGCTGAGATCATGCCATTGAACTCCAGCCTGGGGGACAAGAGGAAGACTTTGTCTCAAAAAAAAAAAAAAAAAAAGAA","GGCCAGACGCGGTGGCTCACGCCTGTAATCCCAGCACTTTGGGAGGCCGAGGTGGGTGGATCACCTGACATCTGGAGTTCGAGACCAGCCTGGCCAACATGGTGAAACCCTGTCTCTACTAAAAATACAAAAATTAGCTGGGCATGGTGGCAGGCACCTGTAATCCCAGCTACTTGGGAGGCTGAGGCAGGAGAATCGCTTGAACCCGGGAGGTGGAGGTTCCAGTGAGCCAAGATTGTGCCATTGCACTCCAGCCTGGGGAATAAGAGCAAGATTTTGTCTCAAAAAAAAAAAAGAAGAAGAA"
"chr6","130858748","130859093","KN296974v1","258695","259015","58","130600053","GGCTGGGCGTGGTGGCTCACGCCTGTAATCCCAGCACTTTGGGAGGACCAGGTGGGTGGATCACCCGAGGTCAGGCGTTCCAGACCAGCCTGGCCCACATGGTGAAACCCCATCTCTACTAAAAATACAAAAATTAGCCAGGTTTGGTGGCAGGCACCTGAAATCCCAGCTACTCATGGGGGTGGGGGTGGGGGGGCCAAGGCCGGAGAATCGCTGGAACCTGGGAGGCAGAGGCTGCAGTGAGCCAAGATCATGCCATTGCACTCCAGCCTGGGGGACAAGAGCGAGACTTTGTCTCAAAAAAAAAGGAAAAAAAAAGAGTAATCAAAATAAACCAAAGACAAAA","GACTGGGCGCGGTGGTTCACGCCTGCAATCCCAGCACTTTGGGAGGCCGAGGTGGGTGGATCACCTGAGGTCAGGAGTTCTAGACCAGCCTGGCCAACATGGTGAAAGCCCATCTCTACTAAAAATACAAAAATTAGCCAGGCGTGGTGGCAGGTGCTTGTAATGCCAGCTACTCAGGTTGGGGGAGGGGCAGGGCCGGAGAATTGCTTGAACCCGGGAGGCGGAGGTTGCAGTAAGCTGAGATCACGCCATTGCACTCCAGCCTGGGGGACAAGAGCGAGACTTCATCTCAAAGAAAAAAAAGAAAGAAAAAAAAAAAAA"
"chr6","132084108","132084393","KN295205v1","747901","748198","53","131336207","CTGTAATCCTAGCACTTTGGGAGGCTGAGGCGGGTGGATCACCTGAGGTCAGGAGTTCAAGACCAGCCTGGCCAACATGGTGAAAACCCCGTTTCTACTAAAAACACAAAAATTAGCTGGGCATGGTGGCAGGTAACTGTATTCCCAGCTACACGGGAGGCTGAGGCAGGAGAATCGCTTGAACCCAGGAGGCGGAGGTTGCAGTGAGCCAAGATCAGTGTCGTCGTACTCTAGCCTGGGGGTCAAGAGCGAGACTTCATCTCCAAAAAAAAAAAAAGAATAAGAA","GTGGTTCACGCCTGTAATATCAGCACTTTGGGAGGCTGAGGCGGGCGGATCACCTGAGGTTGGGAGTTCGAGACCAGCCTGGCCAATATGGTGAAACCCTGTCTCTACTGAAAATACAAAAATTAGCTGGGCATGGTGGCAGGCGGCTGTAATCCCAGCTACTTGGGAGGCTGAGGCAGGAGAATCACTTGAACCCGGGAGGCGGAGGTTGCAGTGAGCCGAGATCGTGCCATCGCACTCCAGCCCGGGGGACAAGAGCAAGATTTTGTCTGAAAAAAAAAAGGGAGAAAGAAAGAAA"
"chr6","134915437","134915501","KN294269v1","1390365","1390426","17","133525072","GACTAAGCACAGTGGCTCACGCCTGTAATCTCAGTACTTTGGGAGGTCCAGGCAATTGTTTCACC","GACCAGGTGCTGTGGCTCATGCCTGTAATCCCAGCACCTTGGGAGGCTGAGGCGGATTCACC"
"chr6","136732481","136732631","KN296470v1","174157","174317","28","136558324","GCCGGGCATGATGGCAGGTGCCTGTAATCGCACCTACTTGGGAGGCTGAGGCAGGAGAATTGCTTGAACCCGGGAGGCGGAGGTTGCAGTGAGCCGAGATCGTGGCATTGCATTCCAGCCTGGGGGACAAGAGTGAGACTTCATCTCAAAA","GCTGGGCGTGGTGGCAAGTATCTATAATCCCAGCTACTTGGGAGGCTGAGGCAGGAGAATCGCTTGAACCCGGGAGGTGGAGGTTGCAGTGAGCCGAGATCATGCCATTGCACTCCAGCCTGGGGGATAAGAGCGAGACTTTGTCTCAAAAAAAAAGAAAA"
"chr6","138954944","138955239","KN297219v1","1714724","1715019","23","137240220","GACCGGGTGCAGTGGCTCACGTCTGTAATCCCAGCACTTTGGGAGGCCAAAGCGGGTGGATCATCTGAGGTCAGGAGTTCGAGATCAGCCTGGCCAACATGGTGAAACACCATCTCTACTAAAAAATACAAAAATTAGCTGGGCATGGTGGCAGGCGCCTTAATCCCAGCTACTTGGGAGGCAGAGGCAGGAGAATCATTTGAACCCAGAAGGTGGAGGTTGCAGTGAGCCGAGAAAAAGCCATTGCACTCAAACCTGGGGGACAAGAGAGAGACTTCTCTCAAAAAAAAAAAAAA","GACCGGGCTCAGTGGCTCACCCCTGTAATCCCAGCACTTTGGGAGGCCGAGGTGGGTGGATCACCTGAGGTCAGGAGTTCGAGACCAGCCTGGCCAACATGGTGAAACCCCATCTCTACTAAAAAATACAAAAATTAGCTGTGCGTGGTGGCAGGTGCCTTAATCCCAGCTACTTGGGAGGTAGAGGCAGGAGAATCATTTGAACCCAGGAGGCGGAGGTTGCAGTGAGCTGAGATAAAGCCATGGCACTGAAACCTGGGGGACAAGAGTGAGACTTCTCTAAAAAAAAAAAGAAA"
"chr6","149107101","149107410","KN294239v1","364052","364364","46","148743049","GGCCGGGCGCGGTGGCTTACACCTGTAATCCCAGCACTTTGGGAAGCCGAGGTGGGTGGATCATCTGAGGTCAGGAGTTCGAGACCAGCCTAGCCAACATGGTGAAACCCCGTCTCTACTAAAAAAAAAAAAAAAAAAATTGGCAGGTGCCTGTAATCTCAGCTATGCAGGAGGCTGAGGCAGGAGAATCAAGTGAACCTGGGAGGCGGAGGTTGCAGTGAGCTGAGATCGTGCCATCGCACTCCACTCCAGCCTGGGGGACAAGAGCGAGACTTTGTCTCCAAAAAAAAAAAAAAAAAAGAAAAGAAAA","GGCTGGGTGTCATGGCTCACACCTGTAAACCAGCATTTTGGGAGGCTGAGGTGGGTGGATCACCTGAGGTCAGGAATTTGAGACCAGCCTGGCCAACATGGTGAAACCCCATCTCTACTAAAATTACAAAAATTAGCCAGGCATGGTGGCAGGTGCCTGTAATCCCACCTACTCAGGAGGCTGAGGCAGGAGAATCACTTGAATCTGGGAGGCGGAGGTTGCAGTGAGCTGAGATCACGCCATTGCATTCACTCCAGACTGAGGGACAAGAGCGAGACTTTGTCTCAAAAAAAAAAAAAAAAAAAAAAAAAAA"
"chr6","152015860","152016154","KN296495v1","1709690","1709980","34","150306170","CTGGGCACAGTGGCTCATGCCTGTAATCCCAGCACTTTGGGAGGCCGAGGCAGGTGGATCACCTGAGGTCAGGAGATCGAGACCAGCCTGGCCAACGTGTAGAAACCCCATCTCTACTAAAAATACAAAAAATTAGCTGGGCTTGGTGGCAGGTGCCTGTAATCCCAGCTACTCGGGAGGCTGAGGCAGGAGAATCACTTGAACCCGGGAGGCGGAGGTTGCAGTGAGCCAAGATCGCGCCGTCACATTCCAGCCTGGGGGAAAAGAGCAAGACTTCGTCTTAAAAAAAAAAAAA","GGCACAGTGGCTCACGCCTGTAATCCCAGCACTTTGGGAGGCCGAGGCAGGTGGATCATGAGGTCAGGAGTTCAAGACCAGCCTGGCCAACATGGTGAAACTCCATCTCTACTAAAAATACAAAAATTAGCCAGGCATGGTGGCAGGTGCCTGTAATCTGAGCTACTTGGGAGGCTGAGACAGGAGAATCACTTGAACCCGGGAGGCGAAGGTTGCAGTGAGCCAAGATCGTGCCATTGCACTCTAGCCTGGGAGACAAGAGCGAGACTTTGTCTCAAAAAAAAAGAAAAA"
"chr6","156366698","156367027","KN294665v1","171883","172197","50","156194815","GGCTGGACATGGTGGCTCACGCCTGTAATCCCAGCACTTTGGGAGGCCAAGGCAGGTGGATCACCTGAGGTCAGGAGTTCGAAACCAGCCTGGCCAACATGGTGAAACCCCGTCTCTACTAAAAATACAAAAATTAGCGGGACATGGTGGCAGGTGCCTGTAATCCCAGCTACTCAGGAGGCTGAGGCAGGAGAATTGCTTGACCTGGGAGGCGGAGGTTGCAGTGAGCTGAGATGGCGTCATCACACTCCAGCCTGGGGGATGAGAGCGAGACCTCATCTCAAAAATAAATAAATAAATAAATATAAATAAATAAATAAATAAAATAAA","GCCGGGCATGGTGGCTCATGCGTGTAATCCCACCACTTTGGGAGTCCGAGGCAGGTGGATCACCTGAGGTCAGGAGTTCGAGACCAGCCTGGCCAACATGGTGAAACCCCCGTCTCTACTAAAAATACAAAAATTAGCTGGGCATGGTGGCAGGCGCCTGTAATCCCAGCTACTCGGGAGGCTGAGGCAAGAGAATCGCTTGAACCCGGGAGATGGAGGTTGCAGTGAGCCGAGATCGCACCATTGCACTCCAGCCTGGGGGACAAAAGAGAGACTTTGTCTCAAAAAAAAAAAAAAAAAAAAAAAAAAGAAAAA"
"chr6","158148517","158148798","KN294372v1","1494160","1494444","38","156654357","GGCCAGGTGCGGTGGCTCACATCTGTAATCCCAGCACTTTGGGAGGCTGAGGTGGGTGGATCACCTGAGGTCAGGAGTTCGAGACCAGCCTGGCCAACATGATGAAACCCCGTCTCTACAAAAAATACAAAAATTAGCTGGGCGTGGTGGCAGGCGCTTGTAATACTACCTACTCAGGAGGCTGAGGAAGGAGAATCGCTTGAACCCAGGAGGTGAAGGGTGTAGTGGGCCAAGATCACACCATTGCACTCCAGCCTGGGAGACAAGAGGGAGACTTCGTCT","GGCCAGGCGTGGTGGCTCACACGTATAATCCCAGCACTTTGGGAGGCCGAGGCGGGTGGATCACCTGAGGTCAGGAGTTTGAGACCAGCCTGACCAACATGGTGAAACCCCATCCCAACTAAAAATACAAAAATTAGCTGGGCGTGGTGGCAGGCGCCTGTAATCCTAGCTACTCTGGGGGCCGAGGCAGGAGAATCGCTTGAACCCGGGAGGCGGAGGTTGCAGTGAGCCAAGATAGCACCATTACAAACCAGCCTGGGGGACAAGAGCGAGACTTCCTCTCAA"
"chr6","159430861","159431164","KN296496v1","794027","794330","40","158636834","GGCTGGATGCAGTGGCTCGTGCCTGTAATCCCAGCACTTTGGAGGCTGAGGCTGGTGGATCACCTGAGTTCAGGAGTTCGAGACCAGCCTGGCCACCATGGTGAAACCCTGTCTCTACCAAAAATACAAAAATTAGTCGGGCATGGTGGCAGGCGCCTGTAATCCCAGCTACTTGGGAGGCTGAAGCAGGAGAATCTCTTGAACCCAGGAGAGAGCAGTTGCAATGAGCCGAGATTATGCCATTGCACTCCAACCTGGGGCACAGGAGCAAGACTTAGTCTCAAAAAAAACAAAAAACAAAAAA","GGCCAGACGCGGTGGCTCACGCCTGTAATCCCAGCACTTTGGGAGGCCGAGGTGGGTGGATCACCTGACATCTGGAGTTCGAGACCAGCCTGGCCAACATGGTGAAACCCTGTCTCTACTAAAAATACAAAAATTAGCTGGGCATGGTGGCAGGCACCTGTAATCCCAGCTACTTGGGAGGCTGAGGCAGGAGAATCGCTTGAACCCGGGAGGTGGAGGTTCCAGTGAGCCAAGATTGTGCCATTGCACTCCAGCCTGGGGAATAAGAGCAAGATTTTGTCTCAAAAAAAAAAAAGAAGAAGAA"
"chr6","162730566","162730690","KN295315v1","1304753","1304876","16","161425813","GGCCAGGCGCGGTGACTCACGTCTGTAATCCCAGCATTTTGGGAGGCCGAGGCAGGTGGATCACCTGAAGTCAGGAGTTCTAGACAAGCCTGGCCAACATGGTGAAACCCCGCCTCTACTAAAAA","GGGCGGGCGCGGAGGCTCACACCTGTAATCCCAGCACTTTGGAAGGCTGAGGCAGGTGGATCACCTGAGGTCAGGAGTTCCAGACCAGCCTGGCCAACATGGTGAAACCCTGTCTCACTAACAA"
"chr6","165443664","165443816","KN294325v1","635905","636046","28","164807759","GGCCGGGCGCGGTGGCTCACACTTGTAATTCCAGCACTTTGGGAGGCTGAAGCAGGTGGATTGCCTGAGGTCAGGAGCTCCAGACCAGCCTGGCATGGCCAACATGTTGAAACCCCCTCTCTACTAAAAAATACAAAAATTAGCCAGGTGTGG","GGCCAGGCGCAGTGGCTCATGCCTGTAATCCCAACACTTTGGGAGGCCGAGGCGGGTGGATCACCTGAGGTCAGGAGTTCCAGACCAGTCTGGCCAACATGGCGAAACCCCGTCTCTACTAAAAATACAAAAGTTGGGTGGG"
"chr7","2031819","2032123","KN294713v1","906670","906972","28","1125149","GGCCGGGTGCAGTGGCTCACTCCTGTAGTCCCAGCACTTTGGGAGGCTGAGGCGGGTGGATCACCTGAGATCAGGAGTTCGAGACCAGCCTGGCCAACATGGTGAAACCCCGTCTCTACTAAAAATACAAAAATTAGCCAGGTGTGGTGGCACGTGCCTATAATCCTAGCTACTCGGGAGGCCGAGGCAGGAGAATCACTTGAATCCAGGAGGTGGAGGTTGCAGTGAGCCGAGATCGCACCACTGCACTCCAGCCTGGGGGACAAGAGTGAGACTTCCTCTCTAAAAAAAAAAAAAAAAAAAAA","GGCCGGGTGCAGTGGCTCAAGCCTGTACTCCCAGCACTTTGGGAGGCCGAGGCGGGCGGATCACCTGAGGTCGGGAGTTCGAGACCAACCTGGTCAACATGGTGAAACCCCTTCTCTACTAAAAACACAAAAATTAGCCGGTCATGGTGGCAGGTGCCTGTAATCCCAGCTACTCGGGAGGCTGAGGCAGGAGAATCGCTTGAACCCTGGAGGCAGAGATTGCAGTGAGCCGAGATCGCACCATTGCACTCCAGCCTGGGGGACAAGAGTGAGACTTCATCTCAAAAAAAAAAAAAAAAAAAA"
"chr7","2457822","2458131","KN294685v1","1269570","1269869","39","1188252","GCTGGGCGTGGTGGCTCACGCCTGTAATCCCAGCACTTTGGGAGGCCGAGGCAGGTGGATCAACTGAGGTCAAGAGTTCGAGACCAGCCTGGCCAACACAGTGAAACCCTGTCTCTACTGAAAATACAAAAAAAATTAGCTGGGTGTGGTGGCAGGCAACTGTAATCCCAGCTACTCTGGAGGCTGAGGCAGGAGAATTGCTTGAACCTGGGAGGCGGAGGTTGCAGTGAGCCGAGAGCGTGCCATTGCACTCCAGCTCTGGGGGACAAGAACGAGACTTTGTCTCCAAAAAGAAAAAAAAAGAAAAAGA","GGCTGGGTGTGGTGGCTTAGGCCTGTAATCCCAGCACTTTGGGAGGCCAAGGCGGGCGGATCACCTGAGGTCAGGAGTTCGAGACCAGCCTGGCCAACATGGTGAAACCCCGTCTCTACTAAAAATACAAAAACTAGCCAGGCGTGGTGGCAGGTGACTGTAATCCCAGCTACTCGGGAGGCTGAGGCAGGAGAACTGCTTGAACCTGGGAGGCGGAGGTTGCAGTGAGCTGAGATCACACCATTGCACTCCAGCCTGGGGGACAAGAGCGAGACTTTGTCTCAAAAATAAAAAAAAAAA"
"chr7","6873685","6874001","KN294827v1","243670","243981","43","6630015","GGCCAGGCATGGTGGCTCACGCCTGTAATCCCAGCACTTTGGGAGGCCGAGGCGAGTGGATCATCTGAGGCCGTGAGTTTGAGACCAGCCTGGCCAACATGGTGAAACCCCATCTCTACTAAAAATATATATATATAAATTAGCCGGACGTGGTGGCAGGTGACTGCAATCCCAGCTACTTGGGAGGCTGAGGCAGGAGAATTGCTTGAACCCAGGAGGCGGAGGTTGCAGTGAGCTGAGATCATGCCATTGCATTCCAGCCTGCGGGACAAGAGCAAGACTTCATCTCAACAAATAAATAAATAAATAAAATAAAA","GGTCAGGTGTGGTGGCTCACGCCTGTAATCCCAGCACTTTGGGAGGCCAAGGTGGGTGGATCACCTGAGGTCAGGAGTTCGAGACCAGCCTGGCCAACATGGTGAAACCCCATCTCTACTAAAAATACAAAAATTAGCTGGGCATGGTTAGCAGTTGCCTGTAATCCCAGCTGCTTGTGAGGCTGAGGCAGGAGAATTGCTTGAACCCAGGAGGCGGGAGGTTGCAGTGAGCTGAGATGGTGCCATTGTACTCCAGCCTGGGGGACAAGAGTGAGACTTCGTCTCAAAAAAAAAATAAAAAGTAAAAATAAA"
"chr7","9434898","9435210","KN296356v1","841874","842188","39","8593024","GGCCAGGCGTGGTGGCTCACGCCTGTAATCCTAGCACTTCGGGAGGCCAAGGTGGTTGCATCACCTGAGGTCAGGAGTTCGAGACCAGCCTGACTAACATGGTGAAAGCCCGTCTCTACTAAAAATACCGAAAAACTAGCCAGGCGTGCTGGCAGGCACCTGTAATCCCAGGATTACTCGGGAGGCTGAGGCAGGAGAATCTCTTGAACCCAGGAGGCAGAGGTTGTAGTGAGCCAAGATCATGCCATCGCACTCCAGCCTGGGGGACAAGAGTGAGACTTTGTCTCAAAAAAAAAAAAAAAAAGAAGAAAAA","GGCCAGGTGTGGTGGCTCATGCCTGTAATCTCAGCACTTCAGGAGGCCAAGGCAGGTGGATCACCTGAGGTCAGGAGTTCGAGACCAGCCTGACTAACATGATGAAACCCCGTTTCCACTAAAAATACCAAAAAACTAGCCAGGCGTGGTGGCAGACGCCTGTAATCCCAGCTACGCGGGAGGCTGAGGCAGGAGAATAGCTTGAACCCGGGAGGCAGAGGTTGCAGTGAGCCGAGATCACACCATCACATTCCAGCCTGGAGGAAAAGAGCGAGACTTTGTCTCAAAAAAAAAAAAAAAAAAAAAAAAAAAAAA"
"chr7","21332294","21332605","KN294665v1","171883","172197","30","21160411","GCCGGGCACAGTGGCTCATGCCTGTAATCCCAGTACTTTGGGAGGCTGAGGCAGGTGGATCACCTGAGGTCAGGAGTTCGAGACCAACCTGGCCAACATGGTGAAACCCTGTCTCTACTAAAAATACAAAAATTAGCCGCGCATGGTGGCAGGCCCCTGTAATCCCAGCTACTCAGGAGGCTGAGGCAGGAGAATCACTTGAAGACAGGAGGCGGAGGTTGCAGTGAGCCGAGATCGCACCATTGCACTCCAGCCTGGGGGACAATAGCGAGACTTGGTCTCAAAAAAAAATGAATAAAAATAAAAAAAAAA","GCCGGGCATGGTGGCTCATGCGTGTAATCCCACCACTTTGGGAGTCCGAGGCAGGTGGATCACCTGAGGTCAGGAGTTCGAGACCAGCCTGGCCAACATGGTGAAACCCCCGTCTCTACTAAAAATACAAAAATTAGCTGGGCATGGTGGCAGGCGCCTGTAATCCCAGCTACTCGGGAGGCTGAGGCAAGAGAATCGCTTGAACCCGGGAGATGGAGGTTGCAGTGAGCCGAGATCGCACCATTGCACTCCAGCCTGGGGGACAAAAGAGAGACTTTGTCTCAAAAAAAAAAAAAAAAAAAAAAAAAAGAAAAA"
"chr7","21420986","21421281","KN294991v1","1107866","1108162","37","20313120","GGCTGGGGGCAGTGGCTCACACCTGTAATCCCAGCACTTCGGGAGGCCGAAGCTGGTGGATCACGTGAGGTCAGGAGATCGAGACCAGCCTGACCAACATGGTGAAACCCCATCTCTCTAAAAAACACAAAAATTAGCCAGGCATGGTGGCAGGCACCTATAATCCCAGCTACTTGGGAGACTGAGGCAGGAGAATCACTTGAACCTGGGAGGCGGAGGTTGCAGTGAGCCAAGATCACACCATTGCACTCCAGCCTGGGGAACAAGAACGAGACTTCGTCTCAAAAAAAAAAAAA","GGCCGGGTGCAGTGGCTCACGCCTGTAATCCCAGCCCTTTGGGAGGTCGAGGCAGGTGGATCACCTGATGTCAGGAGTTCGAGACCAACCTGGCCAACATGGTGAAACCCCATCTCTACTAAAAATACAAAAATTAGCCAGGCGTGGTGGCAGGCACCTGTAATCTCAGCTACTAGGGAGGCTGAGGCAAAAGAATCACTTGAACCCAGGAGGCAGAGGTTGCAGTAAGCTGAGATCACACCACTGCACTCCAACTTGGGGGACAAGAGTGAGACTTTGTCTCAAAAAACAAAAAAA"
"chr7","23723072","23723356","KN294372v1","1494160","1494444","38","22228912","GGCCAGGCATGGTGGCTCATGCTTGTAATCTCAGCACTTTGGGAGGCTGAGGTGGGTGGATCACCTAAGGTCAGGAGTTCAAGACCAGTCTGGCCCACATGGTGAAACCCCCATCTCTACTAAAAACACCAAAAGTAGCCAGGCATGGTGGCAGGCACCTGTAATCCCAGCTACTTGGGGGGCTGAGGCAGGAGAATCGCTTAAACCCAGGAGGCGGAGGTTGCAGTGAGCCGAGATGGCACCATTGCATTCCAGCCTGGGGGACAAGAGCGAGACTTCATTTCA","GGCCAGGCGTGGTGGCTCACACGTATAATCCCAGCACTTTGGGAGGCCGAGGCGGGTGGATCACCTGAGGTCAGGAGTTTGAGACCAGCCTGACCAACATGGTGAAACCCCATCCCAACTAAAAATACAAAAATTAGCTGGGCGTGGTGGCAGGCGCCTGTAATCCTAGCTACTCTGGGGGCCGAGGCAGGAGAATCGCTTGAACCCGGGAGGCGGAGGTTGCAGTGAGCCAAGATAGCACCATTACAAACCAGCCTGGGGGACAAGAGCGAGACTTCCTCTCAA"
"chr7","25370448","25370769","KN294665v1","171883","172197","44","25198565","CCGGGTGCAGTGGCTCACGCCTGTAATCCCAGTACTTTGGGAGGCCGAGGCAGGCGGATCACCTGAGGTCAGGAGTTCCAGACCAGGCTGGCCAACATGGTGAAACCCCATCTCTACTAAAAATGTAAAAATTAGCTGGGTGTGGTAGCTGGTGCCCATAATCCCAGCTACTTGGGAGGCTGAGGCAGGAGAATTGCTTGAACCCGGGAGGTGGAGGTTGCAGTGAGCCGAGATGGCACCACTGCACTCCAGCCTGGGGGAAAAGAGTGAGACTTCGTCTCAAAAATAAATAAATAAATAAATAAATAAATAAATAAATAAA","GCCGGGCATGGTGGCTCATGCGTGTAATCCCACCACTTTGGGAGTCCGAGGCAGGTGGATCACCTGAGGTCAGGAGTTCGAGACCAGCCTGGCCAACATGGTGAAACCCCCGTCTCTACTAAAAATACAAAAATTAGCTGGGCATGGTGGCAGGCGCCTGTAATCCCAGCTACTCGGGAGGCTGAGGCAAGAGAATCGCTTGAACCCGGGAGATGGAGGTTGCAGTGAGCCGAGATCGCACCATTGCACTCCAGCCTGGGGGACAAAAGAGAGACTTTGTCTCAAAAAAAAAAAAAAAAAAAAAAAAAAGAAAAA"
"chr7","27321839","27322138","KN294685v1","1269570","1269869","30","26052269","GGTCGGGCACGATGGCTCATGCCTGTAATCCCAGCACTTTGGGAGGCCAGGGCGGGTGGATCACCTGAGGTCAGGAGGTCGAGACCCGCCTGGCCAACATGGTGAAACCCCATCTCTACTAAAAATACAAAAAATTAGCCAGGCGTGGTGGCAGGCGCCTGTAATCCCAGCTACTCGGGGGGCCGAGGCAGGAGAATCGCTTGAACCCGGGAGGAGGAGGTTGCAGTGAGCCGAGATGGCGCCATCGCACTCCAGCCTGGGGGACAAGAGCGAAACTTTGTCTCAAAAAAAAAAAAAAAA","GGCTGGGTGTGGTGGCTTAGGCCTGTAATCCCAGCACTTTGGGAGGCCAAGGCGGGCGGATCACCTGAGGTCAGGAGTTCGAGACCAGCCTGGCCAACATGGTGAAACCCCGTCTCTACTAAAAATACAAAAACTAGCCAGGCGTGGTGGCAGGTGACTGTAATCCCAGCTACTCGGGAGGCTGAGGCAGGAGAACTGCTTGAACCTGGGAGGCGGAGGTTGCAGTGAGCTGAGATCACACCATTGCACTCCAGCCTGGGGGACAAGAGCGAGACTTTGTCTCAAAAATAAAAAAAAAAA"
"chr7","27955572","27955741","KN294458v1","1673985","1674148","25","26281587","AATTAGCCGGGCGTGGTGGCAGAAGCCTGTAATACCAGCTACTCGGGAGGCTGAGGCAGGAGAATCGCTTGAACCCAGGAGGCGGAGGCTGCAGTGAGCCGAGATCACGCCATTGCACTCCAGCCTGGGAGACAAGAGTGAGACTTCCTCTCAAAACAACAACAACAAAA","TTAGCCGGGCATGGTGGTGGGCACCTATAATCCCAGCTACTCAGGAGGCTGAAGCAGGAGAATCGCTTGAACCCAGGAGGCGGAGGTTGCAGTGAGCTGAGATTGTGCCATTGCACTCCAGCCTGGGAGACAAGAGCGAGACTTCATCTCAAAAAAGAAAGAAA"
"chr7","31362841","31363152","KN296921v1","822515","822822","32","30540326","CCAGCTGCGGTGGCTCACACCTGTAATCCCAGCATTTTGGGAGGCTGAGGTAGGTGGATCATCTGAGGTCAGGAGTTCGAGACCAGCCTGGCCAACATGGTGAAACCCCGTCTCTACTAAAAATACAAAAATTAACTGGGTGTGGTGGCAGGTGCGTGTAATCCCAGCTACTCGGGAGGCTGAGGCAGGAGAATTGCTTGAACCCAGGAGGCGGAGGTTGCAGTGAGCCAAGATCGTGCCATTGTACTCCAGCCTGGAAGACAAGGGCAAGACTTCATCTACAAAAAAAAAAAAAAAAGAAAGAAAAAGAAA","GGCGCGGTGGCTCACACCTGTAATCCCAGCACTTTGGGAGGCCGAGGTGGGTGGATCACCTGAGGTCAGGAGTTCGTAGACCAGCCTGGCCAACATGGTGAAACCCCATCTCTACTAAAAATACAAACATTAGCTGGGCGTGGTAGCAGGTGCCTGTAATCCCAGCTACTCAGGAGACTGAGGCAGGAGAATCGTTTGAACCCAGGAGGCGGAGGTTGCAGTGAGCCGAGATCATGCCATTGCACTACAGCCTGGGGACAAGAGCAAGACTTCGTCTCAAAAAAAAAAAAAAAAAAGGAAAATAAAAA"
"chr7","36049143","36049432","KN296541v1","476659","476959","45","35572484","GGCTCATGCCTGTAATCCCAGCACTTTGGGAGGTCGAGGTGGGTGGATCACCTGAGGTCAGGAGTTTGAGACCAGCCTGACCAACATGGTGAAACCCCATCTCTACTAAAAATACAAAAATTAGCTGGGTGTGGTGGTGCGCGCCTGTAATCGCAGCTACTCGGGAGGCTGAGGCAAGAGAACCACTTGAACCCGGGAGACGGAGGTTGCAGTGAGCCAAGATTGCACCATCACACTCCAACCTGGGGGACAAGAGCGAGACTTCGTCTCAAAACAAAACAAAACAAAAA","GGGCTGACGTGGTGACTCATGCCTGTAATCCCAGCACTTTGGGAGGCCGAGGCAAGTGGATCACCTGAGGTCAGGAGTTCGAGACCAGCCTGGCCAACATGGTGAAACCCAGTCTCTACTAAAAATACAAAAATTAGCCAGGCGTGGCGGTAGGCACCTGTAATCCCAGCTACTCGGGAGGCTGAGGCAGGAGAATCACTTGAACTCGGGAGGCGGAGGTTGCAGTGAGCCGAGATCACGCCATTGCACTCCAGCCTGGCGGACAAGAGCGAGACTTTGTCTCAAAAAAAAAAAAAAAAAA"
"chr7","38739545","38739645","KN295096v1","1733611","1733710","16","37005934","GGCAGGGTGTGGTGGCTCACACCTGTAAATCCAGCACTTTGGGAGGCGAGGCAGGTGGATCACTTGAGGTCAGGAGTTCTAGACTACCCTGGCCAACATGG","GCCGGGCATGGTGGCTCATGCCTGTAATTCCAGCACTTTCGGAGTCTGAGGCAGGTGGATCACCTGAGGTCAGGAGTTCCAGACCAGCCTGCCCAACATG"
"chr7","40466504","40466806","KN294685v1","1269570","1269869","39","39196934","GGCCGGGCGCTATGGCTCACGCCTGTTATCCCAGCACTTTGGGAGGCCAAGGTAGGTGGATCACCTGAGGTCAGGAGTTCGAGACCAGGCTGGCCAACATGGCAAAACCCCGTCTCTCCTAAAAATACAAAAATTAGCCAGGTGTGGTGGCAGGTGTCTGTAATCCCAGCTACTTGGGAGGCTGAGGCAAGAGAATTGCTTGAACCCAGAAGGCGGAGGTTGCAGTGAGCCAAGATTGTGCCATCGCACTCCAGCCTAGGGGACAAGAGCGAGTGAGATGTTGTCTCCAAAAAAAAAAAAAAA","GGCTGGGTGTGGTGGCTTAGGCCTGTAATCCCAGCACTTTGGGAGGCCAAGGCGGGCGGATCACCTGAGGTCAGGAGTTCGAGACCAGCCTGGCCAACATGGTGAAACCCCGTCTCTACTAAAAATACAAAAACTAGCCAGGCGTGGTGGCAGGTGACTGTAATCCCAGCTACTCGGGAGGCTGAGGCAGGAGAACTGCTTGAACCTGGGAGGCGGAGGTTGCAGTGAGCTGAGATCACACCATTGCACTCCAGCCTGGGGGACAAGAGCGAGACTTTGTCTCAAAAATAAAAAAAAAAA"
"chr7","42119210","42119356","KN294325v1","635905","636046","24","41483305","GGCCAGGAGCAGCGACACGTGCCTGTAATTCCAGCACTTTGGGAGGCCAAGGCGGGTGGATCACTTGAGGTCAAGAGTTCTAGACCAGCCTGGCCAACATGGTGAAACCTCATATTTACTAAAAATACAAAAATTAGCCAGGCGTGG","GGCCAGGCGCAGTGGCTCATGCCTGTAATCCCAACACTTTGGGAGGCCGAGGCGGGTGGATCACCTGAGGTCAGGAGTTCCAGACCAGTCTGGCCAACATGGCGAAACCCCGTCTCTACTAAAAATACAAAAGTTGGGTGGG"
"chr7","44328943","44329242","KN294685v1","1269570","1269869","28","43059373","GGCCGGGCGCGGTGGCTCACGCCTGTAATCCCGGCACTTCGGAAGGCCGAGGCGGGTGGATCACCTGAGGTCAGGAGTTTGAGACCAGCCTGGTCAACATGGTGAAACCCCGTCTCTACTAAAAATACCAAAACTAGTCAGGCGTGGTGGCAGGCGGCTGTAATCCCAGCTACTCGGGGGAGCTGAGGCAGGACAATCGCTTGAAGCTGGGAGGCGGAGGTTGCAGTGAGCCGAGATCATGCCATCGCACTCCAGCCTGGGGGACAAGAGCAAGACTTTGTCTCAAAAATAAAAAAAAAA","GGCTGGGTGTGGTGGCTTAGGCCTGTAATCCCAGCACTTTGGGAGGCCAAGGCGGGCGGATCACCTGAGGTCAGGAGTTCGAGACCAGCCTGGCCAACATGGTGAAACCCCGTCTCTACTAAAAATACAAAAACTAGCCAGGCGTGGTGGCAGGTGACTGTAATCCCAGCTACTCGGGAGGCTGAGGCAGGAGAACTGCTTGAACCTGGGAGGCGGAGGTTGCAGTGAGCTGAGATCACACCATTGCACTCCAGCCTGGGGGACAAGAGCGAGACTTTGTCTCAAAAATAAAAAAAAAAA"
"chr7","45381948","45382068","KN295315v1","1304753","1304876","16","44077195","GGCCAGGCACGGTGGCTTATGCCTGTAATCCCAGCACTTTGGGAGGCTGAGGCGAGTGGATCACCTGAGGTCAGGAGTCCCAGACCAGCCTGGCCAACATGGTGAAACTCCTCTCCTAAAA","GGGCGGGCGCGGAGGCTCACACCTGTAATCCCAGCACTTTGGAAGGCTGAGGCAGGTGGATCACCTGAGGTCAGGAGTTCCAGACCAGCCTGGCCAACATGGTGAAACCCTGTCTCACTAACAA"
"chr7","45717941","45718124","KN294458v1","1673985","1674148","42","44043956","TACTAAAACATAATAAAACATTAGGGCCAGGCACAGTGTCTTACGCCTGTAATCCCAGCTACTCAGGAGGCTGAGGCAGGAGAATCACTTGAACCCAGGAGGCAGAGGTTGCAGTAAGCTGAGATTGCACCATTGCACTCCAGCCTGGGGGACAAGAGCGAGTCCTCATCTCAAAAAAAAAAAA","TTAGCCGGGCATGGTGGTGGGCACCTATAATCCCAGCTACTCAGGAGGCTGAAGCAGGAGAATCGCTTGAACCCAGGAGGCGGAGGTTGCAGTGAGCTGAGATTGTGCCATTGCACTCCAGCCTGGGAGACAAGAGCGAGACTTCATCTCAAAAAAGAAAGAAA"
"chr7","47722249","47722376","KN297203v1","546013","546140","15","47176236","GGCCTGGTGCAATAGCTCACACCTGTAATCCCAGCAATTTGGGAGGCCGAGGTGGGTGGATCACTTGAGGCCAGACGTTCTAGACTGGCCTGGCTAACATGGTGATTTCCTGACTTTACCAAAAACAC","GGCCTGGTGCAGTAGCTCACGCATGTAATCTCAGCAGTTTGGGAGGCTGAGGTGGGTGGATCACTTAAGGCCAGAAGTTCTAGACCAACCTGGCTAACATGGTGGAATCCTGACTCTACCAAAAACAC"
"chr7","48306523","48306819","KN295077v1","496548","496840","34","47809975","GGTCGGGCGTGGTGGCTCAAGCCTGTAATCCCAGCACTTTGGGAGGCTGAGGCGGGTGGATCACCTGAGGTCAGGAGTTCCAGATTAGCCTGGCCAACACGGTGAAACCCTGTCTCTACTAAAAATACCAAAACTAGCCGGGTGTGGTGGCAGGCGCCTGTAATCCCAGCTACTTGGGAGGCTGAGGCAGGAGAATCGCTTCAACCCGGGAGGCGGAGGTTGCAGTGAGCCGAAATCATGCCAACACACTCCAGCCTGAGGGACAAGAGCAAGACTTTGTCTCAAAAAAAAAGAGAA","GGCCGGGCATGGGGGCTCACACCTGTAATCCCTGCACTTTGGGAGGCTGAGGTGGGTGGATCACCTGAGGTCAGGAGTTCGAGACAAGCCTGGCCAACATGGTGAAACCCTGTCTCTACTAAAAATACAAAAATTAGCTGGGTGTGGTGGCAGGCGCCTGTAATCCCAGCTACTCAGGAGGCTGAGGCAGGAGAACCGCTTGAACCTGGGAGGCGGAGGTTGCAGTGAGCCAAGAATATGCTATTGCACTCCAGTCTGGGGCACAAGAGCGAGACTTTGTCTCAAAAAAAAAA"
"chr7","50777553","50777864","KN296387v1","301235","301539","39","50476318","GCCAGGCGCGGTGGCTCACCGCTGTAATCCCAGCACTTTGGGAGGCCTAGGTGGGTGGATCACCTGCGGTCAGGAGTTCTAGATTAGCCTGGCCAACATGGTAAAACCCCGTTTCTACTAAAAATACAAAAATTAGCCAGGCGTGGTGGCAGGCGCCTGTAATCTCAGCTACTTGGGGGGCCGAGGCAGGAGAATCGCTTGAACTTGGGAGGCGGAGGTTGCAGTGAGCTGAGATCGCACCATCGCAGTCTAGCCTGGGGGACAAGAGCGAGACTACATCTCAAAAAAAACAAAAACAAAAACAAAAAAAAA","GGCTGGGCGCGGTGGCTCACACCTGTAATCCCAGCACTTTGGGAGGCCGAGGTGGGTGAATCACCTGAGGTCAGGAGTTCGAGACCAGCCTGGCCAACATGGTGAAACCCCATATCTACTAAAAATACAAAAATTAGCCAGGTGTGGTGGCAGGCGCCTATAATCCCAGCTGCTTGGGAGCCTGAGGCAGGAGAATCGCTTGAACCTGGGAGGCGGAGGTTGCAGTGAGCCAAGATCGTGCCATTGCACTCCAGCCTAGGGGACAAGAGTGAGACTAATCTCAAAAAAAAAAAAAAAAAAAAAAA"
"chr7","53299868","53300161","KN295753v1","255222","255516","38","53044646","GGCTGGGTGCGGTGGTTCACTCCTGTAATCCCAGCACTTTGGGAGGCTGAGGCGGGTGGATCACCTGAGGTCAGGAGTTCTAGACCAGCCTGGCGAACATGGTGAAACCCTGTCCCTACTAAAAATACAAAAATTAGCCAGATGTGGTGGCAAGCACCTATAGTCCCAGCTACTCAGGAGGCTAAAGCAGGAGAATCACTTGAACCCGGGAGGCAGAGGTTGCAGTGAGCTGAGATTGCACCATCACACTCCAGCCTGGGGGATGAGAACGAGACTTCATCTCACAAAAAAAAA","GGCCCGGTGCGGTAGCTCACCTCTATAATTCCAGCACTTTGGGAGGCTGAGGCAAGTGGATCACCTGAGGTCAGGAGTTGTAGACTAGCCTGGCCAACATGGTGAAACCCCGTCTCTACTAAAAATACAAAAATTAGCCCGGTGTGGTGGCAGGCACCTGTAATCCCAGCTACTCGGGGGGCCAAGGCAGGAGAATCACTTGAACCCAGGAGGCGGAGGTTGCAGTGAGCCGAGATCATGCCATCGCACTCCAACCTGGGGGACAAGAGCGAGACTTCATCTCAAAAAAAAAAAA"
"chr7","53308398","53308692","KN295576v1","406337","406628","30","52902061","GGCCAGGAGCGGTGGCTCACGCCTGTAATCCCAGCACTTTGGGAGGCCGAGGTGGGTGCATCTCCTGAGGTAAGGAGTTTGAGACCAGCCTGGCCAACATGGTGAAACTCCGTCTCTACTAAAAATACAAAAATTATCAGGGTGTGGTGGCAGGCACATGTAATCCCAGCTACTCGGGAGGCTGAGGCAGGAGAATAGCTTGAACCCAGGAGGCGGAGGTTGCAGTGAGCTGAGATTGCGCCGTTGCACTCCAGCCTGGGGGAAAAGAGCAAGATTTCATCTCAGAAAAAAGAAA","GGCCGGGCGCGGTGGCTCACGCCTGTAATCCCAGCACTTTGGGAGGCCGAGGCGGGCGGATCACCTGAGGTAAGGAGTTCGAGAACAGCCTGGCCAGCATGGTGAAACCCCATCTCTACTAAAAATACAAAAATTAGCCGGGCATGGTGGCAGGTGCCTGTAATCCCAGCTACTCGGGAGGCTGAGGCAGAAGAATCGCTTGAACCCAGGAGGCGGAGGTTGCAGTGAGCCGAGATTGCGCCATTGCACTCCAGCCTAGGGGAGAAGAGCGAGACTTCGTCTCAAAAAAAAA"
"chr7","57135665","57135782","KN294446v1","507219","507341","22","56628446","GGCCAGGTGTGGTGGCTCATGCCTACAATCCCAGCACTTTGGGATGCCGAGGCTGGGGGATCACCTGAGGTCAGGAGTTCTATACCAGCCTGATCAACATAGTGAAACCATCTCTGCT","GGCCAGGCGCGGTGGCTCACGCCTATAATACCAGCACTTTGGGAGACCGAGGCAGATGGATCACCTGAGGTCAGGAGTTCCAGATCAGCCTGGCCAACATAGTGAAACCCCATCTCTTTTAAA"
"chr7","63009460","63009748","KN296495v1","1709690","1709980","41","61299770","GGTGCAGTGGCTCACACCTGTAATCCCAGCACTTTGGGAGGCCAAGGCAGGTGGATCACCTGAGGTCAAGGGTTCTAGACCAGCCTGGCGAACATGGTGAAACCTGTCTCTACTAAAAATACAAAAAATTAGCCAGGCATTGTGGCGTGTGCCTCTAATCCCAGCTACTCAGGAGGCTAAGGCAGGAGAATCACTTGAACCCGGAGGCGAAGGTTGCAGTGAGCCGAGATGGCACCATTGCAGTCCAGCCTGGGTGACAAGAGTGAGATTTCATCACACACAAAAAAAA","GGCACAGTGGCTCACGCCTGTAATCCCAGCACTTTGGGAGGCCGAGGCAGGTGGATCATGAGGTCAGGAGTTCAAGACCAGCCTGGCCAACATGGTGAAACTCCATCTCTACTAAAAATACAAAAATTAGCCAGGCATGGTGGCAGGTGCCTGTAATCTGAGCTACTTGGGAGGCTGAGACAGGAGAATCACTTGAACCCGGGAGGCGAAGGTTGCAGTGAGCCAAGATCGTGCCATTGCACTCTAGCCTGGGAGACAAGAGCGAGACTTTGTCTCAAAAAAAAAGAAAAA"
"chr7","64129387","64129680","KN296883v1","2444932","2445228","35","61684455","GGCCAGGCGCGGTGGCTTACGCCTGTAATCCCAGCATTTTGGGAGACCAAGGCGGGTGGATCACCTGAGGTCAAGAGTTCGAGACCAGCCTGACCAACATGGTGAAACCCTGTCTCAACTAAAAATACAAAAATTAGACGGAGGTGGTGGCAGGCGCCTGTAATCCCAGCTACTCAGGGGGCCGAGGCAGGAGAATCCCTTGAACCCGGGAGGCGGAGGTTGCAGTAAGCTGAGATCACGCCATCGCACTGCAGCCTGGGAGACAAGAGCGAGACTTCATTTCAAAAAAAAAAA","GGCCGGGCACGGTGGCTCATGCCTGTAATCCCAGCACTTTGGGAGGCCAAGGCGGGTGGATCACCTGAGGTCAGGAGTTCTAGACCAGACTGGCCAACATGGTGAAACCCCATCTCTACTAAAAATACAAAAATTAGCCAGATGTGGTGGCAGGCTCCTGTAATCTCAGCTACTCGGGGGGCCAAGGCAGGAGAATTGCTTGAACCCAGGATGCAGAGGTTGCAGTGAGCCAAGATCACGCCATCGCATTCCAGCCTGGGAGACAAGAGTGAGACTTCATATCAAAAAATAAAAAAA"
"chr7","73161295","73161435","KN296119v1","5513182","5513312","40","67648113","GGCCAAGTACGGTGGTTTATGCATGTAATCCCGACAGTTTGGGAGGCCAAGGTGGGAGGACTGCTTGAAGCCAGGAGTTCAGTTCAATACCAGCCTGGGCAACATAGCAAGATCCCAGCTACCACATTAAAAAAAAAAACA","GCCAGGCGCTGTGGCTCATGCCTGTAATCCCAGCACTTTGGGAGGCCAAGGTGGCTGGATTACCTGAGGTCAGGAGTTCCAGACCAGCCTGGTCAACACGGTGAAACCCATTTCTATTAAAAATACAAAAA"
"chr7","73161676","73161848","KN296470v1","174157","174317","64","72987519","NNNNNNNNNNNNNNNNNNNNNNNNNNNNNNNNNNNNNNNNNNNNNNNNNNGGAGGCTAAGGCAGGAGAATTGCTTGAACCCGGGAGGTGGAGGTTGCTGTGAGCTGAGATCGTGCCATTGCACTCCAGCCTGGGGAACAAGAGCGTGACTTCACCTCAAAAAAAAAAAATAAA","GCTGGGCGTGGTGGCAAGTATCTATAATCCCAGCTACTTGGGAGGCTGAGGCAGGAGAATCGCTTGAACCCGGGAGGTGGAGGTTGCAGTGAGCCGAGATCATGCCATTGCACTCCAGCCTGGGGGATAAGAGCGAGACTTTGTCTCAAAAAAAAAGAAAA"
"chr7","73706829","73706965","KN294269v1","66171","66308","19","73640658","GGCTGGGCGCAGTGGCTCACACCCGTAATCTCAGCACCTTGGAAGGCCGAGGCAGATGGATCACCTGAGGTCAGGAGTTCCAGACTGGCCTGGCCAACATGGCAAAACCCCGTCTCTACAAAAAATACAAAACTCAG","GGCCAGGTGCAGTGGCTCACGCCTGTAATCCCAGCACTTTTGGAGGCCGAGGCAGGTGGATCACCTGAGATCAGGAGTTCCAGACTAGCCTGGCCAACATGGTGAAACCCCATCTCTACTAAAAATACAAAAATTAGC"
"chr7","74784065","74784188","KN295315v1","1304753","1304876","17","73479312","GCTGGGCACAGTGGCTCACGCCTGTAATCCCAGCACTTTGGAAGGCTGAGGCAGGCGGATCACCTGATGTCAGGAGTTCTAGGCCAGCCTGGCCAACATGGCGAAACCCCGTTTCTACAAAAAA","GGGCGGGCGCGGAGGCTCACACCTGTAATCCCAGCACTTTGGAAGGCTGAGGCAGGTGGATCACCTGAGGTCAGGAGTTCCAGACCAGCCTGGCCAACATGGTGAAACCCTGTCTCACTAACAA"
"chr7","75861575","75861708","KN296303v1","95275","95403","31","75766300","ACTCGGGAGGCTGAGGCAGAAGAATTGCTTGAACCAGGGAGGCAGAGGTTGCAGCGAGCTGAGATCCCATTGCACTCCAGCCCAGGCTGAAAACAGTAAGACTTCGTCTCAACAAACAAACAAACAAAAAACAA","GGGAGGCTGAGGCAGGAGAATTGCTTGAACCCGGGAAGCGGAGGTTACAGTGAGCCAAGATCGCACCATTGCACTCCAGCCTGGGAGACAAGAGCGAGATTTCATCTCAAAAAAAAAAAAAAAAAGAAA"
"chr7","80416174","80416323","KN294325v1","635905","636046","31","79780269","GACTGGGCATGGTGGCTATGCCTATAATCCCAGCACTTTGGGATGCCAAGGCAGGCGGATCACCTGAGGTCAGGAGTTCTAGACCAGCCTGGCCAACATGGCGAAAACCCGTCTCTTATACAAATACAAAAATGAGCCAAGCATGGTGGC","GGCCAGGCGCAGTGGCTCATGCCTGTAATCCCAACACTTTGGGAGGCCGAGGCGGGTGGATCACCTGAGGTCAGGAGTTCCAGACCAGTCTGGCCAACATGGCGAAACCCCGTCTCTACTAAAAATACAAAAGTTGGGTGGG"
"chr7","81730644","81730950","KN296387v1","301235","301539","33","81429409","GGCTGGGCGCGGTGGCTCACATCTGTAATCCCAGCACTTTGGGAGGCCGAGGTGGGTGGATCACCTGAGCTCAGAAGTTCGAGACCAGCCTGTCCAACGTGGTGAAACCCCGTCTCAACTAAAAATACAAAAATTAGCCAGGCGTGGTGGCAGGTGCCTGTAATCCCAGCTACTCCGGGGGCCGAGGCAGGAGAATCGCTTAAACCTGGGAGGCGGAGGTTACAGAGAGCCAAGATCGCGCCATCGTACTCCAGCCTGGGGGACAAGAGCGAGACTTCATCTCAAAACAACAACAACACACAAAAAA","GGCTGGGCGCGGTGGCTCACACCTGTAATCCCAGCACTTTGGGAGGCCGAGGTGGGTGAATCACCTGAGGTCAGGAGTTCGAGACCAGCCTGGCCAACATGGTGAAACCCCATATCTACTAAAAATACAAAAATTAGCCAGGTGTGGTGGCAGGCGCCTATAATCCCAGCTGCTTGGGAGCCTGAGGCAGGAGAATCGCTTGAACCTGGGAGGCGGAGGTTGCAGTGAGCCAAGATCGTGCCATTGCACTCCAGCCTAGGGGACAAGAGTGAGACTAATCTCAAAAAAAAAAAAAAAAAAAAAAA"
"chr7","81828003","81828100","KN294457v1","346874","346962","20","81481129","TGGGAGGCCGAGGTGGGTGGATAACCTGAGGTCAGAAGTTCCAGACCAGCCTGGCCAACATGGCGAAACTCCATCTCTACTAAAAAATACAAAAATTA","TGGAAGGCCGAGGTGGGTGGATCATTTGAGGGCAGGAGTTCTAGACCAGCCAGGCCAACGTGGCGAAACCCCGTCTCTACTAAAAATAC"
"chr7","82031982","82032135","KN296484v1","728553","728713","24","81303429","GTGGTGGGTGCCTGTAATCCCAGCTACTTGGGAGGCTGAGGCAGGAGAATTGCTTAAACCTAGGAGGTAGAGGTTGCAGTGAGCTGAGATCGCGCCATTGCACTCCAGCCTGGGGGACGAGAGCGAGACTTTGTCTCAAAAAAATAAAATAAAA","TAGTGGCAGGTGCCTGTAATCCCAGCTACTCGGGGGCTTGAGGCAGGAGAATCGCTTGAACCTGGGAGGCAGAGGTTGCAGTGAGCCGAGATTGCACCATTGCACTCCAGCCTGGGGGACAAGAAGGAGACTTCGTCTCAAAAAAAAAAAAAAAATTAAAA"
"chr7","85606117","85606430","KN294172v1","4419501","4419812","42","81186616","GGCCAGGCGCAGTGGCTCACACCTGTAATCCCAGCACTTTAGGAGGCCGAGGCGTGCGGATCACCTGAGGTCAGGAGTTCGAGACCATCCTGGCCAACATGGTGAAACCTCGTCTCTACTAAAAATACAAAAAATTAGCTGAGCGTGGTGTCAGGCACTTGTAATCCCAGCTACTCGGGAGGCTAAGGCAGGAGAATCACTTGAACTCAGGAGACGGAGGTTGCAATGAGCCGAGATCACGTCATCGCACTCCAGACTGGGGGACAAGAGCGAGACTTCGTCTCACAAAAAAAAAAACAACAACAAAAAAGAAA","GGCTGGGCGCAGTGGCTCACGCCTGTAATCCCAGCACTTTGGGAGGCCGAGGCAGGCGGATCACCTGAGGTCAGGAGTTTCAGACCAGCCTGGCCAACATGGTGAAACCCCGTCCCTACTAAAAATACAAAAATTAGCCGGGCGTGGTGGCAGGCACCTGTAATCCCAGCTACTCAGGAGGCTGAGGCAGGAGAATCACTTGAACCCCGGAGGCAGGGGTTGCGGTGAGCCGAGATCGCGCCACTGCACCCCAGCCTGGGGGACAAGAGCAAGACTTCATCTCAAAAATAAATAAATAAATAAAAATAAAAA"
"chr7","89384427","89384728","KN297133v1","1008238","1008538","32","88376189","GGCCGGGCGTGGTGGCTCACTCCTGTAATCCCGCCACTTTGGGAGGCTGAGGCAGGTGGATCACCTGAGGTCAGGAGTTCTAGACCAGCCTGGCCAACATGGTGAAACCCTGTCTCTACTTGAAATACAAAAATTAGCCAGGCATGGTGGCAGGCGCCTGTAATTCCAGCTACTTGGGGGGCTCAGGCAGGAAAATTGCTTGAACCTGGGAGGCAGAGGTTGCAGTGAGCTGAGATCACGCCATCACACTCCAGCCTGGGGGACAAGAGTGAGACTTCGTCTCAAAAAAAAGAAAAAAAAAA","GGCGGGGCGTGGTGGCTCACGCCTGTAATCCCAGCACTTTGGGAGGCTGAGGCGGGTGGATCACCTGAAGTCAGGAGTTCCAGACCAGCCTGGCCGACATGGTGAAACCCGTCTCTACAAAAATACAAAATTTAGCCGGGCATGGTGGCAGACGCCTGTCATCCCAGCTACTCGGGAGGCTGAGGCAAGATAATTGCTTGAACCTGGGAGGCTGAGGTTGCAGTGAGCCGAGATCACGCCACTGCACTCCAGCCTGGGGGACAAGAGTGAGACTCCGTTTCAAAAAACCAGAAAAAAGAAA"
"chr7","94450059","94450351","KN294420v1","890399","890698","34","93559660","GGCCAGGCACGGTGGCTCATGCCTGTAATCCCAGCACTTTAGGAAGCTGAGGCGGGCGGATCACCTGAGGTCAGGAGTTCGAGACCCGTCCGGCCAACATGGTGAAAACCCATGTCTACTAAAAATTAGCCAGGCATGGTGGCATGCGCCTGTAATCCCAGCTACTCAGGAGGCTGAGGCAGGAGAATCACTTGAACCCGGGAGACGGAGGTTGCAGTGAGCCGAGATTGCACCATTGCACTCCAGCCTGGGGGACAAGAGTGAGACATCATCTCAAAAAAAAAAAAAAAAAA","GGCCAGGCACGGTGGCTCACGCCTGTAATCCCAGCACTTTGGGAGGCTGAGGTGGGCGGATCACCTAAGGTCAGGAGTTCTAGATCAGCCTGGCCAACATGGTGAAATCCCGTCTCTACTAAAAATACAAAAATTAGCCAGGCATGGTGGCAGGCGCCTGTAATCACAGCTACTCAGGAGGCTGAGGCAGGAGAATCACTTGAACCCAGGAGGCGGAGTTTGCAGTGAGCTGAGATTGCACCATTGCAGTCCAGCCTGGGGGACAAAAGCAAGACTCCATCTCAAAAAAAAAAAAAAAAA"
"chr7","97970819","97971130","KN295172v1","269190","269486","42","97701629","GGCCGGGCACGGTGGCTCACGCCTGTAATCCTAGCACTCTGGAAGGCCTAGGAGTGTGGATTACCTGAGGTCAGGAATTCTAGACCAGCCTAGCAAACATGGTGAAACCCCTTCTCTACTAAAAATACAAAAATTAGCCGGGCGTGGTAGCAGGCGCCTGTAATCCTAGCTACTTGGGGGACCAAGACAGGAGAATCGCTTGAACCTGGGAGGCGGAGGTTGCAGTGAGCTGAGATCCACCGCTGCACACCAGCCTGGGGGACAAGAGCGAGACTTCGTCTCAAAAAAAAATAAAAATAAAAAATAAAAAAA","GCCGGGCACGGTGGCTCACGCCTGTAATCCAGCACTTTGGGAGGCCGAGGCGGTGGATCACCTGAGGTCAGGAGTTCTAGACCAGCCTGGCCAACATGGTAAAACCCCATCTCTACTAAAAATACAAAAATTAGCTGGGCGTGATGGCAGGCACCTGTAATCCCAGCTACTTGGGGGGCCAAGGCAGGAGAATCGCTTGAACCCTGGAGGCGGAGGTTGCAGTGAGCTGAGATCACACCATCGCACTCCAGCCTGGGGGAGAAGAGCGAGACTTCATCTAAAAAAAAAAAAAAAAAA"
"chr7","103072443","103072726","KN295576v1","406337","406628","30","102666106","GGCAGGGCGTGATGGTTCACGCCTGTAATCCCAGCACTTTGGGAGGCCGAGGTGGGTGGATCACCTGAGGTCAGGAGTTCGAGACCAGCCTGGCCAACATGGTGAAACCCCATCTCTACTAAAAATCAAAAATTAGCCGGGAGTGGCAGGCGCCTGTAATCTCAGCTACTCAGGAGGCTGAGGCAGGAGAATCGCTTGAACCCAAGAGGCGGAGTTTGCAGTGAGCCAAGATCATGCCATTGCACTCCAGCCTAGGGGACAAGAGCAAGACTTCATCTCAAAAA","GGCCGGGCGCGGTGGCTCACGCCTGTAATCCCAGCACTTTGGGAGGCCGAGGCGGGCGGATCACCTGAGGTAAGGAGTTCGAGAACAGCCTGGCCAGCATGGTGAAACCCCATCTCTACTAAAAATACAAAAATTAGCCGGGCATGGTGGCAGGTGCCTGTAATCCCAGCTACTCGGGAGGCTGAGGCAGAAGAATCGCTTGAACCCAGGAGGCGGAGGTTGCAGTGAGCCGAGATTGCGCCATTGCACTCCAGCCTAGGGGAGAAGAGCGAGACTTCGTCTCAAAAAAAAA"
"chr7","111619507","111619821","KN296515v1","690174","690488","41","110929333","GGCCGGGCGTGGTGGCTCACGCCTGTAATCCCAGCACTTTGGGAGGCCAAGGTGGGTGGATCACCTGAGGTCAGGATTTCGAGACCAGCCTAGCCAACATAGTGAAACCCCATCTCTACTAAAAAAAAAAAAAAACAAAAAATTAGCTGGGCTGGTGGCAGATGCCTGTAATCCCAGCTATTCGGGAGGCTGAGGCAGGAGAATCAATTGAACCAGGAGGCGGAGGTTGCAGTGAGCCAAGATCACGCCATTGCACTCCAGCCTGGGGGACAAGAGTGAGAGTTTATCTCAAAAATAAAAATAAAATAAATAAAA","GGCCAGGTGTGGTGGCTCACACCTGTAATTCCAGCACTTTAGGAGGCTGAGGTGGGCGGATCACCTGAGGTCAGGAGATGGAGACCAGCCTAGCCAACATGGTGAAACCCCATCTCTACTAAAAATACAAAAAAAAAATTAGCTGGGCATGGTGGCAGGTGCCTGTGATCCCAGCTACTCAGGAGGCTGAGGCAGGAGAATCGCTTGAACCCAGGAGGTGGAGGTTGCAGAGAGCTGAGATTGTGCCATCGCATGCCAGCCTGGGGGACAAGAGTGAGACTTCATCTCAAAAATAAAAATAAAAATAAAAATAAA"
"chr7","112599639","112599943","KN294526v1","558418","558721","30","112041221","GGCCAGGCGCAGTGGCTCATGCCTGTAATTCCAACACTTTGGGAGGCCGAGGTGGGCGGATCCCCTGAGGTCAGGAGTTCGAGACCAGCCTGGCCAACATGGTGAAACCCCATCTCTACTAAAAATACAAAAATTAGCCGGGCTGGTGGCAGGCACCTGTAATCCCAGCTACTCGGGAGGCTGAGGCAGGAGAATCACTTGAACCCGGGAGGCAGAGTTGCAGTGAGCCAAGATCACGCCATTGCACTCCAGCCTAGGGGACAAGAGCGAGACTTTGTCTACAAAAAAAAAAAAACAAAACAAAA","GGCCAGGCGCAGTGGCTCATGCCTGTAATCCTAGCACTTTGGGAGGCCGAGGTGGGTTGATCACTTGAGGTCAGGAGTTCGAGCCCAGCCTGGCCAATATGGTGAAACCCCGTCTCTACTAAAAATACAAAAATTAGCCGGACGTGATGGCAGGCACCTGTAATCCCAGCTACTCAGGAGGCTGAGGCAGGAGAATTGCTTGAACCCGGGAGGCGGAGGTTACAGTGAGCTGAGATCGCGCCATTGCACTCCAGCCTTGGGTACAAGAGCAAGACTTCATCTCAAAAAAAAAAAAAAAAAAAAA"
"chr7","113059601","113059897","KN294946v1","404366","404661","28","112655235","GGCCGGGCCTGGTGGCTCACACCTGTAATCCCAGCATTTTGGGAGGCTGAGGTGGGTGGATCACCTGAGGTTAGGAGTTCAAGACCAGCCTGGCCAGTGTGGTGAAACCTCGTCTCTACTAAAAATACAAAAATGAGCCAGTCATGGTGGCAGGCACCTGTAATCCCAGCTACTCGGGAAGCTGAAGCAGAATTGCTTGAACCCGGGAGGTGGAGGTTCCAGTGAGATGAGATCGTGCCATTGCACCCCAGCCTGGGGGACAAGAGCGAGACTTTGTCTACAAAAAAAAAAAAAAAA","GACTGGGCCCAGTGGCTCATGCCTGTAATCCCAGCACTTTGGGAGGCTAAGGCGGGTGGATCACCTGAGGTCAGAGTTTGAGACCAGCCTGGCCAACATGGTGAAACCTCATCTCTACTAAAAATACAAAAATGAGCCAGGCATGGTGACAGGCACCTGTAATCCCAGCTACTCGGGAGGCTGAAGCAGAATCGCTTGAACCCGGGAGGTGAAGGTTTCAGTGAGACGAGATTGCGCCATTGCACCCCAGCCTGGGGGACAAGAGCGAGACTTTGTCTCAAAAAACAAAAAAAAAA"
"chr7","113085477","113085536","KN296849v1","913787","913837","15","112171690","CCATCGCACTCCAGCATGGGGGAAAAGAGCGAGACTTCATCTCAAAAAAAAATAAATAAA","ATTGCACTGCAGCCTGGGGGTAAGAGCAAGACTCCATCTCAAAAAATAAAA"
"chr7","114026916","114027196","KN295941v1","1108709","1108994","39","112918207","GGCCTGGCGCGGTGGCTCACGGCTGTAATCCCAGCACTTTGGGAGGCCGAGGCCAGCGGATCATGAGGTCCGGAGATCTATACCAGCCTGGCTAACATGGCGAAACCCCGTCTCTACTAAAAATACAAAAATTAGCCAGGCGTGGTGGCAGGTACCTGTAATCCCAGCTACTCGGGAGGCTGAGGCAGGAGAATCACTTTAACCTGGGAGGCAGAGGTTGCAGTGAGCAGTGATCACACCATTGCACACCAGCCTGGGGGACAAGAGCGAGACTTCGTCTC","GCCGGGTGCTTTGGCTCACGCCTGTAATCCCAGCACTTTGGGATGCCGAGGCGGGTGGATCACCTGAGGTCAGGAGTTTGAGACCAGCCTGGCCAACATGGTGAAACCCTGTCTCTACCAAAAATACAAAAATTAGCCGGGCGGGGTGGCAGGCGCCCGTAATCCCAGCTACTCGGAAGGCTGAGGCAGGATAATCGCTTGAACCTGGGAGGCGGAGGTTGCAGTGAGCCGAGATCGCACCATTGCACTCCAGCCTGGGGGACAAGAGCGAGACTTCGTCTCAAAA"
"chr7","117137776","117137826","KN295601v1","571926","571977","11","116565850","CAGCCTGGGTGACAAGAGTGGGACCTTGTCTCAAAAGCAAAACAGAGAAAA","CAGCCTGGGGGACAAGAGCGAGACTGTGTCTCAAAAAAAAAAAAAAAAAAAA"
"chr7","117289683","117289790","KN296508v1","727224","727330","17","116562459","CTGGGCGCGGTGGCTCACGCCTGTAATCCCAGCACTTTGGGAGTCCAAGGCGGGTGAATCACCTGAGGCCAGGAGTTCCAGACCAGCCTGGCCAAGATGGTGAGACCC","GGCCAGGCGTGGTGGCTCACGCCTGTAATCCCAGCAGTTTGGGAGGCCAAAGCGGGTGAATCACATGAGGTCAGGAGTTCCAGACCAGCCTTGCCAACACGGTGAAA"
"chr7","117442206","117442516","KN294193v1","690006","690308","35","116752200","GGCTGGTCGTGGTGGCTCACACCTGTAATCCCAGCACTTTAGGAGGCCGACGCGGGCGGATCACCTGAGGTCAGGAGTTCGAGACCAGCCTGGCCAACATGGTGAAACCCCATCTCTACTGAAAATACAAAAATTAGCCGGGTGTGGTGGCAGGTACCTGCAATCCCAGCTACTCGGGAGGCTGAGGCAGGAGAGTCACTTGAACCTGGGAGGCGGAGGTTGCAGTGAGCCGAGATAGGGCCATTGCTCTCCAGCCTGGGGGTTAAGAGTAAGACTTCGTCTCAAAAAAAAAAGGAAAAAAGCAAAAGAAA","GGCTGGGCGCGGTGGCTCACGCCTGTAATCCCAGCACTTTGGAAGGCGAGGCAGGCGGATCACCTGAGATCAGGAGTTCGAGACCAGCCTGGCCAACATGGTGAAACCCCATCTCTACTAAAAATACAAAAATTAGTCGGGTGTGGTGGCAGGCGCCTGTAATCCCAGCCACTCGGGAGGCGGAGGCAGGAGAATCGCTTGAACCCGGCAGGCGGAGGTTGCAGTGAGCCGAGGTGGCGCCATTGCACTCCAGCCTGGGGGACAAGAGCAAGACTTCGTCTCAAAAACAAAGAAACAAAAAAA"
"chr7","119561606","119561816","KN294790v1","213980","214189","36","119347626","GGTGAAACCCCACCTCTACTAAAAATACAAAAATTAGCTGGGTGTGGTGGCAGGCGCCTGTAATCCCAGCTACTCGGGAGGCTGAGGCAGGAGAATTGCTTGAACCTGAGAGGTGGAGGCTGCAGTGAGCCGAGATTGCGCCATCGCACTCCAGCCTGGGGACAAGAGAGAATTCGTCTACAAAAAAAAAAAAGAAAGAAAAGAAAAGAAA","CATGGTGAAACCCCGTCTCTACTAAAAATATAAAAATTAGCTGAGTGTGGTGGCAGGCGCCTGTAATCCCAGCTACTGGGGAGGCTGAGGCAGGATAAATGCTTGAACCCGGGAGGCGGAAGTTGCATTGAGCCGAGATTGCACCAGTGCACTCCAGCCTGAGGGACAAGAGTGAGACTTCATCTCAAAAAAAGCAAAACCAAAAACAAA"
"chr7","123274305","123274596","KN296201v1","829989","830280","39","122444316","GGCTGGGCATGGTGGCTCATGACTGTAATCCCAGCACTTTGGGAGGCTGAGTCGGGTGGATCACCTGAGGTCAGTTCTAGACGAGCCTGGCCAACATGGTGAAATCCTGTCTCTACTAAAAATACAAAAATTAGCTGGGCATGGTGGCAGGTGCCTGTAATCCCAGCTGCTCGGGAGGCTGAGGCAGAAGAATCACTTGAACCCGGGAGGCCAGAGGTTGCAATGAGCAGAGATGGTGCCACTGCACTCTAGCTTGGGCGACAAGAGCAAGACTATGTCTCAAAAAAAAAAA","GGCTGGGCATGGTGGCTCATGCCTGTAATCCCAGCACTTTGGGAGGCCGAGGCGGGTGAATCACCTGAGGTCAGGAGTTCAAGACCAGCCTGGCCAACATGGTGAAACCCTGTCTCTACTAAAAATACAAAAATTAGCTGGGCGTGGTGGCAGGCGCCTGTAATCTCAGTTACTCGGGAGGCTGAGGCAGGAGAATTGCTTGAACCCAGGAAGCGGAGGTTGCAGTAAGCCGAGATTGTGCTGTCACACTCCAGCCTGGGGGACAAGAGCAAGATTTTGTCTCAAAAACAAA"
"chr7","129917052","129917355","KN295441v1","1459851","1460153","44","128457201","CCGGGCACTGTGGCTCACGCCTGTAATTCCAGCACTTTGGGAGGCCAAGGTGGGGGGATCACCGGAGGTCAGGAGTTCAAGACCAGCCTGGCCAACATGGTGAAACTCATCTCTACTAAAAATATATATTTAAAAAAATTGGCTGGGCATGGTGGCAGGTGCCTGTAATCCCAGCTACTCGGGAGGCTGAGGTAGGAGAATTGCTTGAACCTGGGAGGCGGAGGTTGCAGTGAGCCGAGATCGTGCCATCACACTCCAGCCAGGGGAACAAGAGTAAGACTTCATCTACAAAAAAAAAAAAGAA","GGCCGGGTGCGGTGGCTCACACCTGTAATTCCAGCACTTTGGGAGGCCGAGGTGGGCGGATCACCTGAGGTCAAGAGTTCGAGACCAGCCTGGCCAACATGGTGAAACCCCGTCTCTACTAAAAATATAAAAATTAGCCAGGCATGGTGGCAGGTGCCTGTAATCCCAGCTACTCGGGAGGCTGAGGCAGGAGAATCGCTTGAACCTGGGAGGCAGAGGTTACAGTGAGCCGAGATCGTGACATTGCACTTGTGCCTGGGGGACAAGAATGAGACTTCATCTCAAAAAACAAACAAAAAAGAA"
"chr7","134097171","134097506","KN296387v1","301235","301539","57","133795936","GGCCGGGTGCGGTGGCTCACACCTGTAATCCCAGCACTTTGGGAGGCCGAGGCTGGGTGGATCACCTGAGGTCAGGAGTTCGAGACCAGCCTGGCCAACATGGTGAAAGCCCATCTCTGTTAAAAATACAAAAATTAGCTGGGCGTGGTGGCAGGCGCCAGTAATCCCAGCTGCTGGGAGGGGCGGGGGCGGGGGCTGCCGAGGCAAGAGAGGCAAGAGAATCGCTTGAACCTGGGAGGCAGAAGTTGCAGTGAGCCGAGATCATATCGCGCCATTGCACTCCAGCCCGGGGGACAAGAGCGAGACTTCATCTAAAAAAAAAAACAAAAACAAAAA","GGCTGGGCGCGGTGGCTCACACCTGTAATCCCAGCACTTTGGGAGGCCGAGGTGGGTGAATCACCTGAGGTCAGGAGTTCGAGACCAGCCTGGCCAACATGGTGAAACCCCATATCTACTAAAAATACAAAAATTAGCCAGGTGTGGTGGCAGGCGCCTATAATCCCAGCTGCTTGGGAGCCTGAGGCAGGAGAATCGCTTGAACCTGGGAGGCGGAGGTTGCAGTGAGCCAAGATCGTGCCATTGCACTCCAGCCTAGGGGACAAGAGTGAGACTAATCTCAAAAAAAAAAAAAAAAAAAAAAA"
"chr7","135896188","135896484","KN295576v1","406337","406628","28","135489851","GGCCGGGCACGGTGGCTCCCGCCTGTAATCCCAGCATTTTGGGAGACCGAGGCGGGTGGATCACCTGAGGTCAGGAGTTCTAGACCAGCCTGGCCAACATGGTAAAACCCTGTCTCTACTAAAAATACAAAAATTAGCCGGGCATGGTGGCAGGTGCCTGTAATCCCAGCTACTCGGGGGGCCGAGGCAGGAGAATCACTTGAACCCAGGAGGCGGAGGTTGCAGTGAGGCGAGATTGTGCCATCGCACTCCAGCCTGGGAGACAAGAGCAAGACTTCGTCTCAAAAAAACAAAAAA","GGCCGGGCGCGGTGGCTCACGCCTGTAATCCCAGCACTTTGGGAGGCCGAGGCGGGCGGATCACCTGAGGTAAGGAGTTCGAGAACAGCCTGGCCAGCATGGTGAAACCCCATCTCTACTAAAAATACAAAAATTAGCCGGGCATGGTGGCAGGTGCCTGTAATCCCAGCTACTCGGGAGGCTGAGGCAGAAGAATCGCTTGAACCCAGGAGGCGGAGGTTGCAGTGAGCCGAGATTGCGCCATTGCACTCCAGCCTAGGGGAGAAGAGCGAGACTTCGTCTCAAAAAAAAA"
"chr7","139225738","139225866","KN294614v1","295099","295217","28","138930639","GAAGAATTGCTTGAACCTGGGAGGCGGAGGTTTCAGTGAGCCGAAATCGCACCATTGCACTCCAGCCTGGGGGACAAGAGTGAGACTTTGTTTACAAAAAAAAAAAAAAAATTAAAAATTAAAAAAAAA","ATCGCTTGGACCTGGGAGGTGGAGGTTGCCATGAGCCAAGATCGTGCCATCGCACTCCAGCTCGGGGGACAAGAGCGAGACTTTGTCTCAAAAAAAAAAAAAAAAAAGAAAGAAAGAAA"
"chr7","139930227","139930509","KN296495v1","2052820","2053103","32","137877407","GGCCGGGCACGGTGGCTCATGCCTGTAATCCCAGCACTTTGGGAGGCCGAGGCGAGTAGATCACCTGAGGTCAGGAGTTCGAGACCAGTCTGGCCAACATGGTGAAACCCTGTCTCTATTAAAAATACAAAAACTAGCTGGGTGTTGTGGCAGGCGCCTGTAATCTCGGCTATTCGGGGGGCTGAGGCAGGAGAATCGTTTGAACCCAGGCTGTGGAGGTTGCAGTGAGCCGAGATCGTGCCATTGCACTCCAGCCTGGGGAACAACAGTGAGACTTCATCCC","GGCTGGGCACGGTGGCTCACGCCTGTCAATCCCAGCACTTTGGGAGGCTGAGGCAGGTGGATCACCTGAGGTCAGGAGTTCGAGACCAGCATGGCCAACATGGTGAAACCCTGTCTCTACTAAAAATACAAAAATTAGCTGGGCGTGGTGGTAGGCACCTGTAATCCCAGTTACTCGGGAGGCTGAGGCAGGAGAATCGCTTGAACCCAGGAGGTGGAGGTTGCAGTGAGCTGAGATTGCGCCATTGCACTGCAACCTGGGGCACAAGAGCGAGACTTCATCTC"
"chr7","142211442","142211751","KN294685v1","1269570","1269869","31","140941872","GGCTGGGCGTGGTGGCTTACGCCTGTAATCCTAGCACTTTGGGAGGCTGAGGCGGGCAGATCACCTGAGGTCAGGAGTTCGAGATGAGCCTGGCCAACATGGTGAAACCCCGTCTCTACTAAAAATACAGAAATTAGCCAGGCGTGGTGGCAGGCGCCTGTAATCCCAGCTACTCGGGAGGCTGAGGCAAGAGAATCGTTTGAACCTGGGAGGCGGAGGTTGCAGTGAGCTGAGATCGTGCCATCGCACTCCAGCCTGGGGGACAAGAGTGAGACTTTGTCTCAAAAAAATAAAGAGAAAAAAAAAAGAA","GGCTGGGTGTGGTGGCTTAGGCCTGTAATCCCAGCACTTTGGGAGGCCAAGGCGGGCGGATCACCTGAGGTCAGGAGTTCGAGACCAGCCTGGCCAACATGGTGAAACCCCGTCTCTACTAAAAATACAAAAACTAGCCAGGCGTGGTGGCAGGTGACTGTAATCCCAGCTACTCGGGAGGCTGAGGCAGGAGAACTGCTTGAACCTGGGAGGCGGAGGTTGCAGTGAGCTGAGATCACACCATTGCACTCCAGCCTGGGGGACAAGAGCGAGACTTTGTCTCAAAAATAAAAAAAAAAA"
"chr7","142414413","142414723","KN296496v1","794027","794330","37","141620386","GGCCAGGCGCGGTGGCTCACGCCTGTAATCCCAGCACTTTGGGAGGTCGTGGCGGGCGGATCACCTGAGGTCAGGAGTTCGTAGACCAGCCTGGCCAACATGGTGAAACCCTGTCTCTACTAAAAATACAAAAATTAGCCAGGCGTGGTGGCAGGCACCTGCAATCCCAGCTACTTGGGAGGCTGAGGCAGGAGAATCACTTGAACCCAGGAGATGGAGGTTGCAATGAGCCAAGATCATGTCATCGCACTCCAGCCTGGGGGACAAGAGCGAGACTTCCTCTCAAAACAAACAAAACAAAGCAAAACAAA","GGCCAGACGCGGTGGCTCACGCCTGTAATCCCAGCACTTTGGGAGGCCGAGGTGGGTGGATCACCTGACATCTGGAGTTCGAGACCAGCCTGGCCAACATGGTGAAACCCTGTCTCTACTAAAAATACAAAAATTAGCTGGGCATGGTGGCAGGCACCTGTAATCCCAGCTACTTGGGAGGCTGAGGCAGGAGAATCGCTTGAACCCGGGAGGTGGAGGTTCCAGTGAGCCAAGATTGTGCCATTGCACTCCAGCCTGGGGAATAAGAGCAAGATTTTGTCTCAAAAAAAAAAAAGAAGAAGAA"
"chr7","142655004","142655300","KN297219v1","1714724","1715019","43","140940280","GGTCAAGCATGGTGGCTCACACTTGTTATCCCAGCACTTTGGGAGGCCTAAGCGGGTGGGTCACCTGAGGTCAGGAATTCGAGACCAGCCTGCCCAACGTGGTGAAACCCTGTTTCTACTAAAATATAATGAAATTAGCTGGGTGTGGTGGCGGGCACCTTAATCCCAGCTACTTGGGAGGCAGAGGCAGAAGAATCGTTTGAACCCAGGAGGCGAAGGTTGCAGTGAGCCGAGATCGAGCCATTGCACTCAAGCCTGGGGGACAAGAGCGAGACTTCTCTCAAAAATAAAAATAAA","GACCGGGCTCAGTGGCTCACCCCTGTAATCCCAGCACTTTGGGAGGCCGAGGTGGGTGGATCACCTGAGGTCAGGAGTTCGAGACCAGCCTGGCCAACATGGTGAAACCCCATCTCTACTAAAAAATACAAAAATTAGCTGTGCGTGGTGGCAGGTGCCTTAATCCCAGCTACTTGGGAGGTAGAGGCAGGAGAATCATTTGAACCCAGGAGGCGGAGGTTGCAGTGAGCTGAGATAAAGCCATGGCACTGAAACCTGGGGGACAAGAGTGAGACTTCTCTAAAAAAAAAAAGAAA"
"chr7","144908984","144909242","KN296682v1","4866975","4867199","50","140042009","GGCCGGGCGTGGTGGCTCACGCCTGTAATCCAAGCACTTTGGGAGGCTGAGGTGGGTGGATCACCTGAGGTCAGGAGTTCTAGACCAGCCTGGCCAACATGGTGAAACCCCGTCTCTACTAAAAATACAAAAATTAACCGGGCCTGGTGGCAAGCACCTGTAATCCCAGCTACTCGGGCAGGGGGGCCGAGGCAGGAGAATCGCTTGAACCCGGGAGGCGGAAATTGCAATGAGCCGAGATCACGCCATCGCACTCCAG","GGCCAGGCGCGGTGGCTCACGCCTGTAATCCTGGCACTTTGGGAGGACGAGGTGGGTGGATCACCTGAGGTTAGGAGTTCGAGACCAGCCTGGCCAACATGGTGAAACCCCATCTCTACTAAAAATACAAAAAATTAGCCGGGCATGGTGGCAGGCGCCTGTAATCCCAGCTACTCAGAGGGGCCGAGGCAGGAGAATCGCTTGAACCCGGGAGGCGGAGGTTGC"
"chr7","145649625","145649932","KN296119v1","5266717","5267021","33","140382908","GGCTAGGTGTGGTGGCTCACACCTGTAATCCCAGCACTCTGGAAGGCCGAGGCGGGTGGATCACCTGAGGTCAGGAGTTCGAGACCAGCCCGGCCAACATGGTGACACCCCATCTCTACTGAAAATACAAAAATTAGCCAGGTGTGGTGGCAGGCACCTGTAATCCCAGCTACTCAGGAGGCTGAGGCAGGAGACTGGCTTGAACCCGGGGCGGGGCGGAGGTTGCAGTGAGCTGAGATCGCGCCATTGCACTCCAGCCTGGGGGACAAGAACGAGACTTCGTCTAAAACAAACAAACAAACAAAAAA","GGCCAGGTGCGGTGGCTCACGCCTGTAATCCTAGCACTTTAGAAGGCCAAGGCGGGTGGATCACCTGAGGTCAGGAGTTCGAGACCAGCCTGGCCAACATGGTGAAACCCTGTCTCTACTTAAAATACAGAAAATTAGCTGGGTGTGGTGGTACGCACCTGTAATCCCAGCTACTTGGGAGGCCGAGGCAGGAGAATCGCTTGAACCCGGGAGGCAGAGGTTGCAGTGAGCTGAGATCGCGCCATTGCACTCCAGACTGAGGAACAAGAGCGAGACTTCGTCTCAAAAAACAAACAAACAAAAAA"
"chr7","148990637","148990940","KN294172v1","4419501","4419812","27","144571136","GCTGGGCGAGGTGGCTCACGCCTGTAATCCCAGCACTTTGGGAGACCGAGGCGGGTGGATCACCTGAGGTCAGAAGTTTGAGACCAGCCTGGCCAACATGGTGAAACCCTGTCTCTACTAAAAATATAAAAATTAGCCGGGCGTGGTGGCAGGCACCTGTAATCCCAGCTACTCAGGAGGCTGAGGCAGGAGAATCGCTTGAACCTGGGAGGCAGAAGTTGCAGTGAGCCGAGATCGCGCCATTGCACTCCAGCCTGGGGGACAAGAGCAAGACTTCGTCTCAAAAAAAAAAAAAAAAAAAAAA","GGCTGGGCGCAGTGGCTCACGCCTGTAATCCCAGCACTTTGGGAGGCCGAGGCAGGCGGATCACCTGAGGTCAGGAGTTTCAGACCAGCCTGGCCAACATGGTGAAACCCCGTCCCTACTAAAAATACAAAAATTAGCCGGGCGTGGTGGCAGGCACCTGTAATCCCAGCTACTCAGGAGGCTGAGGCAGGAGAATCACTTGAACCCCGGAGGCAGGGGTTGCGGTGAGCCGAGATCGCGCCACTGCACCCCAGCCTGGGGGACAAGAGCAAGACTTCATCTCAAAAATAAATAAATAAATAAAAATAAAAA"
"chr7","149518687","149518959","KN296528v1","90077","90363","43","149428610","CCTGTAATCCTAGCACTTTGGGGGGCCAAGGTGGGTGGATCACCTGAGGTCAGGAGTTCGAGACCAGCCTGGCCAACATGGTGAAACCCCGTGTCTACTAAAAATACAAAAACTAGCCAGGCATGGTGGCACGTGCCTGTAATCCCAGCTATTCAGAAGGCTGAGGCAGGAGAATTGCTTGAACCCAGGAGGCAGAGGTTGCAGTGAGCCAAGATCATGCCATTGCACTCCAGCCTGGGGGACAAGAGCAAGACTTCACCTCAAAAAAAAAAA","GGTGGCCTTCGCCTGTAATCCTAGCACTTTGGGAGGCCAAGGCGGGTGGATCCCCTGAGGTCAGGAGTTTGAGACCAGCCTGGCCAACATGGTGAAACCCTGTCTCTACTAAAAATACAAAAATTAGCCGGGTGTGGTGGCAGGCGCCTGTAATCCCAGCTACTTGAGAGGCTAAGGCAGGAGAATCGTTTGAACCCAGGAGGTGGAGGTTGCAGTGAGCTGAGATCGTGCCATTGCACTCTAGCCTGGGGGACAAGAGTGAGACTTTGTCTCAAAAAAAAAAAAAA"
"chr7","149737698","149738008","KN294713v1","906670","906972","40","148831028","GCCGGGCGCGGTGGCTCATGCCCTGTAATCCTAGCACTTTGGGAGGCCAAGGCGGGTGGATCACCCGAGGTCAGGAGTTCAAGACCAGCCTGGCTAACATGGTGAGACCCCATCTCTACTAAAAATACAAAAATTACCCAGGCATGGTGGCAGGTACCTGTAATCCCAGCTACTCGGGAGGCTGAAGCAAGAGAATCGCTTGAACCTGGGAGGCAGATGTTGCAGTGACCCAAGATCGCACCATTGCACTCCAGCCTGGGGTACAAGAGCGAGACTTCATCTCAAGGAAAACAAAACAAAATAAAATAAAA","GGCCGGGTGCAGTGGCTCAAGCCTGTACTCCCAGCACTTTGGGAGGCCGAGGCGGGCGGATCACCTGAGGTCGGGAGTTCGAGACCAACCTGGTCAACATGGTGAAACCCCTTCTCTACTAAAAACACAAAAATTAGCCGGTCATGGTGGCAGGTGCCTGTAATCCCAGCTACTCGGGAGGCTGAGGCAGGAGAATCGCTTGAACCCTGGAGGCAGAGATTGCAGTGAGCCGAGATCGCACCATTGCACTCCAGCCTGGGGGACAAGAGTGAGACTTCATCTCAAAAAAAAAAAAAAAAAAAA"
"chr7","150053666","150053978","KN296486v1","499183","499482","52","149554483","GGGCATGTGGTGCCTCACATGTGTAATCCCAGCACTTTGGGAAGCCAAGGCAGGCGGATCACCTGAGGGCAGGAGTTCGAGTCCAGCCAGGCCAACATGGTGAAACCCCGTCTCTACTAAAAATACAAAAAATTAGCCAGGTGTGGTGGCAGGTACCTTGAAGTCCCAACTACTCGGGCGGCCAAGGCAGGAGAATCGCTTGAACCCAAGAGGTGGAGGTTGCTGTGAGTTGAGATCGCGCCATCGCGCTCCAGCCTGGAGGACACGGGCAAGACTTTGTCTCAAAAAACAACAAGAACAACAAAAAAAGAAA","GGCCGGGTGCGGTGGCTCACACCTGTAATCCCAGCACTTTAGGAGGCCAAGGCAGGCGGATCACCTGAGGCAGGAGTTTGAGACCCGCCTGGCCAACATGGCGAAACCCCGCCTCTACTAAAAATACAAAAATTAGCCGGGTGTGGTGGCAGGCACCTGTAATCTCAGCTACTCGGGAGTCTGAGGCAAGAGAACCGCTTGAACCCAGGAGGTGGAGGTTGCTGTGAGCTGAGATCGCGCCATCACACTCCAGCCTGGGGGACAAAAGCAAGACTTTGCCTCAAAAAACAACAACAAAAA"
"chr7","152097280","152097582","KN294685v1","1269570","1269869","34","150827710","GGCCAGGAGTGGTGGCTCACGCCTGTAATCCCAGCACTTTGGGAGGCTGAGGTGGGTGGATCACCTGTGGTCAGGAGTTCGAGACCAGCTTGGCCAACATGGTGAAACCCCATCTCTACTAAAAATATAAAAATTAGCCAGACGTGGTGGCAGACGCCTGTTATCCCAGCTACTCAGGAGGCTGATGCAGGAGAATTGCTTGAACCCAGGAGGTGGAGATTGCAGTGAGCTGAGATCATGCTATTGCACTCCAGCCTGAGGGACAAGAGCGAGACTTTGTCTCAAAAAAACTAAAAATAAAAA","GGCTGGGTGTGGTGGCTTAGGCCTGTAATCCCAGCACTTTGGGAGGCCAAGGCGGGCGGATCACCTGAGGTCAGGAGTTCGAGACCAGCCTGGCCAACATGGTGAAACCCCGTCTCTACTAAAAATACAAAAACTAGCCAGGCGTGGTGGCAGGTGACTGTAATCCCAGCTACTCGGGAGGCTGAGGCAGGAGAACTGCTTGAACCTGGGAGGCGGAGGTTGCAGTGAGCTGAGATCACACCATTGCACTCCAGCCTGGGGGACAAGAGCGAGACTTTGTCTCAAAAATAAAAAAAAAAA"
"chr7","153482449","153482522","KN297159v1","1081621","1081688","21","152400828","CCTGGGAGGTGGAGGTTGCAGTGAGCCAAGATCGCACCATTGCACTGAGACTCTTGTCTCAAAAAAAAAAAAAA","GAGGCCTAGGTTGCAGCGAGCCAAGATCGCTCCATTGCACTCCCTCTCAAAAAAAAAAAAAAAAAAAA"
"chr7","155016615","155016926","KN294172v1","4419501","4419812","37","150597114","GCCGGGTGCGGTGGTTTACGCCTGTAATCCCAGCACTTTGGGAGGTCGAGGCGGGCAGATCACCTGAGGTCAGGAGTTCGAGACCAGCCTAGCCAACATGGTGAAACCCCGTCTCTACTAAAAATACAAAAATTAGCCAGGCATGGTGGCAGGTGCCCGTAATCCCAGCTACTTGGGAGGCTGAGGCAAGAGAATCTCTTGAACCCAGGAGGCAGAGGTTGCAGTGAGCCGAGATCGCGCCATCGCATTCCAGCCTGGGGGACAAGAGCAAGACTTCATCTCAAAAAAAAAAATTAAAAAATAAAACAGAAA","GGCTGGGCGCAGTGGCTCACGCCTGTAATCCCAGCACTTTGGGAGGCCGAGGCAGGCGGATCACCTGAGGTCAGGAGTTTCAGACCAGCCTGGCCAACATGGTGAAACCCCGTCCCTACTAAAAATACAAAAATTAGCCGGGCGTGGTGGCAGGCACCTGTAATCCCAGCTACTCAGGAGGCTGAGGCAGGAGAATCACTTGAACCCCGGAGGCAGGGGTTGCGGTGAGCCGAGATCGCGCCACTGCACCCCAGCCTGGGGGACAAGAGCAAGACTTCATCTCAAAAATAAATAAATAAATAAAAATAAAAA"
"chr7","161769508","161769797","KN295172v1","269190","269486","48","161500318","GGCCGGCCACGGTGGCTCACGCCTGTAATCCCAGCACTTTGGGAGGCCGAGGCAGGCGGATCATTTGAGGGCAGGAGTTCTAGACCAGCCTGGCCAACGTGGAGAAACCCTGTCTCTACTAAAAATACAAAAATTAGCCAGGCGTGGTGGTGTGTGCCTATAATCCTAGATACTTGGGGGGCCAAGGCAGAAGAATCGCTTGAACCTGGGAGGCGGAGGTTGCAGGTGAGCCACACTCCAGCCTGGGGGACAAGAGTGAGACTGTCTCAAAAAAAAAATGGAAAAAAAAA","GCCGGGCACGGTGGCTCACGCCTGTAATCCAGCACTTTGGGAGGCCGAGGCGGTGGATCACCTGAGGTCAGGAGTTCTAGACCAGCCTGGCCAACATGGTAAAACCCCATCTCTACTAAAAATACAAAAATTAGCTGGGCGTGATGGCAGGCACCTGTAATCCCAGCTACTTGGGGGGCCAAGGCAGGAGAATCGCTTGAACCCTGGAGGCGGAGGTTGCAGTGAGCTGAGATCACACCATCGCACTCCAGCCTGGGGGAGAAGAGCGAGACTTCATCTAAAAAAAAAAAAAAAAAA"
"chr8","1826027","1826341","KN295573v1","1644468","1644772","41","181559","GGCCAGGCACGGTGGCTCACGCCTCTAATCCCAGCACGTGGGAGGCCGAGGCGGGTGGATCACCTGAGGTCAGGAGTTCGAGACCAGCCTTGCCAACATGGTGAACCCTCTACTAAACCTCTACTAAAAATACAAAAATTAGCTGGGCATGGTGGCAGGTGCCTGTAGTCCCAGCTTACTCGGGAGGCTGAGGCAGGAGAATCGTTTGAACCCGGGAGGCAGAGGTTGCAGTGAGCTGAGATCGTGCCATCGCACTGCAGCCTGGGGGACAAGAGCGACACTTCGTCTCAAAAAAAAAGAAAAAGAAAAAAAGAA","GGCCGGGCACAGTGGCTCACACCTGTAATCCCAGCACTTTGGGAGTCTGAGGCAGGCGGATCACCTGAGGTCAGGAGTTCGAGACCAGCCTGGCCAACATGGAGAAACCCCCGTCTCTACTAAAAATACAAAAATTAGCTGGGCATGATGGCAGGAGCCTGTAATCCCAGATACTCAGGAGGCTGAGGCAGGAGAATGGCTTGAACCCGGGAGGCAGAGGTTGCAGTGAGCCAAGGTCGCGCCATTGCACTCCAGCCTGGGGGACAAGAGCGAGACTTCGTCTCAAAAAAAAAAAAAAAAAAAAA"
"chr8","3226882","3227177","KN295605v1","511648","511946","37","2715234","GCCAGGTATGGTGGCTCATGCCTGTAATCCCAGTATTTTGGGAGGCCGAGGTGGGTGGATTGCCTGAGGTCAGGAGTTCGAGACCAGCCTGGCCAATATGGTGAAACCCTGTCTCTACTAAAAATATAAAAATTAGCTGGGCATGGTGGCAAACACCTGTAATCCCAGCTACTCAGGAGGCTGAGGCAGGAGCATTGCTTGAACCCTGAAGTGGAGGTTGCAGTGAGCCAAGATCGCGCTATTGCACTCCAGCCTGGAGGACAAGAGCAAGACTTCGTCTCAAGAAAAAAAAAAAA","GGCTGGGTGTGGTGGCTAACGCCTGTAATCCCAGTACTTTGGGAGGCCGAGGCGGGTGGATCACCTGAGGTCAGAAGTTCGAGACCAGCCTGGCCAACATGGTGAAACCCTGTCTCTACTAAAAATACAAAGATTAGCCGGGCATGATGGCAGGCGCCTGTAATCCCAGTTACTCGGGAGTCTGAAGCAGCAGAATCGCTTGAACCCGGGAGGTGGAGGTTGCAGTGAGCCAAGATTGCGCCATTGCTCTCCAGGCTGGGGAACAAGAGCAAGACTTTGTCTCAAGAAAAAGAAAAAAA"
"chr8","4641907","4642218","KN294665v1","171883","172197","42","4470024","GGCCAGGCATGGTGGCTCACGTCTGTAATCCCAGCACTTTGGGAGGCCGAAGAGGGCGGATCACCTGAGGTCAGGAGTTCCAGACCAGCCTGCCCAACATGGTCAAACCCCATCTCTACTAAAAATACAAAAATTAGCCGGGCGTCGTGGCAGGCGCCTGTAATCCCAGCTACTCGGGAGGCTGAAGCAGAAGAATCGCTTGAACTCGGGAGGAAGAGTTTGCAGTGAACCAAGATCGCACCATTGCACTCCAGGCTGGGGACAAGAGCAAGACTTTGTTTACAAAAAAAAAAAAAAAAAAGAAGGAAAGAA","GCCGGGCATGGTGGCTCATGCGTGTAATCCCACCACTTTGGGAGTCCGAGGCAGGTGGATCACCTGAGGTCAGGAGTTCGAGACCAGCCTGGCCAACATGGTGAAACCCCCGTCTCTACTAAAAATACAAAAATTAGCTGGGCATGGTGGCAGGCGCCTGTAATCCCAGCTACTCGGGAGGCTGAGGCAAGAGAATCGCTTGAACCCGGGAGATGGAGGTTGCAGTGAGCCGAGATCGCACCATTGCACTCCAGCCTGGGGGACAAAAGAGAGACTTTGTCTCAAAAAAAAAAAAAAAAAAAAAAAAAAGAAAAA"
"chr8","4822208","4822347","KN297263v1","890000","890133","19","3932208","AGCTGCTTGGGAGGCTGAGGCAGGAGAATCACTTGAACCTGGGAGGCAGAGGTTGCAGTGAGCCGAGATCGCACCATCGCATTCCAGCCTGGGGGACAACAGCGAGACCGCATCTCAAAAAAAGAAAAAAAAAAAAAAAA","AGCTATTCAGGAGGCTGAGGCAGGAGAATCGCTTCAACCCGGGAGGCAGAGGTTGCAGTGAGCCGAGATCGCACCATCACACTCCAGCCTTGGGGACAAGAGCGAGACTTCATCTCAAAAAAAAAAAAAAAAAA"
"chr8","12052446","12052743","KN296541v1","476659","476959","37","11575787","GTGGTGGCTCATGCCTGTAATCCCAGCACTTTAGGAGGCCGAGGCAGGTGGATCACCTGAGGTCAGGAGTTTGAGACCAGCCTGGTCAACATGGTGAAACCTCATCGCTACTAAAAATACAAAAATTAGCCAGGCATGGTGGCAGGTGCCTGTAATCCCAGCTACTCGGGAGGCTGAGGCAAGAGAATCACTTAAACCAAGGAGGCGGAGGTTGCAGTGAGCTGAGATCATGCCATCGCACTCCAGCCTGCGGGACAAGAGCGAGACTTCGTCTAAAAAAAAAGGTTAAGAAAAAAAA","GGGCTGACGTGGTGACTCATGCCTGTAATCCCAGCACTTTGGGAGGCCGAGGCAAGTGGATCACCTGAGGTCAGGAGTTCGAGACCAGCCTGGCCAACATGGTGAAACCCAGTCTCTACTAAAAATACAAAAATTAGCCAGGCGTGGCGGTAGGCACCTGTAATCCCAGCTACTCGGGAGGCTGAGGCAGGAGAATCACTTGAACTCGGGAGGCGGAGGTTGCAGTGAGCCGAGATCACGCCATTGCACTCCAGCCTGGCGGACAAGAGCGAGACTTTGTCTCAAAAAAAAAAAAAAAAAA"
"chr8","21881429","21881724","KN296541v1","476659","476959","36","21404770","GGCCAGACACAGTGGCTCACGCCTGTAATCCCAGCACTTTGGGAGGCTGAGGCAGATGGATCACCTTAGGTCAGGAGTTTGAGACCAGACTGGCCAACATGGCAAAATCCTGTCCTACTAAAAGTACAAACATTAGCCGGGCATGGTGGCAGGCACCTGTAATCCCAGCTACTCAGGAGGCTGAGACAGGAGAATGCTTGAACCCGGGAGGCGGAGGTTGCAGTGAGCTGAGATCACGCCATTGCACTCCAGCCTGGGGGACAAGAACGAGACTTTGTCTAACAAAAAAAAAAAAA","GGGCTGACGTGGTGACTCATGCCTGTAATCCCAGCACTTTGGGAGGCCGAGGCAAGTGGATCACCTGAGGTCAGGAGTTCGAGACCAGCCTGGCCAACATGGTGAAACCCAGTCTCTACTAAAAATACAAAAATTAGCCAGGCGTGGCGGTAGGCACCTGTAATCCCAGCTACTCGGGAGGCTGAGGCAGGAGAATCACTTGAACTCGGGAGGCGGAGGTTGCAGTGAGCCGAGATCACGCCATTGCACTCCAGCCTGGCGGACAAGAGCGAGACTTTGTCTCAAAAAAAAAAAAAAAAAA"
"chr8","21941439","21941739","KN295172v1","269190","269486","31","21672249","GGCCAGGCACGGTGGCTCACGCCTGTAATCCCAGCACTTTGGGAGGCCAAGGTGGGCAGATCACCTGACATCTGGAGTTCGAGACCAGGCTGGCCAATATGGTGAAACCCCATCTCTACTAAAAATACAAAAATTAGCTGGGCGTGGTTGCAGGCACCTGTAATCCCAGCTACTCAGGAGACCAAGGCAGGAGAATCGCATGAACCTGGGAGGCGGAGGTTGCAGTGAGCTGAGATCGCGCCATTGCACTCCAGCCTGGGGGACAAGAGTGAGACTTCATCTACAAAAAAAAAAAAAGAAA","GCCGGGCACGGTGGCTCACGCCTGTAATCCAGCACTTTGGGAGGCCGAGGCGGTGGATCACCTGAGGTCAGGAGTTCTAGACCAGCCTGGCCAACATGGTAAAACCCCATCTCTACTAAAAATACAAAAATTAGCTGGGCGTGATGGCAGGCACCTGTAATCCCAGCTACTTGGGGGGCCAAGGCAGGAGAATCGCTTGAACCCTGGAGGCGGAGGTTGCAGTGAGCTGAGATCACACCATCGCACTCCAGCCTGGGGGAGAAGAGCGAGACTTCATCTAAAAAAAAAAAAAAAAAA"
"chr8","24903160","24903455","KN295576v1","406337","406628","35","24496823","GGCCGGGTGCGGTGGCTCACGCCTGTAATCCCAGCACTTTTGGAGGCCGAGGGGGGTGGATCCCCTGAGGTCAGGAGTTCTAGACCAGCCTGGCCAACATGGTGAAACCCCGTCTCTACTAAAAATACAAAAATTAGCCAGGCATGGTGGCAGGCACCTGTAATCCCAGCTACTCGGGGAGGTGGGGTGCCAAGGCAGGAGAATCGCTTGAACCCGGGAGGTGGAGGTTGCAGTGAGCCGAGATCACGCCATTGCACTCCAGCCTGGGGACAAGAGCGATACTTTAAAAAAAAAAA","GGCCGGGCGCGGTGGCTCACGCCTGTAATCCCAGCACTTTGGGAGGCCGAGGCGGGCGGATCACCTGAGGTAAGGAGTTCGAGAACAGCCTGGCCAGCATGGTGAAACCCCATCTCTACTAAAAATACAAAAATTAGCCGGGCATGGTGGCAGGTGCCTGTAATCCCAGCTACTCGGGAGGCTGAGGCAGAAGAATCGCTTGAACCCAGGAGGCGGAGGTTGCAGTGAGCCGAGATTGCGCCATTGCACTCCAGCCTAGGGGAGAAGAGCGAGACTTCGTCTCAAAAAAAAA"
"chr8","26770759","26770851","KN296635v1","3077277","3077373","15","23693482","GGCCGGGCGTGGTGGCTCATGCCTGTAATCCCAGCACTTTGGGAGGCCGAGATGGGTGGATCACCTGAGGTCAGGAGTTCCAGACCAGCCTGG","GGCCGGGCGCGGTGGCTCACGCCTGTAATCTCAGCATTTTGAGAGGCTGAGGCAGTTGGATCGCCTGAGGTCAGGAGTTCCAGACCAGCCTGGCAAA"
"chr8","31970015","31970324","KN295441v1","1090941","1091248","31","30879074","GGCCAGGTGCAGTGGCTCACGCCTGTAATCCCAGCACTTTGGGAGGCCGAGGCAGGTGGAGCACCTGAAGTCAAGAGTTCTAGACCAGCCTGGCCAACATGGTGAAACCTCCTCTCTACTAAAAATACAAAAATTAGCCGGGCGTGGTGGCAGGCGCCTGTAATCCCAGCTACTCGGGGGGCCGCGGCAGGAGAATCGCTTGAATCCAGGAGGCAGAAGTTGCTGTGAGCTGAGATCGCGCTATCACTCTCCAGCCTGGGGGACAAGAGCAAGACTTCATCTACAAAAAAAAAAAAAAAAAAAAAAAGAA","GGCCGGGTGCAGTGGCTCACGCCTGTAATCCCAGCACTTTGGGAGGCCGAGGCGGGTGGATCACCTAAAGTCAGGAGTTCTAGACCAGCCTGGCCAACATAGTAAAACCACATCTCTACTAATAATACAAAAATTAACCGGGCATGGTGGCAGGCGCCTGTAATCCCAGCTACTCAGGGGGCTGAGGCAGGAGAATCGCTGGAACCCAGGAGGCAGAGGTTGCAGTGAGCTGAGATCTCACCCTCACACTCCAGCCTGCGGGACAAGAGCAAGACTTTGTCTCAAAAAAAAAAAAAAAAAATTAAAAA"
"chr8","34686273","34686566","KN296110v1","161644","161937","27","34524629","GCCAGGCACAGTGGCTCAAGCCTGTAATCCTAGCACTTTGGGAGGCTGAGGCGGGTGGATCACCTGAGGTCAGGAGTTCTAGACCAGCCTGGCCAAAATGGTGAAACCCCATCTCTACTAAAAATACAAAAATTAGCCGGGCATGGTGGCAGGCGCCTGTAATCCCAGCTACTCGGGGGGCTGACGCAGGAGAATCGCTTGAACCCAGGAGGCGGAAGTTGCAGTGAGCCAAGATCGTGCCATCGCACTCCAGCCTGGGGGACAAGAGTAAGACTTCATCTCAAAAAAAAAAAA","GGCCGGGCGCAGTGGCTCACGCCTGTAATCCCAGCACTTTGGGAGGCTGAGGTGGGTGGATCACCTGAGGTCAGGAGTTCTAGACCAGCCTGGCCAACATGGTAAAACCCGGTTTCTACTAAAAATACAAAAATTAGCCGGGCATGGTGGCAGGTGCCTATAATCCCAGCTACTCGGGGGGCCGAGGCAGGGGAATCGCTTGAACCAGGGAGTCGGAGGTTGCAGTGAGCCAAGATCATACCATCGCACTCCAGCTTGGGGGACAAGAGCGAGATTTCATCTCAAAAAAAAAAA"
"chr8","35170635","35170980","KN295236v1","3375431","3375767","60","31795204","GGCCAGCCATGGTGGCTTACGCCTGTAATCCCAGCAGTTTGGGAGGCTGAGACGGGTGGATCACCTGAGGTCAGGAGTTCAAGACCAGCCTGGCCAACATGGTGAAACCCTGTCTCTACTAAAAATACAAAAAATACAAAATATAAAATACTAAAAATACAAAAAATACAAAAATTAGCCAGGCATGGTGGCAGGCACCTGTAATTCCAGCTACTCAGGAAGCTGAGGCAGGAGAATCGCTTGAACCCGGGAGGCGGAGGTTGCAGTGAGCTGAGATTGCACCATTGCACTCCAGCCTGGGGGACAAAAGTGAGACTTTGTCTCAAAAAAAAAAAAAAAAAAAAAA","GGCTGGGCATGGTGGCTCATGCCTGTACTCCCAGCACTTTGGGAGGCCGAGGCGGGTGCATCACTTGAGGTCAGGAGTCTGAGACCAGCCTGGCCAACATGGTGAAACCCCGTCTCTACTAAAAATACAGAAAAAAAAAAAAAAAAAAAAAAAAAAAAAAAAAAACAACTAGCCGGGCATGGTGGCAGGTGCCTATAATCCCAGCTACTCGGGGTAGGGGCGCAAGGCAGGAGAATAGCTCAAACCCAGGAGGCGGAGGTTGCAGTGAGCGGAGATTGCACCATTGCACTCCAGCCTGGGCGACAAGAGCAAGACTTTGTCTCAAAAAAAAAAAAAA"
"chr8","38208978","38209103","KN295315v1","1304753","1304876","16","36904225","GGTCGGGTGCGGTGGCTCATGCCTGTAATCCCAGCACTTTGTGAGGCTGAGGCTGTTGGATCACCTGAGTTCAGGAGTTCTAGACCAGCCTGGCCAATATGGCGAAACCCTGTCTCTACTAAAAAT","GGGCGGGCGCGGAGGCTCACACCTGTAATCCCAGCACTTTGGAAGGCTGAGGCAGGTGGATCACCTGAGGTCAGGAGTTCCAGACCAGCCTGGCCAACATGGTGAAACCCTGTCTCACTAACAA"
"chr8","38771325","38771533","KN297259v1","2642198","2642414","36","36129127","GGAGTTCAAGACCAGCCTGGCCAACATGGTGAAACCCCGTCTCTACTAAAAACACAAAAATTAGCCGGGCATGGTGGCAGGCACCTGCAATCCCAGCTACTTGGGAGGCTGAGGCAGGAGAATCGCTTGAGCCCGGGAGGCAGAGGTTGCAGTGAGCCGAGATTGCACCATTGCACTCCAGCCTGGGAGACAAGAGCGAGTTTTCGTCT","GAGGTTAGGCGTTCAAGACCAGCCTGGCCAACATGGTGAAACCCCATCTCCACTGAAAATATAAAAATTAGCCAGGCATGGTGGCAGGCGCCTGTAATCCCTGCTACTCAGGAGGCTGAGGCAGGAGAACAGCTTGAACCTAGGAGGTGGAGGTTGCAGTGAGCGGAGATCGTGCCATTGCACTCCAGCCTGGGGGACAAGAGCAAGACTTCATCCC"
"chr8","40023341","40023429","KN295893v1","2958721","2958798","37","37064620","ATTACACTCCAGCCAGGGAGACATAGGGAGAGCTTGTCTCAGAAAAGAAACAAGAAAACAATAAAAAAAAAAAAAAAGAAGGAAAATAA","GAACCCAGGAGGTGGAGGCTGCAGTGAGCCAGAATCACGCCATTGTACTCCAGTAAAAAAAAAAAAAAAAAAAAAAAA"
"chr8","40768822","40768952","KN296308v1","1041756","1041887","17","39727066","GGCTGGGCGCGGTGGCTCATGCCTGTAATCCCAGCACTTTGGGAGGCCAAGGTGGGTGGATCAACTGAGGTCAGGAGTTGGCCAGGTCAGCCTGGCCAACATGGTGAAACCTCGTCTCTACTAAAAATACA","GGCTGAGCGCAGTGGCTCATGCCTGCAATCCCAGCACTTTGGGAGGCCTATGTGGGTGGATCACCTGAGGTTAGGAGTTCCACACCAGCCTGGCCAACATGGTGAAACCCCATCTCTACTAAAAATACAAAA"
"chr8","40860749","40860862","KN294351v1","53165","53278","5","40807584","CTTGAGCCTTGGAGATGGAGGCTGCAGTAAGCAGACATCCCGCAACTGCACTCCAGCCTGCGGGACAGGAGTGAGACCCTCTCTCAAAAACAAAACAAATAAACAAACAAAAAA","GCTTGAGCCTTGGAGATGGAGGCTGCAGTAAGCAGACATCCCACAACTGCACTCCAGCCTGGGGGACAGGAGTGAGACCCTCTTTCAAAAACAAAACAAATAAACAAACAAAAA"
"chr8","43258307","43258602","KN294685v1","1269570","1269869","38","41988737","GGCTGGGTATGGTGGCTCAAGCCTGTAATCCCAGCACTTTGGGAGGCCAAGATGGGTGAATCACCTGAGGGGTGGAGTTCTAGACCAGCCTGGCCGACATGGTGAAACACCGTCTATACTAAAAGTACAAAAATTAGCCAGGCGTGGTGGCAGGCGCCTGTAATCCCAGCTACTCAGGAGGCTGAGGCAGGAGAATTGCTTGAACCCAGGAGGTGGAAGTTGCACTGAACCGGGATCGTGCCATGGCACTCCAGCCTGGGGGACAAGAGTGAGACTTCGTCTCAAAAAAAAAAAAA","GGCTGGGTGTGGTGGCTTAGGCCTGTAATCCCAGCACTTTGGGAGGCCAAGGCGGGCGGATCACCTGAGGTCAGGAGTTCGAGACCAGCCTGGCCAACATGGTGAAACCCCGTCTCTACTAAAAATACAAAAACTAGCCAGGCGTGGTGGCAGGTGACTGTAATCCCAGCTACTCGGGAGGCTGAGGCAGGAGAACTGCTTGAACCTGGGAGGCGGAGGTTGCAGTGAGCTGAGATCACACCATTGCACTCCAGCCTGGGGGACAAGAGCGAGACTTTGTCTCAAAAATAAAAAAAAAAA"
"chr8","45124661","45124774","KN296635v1","1811423","1811536","14","43313238","GCCAGGCATGGTGGTTCATGCCTGTAATCCGAGCACTTTGGAAGGCTGAGGCAGGTGGATCACCTGAGGTCAGGAGTTCTAGACCAGCCTGGCCAACATGGTGAAACCCTGTCT","GCCAGGCACAGTGGCTCATGCCTGTAATCCCAGCACTTGGGGAGGCCAAGGCAGGCGGATCACCTCAGGTCAGGAGTTCTAGACCAGCCTGGATAACATCGTGAAACCCCGTCT"
"chr8","46448805","46449107","KN296541v1","476659","476959","33","45972146","GGCCAGGCGCGATGACTCACGCCTGTAATCCCAGCACTTTGGGAGGCTGAGGCCAGTGGATCACCTGAGGTCAGGAGTTCGAGACCAGCCTGTCCAACACGGTGAAACCCCGTCTCTACTAAAAATACAAAAATTAGCCAGGCGTGGTGGCAGGCGCCTGTAATCCCGGCTATTCAGGAGGCTAAGGCAGAAGAATCGCTTGAACCCAGGAGGCGGAGGTTGCAGTGAGCCGAGATTGTGCCATCACACTCCACCCTGGGGGACAAGAGCGAGACTTCATCTACAAAAAAAAAAAATAAAAAA","GGGCTGACGTGGTGACTCATGCCTGTAATCCCAGCACTTTGGGAGGCCGAGGCAAGTGGATCACCTGAGGTCAGGAGTTCGAGACCAGCCTGGCCAACATGGTGAAACCCAGTCTCTACTAAAAATACAAAAATTAGCCAGGCGTGGCGGTAGGCACCTGTAATCCCAGCTACTCGGGAGGCTGAGGCAGGAGAATCACTTGAACTCGGGAGGCGGAGGTTGCAGTGAGCCGAGATCACGCCATTGCACTCCAGCCTGGCGGACAAGAGCGAGACTTTGTCTCAAAAAAAAAAAAAAAAAA"
"chr8","46755473","46755781","KN294526v1","558418","558721","34","46197055","GGCCGGGCGCGGTGGCTCAAGCCTGTAATCCCAGTACTTTGGGAGGCCAAGGTGGGTGCATCACCTGAGGTCAGGAGTTCAAGACCAGCCTGGCCAACATGGTGAAACCCCGTCTCTACTAAAAATACACAAACTAGCCAGGCATGGTGGCAGACGCCTGTAATCCCAGCTAATCAGGAGGCTGAGGCAGGAGAATTGCTTGAACCCAGGAGGCAGAGGTTGCAGTGAGCCGAGATCGCGCCATTGCACTCTAGCCTTGGGGACAAGAGCGAGACTTCGTCTCAAACAAAACAAAACAAACAAAAAAAA","GGCCAGGCGCAGTGGCTCATGCCTGTAATCCTAGCACTTTGGGAGGCCGAGGTGGGTTGATCACTTGAGGTCAGGAGTTCGAGCCCAGCCTGGCCAATATGGTGAAACCCCGTCTCTACTAAAAATACAAAAATTAGCCGGACGTGATGGCAGGCACCTGTAATCCCAGCTACTCAGGAGGCTGAGGCAGGAGAATTGCTTGAACCCGGGAGGCGGAGGTTACAGTGAGCTGAGATCGCGCCATTGCACTCCAGCCTTGGGTACAAGAGCAAGACTTCATCTCAAAAAAAAAAAAAAAAAAAAA"
"chr8","47820112","47820245","KN296040v1","489522","489654","18","47330590","GGTTGGGTGCAGTGGCTCACATCTGTACTCCCAGCACTTTGGGAGGCTGAAGCGGGTAGATCACCTGAGATCAGGAGTTCTAGACCAGCCTGGCTGACATGGTGAAACCCTGTCTCTACTAAAAATACAAAAAT","GGCTGGGCGCAGGGGCTCACACCTGTAATCCCAGCACTTTGGGAGGCTGAGGTGGGTGGATCACCTGAGGTCAGGAGTTCCAGACCAGCCTGGACAACATGGTGAAATCCCATCCCTACTAAAAATACAAAAA"
"chr8","47832018","47832127","KN296508v1","727224","727330","17","47104794","GGCCAGGGGAGGTGGCTCATACTTGTAATCCCAGCACTTTGAGAGGCCGACGTGGGTGGATCACCTGAGGTCAGGAGTTCCAGACCAGCCTGGCCAACATGGTGAAACCC","GGCCAGGCGTGGTGGCTCACGCCTGTAATCCCAGCAGTTTGGGAGGCCAAAGCGGGTGAATCACATGAGGTCAGGAGTTCCAGACCAGCCTTGCCAACACGGTGAAA"
"chr8","48554897","48555183","KN295576v1","406337","406628","43","48148560","GGCCGGGTGCGGTGGATCATGCCTGTCATCTCAGCACTTTGGGAGGCCGAAGTGGAATGGATCACCTGAGGTCAGGAGTTGGAGACCAGCCTGGCTAACATGGTGAAACCCCATCTCTACTAAAATTAGCCAGGCATGGTGGCAGGCGCCTGTAGTCCCAGCTAGTCGGGAGGCTGAGGCAGGAGAATCGCTTGAACCCCAGAGGCAGAGGTTGCAGTGAGCTGAGATTGCACCATTGCACTCCAGTCTGGGGGACAAGAGTGAGACTGTGTCTCAAAAAAAAAAAA","GGCCGGGCGCGGTGGCTCACGCCTGTAATCCCAGCACTTTGGGAGGCCGAGGCGGGCGGATCACCTGAGGTAAGGAGTTCGAGAACAGCCTGGCCAGCATGGTGAAACCCCATCTCTACTAAAAATACAAAAATTAGCCGGGCATGGTGGCAGGTGCCTGTAATCCCAGCTACTCGGGAGGCTGAGGCAGAAGAATCGCTTGAACCCAGGAGGCGGAGGTTGCAGTGAGCCGAGATTGCGCCATTGCACTCCAGCCTAGGGGAGAAGAGCGAGACTTCGTCTCAAAAAAAAA"
"chr8","50500222","50500521","KN295172v1","269190","269486","33","50231032","GACCGGGTGCGGCGGCTCACACCTGTAATACCAGCACTTTGGGAGGCCAAGGCGGGTAGATCACCTGAGGTCAGGAGTTCGAGACCGGCCTGGCCAACATGGTGAAACCCCGTCTCTACTAAAAATACAAAAATTAGCTGGGCATGGTGGCAGGCACCTGTAATCCCAGCTACTTGGGAGGCTGAGGCAAGAGAATTGCTTGAACCCGGGAGGCGGAGGTTATAGTTAGCTGAGATCATGCATTGCACTCCAGCCTGGGGGACAAGAGCAAGACTTCATCTCAAAAAAAATAAAAATAAA","GCCGGGCACGGTGGCTCACGCCTGTAATCCAGCACTTTGGGAGGCCGAGGCGGTGGATCACCTGAGGTCAGGAGTTCTAGACCAGCCTGGCCAACATGGTAAAACCCCATCTCTACTAAAAATACAAAAATTAGCTGGGCGTGATGGCAGGCACCTGTAATCCCAGCTACTTGGGGGGCCAAGGCAGGAGAATCGCTTGAACCCTGGAGGCGGAGGTTGCAGTGAGCTGAGATCACACCATCGCACTCCAGCCTGGGGGAGAAGAGCGAGACTTCATCTAAAAAAAAAAAAAAAAAA"
"chr8","59520859","59520987","KN294420v1","516954","517082","17","59003905","GCCTGGCACGGTGGCTCACGCCTCTAATCCCAGCACTTTGGGTGGCCGAGGCAGGTGGATCACTTGAGGGCAGGAGTTCTAGACCAGCCTTGCCAACATGGTGAAACACCATCTCCTCTAAAAATACAA","GGCCTGGCATCATGGTTCACACCTGTAATCCCAGCACTTTGGGAGGCCGAGGCAGGTGGATCACTTGAGGTCAGCGTTCTAGACCAGCCTGGCCAACATGGTGAAACCCTGTCTCTACTAAAAATACAA"
"chr8","61137312","61137604","KN295576v1","406337","406628","31","60730975","GGCAGGTCGCGGTGACTCACGCCTGTAATCCCAGCACTTTGGGAGGCCGAGGCGGGTGGATCACCTGTGGTCAGGAGTTCGAGACCAGCCTGGCCAACATGGTGAAACCCCATCTCTACTAAAAATACTAAAATTAGCTGGGCATGGTGTCAGGCGCCTGTAATCCCAGCTACTCAGGAGGCTGAGGCGGGAGAATTGTTTGAACCGGAGAGGCGGAGGTTGCAGTGAGCCAAGATCGCACCATCACACTCCAGCCTGGGGGACAAGAATGAGACTTTGTCTCCAAAAAAAAA","GGCCGGGCGCGGTGGCTCACGCCTGTAATCCCAGCACTTTGGGAGGCCGAGGCGGGCGGATCACCTGAGGTAAGGAGTTCGAGAACAGCCTGGCCAGCATGGTGAAACCCCATCTCTACTAAAAATACAAAAATTAGCCGGGCATGGTGGCAGGTGCCTGTAATCCCAGCTACTCGGGAGGCTGAGGCAGAAGAATCGCTTGAACCCAGGAGGCGGAGGTTGCAGTGAGCCGAGATTGCGCCATTGCACTCCAGCCTAGGGGAGAAGAGCGAGACTTCGTCTCAAAAAAAAA"
"chr8","63527673","63527970","KN294685v1","1269570","1269869","28","62258103","GGCCAGGTGCAGTGACTCATGCCTGTAATCCCAGCACTTTGGGAGGCCAAGGTGGGTGGATCACCTGAGGTCAGGAGTTCGAGACCAGCCTCGCCCACATGGTGAAACCCCGTCTCTACTAAAAACACAAAAATTAGCTGGGCGTGGTGGCAGGCACCTGTAATCCCAGCTACTCGGGAGGCTGAGGCAGAAGAATCGCTTGAACCTGGGAGGCGGAGGTTGCAGTGAGCTGAGATCATGCCATTGCACTCCAGCCTGAGGGACAAGAGCGAGACTTCGTCTCAAAAAAAAAATAAAA","GGCTGGGTGTGGTGGCTTAGGCCTGTAATCCCAGCACTTTGGGAGGCCAAGGCGGGCGGATCACCTGAGGTCAGGAGTTCGAGACCAGCCTGGCCAACATGGTGAAACCCCGTCTCTACTAAAAATACAAAAACTAGCCAGGCGTGGTGGCAGGTGACTGTAATCCCAGCTACTCGGGAGGCTGAGGCAGGAGAACTGCTTGAACCTGGGAGGCGGAGGTTGCAGTGAGCTGAGATCACACCATTGCACTCCAGCCTGGGGGACAAGAGCGAGACTTTGTCTCAAAAATAAAAAAAAAAA"
"chr8","64858464","64858576","KN295112v1","593978","594084","20","64264486","GGTGAATTGCTTGAACCCAGAGGCGGAGGTTGCAGTGAGCCAAGATAGCGCCATCACACTCCAGTCTGGGGGACAAGAGCAAGACTTCGTCTCAAAAAAAAAAAAAAAAAAAA","TTAAAGAACCCAGGAGGCAGAGATTGCAGTGAGCCGAGATCACGCCATTGCACTCCAGTCTGGGGGACAAGAGCGAGACTTCGTCTCAAAAAAAAAAAGGAAAAAAA"
"chr8","64969010","64969246","KN294172v1","5339287","5339545","62","59629723","GGCCGGGCGCGGTGGCTCACGTCTGTAATCTCAACACTTGGGGAGGCCAAGGTGGGTGGATCACGTGAGGTCAGGAGTTCACAACCAGCCTGGCCAACATGGTGAAACCCTGTCTTTATTAAAAATACAAAAGTTAGCCGGGCATGGTAGCAGGCGCCTGTGGCGGAGGTTGCAGTGAGCTGAGATTGCACCACTGCACTGGGGGACAAGAGCAAGACTTCGTCTCAAAAAAAAAGA","GGCTGGGTGCGGTGATTCACACCTGTAATCTCAGCACCTTAGGAGGCCAAGGTAGGCGGATCACGAGGTCAAGAGTTCGAGACCAGCCCGGCGAACATGGTGAAACCCCATCTCAACTAAAAATAAAAAAATTACCCGGGCATGGTGGCAGGTGCCTGTAATCCCAGGGAGGCGGAGGTTGCAGTGAGCCGAGATAGCGCCATTGCACTCCAGCCTGGGGGACAAGAATGAGACTTCATCTCAAAAAAAAGAAAGAAAA"
"chr8","65388571","65388872","KN296117v1","150360","150664","28","65238211","GGCCGGGCGCGGTGGCTCACACCTATAATCCCAGCACTTTGGGAGGCCAAGGCCAGTGGATCACCTGAGGTCAAGAGTTCGAGACCAGCCTGGCCAACACGGTGAAACCCCGTCTCTACTAAAAATACAAAAATTAGCCAGGCATGGTGGCAGGCGCCTGTAATCCCAACTACTTGGGAGACTGAGTCAGGAGAATCACTTGAACCCGGGAGGCGGAGGTTGCAGTGAGCCAAGATCACGCCATCACGCTCCAGCCTGGGGACAACAGCAAGACTTTGTCTAAAAAAAAAAAAAAAAAAAAA","GGCCGGGCGCGGTGGCTCACACCTGTAATCCCAGCACTTTGGGAGGCCGAGGCTGGTGAATCACCTGAGGTCAGGAGTTCTAGACCAGCCTGGCCAACACGGTAAAACCTCGTCTCTACTAAAAATAAAAAAATTAGCCAGGCATGGTGGCAGGCGCCTGTAATCCCAGCTACTTGAGAGGCTGAGGCAGGAGAATCACTTGAACCCAGGAGGCAGAGGTTGCAGTGAGCCATGATCGCGCCACTGCACTCCAGCCTGGGGGACAAGAGCAAGATGTTGTCTCAAAAAAAAAAAAAAAAAAAAAA"
"chr8","69173600","69173883","KN297130v1","7468","7751","33","69166132","GGCCGGGCACAGTGGCTAATGCCCGTAATCCCAGCACTTTGGGAGGCTGAGGTGGGTGGATCATCTGAGGTCAGGAGTTCAAGACCAGCCTGGCTAACATGGTGAAACCACGTCTCTACTAAAAATACAAAAATTAGCCGGGCATGGTGGCAGGTGCCTGTAATCCCAGCTACTCAGGAGGCTGAGGCAGGAGAATCGCTTGAACCCGGGAGGTGGAGGTTGCAGTGAGCCAAGATCGCACCATCGCAATCTGGCCTGGGGGACAAGGGCAAGACTTCATCTCA","GGCTGGGTGCAGTGGCTCATGCCTGTAATCCCAGCACTTTGGGAGGCCTAGGTGGGTGGATCTCCTGAGGTCAGGAGTTCGAGACCAGCCTGGCCAACATGGTGAAACCCTGTTTCTACTAAAAATTCAAAAATTAGCCAGGAGTGGTTGCAGGTGCCTGTAATCCCAGCTAGCTGGGAGGTTGAGGCAGGAGAATCACTTGAACCTGGGAGGTGGAGGTTGCAGTGAGCCAAGATCGTGCCATCACACTCCGGCCTGGGGGACAAAAGCGAGACTTCATCTCA"
"chr8","73114186","73114295","KN296316v1","167495","167598","18","72946691","GCTTGAACCCGGGATGTGGAGGTTGCAGTGAGCCGAGATCGTGCCATCGCACTCCAGCCTGGGGGACAAGAGCAAGACTTCATCTCAAAAAAANAAAAAAAAAAAAAAAA","CTTGAACCCGGCGGGGGGAGGTTGCAGTGAGTTGAGATTGTACCATCGCACTTCAGCCTGGGGGACAAGAGCAACACTTCGTCTCCAAAAAAAAAAAAAAAAAA"
"chr8","78262671","78262959","KN295576v1","406337","406628","25","77856334","GGCCAGGCGCGGTGGCTCACACCTGTCATCCCAGCACTTTGGGAGGCCGAGGCGGGTGGATCACCTGAGGTCAGGAGTTCGAGACCAGCCTGGCCAACATGGTGAAACCCCGTCTCTACTAAAAATACAAAAATTAGCCAGGCATGGTGGCAGGTGCCTGTAATCCCAGCTACTCAGGAGGTTGAGGCAGGAGAATCGCTTGAACCTGGGAGGCGGAGGTTGCAGTGAGCCGAGATTGCACCATTGCACTCCAGCTTGGGGGACAAGCTTGAGACTTCGTCTCCAAAAA","GGCCGGGCGCGGTGGCTCACGCCTGTAATCCCAGCACTTTGGGAGGCCGAGGCGGGCGGATCACCTGAGGTAAGGAGTTCGAGAACAGCCTGGCCAGCATGGTGAAACCCCATCTCTACTAAAAATACAAAAATTAGCCGGGCATGGTGGCAGGTGCCTGTAATCCCAGCTACTCGGGAGGCTGAGGCAGAAGAATCGCTTGAACCCAGGAGGCGGAGGTTGCAGTGAGCCGAGATTGCGCCATTGCACTCCAGCCTAGGGGAGAAGAGCGAGACTTCGTCTCAAAAAAAAA"
"chr8","78445704","78446010","KN296387v1","301235","301539","32","78144469","GGCCGGGACGCGGTAGGCTCACACCTGTATTCCCAGCACTTTGGGAGGCCATGGCGGGTGGATCACCTGAGGTCAGGAGTTCGAGACAAGTCTCGCCAACATGGTGAAACCCTGTCTCTACCAAAAATACAGAAATTAGCCAGGTGTGGTGGCGGGCGCCTGTAATCCCAGCTACTTGGGGAGCCGAGACAGGAGAATTGCTTGAACCTGGGAGGCGGAGGTTGCAGTGAGCCAAGATCGTGCCATCACACTCCAGCCTGGGGGACAAGAGTGAGACTTCGTCTACAAAAAAAAAAAAAGAAAAAAA","GGCTGGGCGCGGTGGCTCACACCTGTAATCCCAGCACTTTGGGAGGCCGAGGTGGGTGAATCACCTGAGGTCAGGAGTTCGAGACCAGCCTGGCCAACATGGTGAAACCCCATATCTACTAAAAATACAAAAATTAGCCAGGTGTGGTGGCAGGCGCCTATAATCCCAGCTGCTTGGGAGCCTGAGGCAGGAGAATCGCTTGAACCTGGGAGGCGGAGGTTGCAGTGAGCCAAGATCGTGCCATTGCACTCCAGCCTAGGGGACAAGAGTGAGACTAATCTCAAAAAAAAAAAAAAAAAAAAAAA"
"chr8","85216941","85217258","KN296036v1","1090158","1090461","47","84126783","GGCTGGGCACGGTGGCTCATGCCTATAATCTCAGCACTTCGGGAGGCAGAGGCAGGTAGATCACAGGAGGTCAGCAGTTCTAGACCAGCCTGGCCAACATGGTGAAACCCCGTCTTTACTAAAAATACAAAAATTAGCCGAGCATGGTGGCAGGCGCCTGTAATCCCAGCTACTCGGTTGCGGGGGGGAGCGGGCTGTGGCAGGAGAATTGCTTGAACCCGGGAGGAGGAGGTTGCAGTGAGCCGAGATCGTGCCATTGCACTCCAGCCTGGGGGAAAAGAGCAAGACTTTGTCTCAAAAAAAAAAAAAAAAAAAAAA","GGCCGGGCACGGTGGCTCACACCTGTAATCCCAGCACTTTGGGAGGCTGAGGCGGATGGATCACCTGAGGTCAAGAGTTCTAGACCAGCCTGGCCAACATGGTGAAACCCTGTCTCTACTAAAAATACAAAAATTAGCCAGGCATGGTGGCAGGCGCATGTAATCCCAGCTGCTCGGTGGGGCCGAGGCAGGAGAGTCGCTTGAACCCAGGAGACGGAGGTTGCAGTGAGCCGAGATAGTGCCATTGCACTCCAACGTGGGGGACAAGAGCGAGACTTCATCTCAAAAAAAAAAAAAAAAAAAA"
"chr8","91287559","91287858","KN296541v1","476659","476959","32","90810900","GGCCTGGCGTGGTGGCTCACGCCTATAATCCTAGCACTTTGGGAGGCTGAGGAGGGAGGGTCACCTGAGGTCAGGAGTTCGAGACCAGCCTGGCCAACATGGTGAAAACCCATCTCTACTAAAAATACAAAAATTAGCCAGGCGTGGTGGCAGGCACTTGTAAATCCCAGCTACTCGGGAGGCTGAGGCAGGAGAATCACTTGAACCCAGGAGGCAGAGGTTGCCGTGAGTCGAGATCGTGCCACTGGACTCCAGCCTGGGGGACAAGAGAGAGACTTCGTCTCAAAAAAAAAAAAAAAA","GGGCTGACGTGGTGACTCATGCCTGTAATCCCAGCACTTTGGGAGGCCGAGGCAAGTGGATCACCTGAGGTCAGGAGTTCGAGACCAGCCTGGCCAACATGGTGAAACCCAGTCTCTACTAAAAATACAAAAATTAGCCAGGCGTGGCGGTAGGCACCTGTAATCCCAGCTACTCGGGAGGCTGAGGCAGGAGAATCACTTGAACTCGGGAGGCGGAGGTTGCAGTGAGCCGAGATCACGCCATTGCACTCCAGCCTGGCGGACAAGAGCGAGACTTTGTCTCAAAAAAAAAAAAAAAAAA"
"chr8","92433676","92433970","KN297219v1","1714724","1715019","32","90718952","GACCGGGCACAGTGGCTCATGCCTGTTATCCCAGCACTTTGGGAGGCTGAGGCAGGCGGATTATCTGAGGTCAGGAGTTCGAGACCAGCCTGGCCAACATGATGAAACCCCGTCTCCACTGAAAAATACAAAAATTAGCCAGGTGTGGTGGCAGGCGCCTTAATCCCAGCTACTTTGGAGGCAGAGGCAGGAGAACTGTTTGCACCCAGGAGGCAGAGGTTGCAGTGAGCCGAGATAAAGCCATTGCACTCAAACCTGGGGGACAAGAGCGAGACTTCTCTCAAAAAAAAAAAAA","GACCGGGCTCAGTGGCTCACCCCTGTAATCCCAGCACTTTGGGAGGCCGAGGTGGGTGGATCACCTGAGGTCAGGAGTTCGAGACCAGCCTGGCCAACATGGTGAAACCCCATCTCTACTAAAAAATACAAAAATTAGCTGTGCGTGGTGGCAGGTGCCTTAATCCCAGCTACTTGGGAGGTAGAGGCAGGAGAATCATTTGAACCCAGGAGGCGGAGGTTGCAGTGAGCTGAGATAAAGCCATGGCACTGAAACCTGGGGGACAAGAGTGAGACTTCTCTAAAAAAAAAAAGAAA"
"chr8","92797450","92797744","KN295576v1","406337","406628","31","92391113","GGCCGGGCGCAGTGGCTCATGCCTGTAATCCGAGCACTTTGGGAGGCTGAGGCAGGTGGTTCACCTGAGGTCAGGAGTTCGAGACCAGCCTGGCCAACATGGTGAAATCCTGTCTCTACTAAAAATACAAAAATTATTCGGGTGTGGTGGCAGGTGCCTGTAATCCCAGCTACTCGGGAGGCTGAGGCAGGAGAATCTCCTGAACCCAGGAGGCGGAGGTTTCAGTGAGCCGAGATTGTGCCGTTGCACTCCAGCCTGGGGGACACGAGTGAGACTTCATCTCAAAAAAAAAAAA","GGCCGGGCGCGGTGGCTCACGCCTGTAATCCCAGCACTTTGGGAGGCCGAGGCGGGCGGATCACCTGAGGTAAGGAGTTCGAGAACAGCCTGGCCAGCATGGTGAAACCCCATCTCTACTAAAAATACAAAAATTAGCCGGGCATGGTGGCAGGTGCCTGTAATCCCAGCTACTCGGGAGGCTGAGGCAGAAGAATCGCTTGAACCCAGGAGGCGGAGGTTGCAGTGAGCCGAGATTGCGCCATTGCACTCCAGCCTAGGGGAGAAGAGCGAGACTTCGTCTCAAAAAAAAA"
"chr8","96567004","96567078","KN294172v1","6135275","6135376","38","90431729","ACCCTGTCTCTACTAAAAATACAAAATTAGCCCAGTGTGGTGGCCTGTAATCCCAGCTACTCCAGAGGCCGAGGC","ACCCTATCTCTACTAAAAATACAAAAATTAGCCAGGCATGGCAGGCAGCTGTAGTCCCGGCTACTTGGGAGGCTAAGGTGGGAGAGTCACTTAAGCCCAAGA"
"chr8","96905687","96905984","KN297112v1","4703110","4703407","31","92202577","GCTGGGTGCGGTGGCTCACGCCTGTAATCCCAGCACTTTGGGAGGCTGAGGCGGGTGGATCACCTGAGGTCCGGAGTTCGAGACCAGCCTGGCCAACATGATGAAACCCAGTCTCTACTAAAAATACAAAAATTAGCCGGGCGTGGTTGCATGCACCTGTAATCCCAGCTACTTGGGAGGCTGAGGCAGGAGAAAATTGAACCCGGGCGGCAGAGGTTGCAGTGAGCCGAGATCGCGCCATTGCACTCCAGCCTGGGGGAAAAGAGCGAGACTTTGACTCAAAAACAAACAAAGAAAA","GGCTGGGTGCGGTGGCTCATGCCTGTAATCCCAGCACTTTGGGAAGCCAAGGCAGGCGGATCACCTGAGGTCAGGAGTTCGAGACCAGCCTGGCCAACATGAAAACCCTGTCTCTACTAAAAATACAAAAATTAGCCGGGTGTGGTGGCAGGCGCCTGTAGTGCCAGCTACAAGGGAGGCTGAGGCAGGAGAATCACTTGAACCCGGGAGGCAGAGGTTGCAGTGAGCCGAGATAGTGCCATTGCACTCCAGCCTGGGGGACAAGAGTGAGACTTTGTCTCAAAAAAAAAAAAAAAAA"
"chr8","101675459","101675767","KN294172v1","4419501","4419812","45","97255958","GGCCGGGCGCGGTGGCTCACGCCTGTAATCCCAGCACTTTGGGAGGCTGAGGCGGGTGAATTGCCTGAGGTCAGGAGACCAGCCTGGCCAACATGCTGAAACTCCATCTCTACTAAAAATACAAAAATTAGCCGGGCGTGGTGGCTGGCTCCTGTAATCCCAGCTCCTCGGGAGGCTGAGGCAGGAGAATCGCTTGAACTGAGGAGGCAGAGGTTGCAGTGAGCCAAGATCTCACCAGGGCACTCCAGCCTGGGGGACAAGAGCAGCGGGACTTCATCTAAAAAAAAATAATAATAATGAAAAATAAAA","GGCTGGGCGCAGTGGCTCACGCCTGTAATCCCAGCACTTTGGGAGGCCGAGGCAGGCGGATCACCTGAGGTCAGGAGTTTCAGACCAGCCTGGCCAACATGGTGAAACCCCGTCCCTACTAAAAATACAAAAATTAGCCGGGCGTGGTGGCAGGCACCTGTAATCCCAGCTACTCAGGAGGCTGAGGCAGGAGAATCACTTGAACCCCGGAGGCAGGGGTTGCGGTGAGCCGAGATCGCGCCACTGCACCCCAGCCTGGGGGACAAGAGCAAGACTTCATCTCAAAAATAAATAAATAAATAAAAATAAAAA"
"chr8","101757098","101757389","KN295576v1","406337","406628","26","101350761","GGCCGGGCACGGTGGCTCACACCTGTAATCCCAGCACTTTGGGAGGCCGAGGCGGGTGGATCACCTGAGGTCAGGGGTTCTAGACCAGCCTGGCCAACATGGTGAAACCCCATCTCTACTAAAAATACAAAAATTAGCTGGGCATGGTGGCAAGTGCCTGTAATCCCAGCTACTCGGGGGGCCAAGGCAGGAGAATTGCTTGAACCCGGGAGGCGGAGGTTGCAATGAGCCAAGATCGTGCCATCGCACTCCAGCCTGGGGAACAAGAGTGAGACTTCATCTCAAAAAAAAA","GGCCGGGCGCGGTGGCTCACGCCTGTAATCCCAGCACTTTGGGAGGCCGAGGCGGGCGGATCACCTGAGGTAAGGAGTTCGAGAACAGCCTGGCCAGCATGGTGAAACCCCATCTCTACTAAAAATACAAAAATTAGCCGGGCATGGTGGCAGGTGCCTGTAATCCCAGCTACTCGGGAGGCTGAGGCAGAAGAATCGCTTGAACCCAGGAGGCGGAGGTTGCAGTGAGCCGAGATTGCGCCATTGCACTCCAGCCTAGGGGAGAAGAGCGAGACTTCGTCTCAAAAAAAAA"
"chr8","104995334","104995641","KN294713v1","906670","906972","35","104088664","GGCTGGGTGCAGTGTCTCACGCCTGTAATCCCAACACTTTGGGAGGCTGAGGTGGGTGGATCACCTGAGGTCAAGAGTTCAAGACCAGCCTGGCCAACATGGTGAAACCCCATCTCTATTGAAAATACCAAAACTAGCCAGGCATGGTGGCAGGCGCACCTGTAATCCCAGCTACTCGGTGGGGGGCTGAGGCAGGAGAATCGCTTGAACTTGGGAGGCAGAGATTTCAGTGAGCCGAGATCACACCATTGCACTCCAGCCTGGGGGACAAGAGTGAGACCTCGTCTCAAAAAAAAAAAAAAAAAAAA","GGCCGGGTGCAGTGGCTCAAGCCTGTACTCCCAGCACTTTGGGAGGCCGAGGCGGGCGGATCACCTGAGGTCGGGAGTTCGAGACCAACCTGGTCAACATGGTGAAACCCCTTCTCTACTAAAAACACAAAAATTAGCCGGTCATGGTGGCAGGTGCCTGTAATCCCAGCTACTCGGGAGGCTGAGGCAGGAGAATCGCTTGAACCCTGGAGGCAGAGATTGCAGTGAGCCGAGATCGCACCATTGCACTCCAGCCTGGGGGACAAGAGTGAGACTTCATCTCAAAAAAAAAAAAAAAAAAAA"
"chr8","105909784","105910079","KN295576v1","406337","406628","34","105503447","GCCAGGTGCGGTGGCTCATGCCTGTAATCCCAGCACTTTGGGAGGCTGAGGCGGGTGGATCACCTGAGGTCAGGATATCGAGACTAGCGTGGCCAACATGGTGAAACCCTGTCTGTACTAAAAATACAAAAATTAGCTGGGCCTGGTGGCAGGTGCCTGTAATCCCAGCTACTCAGGAGGCTGAGGCAGGAGAATCGCTTGAACCCAGCAGGCGGAGGTTGCGGTGAGCCGAGATTGTGCCATTGCATTCCAGCCTGGGGGACAAGAGGGAGATTTCGTCGCCAAAAAAAAGAAAA","GGCCGGGCGCGGTGGCTCACGCCTGTAATCCCAGCACTTTGGGAGGCCGAGGCGGGCGGATCACCTGAGGTAAGGAGTTCGAGAACAGCCTGGCCAGCATGGTGAAACCCCATCTCTACTAAAAATACAAAAATTAGCCGGGCATGGTGGCAGGTGCCTGTAATCCCAGCTACTCGGGAGGCTGAGGCAGAAGAATCGCTTGAACCCAGGAGGCGGAGGTTGCAGTGAGCCGAGATTGCGCCATTGCACTCCAGCCTAGGGGAGAAGAGCGAGACTTCGTCTCAAAAAAAAA"
"chr8","113497969","113498267","KN297112v1","4703110","4703407","32","108794859","GGCTGGGCGCTGTGGCTCACGTCTGTAATCCCAGCACTTTGGGAGGCTGAGGCAGGAGGATCACCTGAGGTCAGGAGTTCGAGACCAGCCAGGCCAACATGGTCAAACCCCCTCTCTACGAAAAATACAAAAATTAGCTGGGTGTGGTGGCAGGCACCTGTAATCCCAGCTACTCGGGAGGCTGAGGCAGGAGAATCACTGGAACCCGGGAGGTGGAGGTTGCAGTGAGCCGAGATCGCGCCATTGCACTCCAGCCTGGGAGACAAGAGTGAGATTTTGCCTCACAAAAAAAAAAAGAA","GGCTGGGTGCGGTGGCTCATGCCTGTAATCCCAGCACTTTGGGAAGCCAAGGCAGGCGGATCACCTGAGGTCAGGAGTTCGAGACCAGCCTGGCCAACATGAAAACCCTGTCTCTACTAAAAATACAAAAATTAGCCGGGTGTGGTGGCAGGCGCCTGTAGTGCCAGCTACAAGGGAGGCTGAGGCAGGAGAATCACTTGAACCCGGGAGGCAGAGGTTGCAGTGAGCCGAGATAGTGCCATTGCACTCCAGCCTGGGGGACAAGAGTGAGACTTTGTCTCAAAAAAAAAAAAAAAAA"
"chr8","119352419","119352555","KN295744v1","576599","576728","32","118775820","GCTCACGCCTGTCATCCCAGCACTTTGGGAAGCCCAGGCAGGTGGATCACCTGAGGTCAGGATTTCCAGACCAGCCTGGCCAACATGGTGAAACCCCGTCTCTACTAAAAGTACAAAAATTAGCCTGGCATGGTGGC","GCTCACGCCTGCAATCCCAGCACTTTGGGAGGCTGAGGCAAGTGGAGAGCCTGAGGTCACTCAGGAGTTCCAGACCAGCCTGGCCATCATGGCAAAACCCTGTCCCTACCAAAAATACAAAAATTAGCTG"
"chr8","119586502","119586798","KN294536v1","1833554","1833849","32","117752948","GGCCGGGCGCGGTGGCTTACGCCTGTAATCCCAACATTTTGGGAGGCTGAGGCAGGTGGATCACCTGAGGTCAGGAGTTCGAGACCAGCCTGGCCAACATGGTGAAGCCCCGTCTCTACTAAAAATACAAAAACTAGCCGGGTGTGGTGGCAGACGCCTGTAATCCCAGCTACTTGGGGGGCTGAGGTAGGATAATCGCTTGAACCCGGGACGCGGACGTGGCAGTGAGCCAAGATCACGCCATCGCACTCCAGCCTGGGGGACAAGAGCGAGACTTCGTCTCACAAAAAAAAAAAA","GGCCGGGCGTGGTGGCTCATGCCTGTAATCCCAGCACTTTGGGAGGCCGAGGCAGGTGGATCACCCGAGGTCAGGAGTTCGAGACCAGCCTGGCCAATATGGTGAAACCCCGTCTCAGCTAAAAATACAAAAATTAGCCGGGCATGGTGGCAGGCACCTGTAATCCCAGCTGCTTGGGGGGGTAGAGGCAGGAGAATCGCTTGAACCCGGGAGGCGGAAGTTGCAGTGAGCTGAGATTGCGCCATCGCACTCCAGCCTGGGGGACAAGAGCGAGACTTTGTCTCAAAAACAAAAAA"
"chr8","122197925","122197975","KN295601v1","571926","571977","6","121625999","CAGCCTGGGGGGCAAGAGTGAGACTCTGTCTCAGAAAAAAAAAAAAAGAAA","CAGCCTGGGGGACAAGAGCGAGACTGTGTCTCAAAAAAAAAAAAAAAAAAAA"
"chr8","122545695","122546026","KN296590v1","153446","153768","47","122392249","GGCCGGGAGTGGTGGCTCACGCCTGTAATCCCAGCACTTTGGGAGGCCAAGGCTGGTGGATCACCTGAGGTTGGGAGTTCGAGACCAGCTTGGCCAACATGGTGAAACCCCTGTCTCTACTAAAAATACAAAAATTAGCCAGGTGTGGTGGCAGGCACCTGTAATCCCAGCTACTTGGGAGGCTGAGGCAGAAGAATTGCTTGAAGCTGGGAGGTGGAGGTTGCAGTGAGCTGAGATAGTGCCATTGCACTCCAGCCTGGGGGACAAGAATGAGACTTCGTCTCAAAATAAATAAATAAATAAATAAATAAATAAATAAATAAATAAATAAA","GCCAAGTGCAGTGGCTCACACCTGTAATCCCAGCACTTTGGGAGGCCGAGGCAGGTGGATCACCTGAGGTCAGGAGTTCGAGACCAGCCAGGCCAACATGGTGAAACCCTGTCTGTACTAAAAATACAAAAATTAGCCAGGTGTGCTGGCAGATGCCTGTAATCTCAGCTACTCAGGAGGTTGAGGCAGGAGAATCACTTGAACCCAGGAGGTGGAGGTTGCAGTGAGCCGAGATCATGCCATTGCACTCCAGCCTGGGGGACAAGAGTGAGACTTAGCCTCAAAAAAAAAAAAAAAAAAAAAAAAAAAAAAAGAAAAGAAAA"
"chr8","122741680","122741983","KN295592v1","1804108","1804419","27","120937572","CCGGGCACAGTGGCTCACGCCTGTAATCCCAGCACTTTGGGAGGCTGAGGTGGATGGATCACCTGAGGTCAGGAGTTCGAGACCAGCCTGGCCAATATGTGAAATCCCATCTCTACTAAAAATACAAAAATTAGCCAGGCATGGTGGCAGGCGCCTGTAATCCCAGCTACTCCAGAGGCTGAGGCAGGAGAATCACTTGAACCCAGGAGGCAGAGGTTGCAGTGAGCTGAGATTGCGCCATTGCACTCCAGCCTGGGGGACAAGAGCGAGACTTCGTCTACAAAAAAAAAAAAAAAAAAACAAA","GCTGGGCACAGTGGCTCACACCTGTAATCCCAGCACTTTGGGAGGCTGAGGTGGGTGGATCACCTGAGGTCAGGAGTTTGAGACCAACCTGGCCAACATGGTGAAACCCCGTCTCTACTAAAAATGCAAAAATTAGCCAGGCATGGTGGCAGGTGCCTGTAATCCCAGCTACTCGAGAGGCTGAGGCCCTGAGGAGAATCACTTGAACCCAGGAGGTGGAGGTTGCAGTGAGCCGAGATTGTGCCATCGCACTCCAGCCTGGGGGACAAGAGCAAGACTTCGTCTCAAAAAAAAAGAAAAAAAAAAAAAAAA"
"chr8","123978717","123979026","KN296847v1","702702","703004","38","123276015","GGCCGGGCATGGTGGCTCACGCCAGTAATCCCAGCACTTTGGGAGGCCAAGGCAGGTGGATCATCTGAGGTGAGGAGTTCTACACCAGCCTGGCCAACATGGTGAAATCCCGTCTCAACTAAAAATACAAAAACTAGCCGGGCGTGGTGGCAGGCACCTGTAATCCCAGCTACTCTGGGGGCCAAGGCAGGAGAATAGCTTGAACCCGGGAGGCAGAGGTTGCAGTGAGTCGAGATTGTGCCATTTGCACTCCAGCCTGGGGACAAGAGCGAGACTTCATCTCAAAAAACAACAACAACAACAACAAAAA","GCTGGGCACGGGGGCTCACGCCTGTAATCCCAGCACTTTGGGAGGCCAAGGCGGGCGGATGACATGAGGTCAGGAGTTGGAGACCAGCCTGGCCAACATGGTGAAACCCCATCTCAACTAAAAATACAAAAGTTAGCCAGGCGTGGTAGCAGGCGCCTGTAATCCCAGCTACTCGGGGGACCAAGGCAGGAGAATCACTTGAACCCGGGAGGCAGAGGTTGCAGTGAGCTGAGATCGTGCCATCGCACTCCAGCCTGGGGGACAAGAGCGAGACTTCATCTCAAAAAAGAAAAAAAAAAAAAA"
"chr8","124285992","124286143","KN296119v1","5485404","5485553","24","118800588","CTGTAATCCCAGCTACTTGAGAGGCTGAAGCAGGAGAATTGCTTCAACCCGGGAGGCGAGGGTTGCAGTGAGCCGAGATTGCACCACTGCACTCCAGCCTGGGGGACAGACAGAGTGAGACTACGTCTAAAAAATAAATAAATAATAAAAAA","CTGTAATCCCAACTACTCGGGAGGCTGAGGCAGGAGAATCGCTTGAACCCGGGAGGCGGAGGTTGCAGTGAGCCGAGATCATGCCATCGCACTCCAGCCTGGGGGACAAGAGTGAGACTTTGTCTCTAAAAAATAAAAAAAAAAAAAAAA"
"chr8","127486915","127487215","KN294685v1","1269570","1269869","32","126217345","GGCCAGGCGCAGTGGCTCACGCCGATAATCCCAGCACTTTGGGAGGCCAAGGTGGGCGGATCACCTGAGGTCAGGAGTTCGAGACCAGCCTGGCAAACATGGTGAAACCCCGTCAATACTAAAAATAAAAAATTAGCCAGGCTTGGTGGCAGCTGCCTGTAATCCCAGCTACTTAGGAGGCTGAGGCAGGAGAATCTCTTGAACCTGGGAGGCGGAGGTTGCAGTGAGCTGAGATTGTGCCGTTGCCCTCCAGCCTGGGGGACAAGAGCAAGACTTTGTCTTAAAAAATAAAAAATAAAAA","GGCTGGGTGTGGTGGCTTAGGCCTGTAATCCCAGCACTTTGGGAGGCCAAGGCGGGCGGATCACCTGAGGTCAGGAGTTCGAGACCAGCCTGGCCAACATGGTGAAACCCCGTCTCTACTAAAAATACAAAAACTAGCCAGGCGTGGTGGCAGGTGACTGTAATCCCAGCTACTCGGGAGGCTGAGGCAGGAGAACTGCTTGAACCTGGGAGGCGGAGGTTGCAGTGAGCTGAGATCACACCATTGCACTCCAGCCTGGGGGACAAGAGCGAGACTTTGTCTCAAAAATAAAAAAAAAAA"
"chr8","130020203","130020495","KN295576v1","406337","406628","40","129613866","GGGTGCAGTGGCTCATGCCTGTAATCCTGGCACTTTCGGAGGCCGAGGCGGGAGAATCACCTCAGGTTAGGAGTTCGAGACCAGCCTGGCCAACATGGTGAAACCCCATCTCTACTAAAAATACAAAAAATTAGCCGGGTGTGGTGGCAGGCGCCTGTAATCCCAGCTACTCGGGAGGCTGAGGAGGGAGAATCACTTGAACCCCGGAAGCGGAGGTTGCAGTGGGCCAAGATCGCGCTGTTGCACTCCAGCCTGGGGGTCAAGAATGAGACTTCGTCTCAGAAAAAAAAGAA","GGCCGGGCGCGGTGGCTCACGCCTGTAATCCCAGCACTTTGGGAGGCCGAGGCGGGCGGATCACCTGAGGTAAGGAGTTCGAGAACAGCCTGGCCAGCATGGTGAAACCCCATCTCTACTAAAAATACAAAAATTAGCCGGGCATGGTGGCAGGTGCCTGTAATCCCAGCTACTCGGGAGGCTGAGGCAGAAGAATCGCTTGAACCCAGGAGGCGGAGGTTGCAGTGAGCCGAGATTGCGCCATTGCACTCCAGCCTAGGGGAGAAGAGCGAGACTTCGTCTCAAAAAAAAA"
"chr8","130987210","130987506","KN297219v1","1714724","1715019","33","129272486","GGCTGGGCACAGTGGCTCACGTCTGTAATCCCAGCATTTTGGAAGGCCGAGGTGGGTGGATCACCTGAGGTCAGGAGATTGAGACCAGCGTGGCCAACGTGGTGAAACCTCGTCTCTATTAAAAAATACAAAAATTAGCTGGATGTGGTGGCAGGAGCCTTAATCCCAGCTATTTGGGAGGCAGAAACAGGAGAATCGTTTGAACCCAGGAGGCGGAGGTTGCAGTGAGCCGAGATCGAGCCATTGCACTCAAACCTGGGGGACAAGAGAAAGACTTCTCTCAAAAAAAAAAAAGAA","GACCGGGCTCAGTGGCTCACCCCTGTAATCCCAGCACTTTGGGAGGCCGAGGTGGGTGGATCACCTGAGGTCAGGAGTTCGAGACCAGCCTGGCCAACATGGTGAAACCCCATCTCTACTAAAAAATACAAAAATTAGCTGTGCGTGGTGGCAGGTGCCTTAATCCCAGCTACTTGGGAGGTAGAGGCAGGAGAATCATTTGAACCCAGGAGGCGGAGGTTGCAGTGAGCTGAGATAAAGCCATGGCACTGAAACCTGGGGGACAAGAGTGAGACTTCTCTAAAAAAAAAAAGAAA"
