"GL873520","7489988","7490268","KN294172v1","3218214","3218512","74","4271774"
"GL873520","8131993","8132246","KN296311v1","2333122","2333358","86","5798871"
"GL873520","8853835","8854065","KN296311v1","6101023","6101248","64","2752812"
"GL873520","16596997","16597184","KN295470v1","159590","159792","55","16437407"
"GL873520","16847826","16847897","KN294987v1","1026695","1026764","27","15821131"
"GL873520","38237631","38237778","KN294172v1","5059298","5059433","66","33178333"
"GL873520","72354068","72354262","KN295382v1","97899","98046","76","72256169"
"GL873521","49703433","49703583","KN295814v1","1373982","1374172","71","48329451"
"GL873522","17190838","17190909","KN295405v1","1364140","1364215","35","15826698"
"GL873522","18949996","18950263","KN296316v1","271676","271950","72","18678320"
"GL873522","21880926","21881030","KN295586v1","5261133","5261236","51","16619793"
"GL873522","26201385","26201642","KN295692v1","1120565","1120818","69","25080820"
"GL873522","26521457","26521490","KN297171v1","1725901","1725923","21","24795556"
"GL873522","30683380","30683567","KN296096v1","2800534","2800728","41","27882846"
"GL873522","35223034","35223273","KN296157v1","1494567","1494796","85","33728467"
"GL873522","37580330","37580631","KN297171v1","3471158","3471448","73","34109172"
"GL873522","42736210","42736394","KN296096v1","2800534","2800728","47","39935676"
"GL873522","45976396","45976452","KN296460v1","553975","554044","21","45422421"
"GL873522","48192652","48192792","KN297050v1","164145","164289","43","48028507"
"GL873523","19563020","19563143","KN297165v1","1771402","1771491","58","17791618"
"GL873523","39754581","39754684","KN296453v1","2052470","2052583","38","37702111"
"GL873524","345354","345612","KN294269v1","212726","212968","82","132628"
"GL873524","2088138","2088352","KN295719v1","80888","81109","58","2007250"
"GL873524","6347256","6347510","KN295114v1","266983","267272","90","6080273"
"GL873524","10848919","10849112","KN297112v1","4317939","4318140","51","6530980"
"GL873524","29607833","29608022","KN297112v1","4317939","4318140","70","25289894"
"GL873524","33944116","33944420","KN294457v1","1033882","1034178","77","32910234"
"GL873525","31143447","31143518","KN296460v1","553975","554044","24","30589472"
"GL873525","33430256","33430498","KN294893v1","211464","211725","76","33218792"
"GL873525","34531305","34531387","KN296535v1","196398","196479","37","34334907"
"GL873525","43915068","43915173","KN294326v1","227751","227868","39","43687317"
"GL873525","46227365","46227650","KN294728v1","1488403","1488700","81","44738962"
"GL873526","17556482","17556773","KN294456v1","459090","459384","68","17097392"
"GL873526","19543723","19543967","KN294506v1","213538","213814","68","19330185"
"GL873526","36392450","36392631","KN294372v1","2496139","2496338","68","33896311"
"GL873526","42317454","42317742","KN294571v1","970270","970566","64","41347184"
"GL873527","11051370","11051492","KN295430v1","2513892","2514025","29","8537478"
"GL873527","13381009","13381103","KN295991v1","524384","524473","34","12856625"
"GL873527","15370644","15370918","KN294806v1","722221","722511","63","14648423"
"GL873527","16447840","16448018","KN296096v1","2800534","2800728","58","13647306"
"GL873528","4306842","4306931","KN294199v1","568120","568207","30","3738722"
"GL873528","34525266","34525448","KN294978v1","259085","259266","59","34266181"
"GL873529","23997741","23997902","KN295382v1","97899","98046","60","23899842"
"GL873529","27714768","27714917","KN294172v1","5059298","5059433","51","22655470"
"GL873529","32507576","32507645","KN294987v1","1026695","1026764","30","31480881"
"GL873529","37854992","37855128","KN296995v1","173126","173284","61","37681866"
"GL873530","12380984","12381243","KN295666v1","1170217","1170493","80","11210767"
"GL873530","14765727","14765966","KN294893v1","211464","211725","70","14554263"
"GL873530","15806451","15806526","KN294987v1","1026695","1026764","40","14779756"
"GL873530","16359883","16360084","KN295893v1","5252826","5253032","52","11107057"
"GL873530","16721033","16721315","KN294365v1","1372973","1373267","78","15348060"
"GL873530","17623386","17623511","KN294262v1","1921271","1921353","64","15702115"
"GL873530","17700495","17700798","KN295828v1","1201309","1201607","80","16499186"
"GL873530","23865502","23865784","KN294520v1","125422","125706","69","23740080"
"GL873530","23907664","23907946","KN294911v1","2226951","2227239","75","21680713"
"GL873530","31670866","31671169","KN294786v1","182790","183093","69","31488076"
"GL873531","6726470","6726688","KN296311v1","6101023","6101248","60","625447"
"GL873531","24609845","24610048","KN297452v1","2979923","2980134","59","21629922"
"GL873532","1808872","1809016","KN295758v1","1129768","1129907","40","679104"
"GL873532","6115844","6116031","KN296096v1","2800534","2800728","53","3315310"
"GL873532","6280631","6280885","KN296316v1","271676","271950","79","6008955"
"GL873532","12809140","12809434","KN297112v1","912671","912966","73","11896469"
"GL873533","3797480","3797642","KN296096v1","2800534","2800728","59","996946"
"GL873533","25995329","25995634","KN294728v1","1488403","1488700","83","24506926"
"GL873533","26042395","26042570","KN296096v1","2800534","2800728","59","23241861"
"GL873533","29478972","29479178","KN295962v1","978438","978640","55","28500534"
"GL873533","30098732","30098984","KN296316v1","271676","271950","82","29827056"
"GL873534","5689423","5689556","KN296065v1","333834","333942","65","5355589"
"GL873534","15344805","15345078","KN294172v1","6850902","6851192","72","8493903"
"GL873534","19866169","19866439","KN295054v1","304289","304568","94","19561880"
"GL873534","22652800","22653077","KN294728v1","626248","626527","79","22026552"
"GL873535","1834780","1835024","KN294601v1","120241","120491","87","1714539"
"GL873535","6705072","6705258","KN296096v1","2800534","2800728","75","3904538"
"GL873536","2125249","2125353","KN296535v1","196398","196479","52","1928851"
"GL873536","13317700","13317973","KN294462v1","169569","169850","73","13148131"
"GL873536","16907950","16908199","KN295692v1","1120565","1120818","65","15787385"
"GL873537","1251312","1251470","KN295382v1","97899","98046","57","1153413"
"GL873537","1348046","1348155","KN296154v1","97828","97949","45","1250218"
"GL873537","1382643","1382736","KN296535v1","196398","196479","38","1186245"
"GL873537","1382817","1383047","KN297008v1","717175","717402","71","665642"
"GL873537","4087025","4087310","KN296528v1","1463321","1463614","73","2623704"
"GL873537","9519333","9519598","KN294571v1","1274621","1274897","75","8244712"
"GL873537","23596313","23596474","KN297050v1","164145","164289","61","23432168"
"GL873537","25134685","25134766","KN294444v1","7147","7219","31","25127538"
"GL873537","26317266","26317547","KN295382v1","200890","201172","71","26116376"
"GL873538","14658936","14659027","KN295991v1","524384","524473","34","14134552"
"GL873538","16642518","16642688","KN295470v1","159590","159792","56","16482928"
"GL873538","17559958","17560224","KN296191v1","54041","54327","71","17505917"
"GL873539","19089903","19090175","KN296281v1","2085","2367","90","19087818"
"GL873540","9147847","9148120","KN294777v1","614268","614527","90","8533579"
"GL873540","20304053","20304209","KN294372v1","1764604","1764757","47","18539449"
"GL873541","6100322","6100398","KN295405v1","1364140","1364215","37","4736182"
"GL873541","14455190","14455470","KN295814v1","559641","559932","78","13895549"
"GL873542","3462872","3463146","KN294365v1","787099","787386","79","2675773"
"GL873542","14980136","14980187","KN295507v1","327","368","27","14979809"
"GL873542","19450808","19450929","KN294833v1","300393","300498","40","19150415"
"GL873543","2484309","2484434","KN296646v1","387305","387429","27","2097004"
"GL873544","10029114","10029318","KN296424v1","31817","32042","63","9997297"
"GL873544","10521733","10521784","KN294922v1","722538","722570","25","9799195"
"GL873544","10522057","10522246","KN296096v1","2800534","2800728","50","7721523"
"GL873544","11410495","11410643","KN294172v1","6039316","6039440","62","5371179"
"GL873544","11982092","11982195","KN294262v1","1921271","1921353","52","10060821"
"GL873544","13178446","13178700","KN296795v1","1084349","1084609","77","12094097"
"GL873544","14772843","14773165","KN294147v1","1733826","1734121","96","13039017"
"GL873544","14828949","14829027","KN294987v1","1026695","1026764","38","13802254"
"GL873544","17008997","17009163","KN294172v1","6039316","6039440","69","10969681"
"GL873545","4617382","4617543","KN296096v1","2800534","2800728","65","1816848"
"GL873546","84798","84875","KN296535v1","196398","196479","35","111600"
"GL873546","109143","109426","KN296157v1","4058627","4058923","73","3949484"
"GL873546","18197318","18197484","KN296096v1","2800534","2800728","65","15396784"
"GL873547","1919975","1920243","KN295666v1","494053","494320","90","1425922"
"GL873547","2834960","2835226","KN297327v1","789781","790062","79","2045179"
"GL873547","4041231","4041431","KN295893v1","5252826","5253032","56","1211595"
"GL873547","5801729","5801953","KN296783v1","545840","546072","80","5255889"
"GL873547","6132160","6132273","KN294326v1","227751","227868","47","5904409"
"GL873547","8457529","8457696","KN297050v1","164145","164289","65","8293384"
"GL873548","3550276","3550555","KN295701v1","591677","591947","66","2958599"
"GL873548","8140876","8141134","KN294980v1","431203","431455","73","7709673"
"GL873548","10939449","10939547","KN295991v1","524384","524473","34","10415065"
"GL873548","12693139","12693365","KN295984v1","1673843","1674088","84","11019296"
"GL873548","13738580","13738762","KN297112v1","4317939","4318140","47","9420641"
"GL873548","14354423","14354585","KN294592v1","1109099","1109242","65","13245324"
"GL873549","3898231","3898408","KN297219v1","1457437","1457623","61","2440794"
"GL873549","15367998","15368257","KN294893v1","211464","211725","72","15156534"
"GL873550","6873561","6873745","KN295962v1","978438","978640","51","5895123"
"GL873550","13304370","13304634","KN295814v1","559641","559932","80","12744729"
"GL873550","13892848","13893112","KN294842v1","903469","903743","74","12989379"
"GL873551","14050130","14050240","KN297376v1","5674","5756","56","14044456"
"GL873553","104640","104922","KN294777v1","614268","614527","87","509628"
"GL873553","2756935","2757091","KN294458v1","204176","204302","60","2552759"
"GL873553","15984346","15984613","KN294619v1","1569569","1569865","75","14414777"
"GL873554","1943139","1943330","KN296844v1","1000001","1000198","45","943138"
"GL873555","3493906","3494194","KN297044v1","522632","522921","76","2971274"
"GL873555","4001675","4001811","KN295099v1","648951","649083","44","3352724"
"GL873555","12056540","12056814","KN295984v1","1609334","1609626","88","10447206"
"GL873556","7430215","7430298","KN296535v1","196398","196479","37","7233817"
"GL873556","10815628","10815834","KN296153v1","3998111","3998295","65","6817517"
"GL873557","5314967","5315226","KN294647v1","109328","109583","70","5205639"
"GL873557","11295125","11295315","KN297112v1","4317939","4318140","47","6977186"
"GL873558","6486602","6486892","KN294911v1","4602628","4602917","69","1883974"
"GL873558","6927930","6928189","KN294777v1","614268","614527","82","6313662"
"GL873558","14180460","14180628","KN294458v1","441006","441179","72","13739454"
"GL873559","4269392","4269507","KN295601v1","1374484","1374615","50","2894908"
"GL873559","4843492","4843754","KN294647v1","109328","109583","84","4734164"
"GL873559","7603655","7603904","KN295586v1","1202963","1203220","83","6400692"
"GL873560","3477714","3477883","KN296844v1","1000001","1000198","68","2477713"
"GL873561","12084704","12084991","KN294217v1","2153754","2154051","77","9930950"
"GL873562","2677271","2677562","KN295736v1","698711","699010","78","1978560"
"GL873562","9007888","9008166","KN295236v1","1658492","1658781","64","7349396"
"GL873563","2115926","2115994","KN294987v1","1026695","1026764","27","1089231"
"GL873564","11547764","11547980","KN294325v1","106765","106990","60","11440999"
"GL873565","2462337","2462457","KN295039v1","529449","529544","58","1932888"
"GL873565","3080146","3080217","KN294987v1","1026695","1026764","38","2053451"
"GL873565","5469198","5469446","KN294733v1","335702","335968","72","5133496"
"GL873565","11726298","11726410","KN294326v1","227751","227868","28","11498547"
"GL873565","12758694","12758824","KN295430v1","2513892","2514025","33","10244802"
"GL873566","9002138","9002296","KN297050v1","164145","164289","58","8837993"
"GL873567","3637635","3637913","KN294199v1","313907","314195","75","3323728"
"GL873567","9468949","9469216","KN294777v1","614268","614527","83","8854681"
"GL873567","10160455","10160575","KN295430v1","2513892","2514025","39","7646563"
"GL873570","1304256","1304351","KN294262v1","1921271","1921353","47","617015"
"GL873570","2329541","2329765","KN295893v1","5252826","5253032","63","2923285"
"GL873571","3100359","3100642","KN294728v1","1488403","1488700","70","1611956"
"GL873571","4425700","4425855","KN295382v1","97899","98046","67","4327801"
"GL873574","4346296","4346400","KN294326v1","227751","227868","32","4118545"
"GL873574","6479179","6479274","KN295991v1","524384","524473","35","5954795"
"GL873574","11478251","11478342","KN295991v1","524384","524473","35","10953867"
"GL873576","1822136","1822269","KN294803v1","209180","209308","40","1612956"
"GL873576","1822357","1822458","KN296460v1","553975","554044","48","1268382"
"GL873576","5304240","5304511","KN295666v1","494053","494320","79","4810187"
"GL873576","9095586","9095680","KN295433v1","2310958","2311039","47","6784628"
"GL873576","10428308","10428472","KN297050v1","164145","164289","58","10264163"
"GL873576","10887298","10887384","KN296535v1","196398","196479","33","10690900"
"GL873577","9841398","9841578","KN296096v1","2800534","2800728","46","7040864"
"GL873578","5335239","5335311","KN294987v1","1026695","1026764","38","4308544"
"GL873578","6915712","6915866","KN294803v1","209180","209308","63","6706532"
"GL873579","593567","593832","KN294893v1","211464","211725","80","382103"
"GL873579","7140710","7140974","KN294571v1","970270","970566","76","6170440"
"GL873579","10759654","10759766","KN294262v1","1921271","1921353","59","8838383"
"GL873580","2558015","2558276","KN296609v1","1759337","1759601","74","798678"
"GL873580","11040033","11040198","KN294172v1","5059298","5059433","62","5980735"
"GL873581","1006125","1006276","KN296995v1","173126","173284","62","832999"
"GL873581","7207153","7207245","KN295405v1","1525125","1525226","31","5682028"
"GL873581","10974888","10975023","KN296995v1","173126","173284","47","10801762"
"GL873584","2352152","2352408","KN294269v1","212726","212968","73","2139426"
"GL873584","7437089","7437434","KN294693v1","431185","431508","99","7005904"
"GL873586","21275","21479","KN294516v1","22535","22736","59","1260"
"GL873586","643733","643902","KN296096v1","2800534","2800728","59","2156801"
"GL873588","83289","83465","KN296096v1","2800534","2800728","54","2717245"
"GL873589","9475981","9476251","KN295236v1","1658492","1658781","68","7817489"
"GL873590","132637","132762","KN297227v1","829959","830092","30","697322"
"GL873590","4038284","4038457","KN295430v1","2513892","2514025","65","1524392"
"GL873591","6016670","6016752","KN294987v1","1026695","1026764","35","4989975"
"GL873592","2223520","2223785","KN296905v1","206534","206772","90","2016986"
"GL873592","6869543","6869742","KN296096v1","2800534","2800728","44","4069009"
"GL873592","7730505","7730680","KN296844v1","1000001","1000198","62","6730504"
"GL873592","8952808","8953052","KN294207v1","33183","33423","75","8919625"
"GL873596","2331594","2331871","KN297219v1","1760120","1760401","74","571474"
"GL873597","1263072","1263354","KN294217v1","2153754","2154051","77","890682"
"GL873598","3636628","3636857","KN296883v1","711659","711911","79","2924969"
"GL873600","1711621","1711722","KN295991v1","524384","524473","44","1187237"
"GL873601","923302","923481","KN295470v1","159590","159792","60","763712"
"GL873601","8711088","8711340","KN294893v1","211464","211725","74","8499624"
"GL873602","2972759","2972970","KN297112v1","4317939","4318140","63","1345180"
"GL873602","7160174","7160336","KN295459v1","666163","666359","67","6494011"
"GL873602","8020148","8020344","KN294703v1","59072","59280","61","7961076"
"GL873603","7543347","7543509","KN296844v1","1000001","1000198","71","6543346"
"GL873606","5053182","5053336","KN295820v1","797220","797367","40","4255962"
"GL873608","4219712","4220007","KN296528v1","1463321","1463614","63","2756391"
"GL873610","4411176","4411378","KN294385v1","358774","358972","55","4052402"
"GL873611","905793","905912","KN297046v1","3132878","3133012","35","2227085"
"GL873611","6719617","6719787","KN296096v1","2800534","2800728","60","3919083"
"GL873612","6112165","6112329","KN294158v1","161458","161609","46","5950707"
"GL873615","5650986","5651185","KN296096v1","2800534","2800728","57","2850452"
"GL873615","7837743","7838002","KN296538v1","856776","857053","71","6980967"
"GL873618","2637433","2637675","KN295825v1","1433718","1433951","72","1203715"
"GL873620","3899444","3899732","KN294668v1","2236792","2237085","71","1662652"
"GL873621","3460608","3460874","KN295701v1","591677","591947","73","2868931"
"GL873622","2044422","2044494","KN295507v1","327","368","38","2044095"
"GL873624","3443381","3443663","KN297163v1","306305","306585","85","3137076"
"GL873624","7455659","7455932","KN294633v1","177912","178198","69","7277747"
"GL873627","5383286","5383547","KN294266v1","372606","372877","75","5010680"
"GL873631","892525","892701","KN296096v1","2800534","2800728","62","1908009"
"GL873631","2419713","2419947","KN294911v1","3836485","3836687","84","1416772"
"GL873631","6436886","6437178","KN296508v1","953107","953401","73","5483779"
"GL873634","1340311","1340485","KN296096v1","2800534","2800728","65","1460223"
"GL873634","2464745","2464870","KN294172v1","6039316","6039440","43","3574571"
"GL873639","3640061","3640254","KN296096v1","2800534","2800728","55","839527"
"GL873640","2592714","2592889","KN296096v1","2800534","2800728","52","207820"
"GL873640","3796305","3796576","KN294571v1","1274621","1274897","62","2521684"
"GL873640","6211864","6212063","KN296096v1","2800534","2800728","67","3411330"
"GL873643","1634822","1634923","KN297376v1","5674","5756","51","1629148"
"GL873645","2612089","2612279","KN297112v1","4317939","4318140","44","1705850"
"GL873646","1732390","1732597","KN295346v1","1461326","1461545","69","271064"
"GL873646","3150363","3150463","KN294326v1","227751","227868","41","2922612"
"GL873646","4411077","4411183","KN295039v1","529449","529544","52","3881628"
"GL873653","1841910","1842023","KN294326v1","227751","227868","32","1614159"
"GL873654","2339624","2339800","KN296096v1","2800534","2800728","65","460910"
"GL873654","4663353","4663662","KN294758v1","2283484","2283779","85","2379869"
"GL873655","761785","761945","KN295382v1","97899","98046","55","663886"
"GL873656","5197183","5197480","KN296201v1","133417","133711","63","5063766"
"GL873658","4135378","4135555","KN296096v1","2800534","2800728","53","1334844"
"GL873662","776467","776596","KN296874v1","253757","253882","30","522710"
"GL873665","417202","417300","KN295991v1","524384","524473","35","107182"
"GL873667","3283759","3284041","KN296528v1","135325","135618","81","3148434"
"GL873668","1453602","1453895","KN294456v1","607761","608051","85","845841"
"GL873669","41829","41958","KN295430v1","2513892","2514025","33","2472063"
"GL873671","289729","289823","KN296311v1","3283157","3283228","48","2993428"
"GL873671","2934266","2934464","KN294856v1","31301","31512","64","2902965"
"GL873671","4199230","4199496","KN295394v1","596701","596983","72","3602529"
"GL873675","155653","155874","KN294325v1","106765","106990","65","48888"
"GL873677","3270876","3271009","KN294803v1","209180","209308","35","3061696"
"GL873677","3271210","3271294","KN296535v1","196398","196479","30","3074812"
"GL873678","177026","177199","KN296844v1","1000001","1000198","58","822975"
"GL873678","724801","724880","KN295405v1","1364140","1364215","41","639339"
"GL873682","1826051","1826172","KN296365v1","692146","692265","62","1133905"
"GL873682","3168258","3168511","KN295586v1","1951282","1951553","71","1216976"
"GL873687","1366787","1367032","KN294987v1","1066292","1066527","78","300495"
"GL873691","1072534","1072718","KN296096v1","2800534","2800728","60","1728000"
"GL873693","250931","251150","KN296424v1","31817","32042","57","219114"
"GL873693","1745965","1746222","KN295708v1","2856800","2857078","80","1110835"
"GL873698","150915","151124","KN296311v1","6101023","6101248","71","5950108"
"GL873698","788802","788873","KN294987v1","1026695","1026764","31","237893"
"GL873700","2201833","2202041","KN296311v1","9766033","9766237","62","7564200"
"GL873702","1833026","1833170","KN294172v1","6039316","6039440","49","4206290"
"GL873704","2664535","2664735","KN295470v1","159590","159792","64","2504945"
"GL873704","2708432","2708575","KN295346v1","2064905","2065048","48","643527"
"GL873708","625394","625508","KN296110v1","103757","103865","41","521637"
"GL873708","1036392","1036652","KN294506v1","213538","213814","77","822854"
"GL873708","2099523","2099830","KN295571v1","28918","29194","92","2070605"
"GL873710","730421","730716","KN297165v1","4193865","4194157","82","3463444"
"GL873711","135656","135732","KN296460v1","553975","554044","29","418319"
"GL873713","817827","817996","KN295382v1","97899","98046","55","719928"
"GL873723","93431","93506","KN296460v1","553975","554044","38","460544"
"GL873723","94049","94267","KN296311v1","6101023","6101248","58","6006974"
"GL873724","104916","105078","KN295637v1","1","154","51","104915"
"GL873728","615679","615792","KN296879v1","45858","45968","38","569821"
"GL873730","956231","956521","KN295022v1","639782","640076","72","316449"
"GL873730","1821952","1822131","KN296096v1","2800534","2800728","55","978582"
"GL873731","1598121","1598424","KN294831v1","133664","133963","86","1464457"
"GL873737","545360","545485","KN295601v1","1374484","1374615","32","829124"
"GL873739","1495328","1495592","KN294767v1","1107916","1108203","74","387412"
"GL873739","1960856","1961014","KN296516v1","89996","90118","64","1870860"
"GL873740","1","173","KN296096v1","2800534","2800728","53","2800533"
"GL873743","1601811","1601903","KN296535v1","196398","196479","39","1405413"
"GL873749","1959317","1959432","KN294326v1","227751","227868","33","1731566"
"GL873763","1643208","1643376","KN296096v1","2800534","2800728","68","1157326"
"GL873772","1467825","1467987","KN297168v1","1336930","1337078","74","130895"
"GL873774","606854","607036","KN296096v1","2800534","2800728","59","2193680"
"GL873777","1211264","1211537","KN297274v1","282578","282865","80","928686"
"GL873795","561769","561952","KN295940v1","592331","592535","55","30562"
"GL873827","102192","102500","KN295601v1","2743110","2743407","73","2640918"
"GL873835","456031","456233","KN297203v1","1257191","1257407","79","801160"
"GL873844","250002","250080","KN296535v1","196398","196479","31","53604"
"GL873888","63178","63332","KN296995v1","173126","173284","55","109948"
"GL873888","134089","134261","KN295459v1","666163","666359","59","532074"
"GL873912","68441","68716","KN294922v1","344412","344701","85","275971"
"GL874350","5446","5571","KN295430v1","2513892","2514025","30","2508446"
"AAQR03197457","405","689","KN294207v1","858213","858475","80","857808"
"AAQR03197458","618","902","KN294207v1","858213","858475","80","857595"
