"GL873520","2729980","2730055","chr20","32318273","32318348","17","29588293"
"GL873520","5968827","5968901","chr16","18835970","18836039","23","12867143"
"GL873520","7106784","7106925","chr2","46295482","46295626","36","39188698"
"GL873520","7153894","7153979","chr3","124578098","124578181","19","117424204"
"GL873520","16086841","16086886","chr5","103740127","103740167","14","87653286"
"GL873520","16087342","16087542","chr5","163364789","163364960","68","147277447"
"GL873520","16780664","16780902","chr7","119902668","119902896","76","103122004"
"GL873520","16835471","16835553","chr5","19876919","19877003","28","3041448"
"GL873520","18244868","18244970","chr11","81032677","81032773","30","62787809"
"GL873520","24570388","24570471","chr3","149909965","149910046","14","125339577"
"GL873520","26001724","26001799","chr2","39515156","39515228","19","13513432"
"GL873520","27613025","27613160","chr1","208531450","208531566","33","180918425"
"GL873520","30075665","30075747","chr5","141438168","141438255","21","111362503"
"GL873520","30148065","30148234","chr7","38963913","38964065","54","8815848"
"GL873520","30148472","30148605","chr1","3418869","3419004","28","26729603"
"GL873520","30307592","30307720","chr12","16056959","16057079","40","14250633"
"GL873520","30307997","30308122","chr10","47279500","47279627","29","16971503"
"GL873520","30644293","30644346","chr1","171169445","171169503","15","140525152"
"GL873520","30644626","30644756","chr2","77484961","77485093","24","46840335"
"GL873520","34668521","34668671","chr2","135453469","135453615","54","100784948"
"GL873520","38507269","38507342","chr9","66040180","66040254","22","27532911"
"GL873520","38852134","38852145","chr1","33382389","33382399","3","5469745"
"GL873520","41660608","41660744","chr19","15128773","15128907","41","26531835"
"GL873520","41660769","41660840","chr2","86329384","86329447","17","44668615"
"GL873520","42050182","42050509","chr17","11331660","11331984","63","30718522"
"GL873520","45601445","45601581","chrX","37449589","37449724","28","8151856"
"GL873520","45601862","45602016","chrX","38622568","38622728","38","6979294"
"GL873520","46131934","46132083","chr4","23025408","23025568","41","23106526"
"GL873520","46132356","46132368","chr1","48820534","48820547","3","2688178"
"GL873520","46132640","46132770","chr1","196368869","196369003","30","150236229"
"GL873520","46902414","46902720","chr2","62660674","62660972","70","15758260"
"GL873520","47083028","47083197","chr1","207342485","207342660","39","160259457"
"GL873520","47083462","47083591","chr1","37730371","37730504","28","9353091"
"GL873520","59071253","59071388","chr1","208531450","208531566","31","149460197"
"GL873520","59570747","59570861","chr3","153390235","153390362","36","93819488"
"GL873520","60111723","60111855","chr10","62076284","62076420","30","1964561"
"GL873520","60112135","60112295","chr12","41793319","41793490","46","18318816"
"GL873520","60873051","60873186","chr8","38259041","38259158","34","22614010"
"GL873520","60937777","60937881","chr13","33447796","33447901","35","27489981"
"GL873520","60938156","60938286","chr19","31654475","31654609","29","29283681"
"GL873520","61773762","61773989","chr11","31227332","31227554","68","30546430"
"GL873520","72645184","72645308","chr19","10038658","10038788","30","62606526"
"GL873520","72645574","72645744","chr6","64849282","64849454","37","7796292"
"GL873520","72695562","72695678","chr1","165451615","165451728","40","92756053"
"GL873520","72695921","72696036","chr11","8097298","8097411","36","64598623"
"GL873521","191316","191395","chr13","8729504","8729591","21","8538188"
"GL873521","7177375","7177437","chr12","78492952","78493012","20","71315577"
"GL873521","9203628","9203782","chr5","72163077","72163236","44","62959449"
"GL873521","11822781","11822898","chr13","44944402","44944525","23","33121621"
"GL873521","11822924","11823077","chr8","119455009","119455164","37","107632085"
"GL873521","13369663","13369934","chr17","17957480","17957744","72","4587817"
"GL873521","20362154","20362268","chr19","6398044","6398141","34","13964110"
"GL873521","24809417","24809578","chr13","69324787","69324947","31","44515370"
"GL873521","26087028","26087176","chr9","94600372","94600507","40","68513344"
"GL873521","26993909","26994076","chr16","4602123","4602292","46","22391786"
"GL873521","26994349","26994493","chr5","141241942","141242082","32","114247593"
"GL873521","30956694","30956803","chr1","42514790","42514895","22","11558096"
"GL873521","32095514","32095619","chr20","70280691","70280792","25","38185177"
"GL873521","32095879","32096085","chr18","18326117","18326332","49","13769762"
"GL873521","32862348","32862502","chr3","152014235","152014379","43","119151887"
"GL873521","33221660","33221761","chr13","43779330","43779425","34","10557670"
"GL873521","35279514","35279565","chr1","137960943","137960997","14","102681429"
"GL873521","39317755","39317840","chr3","46805844","46805931","21","7488089"
"GL873521","40487814","40487991","chr13","64331554","64331733","55","23843740"
"GL873521","40568769","40568851","chr20","27168040","27168110","23","13400729"
"GL873521","40943306","40943379","chr13","85279206","85279291","28","44335900"
"GL873521","40943637","40943827","chr9","56348285","56348486","46","15404648"
"GL873521","40966652","40966987","chr5","108654494","108654828","89","67687842"
"GL873521","40995184","40995245","chr5","114089167","114089234","17","73093983"
"GL873521","42278447","42278594","chr12","59745895","59746043","33","17467448"
"GL873521","42528529","42528702","chr16","66567135","66567314","50","24038606"
"GL873521","48647935","48648019","chr1","141965348","141965426","18","93317413"
"GL873521","48808639","48808706","chr11","94397394","94397462","9","45588755"
"GL873521","49619898","49620034","chr1","58595999","58596133","47","8976101"
"GL873521","53893742","53893910","chr1","143904908","143905076","52","90011166"
"GL873522","4768533","4768615","chr3","173718716","173718798","14","168950183"
"GL873522","8149679","8149740","chr1","13843872","13843931","18","5694193"
"GL873522","8494222","8494296","chr10","81294606","81294684","12","72800384"
"GL873522","9272209","9272424","chr8","118423437","118423654","66","109151228"
"GL873522","9272655","9272798","chr4","92545650","92545792","35","83272995"
"GL873522","16505754","16505850","chr14","83920628","83920730","39","67414874"
"GL873522","20051315","20051399","chr4","98971266","98971347","27","78919951"
"GL873522","25501946","25502038","chr13","25012817","25012904","15","489129"
"GL873522","29582573","29582741","chrX","45737088","45737257","44","16154515"
"GL873522","29582997","29583112","chr9","67737861","67737973","27","38154864"
"GL873522","30103184","30103363","chr7","46538920","46539093","41","16435736"
"GL873522","30103671","30103698","chr1","2326407","2326435","8","27777264"
"GL873522","33580185","33580447","chr1","128964135","128964379","86","95383950"
"GL873522","36171113","36171213","chr15","95839562","95839664","20","59668449"
"GL873522","36171238","36171260","chr3","41850714","41850736","4","5679476"
"GL873522","36582699","36582803","chr4","78564212","78564313","29","41981513"
"GL873522","37187319","37187491","chr3","112944446","112944603","52","75757127"
"GL873522","37803968","37804051","chr20","56906983","56907065","26","19103015"
"GL873522","37804145","37804333","chr20","52523392","52523584","59","14719247"
"GL873522","37849246","37849377","chr7","63697870","63697995","34","25848624"
"GL873522","37849629","37849779","chr11","61637357","61637512","38","23787728"
"GL873522","38000004","38000142","chr15","77604259","77604382","39","39604255"
"GL873522","41126747","41126758","chr2","136447622","136447632","1","95320875"
"GL873522","41126853","41127134","chr10","36156170","36156448","77","4970683"
"GL873522","42701141","42701202","chr11","46824532","46824594","19","4123391"
"GL873522","43241133","43241220","chr13","127622562","127622652","19","84381429"
"GL873522","47072367","47072485","chr3","44532545","44532655","32","2539822"
"GL873522","48077685","48077781","chr19","7565965","7566059","17","40511720"
"GL873522","48191755","48191802","chr10","14255232","14255276","11","33936523"
"GL873522","48192074","48192326","chr18","5958901","5959152","72","42233173"
"GL873523","3332385","3332501","chr10","10493615","10493731","34","7161230"
"GL873523","3332735","3332919","chr3","124991237","124991427","57","121658502"
"GL873523","4356096","4356383","chr3","178489885","178490172","82","174133789"
"GL873523","4356472","4356489","chr2","111605825","111605842","1","107249353"
"GL873523","4429580","4429699","chr8","38259041","38259158","23","33829461"
"GL873523","6833811","6834029","chr9","92251728","92251951","61","85417917"
"GL873523","16315626","16315707","chrX","112357581","112357648","26","96041955"
"GL873523","21241172","21241220","chr7","117063833","117063872","13","95822661"
"GL873523","23105539","23105822","chr4","106849398","106849688","69","83743859"
"GL873523","23426950","23427021","chr11","59861831","59861903","19","36434881"
"GL873523","23442184","23442405","chr1","15934811","15935009","58","7507373"
"GL873523","23442682","23442693","chr3","49538219","49538230","4","26095537"
"GL873523","25683169","25683273","chr2","87773241","87773357","40","62090072"
"GL873523","31106298","31106393","chr8","91413604","91413700","27","60307306"
"GL873523","33422418","33422694","chr3","134067176","134067440","86","100644758"
"GL873523","33763875","33763989","chr9","31577725","31577843","31","2186150"
"GL873523","33764059","33764211","chr11","121214829","121214984","48","87450770"
"GL873523","39364711","39364764","chrX","121806058","121806114","12","82441347"
"GL873523","39442533","39442600","chr20","3704103","3704176","22","35738430"
"GL873523","43190599","43190734","chr1","208531450","208531566","36","165340851"
"GL873523","44268333","44268467","chr11","83880333","83880448","33","39612000"
"GL873523","45183435","45183549","chr1","15652218","15652329","37","29531217"
"GL873524","1197676","1197886","chr16","23533521","23533730","42","22335845"
"GL873524","1198172","1198271","chr14","112158830","112158925","32","110960658"
"GL873524","3058899","3058993","chr7","35751587","35751677","29","32692688"
"GL873524","3866907","3866975","chr10","81942990","81943055","15","78076083"
"GL873524","5893886","5893982","chr3","55187598","55187680","28","49293712"
"GL873524","8037528","8037603","chr14","11672602","11672686","19","3635074"
"GL873524","11279444","11279613","chr15","9399664","9399834","51","1879780"
"GL873524","11279653","11279773","chr12","52406370","52406486","27","41126717"
"GL873524","11628587","11628862","chr2","73023124","73023405","73","61394537"
"GL873524","16511392","16511466","chr2","186811512","186811585","23","170300120"
"GL873524","16511549","16511623","chr2","186811512","186811585","23","170299963"
"GL873524","19863637","19863772","chr1","208531450","208531566","32","188667813"
"GL873524","21542225","21542241","chr7","87750501","87750518","7","66208276"
"GL873524","22965091","22965163","chr10","497805","497873","18","22467286"
"GL873524","28836605","28836679","chr5","126575478","126575560","22","97738873"
"GL873524","29806789","29806882","chr3","173718716","173718798","26","143911927"
"GL873524","40351122","40351310","chr13","9472864","9473032","59","30878258"
"GL873524","43462775","43462937","chr7","51761202","51761364","41","8298427"
"GL873524","43463213","43463338","chr19","1840574","1840705","33","41622639"
"GL873524","45132804","45133101","chr19","470584","470892","75","44662220"
"GL873525","5326525","5326637","chr5","33071238","33071357","33","27744713"
"GL873525","5326686","5326859","chr1","121734178","121734344","54","116407492"
"GL873525","7531820","7531915","chr20","52103023","52103119","33","44571203"
"GL873525","7532192","7532284","chr14","11392828","11392921","20","3860636"
"GL873525","8108080","8108148","chr20","26759854","26759926","23","18651774"
"GL873525","8672403","8672538","chr1","208531450","208531566","32","199859047"
"GL873525","11166273","11166616","chr9","101838392","101838722","97","90672119"
"GL873525","12899476","12899747","chr9","61339652","61339927","75","48440176"
"GL873525","17336158","17336417","chr1","179688842","179689114","88","162352684"
"GL873525","20222951","20223051","chr16","15807510","15807616","28","4415441"
"GL873525","20223298","20223327","chr1","34316032","34316059","8","14092734"
"GL873525","20252925","20253072","chr20","67036080","67036212","39","46783155"
"GL873525","20253346","20253510","chr12","28883903","28884071","44","8630557"
"GL873525","20289361","20289486","chr2","44664370","44664490","30","24375009"
"GL873525","20289514","20289586","chr13","19235000","19235074","21","1054514"
"GL873525","22042539","22042646","chr1","129443714","129443821","39","107401175"
"GL873525","22042928","22043107","chr1","29175881","29176059","47","7132953"
"GL873525","22091206","22091358","chr3","3766976","3767123","60","18324230"
"GL873525","24584081","24584377","chr4","43031221","43031532","70","18447140"
"GL873525","25680003","25680112","chrX","2207401","2207495","35","23472602"
"GL873525","29785863","29786066","chr4","92580981","92581181","61","62795118"
"GL873525","29786306","29786401","chr4","41490236","41490329","20","11703930"
"GL873525","29877465","29877625","chr2","145246634","145246788","49","115369169"
"GL873525","29877907","29878025","chr6","42750956","42751075","29","12873049"
"GL873525","31295530","31295723","chr11","6005552","6005719","61","25289978"
"GL873525","33338359","33338414","chr1","152017801","152017857","20","118679442"
"GL873525","33338687","33338944","chr2","17611811","17612064","70","15726876"
"GL873525","33345321","33345627","chr2","62071040","62071351","86","28725719"
"GL873525","34685957","34685999","chr20","45611046","45611088","11","10925089"
"GL873525","34863164","34863232","chr10","82782488","82782555","10","47919324"
"GL873525","40285069","40285164","chr13","43779330","43779425","26","3494261"
"GL873525","40547002","40547136","chr19","17769532","17769673","38","22777470"
"GL873525","43783277","43783370","chr18","51804094","51804190","32","8020817"
"GL873526","145641","145727","chr3","45504737","45504825","21","45359096"
"GL873526","401382","401451","chr3","151585709","151585776","9","151184327"
"GL873526","401684","401906","chr6","133225789","133226019","68","132824105"
"GL873526","921834","921923","chr16","55600686","55600777","31","54678852"
"GL873526","3954210","3954342","chr1","139366417","139366550","33","135412207"
"GL873526","3954636","3954787","chrX","41629728","41629882","39","37675092"
"GL873526","5852525","5852832","chr9","57279017","57279329","72","51426492"
"GL873526","5893647","5893789","chr16","22771323","22771471","37","16877676"
"GL873526","5894059","5894211","chr3","37646606","37646767","59","31752547"
"GL873526","6308709","6308832","chr12","98229064","98229190","24","91920355"
"GL873526","6545891","6545982","chr3","35225971","35226065","12","28680080"
"GL873526","6650452","6650546","chr1","139282417","139282517","24","132631965"
"GL873526","6650821","6651012","chr7","95792559","95792756","54","89141738"
"GL873526","6885453","6885760","chr2","99007100","99007422","81","92121647"
"GL873526","7268645","7268798","chr19","38850895","38851054","40","31582250"
"GL873526","7269073","7269213","chr1","24221516","24221650","35","16952443"
"GL873526","7277244","7277257","chr1","62300073","62300084","2","55022829"
"GL873526","7277350","7277534","chr3","45663897","45664087","57","38386547"
"GL873526","7277803","7277897","chr10","14096080","14096175","28","6818277"
"GL873526","7326035","7326210","chr8","3378797","3378971","53","3947238"
"GL873526","7326232","7326357","chr13","43679287","43679414","35","36353055"
"GL873526","7387793","7387891","chr13","37764133","37764231","22","30376340"
"GL873526","8727451","8727766","chrX","107931834","107932151","90","99204383"
"GL873526","8840355","8840484","chr5","51015789","51015919","36","42175434"
"GL873526","8840762","8840942","chr11","59706975","59707149","44","50866213"
"GL873526","13539653","13539804","chr1","129434699","129434847","38","115895046"
"GL873526","17092797","17093005","chr12","69786136","69786337","48","52693339"
"GL873526","17445334","17445439","chr12","86506931","86507040","35","69061597"
"GL873526","20495803","20495883","chr6","160516627","160516713","14","140020824"
"GL873526","26237170","26237281","chr2","101518202","101518313","25","75281032"
"GL873526","26495215","26495337","chr3","7427344","7427469","25","19067871"
"GL873526","26495614","26495801","chr4","139370740","139370924","42","112875126"
"GL873526","28522166","28522337","chr3","170811686","170811818","69","142289520"
"GL873526","40937384","40937544","chr3","10255847","10256015","36","30681537"
"GL873527","7744688","7744813","chr3","11444400","11444523","26","3699712"
"GL873527","7745077","7745151","chr2","87112800","87112872","15","79367723"
"GL873527","10550549","10550782","chr15","3569329","3569553","68","6981220"
"GL873527","10551014","10551093","chr16","48351972","48352047","19","37800958"
"GL873527","10823138","10823154","chr6","100674367","100674382","1","89851229"
"GL873527","10823249","10823529","chr7","79578139","79578420","81","68754890"
"GL873527","11294760","11294879","chr10","19590038","19590156","22","8295278"
"GL873527","11294910","11295082","chr17","53123956","53124128","41","41829046"
"GL873527","11937493","11937718","chr7","15285482","15285687","77","3347989"
"GL873527","11937994","11938030","chr9","123615382","123615422","9","111677388"
"GL873527","12924251","12924348","chr10","27718696","27718792","21","14794445"
"GL873527","16494805","16494933","chr16","50824901","50825029","26","34330096"
"GL873527","16495237","16495399","chr17","75962645","75962805","37","59467408"
"GL873527","17550151","17550221","chr5","161656837","161656909","23","144106686"
"GL873527","17550493","17550599","chr5","146751928","146752030","35","129201435"
"GL873527","17550817","17550955","chr14","7944177","7944313","31","9606640"
"GL873527","21739366","21739465","chr15","7166032","7166125","38","14573334"
"GL873527","21739746","21739881","chr13","105550019","105550155","41","83810273"
"GL873527","21860590","21860725","chr1","208531450","208531566","32","186670860"
"GL873527","29086687","29086889","chrX","141464013","141464202","64","112377326"
"GL873527","32955361","32955615","chr10","86657268","86657539","67","53701907"
"GL873527","32955905","32955923","chr4","47395466","47395484","3","14439561"
"GL873527","39618640","39618919","chr2","41466279","41466565","86","1847639"
"GL873528","340621","340775","chr1","64294990","64295139","38","63954369"
"GL873528","340815","340928","chr16","68658807","68658923","26","68317992"
"GL873528","968570","968713","chr19","49196224","49196365","28","48227654"
"GL873528","968979","969119","chr3","138860429","138860565","36","137891450"
"GL873528","2059845","2060163","chr2","50672337","50672663","79","48612492"
"GL873528","3402696","3402969","chr5","30878055","30878345","72","27475359"
"GL873528","5067749","5067835","chr6","160516627","160516713","14","155448878"
"GL873528","7296122","7296295","chr5","11305329","11305500","40","4009207"
"GL873528","9815890","9816026","chr5","69232","69350","37","9746658"
"GL873528","12850029","12850126","chr7","129462395","129462487","40","116612366"
"GL873528","12850221","12850342","chr4","5026751","5026866","31","7823470"
"GL873528","13635143","13635464","chr1","157939966","157940271","82","144304823"
"GL873528","14471318","14471400","chr3","13958833","13958921","17","512485"
"GL873528","28087008","28087107","chr4","59761871","59761967","25","31674863"
"GL873528","29377757","29378072","chr20","19442602","19442923","77","9935155"
"GL873528","33927808","33927969","chr14","55992968","55993121","58","22065160"
"GL873528","36569128","36569409","chr1","23956839","23957126","69","12612289"
"GL873528","37113044","37113319","chr16","57625500","57625784","66","20512456"
"GL873528","38243712","38243790","chr16","53641640","53641717","19","15397928"
"GL873529","2502703","2502823","chr3","10251486","10251598","35","7748783"
"GL873529","2503177","2503247","chrX","93436747","93436806","25","90933570"
"GL873529","2503518","2503612","chr14","10946003","10946095","18","8442485"
"GL873529","2578914","2579045","chr4","16134420","16134544","36","13555506"
"GL873529","3971763","3972065","chr9","91705772","91706076","83","87734009"
"GL873529","6804738","6804899","chr18","2931922","2932093","42","3872816"
"GL873529","6805172","6805303","chr3","44117672","44117806","28","37312500"
"GL873529","9131615","9131722","chr2","62275340","62275449","37","53143725"
"GL873529","12892712","12893019","chr3","173191956","173192270","77","160299244"
"GL873529","16285637","16285748","chr20","26574686","26574799","22","10289049"
"GL873529","16286035","16286285","chr1","1230996","1231240","82","15055039"
"GL873529","16286597","16286848","chr11","30711392","30711654","75","14424795"
"GL873529","16287162","16287174","chr2","42268","42281","1","16244894"
"GL873529","20787228","20787308","chr3","149909965","149910046","14","129122737"
"GL873529","21433940","21434099","chr13","9472864","9473032","54","11961076"
"GL873529","30361582","30361758","chr7","110718313","110718501","57","80356731"
"GL873529","37435712","37435995","chr1","162555408","162555698","69","125119696"
"GL873530","2103983","2104104","chr20","4327296","4327413","26","2223313"
"GL873530","3511429","3511505","chr13","39910631","39910693","25","36399202"
"GL873530","3511765","3511807","chr8","28295899","28295934","11","24784134"
"GL873530","5422299","5422457","chr6","36747041","36747187","52","31324742"
"GL873530","8359806","8359891","chr20","69099112","69099187","29","60739306"
"GL873530","8832431","8832750","chr3","66327763","66328094","99","57495332"
"GL873530","11340324","11340425","chr20","26996383","26996490","33","15656059"
"GL873530","11428714","11428848","chr1","110800321","110800439","50","99371607"
"GL873530","11709328","11709469","chr4","26846298","26846422","47","15136970"
"GL873530","15343402","15343470","chr4","112819465","112819533","12","97476063"
"GL873530","15348456","15348758","chr1","110123983","110124272","73","94775527"
"GL873530","16708867","16709014","chr5","148778455","148778583","46","132069588"
"GL873530","16876480","16876636","chr1","62609830","62609988","37","45733350"
"GL873530","16876891","16877021","chr15","4025263","4025397","29","12851628"
"GL873530","16934149","16934372","chr7","64790757","64790977","79","47856608"
"GL873530","18920450","18920506","chr18","42995869","42995927","12","24075419"
"GL873530","21146990","21147148","chr3","69541544","69541689","58","48394554"
"GL873530","24319936","24320007","chr19","8786390","8786453","19","15533546"
"GL873530","24708441","24708557","chr7","148185932","148186056","36","123477491"
"GL873530","24709565","24709652","chr19","48928631","48928708","27","24219066"
"GL873530","24804711","24804786","chr13","71996215","71996290","16","47191504"
"GL873530","24911474","24911674","chr1","117831649","117831847","43","92920175"
"GL873530","24911901","24912011","chr7","135559244","135559351","25","110647343"
"GL873530","26886298","26886384","chr9","112968371","112968458","16","86082073"
"GL873530","26957903","26958036","chr11","30986963","30987097","28","4029060"
"GL873530","26958288","26958450","chr19","13139307","13139480","46","13818981"
"GL873530","27245179","27245328","chr3","160498531","160498677","42","133253352"
"GL873530","27245605","27245727","chr11","60173557","60173681","40","32927952"
"GL873530","27246002","27246042","chr16","51116433","51116473","7","23870431"
"GL873530","28286487","28286547","chr11","120036157","120036215","16","91749670"
"GL873530","28286795","28286961","chr9","19948366","19948528","45","8338429"
"GL873530","33755547","33755713","chr6","135498535","135498696","58","101742988"
"GL873530","35154543","35154625","chr20","2889961","2890047","26","32264582"
"GL873531","92196","92346","chrX","112278475","112278623","51","112186279"
"GL873531","292691","292811","chr6","125202118","125202241","33","124909427"
"GL873531","292841","293015","chr11","64608129","64608290","52","64315288"
"GL873531","1269421","1269632","chr5","174470370","174470579","55","173200949"
"GL873531","10298048","10298131","chrX","59471865","59471945","22","49173817"
"GL873531","14014391","14014473","chr5","48903473","48903555","19","34889082"
"GL873531","20971065","20971395","chr15","94349198","94349517","86","73378133"
"GL873531","21648650","21648779","chr9","39547701","39547842","46","17899051"
"GL873531","24910290","24910380","chr16","63953133","63953225","13","39042843"
"GL873531","28140004","28140278","chr5","57322002","57322280","64","29181998"
"GL873531","28173323","28173458","chr8","96741995","96742113","30","68568672"
"GL873531","29287798","29287932","chr3","129437737","129437865","40","100149939"
"GL873532","411999","412286","chr17","10506323","10506606","74","10094324"
"GL873532","1556505","1556611","chr7","129537753","129537861","26","127981248"
"GL873532","1556635","1556806","chr11","94828289","94828461","39","93271654"
"GL873532","1828042","1828127","chr1","40097424","40097510","16","38269382"
"GL873532","2251856","2252069","chr2","88024016","88024227","58","85772160"
"GL873532","2252342","2252433","chr18","14213831","14213920","16","11961489"
"GL873532","2511609","2511858","chr16","33417462","33417724","69","30905853"
"GL873532","2512112","2512153","chr2","85840743","85840783","6","83328631"
"GL873532","13718552","13718740","chr19","9312462","9312653","49","4406090"
"GL873532","13718969","13719117","chr6","34592399","34592549","48","20873430"
"GL873532","19805107","19805406","chr4","77953349","77953646","75","58148242"
"GL873532","21365464","21365796","chr14","109053543","109053839","94","87688079"
"GL873532","21625131","21625204","chr20","51253047","51253121","20","29627916"
"GL873532","23569107","23569222","chr2","47672142","47672259","30","24103035"
"GL873532","24653153","24653238","chr10","75180283","75180371","18","50527130"
"GL873532","24653517","24653715","chr16","59342374","59342578","61","34688857"
"GL873532","24797385","24797436","chr7","24499411","24499456","14","297974"
"GL873532","26107613","26107734","chr3","43641387","43641512","24","17533774"
"GL873532","26108044","26108237","chr5","12528703","12528891","49","13579341"
"GL873532","28431979","28432157","chr3","32552139","32552318","42","4120160"
"GL873532","28432422","28432535","chr13","69095287","69095406","32","40662865"
"GL873532","28773892","28774096","chr16","6979582","6979790","70","21794310"
"GL873532","28774408","28774423","chr7","5631273","5631288","0","23143135"
"GL873532","30154004","30154129","chr8","89213235","89213350","28","59059231"
"GL873533","857917","858126","chr20","46702465","46702679","60","45844548"
"GL873533","858391","858476","chr4","17641880","17641964","22","16783489"
"GL873533","4473104","4473389","chr13","68269779","68270062","69","63796675"
"GL873533","10775026","10775109","chr9","94278233","94278318","19","83503207"
"GL873533","19395984","19396283","chrX","62809427","62809723","71","43413443"
"GL873533","24564316","24564401","chr4","135516605","135516690","13","110952289"
"GL873533","24782266","24782368","chr6","132352782","132352885","31","107570516"
"GL873533","26282139","26282219","chr4","69001513","69001594","15","42719374"
"GL873533","26361218","26361398","chr16","54668849","54669031","51","28307631"
"GL873533","26361677","26361785","chr4","81054783","81054879","27","54693106"
"GL873533","27779785","27779989","chr7","119001378","119001557","76","91221593"
"GL873533","28724287","28724421","chr1","208531450","208531566","34","179807163"
"GL873533","30238189","30238248","chr1","196637437","196637494","17","166399248"
"GL873533","30238508","30238754","chr13","9371671","9371918","67","20866837"
"GL873534","342098","342408","chr1","54185224","54185537","67","53843126"
"GL873534","1058418","1058714","chr13","69785446","69785748","73","68727028"
"GL873534","6947792","6948033","chrX","7901808","7902034","79","954016"
"GL873534","10439013","10439067","chr20","57852783","57852840","14","47413770"
"GL873534","12994996","12995250","chr3","127209934","127210202","70","114214938"
"GL873534","12995274","12995290","chr1","11697931","11697946","2","1297343"
"GL873534","13890380","13890470","chr6","36039233","36039321","16","22148853"
"GL873534","16820841","16820854","chr1","32018409","32018422","1","15197568"
"GL873534","16820889","16821167","chrX","17654083","17654370","69","833194"
"GL873534","17808925","17809201","chrX","43727970","43728251","63","25919045"
"GL873534","17809226","17809236","chr14","15615048","15615059","1","2194178"
"GL873534","24218903","24218953","chr2","89144777","89144826","11","64925874"
"GL873534","24222244","24222306","chr2","85503172","85503243","19","61280928"
"GL873534","27408544","27408669","chr16","55500003","55500103","43","28091459"
"GL873534","29375385","29375470","chr3","55187598","55187680","24","25812213"
"GL873535","2833264","2833368","chr16","68659411","68659515","38","65826147"
"GL873535","8145421","8145688","chr7","151998262","151998544","79","143852841"
"GL873535","8836398","8836543","chr6","97735333","97735478","45","88898935"
"GL873535","8836798","8836845","chr14","77079675","77079721","12","68242877"
"GL873535","10326917","10327051","chr1","208531450","208531566","34","198204533"
"GL873535","10669698","10669829","chr7","63697870","63697995","31","53028172"
"GL873535","10670108","10670267","chr6","144042020","144042177","34","133371912"
"GL873535","11458250","11458328","chr1","121579657","121579721","24","110121407"
"GL873535","11508852","11509035","chrX","108288281","108288461","45","96779429"
"GL873535","11509304","11509426","chr10","63247923","63248045","27","51738619"
"GL873535","13108644","13108836","chr8","31623419","31623611","59","18514775"
"GL873535","13573950","13574001","chr5","164671793","164671841","11","151097843"
"GL873535","14291309","14291406","chr12","73169640","73169739","24","58878331"
"GL873535","14749328","14749391","chr4","105610122","105610181","16","90860794"
"GL873535","21037525","21037591","chr2","86329384","86329447","16","65291859"
"GL873535","21037861","21037877","chr1","65667992","65668006","5","44630131"
"GL873535","23005311","23005510","chr6","50193372","50193570","51","27188061"
"GL873535","30036874","30037098","chr7","75782983","75783173","78","45746109"
"GL873535","30074274","30074369","chr12","13309541","13309633","35","16764733"
"GL873536","2048760","2048820","chr8","28336853","28336904","24","26288093"
"GL873536","2049012","2049108","chr12","45199984","45200084","23","43150972"
"GL873536","2049132","2049253","chr1","127705250","127705369","25","125656118"
"GL873536","2100960","2101105","chr4","10576736","10576883","28","8475776"
"GL873536","2503308","2503413","chr13","85846711","85846796","35","83343403"
"GL873536","3184754","3185080","chr10","14132480","14132801","82","10947726"
"GL873536","5657243","5657386","chr15","77153866","77154004","37","71496623"
"GL873536","5657462","5657634","chr11","111279167","111279320","57","105621705"
"GL873536","5916771","5916808","chr1","44540591","44540625","7","38623820"
"GL873536","5917090","5917252","chrX","38473505","38473662","49","32556415"
"GL873536","13061452","13061544","chr10","30838760","30838855","23","17777308"
"GL873536","13310346","13310511","chr10","88565759","88565930","52","75255413"
"GL873536","13310785","13310901","chr1","42620729","42620847","37","29309944"
"GL873536","13325959","13326045","chr19","42743745","42743831","24","29417786"
"GL873536","13326308","13326440","chr10","28364654","28364785","32","15038346"
"GL873536","13520482","13520560","chr6","160516627","160516713","15","146996145"
"GL873536","15807997","15808076","chr7","43198527","43198599","24","27390530"
"GL873536","19609267","19609399","chr6","17220493","17220623","44","2388774"
"GL873536","19609680","19609795","chr9","37709782","37709897","31","18100102"
"GL873536","23848517","23848653","chr5","12150703","12150834","27","11697814"
"GL873536","26712748","26712850","chr5","20455873","20455966","38","6256875"
"GL873537","121531","121627","chr7","106187328","106187432","33","106065797"
"GL873537","419757","419890","chr1","13820420","13820556","26","13400663"
"GL873537","420167","420288","chr6","31317433","31317550","31","30897266"
"GL873537","984172","984344","chr4","42822402","42822551","52","41838230"
"GL873537","4338752","4338865","chr11","3042827","3042934","27","1295925"
"GL873537","10793376","10793711","chr14","9741309","9741646","97","1052067"
"GL873537","14895208","14895352","chr19","39382285","39382433","46","24487077"
"GL873537","14895642","14895798","chr3","149884944","149885096","44","134989302"
"GL873537","15263883","15263981","chr20","24171230","24171314","32","8907347"
"GL873537","15516912","15517072","chrX","38622568","38622728","32","23105656"
"GL873537","15517373","15517507","chr7","32749975","32750110","26","17232602"
"GL873537","15640092","15640277","chr3","67396064","67396266","41","51755972"
"GL873537","17279331","17279432","chr13","43779330","43779425","29","26499999"
"GL873537","17279678","17279805","chr9","80423915","80424047","34","63144237"
"GL873537","22347566","22347649","chr10","27190618","27190707","16","4843052"
"GL873537","23710391","23710549","chr2","88254814","88254972","46","64544423"
"GL873537","23710841","23710953","chr11","49089548","49089663","24","25378707"
"GL873537","24519844","24520020","chr2","103833356","103833531","42","79313512"
"GL873537","24520281","24520424","chr1","129886230","129886375","35","105365949"
"GL873537","24528294","24528507","chr19","31066961","31067191","61","6538667"
"GL873537","24528606","24528672","chr7","15970191","15970251","22","8558415"
"GL873537","26202112","26202195","chr15","39986185","39986274","17","13784073"
"GL873537","26202223","26202380","chr1","136541308","136541460","49","110339085"
"GL873537","26202630","26202713","chr5","82231233","82231315","27","56028603"
"GL873538","526633","526749","chr8","89116137","89116247","35","88589504"
"GL873538","527039","527148","chr1","117438568","117438680","23","116911529"
"GL873538","1504321","1504584","chr13","91763208","91763482","77","90258887"
"GL873538","5005203","5005336","chr14","10135499","10135632","27","5130296"
"GL873538","5005621","5005786","chr4","85525399","85525562","45","80519778"
"GL873538","9911326","9911458","chr14","8113085","8113219","20","1798241"
"GL873538","9911732","9911906","chr17","50494871","50495045","34","40583139"
"GL873538","10358766","10358842","chr19","31053995","31054067","14","20695229"
"GL873538","10413484","10413570","chr15","96746475","96746561","13","86332991"
"GL873538","10413841","10414040","chr12","96564799","96565017","63","86150958"
"GL873538","12394284","12394421","chr1","208531450","208531566","37","196137166"
"GL873538","12394447","12394514","chr3","24069041","24069096","28","11674594"
"GL873538","24424617","24424704","chr1","40097424","40097510","17","15672807"
"GL873538","24469217","24469376","chr3","48136388","48136524","58","23667171"
"GL873538","24469653","24469741","chr6","160516627","160516713","21","136046974"
"GL873538","24981236","24981329","chr1","147496990","147497076","32","122515754"
"GL873538","25128683","25128858","chr10","27622316","27622503","48","2493633"
"GL873539","253828","253930","chr4","93044224","93044326","29","92790396"
"GL873539","254199","254399","chr3","127164696","127164892","46","126910497"
"GL873539","257987","258009","chr2","124203223","124203241","9","123945236"
"GL873539","258030","258191","chr1","88616035","88616202","43","88358005"
"GL873539","4181205","4181447","chr2","43473275","43473521","89","39292070"
"GL873539","4234217","4234295","chr1","9336391","9336467","18","5102174"
"GL873539","4234567","4234727","chr1","92874712","92874869","42","88640145"
"GL873539","9058580","9058687","chr1","37210249","37210360","39","28151669"
"GL873539","14872787","14872938","chr1","184648784","184648946","45","169775997"
"GL873539","16379453","16379735","chrX","49583053","49583339","75","33203600"
"GL873539","16379934","16379946","chr1","190320448","190320460","0","173940514"
"GL873539","17015409","17015547","chr11","30789275","30789409","34","13773866"
"GL873539","17015821","17015971","chr11","132249902","132250050","34","115234081"
"GL873539","19069874","19069946","chr11","59861831","59861903","14","40791957"
"GL873539","19070237","19070315","chr17","41997442","41997526","26","22927205"
"GL873540","4843806","4843869","chr4","39175977","39176031","21","34332171"
"GL873540","8741552","8741619","chr19","16612520","16612594","18","7870968"
"GL873540","16765150","16765306","chr9","12430014","12430172","37","4335136"
"GL873540","16765591","16765720","chr7","29659354","29659488","23","12893763"
"GL873540","17238528","17238614","chr10","75180283","75180371","15","57941755"
"GL873540","19109133","19109170","chrX","102990846","102990879","9","83881713"
"GL873540","19109450","19109715","chr16","32178413","32178686","78","13068963"
"GL873540","19331245","19331378","chr1","151937243","151937376","27","132605998"
"GL873540","19331612","19331778","chr11","98392458","98392624","42","79060846"
"GL873540","19356546","19356681","chr1","208531450","208531566","32","189174904"
"GL873540","19786720","19786797","chr8","118552016","118552081","20","98765296"
"GL873540","19787058","19787182","chr1","53707160","53707284","25","33920102"
"GL873540","24067403","24067492","chr1","40097424","40097510","14","16030021"
"GL873541","2443359","2443541","chr10","88565759","88565930","54","86122400"
"GL873541","13471362","13471453","chr16","6980104","6980195","21","6491258"
"GL873541","17101572","17101746","chr10","85980115","85980283","46","68878543"
"GL873541","17102013","17102121","chr1","181525413","181525519","26","164423400"
"GL873541","18269299","18269403","chr17","50823126","50823225","22","32553827"
"GL873542","110885","111081","chr1","31133102","31133305","56","31022217"
"GL873542","111367","111457","chr3","52080856","52080950","16","51969489"
"GL873542","359154","359248","chr7","52527290","52527377","28","52168136"
"GL873542","878688","878885","chr2","44343711","44343923","58","43465023"
"GL873542","878976","879081","chr9","31386278","31386378","34","30507302"
"GL873542","1385720","1385987","chr11","88800236","88800508","73","87414516"
"GL873542","1879603","1879861","chr5","74638327","74638597","64","72758724"
"GL873542","9268581","9268712","chr14","67918101","67918234","34","58649520"
"GL873542","9278719","9278840","chr2","157026101","157026221","25","147747382"
"GL873542","9346825","9346956","chrX","121842719","121842851","31","112495894"
"GL873542","9347209","9347298","chr10","81294606","81294684","25","71947397"
"GL873542","10417238","10417304","chr13","125304907","125304973","22","114887669"
"GL873542","13112650","13112756","chr9","36468515","36468621","38","23355865"
"GL873542","17254453","17254539","chr3","46805844","46805931","12","29551391"
"GL873542","21513582","21513666","chr4","107924954","107925038","14","86411372"
"GL873542","22582799","22582894","chr15","34931963","34932060","30","12349164"
"GL873542","22582991","22583197","chr8","65956930","65957132","65","43373939"
"GL873542","22909324","22909519","chr11","6005552","6005719","58","16903772"
"GL873543","981057","981192","chr1","214592596","214592730","24","213611539"
"GL873543","981313","981450","chr19","13038395","13038542","36","12057082"
"GL873543","1119389","1119604","chr5","139094596","139094817","74","137975207"
"GL873543","1697672","1697778","chr2","54912784","54912895","24","53215112"
"GL873543","1697806","1697971","chr4","158180034","158180194","39","156482228"
"GL873543","2456356","2456393","chr6","60300758","60300793","12","57844402"
"GL873543","2456647","2456880","chr12","64878387","64878622","65","62421740"
"GL873543","2892374","2892435","chr12","568593","568654","14","2323781"
"GL873543","3758065","3758194","chr12","96207758","96207878","49","92449693"
"GL873543","5715758","5715848","chr13","43779330","43779425","35","38063572"
"GL873543","6536140","6536337","chr1","10468874","10469076","61","3932734"
"GL873543","18782383","18782483","chr8","33560457","33560545","37","14778074"
"GL873543","18852113","18852259","chr3","38092452","38092594","42","19240339"
"GL873543","18852572","18852721","chr3","160498531","160498677","42","141645959"
"GL873543","19344808","19344955","chr19","5442241","5442385","39","13902567"
"GL873543","19345227","19345354","chr7","123709847","123709965","28","104364620"
"GL873543","19416929","19417112","chr4","75348157","75348337","43","55931228"
"GL873543","19951576","19951712","chr10","69322348","69322481","31","49370772"
"GL873543","19951992","19952117","chr3","53058286","53058411","37","33106294"
"GL873543","20544075","20544189","chrX","62868181","62868296","21","42324106"
"GL873543","20544464","20544617","chr13","27689646","27689797","40","7145182"
"GL873544","1114100","1114306","chr10","35861263","35861458","64","34747163"
"GL873544","3729723","3729832","chr6","135848278","135848383","36","132118555"
"GL873544","10270453","10270591","chr8","115540390","115540527","29","105269937"
"GL873544","11270396","11270556","chr3","33696518","33696688","44","22426122"
"GL873544","11270834","11270847","chr1","48820534","48820547","3","37549700"
"GL873544","11271121","11271237","chr9","61370867","61370997","35","50099746"
"GL873544","11819443","11819500","chr7","70438291","70438345","17","58618848"
"GL873544","12307366","12307487","chr16","73798560","73798688","33","61491194"
"GL873544","12307753","12307901","chr11","47215004","47215152","34","34907251"
"GL873544","12749647","12749911","chr15","100401470","100401743","76","87651823"
"GL873544","12750006","12750016","chr4","134693657","134693667","0","121943651"
"GL873544","14345574","14345707","chr20","39330089","39330223","24","24984515"
"GL873544","14345970","14346159","chr3","41847862","41848049","48","27501892"
"GL873544","15336606","15336720","chr14","8821747","8821856","30","6514859"
"GL873544","15336982","15337120","chr4","68905806","68905944","41","53568824"
"GL873544","15451246","15451396","chr6","171378283","171378422","37","155927037"
"GL873544","15525174","15525371","chr3","38686827","38687018","53","23161653"
"GL873544","15718966","15719052","chr4","17641880","17641964","25","1922914"
"GL873544","15719332","15719551","chr9","124324888","124325112","55","108605556"
"GL873544","15768839","15768991","chr3","2273126","2273275","44","13495713"
"GL873544","15769233","15769363","chr13","84237213","84237345","23","68467980"
"GL873544","16316300","16316391","chr4","42350117","42350191","32","26033817"
"GL873544","16578109","16578241","chr16","56309884","56310019","26","39731775"
"GL873544","16578519","16578658","chr6","73277991","73278143","44","56699472"
"GL873544","16591349","16591482","chr1","3418869","3419004","35","13172480"
"GL873544","16591758","16591910","chr1","11105164","11105310","44","5486594"
"GL873544","19101396","19101613","chr11","110467406","110467625","71","91366010"
"GL873544","19101712","19101795","chr1","40097424","40097510","20","20995712"
"GL873545","4389151","4389312","chr10","32375972","32376136","38","27986821"
"GL873545","4389578","4389703","chr2","101429226","101429353","34","97039648"
"GL873545","4544342","4544449","chr15","59743899","59743992","39","55199557"
"GL873545","7273965","7274148","chr19","2600029","2600224","64","4673936"
"GL873545","7274426","7274519","chr19","27847312","27847406","15","20572886"
"GL873545","11746235","11746303","chr1","109739573","109739640","10","97993338"
"GL873545","11843428","11843568","chr16","65573512","65573649","35","53730084"
"GL873545","14066539","14066659","chr19","27597015","27597139","25","13530476"
"GL873545","14066921","14067132","chr7","14657177","14657366","56","590256"
"GL873545","14745262","14745413","chr7","103904262","103904406","31","89159000"
"GL873545","16268378","16268466","chr1","5095502","5095591","15","11172876"
"GL873545","17428284","17428410","chr11","110771562","110771691","38","93343278"
"GL873545","20212636","20212748","chr2","29400789","29400892","33","9188153"
"GL873545","20215180","20215469","chr7","40668188","40668469","72","20453008"
"GL873545","20215763","20215778","chr6","147630033","147630047","2","127414270"
"GL873545","20635384","20635449","chr2","104463483","104463547","20","83828099"
"GL873546","11108858","11108978","chr13","111037335","111037461","48","99928477"
"GL873546","15110900","15111165","chr20","26159997","26160264","65","11049097"
"GL873546","16270928","16271085","chr10","81724428","81724586","40","65453500"
"GL873547","3944645","3944659","chr1","137136953","137136966","1","133192308"
"GL873547","3944933","3945122","chr1","124353606","124353784","69","120408673"
"GL873547","3945364","3945487","chr11","424533","424652","38","3520831"
"GL873547","5196540","5196670","chr1","18651982","18652117","26","13455442"
"GL873547","5196972","5197216","chr19","47829992","47830216","79","42633020"
"GL873547","5733442","5733576","chr13","55504438","55504567","44","49770996"
"GL873547","7357557","7357692","chr1","208531450","208531566","32","201173893"
"GL873547","9704989","9705118","chr6","151957412","151957544","27","142252423"
"GL873547","10038324","10038352","chr11","52267987","52268015","8","42229663"
"GL873547","11282675","11282746","chr3","57429053","57429119","17","46146378"
"GL873547","11282796","11282974","chr2","143974061","143974236","38","132691265"
"GL873547","11643470","11643583","chr5","35018752","35018860","38","23375282"
"GL873547","12880689","12880739","chr20","57410703","57410756","12","44530014"
"GL873547","18563125","18563320","chr1","15825810","15825995","67","2737315"
"GL873548","3918754","3919009","chr2","83924341","83924592","65","80005587"
"GL873548","5505880","5506074","chr9","20766542","20766731","46","15260662"
"GL873548","7395200","7395420","chr14","9310318","9310514","58","1915118"
"GL873548","12120266","12120355","chr14","112158830","112158925","28","100038564"
"GL873548","12120628","12120831","chr19","48536164","48536370","48","36415536"
"GL873548","13532659","13532903","chr5","142174597","142174830","70","128641938"
"GL873548","15019866","15019959","chr3","5049602","5049695","24","9970264"
"GL873548","15020229","15020437","chr4","144004680","144004903","57","128984451"
"GL873548","15066147","15066239","chrX","46102662","46102753","20","31036515"
"GL873548","15066530","15066743","chr6","69481562","69481772","48","54415032"
"GL873548","15249374","15249463","chr1","40097424","40097510","17","24848050"
"GL873548","15817199","15817306","chr4","95102824","95102922","36","79285625"
"GL873548","15817589","15817786","chr3","2989880","2990101","58","12827709"
"GL873548","15856498","15856605","chr8","24142365","24142483","39","8285867"
"GL873548","15856683","15856877","chr9","56348285","56348486","52","40491602"
"GL873549","1940307","1940608","chr13","88409069","88409385","72","86468762"
"GL873549","2657819","2658019","chr10","88456811","88457012","55","85798992"
"GL873549","8853848","8853952","chr10","79350017","79350118","29","70496169"
"GL873549","10378794","10378882","chr1","130102001","130102092","18","119723207"
"GL873549","15488169","15488282","chr14","63615209","63615309","37","48127040"
"GL873549","17403348","17403519","chr10","90450411","90450572","40","73047063"
"GL873550","801968","802043","chr15","42273911","42273985","18","41471943"
"GL873550","802343","802376","chr7","26472663","26472694","8","25670320"
"GL873550","2805841","2805900","chr5","146751711","146751768","15","143945870"
"GL873550","4153085","4153214","chr19","41776907","41777030","34","37623822"
"GL873550","4153472","4153634","chr2","113089695","113089857","41","108936223"
"GL873550","6050671","6050965","chr9","15090158","15090454","77","9039487"
"GL873550","6212004","6212068","chr15","106781034","106781094","23","100569030"
"GL873550","6212319","6212418","chr2","62275340","62275449","35","56063021"
"GL873550","6504310","6504401","chr14","8970805","8970899","27","2466495"
"GL873550","7178331","7178523","chr11","6005552","6005719","58","1172779"
"GL873550","7981631","7981790","chr19","48866701","48866865","39","40885070"
"GL873550","7982053","7982180","chr14","117185400","117185528","26","109203347"
"GL873550","8404122","8404320","chr4","102568041","102568243","43","94163919"
"GL873550","8404408","8404483","chr11","109135450","109135517","24","100731042"
"GL873550","11648593","11648682","chr20","56906983","56907065","26","45258390"
"GL873550","12468624","12468663","chr13","35562246","35562286","10","23093622"
"GL873550","12468943","12469188","chr1","90942489","90942727","91","78473546"
"GL873550","14719674","14719880","chr7","119001378","119001557","75","104281704"
"GL873550","15737883","15738154","chr15","100401470","100401743","70","84663587"
"GL873550","15738844","15738873","chr2","104558881","104558914","7","88820037"
"GL873550","16345151","16345329","chr10","90527891","90528086","64","74182740"
"GL873550","17727115","17727274","chr1","121367281","121367423","52","103640166"
"GL873551","6567068","6567102","chr8","138976406","138976442","10","132409338"
"GL873551","9393264","9393376","chr3","3875525","3875639","30","5517739"
"GL873551","9393708","9393894","chr12","94960824","94961015","41","85567116"
"GL873551","10104594","10104683","chr8","89970583","89970665","31","79865989"
"GL873551","12307468","12307551","chr11","77584109","77584192","18","65276641"
"GL873551","13335872","13336095","chr10","62564436","62564665","52","49228564"
"GL873552","1195303","1195426","chr16","28922600","28922716","33","27727297"
"GL873552","15010293","15010428","chr1","208531450","208531566","31","193521157"
"GL873553","860627","860695","chr16","70214128","70214195","11","69353501"
"GL873553","7206820","7206939","chr3","41695447","41695554","34","34488627"
"GL873553","10985147","10985407","chr12","74361172","74361442","65","63376025"
"GL873553","10985438","10985466","chr17","33400604","33400630","5","22415166"
"GL873553","12443178","12443505","chr5","8255023","8255342","97","4188155"
"GL873553","15121135","15121247","chr1","211662944","211663063","20","196541809"
"GL873553","15121274","15121455","chr7","50063833","50064024","67","34942559"
"GL873553","15614197","15614298","chr6","64352914","64353013","32","48738717"
"GL873553","16849767","16850040","chr5","106888056","106888340","68","90038289"
"GL873554","511555","511741","chr6","106670716","106670906","54","106159161"
"GL873554","2046660","2046725","chr3","170791195","170791260","6","168744535"
"GL873554","2580766","2581036","chr5","102449874","102450162","79","99869108"
"GL873554","5465741","5465829","chr2","132953067","132953157","14","127487326"
"GL873555","8807785","8807956","chr8","135283369","135283514","46","126475584"
"GL873555","8828420","8828440","chr2","85340352","85340371","4","76511932"
"GL873555","12399534","12399604","chr1","141965348","141965426","23","129565814"
"GL873555","12440877","12440963","chr10","27470492","27470576","22","15029615"
"GL873555","13094462","13094529","chr8","70203344","70203414","19","57108882"
"GL873555","13254579","13254784","chr7","30463612","30463805","61","17209033"
"GL873555","13255065","13255153","chrX","103746481","103746572","23","90491416"
"GL873555","13262783","13262918","chr1","208531450","208531566","32","195268667"
"GL873556","639117","639366","chr3","52640395","52640619","74","52001278"
"GL873556","639390","639468","chrX","95738898","95738965","28","95099508"
"GL873556","2031445","2031493","chr10","18512764","18512807","14","16481319"
"GL873556","6655305","6655664","chr13","90897488","90897837","107","84242183"
"GL873556","10802692","10802792","chr14","44609171","44609257","38","33806479"
"GL873557","1682363","1682659","chrX","124784000","124784308","71","123101637"
"GL873557","2465751","2465841","chr16","4523642","4523729","15","2057891"
"GL873557","4047834","4047915","chr1","33382708","33382797","20","29334874"
"GL873557","4048202","4048390","chr11","8595333","8595526","40","4547131"
"GL873557","6292327","6292620","chr7","33058160","33058451","83","26765833"
"GL873557","6324546","6324617","chr7","47581693","47581760","19","41257147"
"GL873557","6406262","6406343","chr3","173718716","173718798","12","167312454"
"GL873557","6417612","6417692","chr18","16536080","16536161","13","10118468"
"GL873557","6903406","6903510","chr8","86169965","86170069","29","79266559"
"GL873557","6903779","6903930","chr3","4691555","4691706","34","2212224"
"GL873557","8133022","8133316","chr12","36487909","36488216","75","28354887"
"GL873557","8171663","8171835","chr3","30856164","30856316","58","22684501"
"GL873557","8172121","8172252","chr19","43028720","43028854","30","34856599"
"GL873557","8260873","8260977","chr17","68981455","68981556","20","60720582"
"GL873557","10032878","10033040","chr3","47821162","47821324","32","37788284"
"GL873557","10366578","10366655","chr7","111398329","111398409","16","101031751"
"GL873557","12031816","12031985","chr19","11930448","11930620","42","101368"
"GL873557","12032023","12032144","chr5","137610905","137611026","23","125578882"
"GL873557","14208944","14209036","chr4","17641880","17641964","25","3432936"
"GL873558","2159034","2159070","chr18","50913680","50913715","6","48754646"
"GL873558","3486850","3487074","chr8","138615375","138615573","72","135128525"
"GL873558","3884156","3884240","chr18","46331762","46331849","14","42447606"
"GL873558","5037604","5037746","chr1","64769456","64769606","42","59731852"
"GL873558","6488648","6488700","chrX","121806008","121806056","16","115317360"
"GL873558","6489359","6489583","chr10","18861907","18862135","64","12372548"
"GL873558","14631848","14632045","chr1","158354183","158354407","65","143722335"
"GL873558","14632352","14632392","chr3","15588939","15588976","13","956587"
"GL873559","8193331","8193614","chr5","100214798","100215087","71","92021467"
"GL873559","8193642","8193657","chr4","27363001","27363017","1","19169359"
"GL873560","393252","393440","chr14","30617892","30618065","52","30224640"
"GL873560","4038833","4039014","chr7","110718313","110718501","52","106679480"
"GL873560","4492531","4492643","chr9","40224373","40224483","29","35731842"
"GL873560","4492670","4492771","chr3","55362662","55362764","28","50869992"
"GL873560","8106775","8106882","chr6","33945612","33945710","39","25838837"
"GL873560","10872201","10872272","chr1","47999931","48000000","10","37127730"
"GL873560","11043320","11043410","chr2","29243220","29243309","17","18199900"
"GL873561","5890611","5890936","chr7","6617764","6618090","77","727153"
"GL873561","10859256","10859475","chr9","92251728","92251951","71","81392472"
"GL873561","10859563","10859576","chr1","32018409","32018422","1","21158846"
"GL873562","12189469","12189706","chr16","406333","406562","73","11783136"
"GL873562","4526861","4526913","chr13","90892994","90893047","15","86366133"
"GL873562","4789223","4789313","chr16","40078359","40078438","25","35289136"
"GL873562","4868605","4868801","chr8","8273079","8273271","43","3404474"
"GL873562","4929184","4929360","chr12","94960824","94961015","47","90031640"
"GL873562","5446395","5446678","chr4","21803431","21803717","80","16357036"
"GL873562","8499356","8499477","chr5","14629034","14629157","28","6129678"
"GL873562","8499731","8499918","chr4","20780087","20780268","41","12280356"
"GL873562","10216295","10216385","chr4","34267876","34267969","32","24051581"
"GL873562","11812352","11812435","chr16","23380166","23380250","18","11567814"
"GL873562","12179920","12180054","chr14","7944177","7944313","17","4235743"
"GL873562","14017684","14017885","chr13","125256672","125256851","74","111238988"
"GL873562","14017915","14018042","chr19","4339216","4339345","24","9678699"
"GL873563","2645481","2645758","chr4","103452129","103452409","71","100806648"
"GL873563","2646059","2646097","chr7","1117623","1117657","10","1528436"
"GL873563","2651001","2651167","chr19","10045984","10046152","38","7394983"
"GL873563","2651449","2651584","chr10","85072878","85073011","29","82421429"
"GL873563","6898038","6898117","chr7","47132911","47132992","27","40234873"
"GL873563","6898395","6898520","chr11","53221279","53221413","29","46322884"
"GL873563","7811395","7811530","chr1","208531450","208531566","31","200720055"
"GL873563","7855904","7856041","chr11","83919027","83919157","34","76063123"
"GL873563","8381194","8381392","chr9","48006201","48006405","64","39625007"
"GL873563","8381923","8382014","chr5","49066573","49066657","32","40684650"
"GL873563","9500422","9500552","chr20","19962861","19962995","33","10462439"
"GL873563","9501087","9501192","chr16","68659411","68659515","33","59158324"
"GL873563","10991062","10991128","chr1","28701511","28701579","12","17710449"
"GL873563","12252577","12252738","chr7","4258448","4258609","40","7994129"
"GL873564","1384131","1384395","chr13","35793864","35794138","63","34409733"
"GL873564","2543879","2544121","chr1","191213531","191213751","73","188669652"
"GL873564","4859126","4859236","chr7","129537753","129537861","31","124678627"
"GL873564","4859490","4859678","chr1","160123541","160123731","54","155264051"
"GL873564","5294014","5294069","chr9","7831483","7831544","18","2537469"
"GL873564","5294155","5294257","chr2","168623303","168623402","19","163329148"
"GL873564","6711055","6711262","chr3","13393793","13394012","60","6682738"
"GL873564","6711356","6711451","chr1","18269731","18269822","30","11558375"
"GL873564","7057009","7057315","chr14","103459065","103459364","85","96402056"
"GL873564","7705416","7705474","chr11","51346406","51346454","18","43640990"
"GL873564","8307239","8307551","chr2","167512846","167513154","90","159205607"
"GL873564","8738781","8739084","chr19","37371644","37371960","86","28632863"
"GL873564","9560044","9560238","chr7","110718313","110718501","51","101158269"
"GL873564","9560508","9560604","chr1","19198733","19198831","27","9638225"
"GL873564","9753449","9753658","chr4","32960006","32960206","56","23206557"
"GL873564","9753896","9754006","chr8","96741995","96742113","31","86988099"
"GL873564","10693118","10693253","chr19","15128773","15128907","32","4435655"
"GL873564","11596705","11596819","chr19","10923491","10923613","35","673214"
"GL873564","13278770","13278831","chr7","15118897","15118952","16","1840127"
"GL873564","13278924","13279152","chr20","66128513","66128737","61","52849589"
"GL873565","1417041","1417214","chrX","102868836","102868986","51","101451795"
"GL873565","2138367","2138455","chr5","21121183","21121269","15","18982816"
"GL873565","2459722","2459938","chr7","13483602","13483808","52","11023880"
"GL873565","2460219","2460297","chr16","48351972","48352047","24","45891753"
"GL873565","11485258","11485580","chr3","38723342","38723655","98","27238084"
"GL873565","13424539","13424574","chr1","33012053","33012092","9","19587514"
"GL873565","13424654","13424896","chr16","72902300","72902555","57","59477646"
"GL873565","13679578","13679856","chr15","22408820","22409099","73","8729242"
"GL873566","947388","947684","chr1","30994506","30994776","82","30047118"
"GL873566","2530056","2530102","chr8","109370434","109370480","9","106840378"
"GL873566","2923434","2923499","chr1","127975366","127975431","18","125051932"
"GL873566","3613441","3613522","chr19","3956147","3956231","18","342706"
"GL873566","6100482","6100582","chr9","57349500","57349607","31","51249018"
"GL873566","6245586","6245714","chr3","52656014","52656147","30","46410428"
"GL873566","6245992","6246162","chr16","22242660","22242832","36","15996668"
"GL873566","6483968","6484033","chr1","20152829","20152891","17","13668861"
"GL873566","7043395","7043464","chr1","144328459","144328529","19","137285064"
"GL873566","7888407","7888429","chr1","124357044","124357062","7","116468637"
"GL873566","7888682","7888751","chr7","63768669","63768731","22","55879987"
"GL873566","8203857","8203949","chrX","37810049","37810139","21","29606192"
"GL873566","8268872","8268975","chr15","96503462","96503565","27","88234590"
"GL873566","8269263","8269458","chr7","13483602","13483808","53","5214339"
"GL873566","8592056","8592127","chr5","171464232","171464299","16","162872176"
"GL873566","8809109","8809200","chr14","10984910","10985004","22","2175801"
"GL873566","8809477","8809608","chr19","9739948","9740081","34","930471"
"GL873566","9503716","9503881","chr19","31980140","31980295","54","22476424"
"GL873566","9537883","9537992","chr16","43972418","43972533","28","34434535"
"GL873566","9538266","9538462","chr14","17232013","17232213","52","7693747"
"GL873566","13663722","13663916","chr13","11398703","11398868","71","2265019"
"GL873566","13664206","13664293","chr13","8729504","8729591","16","4934702"
"GL873567","8375378","8375469","chr2","85904643","85904730","27","77529265"
"GL873567","9062667","9063009","chr1","27030632","27030958","94","17967965"
"GL873567","11215752","11215787","chr9","60148344","60148376","10","48932592"
"GL873567","11215868","11216117","chrX","45229537","45229801","78","34013669"
"GL873567","12342574","12342696","chr9","28321210","28321344","44","15978636"
"GL873567","12342734","12342873","chr1","13345017","13345145","42","1002283"
"GL873568","4322030","4322103","chr15","31950704","31950778","12","27628674"
"GL873568","4439574","4439747","chr7","24660013","24660186","53","20220439"
"GL873568","4546898","4547014","chr2","69637433","69637551","24","65090535"
"GL873568","5509331","5509406","chr7","47581693","47581760","23","42072362"
"GL873568","5509687","5509883","chr2","144437381","144437573","45","138927694"
"GL873568","7119774","7119822","chr2","87910132","87910180","8","80790358"
"GL873568","10881797","10881967","chr13","60833525","60833689","46","49951728"
"GL873569","1403943","1404082","chr10","40970605","40970750","49","39566662"
"GL873569","7343422","7343556","chr14","3222012","3222121","53","4121410"
"GL873569","7404564","7404762","chr8","19570503","19570694","45","12165939"
"GL873569","7405040","7405133","chr2","87168340","87168438","31","79763300"
"GL873569","7519122","7519191","chr8","118552016","118552081","12","111032894"
"GL873569","7989158","7989286","chr12","87090592","87090718","32","79101434"
"GL873569","7989575","7989702","chr4","125378489","125378604","47","117388914"
"GL873569","10034363","10034556","chr3","12847405","12847604","56","2813042"
"GL873569","10034830","10034845","chr2","173673524","173673540","1","163638694"
"GL873569","10203815","10203922","chr1","54523219","54523326","32","44319404"
"GL873569","10204196","10204373","chr10","70151175","70151357","46","59946979"
"GL873569","10473375","10473444","chr1","40401275","40401343","17","29927900"
"GL873570","9287350","9287485","chr1","208531450","208531566","32","199244100"
"GL873571","3669989","3670207","chr4","115970580","115970798","55","112300591"
"GL873571","106134","106236","chr8","119852365","119852467","25","119746231"
"GL873571","3670496","3670589","chr5","253912","254003","14","3416584"
"GL873571","4059090","4059389","chr15","40319258","40319581","84","36260168"
"GL873571","4209418","4209704","chr3","42758230","42758522","81","38548812"
"GL873571","4209985","4210154","chr19","18212503","18212660","58","14002518"
"GL873571","4210444","4210570","chr1","144949482","144949616","36","140739038"
"GL873571","4391733","4391878","chr20","12780771","12780923","43","8389038"
"GL873571","6307773","6307841","chr4","25667524","25667578","21","19359751"
"GL873571","6496217","6496306","chr9","43572052","43572133","27","37075835"
"GL873571","6499738","6499903","chr20","16341601","16341759","47","9841863"
"GL873571","11399575","11399872","chr19","24798979","24799288","78","13399404"
"GL873572","114760","114841","chr2","50185829","50185906","17","50071069"
"GL873572","9421791","9421892","chr8","86473576","86473657","33","77051785"
"GL873572","11052834","11053035","chr3","66223025","66223213","63","55170191"
"GL873573","2564195","2564244","chr9","95040409","95040458","13","92476214"
"GL873573","7423371","7423533","chr20","70940503","70940691","59","63517132"
"GL873573","9657648","9657710","chr1","54248664","54248723","17","44591016"
"GL873574","1624662","1624783","chr19","43708988","43709109","33","42084326"
"GL873574","4459477","4459612","chr1","208531450","208531566","31","204071973"
"GL873574","4681987","4682216","chr6","148435389","148435628","73","143753402"
"GL873574","4709916","4710039","chr7","157488100","157488220","37","152778184"
"GL873574","6353839","6353913","chr1","202852169","202852234","23","196498330"
"GL873574","6533061","6533332","chr20","22727608","22727881","78","16194547"
"GL873574","6643746","6643907","chr10","15184675","15184828","42","8540929"
"GL873574","6644163","6644274","chr20","4302778","4302890","17","2341385"
"GL873574","8511822","8512127","chr6","72845672","72845972","80","64333850"
"GL873575","2107336","2107519","chr9","116343364","116343527","55","114236028"
"GL873575","5831824","5831959","chr16","71712943","71713060","31","65881119"
"GL873575","7451097","7451208","chr9","28565055","28565164","24","21113958"
"GL873575","7451277","7451445","chr7","18122347","18122508","40","10671070"
"GL873576","1765109","1765185","chr3","123508792","123508866","13","121743683"
"GL873576","2711577","2711895","chrX","87422702","87423023","84","84711125"
"GL873576","4782520","4782652","chr19","2749266","2749400","21","2033254"
"GL873576","4782930","4783078","chr3","161865114","161865265","35","157082184"
"GL873576","7828709","7828723","chrX","128167859","128167872","1","120339150"
"GL873576","7828960","7829230","chr1","30994506","30994776","83","23165546"
"GL873576","10622840","10623093","chr4","17492814","17493052","77","6869974"
"GL873576","10819939","10820007","chr1","115368785","115368858","17","104548846"
"GL873576","10920306","10920363","chr2","86329384","86329447","17","75409078"
"GL873576","10920398","10920529","chr3","172830358","172830476","31","161909960"
"GL873577","515809","515961","chr17","83113779","83113916","40","82597970"
"GL873577","1633164","1633256","chr10","30838760","30838855","23","29205596"
"GL873577","3979502","3979560","chr1","38676613","38676673","13","34697111"
"GL873577","3979839","3980009","chr20","49895982","49896145","37","45916143"
"GL873577","6050882","6051080","chr8","31623419","31623611","56","25572537"
"GL873577","8463965","8464050","chr18","14213831","14213920","17","5749866"
"GL873577","9471486","9471613","chr19","17973523","17973668","41","8502037"
"GL873577","9471875","9471998","chr3","9010156","9010265","34","461719"
"GL873577","9853150","9853170","chr2","52170688","52170709","2","42317538"
"GL873577","9853206","9853473","chr3","41732593","41732878","67","31879387"
"GL873577","10722415","10722478","chr1","64586680","64586738","25","53864265"
"GL873578","463331","463568","chr10","29017946","29018186","94","28554615"
"GL873578","1143712","1143827","chr19","14221372","14221485","30","13077660"
"GL873578","1144101","1144139","chr1","18271975","18272009","10","17127874"
"GL873578","1144175","1144343","chr6","128487778","128487940","41","127343603"
"GL873578","4593962","4594035","chr12","12450336","12450410","21","7856374"
"GL873578","6158845","6158972","chr1","129487059","129487188","22","123328214"
"GL873578","6159253","6159444","chr2","135220389","135220575","54","129061136"
"GL873578","6766040","6766171","chr1","92937496","92937628","27","86171456"
"GL873578","6766434","6766577","chr17","26784487","26784643","44","20018053"
"GL873578","7397948","7398119","chr1","59646347","59646521","42","52248399"
"GL873578","7398378","7398515","chr1","39722564","39722700","35","32324186"
"GL873579","370235","370429","chr16","33186712","33186919","56","32816477"
"GL873579","370936","371046","chr2","151826413","151826520","31","151455477"
"GL873579","599436","599605","chr8","95140247","95140412","37","94540811"
"GL873579","599942","599953","chr7","132643907","132643917","3","132043965"
"GL873579","600232","600365","chr1","41168354","41168488","26","40568122"
"GL873579","5650320","5650591","chr6","50071900","50072182","75","44421580"
"GL873579","7037162","7037347","chr10","69237413","69237576","64","62200251"
"GL873579","11077764","11077972","chr19","1156613","1156827","64","9921151"
"GL873579","11078245","11078333","chr5","33844027","33844114","24","22765782"
"GL873580","320374","320488","chr8","91413604","91413700","40","91093230"
"GL873580","374969","375091","chr18","68944686","68944810","25","68569717"
"GL873580","375369","375549","chr19","12142467","12142644","41","11767098"
"GL873580","8760922","8761015","chr4","113779088","113779178","20","105018166"
"GL873580","9391260","9391306","chr3","87498102","87498144","11","78106842"
"GL873581","759283","759365","chr20","51253047","51253121","29","50493764"
"GL873581","1145844","1145979","chr1","208531450","208531566","31","207385606"
"GL873581","9628238","9628362","chr19","11371613","11371736","28","1743375"
"GL873582","1580485","1580534","chr6","31688737","31688780","13","30108252"
"GL873582","1644368","1644551","chr5","34105741","34105908","62","32461373"
"GL873582","5794385","5794459","chr1","13843872","13843931","25","8049487"
"GL873583","102645","102683","chr10","67123306","67123342","8","67020661"
"GL873583","6200447","6200560","chr1","208531450","208531566","23","202331003"
"GL873583","6200584","6200752","chr16","50670782","50670948","40","44470198"
"GL873583","10217398","10217583","chr4","129511438","129511621","43","119294040"
"GL873583","10394919","10394983","chr6","105963884","105963948","19","95568965"
"GL873584","521512","521529","chr16","59615589","59615599","8","59094077"
"GL873584","2079725","2079768","chr10","62767155","62767194","10","60687430"
"GL873584","5216877","5217053","chr1","37442539","37442716","48","32225662"
"GL873584","7289930","7289950","chr11","51306797","51306817","7","44016867"
"GL873584","7289975","7290131","chr14","71102832","71102983","38","63812857"
"GL873584","7577743","7577867","JH679811","13496","13612","27","7564247"
"GL873584","7578135","7578289","chr1","129268611","129268763","32","121690476"
"GL873585","1450952","1451121","chr19","10961961","10962126","48","9511009"
"GL873585","1451382","1451515","chr20","4626299","4626435","23","3174917"
"GL873585","1626960","1627026","chr9","91822540","91822610","18","90195580"
"GL873585","1627304","1627531","chr19","4036659","4036899","60","2409355"
"GL873585","3626082","3626158","chr2","186627555","186627618","24","183001473"
"GL873585","8849829","8849913","chr10","52589391","52589473","15","43739562"
"GL873585","9319890","9319971","chr1","40097424","40097510","15","30777534"
"GL873586","895572","895692","chr1","15669518","15669639","38","14773946"
"GL873586","5645995","5646150","chr1","38256225","38256380","34","32610230"
"GL873586","10258686","10258969","chr11","12141928","12142219","82","1883242"
"GL873587","3208032","3208047","chr7","106459860","106459875","1","103251828"
"GL873587","3208141","3208321","chr6","73631715","73631890","57","70423574"
"GL873587","3278260","3278367","chr9","83560701","83560813","38","80282441"
"GL873587","3278673","3278754","chrX","37810049","37810139","24","34531376"
"GL873587","3782076","3782188","chr9","108632507","108632622","29","104850431"
"GL873587","4564996","4565084","chr9","112968371","112968458","11","108403375"
"GL873587","6307870","6308175","chr12","98029299","98029602","52","91721429"
"GL873587","6484004","6484128","chr1","26382827","26382948","29","19898823"
"GL873587","6484407","6484586","chrX","141217486","141217675","42","134733079"
"GL873587","7466229","7466364","chr1","208531450","208531566","33","201065221"
"GL873588","1502535","1502718","chr4","126063964","126064128","60","124561429"
"GL873588","10189037","10189246","chr11","121468036","121468253","61","111278999"
"GL873589","104719","104807","chr5","21121183","21121269","14","21016464"
"GL873589","796766","796905","chr3","125645024","125645150","49","124848258"
"GL873589","1023679","1023690","chr1","181277357","181277368","0","180253678"
"GL873589","1023771","1024047","chr1","139005950","139006233","71","137982179"
"GL873589","4820958","4821024","chr1","181210056","181210121","11","176389098"
"GL873589","6763768","6763857","chr1","30224590","30224675","27","23460822"
"GL873589","8444551","8444632","chr14","100180970","100181051","15","91736419"
"GL873589","9085365","9085494","chr1","151938417","151938532","41","142853052"
"GL873589","9085767","9086002","chr13","88524019","88524244","66","79438252"
"GL873589","9992904","9993045","chr11","8545354","8545490","46","1447550"
"GL873589","9993319","9993452","chr15","13391031","13391164","26","3397712"
"GL873590","9044589","9044884","chr7","130397127","130397427","82","121352538"
"GL873591","1831505","1831587","chr10","31976650","31976736","21","30145145"
"GL873591","2719175","2719275","chr3","55187598","55187680","28","52468423"
"GL873591","4732974","4733120","chr1","96231135","96231271","52","91498161"
"GL873591","6822728","6823009","chr1","24027241","24027526","73","17204513"
"GL873591","7578706","7578813","chr3","173447434","173447535","39","165868728"
"GL873591","9282916","9283004","chr2","132953067","132953157","14","123670151"
"GL873592","835155","835315","chr1","137893030","137893184","43","137057875"
"GL873592","835589","835765","chr19","34408393","34408562","42","33572804"
"GL873592","2520661","2520705","chr10","37277209","37277256","10","34756548"
"GL873592","4535248","4535388","chr15","90493787","90493921","35","85958539"
"GL873592","4535654","4535831","chr19","41304750","41304919","51","36769096"
"GL873592","6794968","6795049","chr1","160257001","160257080","17","153462033"
"GL873592","6881384","6881478","chr5","253912","254003","25","6627472"
"GL873592","6881755","6881937","chr1","139543429","139543620","62","132661674"
"GL873592","7006080","7006155","chr18","4738453","4738526","23","2267627"
"GL873592","8446508","8446655","chr15","96551260","96551402","40","88104752"
"GL873592","8446953","8447008","chr16","73649495","73649545","15","65202542"
"GL873592","8447239","8447325","chr5","137684805","137684899","19","129237566"
"GL873592","8723925","8724000","chr1","21958928","21959004","20","13235003"
"GL873593","384022","384146","chr5","34731496","34731625","27","34347474"
"GL873593","384425","384607","chr10","32970044","32970231","51","32585619"
"GL873593","1408445","1408467","chr16","8716280","8716300","9","7307835"
"GL873593","4856365","4856484","chr11","46626668","46626793","31","41770303"
"GL873593","6661298","6661485","chr6","98876602","98876797","54","92215304"
"GL873593","6710263","6710446","chr14","4160886","4161051","64","2549377"
"GL873593","7159645","7159716","chr7","19811200","19811276","18","12651555"
"GL873593","7159841","7160050","chr10","79427159","79427338","68","72267318"
"GL873593","8598292","8598391","chr20","10130471","10130564","34","1532179"
"GL873594","357249","357377","chr6","151362785","151362909","33","151005536"
"GL873594","357656","357834","chr6","126614981","126615156","52","126257325"
"GL873594","1410711","1410996","chr19","40789062","40789356","76","39378351"
"GL873594","5528090","5528162","chr1","25254343","25254408","23","19726253"
"GL873594","5834047","5834168","chr7","123709847","123709965","26","117875800"
"GL873594","5834396","5834461","chrX","38311976","38312041","16","32477580"
"GL873594","7786130","7786294","chr18","62060844","62061014","34","54274714"
"GL873595","723579","723774","chr1","31133102","31133305","66","30409523"
"GL873595","724114","724204","chr2","86447193","86447285","21","85723079"
"GL873595","1065346","1065667","chr2","62071040","62071351","77","61005694"
"GL873595","1254878","1255146","chr4","6760046","6760321","67","5505168"
"GL873595","3417105","3417297","chr8","12499706","12499895","45","9082601"
"GL873595","6098380","6098457","chr15","78034358","78034433","21","71935978"
"GL873596","134190","134307","chr9","28565055","28565164","30","28430865"
"GL873596","134578","134681","chr9","43579995","43580099","35","43445417"
"GL873596","8160215","8160350","chr16","71712943","71713060","31","63552728"
"GL873596","8421071","8421132","chr10","4618041","4618103","12","3803030"
"GL873598","4416400","4416489","chr9","112968371","112968458","13","108551971"
"GL873598","4416855","4416947","chr16","39810591","39810684","28","35393736"
"GL873598","5126074","5126161","chr20","26717080","26717168","15","21591006"
"GL873598","5467584","5467662","chr4","81010140","81010223","16","75542556"
"GL873598","6917752","6917856","chr2","100398269","100398369","21","93480517"
"GL873598","8078910","8079062","chr16","66492593","66492749","38","58413683"
"GL873598","8079328","8079454","chr4","27358924","27359045","32","19279596"
"GL873599","3943256","3943456","chr1","160595810","160596009","79","156652554"
"GL873599","6693284","6693349","chr8","70203344","70203414","15","63510060"
"GL873600","991618","991705","chr5","21121183","21121269","13","20129565"
"GL873600","8825981","8826014","chr4","6708026","6708059","6","2117955"
"GL873600","8826039","8826157","chr13","84419265","84419383","34","75593226"
"GL873601","269289","269338","chr10","15081578","15081627","9","14812289"
"GL873601","269431","269678","chr9","51808764","51809002","77","51539333"
"GL873601","1397978","1398117","chr9","39547701","39547842","29","38149723"
"GL873601","4065502","4065590","chr4","41490236","41490329","19","37424734"
"GL873601","8241370","8241465","chr13","91066798","91066883","33","82825428"
"GL873601","8832919","8833001","chrX","20945727","20945807","14","12112808"
"GL873602","4114431","4114444","chr1","4461919","4461931","6","347488"
"GL873602","7681392","7681532","chr18","55027223","55027367","39","47345831"
"GL873602","8317059","8317191","chr1","34155070","34155202","34","25838011"
"GL873602","8317486","8317624","chr4","122980561","122980704","33","114663075"
"GL873603","7583710","7583823","chr5","35182128","35182243","35","27598418"
"GL873603","7825198","7825370","chr12","64527511","64527700","64","56702313"
"GL873604","4384060","4384339","chr4","114346226","114346516","71","109962166"
"GL873604","8104833","8104923","chr14","64209608","64209698","16","56104775"
"GL873605","7487180","7487267","chr3","45551770","45551851","28","38064590"
"GL873607","4530471","4530662","chr14","115347940","115348114","72","110817469"
"GL873607","4921649","4921763","JH681052","930027","930144","26","3991622"
"GL873607","4921791","4921951","chr14","63612181","63612349","43","58690390"
"GL873607","6438194","6438319","chr5","49090599","49090723","27","42652405"
"GL873607","6438346","6438509","chr3","169714654","169714821","50","163276308"
"GL873607","7760138","7760228","chr14","55444037","55444123","16","47683899"
"GL873607","8161380","8161487","chr3","125222476","125222578","37","117061096"
"GL873607","8308052","8308151","chr17","68981455","68981556","20","60673403"
"GL873608","759087","759198","chr4","32260888","32260998","22","31501801"
"GL873608","759704","759809","chr7","21373000","21373092","27","20613296"
"GL873608","5572764","5572837","chr2","7847749","7847827","27","2274985"
"GL873608","6353574","6353639","chr5","146751711","146751768","20","140398137"
"GL873610","2023116","2023182","chr2","86329384","86329447","13","84306268"
"GL873610","2023204","2023353","chr3","43650174","43650306","45","41626970"
"GL873610","3030887","3031019","chr7","149287982","149288116","29","146257095"
"GL873610","4097007","4097110","chr9","25197386","25197472","29","21100379"
"GL873610","4097374","4097554","chr1","26744801","26744984","45","22647427"
"GL873610","4218978","4219300","chr1","214573111","214573437","77","210354133"
"GL873610","4301612","4301809","chr7","110718313","110718501","51","106416701"
"GL873610","5220832","5221027","chr10","27510690","27510890","62","22289858"
"GL873610","5221303","5221392","chr11","107927131","107927223","16","102705828"
"GL873610","6516715","6516831","chr2","87773241","87773357","39","81256526"
"GL873610","6516864","6517024","chr1","34362534","34362691","44","27845670"
"GL873611","660692","660881","chr3","37646606","37646767","67","36985914"
"GL873611","990082","990383","chr3","173191956","173192270","91","172201874"
"GL873611","1096593","1096668","chr2","85503172","85503243","20","84406579"
"GL873611","3832682","3832842","chr3","146200815","146200979","50","142368133"
"GL873611","3833140","3833159","chr2","169497672","169497690","5","165664532"
"GL873611","4580539","4580748","chr18","535338","535549","60","4045201"
"GL873611","4581033","4581069","chr11","97671601","97671637","0","93090568"
"GL873611","4917264","4917440","chr3","87450447","87450618","49","82533183"
"GL873611","4917503","4917682","chr19","627320","627493","39","4290183"
"GL873611","5321260","5321397","chr11","47357714","47357847","28","42036454"
"GL873611","5321658","5321822","chr19","10961961","10962126","42","5640303"
"GL873611","6125065","6125194","chr20","67036080","67036212","26","60911015"
"GL873611","6125474","6125654","chr17","75962645","75962805","51","69837171"
"GL873612","1574408","1574509","chr2","104895934","104896026","29","103321526"
"GL873612","5650696","5650760","chr1","109739573","109739640","20","104088877"
"GL873612","6083324","6083402","chr12","12450336","12450410","15","6367012"
"GL873613","988798","988862","chr13","125304907","125304973","15","124316109"
"GL873613","2683112","2683228","chr5","71603584","71603705","30","68920472"
"GL873613","2975861","2976041","chr14","11120816","11120995","51","8144955"
"GL873613","2976320","2976445","chr19","465166","465290","32","2511154"
"GL873613","3306364","3306424","chr20","24429894","24429960","18","21123530"
"GL873613","3389217","3389227","chr2","102144853","102144864","1","98755636"
"GL873613","3389500","3389785","chr1","43334268","43334560","84","39944768"
"GL873613","3964880","3964944","chr10","82727770","82727838","16","78762890"
"GL873613","5990398","5990466","chr1","109739573","109739640","12","103749175"
"GL873613","6975924","6976102","chr1","124353606","124353784","41","117377682"
"GL873613","6976690","6976816","chr1","15831479","15831608","25","8854789"
"GL873615","362664","362934","chr1","189307390","189307672","67","188944726"
"GL873615","393853","393889","chr6","102430888","102430919","12","102037035"
"GL873615","1595021","1595200","chr1","161601175","161601339","56","160006154"
"GL873615","1758834","1758921","chr4","27439188","27439273","26","25680354"
"GL873615","5518357","5518540","chr10","25707917","25708101","53","20189560"
"GL873615","5518796","5518926","chr20","23037552","23037682","30","17518756"
"GL873615","6584897","6585029","chr13","23437478","23437612","20","16852581"
"GL873615","6585307","6585469","chrX","107246569","107246723","45","100661262"
"GL873615","7184221","7184302","chr15","41719427","41719513","24","34535206"
"GL873615","7184562","7184579","chr6","125904378","125904393","4","118719816"
"GL873615","7555991","7556188","chr14","17977129","17977314","54","10421138"
"GL873615","7556445","7556538","chr14","11392828","11392921","15","3836383"
"GL873616","1105621","1105703","chr6","126896491","126896574","26","125790870"
"GL873616","5739227","5739362","chr1","208531450","208531566","33","202792223"
"GL873617","5627146","5627230","chr3","46805844","46805931","17","41178698"
"GL873617","6683239","6683452","chr1","141753623","141753864","68","135070384"
"GL873617","6683710","6683786","chr19","13926003","13926075","25","7242293"
"GL873618","114510","114690","chr11","124659481","124659661","40","124544971"
"GL873618","114966","115096","chr19","41776907","41777030","28","41661941"
"GL873618","2048878","2049000","chr16","22231657","22231783","28","20182779"
"GL873618","2049273","2049433","chr4","162195716","162195870","46","160146443"
"GL873618","2766139","2766220","chr14","55444037","55444123","19","52677898"
"GL873618","7609915","7609997","chr4","164457670","164457753","17","156847755"
"GL873619","5720374","5720428","chr15","92694751","92694800","11","86974377"
"GL873619","6197449","6197547","chr16","67780019","67780117","27","61582570"
"GL873619","6197819","6198027","chr2","32905120","32905331","59","26707301"
"GL873619","6911975","6912061","chr1","75382776","75382863","26","68470801"
"GL873619","7009092","7009355","chr3","53756550","53756822","55","46747458"
"GL873619","7009635","7009674","chr16","40195974","40196015","9","33186339"
"GL873619","7034707","7034776","chr12","37297392","37297465","21","30262685"
"GL873619","7034804","7035022","chr10","71326274","71326501","60","64291470"
"GL873619","7396564","7396686","chr8","115014048","115014176","33","107617484"
"GL873619","7396953","7397115","chr2","113089695","113089857","36","105692742"
"GL873620","2132612","2132750","chr7","117647887","117648027","31","115515275"
"GL873620","3211415","3211551","chr2","69637433","69637551","36","66426018"
"GL873620","6088801","6088869","chr4","102859881","102859951","9","96771080"
"GL873620","6681752","6681941","chr1","161861875","161862041","65","155180123"
"GL873620","6681964","6682075","chr7","8290536","8290656","23","1608572"
"GL873620","7386769","7386849","chr10","30282647","30282735","29","22895878"
"GL873621","762446","762744","chr7","8350363","8350667","79","7587917"
"GL873621","2248674","2248948","chr2","177108529","177108789","78","174859855"
"GL873621","5323338","5323587","chr20","27474818","27475049","68","22151480"
"GL873622","2212371","2212514","chr18","41876896","41877038","33","39664525"
"GL873623","695793","695977","chr1","134936116","134936303","64","134240323"
"GL873623","696195","696302","chr1","64318466","64318567","27","63622271"
"GL873623","832483","832797","chr15","85054719","85055019","89","84222236"
"GL873623","5877229","5877433","chrX","7955588","7955803","61","2078359"
"GL873624","733562","733744","chr10","64852015","64852187","48","64118453"
"GL873624","734008","734020","chr2","88302162","88302174","6","87568154"
"GL873624","734299","734434","chr10","85072878","85073011","32","84338579"
"GL873624","1333855","1334173","chr5","41392742","41393059","81","40058887"
"GL873624","1436296","1436353","chr2","180810984","180811040","13","179374688"
"GL873624","4217965","4218191","chr1","93906791","93907002","58","89688826"
"GL873624","4314365","4314588","chr15","107140511","107140731","71","102826146"
"GL873624","5838209","5838390","chr10","70151175","70151357","39","64312966"
"GL873624","5838482","5838497","chr1","46781820","46781834","1","40943338"
"GL873625","27057","27239","chr10","79047545","79047718","52","79020488"
"GL873625","1726559","1726754","chr14","17977129","17977314","56","16250570"
"GL873625","1727327","1727422","chr19","10583473","10583567","27","8856146"
"GL873625","2097611","2097704","chr3","130114055","130114124","32","128016444"
"GL873625","3489670","3489813","chr7","78181591","78181737","29","74691921"
"GL873625","3490086","3490244","chr4","84776354","84776522","51","81286268"
"GL873626","2083367","2083571","chr2","172997114","172997300","63","170913747"
"GL873627","873608","873698","chr12","69803357","69803441","22","68929749"
"GL873627","873792","874000","chr1","155756917","155757125","56","154883125"
"GL873628","1908662","1908712","chr13","41474018","41474070","10","39565356"
"GL873628","6511135","6511221","chrX","103746481","103746572","16","97235346"
"GL873629","3052885","3053164","chr19","3046027","3046313","63","6858"
"GL873629","3053199","3053215","chr8","39695710","39695725","1","36642511"
"GL873630","2323246","2323332","chr14","23016559","23016647","22","20693313"
"GL873630","5511093","5511148","chr9","42657568","42657623","16","37146475"
"GL873630","5933457","5933511","chr15","56414484","56414534","13","50481027"
"GL873631","884305","884628","chr9","101838392","101838722","103","100954087"
"GL873631","1602291","1602343","chr10","78732660","78732717","16","77130369"
"GL873631","2906888","2907191","chr7","41867657","41867960","75","38960769"
"GL873631","2960939","2961075","chr16","71712943","71713060","35","68752004"
"GL873631","5220812","5220952","chr16","71712943","71713060","36","66492131"
"GL873632","2294969","2295304","chr4","69075168","69075488","97","66780199"
"GL873632","3147982","3148060","chr8","120069785","120069861","17","116921803"
"GL873632","5785295","5785366","chr9","91745813","91745888","15","85960518"
"GL873633","3072299","3072445","chr19","8833357","8833505","42","5761058"
"GL873633","3072469","3072601","chr20","31358967","31359090","29","28286498"
"GL873633","5124360","5124473","chr5","20455873","20455966","41","15331513"
"GL873633","6752210","6752381","chr2","187068919","187069092","46","180316709"
"GL873633","6752659","6752675","chr2","81246987","81247004","3","74494328"
"GL873634","910338","910440","chr1","9373350","9373452","23","8463012"
"GL873634","2163394","2163472","chr12","8050327","8050397","25","5886933"
"GL873634","3197023","3197103","chr6","143461433","143461520","17","140264410"
"GL873634","4312090","4312192","chr7","126789785","126789883","29","122477695"
"GL873634","5058331","5058464","chr16","11875492","11875611","48","6817161"
"GL873634","6906994","6907102","chr3","42174419","42174527","37","35267425"
"GL873635","832511","832657","chr14","5356429","5356573","46","4523918"
"GL873635","1371727","1372001","chr11","64178049","64178325","74","62806322"
"GL873635","1372229","1372242","chr2","186885640","186885653","0","185513411"
"GL873635","4238154","4238252","chr3","45504737","45504825","28","41266583"
"GL873635","5053485","5053621","chr2","69637433","69637551","33","64583948"
"GL873635","5391089","5391295","chr14","92359751","92359961","67","86968662"
"GL873635","5391552","5391629","chr2","147145863","147145938","22","141754311"
"GL873636","35768","35854","chr6","126896491","126896574","19","126860723"
"GL873637","960892","960978","chr15","105500001","105500090","20","104539109"
"GL873637","977830","978089","chr11","121989677","121989946","76","121011847"
"GL873637","1657184","1657450","chr8","126339506","126339777","67","124682322"
"GL873637","1715157","1715213","chr1","137960943","137960997","12","136245786"
"GL873637","2517076","2517206","chr2","85467707","85467841","31","82950631"
"GL873637","2517463","2517555","chr10","30838760","30838855","22","28321297"
"GL873638","4357011","4357114","chr4","2829236","2829344","22","1527775"
"GL873638","6338249","6338304","chr6","170555009","170555061","19","164216760"
"GL873639","201121","201280","chr2","69637582","69637742","48","69436461"
"GL873639","2218604","2218690","chr7","64790978","64791064","12","62572374"
"GL873639","2218953","2219149","chr1","128204274","128204460","64","125985321"
"GL873640","6027288","6027423","chr1","208531450","208531566","35","202504162"
"GL873641","2168012","2168139","chr2","85523042","85523171","32","83355030"
"GL873642","2035055","2035360","chr10","76853706","76854028","78","74818651"
"GL873643","922557","922611","chr19","9012426","9012479","14","8089869"
"GL873644","457449","457637","chr11","109681884","109682081","57","109224435"
"GL873644","457905","458015","chr6","165698871","165698981","30","165240966"
"GL873644","472572","472670","chr2","12051770","12051862","22","11579198"
"GL873644","472929","473136","chr13","118800649","118800851","71","118327720"
"GL873644","1151404","1151535","chr16","29630494","29630628","23","28479090"
"GL873644","1440815","1440851","chr1","114537307","114537344","7","113096492"
"GL873644","1441100","1441375","chr4","110990679","110990953","79","109549579"
"GL873645","373550","373635","chr12","21658519","21658604","17","21284969"
"GL873645","5998486","5998621","chr1","208531450","208531566","32","202532964"
"GL873646","2273809","2273935","chr3","38342903","38343023","47","36069094"
"GL873646","2292397","2292499","chr1","139282417","139282517","29","136990020"
"GL873646","2292768","2292982","chr2","86429482","86429700","56","84136714"
"GL873646","2962368","2962465","chr17","19320679","19320758","34","16358311"
"GL873646","3448475","3448523","chr8","94410722","94410768","11","90962247"
"GL873646","3450178","3450360","chr1","11740598","11740776","49","8290420"
"GL873646","3450636","3450759","chr3","11444400","11444523","26","7993764"
"GL873646","3787679","3787771","chr2","147178244","147178322","27","143390565"
"GL873646","5586518","5586659","chr12","69630585","69630722","30","64044067"
"GL873647","4628214","4628381","chr19","39748801","39748971","39","35120587"
"GL873647","4628659","4628788","chr19","7148331","7148462","34","2519672"
"GL873647","4941409","4941571","chr2","53178059","53178219","47","48236650"
"GL873647","4941811","4941944","chr1","47343273","47343405","31","42401462"
"GL873648","305542","305610","chr18","51749880","51749950","11","51444338"
"GL873648","3191630","3191723","chr2","86447193","86447285","26","83255563"
"GL873649","2727984","2728056","chr4","34406120","34406187","20","31678136"
"GL873649","3506062","3506125","chr11","29013850","29013911","16","25507788"
"GL873651","1259897","1259926","chr5","135587967","135587993","12","134328070"
"GL873651","1259960","1260084","chr5","50275897","50276022","30","49015937"
"GL873652","1189494","1189823","chr1","128278625","128278962","89","127089131"
"GL873653","559397","559534","chr11","121653287","121653416","48","121093890"
"GL873653","3402427","3402466","chr13","31373025","31373063","4","27970598"
"GL873653","3717210","3717222","chr19","31668753","31668765","2","27951543"
"GL873653","4089717","4089811","chr1","139478117","139478204","37","135388400"
"GL873653","4089865","4089913","chr8","36209839","36209884","14","32119974"
"GL873653","5502576","5502648","chr1","40401275","40401343","15","34898699"
"GL873654","698907","699045","chr16","17893033","17893176","30","17194126"
"GL873654","1197054","1197185","chr16","66967110","66967244","19","65770056"
"GL873654","1197463","1197635","chr19","6513495","6513664","38","5316032"
"GL873654","4392337","4392517","chr12","98642013","98642186","59","94249676"
"GL873654","4393012","4393141","chr8","90449268","90449403","21","86056256"
"GL873655","2092008","2092099","chr8","33560457","33560545","30","31468449"
"GL873655","2430121","2430236","chr2","69637433","69637551","21","67207312"
"GL873655","2430262","2430421","chr7","159000039","159000207","37","156569777"
"GL873656","2577535","2577646","chr10","5332923","5333038","32","2755388"
"GL873656","2583668","2583793","chr5","85583932","85584050","34","83000264"
"GL873659","653917","654104","chr11","131126557","131126756","52","130472640"
"GL873659","654381","654472","chr12","39097711","39097788","29","38443330"
"GL873659","1636589","1636693","chr11","117463839","117463940","20","115827250"
"GL873659","1636969","1637139","chr19","18212503","18212660","57","16575534"
"GL873659","1700222","1700321","chr19","7623912","7624012","26","5923690"
"GL873659","1700599","1700787","chr19","10570727","10570916","45","8870128"
"GL873659","1918710","1918798","chr3","42244561","42244647","22","40325851"
"GL873659","2000913","2001099","chr18","38529095","38529291","60","36528182"
"GL873659","2001355","2001426","chr5","114089167","114089234","20","112087812"
"GL873659","3686128","3686230","chr4","161318323","161318421","26","157632195"
"GL873659","3703211","3703392","chr2","87497262","87497430","65","83794051"
"GL873659","3703674","3703765","chr11","107927131","107927223","16","104223457"
"GL873660","2728281","2728366","chr1","130102001","130102092","18","127373720"
"GL873660","2754670","2754759","chr9","97110002","97110092","18","94355332"
"GL873661","665008","665042","chr19","41967391","41967426","10","41302383"
"GL873661","2087348","2087544","chr13","39849466","39849644","60","37762118"
"GL873661","2087817","2087908","chr15","68409154","68409244","21","66321337"
"GL873661","3133888","3134183","chr3","10317897","10318193","73","7184009"
"GL873662","2618520","2618594","chr2","50185829","50185906","12","47567309"
"GL873663","234405","234662","chr7","52538999","52539263","69","52304594"
"GL873663","382081","382205","chr2","100447419","100447531","36","100065338"
"GL873663","382478","382632","chr10","14250471","14250626","39","13867993"
"GL873663","857244","857321","chr4","161602339","161602424","23","160745095"
"GL873663","2563317","2563485","chr3","9224559","9224726","38","6661242"
"GL873663","2563762","2563892","chr6","125881493","125881625","36","123317731"
"GL873663","4157746","4157910","chr12","94797570","94797736","36","90639824"
"GL873663","4158189","4158312","chr4","83005997","83006126","29","78847808"
"GL873664","1662097","1662159","chr2","86329384","86329447","16","84667287"
"GL873664","1662185","1662313","chr14","110927576","110927698","30","109265391"
"GL873664","3094603","3094737","chr15","5080368","5080503","28","1985765"
"GL873664","3095006","3095188","chr9","56575933","56576111","37","53480927"
"GL873664","3115796","3116008","chr5","1999791","2000000","53","1116005"
"GL873664","3116323","3116434","chr9","83561115","83561225","26","80444792"
"GL873664","4682515","4682565","chr7","130809967","130810017","13","126127452"
"GL873665","2989600","2989826","chr20","11062356","11062584","73","8072756"
"GL873665","3453554","3453615","chr11","1656153","1656214","15","1797401"
"GL873665","3453647","3453778","chr10","7678896","7679011","39","4225249"
"GL873665","3681141","3681233","chr9","25197386","25197472","22","21516245"
"GL873665","3681504","3681645","chr6","51767406","51767546","41","48085902"
"GL873665","4243437","4243527","chr17","24677719","24677809","16","20434282"
"GL873665","4351538","4351677","chr4","30997508","30997655","37","26645970"
"GL873666","961546","961638","chr11","107927131","107927223","18","106965585"
"GL873666","961899","962100","chr3","34888860","34889067","62","33926961"
"GL873666","1922354","1922406","chr10","86299217","86299267","14","84376863"
"GL873666","1922438","1922484","chr8","109370434","109370480","12","107447996"
"GL873666","3817822","3818062","chr10","69303717","69303962","78","65485895"
"GL873667","815056","815101","chr10","37277209","37277256","10","36462153"
"GL873667","822597","822846","chr7","52538999","52539263","75","51716402"
"GL873667","823130","823159","chr14","55610352","55610383","4","54787222"
"GL873667","1581004","1581081","chr1","40401275","40401343","22","38820271"
"GL873667","2885396","2885485","chr7","115049086","115049177","14","112163690"
"GL873667","4181529","4181698","chr16","13886840","13887006","52","9705311"
"GL873668","1063182","1063238","chr4","105610122","105610181","12","104546940"
"GL873668","1621238","1621360","chr7","156494200","156494314","37","154872962"
"GL873670","210289","210387","chr9","57502904","57502989","34","57292615"
"GL873670","210468","210652","chr3","109854567","109854759","45","109644099"
"GL873670","722431","722508","chr14","6226201","6226277","10","5503770"
"GL873670","1317098","1317184","chrX","37810049","37810139","23","36492951"
"GL873670","1936852","1936920","chr3","151585709","151585776","14","149648857"
"GL873671","148787","148890","chr19","49947588","49947683","35","49798801"
"GL873671","184807","184899","chr7","26532930","26533025","18","26348123"
"GL873671","185180","185382","chr20","49536591","49536780","59","49351411"
"GL873671","1776874","1777015","chr16","70214772","70214912","35","68437898"
"GL873671","1777288","1777421","chr6","65780698","65780835","27","64003410"
"GL873671","2452220","2452329","chr12","59230742","59230855","25","56778522"
"GL873671","2452602","2452791","chr2","112924836","112925014","57","110472234"
"GL873671","2488332","2488633","chr7","8349756","8350060","81","5861424"
"GL873671","3634599","3634900","chrX","44460582","44460887","67","40825983"
"GL873672","1218176","1218189","chr10","78208802","78208815","5","76990626"
"GL873672","1790447","1790479","chr1","116241873","116241899","7","114451426"
"GL873672","4414072","4414166","chr6","10959167","10959248","27","6545095"
"GL873673","744620","744936","chrX","20148534","20148860","75","19403914"
"GL873673","2711885","2712008","chr5","158051224","158051352","41","155339339"
"GL873673","2946576","2946724","chr12","33329964","33330114","41","30383388"
"GL873674","793724","793853","chr12","95160827","95160960","34","94367103"
"GL873674","794130","794284","chr13","92525925","92526084","36","91731795"
"GL873674","1929506","1929619","chr3","42174419","42174527","36","40244913"
"GL873674","2182150","2182250","chr18","49825654","49825737","32","47643504"
"GL873674","3216008","3216133","chr20","2184129","2184254","33","1031879"
"GL873674","3216410","3216576","chr19","18212503","18212660","47","14996093"
"GL873674","4028524","4028692","chr2","183542251","183542420","43","179513727"
"GL873674","4028733","4028850","chr11","83880333","83880448","25","79851600"
"GL873675","234218","234368","chr15","66352529","66352660","56","66118311"
"GL873675","1145968","1146047","chr20","69099112","69099187","16","67953144"
"GL873675","2029211","2029398","chr1","117831649","117831847","56","115802438"
"GL873675","2029675","2029783","chr3","13049864","13049969","20","11020189"
"GL873675","2737900","2737963","chr7","63008373","63008425","19","60270473"
"GL873675","2837727","2837808","chr9","43572052","43572133","18","40734325"
"GL873675","3964603","3964737","chr12","80350073","80350208","34","76385470"
"GL873675","3965013","3965144","chr1","3134242","3134371","28","830771"
"GL873675","4096808","4096887","chr3","123508792","123508866","17","119411984"
"GL873676","4173503","4173768","chrX","24232871","24233119","92","20059368"
"GL873677","985851","986131","chr1","158619621","158619875","91","157633770"
"GL873677","3442176","3442254","chr5","62482357","62482439","12","59040181"
"GL873677","3759059","3759127","chr4","102859881","102859951","10","99100822"
"GL873678","659043","659100","chr11","30966763","30966823","13","30307720"
"GL873678","840543","840797","chr4","107477472","107477735","83","106636929"
"GL873679","750910","750991","chr10","82963809","82963883","21","82212899"
"GL873679","811454","811572","chr20","26210601","26210718","39","25399147"
"GL873680","2478342","2478819","chr1","74601486","74601836","216","72123144"
"GL873680","2478820","2478880","chr9","12208861","12208916","18","9730041"
"GL873680","2921533","2921617","chr4","83107716","83107799","26","80186183"
"GL873680","3692596","3692677","chr2","83126368","83126448","27","79433772"
"GL873681","424706","424895","chr1","39761610","39761801","44","39336904"
"GL873681","425172","425281","chr16","59792293","59792402","37","59367121"
"GL873682","1284846","1284975","chr19","7148331","7148462","24","5863485"
"GL873682","1285261","1285471","chr4","34064924","34065130","78","32779663"
"GL873682","1779366","1779496","chr11","47357714","47357847","24","45578348"
"GL873682","1923127","1923290","chr10","83362932","83363097","39","81439805"
"GL873682","3131143","3131278","chr6","163952707","163952826","32","160821564"
"GL873684","1630515","1630787","chr14","8347332","8347613","69","6716817"
"GL873685","93336","93422","chr5","21121183","21121269","18","21027847"
"GL873685","776423","776691","chr6","39188890","39189174","76","38412467"
"GL873685","1039308","1039620","chr4","31203023","31203346","77","30163715"
"GL873685","2340757","2340916","chr1","121772254","121772399","50","119431497"
"GL873685","2981741","2981863","chr2","40255140","40255269","26","37273399"
"GL873685","3262694","3262746","chr4","30936986","30937035","8","27674292"
"GL873685","3262774","3262991","chr6","133225789","133226019","66","129963015"
"GL873685","3513127","3513200","chr15","98006235","98006304","23","94493108"
"GL873685","3513488","3513549","chr6","127830448","127830507","15","124316960"
"GL873686","487966","488254","chr16","41087866","41088157","63","40599900"
"GL873686","3386340","3386475","chr1","208531450","208531566","33","205145110"
"GL873686","3455727","3455885","chr1","15825072","15825238","46","12369345"
"GL873686","3455907","3455935","chr9","89315795","89315824","5","85859888"
"GL873686","3664491","3664569","chr4","135516605","135516690","17","131852114"
"GL873686","3758207","3758296","chr8","86473576","86473657","30","82715369"
"GL873687","3586004","3586314","chr11","103315243","103315536","115","99729239"
"GL873688","1950733","1950799","chr8","120596296","120596361","18","118645563"
"GL873688","3017619","3017721","chr17","71123059","71123156","27","68105440"
"GL873689","240824","240909","chr7","64790978","64791064","18","64550154"
"GL873689","3418491","3418535","chr9","66403123","66403165","8","62984632"
"GL873690","522024","522170","chr3","121994426","121994576","34","121472402"
"GL873690","1024771","1024906","chr15","7970879","7971014","31","6946108"
"GL873690","1024930","1025114","chr10","60558101","60558278","54","59533171"
"GL873690","1724716","1724878","chr7","150895265","150895431","43","149170549"
"GL873690","1725140","1725243","chr2","86396173","86396281","31","84671033"
"GL873691","1439513","1439648","chr2","101691451","101691570","35","100251938"
"GL873691","2130062","2130118","chr2","82169064","82169118","16","80039002"
"GL873692","1781354","1781548","chr19","48536164","48536370","53","46754810"
"GL873692","2411629","2411751","chr4","42760094","42760227","32","40348465"
"GL873692","2412027","2412186","chr12","80834114","80834268","40","78422087"
"GL873695","2103544","2103634","chr3","45926435","45926527","26","43822891"
"GL873696","445612","445738","chr7","41879573","41879703","40","41433961"
"GL873696","2173585","2173768","chr19","7642961","7643111","64","5469376"
"GL873696","2173789","2173937","chr15","5868882","5869031","32","3695093"
"GL873698","915825","915952","chr11","46029011","46029140","23","45113186"
"GL873698","916208","916262","chr9","95040409","95040458","17","94124201"
"GL873699","1713532","1713595","chr3","168528801","168528853","21","166815269"
"GL873700","955119","955209","chr13","85846711","85846796","26","84891592"
"GL873700","1211648","1211827","chr16","53242272","53242447","55","52030624"
"GL873700","1752223","1752359","chr16","46831781","46831916","30","45079558"
"GL873700","1752634","1752795","chr14","9238456","9238614","48","7485822"
"GL873701","873579","873644","chr8","118552016","118552081","15","117678437"
"GL873701","2734824","2734949","chr5","159737616","159737746","24","157002792"
"GL873702","365484","365737","chr13","45674553","45674835","80","45309069"
"GL873702","365785","365797","chr5","167365662","167365673","2","166999877"
"GL873703","466916","466996","chr10","79317980","79318056","25","78851064"
"GL873703","668567","668631","chr17","75958529","75958576","23","75289962"
"GL873703","894337","894598","chr11","121989677","121989946","64","121095340"
"GL873704","975732","975864","chr19","49393250","49393384","23","48417518"
"GL873704","976148","976303","chr10","30528380","30528526","36","29552232"
"GL873704","2365440","2365563","chr2","62275340","62275449","44","59909900"
"GL873704","2555104","2555313","chr6","125385882","125386092","50","122830778"
"GL873704","2555852","2555937","chr14","77922237","77922318","25","75366385"
"GL873704","2615936","2616021","chrX","39751243","39751326","19","37135307"
"GL873705","472387","472522","chr1","208531450","208531566","33","208059063"
"GL873705","2300698","2300803","chr1","40097424","40097510","39","37796726"
"GL873708","613936","614007","chr17","98153","98227","20","515783"
"GL873708","1337972","1338106","chr11","83880333","83880448","32","82542361"
"GL873708","1540068","1540109","chr14","38430078","38430120","9","36890010"
"GL873709","1312189","1312214","chr7","117192187","117192208","5","115879998"
"GL873709","1312246","1312489","chr15","9293301","9293555","70","7981055"
"GL873709","2885292","2885366","chr20","69099112","69099187","16","66213820"
"GL873709","2885623","2885647","chr7","142058261","142058283","10","139172638"
"GL873710","308956","309053","chr6","160516627","160516713","31","160207671"
"GL873710","1019330","1019441","chr2","64476382","64476498","25","63457052"
"GL873710","1023490","1023644","chr7","1171468","1171624","37","147978"
"GL873710","1023896","1023998","chr1","3201534","3201645","26","2177638"
"GL873711","2304001","2304206","chr2","149186496","149186714","57","146882495"
"GL873712","1241417","1241675","chr1","152292768","152293017","82","151051351"
"GL873712","1835219","1835365","chr19","49393250","49393384","45","47558031"
"GL873712","2289190","2289439","chr1","141753623","141753864","71","139464433"
"GL873713","210888","210969","chr18","46331762","46331849","22","46120874"
"GL873715","2471697","2471880","chr3","41847862","41848049","52","39376165"
"GL873715","2472148","2472235","chr16","5585916","5585997","27","3113768"
"GL873715","2472515","2472579","chr2","82023843","82023905","15","79551328"
"GL873716","136917","136983","chr12","568593","568654","15","431676"
"GL873716","2042224","2042302","chr9","61331969","61332049","16","59289745"
"GL873720","1004433","1004565","chr15","62914932","62915064","46","61910499"
"GL873720","2089962","2090022","chr11","46824532","46824594","8","44734570"
"GL873721","334858","335069","chr1","42049969","42050184","61","41715111"
"GL873721","335350","335445","chr5","154286576","154286671","22","153951226"
"GL873721","486591","486909","chr17","1675391","1675699","93","1188800"
"GL873721","1359069","1359214","chr11","117513163","117513317","46","116154094"
"GL873721","1359463","1359601","chr16","4172685","4172822","38","2813222"
"GL873722","557653","557757","chr7","64450756","64450858","22","63893103"
"GL873724","147737","147822","chr11","8677365","8677451","13","8529628"
"GL873726","212615","212750","chr5","121978469","121978592","32","121765854"
"GL873728","898427","898520","chr11","63555218","63555310","28","62656791"
"GL873728","2220252","2220351","chr18","42701490","42701588","26","40481238"
"GL873729","118907","118959","chr3","70695265","70695313","17","70576358"
"GL873729","151731","151829","chr12","80278932","80279022","34","80127201"
"GL873729","246454","246491","chr8","28295899","28295934","3","28049445"
"GL873729","396404","396651","chr11","83251060","83251310","102","82854656"
"GL873729","641303","641382","chr14","7445054","7445136","17","6803751"
"GL873729","693348","693472","chr12","16056959","16057079","42","15363611"
"GL873729","697330","697385","chr12","40003490","40003547","11","39306160"
"GL873729","1163202","1163443","chr16","21619689","21619929","80","20456487"
"GL873729","1163538","1163548","chr1","33382389","33382399","1","32218851"
"GL873729","1573752","1573932","chr1","39647192","39647375","47","38073440"
"GL873729","1574212","1574234","chr19","43316899","43316923","5","41742687"
"GL873730","128666","128804","chr1","23627020","23627154","31","23498354"
"GL873730","129065","129236","chr16","4769255","4769421","36","4640190"
"GL873730","1187605","1187681","chr16","10026196","10026270","11","8838591"
"GL873730","2189208","2189313","chr3","160070411","160070516","35","157881203"
"GL873730","2189590","2189768","chr6","120473102","120473295","55","118283512"
"GL873730","2289627","2289718","chr11","76609953","76610044","17","74320326"
"GL873731","247292","247471","chr5","141243016","141243195","44","140995724"
"GL873731","247740","247871","chr1","53568371","53568506","26","53320631"
"GL873731","800931","801254","chr10","25788170","25788492","80","24987239"
"GL873731","1749678","1749749","chr7","47581693","47581760","20","45832015"
"GL873732","636887","636976","chr3","41353255","41353333","32","40716368"
"GL873732","2013043","2013117","chr1","54917065","54917140","23","52904022"
"GL873733","1444629","1444738","chr7","156494200","156494314","24","155049571"
"GL873733","1445022","1445182","chr9","34578489","34578655","41","33133467"
"GL873735","1321581","1321682","chr19","8077244","8077351","30","6755663"
"GL873735","1562236","1562298","chr7","64685959","64686012","18","63123723"
"GL873735","2167683","2167814","chr10","29468929","29469066","40","27301246"
"GL873735","2167835","2167979","chr7","80807660","80807810","42","78639825"
"GL873735","2168067","2168084","chr7","113108259","113108276","3","110940192"
"GL873737","796020","796273","chr8","96701830","96702077","60","95905810"
"GL873737","946083","946212","chr1","41168354","41168488","23","40222271"
"GL873737","1307283","1307418","chr10","83342427","83342567","28","82035144"
"GL873737","1307677","1307826","chr1","26955414","26955566","45","25647737"
"GL873737","1543972","1544071","chr10","72880185","72880268","30","71336213"
"GL873738","439790","439925","chr6","65742019","65742137","35","65302229"
"GL873739","1113156","1113228","chr6","116753833","116753910","17","115640677"
"GL873739","1137574","1137685","chr16","73977278","73977394","24","72839704"
"GL873739","1191028","1191090","chr1","6601997","6602059","17","5410969"
"GL873739","1191362","1191617","chr2","17611811","17612064","64","16420449"
"GL873740","1301448","1301527","chr6","160516627","160516713","17","159215179"
"GL873740","1538810","1538906","chr3","9044658","9044749","24","7505848"
"GL873740","1539000","1539241","chr13","19217981","19218221","71","17678981"
"GL873741","75049","75065","chr6","78721694","78721711","1","78646645"
"GL873741","75089","75362","chr14","119976201","119976474","76","119901112"
"GL873741","258118","258197","chr3","55081313","55081388","17","54823195"
"GL873744","537658","537725","chr10","69237143","69237204","15","68699485"
"GL873744","977530","977628","chr1","139282417","139282517","28","138304887"
"GL873744","977723","977932","chr6","125385882","125386092","54","124408159"
"GL873750","212603","212679","chr8","14112472","14112544","28","13899869"
"GL873750","285341","285490","chr3","69541544","69541689","55","69256203"
"GL873752","174373","174460","chr14","4547980","4548066","14","4373607"
"GL873752","1794475","1794773","chr4","153709905","153710206","79","151915430"
"GL873754","303386","303647","chr1","39334463","39334733","69","39031077"
"GL873754","338120","338177","chr10","28983002","28983052","16","28644882"
"GL873757","248328","248417","chr4","17641880","17641964","27","17393552"
"GL873757","248699","248882","chr4","71137445","71137629","53","70888746"
"GL873758","228031","228106","chr10","81294606","81294684","20","81066575"
"GL873758","375077","375369","chr14","92001213","92001506","106","91626136"
"GL873760","412311","412436","chr6","143041459","143041586","25","142629148"
"GL873760","412712","412891","chrX","141393116","141393295","42","140980404"
"GL873761","1582598","1582785","chr11","6005552","6005719","56","4422954"
"GL873762","534710","534777","chr8","118552016","118552081","14","118017306"
"GL873762","535036","535157","chr6","158211375","158211499","32","157676339"
"GL873763","1499649","1499775","chr16","7962819","7962949","27","6463170"
"GL873763","1637628","1637804","chr7","43309560","43309751","55","41671932"
"GL873764","1517287","1517419","chr9","89177160","89177295","22","87659873"
"GL873764","1517671","1517852","chrX","109206414","109206603","48","107688743"
"GL873766","1294478","1294613","chr19","33670293","33670408","34","32375815"
"GL873768","1459582","1459709","chr3","38969881","38970014","43","37510299"
"GL873770","84435","84515","chr12","5657997","5658082","19","5573562"
"GL873770","494962","495051","chrX","23655730","23655820","14","23160768"
"GL873770","720442","720573","chr1","31059403","31059538","22","30338961"
"GL873774","1154945","1155059","chr8","95477852","95477949","40","94322907"
"GL873776","579233","579311","chr16","48351972","48352047","15","47772739"
"GL873778","247266","247401","chr2","69637433","69637551","34","69390167"
"GL873779","187946","188018","chr5","114089167","114089234","19","113901221"
"GL873779","1059255","1059336","chr7","15398470","15398551","10","14339215"
"GL873779","1277782","1277891","chr9","28565055","28565164","24","27287273"
"GL873779","1278152","1278306","chr1","42090628","42090789","49","40812476"
"GL873780","86138","86230","chr18","1030196","1030279","30","944058"
"GL873782","336700","336779","chr11","71088990","71089073","11","70752290"
"GL873783","584504","584540","chr10","30503873","30503908","10","29919369"
"GL873783","584620","584856","chr19","15734751","15734988","71","15150131"
"GL873784","888167","888288","chr4","78634719","78634842","25","77746552"
"GL873785","108345","108635","chr1","207140331","207140612","83","207031986"
"GL873790","615785","615896","chr1","14472124","14472230","38","13856339"
"GL873792","582852","582987","chr1","208531450","208531566","31","207948598"
"GL873795","138106","138152","chr1","138949338","138949386","11","138811232"
"GL873795","436039","436114","chr14","6226201","6226277","15","5790162"
"GL873796","659691","659703","chr8","36184553","36184565","5","35524862"
"GL873799","88751","88920","chr19","217992","218161","51","129241"
"GL873799","513633","513954","chr10","81822101","81822430","85","81308468"
"GL873799","1094566","1094656","chr17","24677719","24677809","18","23583153"
"GL873800","182718","182853","chr1","208531450","208531566","31","208348732"
"GL873800","223405","223664","chrX","92859831","92860101","65","92636426"
"GL873800","223953","223994","chr20","26330765","26330807","8","26106812"
"GL873800","420904","421161","chr1","127906873","127907146","66","127485969"
"GL873800","421433","421460","chr9","60148344","60148376","8","59726911"
"GL873800","964962","965116","chr3","24004748","24004902","57","23039786"
"GL873801","678615","678747","chr14","117185400","117185528","30","116506785"
"GL873801","678777","678862","chr19","42743745","42743831","24","42064968"
"GL873804","451581","451757","chr7","110718313","110718501","47","110266732"
"GL873804","878913","878953","chr15","80691004","80691039","10","79812091"
"GL873807","3006","3201","chr1","211958800","211958979","62","211955794"
"GL873807","3476","3644","chr1","130657947","130658112","42","130654471"
"GL873808","444706","444987","chr3","4822479","4822748","96","4377773"
"GL873808","445077","445089","chr2","177416459","177416470","1","176971382"
"GL873808","488624","488823","chr6","10563677","10563875","66","10075053"
"GL873808","535575","535840","chr6","172701021","172701273","99","172165446"
"GL873808","555755","555951","chr1","12829764","12829950","62","12274009"
"GL873811","178037","178257","chr2","66170928","66171150","51","65992891"
"GL873811","768684","768849","chr19","44149889","44150040","43","43381205"
"GL873812","62501","62668","chr8","52649368","52649530","58","52586867"
"GL873812","223379","223537","chr9","12430014","12430172","35","12206635"
"GL873812","223805","223951","chr3","110844144","110844287","36","110620339"
"GL873812","529269","529402","chr1","16844726","16844856","25","16315457"
"GL873812","529677","529836","chr3","42173951","42174112","41","41644274"
"GL873813","90640","90780","chr3","48136388","48136524","40","48045748"
"GL873813","797843","797924","chr20","868405","868479","19","70562"
"GL873814","73184","73310","chr14","31689570","31689698","22","31616386"
"GL873814","73336","73481","chr2","89718401","89718551","39","89645065"
"GL873820","613931","614066","chr1","208531450","208531566","30","207917519"
"GL873821","390533","390544","chr1","3706766","3706778","1","3316233"
"GL873821","390817","390977","chr1","101422491","101422627","53","101031674"
"GL873824","182244","182374","chr19","48482244","48482379","30","48300000"
"GL873824","182645","182706","chr4","42346027","42346086","18","42163382"
"GL873827","493570","493849","chr10","83261746","83262006","94","82768176"
"GL873827","596728","597019","chr8","21496805","21497072","94","20900077"
"GL873827","631171","631451","chr6","150453787","150454043","97","149822616"
"GL873827","632639","632919","chr6","150453787","150454043","97","149821148"
"GL873835","18888","19014","chrX","41859044","41859147","45","41840156"
"GL873835","24503","24707","chr4","32960006","32960206","66","32935503"
"GL873835","79274","79480","chr2","1205269","1205457","69","1125995"
"GL873835","138922","139122","chr19","7636280","7636473","64","7497358"
"GL873835","329144","329341","chr10","35979690","35979883","60","35650546"
"GL873835","443576","443851","chr9","90758928","90759200","98","90315352"
"GL873835","447227","447352","chr13","43304232","43304337","47","42857005"
"GL873835","468233","468509","chr10","13247849","13248101","96","12779616"
"GL873835","479325","479596","chr2","84405451","84405714","99","83926126"
"GL873835","508341","508505","chr12","94426312","94426473","59","93917971"
"GL873835","531484","531689","chr1","29454723","29454915","66","28923239"
"GL873838","357855","357940","chr4","135516605","135516690","16","135158750"
"GL873842","214307","214443","chr1","3418869","3419004","32","3204562"
"GL873842","214718","214873","chr5","103333980","103334143","40","103119262"
"GL873849","69446","69596","chr7","77803466","77803607","59","77734020"
"GL873849","69677","69792","chr1","127488460","127488573","29","127418783"
"GL873854","139740","139853","chr3","76535703","76535819","33","76395963"
"GL873854","140120","140263","chr2","95936444","95936581","48","95796324"
"GL873854","270321","270517","chr19","37721285","37721486","69","37450964"
"GL873854","270612","270732","chr2","149359590","149359711","37","149088978"
"GL873860","130184","130256","chr9","60549162","60549234","19","60418978"
"GL873872","224342","224469","chr6","62812370","62812502","26","62588028"
"GL873878","61919","61972","chr2","86329384","86329447","17","86267465"
"GL873878","61993","62136","chr8","120339947","120340078","36","120277954"
"GL873884","208478","208492","chr19","50479632","50479645","4","50271154"
"GL873884","208761","208838","chr7","129494002","129494081","21","129285241"
"GL873938","51869","51885","chr4","62859707","62859721","2","62807838"
"GL873938","52119","52366","chr1","152734991","152735238","59","152682872"
"GL873938","55172","55294","chr3","162092006","162092129","37","162036834"
"GL873938","55331","55438","chr11","64958055","64958155","31","64902724"
"GL873962","19973","20063","chr13","91799972","91800063","14","91779999"
"GL873970","6087","6222","chr2","69637433","69637551","33","69631346"
"GL874010","34965","35032","chr4","44514495","44514565","18","44479530"
"GL874018","32106","32391","chr20","17289307","17289591","73","17257201"
"GL874140","7434","7486","chr15","92694751","92694800","9","92687317"
"GL874533","2626","2740","chr1","181394938","181395052","22","181392312"
"AAQR03191861","5546","5710","chr12","94426312","94426473","59","94420766"
"AAQR03192810","6317","6597","chr6","150453787","150454043","97","150447470"
"AAQR03195323","1995","2083","chr3","46340049","46340137","13","46338054"
"AAQR03197868","694","783","chr8","93198795","93198885","12","93198101"
"AAQR03199125","453","635","chr14","119003398","119003579","58","119002945"
"AAQR03199125","880","900","chr9","16817181","16817201","2","16816301"
