"GL873520","2151025","2151139","chr9","98618869","98618985","32","96467844"
"GL873520","20611705","20612004","chr1","52726058","52726361","68","32114353"
"GL873520","23993282","23993576","chr17","54779943","54780240","67","30786661"
"GL873520","30119082","30119327","chr5","35361668","35361925","71","5242586"
"GL873520","62911487","62911501","chr4","124210501","124210513","3","61299014"
"GL873520","68825999","68826185","chr12","123302562","123302747","39","54476563"
"GL873520","70969998","70970267","chr17","63050561","63050825","66","7919437"
"GL873521","26887161","26887416","chr4","198532339","198532604","74","171645178"
"GL873521","37167860","37168019","chr5","11018019","11018152","52","26149841"
"GL873521","44366926","44367205","chr5","9227865","9228165","78","35139061"
"GL873521","50504865","50505108","chr7","98956364","98956606","65","48451499"
"GL873522","5172095","5172396","chr6","91715535","91715838","77","86543440"
"GL873522","6932627","6932928","chr8","77861287","77861586","72","70928660"
"GL873522","19115246","19115490","chrX","24204750","24204990","72","5089504"
"GL873522","19152913","19153205","chr1","44687839","44688136","72","25534926"
"GL873522","29956556","29956838","chr9","55874091","55874384","72","25917535"
"GL873522","30018563","30018831","chr17","50613482","50613764","79","20594919"
"GL873522","31557933","31558030","chr8","21170292","21170375","38","10387641"
"GL873522","32012674","32012736","chr2B","109782303","109782359","19","77769629"
"GL873522","36553653","36553775","chr19","10287662","10287790","32","26265991"
"GL873522","40668394","40668576","chr11","50171639","50171813","65","9503245"
"GL873522","42762551","42762767","chr3","34731757","34731984","62","8030794"
"GL873522","47695293","47695579","chr16","52966981","52967263","74","5271688"
"GL873523","5560650","5560812","chr5","70901353","70901498","51","65340703"
"GL873523","21098831","21099120","chr4","197519153","197519451","72","176420322"
"GL873523","21882032","21882206","chr19","32556272","32556446","44","10674240"
"GL873523","24829332","24829385","chr11","62930604","62930662","20","38101272"
"GL873523","24830084","24830304","chr12","127667928","127668152","52","102837844"
"GL873523","27500719","27500779","chr12","112384177","112384234","19","84883458"
"GL873523","33820728","33820995","chr17","698455","698699","84","33122273"
"GL873523","36497513","36497778","chr2A","75743657","75743921","76","39246144"
"GL873523","47336368","47336640","chr4","25885760","25886036","72","21450608"
"GL873524","943036","943314","chr6","155461681","155461955","80","154518645"
"GL873524","1748281","1748554","chr15","71422921","71423198","75","69674640"
"GL873524","1815402","1815595","chr21","1065525","1065698","64","749877"
"GL873524","11986341","11986618","chr14","38290627","38290915","70","26304286"
"GL873524","24967244","24967515","chr12","120500428","120500706","76","95533184"
"GL873524","33453308","33453594","chr3","48129273","48129574","75","14675965"
"GL873524","40199622","40199689","chr19","53734702","53734772","19","13535080"
"GL873524","44671953","44672162","chr16","47496072","47496284","59","2824119"
"GL873525","6607619","6607730","chr1","215570805","215570917","26","208963186"
"GL873525","8545888","8546164","chr15","20780043","20780330","73","12234155"
"GL873525","11071113","11071304","chrX","109679601","109679797","57","98608488"
"GL873525","13609988","13610269","chr12","59581899","59582186","90","45971911"
"GL873525","18910417","18910587","chr22","24728837","24729011","51","5818420"
"GL873525","31608445","31608738","chr1","96321409","96321703","65","64712964"
"GL873525","32888135","32888322","chr5","45485318","45485497","45","12597183"
"GL873525","34601195","34601466","chr6","109121958","109122240","77","74520763"
"GL873525","43627047","43627324","chr5","54415134","54415422","85","10788087"
"GL873525","43871699","43871974","chrX","69040159","69040434","66","25168460"
"GL873526","44043","44310","chr9","54230416","54230685","67","54186373"
"GL873526","6493783","6493858","chrX","16742319","16742395","17","10248536"
"GL873526","11694917","11695169","chr2B","90911263","90911527","58","79216346"
"GL873526","16210494","16210659","chr13","25251988","25252153","44","9041494"
"GL873526","17185395","17185660","chr6","155461681","155461955","64","138276286"
"GL873526","22863004","22863298","chr1","96321409","96321703","68","73458405"
"GL873526","26850759","26850838","chr5","55296924","55297001","22","28446165"
"GL873526","36197662","36197938","chr10","50278328","50278612","69","14080666"
"GL873526","39377313","39377594","chr9","15982951","15983229","66","23394362"
"GL873527","2332695","2332980","chr7","64817117","64817416","71","62484422"
"GL873527","11015321","11015557","chr4","177756695","177756949","87","166741374"
"GL873527","16690168","16690332","chr2A","2014950","2015136","57","14675218"
"GL873527","27812855","27813090","chr19","9354570","9354807","57","18458285"
"GL873527","33196263","33196548","chr6","101421725","101422018","69","68225462"
"GL873528","16162196","16162481","chr5","6557648","6557937","83","9604548"
"GL873529","2737581","2737856","chr1","10068459","10068749","68","7330878"
"GL873529","7176103","7176381","chr6","109121958","109122240","71","101945855"
"GL873529","9635583","9635702","chr9","98618869","98618985","28","88983286"
"GL873529","12292919","12293087","chr13","25251988","25252153","55","12959069"
"GL873529","17495636","17495928","chr6","129838182","129838469","73","112342546"
"GL873529","18834429","18834713","chr12","120500428","120500706","70","101665999"
"GL873529","36402715","36402892","chr11","126482063","126482255","45","90079348"
"GL873530","7692755","7693076","chr13","20180758","20181052","100","12488003"
"GL873530","8252980","8253273","chr4","94503424","94503727","65","86250444"
"GL873530","11536409","11536598","chr12","120333274","120333462","47","108796865"
"GL873530","16298520","16298736","chr11","102438430","102438638","71","86139910"
"GL873530","20684710","20684985","chr5","34630488","34630776","73","13945778"
"GL873530","24066432","24066694","chr5","73505579","73505851","70","49439147"
"GL873530","24881511","24881687","chr10","18256538","18256736","68","6624973"
"GL873530","25137864","25138125","chr9","76740763","76741048","80","51602899"
"GL873530","36050445","36050726","chr10","82769774","82770055","73","46719329"
"GL873531","743580","743873","chr17","24219285","24219589","68","23475705"
"GL873531","4102790","4103038","chr12","31382837","31383075","64","27280047"
"GL873531","11880361","11880661","chr21","8776416","8776718","66","3103945"
"GL873531","15816402","15816670","chr10","85432171","85432456","60","69615769"
"GL873531","21076233","21076407","chr5","44045660","44045843","54","22969427"
"GL873531","31787174","31787465","chr2B","64111137","64111437","86","32323963"
"GL873532","11717643","11717868","chr5","38151850","38152036","78","26434207"
"GL873532","13847052","13847316","chr14","21116605","21116865","82","7269553"
"GL873532","24796591","24796743","chr12","19273028","19273174","44","5523563"
"GL873532","28739238","28739526","chrX","47583488","47583787","76","18844250"
"GL873532","29369734","29370037","chr1","45464309","45464616","61","16094575"
"GL873532","30713115","30713390","chr6","106891513","106891786","79","76178398"
"GL873533","9671302","9671560","chr4","40927985","40928269","74","31256683"
"GL873533","12522207","12522381","chr18","46266233","46266417","54","33744026"
"GL873533","16134333","16134623","chrX","32096822","32097112","66","15962489"
"GL873533","28073656","28073870","chr9","99005061","99005282","54","70931405"
"GL873533","30408285","30408583","chr10","25126935","25127236","71","5281350"
"GL873534","6310704","6310826","chr19","54683573","54683702","28","48372869"
"GL873534","6487366","6487602","chr14","55547041","55547304","77","49059675"
"GL873534","6499556","6499790","chr10","94085194","94085421","52","87585638"
"GL873534","8444999","8445064","chr19","53734702","53734772","20","45289703"
"GL873534","11644684","11644744","chr6","43435900","43435961","17","31791216"
"GL873534","15455935","15456215","chr11","70902470","70902754","68","55446535"
"GL873534","29822405","29822562","chr5","11018019","11018152","62","18804386"
"GL873535","29467371","29467653","chr3","70533836","70534123","67","41066465"
"GL873535","29528380","29528490","chr9","67924410","67924514","34","38396030"
"GL873535","29529721","29529901","chr6","122083180","122083372","62","92553459"
"GL873536","6183235","6183517","chr5","16978106","16978399","67","10794871"
"GL873536","8238390","8238645","chrX","961336","961590","73","7277054"
"GL873536","10089167","10089339","chr7","5499594","5499764","38","4589573"
"GL873536","14391349","14391600","chr6","155461681","155461955","77","141070332"
"GL873536","23022433","23022696","chr6","134308421","134308679","70","111285988"
"GL873537","5214225","5214341","chr1","27044913","27045058","48","21830688"
"GL873537","14521656","14521939","chr19","1502856","1503134","79","13018800"
"GL873537","20439277","20439404","chr3","24542532","24542686","55","4103255"
"GL873537","23592249","23592349","chr9","67924410","67924514","31","44332161"
"GL873537","26407623","26407869","chr6","128488977","128489223","65","102081354"
"GL873537","28066052","28066115","chr2B","109782303","109782359","19","81716251"
"GL873537","28253996","28254310","chr12","40491881","40492181","81","12237885"
"GL873538","2103378","2103585","chr17","5192391","5192599","50","3089013"
"GL873538","4784269","4784514","chr15","80765840","80766093","66","75981571"
"GL873538","12351987","12352285","chr7","49126864","49127168","72","36774877"
"GL873538","12761425","12761574","chr2B","48673383","48673515","53","35911958"
"GL873538","15630912","15631164","chr2A","68469902","68470157","86","52838990"
"GL873538","24528568","24528730","chr12","30067128","30067287","42","5538560"
"GL873539","472215","472416","chr10","18256538","18256736","52","17784323"
"GL873539","10148456","10148531","chr9","2089580","2089653","27","8058876"
"GL873539","25389838","25390116","chr11","101841254","101841537","77","76451416"
"GL873539","25522195","25522485","chr17","1731620","1731907","69","23790575"
"GL873540","6313666","6313849","chr5","44045660","44045843","50","37731994"
"GL873540","8735863","8736130","chr2B","90911263","90911527","65","82175400"
"GL873540","9450448","9450715","chr2A","83434986","83435277","74","73984538"
"GL873540","16674647","16674922","chr4","121184902","121185179","73","104510255"
"GL873540","20655639","20655704","chr10","89328617","89328677","17","68672978"
"GL873541","9631527","9631750","chr22","21487586","21487818","84","11856059"
"GL873541","10352857","10353140","chr5","102513712","102514010","67","92160855"
"GL873541","15745173","15745458","chr3","48678431","48678720","78","32933258"
"GL873541","16870359","16870422","chr3","99289567","99289628","25","82419208"
"GL873542","9537125","9537397","chr4","24698540","24698801","68","15161415"
"GL873542","10979292","10979605","chr4","36644277","36644583","81","25664985"
"GL873543","10220081","10220318","chrX","11328810","11329029","72","1108729"
"GL873543","11551381","11551630","chr12","53744071","53744310","81","42192690"
"GL873543","19025666","19025904","chr10","18053699","18053968","84","971967"
"GL873543","21140344","21140627","chr15","28904905","28905198","70","7764561"
"GL873543","22042367","22042646","chr8","128850540","128850821","86","106808173"
"GL873544","4458562","4458812","chr1","187194543","187194798","73","182735981"
"GL873544","14353211","14353491","chr1","53578657","53578942","71","39225446"
"GL873544","16573157","16573425","chr12","120500428","120500706","71","103927271"
"GL873544","19151818","19152093","chr2B","95744875","95745153","63","76593057"
"GL873544","21012867","21013121","chr4","60814947","60815216","62","39802080"
"GL873545","11819705","11819955","chr10","55135460","55135710","81","43315755"
"GL873545","12502931","12503218","chr16","19120204","19120500","65","6617273"
"GL873546","5021263","5021515","chr14","55547041","55547304","71","50525778"
"GL873546","7372099","7372289","chr14","64349815","64350005","57","56977716"
"GL873546","8501657","8501934","chr3","33278932","33279207","78","24777275"
"GL873547","14483926","14484175","chr6","50766575","50766837","81","36282649"
"GL873548","133851","134130","chr13","2212042","2212334","68","2078191"
"GL873548","4969854","4970136","chr3","50112288","50112575","83","45142434"
"GL873548","7943503","7943547","chr3","172651187","172651239","18","164707684"
"GL873548","15989743","15990030","chr3","145622658","145622967","70","129632915"
"GL873548","16247733","16247866","chr16","59760809","59760939","28","43513076"
"GL873548","18432867","18433143","chr3","70533836","70534123","68","52100969"
"GL873549","2031533","2031800","chr1","210159160","210159442","76","208127627"
"GL873549","4931506","4931790","chr3","70533836","70534123","73","65602330"
"GL873549","5333448","5333610","chrX","97263588","97263749","50","91930140"
"GL873549","7247349","7247622","chr2B","126268211","126268497","79","119020862"
"GL873550","7520634","7520880","chr5","80367581","80367842","83","72846947"
"GL873550","13348325","13348604","chr1","26752359","26752641","74","13404034"
"GL873551","4326719","4326966","chr6","55957845","55958104","75","51631126"
"GL873552","9468539","9468878","chr4","63437067","63437368","108","53968528"
"GL873552","11439967","11440139","chr7","76741247","76741402","57","65301280"
"GL873553","1912528","1912825","chr4","63437067","63437368","71","61524539"
"GL873553","12884955","12885275","chr3","121741100","121741414","85","108856145"
"GL873553","15802799","15802981","chr5","123928415","123928587","48","108125616"
"GL873554","1988516","1988798","chr3","70533836","70534123","76","68545320"
"GL873554","5336457","5336753","chr1","40542909","40543203","66","35206452"
"GL873554","16410261","16410441","chr16","47496072","47496284","59","31085811"
"GL873555","4492561","4492852","chr6","31893969","31894274","78","27401408"
"GL873556","11622534","11622794","chr7","41854441","41854720","76","30231907"
"GL873557","10602774","10603071","chr6","152568293","152568589","66","141965519"
"GL873557","12157885","12158169","chr15","16308051","16308353","75","4150166"
"GL873558","346264","346533","chr11","54765772","54766054","71","54419508"
"GL873558","5090920","5091134","chr1","133472263","133472467","57","128381343"
"GL873558","11729886","11730160","chr6","106891513","106891786","64","95161627"
"GL873560","1046330","1046605","chr17","5278298","5278575","66","4231968"
"GL873560","5671813","5672100","chr2B","1689208","1689494","64","3982605"
"GL873560","10815152","10815418","chr4","7286481","7286744","77","3528671"
"GL873561","14329867","14330129","chr5","164734870","164735155","68","150405003"
"GL873562","11802995","11803177","chr1","15439791","15439988","66","3636796"
"GL873563","6278566","6278672","chr6","70574161","70574259","36","64295595"
"GL873563","10870912","10871197","chr3","10555623","10555917","70","315289"
"GL873563","13001119","13001319","chr10","134133378","134133542","70","121132259"
"GL873564","972189","972457","chr1","14141738","14142022","78","13169549"
"GL873564","7862152","7862443","chr1","26759283","26759581","77","18897131"
"GL873564","8111869","8112128","chr2B","31733906","31734160","69","23622037"
"GL873564","12230896","12231176","chr6","101421725","101422018","73","89190829"
"GL873566","9383623","9383691","chr13","11027172","11027241","17","1643549"
"GL873567","1896908","1897190","chrX","89445715","89446010","70","87548807"
"GL873567","3951100","3951273","chrX","109679601","109679797","57","105728501"
"GL873567","8493033","8493231","chr1","27790338","27790528","67","19297305"
"GL873567","12071888","12072144","chr12","122859561","122859837","73","110787673"
"GL873567","12148816","12149129","chr1","41174714","41175012","74","29025898"
"GL873568","6129492","6129686","chr16","2759981","2760181","58","3369511"
"GL873568","6426355","6426519","chrX","109679601","109679797","59","103253246"
"GL873569","5489766","5490051","chr5","47455654","47455943","68","41965888"
"GL873569","6518440","6518694","chr15","50846147","50846425","70","44327707"
"GL873569","11036395","11036693","chr10","40925230","40925521","72","29888835"
"GL873569","11251153","11251422","chr5","73505579","73505851","82","62254426"
"GL873571","3918742","3919031","chr13","36978773","36979054","75","33060031"
"GL873571","6938648","6938836","chr5","129943357","129943534","59","123004709"
"GL873571","7974878","7975090","chr14","64349815","64350005","69","56374937"
"GL873572","5333658","5333936","chr5","16155627","16155918","67","10821969"
"GL873572","8086416","8086544","chr15","51755821","51755958","44","43669405"
"GL873572","8292948","8293070","chr15","51755821","51755958","42","43462873"
"GL873572","9337676","9337961","chr10","40925230","40925521","76","31587554"
"GL873573","561846","562000","chr4","121179699","121179854","37","120617853"
"GL873573","809429","809661","chr16","54476117","54476367","76","53666688"
"GL873576","10227779","10228037","chr11","125360349","125360604","77","115132570"
"GL873576","10845861","10846063","chr10","24055844","24056038","55","13209983"
"GL873577","2543150","2543436","chr6","36695832","36696118","70","34152682"
"GL873577","6370827","6370932","chr1","216237131","216237220","38","209866304"
"GL873578","6246812","6246921","chr4","134048057","134048175","28","127801245"
"GL873579","1773131","1773405","chr7","73231735","73232023","73","71458604"
"GL873579","4903911","4904118","chr7","67444445","67444644","60","62540534"
"GL873579","5947173","5947436","chr7","28194178","28194457","68","22247005"
"GL873580","3276777","3277037","chrX","961336","961590","66","2315441"
"GL873580","853240","853398","chr3","110766548","110766704","37","109913308"
"GL873580","5868817","5869123","chr2B","118605048","118605360","70","112736231"
"GL873581","838124","838393","chr5","102513712","102514010","70","101675588"
"GL873581","8343445","8343516","chr5","18327037","18327115","29","9983592"
"GL873581","9335059","9335345","chr4","201147793","201148088","72","191812734"
"GL873582","8128619","8128894","chr14","33239923","33240186","70","25111304"
"GL873583","5217241","5217516","chr3","70533836","70534123","69","65316595"
"GL873584","10767629","10767932","chr13","27267404","27267703","70","16499775"
"GL873585","115904","116160","chr17","22540896","22541169","71","22424992"
"GL873585","1653672","1653707","chr18","8368663","8368703","11","6714991"
"GL873585","8812888","8813010","chr19","44425908","44426038","32","35613020"
"GL873585","10753608","10753875","chr6","155461681","155461955","68","144708073"
"GL873587","2344327","2344496","chr12","28537731","28537901","44","26193404"
"GL873588","5747142","5747412","chr8","124786888","124787161","81","119039746"
"GL873589","3491562","3491824","chr16","29798793","29799051","72","26307231"
"GL873589","9310653","9310947","chr21","24477312","24477604","65","15166659"
"GL873590","6901922","6902119","chr12","46189305","46189514","73","39287383"
"GL873590","9938249","9938516","chr3","11949026","11949296","74","2010777"
"GL873592","30274","30479","chr10","18256538","18256736","54","18226264"
"GL873592","3504292","3504588","chr1","96321409","96321703","65","92817117"
"GL873593","5742466","5742735","chr10","18053699","18053968","83","12311233"
"GL873595","7314096","7314202","chr9","105214490","105214607","36","97900394"
"GL873596","9289810","9289980","chr22","24728837","24729011","50","15439027"
"GL873597","5136350","5136508","chr21","15492354","15492522","53","10356004"
"GL873598","6925865","6926121","chrUn_CABD030132529v1","1876","2124","72","6923989"
"GL873600","6358350","6358621","chr1","125131212","125131488","72","118772862"
"GL873601","87941","88233","chr1","152464621","152464912","78","152376680"
"GL873602","1717997","1718263","chr17","5316883","5317154","79","3598886"
"GL873602","5655744","5656017","chr21","24477312","24477604","68","18821568"
"GL873603","2673070","2673193","chr8","145340342","145340469","32","142667272"
"GL873603","3472302","3472505","chr2B","79695554","79695766","66","76223252"
"GL873605","18668","18855","chr14","42916722","42916924","53","42898054"
"GL873605","211678","211971","chr7","28194178","28194457","70","27982500"
"GL873606","413534","413591","chr8","140767073","140767125","18","140353539"
"GL873606","869307","869506","chr7","44016611","44016814","52","43147304"
"GL873606","1561852","1561999","chr9","15573805","15573980","60","14011953"
"GL873606","1584393","1584659","chr1","204267066","204267341","73","202682673"
"GL873606","6040743","6040839","chr15","71381137","71381224","28","65340394"
"GL873606","6713005","6713204","chr14","42916722","42916924","50","36203717"
"GL873607","468681","468880","chr8","59275995","59276202","58","58807314"
"GL873607","3783696","3783827","chr9","89811925","89812054","36","86028229"
"GL873607","5526364","5526636","chr12","129188415","129188688","72","123662051"
"GL873608","3484994","3485156","chr1","31583173","31583337","35","28098179"
"GL873609","279360","279651","chr1","162067992","162068267","85","161788632"
"GL873609","404482","404767","chr7","74192554","74192841","94","73788072"
"GL873609","1717159","1717438","chr19","20343380","20343672","70","18626221"
"GL873610","4454076","4454255","chr1","215234127","215234308","39","210780051"
"GL873610","6659947","6660135","chr11","88676071","88676264","55","82016124"
"GL873610","7088038","7088189","chr1","129199200","129199359","35","122111162"
"GL873611","3341174","3341447","chr4","120917685","120917967","67","117576511"
"GL873611","3648898","3649188","chr20","46263009","46263304","68","42614111"
"GL873611","4326462","4326733","chr15","71422921","71423198","70","67096459"
"GL873611","4410882","4411174","chr7","138205255","138205551","74","133794373"
"GL873611","6208697","6208910","chr7","36211391","36211593","53","30002694"
"GL873614","2464368","2464650","chr6","159494233","159494519","74","157029865"
"GL873614","2570666","2570909","chr8","60634961","60635230","84","58064295"
"GL873614","6206177","6206481","chr3","48129273","48129574","76","41923096"
"GL873615","2242583","2242882","chr3","87994157","87994458","64","85751574"
"GL873615","5164234","5164521","chr10","101951004","101951293","60","96786770"
"GL873617","1608528","1608820","chr1","26759283","26759581","78","25150755"
"GL873617","5505209","5505476","chr14","33239923","33240186","69","27734714"
"GL873617","6429598","6429710","chr9","98618869","98618985","31","92189271"
"GL873618","916822","917081","chr3","70533836","70534123","76","69617014"
"GL873618","1039454","1039766","chr1","161287885","161288187","71","160248431"
"GL873618","3344163","3344386","chr6","36389126","36389354","62","33044963"
"GL873619","529429","529700","chr12","120500428","120500706","78","119970999"
"GL873619","3251154","3251417","chr4","120917685","120917967","70","117666531"
"GL873619","4427770","4427819","chr20","4919686","4919735","17","491916"
"GL873619","5715463","5715603","chr3","187610570","187610717","39","181895107"
"GL873621","270115","270296","chr12","123302562","123302747","49","123032447"
"GL873621","5018554","5018827","chr1","33952927","33953220","80","28934373"
"GL873623","3165346","3165445","chr5","40229554","40229653","19","37064208"
"GL873623","7055444","7055732","chr15","28904905","28905198","65","21849461"
"GL873625","3540946","3541225","chr9","111454277","111454559","80","107913331"
"GL873629","2808739","2809002","chr16","70660162","70660442","66","67851423"
"GL873629","3057379","3057506","chr10","28974120","28974251","25","25916741"
"GL873629","3330842","3331122","chr5","24628513","24628793","69","21297671"
"GL873629","4046390","4046644","chr4","145442925","145443190","70","141396535"
"GL873631","1463608","1463909","chr3","188617614","188617922","71","187154006"
"GL873631","2876948","2877168","chr2A","52340854","52341081","60","49463906"
"GL873633","6680180","6680479","chr9","78217293","78217592","67","71537113"
"GL873634","6070241","6070482","chr13","75155822","75156054","65","69085581"
"GL873635","3143338","3143625","chr11","47983546","47983836","64","44840208"
"GL873636","45557","45823","chr1","127724636","127724915","72","127679079"
"GL873637","4322064","4322316","chr2A","75743657","75743921","69","71421593"
"GL873637","4379152","4379361","chr1","227004347","227004564","60","222625195"
"GL873639","638719","639018","chr10","37292108","37292409","66","36653389"
"GL873639","2243846","2244046","chr7","80105498","80105704","48","77861652"
"GL873640","4602583","4602770","chr12","123302562","123302747","43","118699979"
"GL873641","3204960","3205135","chr6","29161027","29161228","58","25956067"
"GL873642","2370313","2370502","chr6","122083180","122083372","57","119712867"
"GL873642","3375546","3375787","chr15","63923013","63923262","74","60547467"
"GL873645","923581","923868","chr7","3932102","3932399","63","3008521"
"GL873645","4984041","4984262","chr11","128070866","128071087","54","123086825"
"GL873646","917757","918050","chr6","159494233","159494519","68","158576476"
"GL873646","3489451","3489745","chr10","108450868","108451162","68","104961417"
"GL873647","344182","344454","chr12","100222156","100222443","71","99877974"
"GL873647","3251123","3251165","chr14","53951491","53951531","13","50700368"
"GL873648","2930273","2930481","chrX","109679601","109679797","61","106749328"
"GL873648","3742434","3742707","chr12","122859561","122859837","73","119117127"
"GL873649","2198171","2198363","chr7","122634674","122634860","52","120436503"
"GL873652","2033772","2033917","chr10","41996566","41996714","46","39962794"
"GL873652","2538738","2539020","chrX","86527730","86528024","63","83988992"
"GL873653","1770690","1770966","chr10","18839236","18839527","68","17068546"
"GL873653","3498676","3498727","chr1","90620600","90620644","21","87121924"
"GL873653","3498985","3499036","chr19","6433155","6433210","15","2934170"
"GL873654","370003","370233","chr2A","36388111","36388368","78","36018108"
"GL873654","829106","829286","chr1","38455227","38455434","52","37626121"
"GL873654","4345527","4345632","chr14","75700144","75700252","41","71354617"
"GL873656","1570706","1570816","chr11","84262396","84262493","48","82691690"
"GL873659","2345965","2346133","chr3","50457483","50457633","61","48111518"
"GL873661","3259618","3259835","chr11","119198471","119198681","76","115938853"
"GL873662","1156905","1157091","chrX","109679601","109679797","50","108522696"
"GL873662","1216517","1216580","chr19","53734702","53734772","20","52518185"
"GL873662","3546601","3546766","chr22","15203629","15203807","51","11657028"
"GL873664","3452535","3452748","chr19","13847728","13847958","57","10395193"
"GL873665","1381255","1381541","chr10","40925230","40925521","69","39543975"
"GL873666","2597601","2597880","chr3","70533836","70534123","73","67936235"
"GL873666","2806877","2807132","chr15","51502419","51502698","76","48695542"
"GL873667","940378","940498","chr14","75700144","75700252","39","74759766"
"GL873668","1632691","1632893","chr10","18256538","18256736","48","16623847"
"GL873670","1907628","1907917","chr13","60463403","60463696","81","58555775"
"GL873671","886108","886393","chr10","40719319","40719605","71","39833211"
"GL873671","1882360","1882615","chr5","59599451","59599704","62","57717091"
"GL873671","2621633","2621694","chr3","99289567","99289628","16","96667934"
"GL873671","4340632","4340927","chr1","44687839","44688136","71","40347207"
"GL873672","1567049","1567194","chr11","4127841","4127998","41","2560792"
"GL873673","4474890","4475153","chr12","102454793","102455037","72","97979903"
"GL873674","581213","581499","chr6","36606088","36606384","75","36024875"
"GL873676","2872519","2872697","chr1","208868842","208869019","48","205996323"
"GL873677","3241750","3241856","chr9","98618869","98618985","37","95377119"
"GL873677","4159374","4159672","chr3","53743252","53743550","73","49583878"
"GL873678","675254","675318","chr16","22900746","22900807","18","22225492"
"GL873679","851989","852265","chr5","13481770","13482063","80","12629781"
"GL873683","490677","490883","chr9","105059377","105059585","51","104568700"
"GL873683","518085","518266","chr2B","55692723","55692923","53","55174638"
"GL873685","2961205","2961462","chr4","163316062","163316340","76","160354857"
"GL873685","3163893","3164141","chr1","204074882","204075153","91","200910989"
"GL873687","2386388","2386673","chr6","101421725","101422018","80","99035337"
"GL873689","3224911","3225054","chrX","41922127","41922262","49","38697216"
"GL873693","2376743","2376906","chr3","114460728","114460882","46","112083985"
"GL873695","2844578","2844737","chr10","87154022","87154180","47","84309444"
"GL873696","323840","324122","chr6","162486428","162486716","74","162162588"
"GL873698","191566","191806","chr14","47908625","47908888","83","47717059"
"GL873698","2270983","2271091","chr9","74507747","74507849","38","72236764"
"GL873700","779773","780090","chr2A","31980745","31981039","79","31200972"
"GL873700","784432","784686","chr12","118147701","118147965","69","117363269"
"GL873700","1267399","1267642","chr14","33239923","33240186","70","31972524"
"GL873707","1412783","1413068","chr12","2647086","2647377","75","1234303"
"GL873711","600516","600812","chr7","134842793","134843095","67","134242277"
"GL873712","758777","759067","chr10","60893902","60894203","65","60135125"
"GL873714","1365540","1365729","chr13","51491801","51491962","72","50126261"
"GL873715","280277","280452","chr9","15573805","15573980","65","15293528"
"GL873719","1332085","1332336","chr4","24698540","24698801","77","23366455"
"GL873719","2249405","2249681","chr6","56549482","56549761","71","54300077"
"GL873721","2069601","2069880","chr22","33345646","33345926","81","31276045"
"GL873722","41873","42081","chr2B","79695554","79695766","64","79653681"
"GL873726","367205","367447","chr12","102454793","102455037","71","102087588"
"GL873726","694718","694901","chr22","24728837","24729011","50","24034119"
"GL873726","1557093","1557383","chr5","96667530","96667823","69","95110437"
"GL873728","590192","590366","chr1","115159584","115159752","38","114569392"
"GL873728","2347875","2348140","chr19","1502856","1503134","69","845019"
"GL873730","872629","872863","chr1","27948337","27948566","70","27075708"
"GL873731","1122838","1123027","chr15","73525740","73525934","38","72402902"
"GL873731","1140299","1140488","chr3","194648417","194648624","51","193508118"
"GL873731","1216076","1216245","chr10","134116814","134117000","56","132900738"
"GL873731","1624838","1625067","chr8","113034922","113035151","64","111410084"
"GL873733","1761992","1762209","chr9","105059377","105059585","61","103297385"
"GL873737","1509883","1510083","chr14","50732271","50732465","57","49222388"
"GL873738","274991","275089","chr3","144708567","144708682","45","144433576"
"GL873738","275156","275308","chr4","163243662","163243831","45","162968506"
"GL873738","340616","340915","chr12","71168466","71168763","78","70827850"
"GL873738","1279557","1279792","chr19","9354570","9354807","67","8075013"
"GL873739","1496142","1496416","chr9","111678315","111678595","79","110182173"
"GL873744","926494","926690","chr18","46266233","46266417","55","45339739"
"GL873746","1434521","1434693","chr3","15579282","15579468","52","14144761"
"GL873749","2051730","2051995","chr5","80367581","80367842","94","78315851"
"GL873752","304509","304789","chr6","155461681","155461955","72","155157172"
"GL873752","823627","823891","chr10","109087310","109087587","82","108263683"
"GL873752","1607452","1607687","chr13","75155822","75156054","61","73548370"
"GL873762","776077","776256","chr14","42916722","42916924","54","42140645"
"GL873768","208772","208940","chr8","62126182","62126354","36","61917410"
"GL873772","558391","558592","chr16","55614699","55614879","68","55056308"
"GL873778","812679","812951","chr3","70533836","70534123","75","69721157"
"GL873780","151869","151943","chr19","53734702","53734772","24","53582833"
"GL873782","254816","254927","chr9","98618869","98618985","31","98364053"
"GL873786","921802","922045","chr8","138839850","138840092","84","137918048"
"GL873786","1119085","1119310","chr13","17386018","17386248","53","16266933"
"GL873799","235420","235499","chr2B","92247313","92247398","20","92011893"
"GL873799","235575","235812","chr19","57109613","57109840","64","56874038"
"GL873807","378787","379071","chr1","101422441","101422729","54","101043654"
"GL873808","29232","29435","chr17","5192391","5192599","61","5163159"
"GL873808","245245","245520","chr6","35382721","35382989","95","35137476"
"GL873808","371997","372271","chr6","35382721","35382989","96","35010724"
"GL873808","383398","383628","chr20","55534769","55534996","77","55151371"
"GL873812","573147","573383","chr2A","52340854","52341081","57","51767707"
"GL873812","573691","573747","chr5","99995445","99995486","27","99421754"
"GL873814","114306","114462","chr3","114460728","114460882","37","114346422"
"GL873819","193599","193703","chr19","12511209","12511297","42","12317610"
"GL873827","559389","559662","chr6","35382721","35382989","98","34823332"
"GL873827","592240","592445","chr3","159342262","159342452","66","158750022"
"GL873834","433660","433828","chr1","181845404","181845583","56","181411744"
"GL873835","129882","130157","chr6","35382721","35382989","96","35252839"
"GL873835","310078","310363","chr18","41228048","41228334","91","40917970"
"GL873835","316478","316752","chr6","35382721","35382989","96","35066243"
"GL873835","321278","321472","chr22","7247563","7247766","69","6926285"
"GL873835","506358","506631","chr6","35382721","35382989","98","34876363"
"GL873837","334462","334752","chr4","2497819","2498104","93","2163357"
"GL873905","48652","48939","chr7","41854441","41854720","70","41805789"
"GL874082","9765","10044","chr15","37825519","37825809","86","37815754"
"AAQR03192370","4914","5177","chr10","55135460","55135710","89","55130546"
