"GL873520","2151025","2151139","chr9","115984295","115984405","31","113833270"
"GL873520","20611705","20612004","chr9","137239342","137239638","67","116627637"
"GL873520","23993282","23993576","chr1","154011224","154011521","69","130017942"
"GL873520","30119082","30119327","chr2","159560573","159560825","75","129441491"
"GL873520","62911487","62911501","chr9","71921915","71921928","4","9010428"
"GL873520","68825999","68826185","chr6","119819675","119819867","46","50993676"
"GL873520","70969998","70970267","chr1","8924069","8924337","65","62045929"
"GL873521","26887161","26887416","chr10","94643984","94644261","74","67756823"
"GL873521","37167860","37168019","chr19","51981432","51981570","61","14813572"
"GL873521","44366926","44367205","chr19","12909866","12910164","75","31457060"
"GL873521","50504865","50505108","chr8","17025895","17026133","69","33478970"
"GL873522","5172095","5172396","chr12","62819131","62819426","78","57647036"
"GL873522","6932627","6932928","chr8","38341259","38341558","72","31408632"
"GL873522","19115246","19115490","chr9","61592558","61592815","77","42477312"
"GL873522","19152913","19153205","chr7","150653390","150653683","70","131500477"
"GL873522","29956556","29956838","chr9","74092100","74092394","78","44135544"
"GL873522","30018563","30018831","chr16","49372098","49372368","76","19353535"
"GL873522","31557933","31558030","chr2","100571168","100571288","46","69013235"
"GL873522","32012674","32012736","chr2","176000002","176000065","18","143987328"
"GL873522","36553653","36553775","chr1","9924055","9924185","32","26629598"
"GL873522","40668394","40668576","chr13","97184541","97184703","64","56516147"
"GL873522","42762551","42762767","chr3","34158926","34159153","63","8603625"
"GL873522","47695293","47695579","chr15","76766113","76766394","69","29070820"
"GL873523","5560650","5560812","chr2","100571168","100571288","60","95010518"
"GL873523","21098831","21099120","chr3","121553773","121554065","71","100454942"
"GL873523","21882032","21882206","chr3","100409363","100409531","51","78527331"
"GL873523","24829332","24829385","chrX","1092622","1092672","21","23736710"
"GL873523","24830084","24830304","chr18","57686491","57686718","55","32856407"
"GL873523","27500719","27500779","chr3","104907410","104907463","22","77406691"
"GL873523","33820728","33820995","chr8","11075603","11075870","81","22745125"
"GL873523","36497513","36497778","chr2","198175705","198175967","82","161678192"
"GL873523","47336368","47336640","chr6","73212176","73212446","74","25875808"
"GL873524","943036","943314","chr3","176576423","176576703","82","175633387"
"GL873524","1748281","1748554","chr2","159560573","159560825","76","157812292"
"GL873524","1815402","1815595","chr3","100409363","100409531","70","98593961"
"GL873524","11986341","11986618","chr11","20582497","20582777","69","8596156"
"GL873524","24967244","24967515","chr21","26363925","26364210","79","1396681"
"GL873524","33453308","33453594","chr3","47189384","47189681","75","13736076"
"GL873524","40199622","40199689","chr1","47343316","47343382","15","7143694"
"GL873524","44671953","44672162","chr16","3161952","3162166","59","41510001"
"GL873525","6607619","6607730","chr16","89368403","89368519","23","82760784"
"GL873525","8545888","8546164","chr1","83241815","83242110","71","74695927"
"GL873525","11071113","11071304","chr7","35811742","35811944","62","24740629"
"GL873525","13609988","13610269","chr5","83525946","83526237","95","69915958"
"GL873525","18910417","18910587","chr3","100409363","100409531","58","81498946"
"GL873525","31608445","31608738","chrX","46680069","46680365","63","15071624"
"GL873525","32888135","32888322","chr7","12762699","12762885","51","20125436"
"GL873525","34601195","34601466","chr16","73933847","73934111","78","39332652"
"GL873525","43627047","43627324","chr7","143739013","143739307","88","100111966"
"GL873525","43871699","43871974","chr16","19082504","19082778","68","24789195"
"GL873526","44043","44310","chr9","72503441","72503711","66","72459398"
"GL873526","6493783","6493858","chr8","133235104","133235177","21","126741321"
"GL873526","11694917","11695169","chr2","198175705","198175967","59","186480788"
"GL873526","16210494","16210659","chr3","34372251","34372405","49","18161757"
"GL873526","17185395","17185660","chr3","176576423","176576703","66","159391028"
"GL873526","22863004","22863298","chr2","183494574","183494864","68","160631570"
"GL873526","26850759","26850838","chr17","28199306","28199383","22","1348547"
"GL873526","36197662","36197938","chr10","59780935","59781219","69","23583273"
"GL873526","39377313","39377594","chr8","97720005","97720289","68","58342692"
"GL873527","2332695","2332980","chr7","65932799","65933100","73","63600104"
"GL873527","11015321","11015557","chr1","150595820","150596050","88","139580499"
"GL873527","16690168","16690332","chr2","96904854","96905040","57","80214686"
"GL873527","27812855","27813090","chr17","4661135","4661367","59","23151720"
"GL873527","33196263","33196548","chr10","22292346","22292646","67","10903917"
"GL873528","16162196","16162481","chr20","53730977","53731264","83","37568781"
"GL873529","2737581","2737856","chrX","55224636","55224920","63","52487055"
"GL873529","7176103","7176381","chr6","156672168","156672455","75","149496065"
"GL873529","9635583","9635702","chr3","113988214","113988347","32","104352631"
"GL873529","12292919","12293087","chr3","34372251","34372405","57","22079332"
"GL873529","17495636","17495928","chr6","87422470","87422780","71","69926834"
"GL873529","18834429","18834713","chr5","69520304","69520591","73","50685875"
"GL873529","36402715","36402892","chr9","129668868","129669059","46","93266153"
"GL873530","7692755","7693076","chr13","45403656","45403954","99","37710901"
"GL873530","8252980","8253273","chrX","55224636","55224920","62","46971656"
"GL873530","11536409","11536598","chr8","52786801","52786981","51","41250392"
"GL873530","16298520","16298736","chr6","119819675","119819867","75","103521155"
"GL873530","20684710","20684985","chr6","110700925","110701211","70","90016215"
"GL873530","24066432","24066694","chr5","90734582","90734857","72","66668150"
"GL873530","24881511","24881687","chr3","34372251","34372405","71","9490740"
"GL873530","25137864","25138125","chr9","106250872","106251143","79","81113008"
"GL873530","36050445","36050726","chr17","46873726","46874007","73","10823281"
"GL873531","743580","743873","chr1","44166729","44167035","66","43423149"
"GL873531","4102790","4103038","chr3","154966660","154966922","72","150863870"
"GL873531","11880361","11880661","chrX","51727470","51727769","65","39847109"
"GL873531","15816402","15816670","chr6","114003160","114003441","62","98186758"
"GL873531","21076233","21076407","chr9","129668868","129669059","59","108592635"
"GL873531","31787174","31787465","chr5","178834652","178834947","85","147047478"
"GL873532","11717643","11717868","chr2","197490549","197490733","81","185772906"
"GL873532","13847052","13847316","chr12","2927367","2927652","86","10919685"
"GL873532","24796591","24796743","chr4","2628041","2628183","48","22168550"
"GL873532","28739238","28739526","chrX","46988836","46989137","73","18249598"
"GL873532","29369734","29370037","chr1","44934116","44934423","59","15564382"
"GL873532","30713115","30713390","chr6","104679509","104679782","79","73966394"
"GL873533","9671302","9671560","chr4","150941172","150941450","73","141269870"
"GL873533","12522207","12522381","chr3","34372251","34372405","61","21850044"
"GL873533","16134333","16134623","chr8","78910406","78910694","66","62776073"
"GL873533","28073656","28073870","chr5","64438043","64438255","56","36364387"
"GL873533","30408285","30408583","chr7","55729228","55729529","72","25320943"
"GL873534","6310704","6310826","chr2","61592918","61593048","29","55282214"
"GL873534","6487366","6487602","chr10","116842635","116842892","78","110355269"
"GL873534","6499556","6499790","chr10","50690978","50691205","54","44191422"
"GL873534","8444999","8445064","chr7","114499935","114500000","15","106054936"
"GL873534","11644684","11644744","chr16","16577944","16577986","22","4933260"
"GL873534","15455935","15456215","chr14","49927239","49927502","70","34471304"
"GL873534","29822405","29822562","chr9","35034589","35034704","68","5212184"
"GL873535","29467371","29467653","chr15","67855328","67855624","67","38387957"
"GL873535","29528380","29528490","chr19","37778234","37778333","34","8249854"
"GL873535","29529721","29529901","chr6","119819675","119819867","63","90289954"
"GL873536","6183235","6183517","chr15","70886590","70886882","65","64703355"
"GL873536","8238390","8238645","chr1","109811127","109811419","74","101572737"
"GL873536","10089167","10089339","chr8","103992955","103993118","44","93903788"
"GL873536","14391349","14391600","chr5","144020584","144020819","80","129629235"
"GL873536","23022433","23022696","chr1","47321519","47321780","69","24299086"
"GL873537","5214225","5214341","chr2","100571168","100571288","49","95356943"
"GL873537","14521656","14521939","chr20","25646525","25646820","83","11124869"
"GL873537","20439277","20439404","chr9","127801819","127801967","55","107362542"
"GL873537","23592249","23592349","chr8","106864061","106864155","30","83271812"
"GL873537","26407623","26407869","chr8","30609049","30609294","64","4201426"
"GL873537","28066052","28066115","chr15","89253929","89253992","11","61187877"
"GL873537","28253996","28254310","chr16","23127472","23127777","78","5126524"
"GL873538","2103378","2103585","chr17","5245735","5245941","52","3142357"
"GL873538","4784269","4784514","chr2","203277549","203277813","66","198493280"
"GL873538","12351987","12352285","chr1","11003907","11004218","71","1348080"
"GL873538","12761425","12761574","chr13","69167868","69168029","56","56406443"
"GL873538","15630912","15631164","chr2","34011461","34011710","86","18380549"
"GL873538","24528568","24528730","chr13","71367347","71367507","49","46838779"
"GL873539","472215","472416","chr14","59643315","59643517","55","59171100"
"GL873539","10148456","10148531","chr22","48463681","48463747","29","38315225"
"GL873539","25389838","25390116","chr16","49372098","49372368","72","23982260"
"GL873539","25522195","25522485","chr10","37920468","37920759","73","12398273"
"GL873540","6313666","6313849","chr4","180440789","180440983","53","174127123"
"GL873540","8735863","8736130","chr2","198175705","198175967","65","189439842"
"GL873540","9450448","9450715","chrX","55224636","55224920","67","45774188"
"GL873540","16674647","16674922","chr15","72152863","72153142","70","55478216"
"GL873540","20655639","20655704","chr10","31481506","31481563","20","10825867"
"GL873541","9631527","9631750","chr2","34011461","34011710","83","24379934"
"GL873541","10352857","10353140","chr4","174963683","174963968","144","164610826"
"GL873541","15745173","15745458","chr2","84878245","84878542","79","69133072"
"GL873541","16870359","16870422","chr21","39552752","39552813","18","22682393"
"GL873542","9537125","9537397","chr4","25098162","25098423","68","15561037"
"GL873542","10979292","10979605","chr7","19959125","19959426","80","8979833"
"GL873543","10220081","10220318","chrX","11590998","11591218","74","1370917"
"GL873543","11551381","11551630","chr12","31263989","31264226","81","19712608"
"GL873543","19025666","19025904","chr7","99495032","99495306","89","80469366"
"GL873543","21140344","21140627","chr2","3540411","3540706","70","17599933"
"GL873543","22042367","22042646","chr8","127461232","127461515","84","105418865"
"GL873544","4458562","4458812","chr8","23031913","23032156","74","18573351"
"GL873544","14353211","14353491","chr10","67795993","67796273","70","53442782"
"GL873544","16573157","16573425","chr5","39407215","39407500","76","22834058"
"GL873544","19151818","19152093","chrX","17249543","17249822","65","1902275"
"GL873544","21012867","21013121","chr4","67810884","67811156","62","46798017"
"GL873545","11819705","11819955","chr19","2020493","2020758","80","9799212"
"GL873545","12502931","12503218","chr2","65135875","65136169","66","52632944"
"GL873546","5021263","5021515","chr2","169581435","169581714","71","164560172"
"GL873546","7372099","7372289","chr14","80626739","80626931","58","73254640"
"GL873546","8501657","8501934","chr3","32737543","32737819","79","24235886"
"GL873547","14483926","14484175","chr17","5367298","5367568","84","9116628"
"GL873548","133851","134130","chrX","55224636","55224920","65","55090785"
"GL873548","4969854","4970136","chrX","55224636","55224920","84","50254782"
"GL873548","7943503","7943547","chr19","54959514","54959555","21","47016011"
"GL873548","15989743","15990030","chr1","67234699","67234995","70","51244956"
"GL873548","16247733","16247866","chr2","61592918","61593048","30","45345185"
"GL873548","18432867","18433143","chrX","112773728","112774020","68","94340861"
"GL873549","2031533","2031800","chr14","49927239","49927502","76","47895706"
"GL873549","4931506","4931790","chr8","58734400","58734698","72","53802894"
"GL873549","5333448","5333610","chr7","143145911","143146065","53","137812463"
"GL873549","7247349","7247622","chr1","83241815","83242110","78","75994466"
"GL873550","7520634","7520880","chr16","19082504","19082778","87","11561870"
"GL873550","13348325","13348604","chr1","26639499","26639781","73","13291174"
"GL873551","4326719","4326966","chrX","26843012","26843290","78","22516293"
"GL873552","9468539","9468878","chr10","86678341","86678636","107","77209802"
"GL873552","11439967","11440139","chr13","97184541","97184703","53","85744574"
"GL873553","1912528","1912825","chr9","96507410","96507713","72","94594882"
"GL873553","12884955","12885275","chr11","30607961","30608285","83","17723006"
"GL873553","15802799","15802981","chr3","140730810","140730973","51","124928011"
"GL873554","1988516","1988798","chrX","55224636","55224920","69","53236120"
"GL873554","5336457","5336753","chr20","16108566","16108861","69","10772109"
"GL873554","16410261","16410441","chr3","3161474","3161686","62","13248787"
"GL873555","4492561","4492852","chr19","22339249","22339552","73","17846688"
"GL873556","11622534","11622794","chr6","34735928","34736196","73","23113394"
"GL873557","10602774","10603071","chr20","14090293","14090589","68","3487519"
"GL873557","12157885","12158169","chr6","162584905","162585198","71","150427020"
"GL873558","346264","346533","chr9","106250872","106251143","72","105904608"
"GL873558","5090920","5091134","chr14","49836076","49836279","59","44745156"
"GL873558","11729886","11730160","chr6","104679509","104679782","63","92949623"
"GL873560","1046330","1046605","chr2","201143682","201143964","67","200097352"
"GL873560","5671813","5672100","chr7","67169409","67169698","64","61497596"
"GL873560","10815152","10815418","chr1","235299218","235299490","78","224484066"
"GL873561","14329867","14330129","chr12","111859291","111859563","69","97529424"
"GL873562","11802995","11803177","chr7","35811742","35811944","67","24008747"
"GL873563","6278566","6278672","chr9","115984295","115984405","38","109705729"
"GL873563","10870912","10871197","chr3","10296315","10296606","71","574597"
"GL873563","13001119","13001319","chr2","170023412","170023582","73","157022293"
"GL873564","972189","972457","chr1","14170729","14171011","78","13198540"
"GL873564","7862152","7862443","chr2","231678442","231678735","73","223816290"
"GL873564","8111869","8112128","chr10","68640267","68640518","69","60528398"
"GL873564","12230896","12231176","chr1","28351164","28351446","74","16120268"
"GL873566","9383623","9383691","chr21","39552752","39552813","22","30169129"
"GL873567","1896908","1897190","chr4","12269186","12269474","70","10372278"
"GL873567","3951100","3951273","chr14","59643315","59643517","60","55692215"
"GL873567","8493033","8493231","chr3","113497708","113497874","71","105004675"
"GL873567","12071888","12072144","chr17","1499232","1499502","73","10572656"
"GL873567","12148816","12149129","chr13","45403656","45403954","74","33254840"
"GL873568","6129492","6129686","chr2","96904854","96905040","60","90775362"
"GL873568","6426355","6426519","chr1","227360296","227360433","62","220933941"
"GL873569","5489766","5490051","chr17","35840584","35840874","67","30350818"
"GL873569","6518440","6518694","chr15","72152863","72153142","72","65634423"
"GL873569","11036395","11036693","chr2","170023583","170023875","75","158987188"
"GL873569","11251153","11251422","chrX","55224636","55224920","78","43973483"
"GL873571","3918742","3919031","chr5","44864227","44864507","74","40945485"
"GL873571","6938648","6938836","chr6","21794552","21794732","63","14855904"
"GL873571","7974878","7975090","chr9","116385032","116385234","70","108410154"
"GL873572","5333658","5333936","chr17","66995570","66995859","69","61661912"
"GL873572","8086416","8086544","chr2","173631978","173632112","39","165545562"
"GL873572","8292948","8293070","chr2","173631978","173632112","43","165339030"
"GL873572","9337676","9337961","chr13","45403656","45403954","75","36065980"
"GL873573","561846","562000","chr4","109701436","109701591","39","109139590"
"GL873573","809429","809661","chr16","63619829","63620079","75","62810400"
"GL873576","10227779","10228037","chr22","33503551","33503822","77","23275772"
"GL873576","10845861","10846063","chr11","50225028","50225232","62","39379167"
"GL873577","2543150","2543436","chr1","8289971","8290262","73","5746821"
"GL873577","6370827","6370932","chr2","100571168","100571288","42","94200341"
"GL873578","6246812","6246921","chr2","24374869","24374994","34","18128057"
"GL873579","1773131","1773405","chr7","74624911","74625199","73","72851780"
"GL873579","4903911","4904118","chr2","36522956","36523146","63","31619045"
"GL873579","5947173","5947436","chr6","28874908","28875176","63","22927735"
"GL873580","3276777","3277037","chr9","72503441","72503711","70","69226664"
"GL873580","853240","853398","chr3","109322744","109322904","40","108469504"
"GL873580","5868817","5869123","chr20","51731025","51731328","73","45862208"
"GL873581","838124","838393","chr1","40452976","40453258","139","39614852"
"GL873581","8343445","8343516","chr21","39552752","39552813","31","31209307"
"GL873581","9335059","9335345","chr11","111421633","111421923","72","102086574"
"GL873582","8128619","8128894","chr14","49927239","49927502","70","41798620"
"GL873583","5217241","5217516","chrX","55224636","55224920","63","50007395"
"GL873584","10767629","10767932","chr8","57072389","57072688","65","46304760"
"GL873585","115904","116160","chr7","142233458","142233716","69","142117554"
"GL873585","1653672","1653707","chrX","1092622","1092672","19","561050"
"GL873585","8812888","8813010","chr2","170023876","170024000","34","161210988"
"GL873585","10753608","10753875","chr9","72503441","72503711","69","61749833"
"GL873587","2344327","2344496","chr8","127885951","127886126","45","125541624"
"GL873588","5747142","5747412","chr8","123404556","123404839","83","117657414"
"GL873589","3491562","3491824","chr20","64194890","64195153","75","60703328"
"GL873589","9310653","9310947","chr2","125375828","125376123","64","116065175"
"GL873590","6901922","6902119","chr12","40231820","40232028","70","33329898"
"GL873590","9938249","9938516","chr2","223882118","223882412","78","213943869"
"GL873592","30274","30479","chr22","42656270","42656475","55","42625996"
"GL873592","3504292","3504588","chr15","67855328","67855624","64","64351036"
"GL873593","5742466","5742735","chr3","136776011","136776292","81","131033545"
"GL873595","7314096","7314202","chr2","231352866","231352983","39","224038770"
"GL873596","9289810","9289980","chr9","129668868","129669059","57","120379058"
"GL873597","5136350","5136508","chr3","47769235","47769407","59","42632885"
"GL873598","6925865","6926121","chr2","27386559","27386837","72","20460694"
"GL873600","6358350","6358621","chr13","32634584","32634880","71","26276234"
"GL873601","87941","88233","chr4","102449088","102449378","80","102361147"
"GL873602","1717997","1718263","chrX","517601","517871","77","1200396"
"GL873602","5655744","5656017","chrX","55224636","55224920","65","49568892"
"GL873603","2673070","2673193","chr13","40398568","40398692","33","37725498"
"GL873603","3472302","3472505","chr12","40231820","40232028","67","36759518"
"GL873605","18668","18855","chr14","59643315","59643517","55","59624647"
"GL873605","211678","211971","chr17","69402401","69402693","68","69190723"
"GL873606","413534","413591","chr8","139197823","139197875","18","138784289"
"GL873606","869307","869506","chr7","35811742","35811944","57","34942435"
"GL873606","1561852","1561999","chr3","34372251","34372405","62","32810399"
"GL873606","1584393","1584659","chr1","224254096","224254389","77","222669703"
"GL873606","6040743","6040839","chr2","199499689","199499774","31","193458946"
"GL873606","6713005","6713204","chr14","59643315","59643517","50","52930310"
"GL873607","468681","468880","chr5","123226004","123226222","65","122757323"
"GL873607","3783696","3783827","chr10","121987615","121987745","38","118203919"
"GL873607","5526364","5526636","chr2","196184692","196184969","75","190658328"
"GL873608","3484994","3485156","chr2","223829691","223829856","36","220344697"
"GL873609","279360","279651","chr18","64655299","64655599","83","64375939"
"GL873609","404482","404767","chr3","194394252","194394535","94","193989770"
"GL873609","1717159","1717438","chr6","73261632","73261927","72","71544473"
"GL873610","4454076","4454255","chr13","52197196","52197377","48","47743120"
"GL873610","6659947","6660135","chr6","119819675","119819867","59","113159728"
"GL873610","7088038","7088189","chr17","30594089","30594249","33","23506051"
"GL873611","3341174","3341447","chr9","94719361","94719654","71","91378187"
"GL873611","3648898","3649188","chr15","38340532","38340829","67","34691634"
"GL873611","4326462","4326733","chr14","53013390","53013657","72","48686928"
"GL873611","4410882","4411174","chr7","138700336","138700637","74","134289454"
"GL873611","6208697","6208910","chr7","35811742","35811944","55","29603045"
"GL873614","2464368","2464650","chr10","67795993","67796273","74","65331625"
"GL873614","2570666","2570909","chr10","94643984","94644261","86","92073318"
"GL873614","6206177","6206481","chr5","14785773","14786068","76","8579596"
"GL873615","2242583","2242882","chr13","59509361","59509664","63","57266778"
"GL873615","5164234","5164521","chr10","87654693","87654982","61","82490459"
"GL873617","1608528","1608820","chr13","44344814","44345110","75","42736286"
"GL873617","5505209","5505476","chr14","49927239","49927502","68","44422030"
"GL873617","6429598","6429710","chr3","113988214","113988347","38","107558616"
"GL873618","916822","917081","chr6","36051119","36051406","83","35134297"
"GL873618","1039454","1039766","chr6","118499384","118499693","71","117459930"
"GL873618","3344163","3344386","chr12","13969892","13970114","65","10625729"
"GL873619","529429","529700","chr5","160085027","160085298","80","159555598"
"GL873619","3251154","3251417","chr14","53013390","53013657","70","49762236"
"GL873619","4427770","4427819","chr12","56396605","56396649","18","51968835"
"GL873619","5715463","5715603","chr18","68540799","68540957","47","62825336"
"GL873621","270115","270296","chr14","67291389","67291582","56","67021274"
"GL873621","5018554","5018827","chrX","55224636","55224920","79","50206082"
"GL873623","3165346","3165445","chr9","33875018","33875112","23","30709672"
"GL873623","7055444","7055732","chr10","84697942","84698235","64","77642498"
"GL873625","3540946","3541225","chr2","61891454","61891742","76","58350508"
"GL873629","2808739","2809002","chr17","1499232","1499502","71","1309507"
"GL873629","3057379","3057506","chr10","121987615","121987745","26","118930236"
"GL873629","3330842","3331122","chr17","58709093","58709376","73","55378251"
"GL873629","4046390","4046644","chr4","67810884","67811156","78","63764494"
"GL873631","1463608","1463909","chr8","20833834","20834143","73","19370226"
"GL873631","2876948","2877168","chr9","108009397","108009611","61","105132449"
"GL873633","6680180","6680479","chrX","67273616","67273911","67","60593436"
"GL873634","6070241","6070482","chr8","17025895","17026133","65","10955654"
"GL873635","3143338","3143625","chr2","240609965","240610251","61","237466627"
"GL873636","45557","45823","chr5","51715346","51715619","72","51669789"
"GL873637","4322064","4322316","chr9","67842125","67842372","75","63520061"
"GL873637","4379152","4379361","chr1","227457690","227457892","63","223078538"
"GL873639","638719","639018","chr3","98948537","98948832","65","98309818"
"GL873639","2243846","2244046","chr14","59643315","59643517","50","57399469"
"GL873640","4602583","4602770","chr14","67291389","67291582","49","62688806"
"GL873641","3204960","3205135","chr17","43420283","43420483","60","40215323"
"GL873642","2370313","2370502","chr6","119819675","119819867","55","117449362"
"GL873642","3375546","3375787","chr7","20442726","20442982","81","17067180"
"GL873645","923581","923868","chr1","17910953","17911253","67","16987372"
"GL873645","4984041","4984262","chr22","41890709","41890932","55","36906668"
"GL873646","917757","918050","chr6","156672168","156672455","69","155754411"
"GL873646","3489451","3489745","chr7","143739013","143739307","67","140249562"
"GL873647","344182","344454","chrX","55224636","55224920","69","54880454"
"GL873647","3251123","3251165","chr17","793119","793162","7","2458004"
"GL873648","2930273","2930481","chr14","67291389","67291582","62","64361116"
"GL873648","3742434","3742707","chr1","14170729","14171011","69","10428295"
"GL873649","2198171","2198363","chr2","36522956","36523146","57","34324785"
"GL873652","2033772","2033917","chr3","42873656","42873818","47","40839884"
"GL873652","2538738","2539020","chrX","55224636","55224920","61","52685898"
"GL873653","1770690","1770966","chrX","55224636","55224920","69","53453946"
"GL873653","3498676","3498727","chr18","13665065","13665111","24","10166389"
"GL873653","3498985","3499036","chr21","39552752","39552813","19","36053767"
"GL873654","370003","370233","chr1","16343570","16343827","80","15973567"
"GL873654","829106","829286","chr3","49066456","49066664","57","48237350"
"GL873654","4345527","4345632","chr5","37274766","37274837","49","32929239"
"GL873656","1570706","1570816","chr19","7865805","7865904","55","6295099"
"GL873659","2345965","2346133","chr9","129668868","129669059","66","127322903"
"GL873661","3259618","3259835","chr1","212317706","212317938","80","209058088"
"GL873662","1156905","1157091","chr14","67291389","67291582","56","66134484"
"GL873662","1216517","1216580","chrX","5594480","5594543","13","4377963"
"GL873662","3546601","3546766","chr7","143145911","143146065","54","139599310"
"GL873664","3452535","3452748","chr7","101311730","101311954","60","97859195"
"GL873665","1381255","1381541","chr14","74054374","74054674","72","72673119"
"GL873666","2597601","2597880","chrX","55224636","55224920","73","52627035"
"GL873666","2806877","2807132","chr10","54915831","54916096","80","52108954"
"GL873667","940378","940498","chr2","100571168","100571288","39","99630790"
"GL873668","1632691","1632893","chr14","59643315","59643517","49","58010624"
"GL873670","1907628","1907917","chr1","30178549","30178846","85","28270921"
"GL873671","886108","886393","chr2","61891454","61891742","71","61005346"
"GL873671","1882360","1882615","chr21","26735648","26735898","62","24853288"
"GL873671","2621633","2621694","chr21","39552752","39552813","17","36931119"
"GL873671","4340632","4340927","chr17","3990107","3990400","71","350525"
"GL873672","1567049","1567194","chr11","9341312","9341469","42","7774263"
"GL873673","4474890","4475153","chr12","102604729","102604974","74","98129839"
"GL873674","581213","581499","chr15","79997518","79997815","75","79416305"
"GL873676","2872519","2872697","chr13","52197196","52197377","55","49324677"
"GL873677","3241750","3241856","chr15","50700655","50700775","37","47458905"
"GL873677","4159374","4159672","chr2","238176136","238176430","72","234016762"
"GL873678","675254","675318","chr21","39552752","39552813","17","38877498"
"GL873679","851989","852265","chr20","8226691","8226986","80","7374702"
"GL873683","490677","490883","chr14","33120053","33120258","55","32629376"
"GL873683","518085","518266","chr1","227457690","227457892","55","226939605"
"GL873685","2961205","2961462","chr4","25098162","25098423","74","22136957"
"GL873685","3163893","3164141","chr2","159560573","159560825","95","156396680"
"GL873687","2386388","2386673","chrX","55224636","55224920","78","52838248"
"GL873689","3224911","3225054","chr13","97184541","97184703","60","93959630"
"GL873693","2376743","2376906","chr19","17958484","17958654","45","15581741"
"GL873695","2844578","2844737","chr5","142646651","142646791","50","139802073"
"GL873696","323840","324122","chr20","41886630","41886923","73","41562790"
"GL873698","191566","191806","chr14","64557730","64557993","83","64366164"
"GL873698","2270983","2271091","chr9","92541441","92541543","38","90270458"
"GL873700","779773","780090","chr4","87689248","87689544","79","86909475"
"GL873700","784432","784686","chr10","132015520","132015785","69","131231088"
"GL873700","1267399","1267642","chr12","54757694","54757924","68","53490295"
"GL873707","1412783","1413068","chr12","2660544","2660835","75","1247761"
"GL873711","600516","600812","chr7","135473966","135474273","70","134873450"
"GL873712","758777","759067","chr5","74646567","74646865","65","73887790"
"GL873714","1365540","1365729","chr13","69167868","69168029","69","67802328"
"GL873715","280277","280452","chr3","34372251","34372405","74","34091974"
"GL873719","1332085","1332336","chr4","25098162","25098423","75","23766077"
"GL873719","2249405","2249681","chr17_GL000258v2_alt","507911","508187","70","1741494"
"GL873721","2069601","2069880","chr6","159636021","159636309","80","157566420"
"GL873722","41873","42081","chr9","116385032","116385234","62","116343159"
"GL873726","367205","367447","chr16_KI270853v1_alt","1571619","1571861","67","1204414"
"GL873726","694718","694901","chrX","1806005","1806193","58","1111287"
"GL873726","1557093","1557383","chr20","33436984","33437277","69","31879891"
"GL873728","590192","590366","chr22","24084241","24084413","40","23494049"
"GL873728","2347875","2348140","chr1","154661914","154662183","73","152314039"
"GL873730","872629","872863","chrX","11590998","11591218","72","10718369"
"GL873731","1122838","1123027","chr14","67291389","67291582","41","66168551"
"GL873731","1140299","1140488","chr2","96904854","96905040","53","95764555"
"GL873731","1216076","1216245","chr2","96904854","96905040","59","95688778"
"GL873731","1624838","1625067","chr10","50690978","50691205","66","49066140"
"GL873733","1761992","1762209","chr7","72514181","72514388","64","70752189"
"GL873737","1509883","1510083","chr19","3169001","3169198","57","1659118"
"GL873738","274991","275089","chr6","92059070","92059144","41","91784079"
"GL873738","275156","275308","chr3","100409363","100409531","52","100134207"
"GL873738","340616","340915","chr13","32634584","32634880","77","32293968"
"GL873738","1279557","1279792","chr19","9537650","9537881","66","8258093"
"GL873739","1496142","1496416","chr2","174203800","174204092","79","172707658"
"GL873744","926494","926690","chr8","67278566","67278776","55","66352072"
"GL873746","1434521","1434693","chr2","36522956","36523146","59","35088435"
"GL873749","2051730","2051995","chr20","34357868","34358141","92","32306138"
"GL873752","304509","304789","chr3","176576423","176576703","79","176271914"
"GL873752","823627","823891","chr10","94643984","94644261","80","93820357"
"GL873752","1607452","1607687","chr13","47209933","47210171","62","45602481"
"GL873762","776077","776256","chr14","59643315","59643517","54","58867238"
"GL873768","208772","208940","chr3","47769235","47769407","39","47560463"
"GL873772","558391","558592","chr18","57686491","57686718","67","57128100"
"GL873778","812679","812951","chrX","55224636","55224920","73","54411957"
"GL873780","151869","151943","chr16","30842871","30842945","19","30691002"
"GL873782","254816","254927","chr9","115984295","115984405","34","115729479"
"GL873786","921802","922045","chr4","7124471","7124711","81","6202669"
"GL873786","1119085","1119310","chr2","207650079","207650315","58","206530994"
"GL873799","235420","235499","chr1","234890486","234890570","22","234655066"
"GL873799","235575","235812","chr13","47209933","47210171","61","46974358"
"GL873807","378787","379071","chr1","100032556","100032844","54","99653769"
"GL873808","29232","29435","chr17","5245735","5245941","61","5216503"
"GL873808","245245","245520","chr6","34735928","34736196","97","34490683"
"GL873808","371997","372271","chr6","34735928","34736196","101","34363931"
"GL873808","383398","383628","chr9","125223000","125223217","81","124839602"
"GL873812","573147","573383","chr7","56728929","56729167","63","56155782"
"GL873812","573691","573747","chr7","22812815","22812861","24","22239124"
"GL873814","114306","114462","chr17","30594089","30594249","38","30479783"
"GL873819","193599","193703","chr16","21397893","21397985","49","21204294"
"GL873827","559389","559662","chr6","34735928","34736196","99","34176539"
"GL873827","592240","592445","chr17","4921130","4921315","70","4328890"
"GL873834","433660","433828","chr13","52197196","52197377","60","51763536"
"GL873835","129882","130157","chr6","34735928","34736196","100","34606046"
"GL873835","310078","310363","chr4","75609325","75609606","93","75299247"
"GL873835","316478","316752","chr6","34735928","34736196","102","34419450"
"GL873835","321278","321472","chr2","96904854","96905040","71","96583576"
"GL873835","506358","506631","chr6","34735928","34736196","99","34229570"
"GL873837","334462","334752","chr12","128991011","128991299","89","128656549"
"GL873905","48652","48939","chr3","25807686","25807965","72","25759034"
"GL874082","9765","10044","chr6","34735928","34736196","86","34726163"
"AAQR03192370","4914","5177","chr12","4102587","4102864","90","4097673"
