"KN294161v1","307326","307622","chr4","53571955","53572251","28","53264629"
"KN294166v1","9894","10200","chr15","75070840","75071138","39","75060946"
"KN294172v1","193457","193751","chr15","75070840","75071138","31","74877383"
"KN294172v1","1444873","1445169","chr22","44412777","44413080","25","42967904"
"KN294172v1","2170212","2170352","chr22","43674104","43674247","21","41503892"
"KN294172v1","2363524","2363818","chr22","43474303","43474600","33","41110779"
"KN294172v1","2397219","2397522","chr22","43446469","43446762","29","41049250"
"KN294172v1","4505373","4505684","chr11","111930602","111930899","44","107425229"
"KN294172v1","4781360","4781618","chr2B","201473739","201474017","57","196692379"
"KN294172v1","5053252","5053542","chr15","71549667","71549957","37","66496415"
"KN294172v1","5593073","5593381","chr1","12373339","12373643","38","6780266"
"KN294172v1","5607071","5607370","chr17","45366522","45366820","35","39759451"
"KN294172v1","6646228","6646523","chr14","48956321","48956614","36","42310093"
"KN294172v1","6790530","6790842","chr22","38975723","38976032","18","32185193"
"KN294175v1","66217","66398","chr2B","132000001","132000178","37","131933784"
"KN294175v1","89057","89357","chr7","65254566","65254862","30","65165509"
"KN294187v1","248956","249258","chr9","103481429","103481732","32","103232473"
"KN294187v1","1749261","1749424","chr8","19760821","19760989","26","18011560"
"KN294187v1","1997119","1997413","chr7","1419297","1419594","40","577822"
"KN294193v1","139152","139515","chr19","56758284","56758609","77","56619132"
"KN294193v1","410994","411281","chr17","71854557","71854855","34","71443563"
"KN294193v1","803542","803848","chr16","20295189","20295498","37","19491647"
"KN294207v1","58858","59164","chr3","67835473","67835776","38","67776615"
"KN294214v1","1526703","1526983","chr11","9789053","9789338","44","8262350"
"KN294218v1","619296","619604","chr10","2558754","2559058","39","1939458"
"KN294224v1","695582","695803","chr6","99816809","99817031","38","99121227"
"KN294234v1","408475","408772","chr14","48956321","48956614","40","48547846"
"KN294234v1","942827","943124","chr19","7755139","7755434","38","6812312"
"KN294239v1","574611","574910","chr7","144736012","144736310","38","144161401"
"KN294239v1","906177","906358","chrUn_GL393543","46328","46509","31","859849"
"KN294239v1","1110212","1110478","chr9","111370695","111370965","47","110260483"
"KN294239v1","1846063","1846349","chr11","111930602","111930899","51","110084539"
"KN294239v1","1921121","1921423","chr5","42238471","42238773","29","40317350"
"KN294245v1","62355","62662","chr4","73419052","73419362","36","73356697"
"KN294245v1","1520647","1520918","chr4","43571199","43571468","34","42050552"
"KN294251v1","1428406","1428702","chr19","59076998","59077292","24","57648592"
"KN294251v1","2791106","2791407","chr6","52488538","52488832","35","49697432"
"KN294257v1","448576","448839","chr6","26550428","26550709","44","26101852"
"KN294257v1","2713583","2713878","chr7","70873003","70873306","36","68159420"
"KN294260v1","2520484","2520738","chr3","3343502","3343757","27","823018"
"KN294262v1","2410280","2410565","chr1","164444571","164444855","23","162034291"
"KN294266v1","72717","73027","chr1","176516666","176516976","44","176443949"
"KN294266v1","135124","135424","chr12","38207492","38207794","30","38072368"
"KN294266v1","182505","182761","chr14","75004392","75004649","44","74821887"
"KN294269v1","1120063","1120370","chr11","77752199","77752508","36","76632136"
"KN294278v1","2089","2396","chr3","137048504","137048805","41","137046415"
"KN294284v1","116704","117004","chr7","4420760","4421054","43","4304056"
"KN294287v1","854859","855019","chr7","153741375","153741543","32","152886516"
"KN294302v1","648826","649071","chr10","57520891","57521144","30","56872065"
"KN294318v1","317248","317542","chr12","18605491","18605784","34","18288243"
"KN294325v1","802649","802689","chrX","39082350","39082391","23","38279701"
"KN294346v1","268740","269079","chr11","3925406","3925739","59","3656666"
"KN294346v1","613519","613761","chr7","97687407","97687651","38","97073888"
"KN294351v1","52492","52800","chr8","44626416","44626713","38","44573924"
"KN294364v1","21313","21595","chr18","27855946","27856234","39","27834633"
"KN294364v1","232041","232177","chr2A","53659147","53659279","16","53427106"
"KN294372v1","355288","355461","chr17","7159736","7159920","33","6804448"
"KN294372v1","1423120","1423421","chr15","75070840","75071138","46","73647720"
"KN294372v1","2362490","2362831","chr17","36920129","36920442","83","34557639"
"KN294373v1","59785","60012","chrX","48502699","48502954","59","48442914"
"KN294378v1","554715","555017","chr16","18105048","18105351","32","17550333"
"KN294378v1","1301902","1302178","chr12","99464978","99465256","54","98163076"
"KN294387v1","1902122","1902324","chr9","124034099","124034298","33","122131977"
"KN294407v1","45031","45313","chr6","156580972","156581251","53","156535941"
"KN294407v1","678185","678402","chr1","53127739","53127954","40","52449554"
"KN294407v1","702553","702860","chr1","53148107","53148405","44","52445554"
"KN294407v1","1955491","1955774","chr1","54402574","54402862","27","52447083"
"KN294407v1","3179346","3179634","chr8","118683505","118683789","41","115504159"
"KN294410v1","5699","5896","chr3","164324522","164324716","29","164318823"
"KN294410v1","46490","46767","chr7","114238952","114239231","39","114192462"
"KN294410v1","104662","104911","chr4","94066984","94067212","49","93962322"
"KN294416v1","481595","481879","chr13","50204940","50205223","33","49723345"
"KN294416v1","812211","812430","chr2A","37250953","37251159","31","36438742"
"KN294421v1","1011461","1011754","chr2B","204818038","204818333","24","203806577"
"KN294421v1","1621756","1621908","chr3","176404519","176404679","36","174782763"
"KN294433v1","277171","277464","chr3","183335337","183335631","29","183058166"
"KN294433v1","428515","428810","chr3","183203955","183204231","38","182775440"
"KN294446v1","261105","261414","chr10","67005797","67006105","35","66744692"
"KN294446v1","431242","431529","chr1","124931506","124931799","36","124500264"
"KN294446v1","1080420","1080614","chr10","66166629","66166815","24","65086209"
"KN294451v1","686873","687167","chr18","3402396","3402682","43","2715523"
"KN294456v1","190191","190470","chr15","75070840","75071138","36","74880649"
"KN294456v1","357446","357738","chr1","226608896","226609182","51","226251450"
"KN294456v1","405518","405820","chr7","73708656","73708959","36","73303138"
"KN294457v1","697347","697629","chr1","146195212","146195486","52","145497865"
"KN294458v1","1248815","1249123","chr9","96913445","96913753","24","95664630"
"KN294462v1","666236","666543","chr6","32365899","32366198","40","31699663"
"KN294467v1","102352","102607","chr1","185272132","185272389","48","185169780"
"KN294468v1","97640","97942","chr16","45220921","45221224","39","45123281"
"KN294470v1","800276","800397","chr15","88289954","88290073","25","87489678"
"KN294470v1","2279432","2279734","chr11","111930602","111930899","43","109651170"
"KN294470v1","2910812","2911110","chr6","90061121","90061419","21","87150309"
"KN294472v1","399904","400205","chr7","157027266","157027563","112","156627362"
"KN294475v1","442085","442319","chr19","3469504","3469735","48","3027419"
"KN294475v1","754668","754965","chr7","20580302","20580602","28","19825634"
"KN294485v1","168653","168932","chr1","146195212","146195486","36","146026559"
"KN294498v1","475089","475368","chr6","156580972","156581251","42","156105883"
"KN294499v1","1091416","1091581","chr8","19760821","19760989","28","18669405"
"KN294499v1","1574655","1574684","chr1","152489761","152489794","17","150915106"
"KN294499v1","1574725","1574851","chr21","29359263","29359383","20","27784538"
"KN294499v1","1584773","1584936","chr11","60701510","60701681","37","59116737"
"KN294499v1","1585214","1585357","chr3","123495574","123495719","22","121910360"
"KN294501v1","20985","21251","chr18","27855946","27856234","42","27834961"
"KN294501v1","3681566","3681849","chr14","39602194","39602488","38","35920628"
"KN294506v1","315525","315828","chr7","72551487","72551785","32","72235962"
"KN294506v1","358338","358621","chr4","39285304","39285592","43","38926966"
"KN294509v1","304991","305302","chr1","176516666","176516976","41","176211675"
"KN294509v1","549741","550047","chr14","32539017","32539327","33","31989276"
"KN294520v1","41745","42044","chr15","75070840","75071138","33","75029095"
"KN294526v1","50624","50902","chr3","51909182","51909457","30","51858558"
"KN294526v1","514738","515035","chr5","81662133","81662434","37","81147395"
"KN294530v1","204999","205313","chr11","88223902","88224213","35","88018903"
"KN294536v1","321945","322146","chr9","124034099","124034298","33","123712154"
"KN294536v1","1624280","1624588","chr10","101381645","101381953","39","99757365"
"KN294536v1","1964698","1965005","chr2B","206850402","206850711","34","204885704"
"KN294561v1","610052","610335","chr19","59076998","59077292","33","58466946"
"KN294569v1","266100","266272","chr8","68464561","68464738","23","68198461"
"KN294570v1","349094","349379","chr5","11118724","11119017","40","10769630"
"KN294571v1","700601","700892","chr16","2115667","2115968","43","1415066"
"KN294571v1","775939","776238","chr4","40048901","40049199","37","39272962"
"KN294571v1","855468","855760","chr16","4782218","4782514","45","3926750"
"KN294573v1","190192","190455","chr9","111370695","111370965","53","111180503"
"KN294578v1","608930","609239","chr2A","65849710","65850020","39","65240780"
"KN294588v1","625146","625434","chr18","32707337","32707617","32","32082191"
"KN294588v1","2463719","2463999","chr6","156580972","156581251","38","154117253"
"KN294591v1","117407","117721","chr14","34498958","34499256","31","34381551"
"KN294591v1","186818","187131","chr14","34426521","34426836","29","34239703"
"KN294592v1","1127024","1127330","chr17","15448023","15448335","30","14320999"
"KN294592v1","1153178","1153478","chr11","111930602","111930899","39","110777424"
"KN294592v1","1309288","1309598","chr17","15616514","15616820","28","14307226"
"KN294599v1","176047","176332","chr17","42461889","42462183","43","42285842"
"KN294602v1","78908","79229","chr10","97174301","97174611","47","97095393"
"KN294613v1","514142","514439","chr16","29828279","29828575","24","29314137"
"KN294619v1","142264","142573","chr11","18960321","18960630","31","18818057"
"KN294630v1","180208","180517","chr7","99112842","99113150","31","98932634"
"KN294650v1","556179","556473","chr15","75070840","75071138","34","74514661"
"KN294657v1","679709","680041","chr5","140882851","140883163","47","140203142"
"KN294668v1","3874310","3874561","chrX","48502699","48502954","45","44628389"
"KN294685v1","345092","345373","chr6","156580972","156581251","36","156235880"
"KN294685v1","717312","717577","chr1","129825886","129826175","54","129108574"
"KN294685v1","844279","844575","chr6","20388964","20389256","41","19544685"
"KN294693v1","52972","53179","chr7","67027689","67027916","62","66974717"
"KN294701v1","20959","21253","chr8","97411994","97412282","48","97391035"
"KN294705v1","197857","198143","chr3","50032872","50033150","104","49835015"
"KN294705v1","1312379","1312673","chr1","32384668","32384968","32","31072289"
"KN294705v1","1350040","1350340","chr19","7755139","7755434","47","6405099"
"KN294705v1","1388466","1388749","chr18","32707337","32707617","43","31318871"
"KN294705v1","1778649","1778810","chr1","40639893","40640055","23","38861244"
"KN294705v1","1779121","1779264","chr9","7441718","7441851","25","5662597"
"KN294705v1","1806469","1806670","chr3","78120642","78120843","29","76314173"
"KN294705v1","1818305","1818472","chr15","94283880","94284048","26","92465575"
"KN294705v1","1818777","1818911","chr17","2157520","2157653","16","338743"
"KN294705v1","1889536","1889835","chr15","75070840","75071138","39","73181304"
"KN294705v1","1926600","1926891","chr1","33033617","33033913","40","31107017"
"KN294713v1","467007","467139","chr3","139937892","139938024","17","139470885"
"KN294729v1","2060","2196","chr14","103494107","103494239","22","103492047"
"KN294729v1","2689","2859","chr11","60701510","60701681","26","60698821"
"KN294733v1","476787","477063","chr3","50032872","50033150","36","49556085"
"KN294739v1","639168","639467","chr7","70873003","70873306","32","70233835"
"KN294739v1","893477","893783","chr7","73708656","73708959","46","72815179"
"KN294741v1","331830","332129","chr15","23601488","23601788","33","23269658"
"KN294741v1","2010763","2011044","chr15","71549667","71549957","44","69538904"
"KN294747v1","895423","895676","chr14","75004392","75004649","49","74108969"
"KN294758v1","1463196","1463488","chr5","144544636","144544932","36","143081440"
"KN294758v1","1613338","1613644","chr17","62893859","62894162","40","61280521"
"KN294758v1","1884321","1884573","chr14","75004392","75004649","49","73120071"
"KN294758v1","2342141","2342445","chr7","72551487","72551785","39","70209346"
"KN294761v1","933510","933675","chr7","153741375","153741543","24","152807865"
"KN294761v1","1578669","1578964","chr14","48956321","48956614","39","47377652"
"KN294764v1","786069","786231","chr12","19770311","19770462","34","18984242"
"KN294764v1","864364","864663","chr13","61715744","61716039","25","60851380"
"KN294781v1","4147","4443","chr5","19750532","19750829","34","19746385"
"KN294786v1","234898","235060","chr5","110791998","110792152","26","110557100"
"KN294789v1","100483","100673","chr15","94282660","94282858","36","94182177"
"KN294790v1","3262293","3262607","chr10","124920635","124920947","36","121658342"
"KN294790v1","6237118","6237424","chr10","127985325","127985625","33","121748207"
"KN294827v1","198124","198410","chr4","51132690","51132975","12","50934566"
"KN294837v1","358626","358923","chr1","124931506","124931799","36","124572880"
"KN294842v1","200339","200637","chr12","38313349","38313646","34","38113010"
"KN294842v1","558281","558580","chr22","27800913","27801213","29","27242632"
"KN294847v1","738","946","chr9","80453302","80453515","32","80452564"
"KN294848v1","646452","646752","chr5","42238471","42238773","49","41592019"
"KN294856v1","363516","363791","chr9","130199403","130199681","44","129835887"
"KN294864v1","446867","447160","chr4","170350489","170350789","40","169903622"
"KN294873v1","988553","988882","chr14","68122340","68122661","46","67133787"
"KN294873v1","1268509","1268790","chr18","32707337","32707617","42","31438828"
"KN294874v1","3580","3889","chr5","19039208","19039511","45","19035628"
"KN294874v1","24300","24608","chr15","37513463","37513771","25","37489163"
"KN294879v1","1481412","1481695","chr2A","70249434","70249716","44","68768022"
"KN294884v1","252850","253162","chr2A","35190841","35191151","31","34937991"
"KN294900v1","782886","783182","chr19","42324529","42324827","52","41541643"
"KN294904v1","94850","95036","chr7","88863909","88864111","41","88769059"
"KN294906v1","443411","443603","chr3","164324522","164324716","35","163881111"
"KN294911v1","2027339","2027634","chr5","135512787","135513083","39","133485448"
"KN294911v1","2166861","2167156","chr5","135366222","135366515","28","133199361"
"KN294911v1","2810433","2810729","chr7","144736012","144736310","31","141925579"
"KN294911v1","4008790","4009092","chr5","133544461","133544766","35","129535671"
"KN294920v1","344339","344633","chr11","96313283","96313580","30","95968944"
"KN294940v1","265758","265931","chr15","39903810","39903983","23","39638052"
"KN294940v1","267227","267400","chr15","39903810","39903983","24","39636583"
"KN294949v1","752332","752605","chr1","146195212","146195486","41","145442880"
"KN294961v1","16282","16378","chr1","226740878","226740970","26","226724596"
"KN294964v1","739494","739786","chr2B","223551961","223552253","34","222812467"
"KN294964v1","1095677","1095937","chr17","49810495","49810761","54","48714818"
"KN294964v1","1390908","1391246","chr11","3925406","3925739","43","2534498"
"KN294964v1","1451130","1451429","chr2B","224274096","224274389","36","222822966"
"KN294964v1","1513398","1513523","chr19","7877792","7877921","20","6364394"
"KN294964v1","1513573","1513744","chr15","94283880","94284048","30","92770307"
"KN294977v1","54906","55212","chr22","46784407","46784717","47","46729501"
"KN294978v1","1143311","1143617","chr14","36790752","36791055","41","35647441"
"KN294987v1","494557","494865","chr1","36014417","36014725","28","35519860"
"KN294995v1","15303","15491","chrX","124931070","124931259","31","124915767"
"KN294996v1","419207","419500","chr16","56722541","56722831","33","56303334"
"KN294996v1","603812","604106","chr1","124931506","124931799","32","124327694"
"KN295034v1","947734","948044","chr2A","65849710","65850020","38","64901976"
"KN295037v1","268015","268318","chr7","64915461","64915764","30","64647446"
"KN295038v1","319989","320287","chr7","144736012","144736310","33","144416023"
"KN295045v1","746047","746348","chr22","30150689","30150995","34","29404642"
"KN295045v1","916877","917090","chr4","40720908","40721122","38","39804031"
"KN295045v1","1057506","1057818","chr11","124343401","124343710","42","123285895"
"KN295054v1","50270","50548","chr9","117129071","117129338","43","117078801"
"KN295054v1","317541","317876","chr21","27413261","27413587","59","27095720"
"KN295075v1","456873","457181","chr15","80365710","80366018","37","79908837"
"KN295077v1","592095","592387","chr11","105684369","105684665","25","105092274"
"KN295077v1","750320","750623","chr11","105523387","105523688","38","104773067"
"KN295090v1","576386","576682","chr5","144544636","144544932","37","143968250"
"KN295090v1","1107760","1108048","chr11","111930602","111930899","40","110822842"
"KN295090v1","1662653","1662940","chr4","37759492","37759775","38","36096839"
"KN295090v1","1717882","1718181","chr9","129352712","129353013","37","127634830"
"KN295090v1","2487229","2487538","chr5","13282747","13283051","39","10795518"
"KN295090v1","2859031","2859321","chr7","35122965","35123263","32","32263934"
"KN295091v1","2731940","2732235","chr6","152618192","152618486","40","149886252"
"KN295091v1","2770000","2770201","chr9","124034099","124034298","28","121264099"
"KN295096v1","1395803","1396113","chr7","144736012","144736310","36","143340209"
"KN295107v1","483","776","chr5","144544636","144544932","42","144544153"
"KN295107v1","1361853","1362160","chr7","35122965","35123263","33","33761112"
"KN295112v1","504500","504794","chr16","9335700","9336002","36","8831200"
"KN295142v1","1701178","1701340","chr8","58740673","58740858","44","57039495"
"KN295159v1","661534","661832","chr4","63141903","63142195","38","62480369"
"KN295162v1","244141","244428","chr1","124931506","124931799","39","124687365"
"KN295171v1","152286","152450","chr20","30959776","30959938","22","30807490"
"KN295171v1","152553","152735","chr10","66166629","66166815","35","66014076"
"KN295171v1","374126","374428","chr16","2115667","2115968","32","1741541"
"KN295174v1","528794","529088","chr15","93880704","93881005","26","93351910"
"KN295195v1","47933","48067","chr3","139937892","139938024","17","139889959"
"KN295195v1","48388","48412","chr1","152489761","152489794","20","152441373"
"KN295202v1","91675","91985","chr1","36014417","36014725","108","35922742"
"KN295202v1","258608","258903","chr7","72551487","72551785","46","72292879"
"KN295202v1","1578637","1578837","chr7","88863909","88864111","36","87285272"
"KN295205v1","648224","648524","chr14","48956321","48956614","49","48308097"
"KN295209v1","801417","801710","chr16","23876078","23876369","40","23074661"
"KN295217v1","254395","254683","chr11","41826668","41826958","31","41572273"
"KN295225v1","169554","169859","chrX","47034276","47034587","38","46864722"
"KN295225v1","408277","408583","chrX","134304069","134304376","35","133895792"
"KN295225v1","2460608","2460921","chr7","117879405","117879721","31","115418797"
"KN295232v1","302470","302783","chr2B","224212410","224212717","37","223909940"
"KN295235v1","28868","29153","chr16","49104494","49104787","42","49075626"
"KN295236v1","1303631","1303914","chr19","16946445","16946743","35","15642814"
"KN295236v1","2494846","2495123","chr21","32352970","32353251","39","29858124"
"KN295236v1","3037207","3037491","chr11","109794374","109794666","48","106757167"
"KN295236v1","4177684","4177818","chr19","13875538","13875666","15","9697854"
"KN295236v1","5340162","5340478","chr6","35543843","35544150","118","30203681"
"KN295236v1","5345786","5346089","chr13","87170284","87170589","35","81824498"
"KN295236v1","5446202","5446507","chr4","73419052","73419362","36","67972850"
"KN295236v1","5454827","5455118","chrY","21349417","21349710","42","15894590"
"KN295239v1","356548","356813","chr14","75004392","75004649","48","74647844"
"KN295241v1","15094","15398","chr15","75070840","75071138","52","75055746"
"KN295244v1","361497","361702","chr1","53127739","53127954","40","52766242"
"KN295248v1","45959","46264","chr2A","87405245","87405548","48","87359286"
"KN295257v1","588262","588570","chr2B","206850402","206850711","34","206262140"
"KN295261v1","308177","308297","chr6","48908843","48908953","25","48600666"
"KN295267v1","83640","83945","chr2B","167349042","167349349","31","167265402"
"KN295284v1","18157","18458","chr14","88889928","88890224","31","88871771"
"KN295284v1","185279","185500","chr7","101523089","101523309","47","101337810"
"KN295284v1","572817","573123","chr5","179728518","179728828","30","179155701"
"KN295294v1","375030","375326","chr2A","71241048","71241342","29","70866018"
"KN295301v1","414450","414758","chr14","36790752","36791055","35","36376302"
"KN295313v1","107605","107887","chr7","62506747","62507045","35","62399142"
"KN295315v1","2343782","2344104","chr7","65019976","65020297","50","62676194"
"KN295323v1","130240","130555","chr7","144736012","144736310","54","144605772"
"KN295326v1","211059","211351","chr15","20672138","20672432","26","20461079"
"KN295330v1","179140","179312","chr3","112301571","112301739","35","112122431"
"KN295330v1","179348","179452","chr2A","63883844","63883961","29","63704496"
"KN295337v1","9697","9945","chr7","24602940","24603185","48","24593243"
"KN295343v1","76483","76779","chr2B","223913032","223913332","40","223836549"
"KN295343v1","210377","210580","chr3","78120642","78120843","33","77910265"
"KN295343v1","950348","950508","chr19","4456933","4457093","36","3506585"
"KN295346v1","339645","339836","chr3","164324522","164324716","29","163984877"
"KN295350v1","181767","182059","chr17","47374014","47374302","41","47192247"
"KN295350v1","338768","339075","chr17","7745123","7745434","33","7406355"
"KN295352v1","1023105","1023367","chr1","185272132","185272389","34","184249027"
"KN295361v1","973283","973576","chr14","48956321","48956614","32","47983038"
"KN295405v1","293870","294142","chr11","121332151","121332428","43","121038281"
"KN295406v1","279430","279729","chr9","14622581","14622882","36","14343151"
"KN295423v1","173650","173859","chr1","53127739","53127954","40","52954089"
"KN295428v1","61435","61715","chr5","99291239","99291539","34","99229804"
"KN295430v1","625675","625967","chr4","3272670","3272962","45","2646995"
"KN295441v1","649145","649316","chr15","94283880","94284048","30","93634735"
"KN295441v1","1667947","1668250","chr4","173553950","173554248","47","171886003"
"KN295459v1","1418985","1419286","chr7","72551487","72551785","41","71132502"
"KN295459v1","1621861","1622043","chr17","7159736","7159920","23","5537875"
"KN295459v1","1624204","1624343","chr2A","48306909","48307033","56","46682705"
"KN295474v1","933367","933655","chr10","113990899","113991185","24","113057532"
"KN295474v1","975253","975310","chrX","131167794","131167857","20","130192541"
"KN295480v1","3140863","3140994","chr17","2157520","2157653","18","983343"
"KN295480v1","3141299","3141468","chr12","1784711","1784874","30","1356588"
"KN295484v1","189744","189945","chr9","124034099","124034298","30","123844355"
"KN295490v1","176652","176896","chr7","97687407","97687651","23","97510755"
"KN295500v1","14644","14921","chrY","21472708","21472987","23","21458064"
"KN295501v1","961861","962139","chr4","105620712","105621016","47","104658851"
"KN295523v1","84510","84808","chr20","51868554","51868846","33","51784044"
"KN295523v1","2980267","2980569","chr20","16601362","16601663","52","13621095"
"KN295523v1","3169952","3170197","chr20","31432538","31432778","51","28262586"
"KN295523v1","3251889","3252189","chr19","42324529","42324827","40","39072640"
"KN295526v1","4509","4811","chr10","119186690","119186999","49","119182181"
"KN295526v1","50675","50959","chr6","156580972","156581251","33","156530297"
"KN295526v1","137369","137673","chrX","45780035","45780336","31","45642666"
"KN295526v1","171984","172292","chr2B","176294430","176294735","46","176122446"
"KN295526v1","452488","452783","chr15","75070840","75071138","41","74618352"
"KN295533v1","912502","912808","chr7","144736012","144736310","36","143823510"
"KN295533v1","1844716","1845005","chr2B","128683665","128683960","34","126838949"
"KN295533v1","1853141","1853424","chr2B","128675927","128676220","43","126822786"
"KN295533v1","3083066","3083328","chr14","75004392","75004649","36","71921326"
"KN295548v1","140457","140776","chr1","151545016","151545327","46","151404559"
"KN295548v1","222025","222334","chr8","15847756","15848066","37","15625731"
"KN295552v1","119752","120055","chr10","65657671","65657972","29","65537919"
"KN295552v1","328799","328927","chr10","65465926","65466050","10","65137127"
"KN295561v1","190529","190721","chr22","37181857","37182051","25","36991328"
"KN295561v1","316628","316914","chr3","50032872","50033150","166","49716244"
"KN295570v1","288103","288240","chr3","52833416","52833551","25","52545313"
"KN295571v1","494148","494397","chr7","97687407","97687651","33","97193259"
"KN295571v1","499629","499920","chr19","42768241","42768537","44","42268612"
"KN295573v1","82618","82921","chr2B","220438807","220439107","37","220356189"
"KN295586v1","809467","809765","chr16","4782218","4782514","39","3972751"
"KN295586v1","4778112","4778391","chr1","54402574","54402862","45","49624462"
"KN295590v1","17226","17509","chr19","22089519","22089807","27","22072293"
"KN295591v1","174859","175085","chr16","87075973","87076197","32","86901114"
"KN295596v1","93475","93775","chr13","51113664","51113970","18","51020189"
"KN295596v1","1006928","1007211","chr13","50204940","50205223","24","49198012"
"KN295596v1","1422410","1422689","chr1","86200728","86201008","40","84778318"
"KN295601v1","1150627","1150784","chr1","24797611","24797770","26","23646984"
"KN295605v1","779036","779289","chr11","48198367","48198629","45","47419331"
"KN295605v1","779453","779714","chr11","48198367","48198629","39","47418914"
"KN295606v1","265375","265672","chr18","56606853","56607150","38","56341478"
"KN295607v1","3412847","3413111","chr12","99464978","99465256","47","96052131"
"KN295610v1","254182","254492","chr2B","206850402","206850711","39","206596220"
"KN295633v1","291092","291289","chr3","78120642","78120843","33","77829550"
"KN295633v1","468811","469112","chr15","75070840","75071138","37","74602029"
"KN295633v1","1436393","1436685","chr6","152618192","152618486","28","151181799"
"KN295634v1","36516","36771","chr20","38322986","38323237","52","38286470"
"KN295634v1","295074","295320","chrX","37831319","37831556","29","37536245"
"KN295637v1","460259","460498","chr7","67027689","67027916","37","66567430"
"KN295651v1","1087431","1087734","chr3","137085479","137085784","36","135998048"
"KN295651v1","1140692","1140948","chr10","17672974","17673241","56","16532282"
"KN295651v1","1191082","1191391","chr4","5349290","5349596","37","4158208"
"KN295656v1","108413","108707","chr15","43594039","43594328","30","43485626"
"KN295666v1","436464","436764","chr3","67835473","67835776","37","67399009"
"KN295666v1","482866","483054","chr9","124034099","124034298","35","123551233"
"KN295666v1","570919","571210","chr6","152618192","152618486","38","152047273"
"KN295666v1","1040939","1041240","chr2A","39691151","39691451","42","38650212"
"KN295666v1","1099598","1099901","chr11","65959613","65959920","27","64860015"
"KN295667v1","597883","598153","chr1","10255402","10255659","32","9657519"
"KN295667v1","978247","978515","chr1","9866572","9866869","47","8888325"
"KN295667v1","1747631","1747918","chr1","9021794","9022081","19","7274163"
"KN295685v1","247762","248058","chr14","88889928","88890224","45","88642166"
"KN295692v1","85286","85591","chr22","30150689","30150995","34","30065403"
"KN295692v1","3316629","3316824","chr19","57847275","57847465","35","54530646"
"KN295705v1","86256","86539","chr9","130199403","130199681","34","130113147"
"KN295705v1","2335020","2335324","chr2A","46429202","46429505","34","44094182"
"KN295708v1","1346061","1346371","chr1","21753005","21753312","30","20406944"
"KN295708v1","2568139","2568437","chr15","75070840","75071138","33","72502701"
"KN295717v1","1115867","1116180","chr6","135823981","135824293","30","134708114"
"KN295717v1","1252627","1252775","chr4","1803064","1803245","57","550437"
"KN295717v1","1824277","1824476","chr3","164324522","164324716","38","162500245"
"KN295719v1","184081","184255","chr2B","155601921","155602093","26","155417840"
"KN295721v1","307989","308293","chr3","11933891","11934198","33","11625902"
"KN295735v1","404641","404811","chr7","153741375","153741543","29","153336734"
"KN295735v1","500001","500158","chr19","4456933","4457093","26","3956932"
"KN295735v1","1064020","1064195","chr22","29337386","29337545","38","28273366"
"KN295744v1","285061","285247","chr4","1803064","1803245","31","1518003"
"KN295744v1","614710","615005","chr5","144544636","144544932","39","143929926"
"KN295755v1","69253","69558","chr17","66542702","66543007","42","66473449"
"KN295755v1","110208","110500","chr2A","54819012","54819306","40","54708804"
"KN295758v1","56788","56948","chr4","168927740","168927900","21","168870952"
"KN295758v1","571869","572070","chr9","124034099","124034298","25","123462230"
"KN295801v1","175758","176058","chr15","75070840","75071138","33","74895082"
"KN295807v1","52712","52981","chr5","181697419","181697673","49","181644707"
"KN295814v1","767411","767719","chr1","132671938","132672226","44","131904527"
"KN295814v1","846035","846216","chr4","159805526","159805700","28","158959491"
"KN295814v1","846448","846584","chr3","139937892","139938024","21","139091444"
"KN295814v1","1294047","1294351","chr14","51367329","51367629","41","50073282"
"KN295820v1","1061082","1061369","chr1","171866461","171866755","31","170805379"
"KN295825v1","874840","875134","chr12","38313349","38313646","37","37438509"
"KN295825v1","983321","983495","chr9","29164858","29165029","23","28181537"
"KN295828v1","1746967","1747260","chr6","135437821","135438113","37","133690854"
"KN295854v1","239908","240171","chrX","48502699","48502954","38","48262791"
"KN295869v1","260663","260955","chr6","158035567","158035859","37","157774904"
"KN295869v1","561507","561814","chr22","45653279","45653586","37","45091772"
"KN295869v1","1288975","1289246","chr14","38227598","38227888","45","36938623"
"KN295869v1","1415196","1415494","chr6","90061121","90061419","28","88645925"
"KN295871v1","487421","487729","chr2A","24310832","24311140","41","23823411"
"KN295872v1","222266","222568","chr22","30150689","30150995","32","29928423"
"KN295883v1","617346","617650","chr11","111930602","111930899","50","111313256"
"KN295893v1","203726","204022","chr20","53967648","53967948","27","53763922"
"KN295893v1","831812","832112","chr20","54591469","54591770","46","53759657"
"KN295893v1","4314725","4314996","chr12","20162414","20162688","47","15847689"
"KN295893v1","7294392","7294696","chr20","61217873","61218178","32","53923481"
"KN295893v1","7472460","7472763","chr2A","65849710","65850020","50","58377250"
"KN295894v1","15332","15621","chr14","48956321","48956614","45","48940989"
"KN295894v1","562542","562836","chr5","81662133","81662434","43","81099591"
"KN295894v1","2871193","2871499","chr7","144736012","144736310","48","141864819"
"KN295894v1","3167669","3167899","chr7","101523089","101523309","59","98355420"
"KN295906v1","648113","648403","chr14","35241267","35241563","24","34593154"
"KN295907v1","1701575","1701761","chr19","57847275","57847465","26","56145700"
"KN295921v1","41219","41456","chr7","97687407","97687651","48","97646188"
"KN295921v1","311682","311859","chr15","39903810","39903983","33","39592128"
"KN295923v1","1806999","1807305","chr3","137048504","137048805","34","135241505"
"KN295929v1","163710","164015","chr12","64606460","64606765","40","64442750"
"KN295933v1","676419","676711","chr11","18457636","18457943","49","17781217"
"KN295935v1","69334","69620","chr16","66302139","66302430","33","66232805"
"KN295936v1","2530067","2530365","chr9","107777216","107777518","29","105247149"
"KN295940v1","283363","283667","chr15","75070840","75071138","37","74787477"
"KN295941v1","2722252","2722494","chr4","94066984","94067212","39","91344732"
"KN295943v1","685312","685583","chr6","152618192","152618486","55","151932880"
"KN295962v1","1286927","1287195","chr7","12773118","12773374","36","11486191"
"KN295962v1","1589628","1589920","chr2A","54819012","54819306","34","53229384"
"KN295962v1","2242492","2242791","chr7","66103029","66103331","29","63860537"
"KN295974v1","3273301","3273597","chr17","47374014","47374302","48","44100713"
"KN295974v1","3897918","3898214","chr5","81662133","81662434","53","77764215"
"KN295977v1","508301","508555","chr7","118528113","118528366","34","118019812"
"KN295977v1","1347797","1348055","chr18","66480061","66480312","43","65132264"
"KN295983v1","28552","28860","chr2A","24310832","24311140","37","24282280"
"KN295983v1","224305","224613","chr4","39064807","39065102","50","38840502"
"KN295983v1","1510139","1510416","chr4","37759492","37759775","45","36249353"
"KN295983v1","1958789","1959086","chr17","79974171","79974464","33","78015382"
"KN295984v1","1471774","1472076","chr17","66542702","66543007","46","65070928"
"KN295984v1","1554697","1555006","chr5","141807222","141807528","36","140252525"
"KN295984v1","3198588","3198895","chr9","125954702","125955004","30","122756114"
"KN295988v1","42325","42633","chr10","111395450","111395760","25","111353125"
"KN295996v1","318507","318816","chr8","71884851","71885160","32","71566344"
"KN296000v1","994558","994841","chr8","118683505","118683789","43","117688947"
"KN296000v1","1398566","1398839","chr3","183203955","183204231","38","181805389"
"KN296017v1","264781","264891","chr10","100364020","100364115","25","100099239"
"KN296019v1","266470","266772","chr7","144736012","144736310","39","144469542"
"KN296036v1","190054","190379","chr15","70254245","70254558","43","70064191"
"KN296036v1","1057662","1057961","chr3","187947314","187947618","36","186889652"
"KN296036v1","1297450","1297738","chr3","188837200","188837488","40","187539750"
"KN296036v1","1711549","1711844","chr7","72507087","72507385","41","70795538"
"KN296036v1","2069904","2070203","chr3","186958286","186958591","27","184888382"
"KN296042v1","491486","491687","chr3","78120642","78120843","30","77629156"
"KN296062v1","99288","99580","chr11","66178150","66178445","29","66078862"
"KN296062v1","313219","313514","chr19","59076998","59077292","22","58763779"
"KN296062v1","450122","450358","chr17","74101124","74101336","52","73651002"
"KN296062v1","1776946","1777244","chr4","39285304","39285592","36","37508358"
"KN296062v1","1929795","1929997","chr1","205037815","205038006","44","203108020"
"KN296063v1","471426","471636","chr4","40720908","40721122","36","40249482"
"KN296063v1","507074","507302","chr12","125823209","125823448","35","125316135"
"KN296063v1","576449","576757","chr10","5908372","5908674","40","5331923"
"KN296063v1","1101416","1101671","chr1","10255402","10255659","43","9153986"
"KN296075v1","625774","626065","chr7","130056647","130056942","37","129430873"
"KN296078v1","688006","688152","chr3","123495574","123495719","24","122807568"
"KN296079v1","172822","173101","chr11","111930602","111930899","53","111757780"
"KN296079v1","810779","811078","chr7","72551487","72551785","34","71740708"
"KN296096v1","42201","42375","chr2B","155601921","155602093","24","155559720"
"KN296096v1","76532","76836","chr2A","87405245","87405548","44","87328713"
"KN296096v1","96853","97028","chr17","734830","735006","27","637977"
"KN296096v1","2795917","2796206","chr15","69991814","69992109","38","67195897"
"KN296108v1","889549","889745","chr3","164324522","164324716","23","163434973"
"KN296114v1","10666","10923","chr14","75004392","75004649","66","74993726"
"KN296117v1","395006","395303","chr2B","220438807","220439107","30","220043801"
"KN296117v1","804601","804901","chr7","73708656","73708959","34","72904055"
"KN296119v1","1075327","1075583","chr14","75004392","75004649","37","73929065"
"KN296119v1","3459634","3459942","chr1","12373339","12373643","35","8913705"
"KN296119v1","4018232","4018520","chr17","46556002","46556290","47","42537770"
"KN296119v1","4531643","4531882","chr20","31432538","31432778","56","26900895"
"KN296119v1","5273473","5273787","chr11","69780490","69780788","44","64507017"
"KN296119v1","5459642","5459903","chr14","75004392","75004649","36","69544750"
"KN296119v1","5834928","5835246","chrX","42632705","42633009","43","36797777"
"KN296119v1","5916529","5916825","chr19","7755139","7755434","46","1838610"
"KN296122v1","324521","324712","chrX","124931070","124931259","33","124606549"
"KN296128v1","46047","46360","chrX","8658123","8658433","25","8612076"
"KN296138v1","292112","292391","chr18","32707337","32707617","32","32415225"
"KN296139v1","2","203","chr7","88863909","88864111","34","88863907"
"KN296139v1","28938","29239","chr15","39586512","39586810","29","39557574"
"KN296139v1","153218","153558","chr16","21173493","21173826","54","21020275"
"KN296145v1","2298253","2298546","chr18","27855946","27856234","35","25557693"
"KN296145v1","2388560","2388846","chr11","49803420","49803713","41","47414860"
"KN296145v1","2562988","2563294","chr2B","167349042","167349349","39","164786054"
"KN296153v1","33360","33659","chr19","6876841","6877140","28","6843481"
"KN296153v1","1167324","1167494","chr7","153741375","153741543","18","152574051"
"KN296153v1","1653972","1654260","chr19","4297177","4297470","44","2643205"
"KN296153v1","2775026","2775306","chr12","71505712","71505995","47","68730686"
"KN296153v1","3257685","3257984","chr19","3691349","3691654","42","433664"
"KN296153v1","3388525","3388601","chr8","20603417","20603490","26","17214892"
"KN296153v1","3883088","3883271","chr20","29845882","29846072","34","25962794"
"KN296153v1","3883305","3883338","chrUn_GL393543","46653","46698","16","3836652"
"KN296154v1","3109809","3110095","chr20","37918475","37918769","39","34808666"
"KN296154v1","3831130","3831439","chr5","13282747","13283051","34","9451617"
"KN296157v1","3919436","3919688","chr7","118528113","118528366","35","114608677"
"KN296161v1","129390","129695","chrX","16854519","16854826","49","16725129"
"KN296178v1","441184","441382","chr9","124034099","124034298","31","123592915"
"KN296180v1","640970","641269","chr15","31941885","31942188","25","31300915"
"KN296186v1","223610","223908","chr4","44683072","44683363","44","44459462"
"KN296187v1","2285051","2285343","chr3","158917814","158918103","42","156632763"
"KN296187v1","2437384","2437584","chr3","164324522","164324716","36","161887138"
"KN296191v1","1225763","1225914","chr13","78226280","78226406","42","77000517"
"KN296191v1","1226222","1226355","chr21","16939332","16939463","18","15713110"
"KN296192v1","108139","108417","chr3","119829490","119829769","40","119721351"
"KN296200v1","104045","104335","chr16","23876078","23876369","33","23772033"
"KN296200v1","646096","646358","chr14","75004392","75004649","40","74358296"
"KN296201v1","2733347","2733636","chr1","54402574","54402862","32","51669227"
"KN296202v1","303759","304032","chr4","20185549","20185822","23","19881790"
"KN296205v1","150081","150303","chr6","99816809","99817031","19","99666728"
"KN296210v1","353837","353929","chr4","40721433","40721520","23","40367596"
"KN296225v1","200695","200976","chr4","156217552","156217835","34","156016857"
"KN296225v1","570942","571239","chr12","7175232","7175529","43","6604290"
"KN296233v1","121","306","chr17","7159736","7159920","26","7159615"
"KN296247v1","199963","200272","chr5","103561356","103561665","40","103361393"
"KN296253v1","1056880","1057157","chr1","120514612","120514907","32","119457732"
"KN296261v1","83842","84143","chr21","29659720","29660020","20","29575878"
"KN296261v1","207021","207335","chr8","106021949","106022257","49","105814928"
"KN296261v1","217749","218055","chr13","87170284","87170589","26","86952535"
"KN296263v1","289802","290113","chr1","151545016","151545327","42","151255214"
"KN296263v1","641850","642154","chr17","27067708","27068018","28","26425858"
"KN296263v1","880172","880467","chr17","27313074","27313374","37","26432902"
"KN296263v1","983790","983958","chr7","153741375","153741543","29","152757585"
"KN296268v1","1222087","1222353","chr1","146195212","146195486","42","144973125"
"KN296275v1","109304","109587","chr14","38941114","38941392","39","38831810"
"KN296275v1","306322","306639","chr5","134725785","134726092","51","134419463"
"KN296277v1","134513","134802","chr16","49104494","49104787","37","48969981"
"KN296278v1","510974","511239","chr1","109787461","109787716","50","109276487"
"KN296281v1","90887","91188","chr8","39094716","39095014","27","39003829"
"KN296281v1","173530","173834","chr4","73419052","73419362","42","73245522"
"KN296281v1","252951","253250","chr5","42238471","42238773","53","41985520"
"KN296290v1","523643","523921","chr16","25242936","25243215","37","24719293"
"KN296290v1","1358801","1358813","chr1","152489761","152489794","24","151130960"
"KN296290v1","1359121","1359152","chr1","152489761","152489794","9","151130640"
"KN296292v1","233444","233746","chr1","12373339","12373643","35","12139895"
"KN296303v1","332434","332683","chr14","75004392","75004649","44","74671958"
"KN296306v1","2410422","2410718","chr7","157027266","157027563","22","154616844"
"KN296308v1","233149","233490","chr11","3925406","3925739","43","3692257"
"KN296308v1","830922","831217","chr15","75070840","75071138","41","74239918"
"KN296308v1","1339549","1339851","chr12","120135204","120135508","38","118795655"
"KN296310v1","218402","218709","chr1","12373339","12373643","39","12154937"
"KN296311v1","932917","933223","chr1","78023034","78023339","38","77090117"
"KN296311v1","1392826","1393137","chr12","119225088","119225392","29","117832262"
"KN296311v1","3207778","3208057","chr12","121051480","121051765","23","117843702"
"KN296311v1","3465611","3465740","chr1","183558300","183558435","27","180092689"
"KN296311v1","4212638","4212935","chr12","122081239","122081528","40","117868601"
"KN296311v1","4228187","4228482","chr12","122095527","122095821","35","117867340"
"KN296311v1","4407946","4408222","chr3","47882028","47882305","43","43474082"
"KN296311v1","4439034","4439242","chr4","40720908","40721122","42","36281874"
"KN296311v1","4458677","4458848","chr15","39903810","39903983","33","35445133"
"KN296311v1","4469209","4469497","chr12","129951986","129952280","36","125482777"
"KN296311v1","4482305","4482600","chr2A","54819012","54819306","42","50336707"
"KN296311v1","4523665","4523963","chr12","122387913","122388206","32","117864248"
"KN296311v1","4909088","4909363","chr12","122932149","122932432","41","118023061"
"KN296311v1","5063719","5064019","chr19","7755139","7755434","46","2691420"
"KN296311v1","5249294","5249594","chr1","180294340","180294640","35","175045046"
"KN296311v1","5619734","5619865","chr3","139937892","139938024","21","134318158"
"KN296311v1","5620164","5620337","chr20","30959776","30959938","33","25339612"
"KN296311v1","7789367","7789683","chr11","65959613","65959920","42","58170246"
"KN296312v1","103652","103955","chr4","150780903","150781206","38","150677251"
"KN296315v1","243929","244222","chr7","153942305","153942600","37","153698376"
"KN296316v1","39272","39582","chr7","55957481","55957791","36","55918209"
"KN296319v1","810453","810752","chr4","187973776","187974070","36","187163323"
"KN296322v1","597252","597540","chr18","27855946","27856234","37","27258694"
"KN296322v1","2191915","2192217","chr15","75070840","75071138","40","72878925"
"KN296324v1","239746","239889","chr1","202678414","202678563","14","202438668"
"KN296325v1","35867","36121","chrX","48502699","48502954","37","48466832"
"KN296325v1","72741","73040","chr5","96687673","96687973","30","96614932"
"KN296345v1","54555","54852","chr15","75070840","75071138","31","75016285"
"KN296349v1","10579","10769","chr19","57847275","57847465","35","57836696"
"KN296357v1","151300","151505","chr3","78120642","78120843","31","77969342"
"KN296357v1","514661","514913","chr19","53493615","53493871","36","52978954"
"KN296357v1","553467","553661","chr3","164324522","164324716","27","163771055"
"KN296365v1","624657","624947","chr12","6329364","6329655","33","5704707"
"KN296365v1","1264926","1265208","chr17","59982652","59982939","37","58717726"
"KN296365v1","1584826","1585113","chr2A","54819012","54819306","37","53234186"
"KN296378v1","632554","632696","chr12","113870729","113870867","18","113238175"
"KN296381v1","216397","216686","chr9","121060965","121061251","43","120844568"
"KN296381v1","585945","586242","chr19","42324529","42324827","29","41738584"
"KN296383v1","239450","239771","chr14","68122340","68122661","42","67882890"
"KN296387v1","162630","162937","chr5","42238471","42238773","53","42075841"
"KN296392v1","482507","482788","chr13","64933401","64933685","42","64450894"
"KN296404v1","1612199","1612471","chr1","161391945","161392232","41","159779746"
"KN296404v1","1866642","1866943","chr1","161659981","161660282","38","159793339"
"KN296404v1","2203455","2203644","chr22","37181857","37182051","34","34978402"
"KN296406v1","289912","290216","chr20","16601362","16601663","36","16311450"
"KN296430v1","111825","112114","chr14","19753078","19753367","39","19641253"
"KN296442v1","2448","2703","chrX","48502699","48502954","35","48500251"
"KN296453v1","1995762","1996054","chr10","5908372","5908674","55","3912610"
"KN296454v1","201347","201655","chr5","73581239","73581542","31","73379892"
"KN296455v1","588289","588587","chr5","122488741","122489035","25","121900452"
"KN296460v1","539110","539374","chr7","150343832","150344092","30","149804722"
"KN296460v1","1341463","1341770","chr15","75070840","75071138","44","73729377"
"KN296464v1","10056","10392","chr19","23866962","23867270","67","23856906"
"KN296466v1","1","226","chr6","43691733","43691967","43","43691732"
"KN296475v1","42796","43090","chrX","129850008","129850311","50","129807212"
"KN296475v1","127950","128140","chr17","7159736","7159920","31","7031786"
"KN296481v1","222539","222840","chrX","16854519","16854826","32","16631980"
"KN296481v1","540354","540620","chr1","185272132","185272389","46","184731778"
"KN296486v1","25036","25344","chr19","54055623","54055930","36","54030587"
"KN296486v1","40892","41180","chr1","132671938","132672226","50","132631046"
"KN296486v1","479864","480019","chr17","52507734","52507919","53","52027870"
"KN296486v1","1042552","1042817","chrX","48502699","48502954","42","47460147"
"KN296486v1","1363267","1363449","chr4","1803064","1803245","29","439797"
"KN296486v1","1491804","1492084","chr19","55549207","55549505","44","54057403"
"KN296486v1","1723377","1723675","chr3","123562263","123562560","31","121838886"
"KN296495v1","1629508","1629822","chr13","87170284","87170589","47","85540776"
"KN296495v1","3159452","3159620","chr7","153741375","153741543","20","150581923"
"KN296496v1","236118","236257","chr1","183558300","183558435","13","183322182"
"KN296496v1","556037","556316","chr14","48956321","48956614","44","48400284"
"KN296507v1","569275","569576","chr15","93880704","93881005","39","93311429"
"KN296518v1","317595","317708","chr5","49645024","49645117","34","49327429"
"KN296520v1","393506","393809","chr10","101381645","101381953","40","100988139"
"KN296528v1","1341318","1341621","chr14","88889928","88890224","42","87548610"
"KN296528v1","1580168","1580462","chr11","18457636","18457943","35","16877468"
"KN296528v1","1640438","1640746","chr11","18524481","18524783","37","16884043"
"KN296536v1","757970","758268","chr15","75070840","75071138","35","74312870"
"KN296538v1","73542","73839","chr15","69991814","69992109","37","69918272"
"KN296538v1","94877","95060","chr17","7159736","7159920","29","7064859"
"KN296541v1","1844309","1844604","chr10","43006462","43006757","38","41162153"
"KN296547v1","983380","983701","chr10","97174301","97174611","46","96190921"
"KN296557v1","916178","916356","chr2A","69966275","69966437","34","69050097"
"KN296572v1","164322","164507","chr19","57847275","57847465","28","57682953"
"KN296577v1","153467","153664","chr4","40720908","40721122","37","40567441"
"KN296577v1","633390","633555","chr9","29164858","29165029","31","28531468"
"KN296579v1","167823","168126","chr5","93069099","93069406","43","92901276"
"KN296580v1","372453","372760","chr14","51367329","51367629","35","50994876"
"KN296588v1","238083","238384","chr9","111585882","111586183","27","111347799"
"KN296588v1","1097026","1097143","chr4","710664","710777","25","386362"
"KN296588v1","1097180","1097218","chrX","39082350","39082391","13","37985170"
"KN296589v1","95749","96053","chr7","70873003","70873306","55","70777254"
"KN296594v1","319958","320255","chr3","125032654","125032961","41","124712696"
"KN296594v1","1110728","1110997","chr1","146195212","146195486","46","145084484"
"KN296599v1","312251","312531","chr17","13005121","13005390","52","12692870"
"KN296606v1","120344","120626","chrX","34907780","34908061","35","34787436"
"KN296609v1","1269674","1269975","chr7","73708656","73708959","29","72438982"
"KN296609v1","2697737","2698040","chr7","70873003","70873306","33","68175266"
"KN296620v1","639622","639929","chr3","154522763","154523062","40","153883141"
"KN296635v1","352235","352550","chr6","135823981","135824293","47","135471746"
"KN296635v1","975546","975855","chr4","5349290","5349596","42","4373744"
"KN296635v1","1180884","1181186","chr2A","39691151","39691451","38","38510267"
"KN296635v1","3269536","3269713","chr17","734830","735006","23","2534706"
"KN296637v1","462052","462342","chr12","71505712","71505995","25","71043660"
"KN296646v1","29663","29729","chr3","173718113","173718157","30","173688450"
"KN296646v1","1376987","1377147","chr19","4456933","4457093","27","3079946"
"KN296661v1","1330381","1330686","chr8","106021949","106022257","37","104691568"
"KN296682v1","452001","452300","chr11","111930602","111930899","33","111478601"
"KN296682v1","2209395","2209592","chr3","164324522","164324716","31","162115127"
"KN296695v1","209678","209838","chr4","1803064","1803245","51","1593386"
"KN296701v1","108134","108432","chr14","88889928","88890224","32","88781794"
"KN296711v1","12748","13019","chr3","72164426","72164698","38","72151678"
"KN296719v1","103158","103470","chr2B","224212410","224212717","43","224109252"
"KN296719v1","194608","194806","chr3","164324522","164324716","35","164129914"
"KN296726v1","26729","27024","chr12","56532774","56533071","27","56506045"
"KN296726v1","534939","535190","chr9","109234815","109235042","70","108699876"
"KN296726v1","921912","922233","chr13","35650877","35651186","46","34728965"
"KN296731v1","746470","746760","chr12","12404653","12404943","23","11658183"
"KN296731v1","1056837","1057116","chr9","130199403","130199681","39","129142566"
"KN296731v1","1195926","1196117","chr3","164324522","164324716","32","163128596"
"KN296732v1","2137747","2138039","chr18","27855946","27856234","40","25718199"
"KN296732v1","2203025","2203318","chr15","75070840","75071138","44","72867815"
"KN296732v1","2308606","2308883","chr2A","54819012","54819306","36","52510406"
"KN296732v1","2364135","2364405","chr3","72164426","72164698","37","69800291"
"KN296732v1","3248057","3248333","chr11","47761617","47761886","39","44513560"
"KN296732v1","3669496","3669767","chr11","48198367","48198629","28","44528871"
"KN296743v1","2050461","2050766","chr3","137048504","137048805","49","134998043"
"KN296749v1","737371","737510","chr1","149857707","149857851","24","149120336"
"KN296750v1","1542392","1542670","chrY","21472708","21472987","38","19930316"
"KN296768v1","11607","11910","chr7","72551487","72551785","41","72539880"
"KN296795v1","1","178","chr17","7159736","7159920","31","7159735"
"KN296795v1","398304","398605","chr15","90353213","90353511","35","89954909"
"KN296795v1","536104","536406","chr3","137048504","137048805","41","136512400"
"KN296802v1","385399","385558","chr12","32104898","32105058","22","31719499"
"KN296809v1","908642","908898","chr3","39920556","39920828","31","39011914"
"KN296821v1","218785","218979","chr3","164324522","164324716","23","164105737"
"KN296825v1","1467622","1467912","chr8","64408667","64408959","39","62941045"
"KN296852v1","1730302","1730500","chr3","164324522","164324716","34","162594220"
"KN296859v1","897955","898263","chr22","36933033","36933342","37","36035078"
"KN296859v1","1380930","1381092","chr2A","69717435","69717600","24","68336505"
"KN296859v1","1879125","1879431","chr1","145694153","145694456","29","143815028"
"KN296864v1","950676","950951","chr9","130199403","130199681","39","129248727"
"KN296877v1","191682","191996","chr14","68122340","68122661","46","67930658"
"KN296879v1","958384","958436","chrX","39082350","39082391","26","38123966"
"KN296883v1","2844848","2845131","chr7","48585213","48585498","38","45740365"
"KN296883v1","3615425","3615728","chr14","51367329","51367629","28","47751904"
"KN296884v1","227077","227352","chr11","48198367","48198629","56","47971290"
"KN296885v1","801966","802246","chr3","183203955","183204231","40","182401989"
"KN296885v1","2780934","2781237","chr5","103561356","103561665","33","100780422"
"KN296900v1","22600","22908","chr10","88848247","88848556","37","88825647"
"KN296913v1","1206677","1206980","chr1","78593615","78593919","35","77386938"
"KN296921v1","393563","393712","chr1","12208870","12209027","43","11815307"
"KN296921v1","1601677","1601868","chr3","164324522","164324716","35","162722845"
"KN296922v1","168515","168806","chr19","22089519","22089807","28","21921004"
"KN296922v1","276096","276399","chr3","137085479","137085784","41","136809383"
"KN296922v1","818852","819146","chr19","21551154","21551458","35","20732302"
"KN296922v1","821523","821679","chr19","21548591","21548748","14","20727068"
"KN296925v1","274043","274333","chr5","144544636","144544932","38","144270593"
"KN296926v1","633415","633715","chr17","24431862","24432149","38","23798447"
"KN296933v1","124241","124551","chr1","78023034","78023339","34","77898793"
"KN296936v1","85507","85802","chr14","48956321","48956614","33","48870814"
"KN296938v1","153686","153998","chrX","80019555","80019869","44","79865869"
"KN296938v1","736591","736891","chr7","72551487","72551785","31","71814896"
"KN296948v1","412690","413000","chr10","97174301","97174611","41","96761611"
"KN296948v1","699659","699827","chr7","153741375","153741543","25","153041716"
"KN296959v1","279007","279305","chr15","39586512","39586810","36","39307505"
"KN296959v1","672179","672467","chr1","68338914","68339216","51","67666735"
"KN296964v1","661173","661204","chr1","152489761","152489794","22","151828588"
"KN296964v1","661230","661509","chr8","118683505","118683789","36","118022275"
"KN296964v1","846687","846878","chr3","164324522","164324716","28","163477835"
"KN296964v1","1058401","1058704","chr19","7755139","7755434","43","6696738"
"KN296970v1","285906","286206","chr7","144736012","144736310","38","144450106"
"KN296976v1","20344","20561","chr3","164324522","164324716","52","164304178"
"KN296980v1","836406","836709","chr19","42324529","42324827","37","41488123"
"KN296982v1","483237","483530","chr15","93880704","93881005","45","93397467"
"KN296991v1","193154","193455","chr2B","220438807","220439107","39","220245653"
"KN297008v1","404419","404714","chr7","35122965","35123263","38","34718546"
"KN297008v1","681115","681424","chr1","210951786","210952093","39","210270671"
"KN297008v1","1334888","1335155","chr20","2791322","2791566","73","1456434"
"KN297008v1","1819907","1820203","chr5","144544636","144544932","66","142724729"
"KN297008v1","2735928","2736225","chr15","75070840","75071138","37","72334912"
"KN297008v1","3346712","3347011","chr9","134366358","134366642","49","131019646"
"KN297008v1","4027786","4027983","chr22","37181857","37182051","37","33154071"
"KN297008v1","4076409","4076686","chr9","133639708","133639975","49","129563299"
"KN297008v1","6529696","6529870","chr19","4456933","4457093","38","2072763"
"KN297016v1","16230","16521","chr5","44083978","44084268","33","44067748"
"KN297019v1","230038","230309","chr3","46501372","46501651","49","46271334"
"KN297028v1","73116","73231","chr13","78226280","78226406","29","78153164"
"KN297032v1","29151","29344","chr19","57847275","57847465","29","57818124"
"KN297032v1","253860","254057","chr17","7159736","7159920","32","6905876"
"KN297038v1","243393","243552","chr19","4456933","4457093","21","4213540"
"KN297038v1","2559569","2559728","chr2B","132000001","132000178","48","129440432"
"KN297039v1","23629","23985","chr12","68557719","68558050","98","68534090"
"KN297044v1","6085","6141","chr12","6460668","6460716","22","6454583"
"KN297044v1","488939","489238","chr1","17318299","17318600","28","16829360"
"KN297046v1","431884","432183","chr6","90613671","90613954","49","90181787"
"KN297046v1","1830789","1831087","chr19","59076998","59077292","26","57246209"
"KN297046v1","1872273","1872563","chr5","44083978","44084268","36","42211705"
"KN297046v1","3310463","3310761","chr10","72745948","72746245","28","69435485"
"KN297046v1","3328809","3328917","chr16","29588241","29588338","48","26259432"
"KN297046v1","3329210","3329303","chr11","43450925","43451010","19","40121715"
"KN297056v1","8395","8554","chr19","21548591","21548748","25","21540196"
"KN297058v1","486484","486797","chr5","140420625","140420933","52","139934141"
"KN297078v1","182203","182499","chr1","171866461","171866755","30","171684258"
"KN297078v1","219973","220269","chr15","31941885","31942188","35","31721912"
"KN297083v1","19431","19745","chr1","36014417","36014725","42","35994986"
"KN297083v1","385783","386093","chr15","75070840","75071138","35","74685057"
"KN297095v1","282183","282483","chr14","36790752","36791055","46","36508569"
"KN297095v1","499856","500000","chr2B","155489068","155489222","37","154989212"
"KN297095v1","1949952","1950253","chr3","137085479","137085784","36","135135527"
"KN297097v1","8301","8601","chr5","42238471","42238773","37","42230170"
"KN297105v1","1553710","1554020","chr1","142739361","142739658","40","141185651"
"KN297105v1","3233560","3233844","chr1","144442308","144442599","40","141208748"
"KN297108v1","368929","369084","chr14","75821378","75821520","30","75452449"
"KN297112v1","3358570","3358854","chr18","8544570","8544871","49","5186000"
"KN297112v1","3962889","3963141","chrX","69350503","69350737","49","65387614"
"KN297112v1","4589259","4589420","chr7","153741375","153741543","29","149152116"
"KN297133v1","495399","495712","chr8","133350213","133350513","54","132854814"
"KN297133v1","652707","653014","chr1","78023034","78023339","40","77370327"
"KN297133v1","1107905","1108215","chr11","65959613","65959920","48","64851708"
"KN297133v1","1458336","1458479","chr3","123495574","123495719","25","122037238"
"KN297133v1","1458763","1458913","chr12","1784711","1784874","37","325948"
"KN297154v1","72964","73130","chr3","123494982","123495161","40","123422018"
"KN297154v1","73432","73575","chr3","123495574","123495719","25","123422142"
"KN297154v1","744800","745105","chr10","86374566","86374875","43","85629766"
"KN297154v1","905210","905285","chrX","24210465","24210537","14","23305255"
"KN297154v1","1761739","1762032","chr8","19973947","19974240","41","18212208"
"KN297159v1","494903","495203","chr15","75070840","75071138","42","74575937"
"KN297159v1","2071404","2071684","chr5","81662133","81662434","49","79590729"
"KN297165v1","32759","33046","chr1","207790343","207790624","32","207757584"
"KN297165v1","2134409","2134705","chr15","75070840","75071138","33","72936431"
"KN297165v1","2668423","2668731","chr10","88848247","88848556","41","86179824"
"KN297165v1","3169057","3169354","chr5","81662133","81662434","38","78493076"
"KN297165v1","3391036","3391341","chr2A","37562156","37562460","32","34171120"
"KN297171v1","126957","127155","chr3","78120642","78120843","35","77993685"
"KN297171v1","224635","224833","chr4","1803064","1803245","44","1578429"
"KN297171v1","827058","827345","chr14","48956321","48956614","29","48129263"
"KN297171v1","1748175","1748474","chr5","14209041","14209339","38","12460866"
"KN297171v1","1985507","1985788","chr8","118683505","118683789","35","116697998"
"KN297176v1","245478","245783","chrX","8658123","8658433","38","8412645"
"KN297184v1","1500911","1501208","chr4","53571955","53572251","41","52071044"
"KN297189v1","188222","188513","chr16","66302139","66302430","38","66113917"
"KN297190v1","2948240","2948541","chr15","57763782","57764076","29","54815542"
"KN297190v1","4418982","4419280","chr6","29700202","29700499","44","25281220"
"KN297190v1","5215770","5216069","chr7","72551487","72551785","39","67335717"
"KN297195v1","302111","302422","chr15","84276094","84276387","42","83973983"
"KN297197v1","821430","821735","chr3","42443728","42444037","39","41622298"
"KN297197v1","1495209","1495292","chr16","11383882","11383957","26","9888673"
"KN297205v1","196973","197282","chr6","135823981","135824293","36","135627008"
"KN297215v1","342975","343246","chr8","13453545","13453812","36","13110570"
"KN297219v1","2009465","2009756","chr1","124931506","124931799","42","122922041"
"KN297225v1","755275","755574","chr11","27472512","27472810","45","26717237"
"KN297227v1","777104","777407","chr5","13282747","13283051","39","12505643"
"KN297230v1","1161323","1161602","chr7","114238952","114239231","31","113077629"
"KN297233v1","137785","138092","chr13","49787402","49787705","38","49649617"
"KN297242v1","1521442","1521726","chr19","59076998","59077292","38","57555556"
"KN297245v1","2514686","2514998","chr5","140882851","140883163","34","138368165"
"KN297259v1","1153114","1153392","chr3","47882028","47882305","30","46728914"
"KN297259v1","1382691","1382984","chr3","47654915","47655210","32","46272224"
"KN297259v1","2536117","2536408","chr15","87002141","87002432","38","84466024"
"KN297263v1","1869879","1870183","chr8","3828549","3828852","33","1958670"
"KN297274v1","254615","254914","chr11","111930602","111930899","43","111675987"
"KN297274v1","1030436","1030604","chr7","63210924","63211092","29","62180488"
"KN297274v1","1030906","1030917","chr1","152489761","152489794","25","151458855"
"KN297274v1","1031202","1031334","chr17","2157520","2157653","19","1126318"
"KN297274v1","1914574","1914857","chr1","171866461","171866755","44","169951887"
"KN297290v1","143477","143779","chrX","23558422","23558718","32","23414945"
"KN297293v1","296851","297133","chr4","105620712","105621016","43","105323861"
"KN297293v1","502931","503241","chr2A","54819012","54819306","51","54316081"
"KN297313v1","656866","657157","chr16","49104494","49104787","33","48447628"
"KN297313v1","689309","689614","chr3","152532181","152532483","30","151842872"
"KN297314v1","903128","903441","chr8","95001582","95001880","41","94098454"
"KN297320v1","1172012","1172303","chr9","92321040","92321328","30","91149028"
"KN297320v1","1415169","1415331","chr8","19760821","19760989","28","18345652"
"KN297322v1","575940","576234","chr7","4420760","4421054","31","3844820"
"KN297322v1","1083488","1083777","chr16","80853083","80853372","18","79769595"
"KN297322v1","1093654","1093972","chr17","26720487","26720796","48","25626833"
"KN297322v1","1617060","1617238","chrUn_GL393543","46328","46509","26","1570732"
"KN297323v1","709026","709322","chr8","143249624","143249918","19","142540598"
"KN297343v1","471864","472161","chr1","68338914","68339216","45","67867050"
"KN297343v1","2026017","2026309","chr7","158593048","158593336","26","156567031"
"KN297369v1","1870521","1870789","chr8","118683505","118683789","46","116812984"
"KN297369v1","1902571","1902869","chr4","112125167","112125464","41","110222596"
"KN297370v1","415163","415442","chr3","119829490","119829769","21","119414327"
"KN297374v1","120852","121163","chr14","25201378","25201688","43","25080526"
"KN297390v1","1258274","1258584","chr12","64606460","64606765","26","63348186"
"KN297406v1","9930","10218","chr16","49104494","49104787","36","49094564"
"KN297408v1","495966","496119","chr19","4456933","4457093","25","3960967"
"KN297415v1","502240","502537","chr1","171374125","171374420","28","170871885"
"KN297415v1","896258","896545","chr1","171774000","171774293","32","170877742"
"KN297421v1","346947","347228","chr16","68582490","68582772","41","68235543"
"KN297431v1","215894","216165","chr9","130199403","130199681","45","129983509"
"KN297431v1","447582","447768","chr19","43060677","43060862","28","42613095"
"KN297445v1","284143","284430","chr16","68582490","68582772","46","68298347"
"KN297445v1","852815","853148","chr6","9950185","9950494","61","9097370"
"KN297445v1","998314","998496","chr8","68464561","68464738","31","67466247"
"KN297452v1","866528","866836","chr1","158915790","158916100","35","158049262"
"KN297452v1","2549649","2549962","chr4","5349290","5349596","38","2799641"
"KN297452v1","2670478","2670777","chr2B","220438807","220439107","30","217768329"
