"chr1","93323243","93323540","chr14","91564522","91564819","10","1758721"
"chr1","99614699","99614996","chr14","97469489","97469785","14","2145210"
"chr1","7995322","7995490","chr14","7830339","7830507","6","164983"
"chr1","8257502","8257759","chr10","82093521","82093791","66","73836019"
"chr1","10092429","10092741","chr14","9950090","9950403","10","142339"
"chr1","32243589","32243861","chr14","31889054","31889326","5","354535"
"chr1","56360801","56361116","chr14","56473461","56473776","5","112660"
"chr1","66846613","66846925","chr14","65469284","65469594","9","1377329"
"chr1","150788","150988","chr8","8974796","8974978","44","8824008"
"chr1","153235","153490","chr14","173651","173917","24","20416"
"chr1","160272","160424","chr14","180306","180458","7","20034"
"chr1","188982","189260","chr14","211377","211663","20","22395"
"chr1","192456","192745","chr14","214482","214769","8","22026"
"chr1","207159","207323","chr19","47023762","47023928","31","46816603"
"chr1","240931","241123","chr14","265781","265976","5","24850"
"chr1","245568","245780","chr10","65355085","65355314","64","65109517"
"chr1","255452","255561","chr14","283043","283136","18","27591"
"chr1","255953","256020","chr20","218326","218394","18","37627"
"chr1","256016","256109","chr14","283043","283136","1","27027"
"chr1","304992","305193","chr14","331143","331344","5","26151"
"chr1","305255","305396","chr8","137429484","137429627","31","137124229"
"chr1","313891","314217","chr3","83164002","83164293","83","82850111"
"chr1","319033","319264","chr9","6030499","6030716","47","5711466"
"chr1","330508","330630","chr6","168856261","168856393","29","168525753"
"chr1","334386","334675","chr14","359084","359374","10","24698"
"chr1","337743","338022","chr5","53361343","53361626","55","53023600"
"chr1","348624","348913","chr3","63222063","63222357","59","62873439"
"chr1","349071","349120","chr14","363830","363887","9","14759"
"chr1","388198","388334","chr2","82711354","82711493","30","82323156"
"chr1","393592","393692","chr10","61758492","61758586","23","61364900"
"chr1","393996","394140","chr10","31972968","31973110","22","31578972"
"chr1","398320","398484","chr10","53993129","53993294","32","53594809"
"chr1","420540","420780","chr14","443311","443553","6","22771"
"chr1","420804","421082","chr14","443577","443855","6","22773"
"chr1","450997","451151","chr14","475092","475246","2","24095"
"chr1","460588","460751","chr14","484769","484932","8","24181"
"chr1","467584","467868","chr14","492451","492736","10","24867"
"chr1","479242","479550","chrX","21825677","21825985","63","21346435"
"chr1","489128","489299","chr14","522788","522959","5","33660"
"chr1","492480","492584","chr14","513171","513276","1","20691"
"chr1","511761","511903","chr2","172227852","172227991","31","171716091"
"chr1","512245","512327","chr14","541366","541448","0","29121"
"chr1","514768","514871","chr1","194662514","194662620","27","194147746"
"chr1","518333","518524","chr14","545991","546153","34","27658"
"chr1","518829","518913","chr14","546445","546529","3","27616"
"chr1","525005","525207","chr14","555759","555932","41","30754"
"chr1","525678","525943","chr1","203997434","203997688","67","203471756"
"chr1","527664","527969","chr8","8953956","8954255","69","8426292"
"chr1","538368","538650","chr14","569247","569529","7","30879"
"chr1","543636","543766","chr14","574548","574678","5","30912"
"chr1","544080","544265","chr14","574982","575167","23","30902"
"chr1","545863","546034","chr14","578567","578742","6","32704"
"chr1","556529","556734","chr13","71930372","71930585","40","71373843"
"chr1","556971","557158","chr9","3262015","3262192","39","2705044"
"chr1","560885","561058","chr14","596761","596934","8","35876"
"chr1","563648","563943","chr14","599519","599817","19","35871"
"chr1","564041","564220","chr1","30517637","30517824","45","29953596"
"chr1","566037","566173","chr14","601673","601809","2","35636"
"chr1","566469","566621","chr14","602412","602564","4","35943"
"chr1","566809","567065","chr14","602752","603008","2","35943"
"chr1","571672","571943","chr14","607615","607889","12","35943"
"chr1","618421","618690","chr14","652983","653266","30","34562"
"chr1","618691","618799","chr14","653267","653375","1","34576"
"chr1","623172","623342","chr4","33972900","33973074","46","33349728"
"chr1","647979","648170","chr11","52216244","52216414","49","51568265"
"chr1","648475","648597","chr14","61647335","61647457","21","60998860"
"chr1","674494","674734","chr14","708401","708614","35","33907"
"chr1","697916","698192","chr14","733079","733357","6","35163"
"chr1","718056","718193","chr14","754816","754962","14","36760"
"chr1","719506","719661","chr14","756267","756424","3","36761"
"chr1","720393","720662","chr2","155782719","155782987","58","155062326"
"chr1","733313","733447","chr9","102149913","102150048","19","101416600"
"chr1","733448","733740","chr14","769879","770171","63","36431"
"chr1","733741","733768","chr3","89576668","89576692","8","88842927"
"chr1","743355","743507","chr10","75487186","75487344","32","74743831"
"chr1","773549","773832","chr14","810778","811061","4","37229"
"chr1","775211","775504","chr14","812439","812733","11","37228"
"chr1","796709","796849","chr14","834977","835134","20","38268"
"chr1","876121","876169","chr16","67696765","67696807","14","66820644"
"chr1","887587","887766","chr4","152014752","152014934","32","151127165"
"chr1","943443","943663","chrX","50264118","50264341","81","49320675"
"chr1","943678","943807","chr14","979578","979718","16","35900"
"chr1","1152769","1152922","chr14","1103999","1104152","6","48770"
"chr1","1163611","1163910","chr8","117801542","117801838","49","116637931"
"chr1","1263739","1263891","chr14","1209032","1209211","29","54707"
"chr1","1288146","1288427","chr14","1233149","1233429","9","54997"
"chr1","1320139","1320416","chr11","121649189","121649468","59","120329050"
"chr1","1345632","1345804","chr19","46581878","46582049","41","45236246"
"chr1","1383026","1383196","chr3","151382235","151382401","41","149999209"
"chr1","1387936","1388235","chr4","154948284","154948586","59","153560348"
"chr1","1393856","1394164","chr13","57475488","57475784","54","56081632"
"chr1","1402212","1402512","chrX","10212594","10212891","52","8810382"
"chr1","1419606","1419701","chr14","3020859","3020954","2","1601253"
"chr1","1420260","1420453","chr11","565751","565943","36","854509"
"chr1","1451676","1451979","chr11","28795229","28795528","53","27343553"
"chr1","1529449","1529571","chr14","1393568","1393690","4","135881"
"chr1","1590580","1590876","chr14","1452159","1452448","35","138421"
"chr1","1625162","1625462","chrX","17134244","17134545","48","15509082"
"chr1","1626365","1626656","chr14","1488885","1489171","14","137480"
"chr1","1740321","1740622","chr2","97022915","97023209","47","95282594"
"chr1","1743220","1743378","chr14","1601454","1601637","30","141766"
"chr1","1743680","1743793","chr14","1601939","1602052","4","141741"
"chr1","1759084","1759247","chr9","54920627","54920788","32","53161543"
"chr1","1763026","1763185","chr14","1621119","1621278","3","141907"
"chr1","1885377","1885677","chr14","1741517","1741818","7","143860"
"chr1","1915492","1915554","chr8","92567790","92567854","6","90652298"
"chr1","1915715","1915882","chr14","1772542","1772698","13","143173"
"chr1","1917253","1917524","chr14","1774024","1774294","13","143229"
"chr1","1928986","1929161","chr2","48565458","48565631","30","46636472"
"chr1","1929188","1929219","chr2","133693780","133693812","4","131764592"
"chr1","1934244","1934394","chr4","43080170","43080307","33","41145926"
"chr1","2140572","2140871","chr14","1995334","1995634","9","145238"
"chr1","2254916","2255207","chr14","2100264","2100557","11","154652"
"chr1","2287041","2287335","chr14","2129994","2130286","14","157047"
"chr1","2358142","2358497","chr13","27620153","27620508","78","25262011"
"chr1","2442806","2443099","chr14","2290304","2290597","3","152502"
"chr1","2456704","2456971","chr15","75797325","75797598","61","73340621"
"chr1","2458108","2458383","chr14","2304144","2304439","27","153964"
"chr1","2531068","2531277","chr9","51908567","51908766","62","49377499"
"chr1","2568868","2568999","chr1","29281668","29281796","20","26712800"
"chr1","2676411","2676716","chr14","2522815","2523098","34","153596"
"chr1","2686709","2686996","chr14","2533472","2533771","28","153237"
"chr1","2689355","2689659","chr14","2536033","2536337","4","153322"
"chr1","2691380","2691713","chr9","113740769","113741081","71","111049389"
"chr1","2702086","2702384","chr14","2549141","2549435","12","152945"
"chr1","2732162","2732403","chr1","5325347","5325595","57","2593185"
"chr1","2746813","2747114","chr14","2594566","2594865","5","152247"
"chr1","2748291","2748589","chr14","2596036","2596336","10","152255"
"chr1","2780943","2781230","chr14","2629537","2629817","21","151406"
"chr1","2785981","2786260","chr14","2634651","2634931","7","151330"
"chr1","2803943","2804228","chr2","92277567","92277854","74","89473624"
"chr1","2809144","2809369","chr14","2657295","2657513","18","151849"
"chr1","2828652","2828931","chr14","2676285","2676562","5","152367"
"chr1","2875996","2876334","chr14","2722933","2723268","16","153063"
"chr1","2878437","2878521","chr3","150814256","150814344","23","147935819"
"chr1","2880063","2880368","chr14","2728385","2728682","17","151678"
"chr1","2886507","2886783","chr18","71609259","71609530","72","68722752"
"chr1","2886816","2887093","chr13","102047689","102047956","71","99160873"
"chr1","2895477","2895617","chr1","8928585","8928719","26","6033108"
"chr1","2915609","2915900","chr14","2756267","2756557","21","159342"
"chr1","2916523","2916813","chr14","2756267","2756557","24","160256"
"chr1","3004896","3005071","chr15","90547962","90548131","40","87543066"
"chr1","3005097","3005222","chr3","154543697","154543812","30","151538600"
"chr1","3027149","3027395","chr11","94751367","94751621","58","91724218"
"chr1","3053261","3053531","chr14","2892264","2892535","9","160997"
"chr1","3058387","3058693","chr14","2897149","2897455","5","161238"
"chr1","3089535","3089819","chr14","2928727","2929011","8","160808"
"chr1","3160721","3160815","chr14","3020859","3020954","3","139862"
"chr1","3161068","3161240","chr11","94351939","94352106","28","91190871"
"chr1","3177829","3178081","chr14","3035763","3036013","14","142066"
"chr1","3201285","3201480","chr14","3057671","3057866","12","143614"
"chr1","3221168","3221295","chr14","3076834","3076944","20","144334"
"chr1","3221916","3221952","chr1","29085893","29085926","9","25863977"
"chr1","3221953","3222101","chr2","87936677","87936810","31","84714724"
"chr1","3259821","3260113","chr14","3116339","3116639","17","143482"
"chr1","3260121","3260258","chr13","84752135","84752271","37","81492014"
"chr1","3273350","3273629","chr1","198546952","198547242","64","195273602"
"chr1","3291209","3291516","chr10","80976143","80976451","63","77684934"
"chr1","3306249","3306499","chr14","3161542","3161792","11","144707"
"chr1","3308215","3308226","chr2","87828771","87828782","1","84520556"
"chr1","3308538","3308699","chr14","3163818","3163979","5","144720"
"chr1","3331654","3331786","chr14","3185257","3185403","19","146397"
"chr1","3342599","3342734","chr9","50303419","50303545","38","46960820"
"chr1","3342774","3342978","chr10","66128098","66128296","45","62785324"
"chr1","3356979","3357154","chrX","10332884","10333060","31","6975905"
"chr1","3375332","3375628","chr14","3223831","3224126","8","151501"
"chr1","3401095","3401401","chr14","3247929","3248236","18","153166"
"chr1","3417048","3417198","chr20","56244616","56244776","49","52827568"
"chr1","3438753","3439069","chr14","3284910","3285220","15","153843"
"chr1","3476144","3476323","chr14","3319954","3320133","7","156190"
"chr1","3477530","3477777","chr14","3321344","3321591","8","156186"
"chr1","3488302","3488464","chr14","3331490","3331652","8","156812"
"chr1","3522066","3522291","chr14","3364007","3364234","13","158059"
"chr1","3545473","3545774","chr14","3387026","3387321","14","158447"
"chr1","3545797","3545937","chr7","80227307","80227438","35","76681510"
"chr1","3546145","3546286","chr5","46597782","46597918","28","43051637"
"chr1","3579399","3579696","chr14","3417656","3417953","16","161743"
"chr1","3590867","3591146","chr14","3428808","3429087","10","162059"
"chr1","3594781","3595083","chr14","3432776","3433056","30","162005"
"chr1","3595151","3595464","chr7","49060074","49060377","66","45464923"
"chr1","3622927","3623233","chr14","3460828","3461115","46","162099"
"chr1","3630493","3630782","chr4","124361728","124361991","89","120731235"
"chr1","3637397","3637697","chr14","3470722","3471011","24","166675"
"chr1","3642505","3642740","chr16","60973383","60973614","69","57330878"
"chr1","3643293","3643366","chrX","59592045","59592117","14","55948752"
"chr1","3683418","3683710","chr14","3519621","3519911","11","163797"
"chr1","3699304","3699447","chr16","32668161","32668293","28","28968857"
"chr1","3752076","3752098","chr1","50493321","50493341","9","46741245"
"chr1","3752099","3752405","chr14","3587762","3588009","79","164337"
"chr1","3752406","3752520","chr2","149554785","149554889","36","145802379"
"chr1","3763627","3763929","chr14","3596251","3596555","21","167376"
"chr1","3771096","3771367","chr14","3603497","3603759","19","167599"
"chr1","3798587","3798722","chr3","39540961","39541094","30","35742374"
"chr1","3798723","3798938","chr7","1919134","1919352","38","1879589"
"chr1","3799877","3800163","chr14","3624520","3624838","42","175357"
"chr1","4011259","4011507","chr14","3836836","3837084","5","174423"
"chr1","4054044","4054165","chr14","3881562","3881683","2","172482"
"chr1","4057219","4057528","chr14","3884609","3884918","10","172610"
"chr1","4057551","4057615","chr8","92567790","92567854","9","88510239"
"chr1","4091017","4091333","chr14","3917692","3918004","11","173325"
"chr1","4096418","4096522","chr15","24963453","24963561","35","20867035"
"chr1","4114998","4115150","chr2","100069015","100069158","43","95954017"
"chr1","4119837","4120150","chr14","3946615","3946925","20","173222"
"chr1","4128715","4129015","chr4","24794297","24794596","63","20665582"
"chr1","4148144","4148418","chr3","114901229","114901503","60","110753085"
"chr1","4173311","4173477","chr14","4001027","4001183","19","172284"
"chr1","4173775","4173911","chr14","4001491","4001627","6","172284"
"chr1","4179963","4180251","chr14","4008018","4008306","14","171945"
"chr1","4188278","4188525","chr14","4015721","4015965","7","172557"
"chr1","4193257","4193563","chr14","4020696","4021000","7","172561"
"chr1","4194666","4194968","chr14","4022103","4022406","4","172563"
"chr1","4205745","4206040","chr14","4032760","4033055","29","172985"
"chr1","4211961","4212098","chr7","50119985","50120120","21","45908024"
"chr1","4215985","4216087","chr15","55907244","55907342","31","51691259"
"chr1","4226867","4227147","chr14","4054937","4055217","6","171930"
"chr1","4245168","4245467","chr14","4073167","4073465","2","172001"
"chr1","4250838","4250993","chr14","4078837","4078991","5","172001"
"chr1","4261252","4261513","chr14","4089022","4089284","8","172230"
"chr1","4262771","4263081","chr14","4090553","4090863","5","172218"
"chr1","4263093","4263391","chr14","4090875","4091178","9","172218"
"chr1","4270202","4270501","chr14","4098053","4098354","9","172149"
"chr1","4276402","4276697","chr10","30473071","30473368","49","26196669"
"chr1","4279235","4279536","chr14","4104998","4105299","2","174237"
"chr1","4281188","4281333","chr14","4106960","4107105","4","174228"
"chr1","4281609","4281763","chr14","4107390","4107543","4","174219"
"chr1","4285517","4285806","chr10","29047313","29047589","66","24761796"
"chr1","4293327","4293601","chr14","4118010","4118287","14","175317"
"chr1","4305228","4305542","chr14","4130788","4131099","9","174440"
"chr1","4311702","4312007","chr14","4137244","4137550","10","174458"
"chr1","4317734","4318030","chr14","4144128","4144424","6","173606"
"chr1","4321759","4322070","chr14","4147354","4147661","9","174405"
"chr1","4331377","4331686","chr14","4157342","4157648","24","174035"
"chr1","4332233","4332378","chr14","4158186","4158330","5","174047"
"chr1","4332681","4332793","chr14","4158608","4158726","14","174073"
"chr1","4337275","4337576","chr14","4163228","4163519","19","174047"
"chr1","4352987","4353293","chr14","4177893","4178202","19","175094"
"chr1","4364685","4364859","chr14","4189316","4189491","8","175369"
"chr1","4377848","4378113","chr14","4205008","4205272","5","172840"
"chr1","4390606","4390929","chr14","4217552","4217875","16","173054"
"chr1","4390930","4391001","chr14","4217876","4217946","3","173054"
"chr1","4392409","4392677","chr14","4219126","4219393","9","173283"
"chr1","4405959","4406234","chr14","4231260","4231538","12","174699"
"chr1","4413013","4413274","chr3","40367752","40368018","76","35954739"
"chr1","4439323","4439496","chr14","4263664","4263817","24","175659"
"chr1","4551916","4552221","chr14","4371901","4372180","28","180015"
"chr1","4580207","4580355","chr14","4397725","4397858","18","182482"
"chr1","4589494","4589806","chr14","4406999","4407313","14","182495"
"chr1","4635951","4636259","chr14","4451683","4451986","11","184268"
"chr1","4658037","4658322","chr14","4475198","4475479","14","182839"
"chr1","4679797","4679954","chr14","4496033","4496201","16","183764"
"chr1","4679989","4680105","chr14","4496239","4496355","5","183750"
"chr1","4705586","4705916","chr14","4522802","4523129","11","182784"
"chr1","4709987","4710153","chr14","4532929","4533095","2","177058"
"chr1","4725915","4726199","chr6","153670740","153671020","65","148944825"
"chr1","4740796","4741082","chr14","4563095","4563380","11","177701"
"chr1","4779121","4779333","chr14","4602619","4602854","34","176502"
"chr1","4794447","4794570","chr14","4617699","4617822","2","176748"
"chr1","4798677","4798916","chr14","4622540","4622776","12","176137"
"chr1","4808852","4809143","chr14","4632782","4633073","7","176070"
"chr1","4828448","4828602","chr10","32247914","32248061","31","27419466"
"chr1","4835274","4835378","chr14","4658383","4658488","2","176891"
"chr1","4837993","4838256","chr14","4659885","4660152","9","178108"
"chr1","4847832","4848076","chr5","78734228","78734466","42","73886396"
"chr1","4858256","4858560","chr14","4682813","4683116","7","175443"
"chr1","4861782","4862085","chr14","4686344","4686645","6","175438"
"chr1","4875905","4876187","chr14","4698733","4699016","11","177172"
"chr1","4879887","4880177","chr14","4702833","4703135","22","177054"
"chr1","4884988","4885292","chr14","4706310","4706620","15","178678"
"chr1","4940792","4941094","chr7","5884655","5884958","60","943863"
"chr1","4942458","4942760","chr14","4766601","4766903","7","175857"
"chr1","4956294","4956592","chr14","4780438","4780732","15","175856"
"chr1","4964304","4964557","chr2","43055409","43055660","58","38091105"
"chr1","5000219","5000525","chr14","4824694","4825000","4","175525"
"chr1","5026434","5026588","chr3","38344444","38344579","39","33318010"
"chr1","5028387","5028671","chr14","4854502","4854816","36","173885"
"chr1","5035229","5035514","chr14","4861300","4861595","20","173929"
"chr1","5042161","5042310","chr1","134295458","134295607","29","129253297"
"chr1","5042336","5042462","chr13","118758896","118759021","21","113716560"
"chr1","5092693","5092982","chr14","4916608","4916897","6","176085"
"chr1","5226057","5226352","chr14","5047416","5047711","2","178641"
"chr1","5247005","5247049","chr5","129859422","129859469","11","124612417"
"chr1","5342019","5342322","chr14","5156957","5157269","20","185062"
"chr1","5407516","5407803","chr14","5217294","5217586","13","190222"
"chr1","5408616","5408846","chr1","23703870","23704083","67","18295254"
"chr1","5408865","5408981","chr14","5218515","5218638","13","190350"
"chr1","5447845","5448161","chr2","93500645","93500947","65","88052800"
"chr1","5461158","5461431","chr10","82734133","82734376","75","77272975"
"chr1","5461477","5461628","chr2","43194047","43194197","29","37732570"
"chr1","5543464","5543772","chr14","5349837","5350143","12","193627"
"chr1","5586100","5586382","chr14","5392364","5392668","31","193736"
"chr1","5586417","5586436","chr1","56668985","56669002","5","51082568"
"chr1","5601739","5602070","chr14","5406410","5406740","24","195329"
"chr1","5606298","5606589","chr14","5410966","5411255","17","195332"
"chr1","5608599","5608887","chr14","5412835","5413125","12","195764"
"chr1","5613716","5614025","chr20","39705042","39705349","61","34091326"
"chr1","5643821","5643899","chr11","83807798","83807872","15","78163977"
"chr1","5649929","5650105","chr7","152929958","152930134","38","147280029"
"chr1","5651498","5651788","chr14","5457275","5457565","8","194223"
"chr1","5677766","5678064","chr14","5484627","5484927","10","193139"
"chr1","5687665","5687826","chr14","5500796","5500966","12","186869"
"chr1","5695719","5695941","chr14","5508473","5508695","2","187246"
"chr1","5701458","5701638","chr14","5513977","5514159","3","187481"
"chr1","5714913","5715073","chr14","5527429","5527590","5","187484"
"chr1","5715391","5715532","chr14","5527889","5528028","6","187502"
"chr1","5718205","5718454","chr14","5530738","5530987","7","187467"
"chr1","5722286","5722492","chr14","5534696","5534902","34","187590"
"chr1","5725514","5725817","chr14","5537807","5538109","11","187707"
"chr1","5731341","5731632","chr1","189908433","189908718","49","184177092"
"chr1","5736495","5736657","chr2","187026390","187026555","41","181289895"
"chr1","5738805","5739106","chr14","5551707","5552000","13","187098"
"chr1","5739132","5739442","chr14","5552026","5552328","25","187106"
"chr1","5740926","5741153","chr14","5553727","5553956","5","187199"
"chr1","5742591","5742758","chr14","5555395","5555561","4","187196"
"chr1","5743062","5743165","chr14","5555859","5555956","7","187203"
"chr1","5745781","5746075","chr14","5558581","5558876","8","187200"
"chr1","5752886","5753105","chr14","5565098","5565315","9","187788"
"chr1","5762978","5763266","chr14","5575248","5575537","7","187730"
"chr1","5771786","5772077","chr14","5584798","5585091","18","186988"
"chr1","5775790","5776083","chr14","5588603","5588893","10","187187"
"chr1","5777003","5777162","chr16","57927805","57927961","26","52150802"
"chr1","5778889","5779204","chr14","5591679","5592000","14","187210"
"chr1","5780643","5780943","chr14","5593441","5593741","6","187202"
"chr1","5798448","5798744","chr14","5612974","5613269","9","185474"
"chr1","5810764","5810967","chr14","5624817","5625019","3","185947"
"chr1","5832072","5832372","chr14","5645909","5646208","11","186163"
"chr1","5839728","5840044","chr14","5653485","5653791","22","186243"
"chr1","5847263","5847323","chr5","80684202","80684260","13","74836939"
"chr1","5887730","5888031","chr14","5701426","5701726","10","186304"
"chr1","5914482","5914645","chr14","5721315","5721478","6","193167"
"chr1","5915018","5915264","chr14","5721855","5722099","14","193163"
"chr1","5928086","5928314","chr14","5736524","5736751","4","191562"
"chr1","5929247","5929521","chr14","5737691","5737965","7","191556"
"chr1","5941572","5941786","chr14","5750014","5750228","7","191558"
"chr1","5968576","5968876","chr14","5777327","5777630","9","191249"
"chr1","5976284","5976421","chr14","5785055","5785204","16","191229"
"chr1","6006939","6007194","chr14","5816451","5816706","2","190488"
"chr1","6011996","6012282","chr14","5821487","5821773","7","190509"
"chr1","6027845","6028128","chr14","5838890","5839187","24","188955"
"chr1","6036856","6037135","chr14","5849680","5849959","5","187176"
"chr1","6039088","6039381","chr14","5853860","5854155","5","185228"
"chr1","6040225","6040551","chrX","38499192","38499507","67","32458967"
"chr1","6045510","6045783","chr14","5858963","5859236","5","186547"
"chr1","6050559","6050721","chr14","5863784","5863946","4","186775"
"chr1","6074897","6075079","chr14","5886877","5887057","2","188020"
"chr1","6085566","6085863","chr14","5897803","5898108","23","187763"
"chr1","6110979","6111128","chr14","5922548","5922696","5","188431"
"chr1","6111385","6111532","chr4","5658301","5658444","30","453084"
"chr1","6113759","6114047","chr14","5925287","5925580","13","188472"
"chr1","6120343","6120579","chr14","5932801","5933028","17","187542"
"chr1","6120891","6120907","chr9","20973335","20973349","2","14852444"
"chr1","6121037","6121332","chr19","27639596","27639887","58","21518559"
"chr1","6131271","6131566","chr14","5943566","5943866","19","187705"
"chr1","6131953","6132257","chr14","5944579","5944882","9","187374"
"chr1","6135154","6135482","chr13","41851851","41852159","65","35716697"
"chr1","6147483","6147778","chr14","5962060","5962355","15","185423"
"chr1","6173509","6173637","chr14","5988965","5989093","4","184544"
"chr1","6177815","6178047","chr14","5993310","5993541","16","184505"
"chr1","6178387","6178489","chr14","5993853","5993969","14","184534"
"chr1","6179736","6180031","chr14","5995200","5995497","11","184536"
"chr1","6181680","6181975","chr14","5997180","5997483","24","184500"
"chr1","6189298","6189470","chr16","53600255","53600428","35","47410957"
"chr1","6189498","6189611","chr3","154543697","154543812","19","148354199"
"chr1","6202287","6202440","chr14","6018735","6018888","3","183552"
"chr1","6214214","6214350","chr3","45465613","45465747","29","39251399"
"chr1","6219239","6219536","chr14","6036469","6036770","20","182770"
"chr1","6229012","6229180","chr14","6046352","6046520","5","182660"
"chr1","6229181","6229453","chr14","6046521","6046803","17","182660"
"chr1","6229454","6229647","chr14","6046857","6046990","65","182597"
"chr1","6237594","6237768","chr14","6055242","6055416","4","182352"
"chr1","6240308","6240600","chr14","6059097","6059394","11","181211"
"chr1","6289905","6290215","chr14","6106687","6107000","17","183218"
"chr1","6291767","6292049","chr1","30495060","30495349","59","24203293"
"chr1","6294700","6295014","chr1","35300925","35301227","61","29006225"
"chr1","6295588","6295846","chr14","6107634","6107892","9","187954"
"chr1","6302750","6302887","chr14","6127037","6127174","9","175713"
"chr1","6303190","6303352","chr14","6127478","6127641","4","175712"
"chr1","6319772","6320052","chr14","6145160","6145440","16","174612"
"chr1","6327405","6327566","chrX","106861512","106861669","33","100534107"
"chr1","6333029","6333339","chr14","6159765","6160075","6","173264"
"chr1","6378541","6378734","chr14","6206325","6206518","17","172216"
"chr1","6381083","6381251","chr14","6208873","6209041","5","172210"
"chr1","6392242","6392550","chr14","6219953","6220249","14","172289"
"chr1","6406584","6406719","chr14","6225761","6225896","3","180823"
"chr1","6414949","6415238","chr14","6234210","6234506","20","180739"
"chr1","6426314","6426612","chr14","6245366","6245664","8","180948"
"chr1","6428924","6429086","chr14","6248589","6248751","3","180335"
"chr1","6430715","6430798","chr9","39794823","39794909","24","33364108"
"chr1","6438149","6438442","chr14","6257796","6258089","6","180353"
"chr1","6439416","6439711","chr14","6259062","6259358","6","180354"
"chr1","6447170","6447446","chr14","6266858","6267141","12","180312"
"chr1","6453404","6453706","chr14","6273122","6273424","4","180282"
"chr1","6469042","6469314","chr14","6289553","6289834","20","179489"
"chr1","6470923","6471226","chr14","6291431","6291734","4","179492"
"chr1","6500567","6500857","chr14","6323020","6323308","7","177547"
"chr1","6506225","6506516","chr8","94393001","94393292","54","87886776"
"chr1","6535251","6535569","chr14","6356580","6356876","28","178671"
"chr1","6611597","6611890","chr2","76587906","76588205","56","69976309"
"chr1","6614676","6614985","chr14","6435764","6436069","11","178912"
"chr1","6617141","6617263","chr14","6438559","6438679","8","178582"
"chr1","6617344","6617357","chr18","12587331","12587345","2","5969987"
"chr1","6661084","6661365","chr14","6482393","6482674","11","178691"
"chr1","6661997","6662311","chr14","6483325","6483632","24","178672"
"chr1","6662696","6662992","chr7","145473387","145473690","72","138810691"
"chr1","6672815","6672996","chr14","6494024","6494230","34","178791"
"chr1","6673030","6673057","chrX","65951066","65951093","5","59278036"
"chr1","6681748","6681937","chr14","6502823","6503012","2","178925"
"chr1","6682241","6682376","chr1","21721800","21721934","22","15039559"
"chr1","6682380","6682512","chr4","119142322","119142454","18","112459942"
"chr1","6683191","6683417","chr14","6504136","6504362","3","179055"
"chr1","6689386","6689698","chr14","6510639","6510949","10","178747"
"chr1","6692760","6693029","chr14","6513948","6514217","7","178812"
"chr1","6712018","6712326","chr14","6533900","6534210","3","178118"
"chr1","6714233","6714535","chr14","6536109","6536410","10","178124"
"chr1","6734002","6734301","chr14","6558124","6558419","9","175878"
"chr1","6735176","6735229","chr10","6785229","6785278","9","50053"
"chr1","6735230","6735397","chr7","67074697","67074874","40","60339467"
"chr1","6748134","6748184","chr14","6572123","6572173","0","176011"
"chr1","6753027","6753178","chr14","6577000","6577161","16","176027"
"chr1","6783604","6783771","chr14","6608469","6608639","7","175135"
"chr1","6784449","6784741","chr16","26045115","26045411","66","19260666"
"chr1","6791095","6791190","chr3","35325083","35325179","15","28533988"
"chr1","6800565","6800859","chr14","6627063","6627367","16","173502"
"chr1","6810580","6810867","chr2","71375567","71375855","65","64564987"
"chr1","6818709","6818799","chr14","6645840","6645930","1","172869"
"chr1","6819076","6819308","chr1","94650824","94651067","71","87831748"
"chr1","6849470","6849723","chr14","6676011","6676282","21","173459"
"chr1","6860948","6861227","chr14","6687560","6687839","5","173388"
"chr1","6876261","6876443","chr6","33866955","33867140","37","26990694"
"chr1","6878145","6878326","chr19","13019831","13020006","32","6141686"
"chr1","6878696","6878964","chr18","13398332","13398617","59","6519636"
"chr1","6904227","6904362","chr14","6731416","6731550","3","172811"
"chr1","6904674","6904807","chr14","6731864","6731997","5","172810"
"chr1","6918339","6918650","chr2","113489797","113490109","70","106571458"
"chr1","6923439","6923725","chr14","6750396","6750692","18","173043"
"chr1","6928296","6928401","chr14","6755267","6755371","12","173029"
"chr1","6930694","6930867","chr14","6757447","6757620","4","173247"
"chr1","6931222","6931341","chr8","10039828","10039947","15","3108606"
"chr1","6931422","6931721","chr14","6758155","6758467","21","173267"
"chr1","6932758","6932843","chr3","87400685","87400770","27","80467927"
"chr1","6947428","6947562","chr1","4849181","4849310","20","2098247"
"chr1","6950066","6950371","chr14","6777165","6777480","15","172901"
"chr1","6950377","6950553","chr14","6777486","6777662","5","172891"
"chr1","6954715","6954875","chr14","6781826","6781988","5","172889"
"chr1","6967972","6968297","chr14","6797503","6797829","6","170469"
"chr1","6970408","6970705","chr14","6799945","6800241","13","170463"
"chr1","7001551","7001709","chr14","6831100","6831261","4","170451"
"chr1","7001998","7002090","chr14","6831549","6831650","11","170449"
"chr1","7012178","7012272","chr14","6842015","6842109","1","170163"
"chr1","7026827","7027068","chr14","6857287","6857528","4","169540"
"chr1","7031751","7031966","chr14","6862301","6862522","13","169450"
"chr1","7032250","7032571","chr14","6862828","6863143","12","169422"
"chr1","7032580","7032713","chr1","8928585","8928719","24","1896005"
"chr1","7033977","7034269","chr14","6864538","6864829","26","169439"
"chr1","7038023","7038148","chr1","38631720","38631844","23","31593697"
"chr1","7038767","7039075","chr14","6869295","6869633","36","169472"
"chr1","7041998","7042298","chr14","6872276","6872578","6","169722"
"chr1","7042447","7042734","chr14","6872721","6873008","4","169726"
"chr1","7047434","7047566","chr14","6877729","6877868","10","169705"
"chr1","7048114","7048199","chr1","161105488","161105574","12","154057374"
"chr1","7054566","7054872","chr14","6884030","6884326","20","170536"
"chr1","7061630","7061929","chr14","6891440","6891732","15","170190"
"chr1","7064673","7064947","chr14","6895430","6895701","3","169243"
"chr1","7073665","7073951","chr7","29607624","29607916","64","22533959"
"chr1","7078626","7078907","chr14","6908732","6909023","19","169894"
"chr1","7084401","7084690","chr14","6915037","6915332","9","169364"
"chr1","7087441","7087595","chr14","6918021","6918175","3","169420"
"chr1","7089347","7089482","chr14","6919933","6920068","6","169414"
"chr1","7089807","7089817","chr11","2965492","2965503","1","4124315"
"chr1","7090130","7090252","chr14","6920696","6920817","7","169434"
"chr1","7091089","7091250","chr14","6921669","6921839","10","169420"
"chr1","7117646","7117949","chr14","6947794","6948097","8","169852"
"chr1","7122216","7122518","chr9","20851892","20852190","68","13729676"
"chr1","7123841","7124144","chr7","112841491","112841793","63","105717650"
"chr1","7127896","7128203","chr14","6956043","6956349","8","171853"
"chr1","7143117","7143414","chr14","6971723","6972027","19","171394"
"chr1","7145018","7145138","chr14","6973619","6973739","1","171399"
"chr1","7145982","7146252","chr14","6974588","6974858","4","171394"
"chr1","7187866","7188139","chr14","7016458","7016737","11","171408"
"chr1","7191934","7191993","chr1","184803787","184803842","12","177611853"
"chr1","7192308","7192467","chr14","7021230","7021386","3","171078"
"chr1","7192840","7193002","chr14","7021759","7021921","3","171081"
"chr1","7193310","7193325","chr9","5869057","5869070","2","1324253"
"chr1","7207411","7207566","chr2","172227852","172227991","38","165020441"
"chr1","7208766","7208898","chrX","25067848","25067980","17","17859082"
"chr1","7230314","7230623","chr14","7061434","7061737","13","168880"
"chr1","7235473","7235807","chr14","7067846","7068158","23","167627"
"chr1","7251225","7251501","chr14","7084073","7084344","7","167152"
"chr1","7259347","7259623","chr14","7092487","7092762","7","166860"
"chr1","7262451","7262537","chr2","76595940","76596024","20","69333489"
"chr1","7267668","7267794","chr13","63787243","63787367","36","56519575"
"chr1","7269522","7269625","chr1","26521538","26521641","23","19252016"
"chr1","7271087","7271311","chr2","41641895","41642119","48","34370808"
"chr1","7283049","7283330","chr14","7113574","7113853","9","169475"
"chr1","7288850","7289142","chr14","7121772","7122064","6","167078"
"chr1","7304470","7304658","chr10","87423992","87424165","38","80119522"
"chr1","7304974","7305011","chr9","92079845","92079882","11","84774871"
"chr1","7305249","7305320","chr11","107874455","107874526","12","100569206"
"chr1","7311502","7311765","chr14","7136870","7137141","12","174632"
"chr1","7321243","7321535","chr14","7145684","7145961","18","175559"
"chr1","7328332","7328627","chr14","7153919","7154206","12","174413"
"chr1","7334574","7334737","chr19","14673246","14673394","39","7338672"
"chr1","7360428","7360714","chr14","7187061","7187347","5","173367"
"chr1","7382127","7382216","chr1","28195903","28195995","16","20813776"
"chr1","7382323","7382563","chr4","123832208","123832428","66","116449885"
"chr1","7424567","7424852","chr14","7250859","7251146","7","173708"
"chr1","7436783","7437085","chr14","7262240","7262542","7","174543"
"chr1","7439288","7439458","chr14","7264746","7264912","8","174542"
"chr1","7440036","7440169","chr14","7265816","7265949","3","174220"
"chr1","7440982","7441290","chr14","7266757","7267065","4","174225"
"chr1","7452110","7452183","chr14","7277749","7277822","1","174361"
"chr1","7483733","7484014","chr14","7309334","7309616","5","174399"
"chr1","7487931","7488045","chr14","7314485","7314588","12","173446"
"chr1","7489670","7489914","chr14","7315890","7316123","16","173780"
"chr1","7493936","7494201","chr14","7319673","7319940","7","174263"
"chr1","7504504","7504824","chr14","109704371","109704669","73","102199867"
"chr1","7507948","7508241","chr14","7356424","7356717","6","151524"
"chr1","7510650","7510936","chr14","7330032","7330319","3","180618"
"chr1","7523373","7523614","chr7","39876078","39876332","77","32352705"
"chr1","7524372","7524529","chr14","7368195","7368355","14","156177"
"chr1","7524842","7524975","chr14","7368657","7368790","1","156185"
"chr1","7569580","7569893","chr14","7414740","7415052","7","154840"
"chr1","7577401","7577685","chr14","7422221","7422512","14","155180"
"chr1","7588781","7589052","chr14","7433156","7433434","11","155625"
"chr1","7590067","7590353","chr14","7434446","7434732","2","155621"
"chr1","7591152","7591450","chr14","7435527","7435823","18","155625"
"chr1","7592608","7592896","chr14","7437641","7437924","14","154967"
"chr1","7607948","7608087","chr14","7453134","7453273","5","154814"
"chr1","7608631","7608812","chr14","7453816","7454001","10","154815"
"chr1","7615194","7615465","chr14","7460459","7460729","9","154735"
"chr1","7619228","7619450","chr14","7464970","7465194","7","154258"
"chr1","7620291","7620412","chr3","16112419","16112537","22","8492128"
"chr1","7622089","7622399","chr14","67346230","67346520","61","59724141"
"chr1","7622404","7622564","chr13","68543994","68544160","38","60921590"
"chr1","7641128","7641421","chr14","7486360","7486662","15","154768"
"chr1","7643323","7643628","chr18","15790652","15790957","59","8147329"
"chr1","7656559","7656902","chr20","62661421","62661767","91","55004862"
"chr1","7657016","7657305","chr14","7509973","7510262","3","147043"
"chr1","7660954","7661115","chrX","106861512","106861669","35","99200558"
"chr1","7668616","7668703","chr2","89735536","89735621","17","82066920"
"chr1","7669425","7669732","chr14","7514795","7515081","26","154630"
"chr1","7685097","7685390","chr14","7528212","7528505","4","156885"
"chr1","7700932","7701236","chr14","7543420","7543729","13","157512"
"chr1","7701312","7701614","chr14","7543780","7544085","14","157532"
"chr1","7713482","7713759","chr14","7555925","7556206","9","157557"
"chr1","7715084","7715368","chr14","7557528","7557812","5","157556"
"chr1","7717355","7717681","chr14","7559781","7560104","8","157574"
"chr1","7721536","7721644","chr1","90559455","90559562","17","82837919"
"chr1","7736538","7736822","chr14","7580044","7580328","2","156494"
"chr1","7768855","7769154","chr4","11915397","11915699","60","4146542"
"chr1","7769868","7770168","chr14","7622769","7623052","24","147099"
"chr1","7774791","7774853","chr16","32237001","32237062","17","24462210"
"chr1","7790093","7790147","chr4","153887367","153887414","16","146097274"
"chr1","7790149","7790253","chr11","14641291","14641391","21","6851142"
"chr1","7820110","7820325","chr14","17098025","17098238","41","9277915"
"chr1","7823659","7823960","chr4","42143224","42143519","59","34319565"
"chr1","7851151","7851457","chr14","7675621","7675947","25","175530"
"chr1","7854958","7855232","chr14","7678928","7679201","4","176030"
"chr1","7879360","7879491","chr14","7703626","7703757","5","175734"
"chr1","7883927","7884079","chr14","7708202","7708357","5","175725"
"chr1","7890804","7891110","chr14","7714831","7715142","15","175973"
"chr1","7892188","7892490","chr14","7716419","7716715","13","175769"
"chr1","7899913","7900224","chr14","7725112","7725422","4","174801"
"chr1","7909912","7910199","chr14","7736267","7736554","6","173645"
"chr1","7925520","7925798","chr14","7758700","7758984","19","166820"
"chr1","7926661","7926674","chr14","7759831","7759844","0","166830"
"chr1","7926675","7926979","chr14","7759845","7760149","2","166830"
"chr1","7926980","7927140","chr14","7760150","7760310","1","166830"
"chr1","7937579","7937845","chr14","7772145","7772405","21","165434"
"chr1","7975452","7975733","chr14","7810485","7810797","36","164967"
"chr1","7995794","7995922","chr14","7830806","7830934","3","164988"
"chr1","8005895","8006089","chr14","7840919","7841113","2","164976"
"chr1","8006395","8006500","chr14","7841420","7841524","2","164975"
"chr1","8012046","8012335","chr14","7846834","7847123","5","165212"
"chr1","8033527","8033603","chr14","52228994","52229067","14","44195467"
"chr1","8033670","8033902","chr6","142890910","142891153","41","134857240"
"chr1","8046248","8046507","chr14","7881124","7881383","8","165124"
"chr1","8052708","8053003","chr14","7887828","7888122","6","164880"
"chr1","8053417","8053715","chr14","7888539","7888847","21","164878"
"chr1","8060076","8060286","chr14","7895214","7895423","8","164862"
"chr1","8060587","8060666","chr9","85194339","85194418","12","77133752"
"chr1","8063692","8063809","chr14","7898774","7898889","6","164918"
"chr1","8093835","8093971","chr8","113021074","113021211","34","104927239"
"chr1","8094002","8094249","chr6","101193819","101194038","73","93099817"
"chr1","8096552","8096821","chr14","7932840","7933091","26","163712"
"chr1","8109026","8109329","chr14","7945191","7945493","9","163835"
"chr1","8119957","8120244","chr14","7962053","7962341","11","157904"
"chr1","8141757","8141918","chr4","43080170","43080307","44","34938413"
"chr1","8142226","8142526","chr14","7985087","7985387","8","157139"
"chr1","8145824","8146125","chr14","7988495","7988796","2","157329"
"chr1","8161692","8161976","chr14","8004849","8005133","3","156843"
"chr1","8165209","8165407","chr14","8008606","8008802","9","156603"
"chr1","8180654","8180943","chr14","8023733","8024018","11","156921"
"chr1","8183047","8183343","chr14","8025883","8026179","8","157164"
"chr1","8198118","8198409","chr14","8040744","8041036","22","157374"
"chr1","8222196","8222505","chr16","22294372","22294673","64","14072176"
"chr1","8225531","8225709","chr2","115710121","115710276","49","107484590"
"chr1","8226760","8227008","chr10","77079840","77080085","85","68853080"
"chr1","8246516","8246663","chr14","8093507","8093653","3","153009"
"chr1","8257792","8257923","chr6","144303318","144303443","27","136045526"
"chr1","8273643","8273813","chr14","8121472","8121633","14","152171"
"chr1","8278795","8279087","chr14","8125435","8125729","13","153360"
"chr1","8283221","8283463","chr14","8130323","8130567","11","152898"
"chr1","8283473","8283765","chr14","8130577","8130872","7","152896"
"chr1","8296744","8297040","chr14","8144265","8144554","15","152479"
"chr1","8299768","8300047","chr14","8147287","8147566","11","152481"
"chr1","8306350","8306631","chr14","8152748","8153026","11","153602"
"chr1","8315608","8315913","chr6","73547736","73548035","55","65232128"
"chr1","8320595","8320753","chr14","8170193","8170351","2","150402"
"chr1","8333075","8333190","chr14","8181889","8182004","1","151186"
"chr1","8333247","8333394","chr14","8182038","8182205","23","151209"
"chr1","8344992","8345285","chr1","164144365","164144648","71","155799373"
"chr1","8352783","8353036","chr18","9804584","9804832","61","1451801"
"chr1","8354879","8355121","chr14","8206781","8207024","5","148098"
"chr1","8355687","8355898","chr14","8207591","8207817","17","148096"
"chr1","8358385","8358666","chr14","8209879","8210212","60","148506"
"chr1","8402552","8402782","chr9","94815349","94815573","57","86412797"
"chr1","8415482","8415802","chr14","8267314","8267633","6","148168"
"chr1","8435818","8436101","chr14","8288091","8288364","17","147727"
"chr1","8439846","8440146","chr14","8290018","8290317","10","149828"
"chr1","8443138","8443464","chr14","8293826","8294123","34","149312"
"chr1","8463600","8463761","chr14","8316921","8317082","2","146679"
"chr1","8464056","8464214","chr11","46309555","46309684","46","37845499"
"chr1","8488119","8488412","chr14","8340624","8340915","8","147495"
"chr1","8501153","8501460","chr14","62153460","62153766","53","53652307"
"chr1","8501861","8502158","chr6","109582888","109583178","52","101081027"
"chr1","8504920","8505238","chrX","15697361","15697669","58","7192441"
"chr1","8520866","8521147","chr14","14864487","14864770","58","6343621"
"chr1","8525729","8526020","chr14","8356566","8356860","9","169163"
"chr1","8531906","8532087","chr14","8362707","8362907","31","169199"
"chr1","8532381","8532513","chr14","8363514","8363646","2","168867"
"chr1","8534546","8534729","chr14","8362707","8362907","31","171839"
"chr1","8535023","8535155","chr14","8363514","8363646","2","171509"
"chr1","8558473","8558746","chr1","28499187","28499455","60","19940714"
"chr1","8574593","8574874","chr14","8410509","8410797","21","164084"
"chr1","8606349","8606660","chr14","8442807","8443114","11","163542"
"chr1","8633429","8633567","chr14","8477524","8477662","1","155905"
"chr1","8641702","8641999","chr14","8473321","8473617","9","168381"
"chr1","8671788","8671882","chr14","8507771","8507881","18","164017"
"chr1","8720816","8721072","chr3","125030767","125031037","51","116309951"
"chr1","8724270","8724405","chr14","8562232","8562366","4","162038"
"chr1","8725033","8725206","chr14","8562658","8562831","3","162375"
"chr1","8728312","8728619","chr11","115869443","115869748","65","107141131"
"chr1","8760354","8760571","chr14","8594459","8594676","2","165895"
"chr1","8774504","8774649","chr14","8607132","8607279","3","167372"
"chr1","8774938","8775081","chr14","8607570","8607709","5","167368"
"chr1","8779702","8779861","chr20","25010775","25010932","36","16231073"
"chr1","8780173","8780188","chr3","152129232","152129245","3","143349059"
"chr1","8780497","8780515","chr7","158140799","158140817","5","149360302"
"chr1","8780829","8780996","chr19","38967848","38968005","50","30187019"
"chr1","8784996","8785307","chr14","8619252","8619563","10","165744"
"chr1","8822322","8822621","chr14","8661710","8662014","32","160612"
"chr1","8824038","8824339","chr14","8661710","8662014","9","162328"
"chr1","8828495","8828775","chr14","8658725","8659007","11","169770"
"chr1","8828958","8829171","chr9","14850025","14850246","48","6021067"
"chr1","8829979","8830258","chr14","8666091","8666382","59","163888"
"chr1","8831099","8831388","chr14","8667543","8667832","5","163556"
"chr1","8835262","8835444","chr9","57895250","57895445","61","49059988"
"chr1","8840797","8840901","chr13","59842000","59842110","18","51001203"
"chr1","8840912","8841034","chr7","30249077","30249200","41","21408165"
"chr1","8871101","8871224","chr14","8709367","8709489","4","161734"
"chr1","8871539","8871695","chr14","8709811","8709968","5","161728"
"chr1","8908648","8908812","chr5","103650142","103650309","35","94741494"
"chr1","8911027","8911157","chr14","8749997","8750127","2","161030"
"chr1","8929660","8929907","chr14","8770269","8770559","51","159391"
"chr1","8929908","8929958","chr3","73860886","73860934","11","64930978"
"chr1","8929969","8930135","chrX","45599837","45600005","35","36669868"
"chr1","8934179","8934475","chr14","8774687","8774986","9","159492"
"chr1","8949552","8949855","chr14","8789226","8789513","16","160326"
"chr1","8951649","8951940","chr14","8791296","8791589","5","160353"
"chr1","8952724","8952903","chr14","8792371","8792558","10","160353"
"chr1","8953195","8953286","chr14","8792853","8792944","1","160342"
"chr1","8960453","8960746","chr6","144636307","144636597","60","135675854"
"chr1","8964573","8964696","chr14","8805392","8805515","3","159181"
"chr1","8972803","8973091","chr14","8814100","8814403","36","158703"
"chr1","8973092","8973264","chr2","33345898","33346071","27","24372806"
"chr1","8977635","8977872","chr14","8819352","8819640","56","158283"
"chr1","8977938","8978176","chr14","8819352","8819640","54","158586"
"chr1","8979670","8979837","chr19","37162232","37162399","31","28182562"
"chr1","8983861","8984000","chr19","33047254","33047391","25","24063393"
"chr1","8984291","8984457","chr4","17570438","17570600","41","8586147"
"chr1","8985108","8985415","chr14","8829262","8829569","10","155846"
"chr1","8996117","8996421","chr14","8835737","8836048","12","160380"
"chr1","8999236","8999369","chr14","8838807","8838940","2","160429"
"chr1","9018628","9018929","chr14","8863467","8863771","11","155161"
"chr1","9029344","9029635","chr14","8871594","8871887","12","157750"
"chr1","9030962","9031054","chr14","8873449","8873541","3","157513"
"chr1","9031374","9031453","chr14","8873856","8873934","4","157518"
"chr1","9037864","9038094","chr15","99486679","99486907","55","90448815"
"chr1","9052428","9052766","chr14","8893862","8894165","49","158566"
"chr1","9072967","9073132","chr10","81708372","81708536","31","72635405"
"chr1","9078036","9078326","chr14","8920640","8920940","17","157396"
"chr1","9092192","9092369","chr14","8936558","8936735","4","155634"
"chr1","9130055","9130269","chr14","8975260","8975476","4","154795"
"chr1","9130832","9131132","chr13","9154642","9154934","73","23810"
"chr1","9131412","9131533","chr14","8977232","8977353","3","154180"
"chr1","9131829","9132022","chr14","8977648","8977840","6","154181"
"chr1","9132708","9132906","chr14","8978530","8978730","8","154178"
"chr1","9133209","9133338","chr14","8979029","8979165","12","154180"
"chr1","9140323","9140622","chr10","80331776","80332071","58","71191453"
"chr1","9140670","9140830","chr14","8986325","8986469","19","154345"
"chr1","9142540","9142652","chr14","8988178","8988290","1","154362"
"chr1","9142942","9143075","chr14","8988578","8988713","4","154364"
"chr1","9143426","9143556","chr14","8989037","8989168","7","154389"
"chr1","9153883","9154147","chr11","112972511","112972776","65","103818628"
"chr1","9155480","9155702","chr13","100910734","100910954","48","91755254"
"chr1","9159694","9159789","chr4","107915832","107915927","11","98756138"
"chr1","9160086","9160297","chr15","6130205","6130419","45","3029881"
"chr1","9165548","9165856","chr14","92998547","92998853","50","83832999"
"chr1","9183287","9183604","chr4","21577512","21577826","67","12394225"
"chr1","9183900","9184038","chr9","84379993","84380119","32","75196093"
"chr1","9185066","9185337","chr14","9030927","9031198","12","154139"
"chr1","9196851","9197153","chr14","9043356","9043661","12","153495"
"chr1","9199619","9199899","chr14","9046127","9046407","3","153492"
"chr1","9202706","9203013","chr5","46180676","46180978","63","36977970"
"chr1","9208356","9208475","chr1","19748519","19748641","23","10540163"
"chr1","9209029","9209243","chr20","20042595","20042794","54","10833566"
"chr1","9211139","9211432","chr14","9059297","9059591","4","151842"
"chr1","9215530","9215702","chr14","9063492","9063662","4","152038"
"chr1","9222014","9222158","chr1","29712199","29712351","39","20490185"
"chr1","9225150","9225449","chr14","9072804","9073103","7","152346"
"chr1","9225999","9226191","chr14","9073385","9073569","13","152614"
"chr1","9227173","9227289","chr14","9075157","9075278","14","152016"
"chr1","9230626","9230947","chr14","9079345","9079665","15","151281"
"chr1","9243687","9243963","chr14","9094088","9094387","30","149599"
"chr1","9261031","9261114","chr14","9110526","9110609","2","150505"
"chr1","9264793","9265081","chr14","9116035","9116323","7","148758"
"chr1","9289363","9289576","chr14","9141649","9141864","3","147714"
"chr1","9297510","9297822","chr14","9150258","9150547","26","147252"
"chr1","9306163","9306442","chr14","9158911","9159211","29","147252"
"chr1","9311645","9311887","chr14","9164671","9164946","40","146974"
"chr1","9312571","9312873","chr14","9165630","9165925","11","146941"
"chr1","9332289","9332602","chr14","9186024","9186328","14","146265"
"chr1","9343935","9344229","chr14","9197518","9197817","13","146417"
"chr1","9349632","9349888","chr14","9203098","9203354","6","146534"
"chr1","9372228","9372416","chr19","36277257","36277449","49","26905029"
"chr1","9389480","9389649","chr14","9242876","9243044","4","146604"
"chr1","9406508","9406673","chr14","9259425","9259593","11","147083"
"chr1","9406970","9407108","chr14","9259889","9260027","9","147081"
"chr1","9418920","9419091","chr14","9273017","9273188","5","145903"
"chr1","9420843","9421129","chr14","9275237","9275529","11","145606"
"chr1","9431508","9431704","chr14","9294217","9294421","17","137291"
"chr1","9433300","9433599","chr14","9296015","9296320","10","137285"
"chr1","9436586","9436884","chr14","9299305","9299601","10","137281"
"chr1","9446551","9446678","chr13","10389947","10390076","34","943396"
"chr1","9533614","9533906","chr14","9391252","9391542","11","142362"
"chr1","9687038","9687394","chr14","9545244","9545605","13","141794"
"chr1","9707148","9707431","chr14","9565289","9565593","31","141859"
"chr1","9728801","9729115","chr14","9589734","9590035","22","139067"
"chr1","9757410","9757558","chr4","85201726","85201872","31","75444316"
"chr1","9757584","9757702","chrX","108971246","108971363","11","99213662"
"chr1","9764713","9765007","chr14","9615453","9615747","8","149260"
"chr1","9772337","9772619","chr14","9623112","9623376","25","149225"
"chr1","9775619","9775931","chr14","9626373","9626705","31","149246"
"chr1","9780087","9780337","chr14","9631228","9631475","7","148859"
"chr1","9793708","9793996","chr14","9646354","9646643","12","147354"
"chr1","9806681","9806936","chr14","9662181","9662436","7","144500"
"chr1","9808385","9808695","chr1","93320510","93320814","58","83512125"
"chr1","9818845","9819048","chr14","9673207","9673410","8","145638"
"chr1","9819338","9819446","chr14","9673708","9673814","6","145630"
"chr1","9823640","9823930","chr14","9677892","9678183","14","145748"
"chr1","9826877","9827176","chr14","9681778","9682074","15","145099"
"chr1","9856169","9856452","chr14","9711537","9711811","17","144632"
"chr1","9895280","9895574","chr14","9749822","9750118","7","145458"
"chr1","9897509","9897798","chr14","9753107","9753397","5","144402"
"chr1","9935797","9936000","chr14","9791858","9792078","19","143939"
"chr1","9944334","9944583","chr1","80271049","80271304","57","70326715"
"chr1","9956578","9956790","chr1","17959051","17959266","47","8002473"
"chr1","9956991","9957091","chr2","3880884","3880982","24","6076107"
"chr1","9963479","9963629","chr4","31103892","31104045","40","21140413"
"chr1","10014180","10014472","chr14","9870855","9871147","5","143325"
"chr1","10017162","10017466","chr14","9873830","9874134","8","143332"
"chr1","10024314","10024448","chr6","143037757","143037891","16","133013443"
"chr1","10024800","10024967","chr14","9881080","9881251","10","143720"
"chr1","10037967","10038187","chr7","159803714","159803930","34","149765747"
"chr1","10039773","10039918","chr14","9896895","9897040","3","142878"
"chr1","10040539","10040706","chr14","9897613","9897797","34","142926"
"chr1","10053869","10054066","chr14","9912445","9912677","41","141424"
"chr1","10076068","10076349","chr14","9933800","9934082","7","142268"
"chr1","10081903","10082063","chrX","117872779","117872935","28","107790876"
"chr1","10082375","10082491","chr3","109855880","109855996","22","99773505"
"chr1","10091708","10092013","chr14","9949389","9949689","11","142319"
"chr1","10097312","10097443","chr14","9954965","9955096","5","142347"
"chr1","10098885","10099065","chr16","15778375","15778547","39","5679490"
"chr1","10099368","10099487","chr13","124948902","124949015","17","114849534"
"chr1","10128897","10129011","chr2","150020755","150020867","19","139891858"
"chr1","10129031","10129323","chr1","179093999","179094286","48","168964968"
"chr1","10188116","10188186","chr8","5999686","5999751","28","4188430"
"chr1","10228324","10228581","chr14","10087980","10088264","34","140344"
"chr1","10251803","10252027","chr14","10106660","10106884","5","145143"
"chr1","10274571","10274857","chr7","12853214","12853492","54","2578643"
"chr1","10276615","10276749","chr14","10138793","10138927","2","137822"
"chr1","10277063","10277221","chr14","10139230","10139388","2","137833"
"chr1","10280430","10280724","chr14","10142782","10143080","14","137648"
"chr1","10292383","10292560","chr1","11980907","11981080","36","1688524"
"chr1","10299409","10299708","chr14","10156469","10156767","10","142940"
"chr1","10309111","10309414","chr14","10166163","10166465","7","142948"
"chr1","10309684","10309994","chr14","10166738","10167051","11","142946"
"chr1","10317136","10317296","chr6","43023740","43023893","29","32706604"
"chr1","10317336","10317443","chr20","10873126","10873230","18","555790"
"chr1","10317623","10317759","chr9","93045644","93045781","33","82728021"
"chr1","10317768","10317996","chr16","48598989","48599215","51","38281221"
"chr1","10362699","10363003","chr14","10214112","10214414","13","148587"
"chr1","10363061","10363340","chr14","10214470","10214749","9","148591"
"chr1","10364312","10364620","chr14","10215720","10216028","5","148592"
"chr1","10370664","10370870","chr14","10222682","10222899","17","147982"
"chr1","10377749","10377876","chr3","40555344","40555474","27","30177595"
"chr1","10380804","10381092","chr14","10232525","10232813","10","148279"
"chr1","10382740","10382871","chr14","10234461","10234596","6","148279"
"chr1","10382951","10383236","chr14","10234652","10234952","31","148299"
"chr1","10390356","10390539","chr14","10243403","10243571","17","146953"
"chr1","10395541","10395678","chr14","10250746","10250881","7","144795"
"chr1","10441427","10441691","chr14","10295012","10295277","8","146415"
"chr1","10444151","10444418","chr3","160818351","160818618","60","150374200"
"chr1","10458258","10458560","chr14","10304796","10305106","47","153462"
"chr1","10458579","10458841","chr2","125673491","125673757","62","115214912"
"chr1","10466164","10466445","chr14","10315596","10315891","22","150568"
"chr1","10470641","10470774","chr6","32389707","32389840","26","21919066"
"chr1","10471077","10471255","chr1","21902520","21902695","35","11431443"
"chr1","10492538","10492803","chr14","10338558","10338821","4","153980"
"chr1","10504739","10505040","chr14","10350860","10351161","8","153879"
"chr1","10527586","10527888","chr14","10373733","10374036","5","153853"
"chr1","10537787","10538060","chr7","33675616","33675892","53","23137829"
"chr1","10540020","10540331","chr14","10385841","10386161","21","154179"
"chr1","10542154","10542444","chr14","10387983","10388276","10","154171"
"chr1","10546200","10546475","chr14","10391792","10392067","6","154408"
"chr1","10546827","10547117","chr14","10392415","10392705","4","154412"
"chr1","10547874","10547993","chr14","10393467","10393586","1","154407"
"chr1","10554377","10554681","chr14","10399555","10399861","9","154822"
"chr1","10574138","10574253","chr14","10421866","10421973","10","152272"
"chr1","10577480","10577749","chr14","10425447","10425716","9","152033"
"chr1","10597042","10597179","chr14","10445970","10446107","5","151072"
"chr1","10621819","10621988","chr14","10477052","10477220","3","144767"
"chr1","10640239","10640343","chr9","105401337","105401441","23","94761098"
"chr1","10640373","10640681","chr4","36625432","36625738","49","25985059"
"chr1","10651008","10651137","chr14","10498184","10498325","12","152824"
"chr1","10651462","10651637","chr14","10498630","10498805","4","152832"
"chr1","10675745","10675953","chr9","56809291","56809494","42","46133546"
"chr1","10685341","10685640","chr14","10532483","10532780","7","152858"
"chr1","10687157","10687456","chr14","10534730","10535029","6","152427"
"chr1","10689441","10689734","chr7","115474282","115474567","60","104784841"
"chr1","10698009","10698333","chr14","10546249","10546544","35","151760"
"chr1","10698648","10698816","chr3","17562232","17562395","36","6863584"
"chr1","10706077","10706344","chr14","54986321","54986578","62","44280244"
"chr1","10720570","10720637","chr6","106717550","106717603","21","95996980"
"chr1","10802124","10802427","chr14","10631804","10632119","21","170320"
"chr1","10916937","10917236","chr14","10743957","10744252","6","172980"
"chr1","10932745","10932864","chr8","95946480","95946600","21","85013735"
"chr1","10936601","10936731","chr14","114574017","114574143","20","103637416"
"chr1","10951463","10951530","chr2","25992584","25992648","11","15041121"
"chr1","10951551","10951705","chr5","135437185","135437333","25","124485634"
"chr1","10958431","10958726","chr2","97499012","97499310","49","86540581"
"chr1","10959355","10959653","chr14","10788633","10788928","6","170722"
"chr1","10975689","10976004","chr14","10804449","10804766","7","171240"
"chr1","11013162","11013298","chr14","10840468","10840606","3","172694"
"chr1","11013557","11013723","chr14","10840865","10841037","12","172692"
"chr1","11024042","11024333","chr14","10850868","10851159","3","173174"
"chr1","11026292","11026390","chr17","75610469","75610564","22","64584177"
"chr1","11026734","11026793","chr6","73322288","73322337","26","62295554"
"chr1","11027104","11027224","chr3","109504048","109504163","26","98476944"
"chr1","11033368","11033495","chr4","42979297","42979395","45","31945929"
"chr1","11034687","11034812","chr14","10853492","10853617","0","181195"
"chr1","11056015","11056279","chr14","10875946","10876212","5","180069"
"chr1","11065059","11065280","chr5","20552173","20552400","52","9487114"
"chr1","11082889","11083177","chr14","10896371","10896659","5","186518"
"chr1","11088903","11089198","chr14","10902529","10902829","7","186374"
"chr1","11089276","11089559","chr14","10902909","10903196","8","186367"
"chr1","11092539","11092622","chr11","51877592","51877667","24","40785053"
"chr1","11092874","11092885","chr1","24903687","24903697","10","13810813"
"chr1","11093174","11093289","chr11","31306749","31306868","25","20213575"
"chr1","11093317","11093632","chr14","10919928","10920247","14","173389"
"chr1","11101321","11101528","chr19","33091905","33092123","65","21990584"
"chr1","11104580","11104710","chr7","58992652","58992774","29","47888072"
"chr1","11109030","11109292","chr14","10935512","10935778","11","173518"
"chr1","11119683","11119870","chr1","66887413","66887590","41","55767730"
"chr1","11120055","11120249","chr14","10945305","10945500","3","174750"
"chr1","11121617","11121811","chr14","10945305","10945500","3","176312"
"chr1","11123029","11123200","chr14","10947311","10947479","13","175718"
"chr1","11123503","11123513","chr6","13692991","13693004","4","2569488"
"chr1","11123820","11123964","chr2","100024301","100024447","25","88900481"
"chr1","11164039","11164315","chr7","15905092","15905362","57","4741053"
"chr1","11169549","11169712","chr3","128928507","128928670","36","117758958"
"chr1","11175075","11175335","chr16","23095491","23095736","70","11920416"
"chr1","11207820","11208100","chr14","11034768","11035045","17","173052"
"chr1","11211705","11212003","chr14","11039710","11040008","8","171995"
"chr1","11221933","11222069","chr12","80614773","80614908","26","69392840"
"chr1","11227265","11227400","chr14","11053611","11053746","4","173654"
"chr1","11227712","11227887","chr14","11054059","11054242","12","173653"
"chr1","11236059","11236227","chr14","11064492","11064652","13","171567"
"chr1","11238786","11239002","chr14","11067543","11067767","24","171243"
"chr1","11248345","11248503","chr14","11077373","11077534","5","170972"
"chr1","11248508","11248833","chr11","51829366","51829695","59","40580858"
"chr1","11253697","11253943","chr14","11083924","11084171","9","169773"
"chr1","11281812","11281935","chr1","130580963","130581081","34","119299151"
"chr1","11282089","11282339","chr14","11116129","11116375","10","165960"
"chr1","11285254","11285557","chr1","144453383","144453695","63","133168129"
"chr1","11311781","11311929","chr11","48844804","48844952","47","37533023"
"chr1","11312227","11312367","chr1","157401177","157401311","20","146088950"
"chr1","11318279","11318444","chr14","11155083","11155246","2","163196"
"chr1","11318753","11318933","chr14","11155563","11155745","5","163190"
"chr1","11319219","11319342","chr14","11156033","11156156","0","163186"
"chr1","11336654","11336775","chr2","85452723","85452848","30","74116069"
"chr1","11339779","11340080","chr15","74219376","74219673","56","62879597"
"chr1","11348004","11348327","chr14","11182116","11182437","6","165888"
"chr1","11362784","11363060","chr14","11196825","11197101","2","165959"
"chr1","11395260","11395549","chr14","11232124","11232392","43","163136"
"chr1","11400543","11400704","chr14","11237407","11237567","5","163136"
"chr1","11401002","11401140","chr10","59994419","59994557","37","48593417"
"chr1","11401145","11401286","chr14","11237865","11238010","6","163280"
"chr1","11402740","11403054","chr14","11240791","11241105","8","161949"
"chr1","11412094","11412226","JH682236","85743","85875","21","11326351"
"chr1","11420057","11420349","chr14","11260625","11260920","6","159432"
"chr1","11425739","11425910","chr16","41038786","41038956","44","29613047"
"chr1","11450253","11450560","chr8","76388281","76388586","52","64938028"
"chr1","11462188","11462472","chr1","110265403","110265689","48","98803215"
"chr1","11480969","11481134","chr14","11322833","11322994","9","158136"
"chr1","11481448","11481461","chr14","11323306","11323319","0","158142"
"chr1","11485200","11485371","chr1","111429353","111429516","32","99944153"
"chr1","11487413","11487701","chr14","11329191","11329482","46","158222"
"chr1","11490798","11491094","chr14","11332298","11332601","16","158500"
"chr1","11491157","11491319","chr10","62555167","62555321","56","51064010"
"chr1","11503940","11504054","chr14","11344995","11345109","3","158945"
"chr1","11509996","11510284","chr14","11354823","11355111","7","155173"
"chr1","11526596","11526891","chr14","11373855","11374148","12","152741"
"chr1","11548576","11548886","chr10","50303474","50303781","56","38754898"
"chr1","11564052","11564359","chr14","11414456","11414757","23","149596"
"chr1","11577630","11577922","chr15","27220725","27221028","67","15643095"
"chr1","11596685","11596910","chr6","151329651","151329875","49","139732966"
"chr1","11597575","11597664","chr6","78398645","78398731","18","66801070"
"chr1","11678830","11679001","chr14","11559606","11559770","10","119224"
"chr1","11737397","11737496","chr14","11617099","11617197","2","120298"
"chr1","11738688","11739002","chr14","11618264","11618583","42","120424"
"chr1","11739041","11739308","chr14","11618264","11618583","61","120777"
"chr1","11751271","11751589","chr14","11631072","11631390","11","120199"
"chr1","11777659","11777955","chr14","11662414","11662736","47","115245"
"chr1","11783964","11784252","chr14","11666640","11666928","7","117324"
"chr1","11800418","11800572","chr14","11684315","11684470","4","116103"
"chr1","11821381","11821502","chr14","11706041","11706169","11","115340"
"chr1","11851047","11851139","chr14","11737610","11737702","0","113437"
"chr1","11853619","11853899","chr14","11739888","11740168","13","113731"
"chr1","11858812","11859089","chr14","11745086","11745363","4","113726"
"chr1","11871556","11871811","chr14","11758420","11758684","19","113136"
"chr1","11907865","11908148","chr14","11795024","11795309","11","112841"
"chr1","11909377","11909672","chr14","11796550","11796849","8","112827"
"chr1","11919436","11919725","chr14","11806422","11806719","20","113014"
"chr1","11940177","11940313","chr14","11826122","11826258","3","114055"
"chr1","11940622","11940775","chr3","78085606","78085755","29","66144984"
"chr1","11991857","11992092","chr3","36736557","36736796","44","24744700"
"chr1","12009608","12009912","chr14","11896019","11896327","8","113589"
"chr1","12025712","12026022","chr14","11912149","11912459","14","113563"
"chr1","12031589","12031878","chr14","11918355","11918644","8","113234"
"chr1","12053857","12054033","chr14","11940304","11940459","25","113553"
"chr1","12054923","12055058","chr18","59438140","59438272","33","47383217"
"chr1","12087426","12087716","chr14","11973802","11974099","12","113624"
"chr1","12204927","12205201","chr14","12094680","12094951","9","110247"
"chr1","12359051","12359350","chr14","12251279","12251578","12","107772"
"chr1","12361143","12361435","chr14","12253363","12253655","2","107780"
"chr1","12383313","12383619","chr14","12276154","12276459","5","107159"
"chr1","12386228","12386486","chr14","12283700","12283957","9","102528"
"chr1","12388774","12388981","chr14","12286781","12286986","3","101993"
"chr1","12389841","12389997","chr20","17880331","17880497","41","5490490"
"chr1","12408859","12409163","chr14","12310221","12310520","15","98638"
"chr1","12415468","12415712","chr14","12316804","12317048","7","98664"
"chr1","12424444","12424723","chr7","132337936","132338220","59","119913492"
"chr1","12424965","12425258","chr14","12326685","12326976","6","98280"
"chr1","12441275","12441576","chr14","12342835","12343173","44","98440"
"chr1","12447802","12447938","chr14","12351356","12351490","11","96446"
"chr1","12448246","12448413","chr14","12351810","12351975","5","96436"
"chr1","12458735","12458979","chr14","12362730","12362975","1","96005"
"chr1","12482133","12482355","chr17","90056068","90056294","46","77573935"
"chr1","12494467","12494720","chr14","12399446","12399698","17","95021"
"chr1","12504475","12504777","chr14","12409527","12409824","8","94948"
"chr1","12518219","12518508","chr14","12423291","12423577","9","94928"
"chr1","12524386","12524534","chr13","63787243","63787367","49","51262857"
"chr1","12540981","12541288","chr14","12447201","12447514","13","93780"
"chr1","12549869","12550158","chr14","12456153","12456448","10","93716"
"chr1","12561790","12562068","chr14","12468335","12468609","10","93455"
"chr1","12581632","12581983","chr14","12488621","12488977","9","93011"
"chr1","12588098","12588409","chr14","12494310","12494614","16","93788"
"chr1","12630319","12630603","chr14","12522018","12522316","33","108301"
"chr1","12656184","12656493","chr14","12522018","12522316","27","134166"
"chr1","12660442","12660712","chr14","12526268","12526538","4","134174"
"chr1","12663445","12663744","chr14","12529734","12530033","10","133711"
"chr1","12666684","12666993","chr20","27160084","27160391","51","14493400"
"chr1","12670609","12670929","chr14","12537290","12537609","7","133319"
"chr1","12672108","12672421","chr14","12553038","12553339","21","119070"
"chr1","12705044","12705339","chr14","12586666","12586961","6","118378"
"chr1","12710556","12710726","chr10","455265","455435","32","12255291"
"chr1","12733732","12734037","chr13","24973244","24973543","64","12239512"
"chr1","12792548","12792863","chr14","12669132","12669449","14","123416"
"chr1","12795296","12795595","chr14","12671720","12672027","20","123576"
"chr1","12815336","12815529","chr14","12690463","12690654","8","124873"
"chr1","12815758","12815869","chr14","12690890","12691001","2","124868"
"chr1","12832028","12832323","chr14","12706940","12707234","11","125088"
"chr1","12872579","12872870","chr14","12747152","12747443","4","125427"
"chr1","12879396","12879587","chr14","12752968","12753161","9","126428"
"chr1","12889054","12889191","chr14","12763163","12763300","5","125891"
"chr1","12889494","12889610","chr14","12763599","12763714","4","125895"
"chr1","12901620","12901895","chr14","12775284","12775579","38","126336"
"chr1","12914514","12914833","chr14","12788324","12788637","11","126190"
"chr1","13005985","13006289","chr9","32668102","32668409","57","19662117"
"chr1","13118598","13118906","chr14","12984257","12984565","45","134341"
"chr1","13118907","13119042","chr9","102149913","102150048","17","89031006"
"chr1","13153022","13153089","chr3","51058258","51058321","19","37905236"
"chr1","13283458","13283804","chr14","13149984","13150305","28","133474"
"chr1","13397142","13397445","chr14","13272658","13272957","21","124484"
"chr1","13489765","13489962","chr14","13367095","13367301","19","122670"
"chr1","13515777","13516034","chr14","13391491","13391748","9","124286"
"chr1","13518551","13518810","chr14","13393620","13393869","17","124931"
"chr1","13518969","13519046","chr17","27699103","27699183","15","14180134"
"chr1","13586279","13586586","chr14","13460820","13461127","16","125459"
"chr1","13633841","13634074","chr6","61679011","61679231","57","48045170"
"chr1","13707151","13707436","chr14","13575721","13576006","5","131430"
"chr1","13755498","13755791","chr14","13624335","13624628","8","131163"
"chr1","13826665","13826783","chr14","13697450","13697568","4","129215"
"chr1","13846647","13846786","chr14","13718576","13718716","4","128071"
"chr1","13855706","13855883","chr1","159993342","159993520","40","146137636"
"chr1","13872727","13873026","chr14","13746555","13746850","13","126172"
"chr1","13878018","13878117","chr14","13751820","13751915","6","126198"
"chr1","13898484","13898758","chr3","7156646","7156914","58","6741838"
"chr1","13918270","13918389","chr20","929087","929213","26","12989183"
"chr1","13918400","13918478","chr13","19314587","19314665","20","5396187"
"chr1","13918481","13918755","chr14","13791548","13791842","31","126933"
"chr1","13941222","13941529","chr1","14612826","14613129","54","671604"
"chr1","13952088","13952263","chr14","13821566","13821734","12","130522"
"chr1","13953059","13953108","chr4","17945798","17945842","15","3992739"
"chr1","13953187","13953317","chr16","22932775","22932908","22","8979588"
"chr1","13963567","13963867","chr14","13832673","13832973","7","130894"
"chr1","13978508","13978807","chr14","13847527","13847818","10","130981"
"chr1","13979268","13979565","chr5","114300969","114301247","82","100321701"
"chr1","13990136","13990428","chr14","13858613","13858905","9","131523"
"chr1","13990435","13990720","chr14","13858912","13859196","7","131523"
"chr1","14000462","14000733","chr14","13869029","13869296","9","131433"
"chr1","14001784","14002061","chr14","13870114","13870391","6","131670"
"chr1","14007202","14007419","chr14","13875612","13875824","8","131590"
"chr1","14021891","14022015","JH682236","182271","182384","33","13839620"
"chr1","14022027","14022316","chr14","13891082","13891375","9","130945"
"chr1","14022931","14023188","chr14","13891989","13892246","5","130942"
"chr1","14027760","14027861","chr14","13896728","13896829","2","131032"
"chr1","14028150","14028327","chr14","13897118","13897296","6","131032"
"chr1","14031509","14031820","chr14","13899212","13899519","8","132297"
"chr1","14056768","14056874","chr14","13922934","13923040","3","133834"
"chr1","14064312","14064605","chr14","13930052","13930344","34","134260"
"chr1","14085677","14085974","chr14","13951613","13951911","6","134064"
"chr1","14086552","14086667","chr14","13954216","13954341","12","132336"
"chr1","14091782","14091927","chr14","13953739","13953900","18","138043"
"chr1","14091931","14092125","chr7","49055521","49055705","70","34963590"
"chr1","14092416","14092541","chr14","13954216","13954341","3","138200"
"chr1","14093857","14094158","chr14","13958448","13958764","21","135409"
"chr1","14112737","14113043","chr14","13975842","13976147","9","136895"
"chr1","14124055","14124348","chr14","13985890","13986184","4","138165"
"chr1","14140098","14140414","chr14","14001041","14001337","31","139057"
"chr1","14168139","14168303","chr14","14028124","14028292","12","140015"
"chr1","14243883","14244181","chr14","14109541","14109837","11","134342"
"chr1","14301193","14301501","chr14","14166367","14166679","17","134826"
"chr1","14302976","14303095","chr14","14168201","14168324","9","134775"
"chr1","14305859","14306001","chr14","14171092","14171233","3","134767"
"chr1","14379691","14379863","chr14","14251678","14251853","7","128013"
"chr1","14394719","14394970","chr14","14267552","14267812","15","127167"
"chr1","14454515","14454689","chr14","14350006","14350180","3","104509"
"chr1","14498250","14498477","chr14","14399832","14400058","4","98418"
"chr1","14551176","14551422","chr14","14453077","14453310","21","98099"
"chr1","14581194","14581417","chr14","14399832","14400058","30","181362"
"chr1","14617323","14617602","chr3","129072108","129072384","54","114454785"
"chr1","14625197","14625420","chr14","14510134","14510357","6","115063"
"chr1","14784083","14784381","chr2","183065986","183066284","74","168281903"
"chr1","14799387","14799533","chr14","8696609","8696738","46","6102778"
"chr1","14865399","14865703","chr14","14743091","14743395","5","122308"
"chr1","14875853","14875894","chr17","87926105","87926148","9","73050252"
"chr1","14877839","14878127","chr14","14755871","14756159","5","121968"
"chr1","14878266","14878553","chr14","14755871","14756159","6","122395"
"chr1","14879238","14879372","chr14","14756844","14756978","3","122394"
"chr1","14917349","14917661","chr14","14799026","14799340","30","118323"
"chr1","14982494","14982794","chr14","14864487","14864770","24","118007"
"chr1","15112442","15112573","chr14","14989700","14989831","1","122742"
"chr1","15230226","15230417","chr14","15099288","15099485","20","130938"
"chr1","15267442","15267502","chr14","15132912","15132978","7","134530"
"chr1","15329758","15330067","chr14","15191051","15191322","46","138707"
"chr1","15336066","15336366","chr14","15195482","15195792","22","140584"
"chr1","15343875","15344185","chr14","15202496","15202815","15","141379"
"chr1","15374057","15374174","chr14","15233432","15233549","1","140625"
"chr1","15384616","15384902","chr14","15247916","15248202","6","136700"
"chr1","15385677","15385880","chr9","114486043","114486237","42","99100366"
"chr1","15386548","15386603","chr11","110640487","110640539","14","95253939"
"chr1","15390317","15390623","chr14","15253151","15253463","16","137166"
"chr1","15390655","15390723","chr3","165938747","165938813","21","150548092"
"chr1","15391249","15391452","chr14","15253989","15254200","9","137260"
"chr1","15393261","15393556","chr14","15256008","15256303","10","137253"
"chr1","15395025","15395311","chrX","141487608","141487901","74","126092583"
"chr1","15416841","15417143","chr14","15281470","15281779","12","135371"
"chr1","15444338","15444627","chr14","15308840","15309117","14","135498"
"chr1","15455060","15455329","chr14","15319982","15320245","12","135078"
"chr1","15456305","15456592","chr1","53885823","53886111","52","38429518"
"chr1","15462068","15462343","chr14","15326866","15327138","8","135202"
"chr1","15470288","15470459","chr14","15335040","15335211","3","135248"
"chr1","15470843","15471017","chr19","40660796","40660964","29","25189953"
"chr1","15477002","15477125","chr5","103772096","103772223","35","88295094"
"chr1","15482463","15482705","chr14","15343260","15343507","12","139203"
"chr1","15507477","15507748","chr14","15366156","15366428","10","141321"
"chr1","15509976","15510282","chr14","15368654","15368961","11","141322"
"chr1","15517125","15517415","chr4","69077877","69078163","48","53560752"
"chr1","15518145","15518429","chr14","15376816","15377100","7","141329"
"chr1","15543509","15543812","chr14","15402236","15402537","13","141273"
"chr1","15549492","15549784","chr5","33840057","33840343","59","18290565"
"chr1","15563451","15563733","chr14","15422464","15422746","2","140987"
"chr1","15571800","15571934","chr14","15430427","15430561","1","141373"
"chr1","15573881","15573994","chr14","15432518","15432630","5","141363"
"chr1","15607167","15607487","chr14","15465833","15466145","19","141334"
"chr1","15607916","15608227","chr14","15466652","15466936","28","141264"
"chr1","15614067","15614173","chr14","15472165","15472273","5","141902"
"chr1","15614485","15614684","chr14","15472588","15472785","6","141897"
"chr1","15643867","15644164","chr14","15504702","15505000","9","139165"
"chr1","15644482","15644762","chr14","15505308","15505584","8","139174"
"chr1","15656401","15656571","chr14","15515122","15515280","15","141279"
"chr1","15656886","15656912","chr4","102608663","102608686","4","86951777"
"chr1","15658905","15659212","chr14","15517601","15517902","14","141304"
"chr1","15690816","15691118","chr14","15548395","15548686","24","142421"
"chr1","15714686","15714845","chr9","31830662","31830825","30","16115976"
"chr1","15714932","15715198","chr14","15570627","15570917","33","144305"
"chr1","15715898","15716195","chr14","15571416","15571713","10","144482"
"chr1","15724384","15724510","chr14","15580579","15580730","28","143805"
"chr1","15724819","15724964","chr14","15581039","15581185","5","143780"
"chr1","15725454","15725639","chr8","78777591","78777773","34","63052137"
"chr1","15725640","15725705","chr8","135489871","135489938","16","119764231"
"chr1","15725716","15725840","chr9","57895123","57895243","29","42169407"
"chr1","15725850","15726146","chr9","84129138","84129432","57","68403288"
"chr1","15729951","15730276","chr14","15584305","15584627","10","145646"
"chr1","15730810","15731036","chr7","149278852","149279073","47","133548042"
"chr1","15738757","15738819","chr14","63550794","63550854","16","47812037"
"chr1","15763103","15763409","chr14","15614387","15614693","5","148716"
"chr1","15763531","15763633","chr18","44683821","44683920","18","28920290"
"chr1","15779976","15780270","chr14","15630573","15630868","10","149403"
"chr1","15790522","15790641","chr19","40190589","40190699","23","24400067"
"chr1","15790703","15791029","chr14","15641224","15641550","6","149479"
"chr1","15794045","15794351","chr4","152226280","152226592","52","136432235"
"chr1","15801514","15801812","chr14","15649016","15649318","17","152498"
"chr1","15826903","15827204","chr14","15673481","15673780","17","153422"
"chr1","15834716","15834894","chr14","15680809","15681014","32","153907"
"chr1","15834937","15835054","chr14","15681044","15681159","7","153893"
"chr1","15836381","15836529","chr14","15683668","15683791","28","152713"
"chr1","15909599","15909915","chr5","148174721","148175030","61","132265122"
"chr1","15983826","15984114","chr3","42704741","42705036","55","26720915"
"chr1","16040500","16040813","chr14","15879425","15879736","7","161075"
"chr1","16313972","16314197","chr14","16151826","16152046","8","162146"
"chr1","16317261","16317315","chr14","16155050","16155100","5","162211"
"chr1","16382040","16382338","chr14","16218752","16219032","30","163288"
"chr1","16393440","16393756","chr14","16230458","16230766","23","162982"
"chr1","16434659","16434963","chr18","6987529","6987832","66","9447130"
"chr1","16458735","16459036","chr14","16269958","16270259","11","188777"
"chr1","16628492","16628731","JH682611","1572","1808","8","16626920"
"chr1","16722873","16723171","chr14","16591731","16592026","8","131142"
"chr1","16869850","16869985","chr14","16732546","16732681","3","137304"
"chr1","16876187","16876469","chr14","16738461","16738761","22","137726"
"chr1","16876470","16876645","chr7","16958421","16958590","36","81951"
"chr1","16892846","16893134","chr14","16753546","16753848","24","139300"
"chr1","16969128","16969266","chr11","117160418","117160555","33","100191290"
"chr1","16998155","16998441","chr11","113206738","113207028","62","96208583"
"chr1","17090126","17090429","chr14","16949658","16949954","14","140468"
"chr1","17126851","17126982","chr11","1808170","1808304","24","15318681"
"chr1","17130031","17130189","chr19","16956752","16956910","33","173279"
"chr1","17145603","17145899","chr14","17012366","17012667","20","133237"
"chr1","17147007","17147195","chrX","92618497","92618682","46","75471490"
"chr1","17147737","17148033","chr14","17014505","17014802","11","133232"
"chr1","17230206","17230409","chr14","17098025","17098238","15","132181"
"chr1","17241459","17241755","chr14","17109087","17109375","16","132372"
"chr1","17248462","17248772","chr14","17116112","17116420","12","132350"
"chr1","17257790","17258100","chr7","42683169","42683480","66","25425379"
"chr1","17259716","17260015","chr14","17125793","17126093","8","133923"
"chr1","17264274","17264492","chr1","76932143","76932373","49","59667869"
"chr1","17267063","17267168","chr9","42532907","42533005","18","25265844"
"chr1","17320484","17320783","chr14","17183627","17183926","2","136857"
"chr1","17321884","17322170","chr14","17185044","17185335","14","136840"
"chr1","17330160","17330443","chr14","17193113","17193383","16","137047"
"chr1","17332913","17333192","chr14","17200039","17200331","51","132874"
"chr1","17335019","17335304","chr14","17195737","17196025","14","139282"
"chr1","17339031","17339347","chr14","17202034","17202350","8","136997"
"chr1","17341874","17342182","chr14","17204781","17205083","13","137093"
"chr1","17347478","17347620","chr3","137292178","137292315","32","119944700"
"chr1","17347861","17348152","chr14","17209701","17209991","6","138160"
"chr1","17351525","17351826","chr14","17213379","17213676","13","138146"
"chr1","17355022","17355129","chr14","17216875","17216980","8","138147"
"chr1","17358061","17358366","chr3","51622492","51622797","50","34264431"
"chr1","17360182","17360339","chr14","17219416","17219573","8","140766"
"chr1","17365257","17365541","chr3","39339607","39339886","55","21974350"
"chr1","17367495","17367760","chr9","20738605","20738871","43","3371110"
"chr1","17369208","17369441","chr14","17230674","17230907","2","138534"
"chr1","17378876","17379053","chr3","173726907","173727084","36","156348031"
"chr1","17379126","17379255","chr6","34367259","34367385","28","16988133"
"chr1","17386002","17386070","chr19","30720282","30720351","12","13334280"
"chr1","17386083","17386294","chr19","10924290","10924498","62","6461793"
"chr1","17388933","17389036","JH679796","3334","3438","19","17385599"
"chr1","17389048","17389272","chr1","218225762","218225979","55","200836714"
"chr1","17389592","17389604","chr13","107299184","107299196","0","89909592"
"chr1","17389907","17390058","chr3","2903291","2903443","34","14486616"
"chr1","17398271","17398526","chr19","42678264","42678523","55","25279993"
"chr1","17400556","17400695","chr1","11405759","11405892","24","5994797"
"chr1","17403405","17403693","chr14","17261583","17261878","15","141822"
"chr1","17403879","17404190","chr5","148262644","148262948","63","130858765"
"chr1","17413102","17413177","chr14","17269450","17269525","0","143652"
"chr1","17413187","17413431","chr14","17269535","17269776","5","143652"
"chr1","17420815","17421109","chr2","89845828","89846122","57","72425013"
"chr1","17426904","17427028","chr7","52810378","52810499","26","35383474"
"chr1","17442723","17442792","chr14","17296118","17296190","12","146605"
"chr1","17446315","17446641","chr14","17299589","17299870","51","146726"
"chr1","17448913","17449125","chr9","92676673","92676881","48","75227760"
"chr1","17449554","17449857","chr12","99689911","99690212","47","82240357"
"chr1","17460674","17460834","chr7","41139135","41139285","40","23678461"
"chr1","17471946","17472262","chr6","52951839","52952147","63","35479893"
"chr1","17476750","17477010","chr14","17326986","17327247","10","149764"
"chr1","17483597","17483821","chr14","17334906","17335130","4","148691"
"chr1","17495297","17495572","chr14","17343715","17343990","6","151582"
"chr1","17496083","17496367","chr14","17344497","17344782","5","151586"
"chr1","17501507","17501803","chr14","17351969","17352257","17","149538"
"chr1","17504724","17504903","chr10","62966219","62966397","35","45461495"
"chr1","17505205","17505338","chr3","45465613","45465747","25","27960408"
"chr1","17508397","17508680","chr14","17358408","17358700","10","149989"
"chr1","17516738","17516793","chr14","17368443","17368498","2","148295"
"chr1","17518152","17518445","chr14","17365828","17366120","13","152324"
"chr1","17541258","17541515","chr14","17392224","17392481","8","149034"
"chr1","17544293","17544482","chr14","17395580","17395767","7","148713"
"chr1","17546048","17546332","chr14","17397646","17397930","3","148402"
"chr1","17551355","17551596","chr1","52912374","52912609","55","35361019"
"chr1","17555084","17555164","chr14","17402873","17402953","1","152211"
"chr1","17560501","17560788","chr14","17408495","17408782","9","152006"
"chr1","17562756","17563072","chr14","17410898","17411202","22","151858"
"chr1","17569163","17569443","chrX","45459917","45460198","60","27890754"
"chr1","17579370","17579468","chr8","89386985","89387082","22","71807615"
"chr1","17581056","17581344","chr14","17430482","17430760","15","150574"
"chr1","17590569","17590856","chr14","17439367","17439644","13","151202"
"chr1","17595589","17595874","chr14","17444389","17444681","10","151200"
"chr1","17607214","17607390","chr10","7542626","7542804","51","10064588"
"chr1","17620488","17620743","chr14","17470741","17470996","6","149747"
"chr1","17622030","17622063","chr14","17472289","17472325","3","149741"
"chr1","17622098","17622380","chr14","17472360","17472642","10","149738"
"chr1","17623489","17623782","chr14","17473439","17473733","6","150050"
"chr1","17630137","17630339","chr14","17479876","17480054","26","150261"
"chr1","17635700","17636008","chr14","17487211","17487501","26","148489"
"chr1","17636768","17637037","chr14","17488260","17488530","6","148508"
"chr1","17638945","17639124","chr14","54654409","54654588","34","37015464"
"chr1","17639847","17640126","chr14","17491338","17491628","17","148509"
"chr1","17642495","17642787","chr14","17494734","17495029","5","147761"
"chr1","17644028","17644325","chr14","17496593","17496882","13","147435"
"chr1","17644527","17644754","chr14","17497082","17497309","4","147445"
"chr1","17652512","17652646","chr7","106653973","106654108","21","89001461"
"chr1","17653554","17653720","chr14","17506306","17506474","5","147248"
"chr1","17659528","17659772","chr1","219737305","219737551","53","202077777"
"chr1","17669442","17669598","chr14","17522053","17522209","10","147389"
"chr1","17669906","17670041","chr14","17522514","17522648","3","147392"
"chr1","17672058","17672331","chr14","17524989","17525268","12","147069"
"chr1","17673925","17674224","chrX","123149101","123149407","54","105475176"
"chr1","17684989","17685220","chr8","36392608","36392843","48","18707619"
"chr1","17685531","17685609","chr5","79930418","79930496","14","62244887"
"chr1","17697784","17698078","chr14","17551945","17552238","7","145839"
"chr1","17699441","17699623","chr14","17553606","17553785","6","145835"
"chr1","17699920","17700053","chr14","17554082","17554216","4","145838"
"chr1","17714932","17715251","chr14","17568767","17569089","11","146165"
"chr1","17716153","17716231","chr14","17570003","17570068","14","146150"
"chr1","17722187","17722496","chr3","3692905","3693188","77","14029282"
"chr1","17722775","17722998","chr15","6130205","6130419","49","11592570"
"chr1","17733841","17734122","chr14","17586915","17587195","6","146926"
"chr1","17736248","17736522","chr14","17589626","17589904","8","146622"
"chr1","17736578","17736853","chr14","17589960","17590235","7","146618"
"chr1","17749550","17749855","chr14","17602659","17602963","6","146891"
"chr1","17788963","17789103","chr14","17644234","17644374","1","144729"
"chr1","17790902","17791202","chr14","17662819","17663119","7","128083"
"chr1","17791315","17791612","chr2","97022915","97023209","52","79231600"
"chr1","17793118","17793322","chr14","17645889","17646085","13","147229"
"chr1","17794931","17795051","chr14","17647705","17647825","0","147226"
"chr1","17799644","17799911","chr18","1368064","1368332","48","16431580"
"chr1","17813449","17813752","chr14","17671390","17671692","7","142059"
"chr1","17826363","17826656","chr14","17683967","17684259","9","142396"
"chr1","17833994","17834292","chr14","17691617","17691912","12","142377"
"chr1","17835069","17835336","chr14","17692699","17692922","48","142370"
"chr1","17845695","17845968","chr14","17703686","17703954","20","142009"
"chr1","17854651","17854942","chr14","17712249","17712543","6","142402"
"chr1","17860652","17860931","chr14","17718924","17719232","37","141728"
"chr1","17864599","17864888","chr14","17724671","17724960","12","139928"
"chr1","17865489","17865792","chr14","10166163","10166465","57","7699326"
"chr1","17867188","17867280","chr14","17727564","17727656","3","139624"
"chr1","17867281","17867487","chr14","17727657","17727863","3","139624"
"chr1","17885677","17885976","chr14","17758845","17759152","15","126832"
"chr1","17891092","17891224","chr14","17749569","17749700","4","141523"
"chr1","17891533","17891712","chr14","17750007","17750194","13","141526"
"chr1","17908851","17909148","chr7","49571405","49571710","59","31662554"
"chr1","17915054","17915252","chr13","59740128","59740328","59","41825074"
"chr1","17927838","17928130","chr14","17793102","17793400","20","134736"
"chr1","17928803","17928923","chr1","25467746","25467863","25","7538943"
"chr1","17932225","17932510","chr14","17798120","17798405","7","134105"
"chr1","17944686","17944948","chr14","17810097","17810379","26","134589"
"chr1","17962593","17962903","chr14","17828199","17828509","12","134394"
"chr1","17994011","17994155","chr14","17859854","17860007","12","134157"
"chr1","18000596","18000896","chr14","17863239","17863539","6","137357"
"chr1","18013297","18013589","chr14","17883296","17883562","29","130001"
"chr1","18015058","18015361","chr14","17885035","17885347","18","130023"
"chr1","18043210","18043509","chr14","17914020","17914318","8","129190"
"chr1","18044233","18044381","chr14","17915045","17915197","6","129188"
"chr1","18047303","18047621","chr14","17918455","17918768","11","128848"
"chr1","18057321","18057611","chr5","20485581","20485861","55","2428260"
"chr1","18059543","18059866","chr1","48423021","48423344","70","30363478"
"chr1","18074668","18074807","chr7","65157340","65157477","21","47082672"
"chr1","18075298","18075418","chr14","17945616","17945736","2","129682"
"chr1","18079220","18079371","chr1","94558530","94558684","33","76479310"
"chr1","18108969","18109266","chr14","17977572","17977869","5","131397"
"chr1","18131576","18131901","chr14","18001249","18001559","18","130327"
"chr1","18142073","18142369","chr14","18011727","18012023","10","130346"
"chr1","18153040","18153328","chr14","18022716","18023004","13","130324"
"chr1","18154750","18155045","chr14","18024220","18024515","6","130530"
"chr1","18172899","18173197","chr14","18043213","18043510","7","129686"
"chr1","18188520","18188818","chr14","18058764","18059070","15","129756"
"chr1","18211650","18211932","chr7","123143333","123143620","64","104931683"
"chr1","18212184","18212488","chr14","18083728","18084031","6","128456"
"chr1","18232504","18232815","chr14","18108043","18108351","4","124461"
"chr1","18254581","18254843","chr14","18129780","18130033","13","124801"
"chr1","18256749","18257053","chr14","18131936","18132239","5","124813"
"chr1","18260250","18260543","chr14","18135463","18135756","8","124787"
"chr1","18261530","18261837","chr14","18136723","18137025","9","124807"
"chr1","18265988","18266281","chr14","18141363","18141656","2","124625"
"chr1","18266350","18266661","chr13","97235484","97235795","46","78969134"
"chr1","18271935","18272118","chrX","62813073","62813257","45","44541138"
"chr1","18284222","18284533","chr14","18157849","18158159","7","126373"
"chr1","18302408","18302589","chr14","18175642","18175821","3","126766"
"chr1","18304494","18304788","chr14","18177741","18178035","4","126753"
"chr1","18310198","18310330","chr10","81845624","81845752","32","63535426"
"chr1","18311971","18312266","chr14","18185842","18186138","7","126129"
"chr1","18314389","18314680","chr5","45581442","45581728","47","27267053"
"chr1","18314708","18314735","chr13","100343973","100343999","4","82029265"
"chr1","18334665","18334791","chr3","44068058","44068185","29","25733393"
"chr1","18338658","18338945","chr14","18211787","18212071","9","126871"
"chr1","18341946","18342242","chr14","18215062","18215357","12","126884"
"chr1","18351213","18351423","chr14","18222324","18222534","1","128889"
"chr1","18360653","18360946","chr14","18233226","18233507","17","127427"
"chr1","18368145","18368436","chr2","167664248","167664541","64","149296103"
"chr1","18372247","18372554","chr14","18244817","18245126","11","127430"
"chr1","18379421","18379544","chr14","18252324","18252475","32","127097"
"chr1","18379584","18379600","chr6","50494769","50494782","4","32115185"
"chr1","18381201","18381448","chr14","18254896","18255145","6","126305"
"chr1","18387146","18387475","chr14","18260801","18261115","26","126345"
"chr1","18395482","18395786","chr14","18270011","18270313","12","125471"
"chr1","18406738","18407049","chr14","18281576","18281889","6","125162"
"chr1","18419054","18419360","chr14","18294064","18294372","12","124990"
"chr1","18419372","18419670","chr5","142071051","142071354","54","123651679"
"chr1","18432555","18432850","chr14","18307707","18308001","4","124848"
"chr1","18443327","18443633","chr14","18318776","18319083","4","124551"
"chr1","18454779","18455068","chr20","29012407","29012696","3","10557628"
"chr1","18458809","18459086","chr20","29016440","29016717","6","10557631"
"chr1","18481908","18482093","chr14","18335175","18335357","8","146733"
"chr1","18487143","18487424","chr14","18340041","18340323","8","147102"
"chr1","18491814","18492126","chr14","18345010","18345325","12","146804"
"chr1","18493998","18494133","chr7","106653973","106654108","19","88159975"
"chr1","18494438","18494598","chr6","148135774","148135932","33","129641336"
"chr1","18494633","18494919","chr14","18347521","18347807","3","147112"
"chr1","18502279","18502527","chrX","44838785","44839000","64","26336506"
"chr1","18503843","18504052","chr14","18356813","18357022","4","147030"
"chr1","18510679","18510801","chr14","18363456","18363587","10","147223"
"chr1","18514223","18514346","chr11","108063934","108064062","32","89549711"
"chr1","18514384","18514708","chr14","18366407","18366733","10","147977"
"chr1","18516693","18516960","chr14","18368716","18368983","7","147977"
"chr1","18524017","18524264","chr14","18376076","18376313","12","147941"
"chr1","18524306","18524608","chr14","18376355","18376657","3","147951"
"chr1","18527556","18527854","chr14","18379622","18379921","9","147934"
"chr1","18528309","18528355","chr14","18380376","18380422","3","147933"
"chr1","18528408","18528556","chr14","18380473","18380621","3","147935"
"chr1","18533610","18533728","chr14","18385224","18385342","2","148386"
"chr1","18533729","18533886","chr14","18385343","18385501","2","148386"
"chr1","18534159","18534464","chr14","18385774","18386083","8","148385"
"chr1","18537945","18538138","chr16","49484775","49484964","47","30946830"
"chr1","18558880","18559094","chr14","18410710","18410926","8","148170"
"chr1","18559215","18559491","chr14","18411047","18411324","16","148168"
"chr1","18559599","18559905","chr14","18411437","18411739","9","148162"
"chr1","18566418","18566728","chr14","18418532","18418842","9","147886"
"chr1","18569623","18569781","chr14","18421744","18421905","4","147879"
"chr1","18579771","18580045","chr14","18432412","18432686","4","147359"
"chr1","18585504","18585799","chr14","18438146","18438440","21","147358"
"chr1","18588924","18589175","chr14","18441148","18441391","17","147776"
"chr1","18590443","18590677","chr14","18442982","18443216","4","147461"
"chr1","18596224","18596453","chr14","18449185","18449415","8","147039"
"chr1","18600525","18600832","chr14","18453423","18453717","21","147102"
"chr1","18620698","18620930","chr14","18474596","18474828","5","146102"
"chr1","18642329","18642640","chr14","18501154","18501447","22","141175"
"chr1","18655537","18655846","chr14","18514446","18514756","16","141091"
"chr1","18660799","18661110","chr11","100727299","100727603","59","82066500"
"chr1","18664991","18665285","chr6","134251498","134251796","55","115586507"
"chr1","18665657","18665798","chr5","46320987","46321125","23","27655330"
"chr1","18665814","18666129","chr14","18524140","18524452","12","141674"
"chr1","18680567","18680837","chr14","18538819","18539089","10","141748"
"chr1","18686778","18686930","chr14","18545812","18545951","19","140966"
"chr1","18687601","18687890","chr14","18546657","18546940","12","140944"
"chr1","18693015","18693326","chr14","18544400","18544707","10","148615"
"chr1","18693987","18694334","chr20","622680","623014","64","18071307"
"chr1","18696539","18696812","chr16","7643344","7643629","64","11053195"
"chr1","18702657","18702962","chr14","18554386","18554676","22","148271"
"chr1","18705722","18706030","chr14","18557551","18557858","7","148171"
"chr1","18718203","18718495","chr14","18576064","18576370","19","142139"
"chr1","18719283","18719441","chr14","18577160","18577331","16","142123"
"chr1","18723917","18724168","chr14","18582601","18582862","17","141316"
"chr1","18732942","18733234","chr14","18588306","18588600","10","144636"
"chr1","18733888","18734146","chr14","18593258","18593547","46","140630"
"chr1","18744031","18744180","chr14","18604120","18604281","18","139911"
"chr1","18745156","18745431","chr13","73461011","73461290","59","54715855"
"chr1","18746289","18746578","chr14","18606208","18606503","9","140081"
"chr1","18755383","18755657","chr14","18615211","18615482","7","140172"
"chr1","18758356","18758659","chr14","18617724","18618027","7","140632"
"chr1","18758806","18759110","chr14","18618173","18618468","15","140633"
"chr1","18761281","18761575","chr14","18620269","18620554","13","141012"
"chr1","18773500","18773631","chrX","61671031","61671155","27","42897531"
"chr1","18791550","18791851","chr14","18649560","18649854","12","141990"
"chr1","18821560","18821691","chr14","10256467","10256598","22","8565093"
"chr1","18823487","18823647","chr4","31611641","31611789","35","12788154"
"chr1","18824722","18825010","chr14","18681499","18681789","11","143223"
"chr1","18841897","18842012","chr14","18698760","18698875","0","143137"
"chr1","18842305","18842449","chr14","18699165","18699309","0","143140"
"chr1","18850234","18850535","chr14","18707432","18707733","5","142802"
"chr1","18867638","18867920","chr14","18725799","18726084","4","141839"
"chr1","18873700","18874011","chr14","18731853","18732173","17","141847"
"chr1","18878293","18878599","chr14","18736341","18736647","2","141952"
"chr1","18881288","18881426","chr14","18739348","18739508","25","141940"
"chr1","18881738","18881857","chr14","18739795","18739916","7","141943"
"chr1","18886876","18887042","chr3","37739670","37739832","25","18852794"
"chr1","18916063","18916395","chr14","18773669","18773993","13","142394"
"chr1","18923062","18923365","chr14","18780822","18781125","5","142240"
"chr1","18924949","18925249","chr14","18782926","18783226","6","142023"
"chr1","18928376","18928666","chr14","18786352","18786644","9","142024"
"chr1","18941743","18941884","chr4","151693413","151693549","42","132751670"
"chr1","19004681","19004836","chr14","18863332","18863484","7","141349"
"chr1","19024484","19024797","chr14","18883384","18883692","10","141100"
"chr1","19026070","19026251","chr7","54412705","54412868","42","35386635"
"chr1","19027783","19027981","chr10","32028954","32029158","49","13001171"
"chr1","19068802","19068947","chr14","18925649","18925794","3","143153"
"chr1","19074646","19074929","chr14","18931367","18931654","14","143279"
"chr1","19076616","19076929","chr14","18933364","18933677","3","143252"
"chr1","19078103","19078407","chr14","18934843","18935141","9","143260"
"chr1","19089939","19090230","chr14","18946308","18946599","3","143631"
"chr1","19111116","19111414","chr14","18966768","18967060","11","144348"
"chr1","19114371","19114496","chr14","18970034","18970159","2","144337"
"chr1","19118061","19118363","chr14","18973354","18973656","6","144707"
"chr1","19135874","19136179","chr14","18988612","18988922","18","147262"
"chr1","19166548","19166861","chr14","19015479","19015788","9","151069"
"chr1","19172118","19172143","chr4","136812065","136812089","3","117639947"
"chr1","19172218","19172336","chr19","13813084","13813203","24","5359134"
"chr1","19172347","19172644","chr14","19021512","19021811","30","150835"
"chr1","19197586","19197879","chr14","19045792","19046082","6","151794"
"chr1","19215705","19215997","chr14","19063911","19064201","10","151794"
"chr1","19238332","19238424","chr14","19086857","19086945","4","151475"
"chr1","19238724","19238927","chr14","19087246","19087449","1","151478"
"chr1","19247591","19247886","chr14","19096187","19096478","8","151404"
"chr1","19252886","19253177","chr14","19101458","19101751","4","151428"
"chr1","19307387","19307669","chr14","19162025","19162307","5","145362"
"chr1","19318163","19318470","chr14","19172673","19172982","4","145490"
"chr1","19319732","19320008","chr14","19174124","19174400","9","145608"
"chr1","19350178","19350487","chr14","19204796","19205104","8","145382"
"chr1","19358705","19359013","chr14","19213290","19213603","8","145415"
"chr1","19364391","19364692","chr14","19218975","19219277","6","145416"
"chr1","19365822","19366119","chr14","19220407","19220704","2","145415"
"chr1","19382509","19382823","chr14","19236738","19237052","4","145771"
"chr1","19389471","19389667","chr14","19244146","19244339","7","145325"
"chr1","19398298","19398656","chr14","19253153","19253510","11","145145"
"chr1","19400455","19400663","chr9","56809291","56809494","36","37408836"
"chr1","19405735","19406039","chr14","19260437","19260742","5","145298"
"chr1","19420901","19421160","chr14","19275695","19275954","5","145206"
"chr1","19475880","19476191","chr14","19329465","19329776","8","146415"
"chr1","19495846","19496162","chr14","19348877","19349182","17","146969"
"chr1","19507130","19507402","chr14","19359783","19360056","6","147347"
"chr1","19514443","19514772","chr8","49478046","49478380","82","29963603"
"chr1","19552937","19553212","chr14","19404855","19405131","13","148082"
"chr1","19573884","19574015","chr6","133234948","133235082","18","113661064"
"chr1","19582135","19582391","chr14","19436377","19436653","30","145758"
"chr1","19587984","19588109","chr14","19442214","19442339","2","145770"
"chr1","19588389","19588573","chr14","19442619","19442835","36","145770"
"chr1","19602016","19602279","chr14","19455305","19455570","7","146711"
"chr1","19671310","19671600","chr14","19519976","19520266","10","151334"
"chr1","19729334","19729641","chr14","19575431","19575738","12","153903"
"chr1","19789387","19789625","chr14","19632999","19633217","27","156388"
"chr1","19789703","19789754","chr11","113677231","113677281","11","93887528"
"chr1","19790044","19790130","chr14","19633529","19633615","0","156515"
"chr1","19791414","19791656","chr1","101437092","101437355","63","81645678"
"chr1","19811086","19811285","chr16","51676093","51676284","44","31865007"
"chr1","19905088","19905397","chr14","103561503","103561817","52","83656415"
"chr1","19914081","19914360","chr19","35543793","35544072","72","15629712"
"chr1","19920300","19920604","chr14","19758242","19758549","5","162058"
"chr1","19942030","19942356","chr3","49634161","49634472","63","29692131"
"chr1","20024297","20024595","chr14","19862102","19862418","30","162195"
"chr1","20028654","20028957","chr14","19866516","19866816","18","162138"
"chr1","20058013","20058263","chr15","22573263","22573509","68","2515250"
"chr1","20080125","20080406","chr1","54916700","54916978","53","34836575"
"chr1","20087835","20088127","chr14","19921454","19921750","9","166381"
"chr1","20105345","20105646","chr14","19937891","19938191","8","167454"
"chr1","20121257","20121545","chr14","19953301","19953588","8","167956"
"chr1","20190769","20191066","chr14","20021744","20022050","14","169025"
"chr1","20210588","20210885","chr14","20041834","20042132","7","168754"
"chr1","20245422","20245738","chr14","20078352","20078673","11","167070"
"chr1","20249152","20249454","chr14","20082053","20082355","5","167099"
"chr1","20278532","20278798","chr14","20111637","20111902","6","166895"
"chr1","20358998","20359284","chr14","20187548","20187833","6","171450"
"chr1","20436815","20437115","chr14","20261984","20262273","22","174831"
"chr1","20440333","20440638","chr14","20265092","20265397","9","175241"
"chr1","20542697","20543017","chr14","20362495","20362810","14","180202"
"chr1","20552152","20552430","chr14","20371326","20371604","7","180826"
"chr1","20629780","20629981","chr2","76985100","76985258","65","56355320"
"chr1","20630034","20630162","chr7","42254946","42255078","23","21624912"
"chr1","20681891","20682145","chr6","135881865","135882115","66","115199974"
"chr1","20705481","20705671","chr14","20519862","20520052","5","185619"
"chr1","20718294","20718562","chr1","203437600","203437853","66","182719306"
"chr1","20749691","20749954","chr5","94097853","94098133","66","73348162"
"chr1","20757359","20757635","chr14","20570951","20571227","5","186408"
"chr1","20771592","20771814","chr8","96074546","96074762","56","75302954"
"chr1","20797135","20797433","chr14","20608925","20609223","6","188210"
"chr1","20818970","20819280","chr14","20629572","20629881","9","189398"
"chr1","20824947","20825111","chr14","20635411","20635577","10","189536"
"chr1","20825139","20825285","chr14","20635617","20635762","5","189522"
"chr1","20844440","20844740","chr14","20653974","20654256","26","190466"
"chr1","20866526","20866821","chr14","20673648","20673943","10","192878"
"chr1","20870107","20870403","chr14","20676890","20677216","36","193217"
"chr1","20892132","20892363","chr14","20698003","20698256","37","194129"
"chr1","20912665","20912961","chr14","20719039","20719343","19","193626"
"chr1","20922147","20922452","chr14","20730656","20730961","6","191491"
"chr1","20930889","20931172","chr14","20738363","20738646","7","192526"
"chr1","21021053","21021339","chr14","20823078","20823368","15","197975"
"chr1","21029345","21029639","chr14","20831390","20831684","4","197955"
"chr1","21223931","21224214","chr14","21021527","21021809","9","202404"
"chr1","21295903","21296069","chr14","21089910","21090076","4","205993"
"chr1","21328530","21328848","chr14","21122284","21122604","14","206246"
"chr1","21331477","21331570","chr14","21125038","21125137","16","206439"
"chr1","21333116","21333399","chrX","15783794","15784082","53","5549322"
"chr1","21335475","21335767","chr14","21129009","21129301","2","206466"
"chr1","21335927","21336081","chr19","14673246","14673394","40","6662681"
"chr1","21343269","21343335","chr14","47529196","47529259","21","26185927"
"chr1","21352273","21352342","chr14","21144983","21145046","6","207290"
"chr1","21355423","21355733","chr8","50403783","50404088","54","29048360"
"chr1","21369787","21370097","chr14","21160986","21161269","38","208801"
"chr1","21370396","21370505","chrX","124275818","124275924","20","102905422"
"chr1","21370546","21370820","chr14","21161569","21161843","9","208977"
"chr1","21385437","21385719","chr14","21176642","21176922","6","208795"
"chr1","21388033","21388337","chr14","21179254","21179559","17","208779"
"chr1","21410778","21411073","chr14","21201367","21201666","14","209411"
"chr1","21412243","21412408","chr1","4955934","4956104","32","16456309"
"chr1","21412417","21412571","chrX","92355933","92356087","34","70943516"
"chr1","21412601","21412722","chr6","162438658","162438779","17","141026057"
"chr1","21437485","21437819","chr14","21226770","21227112","28","210715"
"chr1","21456105","21456382","chr14","21244683","21244959","12","211422"
"chr1","21456455","21456702","chr14","21244683","21244959","38","211772"
"chr1","21498322","21498635","chr14","21285117","21285433","9","213205"
"chr1","21520102","21520396","chr14","21306775","21307069","5","213327"
"chr1","21526009","21526241","chr14","21312305","21312537","7","213704"
"chr1","21533120","21533432","chr14","21319500","21319810","21","213620"
"chr1","21537636","21537936","chr14","21324049","21324358","22","213587"
"chr1","21541305","21541592","chr14","21326567","21326857","7","214738"
"chr1","21561916","21562215","chr14","21346082","21346383","10","215834"
"chr1","21597965","21598228","chr14","21382001","21382264","9","215964"
"chr1","21622563","21622708","chr14","21406876","21407021","3","215687"
"chr1","21623015","21623192","chr14","21407331","21407500","12","215684"
"chr1","21650856","21650982","chr3","75254804","75254929","33","53603948"
"chr1","21670055","21670353","chr14","21453503","21453803","8","216552"
"chr1","21675992","21676207","chr14","21459184","21459391","10","216808"
"chr1","21705810","21706135","chr14","21488682","21489006","11","217128"
"chr1","21712780","21712901","chrX","108971246","108971363","18","87258466"
"chr1","21712919","21713212","chrX","141365274","141365565","56","119652355"
"chr1","21750456","21750748","chr14","21530962","21531247","41","219494"
"chr1","21762700","21762987","chr14","21543155","21543442","5","219545"
"chr1","21763146","21763441","chr14","21543601","21543901","18","219545"
"chr1","21809514","21809626","chr5","20259577","20259676","23","1549937"
"chr1","21830133","21830360","chr14","21609957","21610184","7","220176"
"chr1","21831610","21831924","chr14","21611429","21611744","10","220181"
"chr1","21853880","21854169","chr14","21633644","21633936","13","220236"
"chr1","21896230","21896483","chr7","22674919","22675167","64","778689"
"chr1","21896538","21896591","chr1","13005962","13006017","20","8890576"
"chr1","21964156","21964451","chr14","21742885","21743176","8","221271"
"chr1","21971446","21971733","chr14","21750164","21750451","5","221282"
"chr1","21983583","21983740","chr14","21762308","21762466","4","221275"
"chr1","21984050","21984183","chr14","21762776","21762909","6","221274"
"chr1","21988392","21988698","chr14","21766809","21767121","15","221583"
"chr1","21990074","21990391","chr14","21768290","21768606","14","221784"
"chr1","22009173","22009399","chr14","21786398","21786624","5","222775"
"chr1","22017634","22017788","chr14","21794925","21795079","6","222709"
"chr1","22030987","22031282","chr2","149220987","149221284","57","127190000"
"chr1","22052483","22052774","chr14","21827051","21827342","9","225432"
"chr1","22059712","22059893","chr14","21834058","21834239","0","225654"
"chr1","22067201","22067486","chr14","21841540","21841825","3","225661"
"chr1","22077876","22078007","chr7","42422566","42422701","29","20344690"
"chr1","22081931","22082201","chr14","21856168","21856437","9","225763"
"chr1","22085538","22085609","chr3","29861012","29861083","16","7775474"
"chr1","22111051","22111179","chr14","21883612","21883743","14","227439"
"chr1","22115015","22115313","chr14","21887583","21887881","4","227432"
"chr1","22193160","22193455","chr14","21964235","21964530","7","228925"
"chr1","22213736","22214046","chr15","75127303","75127612","47","52913567"
"chr1","22220532","22220764","chr14","21988840","21989072","8","231692"
"chr1","22351898","22352196","chr14","22121698","22121984","22","230200"
"chr1","22612082","22612372","chr14","22380725","22381015","6","231357"
"chr1","22662161","22662471","chr14","22429892","22430199","14","232269"
"chr1","22720383","22720672","chr14","22485998","22486267","26","234385"
"chr1","22738490","22738776","chr14","22507021","22507307","4","231469"
"chr1","22908750","22909041","chr14","22671021","22671312","9","237729"
"chr1","22925528","22925835","chr14","22687468","22687770","17","238060"
"chr1","22999868","23000000","chr12","80614773","80614908","20","57614905"
"chr1","23022839","23022926","chr9","85194339","85194418","17","62171500"
"chr1","23022939","23023209","chr14","22781301","22781592","32","241638"
"chr1","23057975","23058060","chr2","2600502","2600583","17","20457473"
"chr1","23058063","23058213","chr1","10902379","10902525","33","12155684"
"chr1","23058293","23058496","chr14","22815794","22815996","11","242499"
"chr1","23135823","23136124","chr14","22898197","22898502","17","237626"
"chr1","23160226","23160523","chr14","22923105","22923402","6","237121"
"chr1","23222876","23223046","chr10","32525861","32526028","70","9302985"
"chr1","23457210","23457486","chr14","23223920","23224196","1","233290"
"chr1","23511313","23511623","chr14","23279095","23279397","34","232218"
"chr1","23578900","23578965","chr1","201918241","201918308","14","178339341"
"chr1","23593959","23594030","chr8","92567790","92567854","24","68973831"
"chr1","23595509","23595591","chr5","70065014","70065099","20","46469505"
"chr1","23659145","23659266","chr14","23429773","23429894","2","229372"
"chr1","23728677","23728934","chr2","78855951","78856210","63","55127274"
"chr1","23747402","23747707","chr14","23518633","23518933","27","228769"
"chr1","23770278","23770555","chr6","74294843","74295131","71","50524565"
"chr1","23802407","23802730","chr14","23573782","23574112","26","228625"
"chr1","23812774","23813137","chr14","23583911","23584209","74","228863"
"chr1","23828990","23829287","chr14","23603248","23603553","17","225742"
"chr1","23830607","23830921","chr14","23604864","23605165","37","225743"
"chr1","23859395","23859705","chr14","23631881","23632189","12","227514"
"chr1","23932498","23932788","chr14","23702486","23702778","19","230012"
"chr1","23979836","23980218","chr14","23753706","23754012","89","226130"
"chr1","23991694","23991969","chr14","23764763","23765082","52","226931"
"chr1","23991980","23992215","chr9","39523557","39523783","56","15531577"
"chr1","23992220","23992389","chr16","59918798","59918960","40","35926578"
"chr1","24161704","24161827","chr14","23930009","23930132","3","231695"
"chr1","24280701","24280877","chr14","24036604","24036776","10","244097"
"chr1","24440897","24441196","chr14","24187877","24188176","11","253020"
"chr1","24598345","24598522","chr14","24342027","24342204","8","256318"
"chr1","24619190","24619370","chr14","24362532","24362720","15","256658"
"chr1","24619736","24619859","chr14","24363086","24363209","1","256650"
"chr1","24884341","24884636","chr14","24610562","24610857","2","273779"
"chr1","24958153","24958432","chr14","24680621","24680905","16","277532"
"chr1","25009608","25009858","chr14","24728237","24728522","52","281371"
"chr1","25018715","25018872","chr14","24737268","24737425","0","281447"
"chr1","25052948","25053244","chr14","24769623","24769921","8","283325"
"chr1","25083646","25083935","chr14","24799493","24799778","9","284153"
"chr1","25126715","25127018","chr14","24841680","24841987","7","285035"
"chr1","25265078","25265365","chr14","24971950","24972238","10","293128"
"chr1","25400557","25400854","chr14","25103587","25103887","10","296970"
"chr1","25423730","25424030","chr14","25126283","25126581","9","297447"
"chr1","25455849","25456057","chr14","25156417","25156620","11","299432"
"chr1","25468450","25468551","chr1","18170763","18170860","24","7297687"
"chr1","25468699","25468987","chr14","25172442","25172730","8","296257"
"chr1","25493281","25493565","chr14","25196352","25196646","14","296929"
"chr1","25494014","25494302","chr14","25197128","25197416","13","296886"
"chr1","25580668","25580944","chr14","25273324","25273595","12","307344"
"chr1","25602180","25602446","chr14","25298279","25298544","7","303901"
"chr1","25602464","25602500","chr1","13731469","13731504","7","11870995"
"chr1","25641199","25641499","chr14","25335418","25335720","21","305781"
"chr1","25745332","25745570","chr14","25436585","25436823","6","308747"
"chr1","25751955","25752234","chr14","25443147","25443440","22","308808"
"chr1","25929141","25929434","chr14","25615630","25615914","29","313511"
"chr1","25937438","25937717","chr6","102183279","102183558","61","76245841"
"chr1","25990933","25991219","chr14","25675087","25675374","9","315846"
"chr1","25991513","25991646","chr14","25675668","25675793","11","315845"
"chr1","25991682","25991871","chr14","25675849","25676026","20","315833"
"chr1","26013556","26013842","chr14","25695730","25696016","10","317826"
"chr1","26057861","26058036","chr7","24719953","24720127","49","1337908"
"chr1","26058051","26058295","chr8","36392608","36392843","50","10334557"
"chr1","26116179","26116443","chr14","25795724","25795988","4","320455"
"chr1","26273160","26273456","chr14","25945520","25945841","35","327640"
"chr1","26349612","26349817","chr14","26020833","26021038","4","328779"
"chr1","26366823","26366985","chr14","26036947","26037132","25","329876"
"chr1","26374237","26374564","chr14","26044564","26044891","19","329673"
"chr1","26526683","26526842","chr14","26209015","26209176","7","317668"
"chr1","26883475","26883737","chr1","127729906","127730171","51","100846431"
"chr1","26895735","26896013","chr14","26548447","26548725","10","347288"
"chr1","27114930","27115214","chr14","26764423","26764707","6","350507"
"chr1","27144068","27144362","chr14","26794937","26795229","12","349131"
"chr1","27158888","27159133","chr14","26808533","26808778","8","350355"
"chr1","27166241","27166484","chr14","26815589","26815830","12","350652"
"chr1","27213583","27213871","chr14","26875900","26876188","8","337683"
"chr1","27227740","27228050","chr14","26892871","26893174","14","334869"
"chr1","27301026","27301331","chr14","26965758","26966064","16","335268"
"chr1","27458716","27459005","chr14","27114654","27114860","88","344062"
"chr1","27489402","27489649","chr14","27142757","27143002","8","346645"
"chr1","27546560","27546693","chr14","27198192","27198325","7","348368"
"chr1","27666827","27667128","chr14","27344231","27344552","26","322596"
"chr1","27785609","27785885","chr14","27462203","27462479","4","323406"
"chr1","27903368","27903523","chr14","27579835","27580011","26","323533"
"chr1","27909837","27910138","chr14","27586231","27586540","18","323606"
"chr1","27916467","27916744","chr14","27592427","27592706","21","324040"
"chr1","27916806","27916952","chr10","65746323","65746471","29","37829517"
"chr1","27994283","27994529","chr14","27666622","27666893","31","327661"
"chr1","27994588","27994812","chr4","113612592","113612804","69","85618004"
"chr1","28052554","28052865","chr14","27720581","27720895","19","331973"
"chr1","28089003","28089303","chr14","27756845","27757144","5","332158"
"chr1","28265897","28266114","chr14","27923511","27923731","15","342386"
"chr1","28364116","28364427","chr8","61423665","61423965","98","33059549"
"chr1","28466484","28466719","chr14","28113012","28113255","13","353472"
"chr1","28641764","28642059","chr14","28277325","28277619","5","364439"
"chr1","28712376","28712677","chr14","28345424","28345732","13","366952"
"chr1","28728510","28728773","chr14","28361285","28361548","5","367225"
"chr1","28802962","28803223","chr14","28436158","28436428","27","366804"
"chr1","28835246","28835293","chr6","148291297","148291342","9","119456051"
"chr1","28835294","28835449","chr15","42543838","42543990","37","13708544"
"chr1","28888896","28889187","chr14","28517160","28517450","7","371736"
"chr1","28908697","28909001","chr14","28538053","28538353","9","370644"
"chr1","28909869","28910147","chr14","28539224","28539502","7","370645"
"chr1","28943568","28943662","chr7","91468071","91468166","13","62524503"
"chr1","28966124","28966430","chr14","28595222","28595503","37","370902"
"chr1","28976826","28977123","chr14","28605160","28605457","9","371666"
"chr1","29012886","29013197","chr14","28637312","28637623","8","375574"
"chr1","29043263","29043572","chr14","28664413","28664723","18","378850"
"chr1","29091048","29091333","chr14","28710336","28710621","4","380712"
"chr1","29091337","29091630","chr14","28710625","28710916","9","380712"
"chr1","29109340","29109613","chr14","28727414","28727687","4","381926"
"chr1","29164562","29164864","chr14","28780966","28781275","23","383596"
"chr1","29166754","29167067","chr14","28783085","28783368","63","383669"
"chr1","29168450","29168760","chr14","28784747","28785055","20","383703"
"chr1","29171404","29171692","chr14","28790270","28790555","17","381134"
"chr1","29186715","29187023","chr14","28804615","28804924","15","382100"
"chr1","29190125","29190438","chr6","157064190","157064497","59","127874065"
"chr1","29195337","29195395","chrX","46917498","46917556","14","17722161"
"chr1","29195414","29195692","chr14","28812206","28812486","8","383208"
"chr1","29219408","29219676","chr14","28834365","28834633","6","385043"
"chr1","29236700","29237011","chr14","28850265","28850571","18","386435"
"chr1","29296444","29296744","chr14","28907337","28907635","10","389107"
"chr1","29333051","29333358","chr14","28942804","28943112","11","390247"
"chr1","29347170","29347331","chr1","26705263","26705423","27","2641907"
"chr1","29347627","29347715","chr11","97618455","97618548","21","68270828"
"chr1","29365402","29365709","chr14","28976020","28976333","18","389382"
"chr1","29389585","29389779","chr14","29003198","29003372","28","386387"
"chr1","29390136","29390248","chr14","29003730","29003842","6","386406"
"chr1","29408837","29408981","chr9","102282987","102283142","29","72874150"
"chr1","29418424","29418549","chr14","29031461","29031593","12","386963"
"chr1","29418843","29419028","chr14","29031872","29032069","17","386971"
"chr1","29518332","29518625","chr3","125030767","125031037","67","95512435"
"chr1","29530206","29530331","chr14","29143112","29143237","3","387094"
"chr1","29552406","29552591","chr20","62793124","62793314","37","33240718"
"chr1","29593879","29594124","chr7","73232517","73232748","60","43638638"
"chr1","29623183","29623481","chr14","29229123","29229421","8","394060"
"chr1","29654540","29654848","chr14","29260279","29260576","17","394261"
"chr1","29661247","29661523","chr14","29266845","29267149","31","394402"
"chr1","29667416","29667724","chr14","29273215","29273501","27","394201"
"chr1","29690127","29690424","chr14","29295500","29295802","15","394627"
"chr1","29690706","29690977","chr14","29295500","29295802","42","395206"
"chr1","29760269","29760577","chr14","29362091","29362396","13","398178"
"chr1","29769243","29769545","chr14","29370534","29370836","8","398709"
"chr1","29777827","29777961","chr14","29378378","29378516","7","399449"
"chr1","29822158","29822425","chr14","29423693","29423988","36","398465"
"chr1","29822469","29822500","chr16","18256686","18256711","6","11565783"
"chr1","29877453","29877758","chr14","29477092","29477397","5","400361"
"chr1","29905845","29906126","chr14","29503079","29503347","22","402766"
"chr1","29928034","29928213","chr14","29528001","29528181","8","400033"
"chr1","29969039","29969335","chr14","29568324","29568620","6","400715"
"chr1","30046906","30047223","chr14","29644488","29644797","19","402418"
"chr1","30189721","30190034","chr14","29784462","29784754","25","405259"
"chr1","30211565","30211864","chr14","29811736","29812035","4","399829"
"chr1","30256878","30257207","chr14","29854863","29855191","9","402015"
"chr1","30295336","30295637","chr14","29893119","29893422","10","402217"
"chr1","30325597","30325909","chr14","29924555","29924852","20","401042"
"chr1","30362765","30363025","chr14","29964950","29965220","12","397815"
"chr1","30480492","30480795","chr6","89727589","89727901","61","59247097"
"chr1","30563454","30563754","chr14","30164626","30164924","10","398828"
"chr1","30586202","30586512","chrX","44566163","44566473","63","13979961"
"chr1","30597697","30597982","chr14","30200281","30200571","8","397416"
"chr1","30710498","30710751","chr11","94751367","94751621","60","64040869"
"chr1","30726561","30726854","chr14","30325753","30326045","8","400808"
"chr1","30758022","30758291","chr14","30355389","30355658","7","402633"
"chr1","30758315","30758612","chr14","30355683","30355979","5","402632"
"chr1","30758710","30758798","chr4","2744439","2744523","20","28014271"
"chr1","30763063","30763366","chr14","30359620","30359924","8","403443"
"chr1","30787608","30787895","chr14","30381876","30382163","5","405732"
"chr1","30791796","30792105","chr14","30386356","30386665","4","405440"
"chr1","30814279","30814557","chr14","30408564","30408845","10","405715"
"chr1","30825808","30826110","chr14","30419687","30419989","14","406121"
"chr1","30837599","30837904","chr4","152226280","152226592","59","121388681"
"chr1","30852109","30852413","chr2","49984213","49984519","68","19132104"
"chr1","30855425","30855708","chr14","30449439","30449745","33","405986"
"chr1","30901562","30901693","chr3","116700233","116700368","44","85798671"
"chr1","30901722","30901964","chr14","30489433","30489662","17","412289"
"chr1","30920748","30921044","chrX","118956252","118956548","55","88035504"
"chr1","30926289","30926383","chr14","30512945","30513051","15","413344"
"chr1","30948318","30948610","chr14","30535698","30535988","13","412620"
"chr1","30953711","30953869","chr14","30540552","30540709","5","413159"
"chr1","30973509","30973771","chr14","30560556","30560818","5","412953"
"chr1","30999044","30999342","chr14","30586389","30586692","18","412655"
"chr1","31007690","31007973","chr14","30594871","30595160","12","412819"
"chr1","31013215","31013499","chr14","30600438","30600720","10","412777"
"chr1","31023597","31023879","chr14","30610389","30610671","6","413208"
"chr1","31035387","31035460","chr14","30621733","30621805","3","413654"
"chr1","31035733","31035873","chr3","37634556","37634690","28","6598823"
"chr1","31036230","31036354","chr14","30622579","30622707","8","413651"
"chr1","31039734","31039855","chr1","85858415","85858535","18","54818681"
"chr1","31058087","31058384","chr5","34124845","34125142","53","3066758"
"chr1","31077029","31077186","chr11","124217507","124217665","28","93140478"
"chr1","31081248","31081533","chr14","30667669","30667954","6","413579"
"chr1","31087147","31087326","chr14","30673254","30673434","3","413893"
"chr1","31087850","31088144","chr14","30673962","30674256","10","413888"
"chr1","31093317","31093508","chr14","30679451","30679643","7","413866"
"chr1","31118317","31118578","chrX","43898823","43899097","57","12780506"
"chr1","31137598","31137709","chr20","26234468","26234574","22","4903130"
"chr1","31137711","31137780","chr1","203526304","203526368","17","172388593"
"chr1","31137797","31137991","chr14","30721912","30722117","27","415885"
"chr1","31178052","31178375","chr14","30763478","30763819","25","414574"
"chr1","31187504","31187784","chr14","30770188","30770468","4","417316"
"chr1","31208129","31208417","chr14","30792557","30792843","8","415572"
"chr1","31236538","31236849","chr2","78493440","78493742","51","47256902"
"chr1","31249537","31249832","chr14","30829389","30829682","18","420148"
"chr1","31258897","31259225","chr14","30834709","30834999","41","424188"
"chr1","31260693","31260990","chr14","30843471","30843770","8","417222"
"chr1","31272414","31272652","chr14","30854525","30854757","10","417889"
"chr1","31283970","31284291","chr14","30870717","30871034","19","413253"
"chr1","31288562","31288784","chr1","14828122","14828342","48","16460440"
"chr1","31291874","31292181","chr14","30878979","30879283","10","412895"
"chr1","31295405","31295536","chr14","30882625","30882756","6","412780"
"chr1","31304487","31304603","chr4","43561239","43561356","25","12256752"
"chr1","31304605","31304909","chr3","51622492","51622797","44","20317887"
"chr1","31307985","31308285","chr14","30894849","30895151","7","413136"
"chr1","31316619","31316903","chr14","30903352","30903636","10","413267"
"chr1","31334143","31334435","chr14","30920953","30921245","9","413190"
"chr1","31336187","31336419","chr1","15094861","15095096","57","16241326"
"chr1","31352589","31352887","chr14","30939781","30940080","11","412808"
"chr1","31359239","31359537","chr14","30946579","30946877","3","412660"
"chr1","31362150","31362432","chr14","30949481","30949760","14","412669"
"chr1","31364725","31365034","chr14","30952028","30952339","5","412697"
"chr1","31386840","31387121","chr14","30973931","30974219","19","412909"
"chr1","31407959","31408238","chr14","30995774","30996050","8","412185"
"chr1","31414030","31414345","chr14","31001642","31001947","16","412388"
"chr1","31417370","31417654","chr14","31004971","31005255","7","412399"
"chr1","31433126","31433283","chr1","9350553","9350709","26","22082573"
"chr1","31433310","31433430","chr6","41255012","41255132","18","9821702"
"chr1","31434576","31434867","chr20","52010350","52010639","58","20575774"
"chr1","31455261","31455461","chr14","31041973","31042175","3","413288"
"chr1","31490498","31490824","chr14","31077462","31077791","8","413036"
"chr1","31506746","31507040","chr14","31093094","31093401","22","413652"
"chr1","31551639","31551915","chr14","31138096","31138372","3","413543"
"chr1","31578014","31578187","chrX","113108488","113108658","44","81530474"
"chr1","31652390","31652689","chr14","31228969","31229257","16","423421"
"chr1","31678076","31678373","chr14","31254117","31254401","15","423959"
"chr1","31728135","31728425","chr14","31303686","31303976","10","424449"
"chr1","31746108","31746227","chr18","12999568","12999690","18","18746540"
"chr1","31761048","31761363","chr14","31334249","31334562","11","426799"
"chr1","31784569","31784852","chr14","31357240","31357523","5","427329"
"chr1","31792976","31793269","chr14","31365532","31365826","8","427444"
"chr1","31827088","31827399","chr14","31399066","31399380","9","428022"
"chr1","31834862","31835138","chr14","31406638","31406911","13","428224"
"chr1","31841389","31841694","chr14","31412734","31413034","13","428655"
"chr1","31876241","31876549","chr14","31446113","31446421","5","430128"
"chr1","31881822","31881900","chr14","31450654","31450732","2","431168"
"chr1","31896682","31896951","chr14","31465246","31465515","7","431436"
"chr1","31899604","31899878","chr14","31468176","31468450","2","431428"
"chr1","31934220","31934380","chr6","31409990","31410151","26","524230"
"chr1","31952322","31952622","chr14","31519210","31519502","11","433112"
"chr1","31961934","31962240","chr14","31528824","31529130","6","433110"
"chr1","31975489","31975808","chr7","151838760","151839063","78","119863271"
"chr1","31988314","31988605","chr14","31556433","31556724","7","431881"
"chr1","32035195","32035497","chr14","31651174","31651479","10","384021"
"chr1","32036178","32036488","chr14","31652173","31652463","25","384005"
"chr1","32037695","32037836","chr14","31653679","31653841","27","384016"
"chr1","32049929","32050132","chr14","31665898","31666107","11","384031"
"chr1","32053044","32053326","chr14","31668998","31669281","13","384046"
"chr1","32060279","32060512","chr10","86392675","86392913","57","54332396"
"chr1","32063296","32063426","chrX","5004383","5004514","44","27058913"
"chr1","32063749","32063906","chr1","17983839","17983979","35","14079910"
"chr1","32070374","32070671","chr14","31686851","31687148","8","383523"
"chr1","32085592","32085752","chr1","18863365","18863517","45","13222227"
"chr1","32086050","32086193","chr14","31702584","31702727","2","383466"
"chr1","32094522","32094820","chr14","31711134","31711432","4","383388"
"chr1","32095128","32095423","chr14","31711740","31712035","5","383388"
"chr1","32100577","32100888","chr14","31717218","31717499","34","383359"
"chr1","32101045","32101307","chr14","31717656","31717926","16","383389"
"chr1","32114705","32114985","chr14","31731630","31731911","8","383075"
"chr1","32129737","32130050","chr14","31774116","31774426","11","355621"
"chr1","32135820","32136113","chr14","31780182","31780481","11","355638"
"chr1","32157598","32157882","chr14","31802030","31802305","15","355568"
"chr1","32165751","32166080","chr14","31810487","31810784","45","355264"
"chr1","32167778","32168077","chr14","31812401","31812700","13","355377"
"chr1","32168233","32168326","chr14","31812856","31812951","2","355377"
"chr1","32172419","32172596","chr14","31817040","31817215","8","355379"
"chr1","32172597","32172896","chr14","31817216","31817510","13","355381"
"chr1","32188647","32188941","chr14","31832957","31833251","3","355690"
"chr1","32202487","32202795","chr5","19920562","19920869","53","12281925"
"chr1","32204903","32205198","chr14","31848318","31848611","5","356585"
"chr1","32205901","32206115","chr14","31849316","31849530","6","356585"
"chr1","32216555","32216833","chr5","46451590","46451863","62","14235035"
"chr1","32226392","32226686","chr14","31869867","31870162","11","356525"
"chr1","32232200","32232467","chr14","31877808","31878083","16","354392"
"chr1","32233418","32233796","chr10","81284866","81285229","115","49051448"
"chr1","32237012","32237346","chr14","31882497","31882819","24","354515"
"chr1","32260727","32260841","chr5","103784948","103785065","22","71524221"
"chr1","32262089","32262309","chr14","31908471","31908675","22","353618"
"chr1","32265321","32265620","chr14","31911720","31912033","19","353601"
"chr1","32268314","32268592","chr14","31914718","31914989","9","353596"
"chr1","32295167","32295466","chr14","31941607","31941904","7","353560"
"chr1","32320317","32320614","chr14","31967088","31967403","26","353229"
"chr1","32324020","32324306","chr14","31970765","31971051","7","353255"
"chr1","32334538","32334828","chr14","31981613","31981910","16","352925"
"chr1","32354700","32355005","chr4","152226280","152226592","56","119871580"
"chr1","32358866","32359169","chr14","32006008","32006312","5","352858"
"chr1","32361314","32361609","chr14","32008461","32008744","20","352853"
"chr1","32361614","32361900","chr14","32008760","32009045","13","352854"
"chr1","32365716","32366000","chr14","32012853","32013151","19","352863"
"chr1","32374065","32374366","chr14","32021652","32021936","25","352413"
"chr1","32381568","32381789","chr14","32029057","32029285","8","352511"
"chr1","32385458","32385762","chr14","32032775","32033079","8","352683"
"chr1","32395819","32396123","chr14","32043128","32043400","35","352691"
"chr1","32404984","32405274","chr14","32052553","32052841","5","352431"
"chr1","32412209","32412500","chr14","32059420","32059717","16","352789"
"chr1","32418111","32418448","chr14","32065325","32065632","33","352786"
"chr1","32425492","32425557","chr14","32072580","32072650","7","352912"
"chr1","32426629","32426922","chr2","186858126","186858417","67","154431497"
"chr1","32430063","32430355","chr4","7327839","7328133","65","25102224"
"chr1","32433544","32433829","chr14","32080339","32080624","18","353205"
"chr1","32464632","32464772","chr14","32109734","32109868","11","354898"
"chr1","32465058","32465238","chr14","32110154","32110333","6","354904"
"chr1","32479466","32479743","chr14","32126631","32126910","9","352835"
"chr1","32504414","32504702","chr14","32152036","32152324","7","352378"
"chr1","32510827","32511127","chr14","32158492","32158796","26","352335"
"chr1","32518560","32518830","chr14","32166648","32166933","21","351912"
"chr1","32569106","32569239","chr14","32211550","32211683","4","357556"
"chr1","32569417","32569444","chr14","32212075","32212102","0","357342"
"chr1","32576343","32576693","chr14","32218635","32218985","2","357708"
"chr1","32585694","32585995","chr14","32227975","32228281","9","357719"
"chr1","32593133","32593395","chr14","32235424","32235685","5","357709"
"chr1","32593436","32593735","chr14","32235726","32236020","13","357710"
"chr1","32625540","32625830","chr3","35835269","35835556","55","3209729"
"chr1","32653107","32653383","chr14","32293264","32293553","28","359843"
"chr1","32655458","32655727","chr14","32295649","32295927","13","359809"
"chr1","32664329","32664619","chr14","32304154","32304444","10","360175"
"chr1","32665104","32665365","chr14","32304925","32305186","7","360179"
"chr1","32675625","32675914","chr14","32319936","32320224","17","355689"
"chr1","32683232","32683523","chr14","32324593","32324886","4","358639"
"chr1","32717701","32717965","chr14","32356587","32356870","47","361114"
"chr1","32718777","32718975","chr14","32357680","32357877","6","361097"
"chr1","32721222","32721514","chr14","32363641","32363934","8","357581"
"chr1","32724716","32725016","chr14","32367143","32367443","5","357573"
"chr1","32732201","32732324","chr14","32375166","32375289","6","357035"
"chr1","32732633","32732806","chr14","32375577","32375744","16","357056"
"chr1","32774428","32774739","chr14","32417143","32417422","40","357285"
"chr1","32791973","32792279","chr14","32434277","32434583","7","357696"
"chr1","32798306","32798612","chr14","32440613","32440914","15","357693"
"chr1","32822194","32822501","chr14","32464455","32464762","10","357739"
"chr1","32846023","32846342","chr14","32488865","32489185","17","357158"
"chr1","32886814","32887107","chr14","32530488","32530783","11","356326"
"chr1","32909251","32909510","chr14","32553034","32553283","16","356217"
"chr1","32923519","32923801","chr14","32567439","32567718","12","356080"
"chr1","32938933","32939169","chr14","32582776","32583004","16","356157"
"chr1","32950239","32950516","chr14","32594073","32594342","20","356166"
"chr1","32958153","32958310","chr14","32601710","32601868","5","356443"
"chr1","32958484","32958623","chr14","32602042","32602181","2","356442"
"chr1","32964838","32965102","chr14","32608384","32608650","11","356454"
"chr1","32967613","32967783","chr14","32611526","32611689","15","356087"
"chr1","32988479","32988798","chr14","32624216","32624537","5","364263"
"chr1","33005661","33005952","chr14","32641359","32641646","7","364302"
"chr1","33033855","33034185","chr14","32669559","32669865","26","364296"
"chr1","33052511","33052798","chr14","32689208","32689528","41","363303"
"chr1","33065015","33065324","chr14","32701710","32701999","31","363305"
"chr1","33082492","33082802","chr14","32719022","32719329","10","363470"
"chr1","33089976","33090253","chr6","172791580","172791872","74","139701604"
"chr1","33122078","33122278","chr14","32757977","32758163","27","364101"
"chr1","33167327","33167638","chr14","32804002","32804315","13","363325"
"chr1","33175968","33176218","chr14","32812665","32812916","6","363303"
"chr1","33211039","33211339","chr14","32847858","32848158","6","363181"
"chr1","33226886","33227212","chr14","32864004","32864321","17","362882"
"chr1","33281996","33282331","chr14","32919827","32920145","25","362169"
"chr1","33294199","33294509","chr14","32932380","32932696","19","361819"
"chr1","33333334","33333637","chr14","32971284","32971608","34","362050"
"chr1","33339408","33339715","chr14","32977679","32977981","7","361729"
"chr1","33363155","33363468","chr14","33001408","33001716","12","361747"
"chr1","33428417","33428576","chr14","33066905","33067064","3","361512"
"chr1","33428889","33429016","chr14","33067378","33067509","5","361511"
"chr1","33430390","33430674","chr14","33068879","33069163","7","361511"
"chr1","33445743","33445981","chr14","33084232","33084472","10","361511"
"chr1","33455236","33455325","chr3","3597832","3597921","14","29857404"
"chr1","33459084","33459381","chr14","33097552","33097848","12","361532"
"chr1","33507469","33507758","chr14","33146145","33146433","4","361324"
"chr1","33521492","33521796","chr14","33160411","33160716","10","361081"
"chr1","33528699","33529008","chr14","33167587","33167884","18","361112"
"chr1","33584973","33585266","chr14","33222662","33222955","1","362311"
"chr1","33604417","33604688","chr14","33241734","33242005","9","362683"
"chr1","33605518","33605729","chr14","33242830","33243041","1","362688"
"chr1","33611749","33611976","chr14","33248990","33249217","2","362759"
"chr1","33664137","33664345","chr14","33299210","33299418","4","364927"
"chr1","33672329","33672612","chr14","33307342","33307629","8","364987"
"chr1","33673161","33673449","chr14","33308165","33308455","8","364996"
"chr1","33713631","33713778","chr14","33348249","33348396","1","365382"
"chr1","33727981","33728264","chr14","33362222","33362507","6","365759"
"chr1","33782767","33782977","chr14","33426274","33426484","4","356493"
"chr1","33814639","33814939","chr14","33460303","33460614","17","354336"
"chr1","34064778","34065002","chr14","33714114","33714339","8","350664"
"chr1","34085690","34085968","chr14","33735087","33735366","7","350603"
"chr1","34155756","34156058","chr14","33804655","33804958","5","351101"
"chr1","34160848","34161155","chr14","33809543","33809858","10","351305"
"chr1","34290275","34290585","chr14","33949384","33949684","20","340891"
"chr1","34297205","34297497","chr14","33956340","33956632","7","340865"
"chr1","34442907","34443156","chr14","34100668","34100925","22","342239"
"chr1","34461520","34461801","chr14","34119063","34119364","28","342457"
"chr1","34515522","34515834","chr14","34173763","34174084","20","341759"
"chr1","34609349","34609668","chr14","34269779","34270082","27","339570"
"chr1","34681505","34681783","chr14","34340139","34340417","3","341366"
"chr1","34696987","34697264","chr14","34355626","34355902","11","341361"
"chr1","34719513","34719804","chr14","34377908","34378200","8","341605"
"chr1","34768562","34768869","chr14","34426821","34427122","17","341741"
"chr1","34947227","34947390","chr14","34607195","34607358","2","340032"
"chr1","35032540","35032847","chr14","34694450","34694764","15","338090"
"chr1","35133677","35133959","chr14","34805836","34806118","3","327841"
"chr1","35213033","35213331","chr14","34884447","34884740","12","328586"
"chr1","35253147","35253431","chr14","34927101","34927392","15","326046"
"chr1","35301392","35301698","chr14","34978946","34979250","8","322446"
"chr1","35312736","35313028","chr14","34989971","34990265","12","322765"
"chr1","35400238","35400383","chr14","35075276","35075415","9","324962"
"chr1","35473810","35474105","chr14","35152730","35153018","17","321080"
"chr1","35543372","35543665","chr14","35228242","35228536","8","315130"
"chr1","35547322","35547645","chr14","35232231","35232554","8","315091"
"chr1","35589242","35589527","chr14","35274996","35275293","12","314246"
"chr1","35688579","35688861","chr8","62482204","62482483","75","26793625"
"chr1","35959040","35959325","chr14","35660280","35660565","2","298760"
"chr1","36022601","36022929","chr14","35722660","35722989","5","299941"
"chr1","36065945","36066260","chr14","35780899","35781181","38","285046"
"chr1","36093911","36093987","chr1","181872340","181872413","17","145778429"
"chr1","36249309","36249622","chr11","59150028","59150339","67","22900719"
"chr1","36320866","36321177","chr14","36045385","36045695","11","275481"
"chr1","36324961","36325193","chr14","36049423","36049655","4","275538"
"chr1","36327724","36327796","chr14","36052176","36052252","5","275548"
"chr1","36331645","36331964","chr14","36056036","36056367","24","275609"
"chr1","36388927","36389219","chr14","36113229","36113530","30","275698"
"chr1","36568464","36568735","chr14","36291295","36291570","8","277169"
"chr1","36594384","36594683","chr14","36318766","36319076","14","275618"
"chr1","36667491","36667802","chr14","36389578","36389878","14","277913"
"chr1","36772178","36772310","chr9","119390480","119390614","17","82618302"
"chr1","36776592","36776681","chr1","23191755","23191840","22","13584837"
"chr1","36834867","36835170","chr14","36572331","36572623","25","262536"
"chr1","36891866","36892108","chr14","36635548","36635790","6","256318"
"chr1","36964603","36964870","chr14","36708925","36709191","6","255678"
"chr1","36976045","36976338","chr14","36720337","36720629","6","255708"
"chr1","37019905","37020013","chr14","36764267","36764375","1","255638"
"chr1","37059857","37060158","chr14","36805107","36805401","13","254750"
"chr1","37118033","37118324","chr14","36868010","36868293","15","250023"
"chr1","37184932","37185063","chr14","36934592","36934723","3","250340"
"chr1","37185580","37185876","chr14","36935239","36935533","9","250341"
"chr1","37187029","37187330","chr14","36936688","36936989","10","250341"
"chr1","37195488","37195787","chr14","36944774","36945070","6","250714"
"chr1","37250564","37250709","chr14","37000068","37000210","7","250496"
"chr1","37374538","37374826","chr14","37128667","37128980","34","245871"
"chr1","37474423","37474727","chr14","37231309","37231603","11","243114"
"chr1","37481325","37481628","chr14","37238215","37238518","5","243110"
"chr1","37525269","37525479","chr14","37282088","37282298","12","243181"
"chr1","37525614","37525877","chr14","37282429","37282697","9","243185"
"chr1","37526918","37527216","chr14","37283715","37284010","12","243203"
"chr1","37547930","37548204","chr14","37305977","37306235","19","241953"
"chr1","37571348","37571456","chr14","37329060","37329168","1","242288"
"chr1","37615452","37615735","chr14","37375447","37375730","9","240005"
"chr1","37620271","37620436","chr14","37380836","37381003","9","239435"
"chr1","37621781","37621916","chr14","37382366","37382502","4","239415"
"chr1","37642692","37642993","chr14","37404413","37404717","10","238279"
"chr1","37686754","37686986","chr14","37449044","37449274","8","237710"
"chr1","37702545","37702800","chr14","37464934","37465189","6","237611"
"chr1","37725163","37725469","chr14","37486880","37487186","11","238283"
"chr1","37734058","37734350","chr14","37495430","37495720","9","238628"
"chr1","37751755","37751987","chr14","37513182","37513466","55","238573"
"chr1","37797771","37798062","chr14","37559796","37560087","3","237975"
"chr1","37830594","37830879","chr14","37592939","37593224","4","237655"
"chr1","37853327","37853631","chr14","37615815","37616120","8","237512"
"chr1","37931261","37931545","chr14","37693886","37694214","45","237375"
"chr1","37933106","37933408","chr14","37695776","37696079","4","237330"
"chr1","38081970","38082271","chr14","37845906","37846209","14","236064"
"chr1","38108251","38108562","chr14","37876792","37877103","3","231459"
"chr1","38194866","38195042","chr14","37971682","37971849","15","223184"
"chr1","38208077","38208353","chr14","37990417","37990706","20","217660"
"chr1","38256677","38256984","chr14","38034682","38034990","11","221995"
"chr1","38427314","38427604","chr14","38204616","38204906","11","222698"
"chr1","38464477","38464775","chr3","49634161","49634472","68","11169684"
"chr1","38484059","38484348","chr14","38261866","38262161","10","222193"
"chr1","38625399","38625715","chr14","38406048","38406370","12","219351"
"chr1","38709008","38709160","chr4","123473830","123473989","33","84764822"
"chr1","38709189","38709308","chr2","83766108","83766225","12","45056919"
"chr1","39081935","39082059","chr11","108818225","108818352","19","69736290"
"chr1","39082088","39082293","chr20","20042595","20042794","58","19039493"
"chr1","39202049","39202285","chr14","38995800","38996040","16","206249"
"chr1","39354503","39354789","chr14","39155142","39155440","18","199361"
"chr1","39356274","39356561","chr14","39156517","39156815","16","199757"
"chr1","39380031","39380328","chr14","39181609","39181911","15","198422"
"chr1","39501715","39502025","chr14","39320375","39320684","21","181340"
"chr1","39642395","39642495","chr4","6819242","6819342","17","32823153"
"chr1","39884503","39884633","chr14","39710872","39711002","6","173631"
"chr1","39896001","39896151","chr19","14673246","14673394","42","25222755"
"chr1","39920112","39920404","chr14","39748408","39748700","13","171704"
"chr1","39933131","39933297","chr1","13847107","13847258","41","26086024"
"chr1","39933337","39933460","chr4","33514863","33514986","24","6418474"
"chr1","39982156","39982446","chr14","39808654","39808957","24","173502"
"chr1","40210928","40211103","chr4","102293007","102293184","39","62082079"
"chr1","40211131","40211247","chr19","15059253","15059370","20","25151878"
"chr1","40252145","40252435","chr13","42501441","42501727","59","2249296"
"chr1","40280817","40281117","chr14","40118385","40118688","14","162432"
"chr1","40364822","40365104","chr14","40174262","40174545","12","190560"
"chr1","40527606","40527676","chr14","40336991","40337060","1","190615"
"chr1","40544390","40544571","chr14","40353731","40353911","6","190659"
"chr1","40808453","40808743","chr14","41044718","41045010","11","236265"
"chr1","40811193","40811476","chrX","97683741","97684026","70","56872548"
"chr1","40814392","40814505","chr14","41039002","41039115","3","224610"
"chr1","40814812","40814845","chr14","41038629","41038662","0","223817"
"chr1","40815149","40815310","chr14","41038166","41038328","4","223017"
"chr1","40944887","40945102","chr14","40898675","40898890","8","46212"
"chr1","40973533","40973826","chr14","40868217","40868514","14","105316"
"chr1","41027425","41027711","chr14","40810685","40810962","15","216740"
"chr1","41236637","41236920","chr14","40598258","40598542","9","638379"
"chr1","41419239","41419512","chr14","41248562","41248838","10","170677"
"chr1","41492421","41492720","chr14","41321632","41321920","43","170789"
"chr1","41494058","41494375","chr14","41323293","41323610","11","170765"
"chr1","41498873","41499139","chr14","41328113","41328381","11","170760"
"chr1","41568411","41568733","chr14","41399278","41399578","40","169133"
"chr1","41583243","41583330","chr14","41417310","41417394","9","165933"
"chr1","41583403","41583691","chr14","41417455","41417765","33","165948"
"chr1","41673649","41673963","chr14","41505517","41505823","10","168132"
"chr1","41684603","41684889","chr14","41516475","41516769","16","168128"
"chr1","41685843","41686116","chr14","41517737","41518010","7","168106"
"chr1","41741996","41742292","chr14","41574236","41574541","20","167760"
"chr1","41809393","41809679","chr14","41635619","41635905","6","173774"
"chr1","41824315","41824595","chr4","38371100","38371378","52","3453215"
"chr1","41834526","41834783","chr14","41660361","41660618","3","174165"
"chr1","41930602","41930909","chr14","41758959","41759241","31","171643"
"chr1","42145197","42145423","chr14","41972088","41972322","12","173109"
"chr1","42180977","42181259","chr14","42009803","42010097","17","171174"
"chr1","42191114","42191428","chr20","27160084","27160391","67","15031030"
"chr1","42268353","42268650","chr2","184003214","184003505","74","141734861"
"chr1","42323340","42323639","chr14","42153506","42153801","24","169834"
"chr1","42325837","42326087","chr14","42156000","42156250","4","169837"
"chr1","42347134","42347295","chr8","63744922","63745087","37","21397788"
"chr1","42347660","42347682","chr13","125432389","125432411","4","83084729"
"chr1","42510893","42511051","chr14","42336635","42336778","16","174258"
"chr1","42571606","42571925","chr7","36930890","36931204","80","5640716"
"chr1","42598723","42599010","chr2","48846018","48846311","75","6247295"
"chr1","42681364","42681488","chr12","95010795","95010913","37","52329431"
"chr1","42714430","42714655","chr14","42540318","42540543","11","174112"
"chr1","42790577","42790878","chr14","42614461","42614763","7","176116"
"chr1","42819583","42819894","chr14","42643684","42643995","6","175899"
"chr1","42969517","42969828","chr14","42800487","42800794","11","169030"
"chr1","43066990","43067167","chr14","42904631","42904815","11","162359"
"chr1","43103118","43103340","chr14","42948938","42949159","32","154180"
"chr1","43143919","43144224","chr14","42996824","42997131","9","147095"
"chr1","43191934","43192165","chr14","43044735","43044966","2","147199"
"chr1","43391143","43391413","chr3","44433638","44433901","62","1042495"
"chr1","43591204","43591507","chr14","43477769","43478074","8","113435"
"chr1","43766472","43766735","chr14","43657701","43657898","68","108771"
"chr1","43768956","43769250","chr14","43660129","43660422","7","108827"
"chr1","43812340","43812620","chr14","43703916","43704201","15","108424"
"chr1","43895275","43895394","chr14","43787897","43788014","6","107378"
"chr1","43895420","43895585","chr14","43788037","43788202","7","107383"
"chr1","43912461","43912768","chr14","43804992","43805299","8","107469"
"chr1","43913311","43913605","chr14","43805840","43806135","5","107471"
"chr1","43918887","43919164","chr14","43811430","43811716","14","107457"
"chr1","43948905","43949228","chr14","43841750","43842101","55","107155"
"chr1","44123464","44123759","chr14","44017951","44018244","8","105513"
"chr1","44230245","44230553","chr14","44126254","44126564","16","103991"
"chr1","44297468","44297643","chr14","44194472","44194647","4","102996"
"chr1","44414114","44414427","chr14","44311575","44311883","14","102539"
"chr1","44415471","44415749","chr14","44312929","44313207","9","102542"
"chr1","44428512","44428791","chr14","44326412","44326689","7","102100"
"chr1","44434172","44434479","chr14","44332085","44332382","17","102087"
"chr1","44439233","44439573","chr14","44337156","44337495","10","102077"
"chr1","44459884","44460165","chr14","44360524","44360805","5","99360"
"chr1","44462859","44462938","chr14","44363486","44363564","1","99373"
"chr1","44482111","44482411","chr14","44382986","44383287","14","99125"
"chr1","44580052","44580359","chr14","44474261","44474564","8","105791"
"chr1","44596468","44596734","chr14","44490651","44490917","5","105817"
"chr1","44636499","44636828","chr14","44530666","44530997","7","105833"
"chr1","44654822","44655114","chr14","44549144","44549436","12","105678"
"chr1","44674600","44674908","chr14","44568664","44568967","11","105936"
"chr1","44689296","44689599","chr12","38919021","38919319","64","5770275"
"chr1","44740033","44740092","chr16","40153355","40153413","9","4586678"
"chr1","44744496","44744799","chr14","44638222","44638529","8","106274"
"chr1","44774367","44774678","chr14","44669113","44669419","14","105254"
"chr1","44834217","44834508","chr14","44728265","44728565","14","105952"
"chr1","44858104","44858416","chr14","44751089","44751401","8","107015"
"chr1","44861450","44861753","chr14","44754428","44754731","17","107022"
"chr1","44964858","44965163","chr14","44857353","44857658","3","107505"
"chr1","45002741","45003044","chr14","44893630","44893932","7","109111"
"chr1","45003126","45003290","chr14","44894015","44894176","6","109111"
"chr1","45003591","45003605","chr14","44894488","44894502","1","109103"
"chr1","45054464","45054744","chr14","44945120","44945395","9","109344"
"chr1","45064498","45064734","chr16","16316449","16316692","61","28748049"
"chr1","45089639","45089934","chr14","44979942","44980225","18","109697"
"chr1","45182252","45182370","chr14","45072978","45073096","6","109274"
"chr1","45182655","45182806","chr14","45073384","45073541","8","109271"
"chr1","45268084","45268294","chr14","45160310","45160521","7","107774"
"chr1","45304261","45304527","chr14","45196773","45197039","1","107488"
"chr1","45373460","45373736","chr14","45267897","45268172","9","105563"
"chr1","45709142","45709434","chr14","45604214","45604506","5","104928"
"chr1","45732956","45733263","chr14","45627860","45628167","5","105096"
"chr1","45738586","45738847","chr14","45633454","45633715","7","105132"
"chr1","45768693","45768969","chr14","45664331","45664611","6","104362"
"chr1","45779509","45779802","chr14","45675149","45675442","6","104360"
"chr1","45791782","45792078","chr14","45687435","45687730","10","104347"
"chr1","45828158","45828473","chr14","45724041","45724332","32","104117"
"chr1","45881239","45881520","chr14","45778818","45779099","6","102421"
"chr1","45948866","45949181","chr1","33067744","33068053","64","12881122"
"chr1","45976814","45977093","chr14","45876458","45876737","6","100356"
"chr1","46022683","46022957","chr14","45924829","45925103","16","97854"
"chr1","46044071","46044372","chr14","45968374","45968682","52","75697"
"chr1","46066282","46066588","chr14","45968374","45968682","10","97908"
"chr1","46256078","46256374","chr14","46216688","46216983","2","39390"
"chr1","46269449","46269762","chr14","46231427","46231734","13","38022"
"chr1","46286614","46286887","chr18","38169558","38169838","53","8117056"
"chr1","46310763","46311041","chr11","76820429","76820700","73","30509666"
"chr1","46339152","46339313","chr12","93466662","93466820","28","47127510"
"chr1","46339314","46339373","chr1","31252960","31253021","9","15086354"
"chr1","46355976","46356283","chr14","46322594","46322905","12","33382"
"chr1","46364571","46364849","chr14","46330350","46330637","18","34221"
"chr1","46365427","46365549","chr14","46331215","46331337","0","34212"
"chr1","46365857","46366023","chr14","46331638","46331803","2","34219"
"chr1","46367998","46368115","chr13","63120596","63120714","20","16752598"
"chr1","46370975","46371281","chr13","38458179","38458494","62","7912796"
"chr1","46394807","46394996","chr14","46363093","46363282","1","31714"
"chr1","46399573","46399860","chr14","46367849","46368136","8","31724"
"chr1","46406877","46407178","chr14","46375050","46375341","16","31827"
"chr1","46407185","46407477","chr14","46375348","46375639","5","31837"
"chr1","46409826","46410111","chr14","46377687","46377977","5","32139"
"chr1","46417413","46417624","chr14","46385854","46386062","5","31559"
"chr1","46417705","46417767","chr12","14531859","14531921","8","31885846"
"chr1","46424556","46424863","chr14","46393020","46393325","10","31536"
"chr1","46432074","46432318","chr14","46400553","46400801","7","31521"
"chr1","46452220","46452409","chr4","15950711","15950896","44","30501509"
"chr1","46454082","46454311","chr6","101193819","101194038","62","54739737"
"chr1","46466219","46466539","chr14","46436986","46437302","12","29233"
"chr1","46470315","46470612","chr14","46441066","46441363","3","29249"
"chr1","46478630","46478922","chr14","46450445","46450737","4","28185"
"chr1","46491368","46491654","chr1","159614491","159614771","57","113123123"
"chr1","46493727","46494035","chr14","46466109","46466410","13","27618"
"chr1","46514756","46515034","chr14","46488784","46489070","14","25972"
"chr1","46524253","46524530","chr2","86171951","86172203","65","39647698"
"chr1","46530633","46530923","chr14","46503335","46503621","22","27298"
"chr1","46543067","46543256","chr14","46518208","46518399","9","24859"
"chr1","46546280","46546565","chr14","46521228","46521526","23","25052"
"chr1","46547550","46547782","chr14","46522418","46522681","34","25132"
"chr1","46551793","46551927","chr16","69527085","69527215","29","22975292"
"chr1","46554830","46554951","chr10","70785006","70785125","27","24230176"
"chr1","46558293","46558377","chr14","46541516","46541615","17","16777"
"chr1","46565199","46565357","chr14","46536126","46536299","19","29073"
"chr1","46566197","46566351","chr14","46537140","46537294","6","29057"
"chr1","46568914","46569242","chr14","46544876","46545196","14","24038"
"chr1","46582134","46582346","chr3","151532303","151532521","62","104950169"
"chr1","46582369","46582490","chr14","46562878","46562994","11","19491"
"chr1","46585123","46585348","chr14","46565689","46565918","8","19434"
"chr1","46586360","46586641","chr14","46566926","46567182","31","19434"
"chr1","46586690","46587007","chr14","46567223","46567536","13","19467"
"chr1","46596568","46596854","chr14","46577661","46577970","28","18907"
"chr1","46610937","46611235","chr14","46592656","46592954","6","18281"
"chr1","46628169","46628483","chr14","46609520","46609820","22","18649"
"chr1","46633160","46633473","chr14","15585030","15585344","57","31048130"
"chr1","46634361","46634672","chr14","46615677","46615988","4","18684"
"chr1","46657238","46657540","chr13","23206684","23206979","62","23450554"
"chr1","46679454","46679764","chr14","46666854","46667163","4","12600"
"chr1","46688991","46689224","chr14","46663061","46663321","30","25930"
"chr1","46699186","46699489","chr14","46682930","46683233","4","16256"
"chr1","46717378","46717692","chr14","46701115","46701429","10","16263"
"chr1","46721738","46722028","chr7","30922039","30922336","55","15799699"
"chr1","46726944","46727177","chr13","41091235","41091484","77","5635709"
"chr1","46736440","46736739","chr14","46719715","46720018","19","16725"
"chr1","46847997","46848285","chr14","46866200","46866511","34","18203"
"chr1","46851435","46851730","chr14","46869765","46870085","31","18330"
"chr1","46864824","46865134","chr14","46883200","46883510","12","18376"
"chr1","46876699","46876996","chr14","46895060","46895357","5","18361"
"chr1","46877014","46877299","chr14","46895375","46895660","4","18361"
"chr1","46891992","46892169","chr2","86410514","86410685","40","39518522"
"chr1","46892170","46892224","chr11","100687851","100687903","10","53795681"
"chr1","46909204","46909387","chr14","46927193","46927353","28","17989"
"chr1","46909698","46909835","chr14","46927671","46927806","4","17973"
"chr1","46931386","46931683","chr8","68808553","68808854","53","21877167"
"chr1","46933041","46933348","chr4","103468600","103468909","55","56535559"
"chr1","46952534","46952695","chr14","46970342","46970503","1","17808"
"chr1","46972454","46972722","chr14","46990242","46990512","5","17788"
"chr1","46987695","46987996","chr14","47005708","47006010","4","18013"
"chr1","47058832","47059111","chr14","47078095","47078374","6","19263"
"chr1","47153504","47153821","chr14","47177165","47177451","46","23661"
"chr1","47269815","47270096","chr14","47293933","47294237","33","24118"
"chr1","47270249","47270559","chr4","52961724","52962009","87","5691475"
"chr1","47270614","47270630","chr12","83941902","83941919","1","36671288"
"chr1","47301936","47302058","chr14","47326391","47326513","1","24455"
"chr1","47311137","47311431","chr14","47334821","47335116","12","23684"
"chr1","47352566","47352866","chr14","47376195","47376491","9","23629"
"chr1","47408343","47408645","chr14","47431885","47432189","12","23542"
"chr1","47432472","47432782","chr14","47457014","47457322","13","24542"
"chr1","47438986","47439292","chr14","47464516","47464822","2","25530"
"chr1","47445322","47445614","chr14","47470669","47470961","13","25347"
"chr1","47491845","47491951","chr14","47515481","47515590","7","23636"
"chr1","47505135","47505405","chr14","47528758","47529036","12","23623"
"chr1","47505554","47505620","chr14","47529196","47529259","6","23642"
"chr1","47562500","47562783","chr14","47585065","47585389","51","22565"
"chr1","47607749","47608062","chr14","47621331","47621639","12","13582"
"chr1","47609858","47610116","chr14","47624459","47624742","29","14601"
"chr1","47610706","47610931","chr14","47625309","47625534","2","14603"
"chr1","47653567","47653621","chr14","47668388","47668449","7","14821"
"chr1","47654234","47654415","chr14","47669060","47669241","8","14826"
"chr1","47666819","47667095","chr11","31053966","31054248","47","16612853"
"chr1","47680084","47680310","chr14","47694839","47695063","8","14755"
"chr1","47681077","47681337","chr14","47695836","47696096","5","14759"
"chr1","47685723","47686033","chr14","47700422","47700731","8","14699"
"chr1","47686468","47686685","chr14","47701190","47701409","2","14722"
"chr1","47692174","47692466","chr14","47706901","47707193","3","14727"
"chr1","47700783","47701074","chr14","47715494","47715790","15","14711"
"chr1","47707875","47708108","chr4","43105703","43105947","60","4602172"
"chr1","47729093","47729395","chr14","47743379","47743681","4","14286"
"chr1","47739179","47739476","chr14","47753729","47754035","19","14550"
"chr1","47740926","47740992","chr1","30644596","30644660","11","17096330"
"chr1","47748752","47749024","chr2","157473049","157473326","51","109724297"
"chr1","47749470","47749771","chr14","47764731","47765042","16","15261"
"chr1","47765353","47765641","chr14","47780602","47780895","10","15249"
"chr1","47770518","47770811","chr14","47786082","47786384","13","15564"
"chr1","47774854","47775166","chr14","47790452","47790742","30","15598"
"chr1","47779959","47780257","chr14","47796087","47796383","9","16128"
"chr1","47783917","47784227","chr14","47800049","47800359","6","16132"
"chr1","47784534","47784795","chr14","47800606","47800889","29","16072"
"chr1","47785573","47785773","chr14","47801648","47801860","20","16075"
"chr1","47798425","47798709","chr14","47814479","47814763","8","16054"
"chr1","47801288","47801484","chr14","47817331","47817538","12","16043"
"chr1","47805203","47805476","chr14","47820830","47821128","29","15627"
"chr1","47810242","47810501","chr14","47826209","47826465","7","15967"
"chr1","47840263","47840573","chr14","47856421","47856730","4","16158"
"chr1","47842396","47842699","chr14","47858558","47858859","5","16162"
"chr1","47845720","47846019","chr14","47862047","47862352","9","16327"
"chr1","47855117","47855381","chr14","47870332","47870584","23","15215"
"chr1","47870218","47870519","chr14","47886122","47886423","5","15904"
"chr1","47873128","47873250","chr14","47889034","47889156","1","15906"
"chr1","47878842","47879137","chr14","47894744","47895048","14","15902"
"chr1","47888636","47888931","chr14","47894744","47895048","14","6108"
"chr1","47897589","47897703","chrX","45892592","45892708","39","2004997"
"chr1","47897904","47898089","chr14","47914196","47914384","6","16292"
"chr1","47926330","47926620","chr14","47939542","47939831","7","13212"
"chr1","47928113","47928389","chr14","47941319","47941594","5","13206"
"chr1","47940832","47941137","chr14","47954059","47954364","3","13227"
"chr1","47964556","47964780","chr7","123708653","123708877","41","75744097"
"chr1","47973779","47973971","chr14","105574684","105574870","46","57600905"
"chr1","47975570","47975870","chr14","47991282","47991578","7","15712"
"chr1","47977873","47978160","chr14","47993502","47993795","14","15629"
"chr1","47990207","47990514","chr14","48005801","48006107","9","15594"
"chr1","48019347","48019656","chr14","48035485","48035788","12","16138"
"chr1","48039880","48040183","chr14","48056061","48056364","8","16181"
"chr1","48053048","48053341","chr14","48069673","48069988","34","16625"
"chr1","48056156","48056392","chr14","48073101","48073346","15","16945"
"chr1","48067847","48068153","chr14","48085158","48085470","14","17311"
"chr1","48069497","48069793","chr14","48086826","48087122","0","17329"
"chr1","48073415","48073712","chr14","48090741","48091035","9","17326"
"chr1","48097149","48097424","chr14","48114751","48115042","18","17602"
"chr1","48107772","48108063","chr14","48125589","48125880","9","17817"
"chr1","48177999","48178303","chr14","48196261","48196564","6","18262"
"chr1","48201601","48201925","chr14","48219829","48220153","6","18228"
"chr1","48219813","48220105","chr14","48239371","48239629","37","19558"
"chr1","48227914","48228202","chr14","48247447","48247735","8","19533"
"chr1","48247663","48247970","chr14","48263022","48263314","34","15359"
"chr1","48285491","48285577","chr14","48305582","48305668","1","20091"
"chr1","48285610","48285773","chr14","48305701","48305870","10","20091"
"chr1","48295735","48296024","chr14","48315793","48316083","10","20058"
"chr1","48347079","48347357","chr14","48372102","48372380","9","25023"
"chr1","48400685","48400988","chr14","48429886","48430191","8","29201"
"chr1","48415126","48415424","chr14","48446429","48446720","13","31303"
"chr1","48474369","48474616","chr3","109917225","109917477","61","61442856"
"chr1","48475138","48475418","chr14","48506459","48506736","5","31321"
"chr1","48518572","48518882","chr14","48548198","48548495","21","29626"
"chr1","48562013","48562215","chr14","48591145","48591346","3","29132"
"chr1","48709569","48709722","chr14","48739094","48739258","16","29525"
"chr1","48816509","48816791","chr14","48864786","48865099","34","48277"
"chr1","48821931","48822132","chr13","42098208","42098404","55","6723723"
"chr1","49098555","49098842","chr14","49146422","49146689","21","47867"
"chr1","49276685","49276921","chr14","49322965","49323201","5","46280"
"chr1","49285551","49285687","chr7","8262779","8262919","29","41022772"
"chr1","49481690","49482022","chr14","49528220","49528553","10","46530"
"chr1","49544609","49544899","chr14","49591816","49592109","8","47207"
"chr1","49690995","49691142","chr10","65746323","65746471","25","16055328"
"chr1","49691175","49691270","chrX","62928695","62928788","19","13237520"
"chr1","49787179","49787473","chr14","49838815","49839108","8","51636"
"chr1","49812296","49812590","chr14","49864365","49864657","11","52069"
"chr1","49963070","49963367","chr14","50025551","50025850","15","62481"
"chr1","50047565","50047665","chr14","50110694","50110794","3","63129"
"chr1","50073731","50074048","chr14","50136866","50137184","6","63135"
"chr1","50099322","50099606","chr14","50164190","50164473","8","64868"
"chr1","50185348","50185642","chr20","27160084","27160391","65","23025264"
"chr1","50209424","50209722","chr14","50281280","50281572","14","71856"
"chr1","50214432","50214724","chr14","50285818","50286119","12","71386"
"chr1","50237774","50238085","chr14","50310204","50310518","19","72430"
"chr1","50244398","50244684","chr14","50316863","50317150","8","72465"
"chr1","50264152","50264285","chr14","50339735","50339868","1","75583"
"chr1","50272689","50272963","chr9","113660587","113660871","63","63387898"
"chr1","50285492","50285613","chr14","50361430","50361552","3","75938"
"chr1","50319847","50320162","chr8","75547570","75547888","61","25227723"
"chr1","50322045","50322297","chr14","50399230","50399477","6","77185"
"chr1","50340888","50341174","chr14","50417954","50418239","5","77066"
"chr1","50353934","50354238","chr14","50430876","50431180","5","76942"
"chr1","50359616","50359904","chr1","14602906","14603171","86","35756710"
"chr1","50418397","50418587","chr14","50497867","50498061","7","79470"
"chr1","50422784","50423063","chr14","50502244","50502523","5","79460"
"chr1","50430694","50430995","chr14","50510169","50510470","4","79475"
"chr1","50455244","50455340","chr11","110032530","110032623","24","59577286"
"chr1","50455665","50455836","chrX","37210223","37210398","32","13245442"
"chr1","50467377","50467667","chr14","50543810","50544098","5","76433"
"chr1","50474405","50474686","chr14","50551161","50551442","2","76756"
"chr1","50481932","50482228","chr14","50558480","50558786","18","76548"
"chr1","50485172","50485448","chr14","50561892","50562089","83","76720"
"chr1","50485496","50485615","chr14","50562208","50562314","14","76712"
"chr1","50486250","50486547","chr14","50562949","50563245","3","76699"
"chr1","50542665","50542941","chr14","50619159","50619436","15","76494"
"chr1","50547058","50547324","chr14","50623515","50623803","35","76457"
"chr1","50552604","50552882","chr14","50629077","50629359","10","76473"
"chr1","50554440","50554608","chr14","50630766","50630918","17","76326"
"chr1","50556427","50556607","chr14","50632782","50632970","10","76355"
"chr1","50556610","50556658","chr5","58115037","58115082","10","7558427"
"chr1","50563296","50563620","chr14","50639365","50639689","9","76069"
"chr1","50564326","50564638","chr14","50640392","50640708","9","76066"
"chr1","50578959","50579280","chr14","50655006","50655327","7","76047"
"chr1","50589089","50589235","chr14","50665137","50665283","1","76048"
"chr1","50597476","50597771","chr14","50673573","50673872","11","76097"
"chr1","50615487","50615628","chr14","50691842","50691985","7","76355"
"chr1","50615953","50615997","chr3","103316080","103316129","9","52700127"
"chr1","50639959","50640173","chr14","50720857","50721071","3","80898"
"chr1","50644926","50645222","chr14","50725828","50726124","9","80902"
"chr1","50664517","50664728","chr14","50745436","50745648","2","80919"
"chr1","50680417","50680684","chr14","50760550","50760839","32","80133"
"chr1","50683283","50683570","chr14","50763418","50763705","3","80135"
"chr1","50726344","50726635","chr14","50814237","50814530","6","87893"
"chr1","50900127","50900426","chr14","50992012","50992312","6","91885"
"chr1","50932545","50932845","chr14","51024862","51025159","9","92317"
"chr1","50961326","50961623","chr14","51053684","51053980","6","92358"
"chr1","51012797","51013083","chr14","51105058","51105342","6","92261"
"chr1","51048744","51049043","chr14","51142657","51142954","7","93913"
"chr1","51114521","51114810","chr14","51208125","51208413","9","93604"
"chr1","51135866","51136050","chr14","51229506","51229703","13","93640"
"chr1","51155932","51156240","chr14","51249899","51250192","23","93967"
"chr1","51166523","51166788","chr14","51260607","51260871","39","94084"
"chr1","51200686","51200839","chr14","51300390","51300544","11","99704"
"chr1","51206370","51206665","chr14","51306065","51306369","18","99695"
"chr1","51219154","51219454","chr14","51312149","51312448","21","92995"
"chr1","51266380","51266675","chr14","51361147","51361416","28","94767"
"chr1","51273344","51273649","chr14","51367998","51368311","11","94654"
"chr1","51322746","51323019","chr14","51417550","51417822","10","94804"
"chr1","51332969","51333278","chr3","39858453","39858763","57","11474516"
"chr1","51343060","51343378","chr14","51438030","51438348","6","94970"
"chr1","51347854","51347979","chr14","51448025","51448150","2","100171"
"chr1","51366718","51367006","chr14","51466963","51467254","12","100245"
"chr1","51397479","51397718","chr14","51496979","51497216","8","99500"
"chr1","51408205","51408505","chr14","51506897","51507195","6","98692"
"chr1","51408624","51408810","chr14","51507316","51507502","3","98692"
"chr1","51409223","51409350","chr14","51507913","51508040","0","98690"
"chr1","51434080","51434356","chr14","51534743","51535019","5","100663"
"chr1","51444066","51444350","chr14","51544748","51545031","5","100682"
"chr1","51445049","51445342","chr14","51545730","51546023","2","100681"
"chr1","51470143","51470431","chr14","51570085","51570373","8","99942"
"chr1","51535479","51535708","chr14","51633651","51633880","3","98172"
"chr1","51583076","51583349","chr14","51680902","51681175","6","97826"
"chr1","51604203","51604501","chr14","51704786","51705082","10","100583"
"chr1","51615303","51615437","chr5","15629045","15629183","37","35986258"
"chr1","51617347","51617626","chr14","51718215","51718488","17","100868"
"chr1","51670693","51671001","chr14","51771845","51772143","17","101152"
"chr1","51674599","51674923","chr14","51775766","51776081","15","101167"
"chr1","51679349","51679648","chr14","51780532","51780831","9","101183"
"chr1","51728929","51729212","chr14","51829751","51830016","21","100822"
"chr1","51730517","51730797","chr14","51831332","51831618","37","100815"
"chr1","51860987","51861260","chr14","51960132","51960405","7","99145"
"chr1","51867741","51867953","chr14","51966882","51967083","19","99141"
"chr1","51879562","51879845","chr3","5972689","5972973","78","45906873"
"chr1","51880205","51880414","chr14","51979390","51979608","10","99185"
"chr1","51951710","51952018","chr14","52052844","52053152","5","101134"
"chr1","51963187","51963495","chr14","52064355","52064655","21","101168"
"chr1","51983417","51983724","chr14","52085328","52085651","23","101911"
"chr1","51985582","51985884","chr1","183390850","183391147","51","131405268"
"chr1","52044101","52044385","chr14","52146155","52146457","21","102054"
"chr1","52058645","52058875","chr14","52160670","52160905","12","102025"
"chr1","52114511","52114769","chr14","52216423","52216666","17","101912"
"chr1","52127037","52127083","chr14","52228946","52228992","1","101909"
"chr1","52127085","52127162","chr14","52228994","52229067","6","101909"
"chr1","52128235","52128541","chr14","52230150","52230449","12","101915"
"chr1","52131226","52131521","chr14","52233122","52233415","5","101896"
"chr1","52150973","52151257","chr14","52252871","52253155","8","101898"
"chr1","52168824","52169128","chr14","52270545","52270849","4","101721"
"chr1","52171670","52171933","chr9","59620205","59620469","68","7448535"
"chr1","52178758","52179043","chr3","124418934","124419233","59","72240176"
"chr1","52182384","52182684","chr14","52281799","52282085","19","99415"
"chr1","52187327","52187548","chr14","52286742","52286963","3","99415"
"chr1","52196410","52196709","chr1","162336287","162336584","54","110139877"
"chr1","52202617","52202851","chr14","52301910","52302132","15","99293"
"chr1","52204151","52204456","chr14","52303517","52303817","10","99366"
"chr1","52275127","52275402","chr14","52374530","52374804","7","99403"
"chr1","52290122","52290318","chr14","52389538","52389734","9","99416"
"chr1","52317284","52317576","chr14","51208125","51208413","56","1109159"
"chr1","52322100","52322394","chr14","52422542","52422836","7","100442"
"chr1","52354741","52355045","chr14","52454470","52454779","9","99729"
"chr1","52360514","52360819","chr14","52460189","52460500","12","99675"
"chr1","52365226","52365470","chr14","52464871","52465147","40","99645"
"chr1","52380595","52380908","chr14","52480867","52481175","16","100272"
"chr1","52416457","52416727","chr14","52517556","52517824","11","101099"
"chr1","52434365","52434517","chr14","52535390","52535555","14","101025"
"chr1","52548390","52548665","chr14","52654330","52654606","4","105940"
"chr1","52623377","52623600","chr14","52729090","52729316","10","105713"
"chr1","52645176","52645460","chr14","52750502","52750786","5","105326"
"chr1","52653006","52653302","chr14","52758227","52758523","5","105221"
"chr1","52658218","52658353","chr14","52763417","52763552","5","105199"
"chr1","52660157","52660464","chr14","52765358","52765660","19","105201"
"chr1","52664848","52665139","chr14","52770590","52770875","17","105742"
"chr1","52684801","52684907","chr14","52790438","52790544","0","105637"
"chr1","52735042","52735351","chr14","52841335","52841646","15","106293"
"chr1","52766734","52766911","chr14","52872997","52873170","4","106263"
"chr1","52767191","52767207","chr14","52873451","52873467","0","106260"
"chr1","52768641","52768963","chr14","32624216","32624537","65","20144425"
"chr1","52769490","52769783","chr14","52876086","52876373","9","106596"
"chr1","52772538","52772832","chr14","52879118","52879412","6","106580"
"chr1","52784696","52785004","chr14","52891130","52891437","9","106434"
"chr1","52786067","52786174","chr14","52892496","52892602","3","106429"
"chr1","52914447","52914732","chr14","53021790","53022081","15","107343"
"chr1","52996049","52996352","chr14","53103325","53103615","16","107276"
"chr1","53003084","53003391","chr14","53110345","53110652","5","107261"
"chr1","53010712","53010870","chr6","66227817","66227968","35","13217105"
"chr1","53010901","53011011","chr2","186300207","186300314","29","133289306"
"chr1","53044067","53044330","chr3","45100383","45100650","51","7943684"
"chr1","53087294","53087600","chr14","53194609","53194915","3","107315"
"chr1","53110650","53110935","chr14","53218248","53218533","4","107598"
"chr1","53123495","53123788","chr14","53231047","53231339","9","107552"
"chr1","53139674","53139967","chr14","53255333","53255625","8","115659"
"chr1","53144024","53144333","chr14","53259724","53260007","32","115700"
"chr1","53148110","53148401","chr14","53263800","53264090","2","115690"
"chr1","53213217","53213341","chr14","53330918","53331043","3","117701"
"chr1","53326068","53326351","chr14","53449625","53449913","12","123557"
"chr1","53358321","53358653","chr14","53481998","53482322","18","123677"
"chr1","53375456","53375741","chr14","53499106","53499391","5","123650"
"chr1","53491485","53491799","chr14","53613879","53614193","8","122394"
"chr1","53633512","53633829","chr14","53764033","53764339","20","130521"
"chr1","53671579","53671878","chr14","53801753","53802049","8","130174"
"chr1","53771513","53771658","chr10","30604017","30604157","41","23167496"
"chr1","53771729","53771845","chr1","1620358","1620474","17","52151371"
"chr1","53805042","53805187","chr14","118945688","118945833","40","65140646"
"chr1","53828952","53829221","chr14","53961837","53962122","20","132885"
"chr1","53857770","53858078","chr14","53995017","53995330","19","137247"
"chr1","53939834","53940110","chr14","54081737","54082026","23","141903"
"chr1","53943647","53943905","chr14","54090400","54090654","7","146753"
"chr1","53948326","53948466","chr14","3185257","3185403","30","50763069"
"chr1","53961267","53961564","chr14","54108927","54109226","6","147660"
"chr1","53962262","53962589","chr14","54109924","54110252","5","147662"
"chr1","53967018","53967319","chr14","54111420","54111721","9","144402"
"chr1","53978827","53979020","chr14","54123584","54123745","35","144757"
"chr1","53987204","53987496","chr14","54132457","54132742","12","145253"
"chr1","53993281","53993576","chr14","54138964","54139260","12","145683"
"chr1","54006569","54006869","chr14","54152120","54152418","11","145551"
"chr1","54010461","54010763","chr14","54156301","54156610","12","145840"
"chr1","54013705","54013914","chr5","153153513","153153726","50","99139808"
"chr1","54014106","54014339","chr14","54159535","54159779","17","145429"
"chr1","54027862","54028140","chr14","54172954","54173241","15","145092"
"chr1","54032359","54032433","chr6","170412390","170412455","25","116380031"
"chr1","54032481","54032711","chr14","54177475","54177686","47","144994"
"chr1","54032730","54032903","chr9","108993260","108993425","37","54960530"
"chr1","54037376","54037672","chr14","54182366","54182663","3","144990"
"chr1","54037817","54038114","chr14","54182811","54183117","12","144994"
"chr1","54064858","54065149","chr14","54209332","54209619","12","144474"
"chr1","54066261","54066419","chr7","108133653","108133813","36","54067392"
"chr1","54070551","54070845","chr14","54215025","54215320","6","144474"
"chr1","54080470","54080611","chr14","54224942","54225083","1","144472"
"chr1","54095716","54096025","chr14","54234701","54235015","11","138985"
"chr1","54114507","54114704","chr14","54253304","54253536","38","138797"
"chr1","54199432","54199705","chr14","54339002","54339275","6","139570"
"chr1","54233924","54234008","chr10","61763786","61763870","13","7529862"
"chr1","54234289","54234522","chr7","40872150","40872364","51","13362139"
"chr1","54251737","54251838","chr14","54391133","54391212","24","139396"
"chr1","54342658","54342976","chr14","54481009","54481327","9","138351"
"chr1","54364783","54365067","chr14","54503215","54503499","4","138432"
"chr1","54367189","54367472","chr14","54505633","54505914","29","138444"
"chr1","54367837","54368147","chr14","54506279","54506586","8","138442"
"chr1","54387687","54387983","chr14","54526258","54526554","10","138571"
"chr1","54441335","54441631","chr14","54583281","54583589","21","141946"
"chr1","54445444","54445745","chr14","54587390","54587690","7","141946"
"chr1","54461499","54461771","chr14","54603757","54604029","6","142258"
"chr1","54472530","54472828","chr14","54615291","54615587","7","142761"
"chr1","54472907","54473217","chr14","54615666","54615975","9","142759"
"chr1","54473660","54473772","chr10","30806784","30806890","27","23666876"
"chr1","54479858","54480022","chr14","54622754","54622919","6","142896"
"chr1","54486794","54487093","chr14","54629957","54630260","7","143163"
"chr1","54488119","54488429","chr14","54631296","54631571","41","143177"
"chr1","54489249","54489551","chr14","54632398","54632701","5","143149"
"chr1","54495004","54495309","chr14","54638131","54638418","24","143127"
"chr1","54509705","54509884","chr14","54654409","54654588","4","144704"
"chr1","54525189","54525328","chr16","49484330","49484464","23","5040859"
"chr1","54540272","54540531","chr14","54685529","54685788","2","145257"
"chr1","54548006","54548138","chr11","121305652","121305783","24","66757646"
"chr1","54552382","54552645","chr14","54698260","54698521","3","145878"
"chr1","54557003","54557304","chr14","54703190","54703492","6","146187"
"chr1","54559416","54559728","chr14","54705578","54705880","17","146162"
"chr1","54563932","54564188","chr14","54710520","54710775","3","146588"
"chr1","54567982","54568247","chr14","54714284","54714549","10","146302"
"chr1","54568258","54568507","chr14","54714560","54714809","1","146302"
"chr1","54571487","54571779","chr14","54717779","54718068","9","146292"
"chr1","54580607","54580911","chr14","54726720","54727023","6","146113"
"chr1","54587224","54587524","chr14","54733381","54733684","10","146157"
"chr1","54589569","54589833","chr14","54735855","54736111","13","146286"
"chr1","54603587","54603702","chr14","54749851","54749966","1","146264"
"chr1","54608828","54609133","chr14","54755103","54755409","8","146275"
"chr1","54622936","54623228","chr14","54768784","54769073","6","145848"
"chr1","54637144","54637390","chr14","54788476","54788721","5","151332"
"chr1","54663178","54663462","chr14","54814383","54814666","6","151205"
"chr1","54675051","54675161","chr14","54825789","54825899","1","150738"
"chr1","54724235","54724531","chr14","54874573","54874869","6","150338"
"chr1","54739594","54739900","chr14","54889808","54890115","9","150214"
"chr1","54759884","54760048","chr14","54907433","54907603","9","147549"
"chr1","54760076","54760225","chr14","54907626","54907775","5","147550"
"chr1","54802094","54802388","chr14","54950733","54951025","9","148639"
"chr1","54805733","54805918","chr13","70022938","70023130","42","15217205"
"chr1","54837542","54837798","chr14","54986321","54986578","6","148779"
"chr1","54837799","54837916","chr14","54986579","54986692","6","148780"
"chr1","54844677","54844985","chr14","54993441","54993753","14","148764"
"chr1","54873922","54874105","chr14","55024842","55025025","4","150920"
"chr1","54889054","54889364","chr14","55040327","55040637","5","151273"
"chr1","54901811","54902134","chr14","55046259","55046584","11","144448"
"chr1","54906866","54907162","chr14","55051941","55052237","6","145075"
"chr1","54909542","54909860","chr14","55056224","55056513","37","146682"
"chr1","54918736","54919034","chr14","55066108","55066406","2","147372"
"chr1","54921517","54921814","chr14","55069220","55069512","14","147703"
"chr1","54938634","54938822","chr9","13463995","13464177","47","41474639"
"chr1","54963490","54963779","chr14","55110442","55110731","6","146952"
"chr1","54967532","54967882","chr14","55114806","55115155","5","147274"
"chr1","54974651","54974954","chr14","55122004","55122315","13","147353"
"chr1","54991221","54991509","chr14","55138522","55138840","35","147301"
"chr1","54995490","54995795","chr1","101515728","101516038","59","46520238"
"chr1","55008703","55008996","chr10","26742963","26743263","60","28265740"
"chr1","55016669","55016976","chr1","47272557","47272861","48","7744112"
"chr1","55021405","55021701","chr14","55168986","55169282","4","147581"
"chr1","55032156","55032376","chr14","55180056","55180284","12","147900"
"chr1","55033251","55033562","chr14","55181159","55181473","24","147908"
"chr1","55040827","55041107","chr14","55188997","55189271","10","148170"
"chr1","55045166","55045464","chr14","55193335","55193635","3","148169"
"chr1","55055836","55056141","chr14","55204008","55204307","19","148172"
"chr1","55083171","55083472","chr4","103635327","103635633","47","48552156"
"chr1","55090550","55090811","chr14","55239859","55240116","8","149309"
"chr1","55106067","55106328","chr14","55255210","55255479","13","149143"
"chr1","55106343","55106647","chr14","55255493","55255786","22","149150"
"chr1","55107808","55108119","chr14","55256944","55257267","15","149136"
"chr1","55116047","55116363","chr14","55265122","55265425","23","149075"
"chr1","55121802","55122121","chr14","55270548","55270869","8","148746"
"chr1","55127413","55127560","chr1","205747923","205748058","44","150620510"
"chr1","55132291","55132590","chr14","55281084","55281370","16","148793"
"chr1","55132760","55132895","chr4","103199591","103199725","23","48066831"
"chr1","55137153","55137458","chr14","55285930","55286238","22","148777"
"chr1","55140326","55140693","chr14","55289121","55289447","45","148795"
"chr1","55163896","55164182","chr14","55313978","55314264","1","150082"
"chr1","55165398","55165694","chr9","55802280","55802577","56","636882"
"chr1","55177951","55178178","chr14","55329085","55329314","6","151134"
"chr1","55186076","55186381","chr14","55337791","55338096","8","151715"
"chr1","55186511","55186793","chr14","55338226","55338521","16","151715"
"chr1","55192638","55192791","chr1","9667266","9667402","39","45525372"
"chr1","55200884","55201181","chr14","55352513","55352810","3","151629"
"chr1","55209873","55210166","chr14","55363397","55363690","9","153524"
"chr1","55218344","55218639","chr2","94164770","94165072","54","38946426"
"chr1","55221921","55222202","chr7","150126938","150127230","62","94905017"
"chr1","55223494","55223797","chr4","34410345","34410644","54","20813149"
"chr1","55233101","55233398","chr14","55382185","55382482","6","149084"
"chr1","55248681","55248965","chr14","55397536","55397831","17","148855"
"chr1","55249510","55249805","chr14","55398375","55398679","18","148865"
"chr1","55250246","55250523","chr14","55399078","55399370","20","148832"
"chr1","55252319","55252593","chr14","55401167","55401442","10","148848"
"chr1","55273048","55273350","chr14","55422446","55422749","10","149398"
"chr1","55278031","55278336","chr14","55426817","55427121","9","148786"
"chr1","55278631","55278769","chr14","55427411","55427579","33","148780"
"chr1","55286119","55286411","chr1","217833241","217833529","50","162547122"
"chr1","55291000","55291219","chr14","55438360","55438588","10","147360"
"chr1","55299866","55300115","chr14","55447810","55448058","9","147944"
"chr1","55313852","55314149","chr14","55461417","55461715","2","147565"
"chr1","55319246","55319532","chr14","55467011","55467298","8","147765"
"chr1","55321952","55322231","chr6","133466384","133466659","62","78144432"
"chr1","55322582","55322624","chr14","6765227","6765269","4","48557355"
"chr1","55322846","55323135","chr14","55470899","55471188","2","148053"
"chr1","55323299","55323609","chr14","55471352","55471662","8","148053"
"chr1","55340464","55340625","chr14","55496524","55496685","2","156060"
"chr1","55346121","55346424","chr5","35786577","35786873","59","19559544"
"chr1","55351101","55351239","chr14","55494389","55494526","2","143288"
"chr1","55351839","55352021","chr14","55494823","55495002","8","142984"
"chr1","55357278","55357565","chr14","55507550","55507837","4","150272"
"chr1","55367320","55367611","chr14","55514229","55514520","4","146909"
"chr1","55394008","55394323","chr14","55546787","55547103","11","152779"
"chr1","55401461","55401756","chr14","55555053","55555345","9","153592"
"chr1","55418286","55418492","chr14","55572254","55572463","8","153968"
"chr1","55436707","55436823","chr14","55591984","55592100","4","155277"
"chr1","55443590","55443741","chr14","55599059","55599213","8","155469"
"chr1","55445174","55445451","chr14","55600380","55600657","5","155206"
"chr1","55457591","55457837","chr14","55612994","55613235","11","155403"
"chr1","55458125","55458337","chr14","55613530","55613747","7","155405"
"chr1","55481108","55481280","chr14","55645181","55645344","22","164073"
"chr1","55481581","55481721","chr14","55645658","55645798","3","164077"
"chr1","55485072","55485355","chr14","55649176","55649459","7","164104"
"chr1","55495482","55495784","chr14","109160689","109160990","70","53665207"
"chr1","55504195","55504399","chr14","55666588","55666787","8","162393"
"chr1","55510913","55511140","chr14","55673589","55673816","3","162676"
"chr1","55516707","55516938","chr14","55679149","55679380","5","162442"
"chr1","55524610","55524692","chr14","55693917","55693999","2","169307"
"chr1","55528591","55528704","chr3","620120","620233","16","54908471"
"chr1","55541161","55541300","chr10","70292749","70292884","24","14751588"
"chr1","55549583","55549891","chr19","16104533","16104837","66","39445050"
"chr1","55552930","55553039","chr14","55713475","55713576","12","160545"
"chr1","55555004","55555145","chr14","55715513","55715653","6","160509"
"chr1","55556588","55556883","chr14","55717082","55717379","9","160494"
"chr1","55557523","55557615","chr6","148399651","148399742","17","92842128"
"chr1","55561168","55561304","chr14","55721547","55721683","4","160379"
"chr1","55561620","55561778","chr14","55721993","55722154","4","160373"
"chr1","55562535","55562768","chr14","55722914","55723147","3","160379"
"chr1","55562899","55563190","chr14","55723278","55723581","19","160379"
"chr1","55568428","55568719","chr14","55728496","55728784","8","160068"
"chr1","55572691","55572986","chr14","55732753","55733044","10","160062"
"chr1","55582300","55582585","chr14","55742482","55742767","6","160182"
"chr1","55590963","55591121","chr15","74421930","74422096","36","18830967"
"chr1","55593816","55594063","chr14","55755198","55755445","7","161382"
"chr1","55595643","55595782","chr6","144818898","144819036","29","89223255"
"chr1","55614320","55614637","chr14","55775766","55776084","4","161446"
"chr1","55630485","55630809","chr14","55792848","55793172","5","162363"
"chr1","55635052","55635343","chr14","55797415","55797707","10","162363"
"chr1","55647672","55647883","chr14","55809977","55810227","44","162305"
"chr1","55648946","55649249","chr14","55811266","55811575","13","162320"
"chr1","55653421","55653708","chr14","55815472","55815762","20","162051"
"chr1","55678269","55678556","chr14","55839880","55840167","10","161611"
"chr1","55687398","55687703","chr14","55848850","55849155","4","161452"
"chr1","55691410","55691681","chr14","55852656","55852927","5","161246"
"chr1","55696524","55696816","chr11","41733228","41733516","54","13963296"
"chr1","55712511","55712686","chr14","55872772","55872947","5","160261"
"chr1","55712991","55713134","chr14","55873253","55873396","2","160262"
"chr1","55745773","55746055","chr14","55906124","55906436","31","160351"
"chr1","55748646","55748945","chr9","102340368","102340668","55","46591722"
"chr1","55773182","55773432","chr12","14763301","14763533","58","41009881"
"chr1","55779948","55780249","chr14","55940057","55940356","5","160109"
"chr1","55785684","55785990","chr14","55945788","55946094","8","160104"
"chr1","55810853","55811144","chr14","55971116","55971407","5","160263"
"chr1","55814735","55815050","chr14","55974929","55975231","16","160194"
"chr1","55821847","55822148","chr14","55982034","55982335","7","160187"
"chr1","55829334","55829499","chrX","38716150","38716313","29","17113184"
"chr1","55834222","55834513","chr14","55994528","55994819","6","160306"
"chr1","55853853","55853939","chr1","58740674","58740760","14","2886821"
"chr1","55866471","55866786","chr1","120346116","120346429","73","64479645"
"chr1","55867637","55867944","chr14","56028194","56028501","12","160557"
"chr1","55876631","55876915","chr14","56036680","56036961","6","160049"
"chr1","55880424","55880546","chr14","56040481","56040595","11","160057"
"chr1","55890826","55891035","chr2","181564775","181564973","37","125673949"
"chr1","55905505","55905690","chr14","56065296","56065498","25","159791"
"chr1","55905998","55906132","chr14","56065788","56065922","3","159790"
"chr1","55913679","55913987","chr14","56073463","56073767","8","159784"
"chr1","55932331","55932643","chr14","56092189","56092480","30","159858"
"chr1","55935597","55935901","chr14","56095500","56095801","8","159903"
"chr1","55937804","55938115","chr14","56097837","56098140","15","160033"
"chr1","55949460","55949760","chr14","56109361","56109663","10","159901"
"chr1","55962709","55963043","chr14","56122569","56122904","7","159860"
"chr1","55976926","55977151","chr14","56136526","56136755","11","159600"
"chr1","55979540","55979903","chr14","56139317","56139625","60","159777"
"chr1","55982487","55982797","chr14","56142202","56142513","6","159715"
"chr1","55997401","55997673","chr14","56156964","56157236","9","159563"
"chr1","56014898","56015131","chr1","30729477","30729695","55","25285421"
"chr1","56044369","56044511","chr14","56203052","56203194","1","158683"
"chr1","56054344","56054479","chr14","56213052","56213184","6","158708"
"chr1","56054480","56054773","chr14","56213188","56213481","4","158708"
"chr1","56055655","56055950","chr14","56214348","56214646","11","158693"
"chr1","56058938","56059254","chr14","56217998","56218304","43","159060"
"chr1","56062632","56062757","chr14","56221736","56221861","4","159104"
"chr1","56092490","56092802","chr14","56252120","56252422","14","159630"
"chr1","56107914","56108071","chr14","56267571","56267689","40","159657"
"chr1","56125533","56125844","chr14","56284940","56285261","14","159407"
"chr1","56169829","56170115","chr14","56329493","56329774","7","159664"
"chr1","56184113","56184412","chr14","56341312","56341605","9","157199"
"chr1","56188118","56188210","chr20","65874314","65874396","26","9686196"
"chr1","56190150","56190320","chr4","152516317","152516477","34","96326167"
"chr1","56195905","56196016","chr11","43960970","43961075","20","12234935"
"chr1","56200505","56200813","chr14","56357490","56357797","9","156985"
"chr1","56219448","56219632","chr14","56376627","56376805","9","157179"
"chr1","56223940","56224005","chr14","56381079","56381144","0","157139"
"chr1","56231182","56231489","chr14","56389150","56389452","31","157968"
"chr1","56234049","56234305","chr14","56392008","56392264","5","157959"
"chr1","56250450","56250728","chr14","56408271","56408549","2","157821"
"chr1","56264719","56264984","chr14","56422688","56422953","6","157969"
"chr1","56269806","56270098","chr14","56427763","56428055","9","157957"
"chr1","56305686","56305980","chr15","37516439","37516725","49","18789247"
"chr1","56546354","56546636","chr14","56657428","56657705","9","111074"
"chr1","56565886","56566203","chr16","71416889","71417195","75","14851003"
"chr1","56613632","56613771","chr14","56725005","56725144","1","111373"
"chr1","56634682","56634980","chr14","56745947","56746248","19","111265"
"chr1","56683579","56683879","chr14","56790105","56790405","8","106526"
"chr1","56824934","56825223","chr14","56933672","56933959","7","108738"
"chr1","56896123","56896427","chr3","11962384","11962686","53","44933739"
"chr1","56950655","56950941","chr3","111610319","111610611","57","54659664"
"chr1","57021682","57021974","chr14","3387026","3387321","53","53634656"
"chr1","57069788","57070051","chr9","56456050","56456320","59","613738"
"chr1","57108282","57108469","chr14","57007362","57007546","9","100920"
"chr1","57138719","57138845","chr14","57034979","57035105","1","103740"
"chr1","57148630","57148936","chr14","57044891","57045198","23","103739"
"chr1","57174986","57175284","chr14","57071409","57071701","8","103577"
"chr1","57232300","57232615","chr14","57129342","57129658","38","102958"
"chr1","57272589","57272897","chr14","57169068","57169359","24","103521"
"chr1","57333489","57333779","chr14","57229775","57230065","7","103714"
"chr1","57334094","57334396","chr14","57230380","57230680","11","103714"
"chr1","57339137","57339448","chr14","57235403","57235720","11","103734"
"chr1","57342275","57342463","chr14","57238540","57238726","6","103735"
"chr1","57358942","57359184","chr14","57255377","57255647","32","103565"
"chr1","57387104","57387442","chr14","57283615","57283957","16","103489"
"chr1","57453539","57453833","chr14","57354978","57355275","15","98561"
"chr1","57498939","57499114","chr14","57402797","57402965","13","96142"
"chr1","57499192","57499246","chr14","57403015","57403070","2","96177"
"chr1","57629234","57629521","chr14","57547632","57547918","6","81602"
"chr1","57708310","57708609","chr14","57634619","57634912","14","73691"
"chr1","57816741","57817015","chr14","57746632","57746906","8","70109"
"chr1","57851375","57851665","chr14","57781461","57781744","12","69914"
"chr1","57996843","57997152","chr14","57965949","57966258","4","30894"
"chr1","58008225","58008521","chr14","57977677","57977973","4","30548"
"chr1","58040203","58040490","chr14","57991757","57992045","8","48446"
"chr1","58129265","58129551","chr14","58284131","58284448","34","154866"
"chr1","58150060","58150352","chr14","58308040","58308332","3","157980"
"chr1","58163217","58163377","chr10","69721438","69721589","35","11558221"
"chr1","58163385","58163587","chr14","58321408","58321583","30","158023"
"chr1","58164686","58164988","chr14","58322445","58322747","10","157759"
"chr1","58264938","58265245","chr14","58423326","58423618","21","158388"
"chr1","58291195","58291466","chr14","58449572","58449843","6","158377"
"chr1","58308727","58309025","chr14","58467272","58467570","8","158545"
"chr1","58310967","58311277","chr14","58469520","58469826","8","158553"
"chr1","58323777","58324072","chr14","58481626","58481921","6","157849"
"chr1","58334691","58334874","chr14","58492695","58492867","17","158004"
"chr1","58336965","58337285","chr14","58494844","58495165","12","157879"
"chr1","58364802","58365119","chr14","58522997","58523314","5","158195"
"chr1","58391776","58392057","chr14","58549624","58549907","8","157848"
"chr1","58392821","58393101","chr14","58550673","58550987","38","157852"
"chr1","58406592","58406878","chr13","46251403","46251693","64","12155189"
"chr1","58417428","58417729","chr14","58575648","58575946","7","158220"
"chr1","58457432","58457710","chr14","58617809","58618103","26","160377"
"chr1","58489736","58490025","chr14","58648825","58649114","5","159089"
"chr1","58507577","58507898","chr14","58666650","58666947","35","159073"
"chr1","58564201","58564509","chr14","58725280","58725590","7","161079"
"chr1","58580449","58580753","chr14","58741265","58741569","4","160816"
"chr1","58595722","58595843","chr6","87584999","87585119","18","28989277"
"chr1","58595888","58596066","chr14","15335040","15335211","43","43260848"
"chr1","58625790","58625857","chr14","58785506","58785573","1","159716"
"chr1","58818359","58818504","chr7","15394911","15395040","31","43423448"
"chr1","58855422","58855565","chr14","59032915","59033056","3","177493"
"chr1","60782063","60782362","chr6","85093499","85093798","57","24311436"
"chr1","60899582","60899905","chr3","51622492","51622797","65","9277090"
"chr1","61037505","61037801","chr14","59522570","59522865","9","1514935"
"chr1","61037841","61037856","chr3","8255985","8255999","2","52781856"
"chr1","61060519","61060785","chr14","59545616","59545882","3","1514903"
"chr1","61068909","61069204","chr14","59554006","59554301","5","1514903"
"chr1","61148643","61148944","chr14","59643632","59643933","12","1505011"
"chr1","61341116","61341420","chr14","59876663","59876965","10","1464453"
"chr1","61431049","61431319","chr14","59984128","59984398","5","1446921"
"chr1","61504604","61504883","chr14","60063358","60063653","24","1441246"
"chr1","61549913","61550191","chr14","60115791","60116068","8","1434122"
"chr1","61600997","61601076","chr2","50994498","50994576","11","10606499"
"chr1","61610983","61611279","chr14","60224056","60224355","11","1386927"
"chr1","61669570","61669873","chr14","60283715","60284015","12","1385855"
"chr1","61673518","61673827","chr14","60287070","60287381","15","1386448"
"chr1","61767788","61767890","chr9","16355219","16355325","19","45412569"
"chr1","61833249","61833415","chr14","60365016","60365180","8","1468233"
"chr1","62035708","62036012","chr14","60557121","60557426","3","1478587"
"chr1","62038008","62038299","chrX","12778727","12779009","61","49259281"
"chr1","62153855","62154161","chr14","60681276","60681584","10","1472579"
"chr1","62339357","62339505","chr14","60871753","60871901","1","1467604"
"chr1","62378014","62378325","chr14","60917433","60917729","19","1460581"
"chr1","62425878","62426180","chr14","60965872","60966198","28","1460006"
"chr1","62536301","62536422","chr14","61077591","61077712","2","1458710"
"chr1","62588270","62588547","chr14","61132438","61132713","4","1455832"
"chr1","62618951","62619017","chr14","61163347","61163417","5","1455604"
"chr1","62619888","62619997","chr14","61164463","61164572","0","1455425"
"chr1","62639318","62639613","chr14","61183932","61184227","3","1455386"
"chr1","62640730","62640962","chr4","84589217","84589447","59","21948487"
"chr1","62641197","62641299","chr14","61185823","61185918","8","1455374"
"chr1","62655418","62655711","chr14","61200066","61200359","7","1455352"
"chr1","62663917","62664225","chr4","36593951","36594258","58","26069966"
"chr1","62664431","62664738","chr14","61209375","61209682","9","1455056"
"chr1","62690140","62690452","chr14","61234877","61235187","8","1455263"
"chr1","62694024","62694321","chr14","61238371","61238683","19","1455653"
"chr1","62718860","62719166","chr14","61263555","61263859","4","1455305"
"chr1","62726542","62726845","chr14","61271229","61271532","7","1455313"
"chr1","62738932","62739241","chr12","96210214","96210521","52","33471282"
"chr1","62755475","62755639","chr14","61298836","61299004","6","1456639"
"chr1","62755659","62755950","chr14","61299024","61299309","10","1456635"
"chr1","62763815","62764122","chr14","61307202","61307509","9","1456613"
"chr1","62772002","62772127","chr14","61315387","61315526","15","1456615"
"chr1","62773444","62773737","chr14","61316842","61317137","8","1456602"
"chr1","62775129","62775404","chr14","61318712","61318987","1","1456417"
"chr1","62783785","62783920","chr14","61327379","61327514","2","1456406"
"chr1","62808500","62808815","chr14","61353212","61353527","6","1455288"
"chr1","62809315","62809626","chr14","61354027","61354333","13","1455288"
"chr1","62813426","62813705","chr14","61358200","61358487","13","1455226"
"chr1","62824750","62825055","chr14","61369587","61369892","4","1455163"
"chr1","62829338","62829500","chr14","61374493","61374654","1","1454845"
"chr1","62838270","62838566","chr14","61383886","61384182","6","1454384"
"chr1","62845146","62845440","chr10","7924308","7924597","60","54920838"
"chr1","62846076","62846382","chr14","61393643","61393949","4","1452433"
"chr1","62851026","62851335","chr14","61398598","61398907","1","1452428"
"chr1","62858586","62858811","chr14","61406158","61406383","5","1452428"
"chr1","62872135","62872231","chr14","61420461","61420567","11","1451674"
"chr1","62889300","62889619","chr14","61437638","61437952","8","1451662"
"chr1","62892058","62892330","chrX","61934822","61935092","52","957236"
"chr1","62900722","62900992","chr14","61448739","61449010","7","1451983"
"chr1","62901614","62901920","chr3","49634161","49634472","69","13267453"
"chr1","62904408","62904615","chr20","54500179","54500385","43","8404229"
"chr1","62905593","62905897","chr14","61453292","61453596","6","1452301"
"chr1","62917720","62917990","chr14","61466557","61466825","5","1451163"
"chr1","62922309","62922606","chr14","61471445","61471741","6","1450864"
"chr1","62926850","62927155","chr14","61473222","61473523","10","1453628"
"chr1","62927411","62927694","chr14","61473774","61474057","7","1453637"
"chr1","62939173","62939468","chr14","61486540","61486833","6","1452633"
"chr1","62941424","62941693","chr14","61489018","61489287","2","1452406"
"chr1","62945275","62945578","chr14","61492838","61493134","18","1452437"
"chr1","62948145","62948234","chr20","11844482","11844574","25","51103663"
"chr1","62949845","62950106","chr14","61495860","61496151","38","1453985"
"chr1","62969973","62970262","chr14","61518260","61518549","7","1451713"
"chr1","62989717","62989996","chr9","59536949","59537244","68","3452768"
"chr1","62995917","62996139","chr14","61544710","61544932","5","1451207"
"chr1","62999575","62999862","chr14","61548640","61548927","6","1450935"
"chr1","63002943","63003237","chr14","61551891","61552192","15","1451052"
"chr1","63004794","63004933","chr14","61553744","61553883","3","1451050"
"chr1","63005410","63005622","chr3","10114060","10114263","63","52891350"
"chr1","63020188","63020449","chr14","61569410","61569659","16","1450778"
"chr1","63027895","63028002","chr3","160109694","160109802","22","97081799"
"chr1","63029676","63029864","chr14","61579078","61579296","34","1450598"
"chr1","63032090","63032385","chr6","42260255","42260550","57","20771835"
"chr1","63032791","63033075","chr14","61582031","61582315","1","1450760"
"chr1","63043451","63043733","chr14","61592899","61593181","7","1450552"
"chr1","63043764","63043932","chr14","61593212","61593375","9","1450552"
"chr1","63052391","63052667","chr14","61602011","61602287","2","1450380"
"chr1","63053403","63053475","chr14","61603026","61603104","6","1450377"
"chr1","63055845","63056140","chr14","61605813","61606108","6","1450032"
"chr1","63074320","63074463","chr14","61624202","61624345","3","1450118"
"chr1","63074752","63074859","chr14","61624630","61624738","2","1450122"
"chr1","63097240","63097362","chr14","61647335","61647457","1","1449905"
"chr1","63116368","63116525","chr14","61670703","61670860","0","1445665"
"chr1","63116822","63116955","chr14","61671159","61671292","0","1445663"
"chr1","63122551","63122848","chr6","134251498","134251796","50","71128947"
"chr1","63125167","63125452","chr14","61679505","61679790","1","1445662"
"chr1","63129480","63129780","chr14","61683770","61684072","10","1445710"
"chr1","63130457","63130735","chr14","61685050","61685328","4","1445407"
"chr1","63137118","63137401","chr14","61691315","61691601","9","1445803"
"chr1","63151570","63151864","chr14","61705912","61706216","17","1445658"
"chr1","63163337","63163648","chr14","61717838","61718148","10","1445499"
"chr1","63167036","63167328","chr2","97022915","97023209","46","33855879"
"chr1","63174573","63174860","chr14","61729970","61730266","13","1444603"
"chr1","63232496","63232806","chr14","61788645","61788951","7","1443851"
"chr1","63236248","63236532","chr14","61792320","61792604","2","1443928"
"chr1","63236605","63236899","chr14","61792678","61792974","7","1443927"
"chr1","63238399","63238707","chr14","61794461","61794768","10","1443938"
"chr1","63246757","63246848","chr6","133283117","133283210","18","70036360"
"chr1","63249194","63249494","chr14","61805102","61805407","15","1444092"
"chr1","63249933","63250009","chr3","406344","406414","22","62843589"
"chr1","63253326","63253451","chr2","147433393","147433519","20","84180067"
"chr1","63253567","63253749","chr10","7732797","7732975","36","55520770"
"chr1","63255380","63255676","chr14","61811391","61811686","5","1443989"
"chr1","63263206","63263486","chr14","61820314","61820594","3","1442892"
"chr1","63264288","63264580","chr14","61821391","61821683","2","1442897"
"chr1","63265393","63265700","chr14","61822494","61822799","14","1442899"
"chr1","63267872","63268169","chr14","61824687","61824984","8","1443185"
"chr1","63268756","63269055","chr14","61825888","61826189","9","1442868"
"chr1","63274391","63274633","chr14","61832172","61832448","39","1442219"
"chr1","63279635","63279941","chr14","61837441","61837748","4","1442194"
"chr1","63288831","63289143","chr14","61846615","61846928","9","1442216"
"chr1","63296431","63296542","chr14","61854191","61854302","2","1442240"
"chr1","63311003","63311308","chr14","61868818","61869123","9","1442185"
"chr1","63311358","63311650","chr14","61869182","61869477","9","1442176"
"chr1","63324372","63324670","chr14","61882805","61883104","5","1441567"
"chr1","63352594","63352894","chr14","61911847","61912139","11","1440747"
"chr1","63356479","63356749","chr14","61915722","61915986","14","1440757"
"chr1","63357071","63357340","chr14","61916308","61916612","42","1440763"
"chr1","63367277","63367382","chr14","108999830","108999934","20","45632553"
"chr1","63367939","63368251","chr14","61928092","61928404","2","1439847"
"chr1","63369403","63369707","chr14","61929540","61929852","15","1439863"
"chr1","63397019","63397328","chr14","61957046","61957360","11","1439973"
"chr1","63401273","63401507","chr14","61961180","61961414","5","1440093"
"chr1","63401822","63402126","chr14","61961729","61962040","10","1440093"
"chr1","63403701","63404019","chr14","61963621","61963944","9","1440080"
"chr1","63419925","63420241","chr14","61979297","61979606","11","1440628"
"chr1","63420768","63420941","chr14","61980133","61980300","9","1440635"
"chr1","63422056","63422260","chr14","61981392","61981597","8","1440664"
"chr1","63425113","63425405","chr14","61986799","61987091","8","1438314"
"chr1","63430100","63430391","chr14","61991479","61991770","5","1438621"
"chr1","63431170","63431486","chr14","61992250","61992552","20","1438920"
"chr1","63466205","63466390","chr14","62028267","62028452","2","1437938"
"chr1","63489497","63489810","chr1","114046752","114047056","63","50557255"
"chr1","63513442","63513692","chr14","62076439","62076719","34","1437003"
"chr1","63525483","63525791","chr14","62089215","62089523","4","1436268"
"chr1","63571233","63571523","chr14","62134873","62135163","4","1436360"
"chr1","63589537","63589843","chr14","62153460","62153766","7","1436077"
"chr1","63597749","63597920","chr14","62161669","62161840","1","1436080"
"chr1","63598258","63598381","chr14","62162153","62162281","12","1436105"
"chr1","63698919","63699077","chr14","62264048","62264209","14","1434871"
"chr1","63701294","63701589","chr14","62266419","62266714","8","1434875"
"chr1","63702764","63702836","chr16","25477961","25478031","11","38224803"
"chr1","63715680","63715958","chr14","62280312","62280592","16","1435368"
"chr1","63716004","63716023","chr3","29269233","29269250","4","34446771"
"chr1","63717687","63717828","chr15","7750047","7750182","23","55967640"
"chr1","63728895","63728992","chr14","62294147","62294244","2","1434748"
"chr1","63729301","63729494","chr14","62294543","62294737","2","1434758"
"chr1","63752066","63752331","chr14","62317638","62317904","5","1434428"
"chr1","63789294","63789595","chr14","62350259","62350557","10","1439035"
"chr1","63928696","63928948","chr14","62491192","62491444","3","1437504"
"chr1","63973724","63974016","chr12","39222794","39223082","45","24750930"
"chr1","63975000","63975186","chr14","62538246","62538439","12","1436754"
"chr1","63976382","63976686","chr14","62539622","62539931","11","1436760"
"chr1","64008485","64008658","chr14","62571566","62571727","15","1436919"
"chr1","64025672","64025915","chr14","62588968","62589215","5","1436704"
"chr1","64034846","64035037","chr14","62598130","62598318","5","1436716"
"chr1","64035644","64035779","chr14","62598943","62599078","3","1436701"
"chr1","64036202","64036361","chr14","62603712","62603871","2","1432490"
"chr1","64037216","64037350","chr14","62604730","62604860","9","1432486"
"chr1","64037707","64038018","chr14","62605217","62605535","21","1432490"
"chr1","64038023","64038181","chr14","62605540","62605698","2","1432483"
"chr1","64039778","64040016","chr4","51722411","51722638","49","12317367"
"chr1","64042313","64042600","chr14","62609721","62610004","19","1432592"
"chr1","64046948","64047239","chr14","62603032","62603323","7","1443916"
"chr1","64077849","64078083","chr8","50188264","50188475","70","13889585"
"chr1","64078182","64078231","chr1","54500597","54500644","8","9577585"
"chr1","64089669","64089969","chr14","62653543","62653845","3","1436126"
"chr1","64102743","64103024","chr14","62665926","62666207","5","1436817"
"chr1","64115479","64115672","chr14","62679138","62679331","4","1436341"
"chr1","64116268","64116520","chr14","62679927","62680179","3","1436341"
"chr1","64119211","64119460","chr14","62682853","62683123","24","1436358"
"chr1","64122614","64122899","chr14","62685909","62686195","2","1436705"
"chr1","64123519","64123781","chr14","62686807","62687069","6","1436712"
"chr1","64129961","64130199","chr1","47641716","47641948","53","16488245"
"chr1","64137587","64137901","chr14","62701507","62701826","8","1436080"
"chr1","64138343","64138582","chr14","62702271","62702513","4","1436072"
"chr1","64147840","64148120","chr14","62711887","62712157","17","1435953"
"chr1","64173763","64173882","chr14","62738816","62738936","3","1434947"
"chr1","64231455","64231755","chr14","62794317","62794624","13","1437138"
"chr1","64233709","64234000","chr14","62796865","62797156","2","1436844"
"chr1","64252992","64253296","chr14","62817047","62817351","5","1435945"
"chr1","64257795","64258107","chr14","62821859","62822174","8","1435936"
"chr1","64262080","64262294","chr14","62826123","62826337","3","1435957"
"chr1","64267522","64267820","chr14","62831587","62831882","13","1435935"
"chr1","64271509","64271772","chr14","62836049","62836308","13","1435460"
"chr1","64283133","64283224","chr14","62847345","62847436","0","1435788"
"chr1","64291180","64291332","chr14","62855958","62856092","21","1435222"
"chr1","64291333","64291425","chr14","62856099","62856192","2","1435234"
"chr1","64312187","64312485","chr14","62881104","62881402","9","1431083"
"chr1","64332149","64332440","chr14","62901731","62902019","6","1430418"
"chr1","64354946","64355248","chr14","62924187","62924488","12","1430759"
"chr1","64373909","64374223","chr4","144950140","144950459","63","80576231"
"chr1","64375620","64375909","chr14","62945226","62945510","13","1430394"
"chr1","64377757","64377978","chr14","62947367","62947582","11","1430390"
"chr1","64391059","64391371","chr14","62960823","62961135","9","1430236"
"chr1","64423156","64423435","chrX","4247620","4247896","49","60175536"
"chr1","64423713","64423883","chr2","149685908","149686075","36","85262195"
"chr1","64442832","64443124","chr14","63021020","63021312","6","1421812"
"chr1","64447629","64447944","chr14","63026037","63026352","5","1421592"
"chr1","64452051","64452348","chr14","63029896","63030194","9","1422155"
"chr1","64454666","64454894","chr14","63034380","63034637","31","1420286"
"chr1","64499437","64499661","chr14","63078607","63078826","6","1420830"
"chr1","64503938","64504239","chr14","63083113","63083418","9","1420825"
"chr1","64509626","64509689","chr9","59543709","59543771","14","4965917"
"chr1","64529790","64530081","chr14","63108518","63108809","5","1421272"
"chr1","64565277","64565552","chr14","63144071","63144364","22","1421206"
"chr1","64582081","64582312","chr14","63160863","63161094","2","1421218"
"chr1","64606107","64606400","chr14","63185052","63185350","10","1421055"
"chr1","64611000","64611268","chr14","63189938","63190205","7","1421062"
"chr1","64619258","64619492","chr14","63198188","63198423","4","1421070"
"chr1","64645108","64645408","chr14","63224060","63224332","35","1421048"
"chr1","64653734","64654034","chr14","63232668","63232970","7","1421066"
"chr1","64662254","64662493","chr14","63240876","63241115","3","1421378"
"chr1","64694759","64695047","chr14","63273966","63274258","11","1420793"
"chr1","64733541","64733879","chr14","63313284","63313596","36","1420257"
"chr1","64736828","64737129","chr14","63316526","63316813","17","1420302"
"chr1","64737889","64738191","chr14","63317576","63317878","5","1420313"
"chr1","64759099","64759177","chr14","63339371","63339455","10","1419728"
"chr1","64759463","64759736","chr14","63339736","63340009","3","1419727"
"chr1","64774980","64775276","chr14","63355652","63355944","8","1419328"
"chr1","64779040","64779311","chr14","63359718","63359991","5","1419322"
"chr1","64792307","64792478","chr4","21717100","21717271","45","43075207"
"chr1","64795465","64795762","chr14","63375596","63375915","24","1419869"
"chr1","64798781","64799079","chr14","63378912","63379211","10","1419869"
"chr1","64817342","64817598","chr14","63397344","63397615","20","1419998"
"chr1","64819134","64819290","chr14","63399156","63399307","9","1419978"
"chr1","64834283","64834569","chr14","63413673","63413960","8","1420610"
"chr1","64845587","64845729","chr16","31693977","31694104","32","33151610"
"chr1","64846649","64846958","chr14","63426289","63426598","3","1420360"
"chr1","64851405","64851712","chr14","63431170","63431477","6","1420235"
"chr1","64854098","64854381","chr14","63433725","63434006","5","1420373"
"chr1","64861197","64861502","chr14","63441437","63441742","9","1419760"
"chr1","64861912","64862208","chr14","63442147","63442450","11","1419765"
"chr1","64863026","64863162","chr1","12535848","12535979","33","52327178"
"chr1","64883090","64883381","chrX","7312938","7313223","56","57570152"
"chr1","64917180","64917436","chr14","63498137","63498415","24","1419043"
"chr1","64917995","64918264","chr14","63498964","63499236","6","1419031"
"chr1","64927136","64927445","chr14","63507395","63507704","9","1419741"
"chr1","64931899","64932201","chr14","63512441","63512749","12","1419458"
"chr1","64944523","64944814","chr14","63532169","63532461","5","1412354"
"chr1","64951478","64951781","chr1","29968074","29968383","64","34983404"
"chr1","64958434","64958729","chr14","63535526","63535821","3","1422908"
"chr1","64973606","64973647","chr14","63550447","63550488","0","1423159"
"chr1","64973949","64974009","chr14","63550794","63550854","1","1423155"
"chr1","64979011","64979305","chr14","63555777","63556070","3","1423234"
"chr1","64989531","64989818","chr14","63566934","63567236","23","1422597"
"chr1","64993928","64994236","chr14","63571658","63571966","10","1422270"
"chr1","64998076","64998170","chr14","63575691","63575785","2","1422385"
"chr1","64999222","64999398","chr7","147810756","147810933","36","82811534"
"chr1","65009948","65010030","chr4","2744439","2744523","16","62265509"
"chr1","65014725","65014838","chr7","91767573","91767677","38","26752848"
"chr1","65015218","65015514","chr14","63590875","63591162","14","1424343"
"chr1","65037238","65037529","chr14","63619712","63620003","3","1417526"
"chr1","65041206","65041536","chr11","61860158","61860460","105","3181048"
"chr1","65047922","65047959","chr14","63631691","63631728","0","1416231"
"chr1","65049469","65049767","chr4","153852084","153852380","46","88802615"
"chr1","65049992","65050301","chr14","63633763","63634073","5","1416229"
"chr1","65052298","65052569","chr14","63636382","63636653","5","1415916"
"chr1","65052644","65052656","chr2","87828771","87828782","4","22776127"
"chr1","65057896","65058102","chr18","1492632","1492843","37","63565264"
"chr1","65061116","65061414","chr14","63645059","63645360","10","1416057"
"chr1","65062200","65062264","chr14","63646146","63646210","0","1416054"
"chr1","65064060","65064348","chr14","63647999","63648282","14","1416061"
"chr1","65071592","65071852","chr1","29272282","29272531","96","35799310"
"chr1","65075670","65075883","chr14","63662743","63662959","8","1412927"
"chr1","65087599","65087901","chr14","63673115","63673421","18","1414484"
"chr1","65089119","65089419","chr14","63674965","63675269","9","1414154"
"chr1","65093019","65093209","chr14","63678885","63679075","0","1414134"
"chr1","65093225","65093491","chr14","63679091","63679357","2","1414134"
"chr1","65099620","65099899","chr14","63685409","63685692","8","1414211"
"chr1","65101590","65101896","chr14","63687145","63687449","6","1414445"
"chr1","65107266","65107447","chr14","63693515","63693696","3","1413751"
"chr1","65107473","65107529","chr14","63693722","63693779","1","1413751"
"chr1","65110369","65110669","chr14","63696928","63697228","4","1413441"
"chr1","65119482","65119790","chr14","63705711","63706020","8","1413771"
"chr1","65132159","65132289","chr14","63718834","63718964","3","1413325"
"chr1","65133906","65134067","chr14","63720631","63720792","3","1413275"
"chr1","65134959","65135237","chr14","63721718","63721958","42","1413241"
"chr1","65137389","65137558","chr14","63724107","63724283","24","1413282"
"chr1","65140963","65141035","chr19","3643688","3643758","7","61497275"
"chr1","65141400","65141626","chr6","64011986","64012202","63","1129414"
"chr1","65141869","65141957","chr17","30082562","30082650","18","35059307"
"chr1","65154607","65154905","chr14","63741536","63741842","18","1413071"
"chr1","65157958","65158091","chr14","63745594","63745727","0","1412364"
"chr1","65158393","65158560","chr14","63746029","63746194","3","1412364"
"chr1","65160093","65160393","chr14","63747729","63748029","7","1412364"
"chr1","65177686","65177984","chr14","63765308","63765611","10","1412378"
"chr1","65187798","65188094","chr14","63774912","63775205","4","1412886"
"chr1","65191663","65191956","chr14","63778512","63778804","14","1413151"
"chr1","65195403","65195711","chr12","99689911","99690212","61","34494508"
"chr1","65198986","65199136","chr14","63785760","63785906","4","1413226"
"chr1","65199429","65199601","chr14","63786190","63786362","2","1413239"
"chr1","65209236","65209552","chr14","63796423","63796727","16","1412813"
"chr1","65211172","65211448","chr1","13864230","13864506","58","51346942"
"chr1","65216624","65216935","chr11","27258286","27258594","59","37958338"
"chr1","65239420","65239708","chr14","63826255","63826543","3","1413165"
"chr1","65245890","65246181","chr14","63832458","63832775","31","1413432"
"chr1","65249595","65249885","chr14","63836085","63836375","6","1413510"
"chr1","65259945","65260263","chr7","38305205","38305510","79","26954740"
"chr1","65264770","65265055","chr14","63855491","63855771","12","1409279"
"chr1","65297896","65298185","chr14","63888743","63889032","3","1409153"
"chr1","65312070","65312361","chr14","63902507","63902798","4","1409563"
"chr1","65313844","65314138","chr14","63904222","63904525","15","1409622"
"chr1","65325935","65326201","chr14","63916293","63916559","5","1409642"
"chr1","65332804","65333110","chr14","63923144","63923461","12","1409660"
"chr1","65378750","65379043","chr14","63969522","63969815","6","1409228"
"chr1","65388619","65388910","chr14","63987834","63988125","6","1400785"
"chr1","65391193","65391362","chr14","63990401","63990570","2","1400792"
"chr1","65394093","65394385","chr14","63993313","63993605","4","1400780"
"chr1","65399410","65399571","chr14","63998309","63998458","14","1401101"
"chr1","65420736","65420885","chr14","64021740","64021889","2","1398996"
"chr1","65421195","65421349","chr14","64022198","64022367","15","1398997"
"chr1","65454434","65454735","chr14","64056134","64056431","7","1398300"
"chr1","65470957","65471029","chr4","32478169","32478238","19","32992788"
"chr1","65494991","65495324","chr14","64100974","64101298","18","1394017"
"chr1","65525574","65525655","chr14","64131495","64131576","1","1394079"
"chr1","65569399","65569694","chr14","64174433","64174728","6","1394966"
"chr1","65612025","65612113","chr14","64217261","64217351","2","1394764"
"chr1","65612775","65612967","chrX","62604557","62604759","44","3008218"
"chr1","65627588","65627763","chr14","64234023","64234195","12","1393565"
"chr1","65677212","65677514","chr14","64283656","64283958","5","1393556"
"chr1","65680277","65680603","chr14","64286707","64287034","7","1393570"
"chr1","65683176","65683310","chr14","64289610","64289746","3","1393566"
"chr1","65694554","65694674","chr14","64300997","64301117","2","1393557"
"chr1","65711520","65711796","chr14","64317582","64317880","30","1393938"
"chr1","65712752","65713051","chr14","64318828","64319125","8","1393924"
"chr1","65717929","65718247","chr14","64324002","64324321","16","1393927"
"chr1","65719538","65719834","chr14","64328159","64328455","5","1391379"
"chr1","65720414","65720709","chr14","64329026","64329321","7","1391388"
"chr1","65749076","65749387","chr14","64357402","64357712","13","1391674"
"chr1","65758411","65758570","chr3","38428298","38428454","33","27330113"
"chr1","65771961","65772267","chr14","64380281","64380577","19","1391680"
"chr1","65790036","65790260","chr14","64397617","64397860","24","1392419"
"chr1","65793082","65793390","chr9","80146497","80146802","64","14353415"
"chr1","65798147","65798297","chr14","64405724","64405874","1","1392423"
"chr1","65803988","65804169","chr14","64411445","64411604","24","1392543"
"chr1","65806370","65806502","chr14","64413753","64413885","1","1392617"
"chr1","65808606","65808894","chr14","64415990","64416303","30","1392616"
"chr1","65814134","65814449","chr14","64421513","64421829","7","1392621"
"chr1","65830953","65831241","chr17","10902080","10902366","64","54928873"
"chr1","65838207","65838517","chr14","64445446","64445748","17","1392761"
"chr1","65840072","65840224","chr13","99896250","99896399","30","34056178"
"chr1","65840531","65840665","chr9","102165756","102165893","21","36325225"
"chr1","65848389","65848654","chr14","64455384","64455649","2","1393005"
"chr1","65849820","65850123","chr14","64456810","64457113","6","1393010"
"chr1","65860542","65860839","chr14","64467186","64467482","9","1393356"
"chr1","65944877","65945177","chr14","64551564","64551868","12","1393313"
"chr1","65954282","65954410","chr14","64560925","64561054","6","1393357"
"chr1","65959424","65959727","chr14","64566079","64566378","11","1393345"
"chr1","65976838","65977139","chr14","64583404","64583747","53","1393434"
"chr1","65979961","65980267","chr14","64586585","64586880","18","1393376"
"chr1","65980326","65980634","chr14","64586944","64587248","14","1393382"
"chr1","65987041","65987361","chr14","64593349","64593669","6","1393692"
"chr1","65988938","65989214","chr14","64595250","64595531","15","1393688"
"chr1","66000530","66000820","chr14","64606802","64607092","8","1393728"
"chr1","66005425","66005698","chr14","64611710","64611983","3","1393715"
"chr1","66033443","66033733","chr14","64645770","64646061","6","1387673"
"chr1","66046445","66046745","chr14","64658038","64658338","7","1388407"
"chr1","66047470","66047798","chr14","64659072","64659400","6","1388398"
"chr1","66054011","66054314","chr14","64665470","64665773","7","1388541"
"chr1","66115741","66116037","chr14","64728129","64728415","15","1387612"
"chr1","66160180","66160451","chr14","64776668","64776938","7","1383512"
"chr1","66173660","66173957","chr14","64789782","64790075","8","1383878"
"chr1","66176963","66177245","chr14","64793087","64793369","6","1383876"
"chr1","66199681","66199959","chr18","66437111","66437406","65","237430"
"chr1","66200693","66200867","chr14","64817356","64817535","7","1383337"
"chr1","66246955","66247255","chr14","64863152","64863451","8","1383803"
"chr1","66285769","66286044","chr14","64902185","64902460","5","1383584"
"chr1","66297548","66297706","chr1","41160156","41160285","43","25137392"
"chr1","66318910","66319084","chr14","64935253","64935428","4","1383657"
"chr1","66330147","66330441","chr14","64949375","64949657","21","1380772"
"chr1","66345055","66345273","chr14","64963830","64964048","4","1381225"
"chr1","66346599","66346820","chr14","64965378","64965625","38","1381221"
"chr1","66350685","66350951","chr1","41034829","41035098","51","25315856"
"chr1","66383068","66383198","chr14","65001303","65001439","8","1381765"
"chr1","66409916","66409982","chr14","65028427","65028493","3","1381489"
"chr1","66410515","66410603","chr14","65029023","65029111","2","1381492"
"chr1","66410897","66411040","chr14","65029405","65029548","5","1381492"
"chr1","66434879","66435194","chr14","65053797","65054113","9","1381082"
"chr1","66446331","66446515","chr14","65065236","65065412","12","1381095"
"chr1","66446805","66446938","chr14","65065702","65065838","5","1381103"
"chr1","66481467","66481781","chr14","65092636","65092950","5","1388831"
"chr1","66515454","66515772","chr14","65132924","65133242","12","1382530"
"chr1","66519766","66520060","chr14","65137226","65137520","6","1382540"
"chr1","66541069","66541342","chr14","65159588","65159891","34","1381481"
"chr1","66553418","66553429","chr5","123861148","123861159","2","57307730"
"chr1","66553488","66553767","chr6","132233796","132234079","59","65680308"
"chr1","66555626","66555812","chr3","44961085","44961258","37","21594541"
"chr1","66556134","66556261","chr1","17969919","17970043","23","48586215"
"chr1","66577071","66577359","chr14","65195786","65196082","10","1381285"
"chr1","66587524","66587546","chr11","110454313","110454334","6","43866789"
"chr1","66599721","66600025","chr14","65222458","65222722","41","1377263"
"chr1","66600775","66601052","chr14","65223463","65223741","9","1377312"
"chr1","66606066","66606365","chr8","59099770","59100064","62","7506296"
"chr1","66609094","66609397","chr14","65228850","65229157","22","1380244"
"chr1","66631786","66632002","chr14","65252739","65252955","2","1379047"
"chr1","66638916","66639161","chr14","65259590","65259806","33","1379326"
"chr1","66639586","66639868","chr14","65260558","65260840","9","1379028"
"chr1","66671413","66671579","chr14","65292943","65293109","1","1378470"
"chr1","66671607","66671726","chr14","65293131","65293248","3","1378476"
"chr1","66688146","66688393","chr14","65310456","65310744","45","1377690"
"chr1","66689511","66689753","chr14","65311874","65312116","3","1377637"
"chr1","66713992","66714126","chr14","6731416","6731550","21","59982576"
"chr1","66726834","66727130","chr14","65350285","65350582","8","1376549"
"chr1","66756570","66756853","chr6","65411293","65411568","63","1345277"
"chr1","66761757","66762025","chr14","65384146","65384429","18","1377611"
"chr1","66772380","66772676","chr14","65394356","65394652","9","1378024"
"chr1","66794157","66794457","chr14","65416641","65416941","5","1377516"
"chr1","66871954","66872262","chr14","65494546","65494854","6","1377408"
"chr1","66952860","66953161","chr14","65575788","65576098","15","1377072"
"chr1","67011558","67011830","chr14","65634211","65634509","28","1377347"
"chr1","67016140","67016438","chr14","65638775","65639074","8","1377365"
"chr1","67025608","67025898","chr14","65648657","65648947","2","1376951"
"chr1","67029041","67029328","chr14","65651774","65652067","15","1377267"
"chr1","67031395","67031706","chr14","65654126","65654437","14","1377269"
"chr1","67043276","67043366","chr14","65660951","65661025","17","1382325"
"chr1","67062783","67063076","chr14","65685982","65686276","4","1376801"
"chr1","67070909","67071193","chr14","65694425","65694710","6","1376484"
"chr1","67074405","67074698","chr14","65697922","65698215","7","1376483"
"chr1","67081803","67082107","chr14","65704778","65705082","9","1377025"
"chr1","67083393","67083679","chr14","65706360","65706646","3","1377033"
"chr1","67125845","67126147","chr14","65751563","65751866","12","1374282"
"chr1","67177733","67178013","chr14","65806114","65806396","8","1371619"
"chr1","67212719","67213027","chr14","65844775","65845071","20","1367944"
"chr1","67216404","67216706","chr14","65848477","65848781","11","1367927"
"chr1","67217021","67217292","chr14","65849082","65849353","4","1367939"
"chr1","67231977","67232272","chr14","65864187","65864476","11","1367790"
"chr1","67246803","67247090","chr14","65878685","65878974","7","1368118"
"chr1","67247948","67248235","chr14","65879834","65880121","9","1368114"
"chr1","67268822","67269119","chr14","65900741","65901042","11","1368081"
"chr1","67287677","67287986","chr14","65919957","65920260","10","1367720"
"chr1","67293431","67293729","chr14","65925759","65926051","7","1367672"
"chr1","67298574","67298865","chr14","65930875","65931184","42","1367699"
"chr1","67312890","67313099","chr14","65945244","65945454","4","1367646"
"chr1","67313148","67313446","chr19","12321058","12321358","56","54992090"
"chr1","67321537","67321836","chr14","65953875","65954176","9","1367662"
"chr1","67346604","67346899","chr14","65978881","65979176","4","1367723"
"chr1","67399507","67399834","chr14","66031248","66031575","6","1368259"
"chr1","67432944","67433042","chr14","66064956","66065054","3","1367988"
"chr1","67439434","67439611","chr14","66071412","66071581","12","1368022"
"chr1","67467137","67467292","chr14","66099180","66099341","10","1367957"
"chr1","67495576","67495871","chr14","66127223","66127518","9","1368353"
"chr1","67505501","67505820","chr14","66136620","66136944","9","1368881"
"chr1","67505899","67506195","chr14","66137023","66137288","40","1368876"
"chr1","67529460","67529757","chr14","66160747","66161016","31","1368713"
"chr1","67545109","67545263","chr14","66177256","66177411","2","1367853"
"chr1","67545570","67545703","chr14","66177729","66177866","9","1367841"
"chr1","67555003","67555312","chr14","66187140","66187450","13","1367863"
"chr1","67576075","67576384","chr14","66208261","66208569","11","1367814"
"chr1","67578590","67578894","chr14","66210764","66211067","9","1367826"
"chr1","67587004","67587227","chr14","66218577","66218802","11","1368427"
"chr1","67587295","67587610","chr14","66218867","66219168","31","1368428"
"chr1","67602313","67602613","chr14","66233130","66233430","7","1369183"
"chr1","67610567","67610873","chr14","66241382","66241697","14","1369185"
"chr1","67618533","67618814","chr14","66249724","66250022","22","1368809"
"chr1","67630337","67630625","chr8","10034943","10035230","52","57595394"
"chr1","67630658","67630680","chr2","80838771","80838795","2","13208113"
"chr1","67638810","67639104","chr14","66270171","66270469","7","1368639"
"chr1","67642409","67642599","chr14","66273866","66274056","1","1368543"
"chr1","67642888","67643025","chr14","66274344","66274481","1","1368544"
"chr1","67646029","67646295","chr14","66277512","66277779","3","1368517"
"chr1","67663512","67663816","chr6","74070978","74071283","53","6407466"
"chr1","67663820","67664132","chr14","66295603","66295915","11","1368217"
"chr1","67687319","67687634","chr14","66318742","66319057","10","1368577"
"chr1","67711713","67711887","chr8","67378736","67378912","49","332977"
"chr1","67732299","67732549","chr14","66363016","66363270","11","1369283"
"chr1","67735252","67735526","chr14","66365962","66366236","4","1369290"
"chr1","67748779","67749092","chr10","30340323","30340632","48","37408456"
"chr1","67780367","67780649","chr14","66411884","66412166","3","1368483"
"chr1","67783004","67783318","chr14","66414437","66414716","41","1368567"
"chr1","67839016","67839321","chr14","66469829","66470137","5","1369187"
"chr1","67839327","67839505","chr14","90427944","90428113","42","22588617"
"chr1","67839535","67839627","chr6","133011443","133011533","11","65171908"
"chr1","67942856","67942977","chr7","123622375","123622499","24","55679519"
"chr1","67947500","67947795","chr14","66580992","66581286","8","1366508"
"chr1","67951714","67951960","chr14","66585204","66585450","4","1366510"
"chr1","67952161","67952226","chr9","124946883","124946946","16","56994722"
"chr1","67959410","67959585","chr16","49295116","49295286","35","18664294"
"chr1","67979970","67980193","chr4","105437631","105437848","46","37457661"
"chr1","67980497","67980572","chr1","201808952","201809025","14","133828455"
"chr1","68005878","68005970","chr4","157661401","157661488","20","89655523"
"chr1","68037416","68037707","chr14","66670310","66670599","3","1367106"
"chr1","68040264","68040455","chr14","66673147","66673336","7","1367117"
"chr1","68045395","68045455","chr14","66678278","66678338","1","1367117"
"chr1","68056986","68057294","chr2","44247952","44248260","58","23809034"
"chr1","68059439","68059710","chr14","66693614","66693883","11","1365825"
"chr1","68071548","68071701","chr17","26715617","26715766","39","41355931"
"chr1","68076626","68076923","chr14","66712885","66713181","7","1363741"
"chr1","68082081","68082372","chr14","66718367","66718658","1","1363714"
"chr1","68093594","68093887","chr14","66727085","66727384","16","1366509"
"chr1","68098720","68099034","chr14","66732222","66732529","14","1366498"
"chr1","68101774","68102060","chr14","66735272","66735551","9","1366502"
"chr1","68139101","68139352","chr14","66771952","66772203","9","1367149"
"chr1","68145514","68145791","chr14","66778343","66778620","6","1367171"
"chr1","68145814","68146103","chr14","66778643","66778933","5","1367171"
"chr1","68146879","68147100","chr14","66779712","66779933","4","1367167"
"chr1","68163692","68163998","chr14","66800819","66801125","3","1362873"
"chr1","68179160","68179476","chr14","66816267","66816576","9","1362893"
"chr1","68187662","68187925","chr14","66824752","66825017","11","1362910"
"chr1","68195720","68196018","chr14","66832851","66833149","4","1362869"
"chr1","68231887","68231957","chr14","66869526","66869596","4","1362361"
"chr1","68239770","68240046","chr14","66877389","66877658","12","1362381"
"chr1","68240981","68241248","chr14","66878595","66878862","6","1362386"
"chr1","68245868","68245978","chr14","66883501","66883615","9","1362367"
"chr1","68246015","68246184","chr14","66883641","66883809","4","1362374"
"chr1","68251520","68251784","chr14","66892698","66892960","8","1358822"
"chr1","68261494","68261782","chr14","66899217","66899505","5","1362277"
"chr1","68268004","68268216","chr14","66905967","66906187","13","1362037"
"chr1","68377806","68378103","chr14","67015271","67015568","7","1362535"
"chr1","68489867","68490174","chr14","67127814","67128118","8","1362053"
"chr1","68491306","68491483","chr14","67129250","67129427","0","1362056"
"chr1","68501013","68501322","chr14","67138910","67139218","8","1362103"
"chr1","68503062","68503364","chr14","67140940","67141242","5","1362122"
"chr1","68526764","68527109","chr10","20853642","20853971","74","47673122"
"chr1","68534423","68534717","chr14","67176832","67177131","13","1357591"
"chr1","68585129","68585400","chr14","67226948","67227254","38","1358181"
"chr1","68585444","68585459","chr4","148551272","148551286","4","79965828"
"chr1","68611428","68611726","chr14","67253019","67253317","4","1358409"
"chr1","68613176","68613276","chr14","67254875","67254975","2","1358301"
"chr1","68617559","68617836","chr14","67259510","67259788","7","1358049"
"chr1","68639346","68639525","chr14","67285651","67285819","20","1353695"
"chr1","68639526","68639836","chr14","67285820","67286157","32","1353706"
"chr1","68639837","68639968","chr14","67286158","67286299","15","1353679"
"chr1","68670680","68670966","chr14","67316988","67317243","42","1353692"
"chr1","68680259","68680419","chr7","147655739","147655879","43","78975480"
"chr1","68683156","68683474","chr14","67329456","67329775","7","1353700"
"chr1","68683477","68683610","chr14","67329778","67329911","1","1353699"
"chr1","68692273","68692418","chr11","14255490","14255622","40","54436783"
"chr1","68693586","68693882","chr14","113770293","113770582","63","45076707"
"chr1","68698303","68698587","chr14","67346230","67346520","9","1352073"
"chr1","68708895","68709066","chr14","67358243","67358424","11","1350652"
"chr1","68716080","68716380","chr14","67365075","67365375","7","1351005"
"chr1","68733247","68733556","chr14","67385813","67386122","2","1347434"
"chr1","68734003","68734248","chr14","67386569","67386815","6","1347434"
"chr1","68741034","68741329","chr14","67393700","67394000","10","1347334"
"chr1","68750825","68750909","chr14","67403380","67403464","1","1347445"
"chr1","68751197","68751386","chr14","67403741","67403943","17","1347456"
"chr1","68798228","68798319","chr14","67452517","67452600","11","1345711"
"chr1","68806099","68806205","chr14","67453658","67453756","10","1352441"
"chr1","68815795","68816089","chr14","67463975","67464284","21","1351820"
"chr1","68820225","68820239","chr13","46779000","46779013","2","22041225"
"chr1","68821009","68821281","chr14","67469184","67469456","5","1351825"
"chr1","68822001","68822172","chr14","67470178","67470347","7","1351823"
"chr1","68840641","68840942","chr14","67489031","67489332","4","1351610"
"chr1","68842809","68843047","chr14","67491199","67491436","3","1351610"
"chr1","68843348","68843373","chr14","67491737","67491767","5","1351611"
"chr1","68849023","68849330","chr14","67499373","67499678","11","1349650"
"chr1","68850289","68850326","chr15","93717620","93717656","4","24867331"
"chr1","68851878","68852142","chr14","67500637","67500927","32","1351241"
"chr1","68860111","68860400","chr14","67508689","67508978","13","1351422"
"chr1","68865711","68865983","chr14","67514280","67514553","4","1351431"
"chr1","68885223","68885382","chr14","67534436","67534595","2","1350787"
"chr1","68888783","68889076","chr14","67541606","67541895","10","1347177"
"chr1","68893608","68893902","chr14","67541606","67541895","11","1352002"
"chr1","68918349","68918675","chr14","67565959","67566280","12","1352390"
"chr1","68922426","68922758","chr2","47735644","47735958","77","21186782"
"chr1","68928738","68929032","chr9","6062262","6062553","56","62866476"
"chr1","68929962","68930119","chr14","67577386","67577543","4","1352576"
"chr1","68931077","68931336","chr14","67578502","67578761","4","1352575"
"chr1","68955768","68956028","chr14","67604782","67605040","11","1350986"
"chr1","68962956","68963157","chr14","67612290","67612502","13","1350666"
"chr1","68968997","68969131","chr12","3084954","3085087","28","65884043"
"chr1","68969132","68969441","chr14","67618570","67618859","25","1350562"
"chr1","68969442","68969665","chr11","48017316","48017508","61","20952126"
"chr1","68977777","68978096","chr14","67627581","67627903","14","1350196"
"chr1","68990957","68991145","chr14","67640753","67640941","4","1350204"
"chr1","69002526","69002836","chr14","67653018","67653317","29","1349508"
"chr1","69008805","69009102","chr14","67659173","67659463","11","1349632"
"chr1","69010474","69010630","chr14","67660840","67660996","4","1349634"
"chr1","69012780","69013028","chr14","67663130","67663378","3","1349650"
"chr1","69014159","69014436","chr2","47838226","47838512","53","21175933"
"chr1","69019868","69020003","chr14","67670213","67670348","0","1349655"
"chr1","69020842","69021143","chr14","67671187","67671499","16","1349655"
"chr1","69032127","69032243","chr5","103784948","103785065","22","34752821"
"chr1","69058449","69058620","chr14","67707858","67708029","7","1350591"
"chr1","69058935","69059039","chr14","67708344","67708448","1","1350591"
"chr1","69061601","69061766","chr3","38910368","38910526","36","30151233"
"chr1","69075307","69075604","chr14","67723984","67724278","6","1351323"
"chr1","69079938","69080214","chr14","67728740","67729016","7","1351198"
"chr1","69093050","69093342","chr14","67741694","67741980","12","1351356"
"chr1","69105501","69105610","chrX","90918797","90918904","19","21813296"
"chr1","69115135","69115419","chr14","67763966","67764219","33","1351169"
"chr1","69125363","69125671","chr14","67773854","67774161","6","1351509"
"chr1","69144158","69144492","chr14","67793131","67793439","31","1351027"
"chr1","69155210","69155510","chr14","67804528","67804822","10","1350682"
"chr1","69156574","69156857","chr14","67805889","67806171","3","1350685"
"chr1","69162402","69162703","chr14","67812022","67812322","5","1350380"
"chr1","69163466","69163752","chr14","67813092","67813384","14","1350374"
"chr1","69164246","69164541","chr14","67813872","67814166","10","1350374"
"chr1","69170665","69170905","chr14","67820607","67820847","7","1350058"
"chr1","69177255","69177462","chr14","67827826","67828033","9","1349429"
"chr1","69178743","69179052","chr14","67829314","67829626","9","1349429"
"chr1","69181327","69181622","chr14","67829644","67829931","15","1351683"
"chr1","69185279","69185584","chr14","67833917","67834225","7","1351362"
"chr1","69186756","69187068","chr6","75965294","75965604","66","6778538"
"chr1","69189845","69189994","chr14","67838602","67838752","4","1351243"
"chr1","69192990","69193130","chr14","67841748","67841888","2","1351242"
"chr1","69194739","69195023","chr14","67843497","67843778","8","1351242"
"chr1","69195375","69195528","chr14","67844121","67844274","0","1351254"
"chr1","69197551","69197664","chr14","67846295","67846408","2","1351256"
"chr1","69201336","69201632","chrX","49777712","49778013","60","19423624"
"chr1","69202530","69202811","chr14","67851295","67851603","31","1351235"
"chr1","69206595","69206881","chr1","153947272","153947564","67","84740677"
"chr1","69209461","69209762","chr14","67858510","67858813","7","1350951"
"chr1","69212153","69212439","chr14","67861206","67861515","29","1350947"
"chr1","69215058","69215235","chr13","96234058","96234229","29","27019000"
"chr1","69215280","69215550","chr14","67864309","67864579","5","1350971"
"chr1","69227364","69227555","chr14","67878831","67878995","34","1348533"
"chr1","69230616","69230835","chr14","67882106","67882325","2","1348510"
"chr1","69234450","69234734","chr14","67887704","67887984","7","1346746"
"chr1","69238012","69238282","chr14","67891218","67891494","15","1346794"
"chr1","69246957","69247142","chr14","67898461","67898647","13","1348496"
"chr1","69252409","69252665","chr14","67907155","67907410","13","1345254"
"chr1","69254420","69254736","chr14","67909163","67909495","20","1345257"
"chr1","69254799","69255100","chr14","67909542","67909842","7","1345257"
"chr1","69258164","69258474","chr14","67913563","67913868","10","1344601"
"chr1","69264493","69264796","chr14","67920004","67920310","10","1344489"
"chr1","69267805","69268127","chr14","67922941","67923270","15","1344864"
"chr1","69277127","69277343","chr14","67933090","67933306","0","1344037"
"chr1","69281397","69281674","chr14","67937317","67937600","12","1344080"
"chr1","69282790","69283082","chr8","40463498","40463792","54","28819292"
"chr1","69284487","69284798","chr14","67940381","67940672","29","1344106"
"chr1","69293168","69293237","chr2","86491964","86492039","17","17198796"
"chr1","69293238","69293378","chr7","159089698","159089835","24","89796460"
"chr1","69295604","69295917","chr14","67951610","67951927","10","1343994"
"chr1","69297422","69297721","chr14","67953426","67953724","4","1343996"
"chr1","69299900","69300065","chr14","67955886","67956050","7","1344014"
"chr1","69301567","69301691","chr14","67957556","67957680","1","1344011"
"chr1","69303477","69303751","chr13","116773361","116773636","60","47469884"
"chr1","69304274","69304546","chr14","67960203","67960472","5","1344071"
"chr1","69307303","69307599","chr14","67963217","67963525","16","1344086"
"chr1","69322980","69323244","chr14","67978921","67979185","6","1344059"
"chr1","69324313","69324618","chr14","67980292","67980590","23","1344021"
"chr1","69329912","69330217","chr14","67985878","67986180","8","1344034"
"chr1","69334530","69334825","chr14","67999158","67999449","12","1335372"
"chr1","69335352","69335654","chr14","68000002","68000272","36","1335350"
"chr1","69335851","69336021","chr13","47285224","47285397","37","22050627"
"chr1","69339427","69339644","chrX","50716939","50717149","42","18622488"
"chr1","69339647","69339740","chr1","64356404","64356510","29","4983243"
"chr1","69351623","69351941","chr14","68009223","68009541","2","1342400"
"chr1","69357801","69358061","chr14","68015184","68015453","10","1342617"
"chr1","69362109","69362391","chr14","68019499","68019783","8","1342610"
"chr1","69367137","69367436","chr14","68024539","68024838","8","1342598"
"chr1","69369435","69369777","chr13","16852127","16852474","87","52517308"
"chr1","69383168","69383450","chr4","154168512","154168802","59","84785344"
"chr1","69390908","69391191","chr14","68048805","68049089","5","1342103"
"chr1","69392251","69392495","chr14","68050149","68050393","10","1342102"
"chr1","69399101","69399425","chr14","68057354","68057667","25","1341747"
"chr1","69438087","69438392","chr2","56712044","56712343","51","12726043"
"chr1","69439140","69439437","chr14","68096532","68096839","14","1342608"
"chr1","69466019","69466134","chr14","68123764","68123877","5","1342255"
"chr1","69466164","69466351","chr14","68123929","68124112","6","1342235"
"chr1","69476433","69476529","chr14","68134137","68134226","7","1342296"
"chr1","69478775","69478934","chr14","68136549","68136708","0","1342226"
"chr1","69492436","69492731","chr14","68150365","68150652","10","1342071"
"chr1","69496404","69496687","chr14","68154534","68154832","20","1341870"
"chr1","69511599","69511724","chr14","68169781","68169906","2","1341818"
"chr1","69512402","69512483","chr1","52328523","52328606","17","17183879"
"chr1","69513606","69513763","chr14","68172004","68172166","7","1341602"
"chr1","69526382","69526657","chr14","68184565","68184816","29","1341817"
"chr1","69569797","69570109","chr14","68228872","68229183","7","1340925"
"chr1","69589769","69590053","chr18","13337810","13338092","55","56251959"
"chr1","69597112","69597323","chr14","68255808","68256019","5","1341304"
"chr1","69610666","69610959","chr14","68268754","68269047","4","1341912"
"chr1","69636262","69636527","chr14","68293216","68293481","5","1343046"
"chr1","69636531","69636833","chr14","68293485","68293787","9","1343046"
"chr1","69657667","69657948","chr14","68316067","68316347","8","1341600"
"chr1","69668984","69669252","chr14","68327392","68327659","9","1341592"
"chr1","69669544","69669708","chr17","4926416","4926578","34","64743128"
"chr1","69677100","69677392","chr14","68335861","68336166","18","1341239"
"chr1","69680752","69680968","chr14","68339527","68339742","6","1341225"
"chr1","69690551","69690871","chr14","68349885","68350182","32","1340666"
"chr1","69697360","69697564","chr14","68356660","68356868","9","1340700"
"chr1","69697683","69697983","chr14","68356987","68357286","3","1340696"
"chr1","69713488","69713779","chr14","68373001","68373290","5","1340487"
"chr1","69768374","69768526","chr19","13060538","13060678","45","56707836"
"chr1","69773927","69774212","chr14","68433480","68433768","11","1340447"
"chr1","69788258","69788385","chr14","68447750","68447877","6","1340508"
"chr1","69788437","69788586","chr14","68447912","68448059","8","1340525"
"chr1","69825503","69825633","chr10","62619052","62619187","29","7206451"
"chr1","69909307","69909611","chr14","68583299","68583603","3","1326008"
"chr1","69941558","69941894","chr14","68615714","68616050","6","1325844"
"chr1","69960816","69961117","chr14","68634740","68635045","13","1326076"
"chr1","70061545","70061837","chr14","68735617","68735909","4","1325928"
"chr1","70102270","70102577","chr14","68776203","68776508","8","1326067"
"chr1","70106526","70106782","chr2","41949823","41950074","71","28156703"
"chr1","70150857","70151179","chr14","68844199","68844516","16","1306658"
"chr1","70196541","70196818","chr14","68891403","68891681","8","1305138"
"chr1","70197628","70197949","chr14","68892480","68892788","28","1305148"
"chr1","70261318","70261559","chr14","68956541","68956789","13","1304777"
"chr1","70409241","70409534","chr14","69105779","69106078","17","1303462"
"chr1","70585851","70586028","chr1","11980907","11981080","37","58604944"
"chr1","70594513","70594820","chr14","69291285","69291592","8","1303228"
"chr1","70630744","70631073","chr8","75940983","75941285","77","5310239"
"chr1","70660135","70660282","chr14","69357268","69357415","5","1302867"
"chr1","70683122","70683415","chr14","69380199","69380479","24","1302923"
"chr1","70731014","70731309","chr14","69429907","69430206","16","1301107"
"chr1","70766519","70766674","chr1","111429353","111429516","31","40662834"
"chr1","70797568","70797881","chr14","69497355","69497697","36","1300213"
"chr1","70802840","70803142","chr14","69502627","69502933","9","1300213"
"chr1","70844859","70844996","chr14","69544621","69544758","4","1300238"
"chr1","70850185","70850370","chr14","69549765","69549949","8","1300420"
"chr1","70850544","70850851","chr14","69550123","69550430","5","1300421"
"chr1","70880204","70880499","chr14","69580609","69580893","24","1299595"
"chr1","71177271","71177417","chr14","69881145","69881291","2","1296126"
"chr1","71177465","71177486","chr14","69881323","69881346","2","1296142"
"chr1","71217086","71217239","chr14","69920133","69920279","8","1296953"
"chr1","71409240","71409538","chr14","70124280","70124578","4","1284960"
"chr1","71448287","71448597","chr2","60938916","60939220","59","10509371"
"chr1","71562423","71562631","chr14","70285701","70285909","6","1276722"
"chr1","71577126","71577416","chr16","73736952","73737242","63","2159826"
"chr1","71841667","71841885","chr14","70572937","70573162","12","1268730"
"chr1","72068482","72068781","chr14","70812685","70812983","10","1255797"
"chr1","72120659","72120970","chr14","70864813","70865106","27","1255846"
"chr1","72125968","72126219","chr14","70869988","70870239","2","1255980"
"chr1","72170276","72170421","chr14","70914870","70915015","3","1255406"
"chr1","72192119","72192412","chr14","70938883","70939220","50","1253236"
"chr1","72243038","72243311","chr14","99580447","99580720","64","27337409"
"chr1","72532257","72532541","chr14","71288281","71288573","15","1243976"
"chr1","72648193","72648311","chrX","108971246","108971363","16","36323053"
"chr1","72649708","72649967","chr14","71407425","71407709","34","1242283"
"chr1","72704964","72705263","chr14","71462929","71463230","12","1242035"
"chr1","72739688","72739931","chr14","71499184","71499427","7","1240504"
"chr1","72809961","72810260","chr14","71571020","71571319","8","1238941"
"chr1","72812010","72812304","chr14","71573081","71573373","16","1238929"
"chr1","72837249","72837327","chr7","106089161","106089239","16","33251912"
"chr1","72948127","72948355","chr14","71715136","71715366","3","1232991"
"chr1","72972026","72972333","chr14","71740803","71741109","4","1231223"
"chr1","73026047","73026358","chr14","71806450","71806765","12","1219597"
"chr1","73416498","73416658","chr14","72198857","72199017","4","1217641"
"chr1","73421984","73422291","chr14","72204180","72204486","4","1217804"
"chr1","73440238","73440521","chr14","72222379","72222666","15","1217859"
"chr1","73533086","73533297","chr1","185312133","185312324","60","111779047"
"chr1","73592915","73593217","chr14","72373533","72373835","7","1219382"
"chr1","73598779","73598906","chr14","72379408","72379539","6","1219371"
"chr1","73649896","73650206","chr14","72433115","72433423","8","1216781"
"chr1","73767185","73767291","chr14","72552913","72553030","15","1214272"
"chr1","73807518","73807821","chr14","72593188","72593491","4","1214330"
"chr1","73935592","73935908","chr14","72726255","72726565","31","1209337"
"chr1","73966697","73966855","chr19","36512354","36512503","36","37454343"
"chr1","73966858","73966924","chr5","75931637","75931703","14","1964779"
"chr1","73975908","73976074","chr1","25434148","25434318","36","48541760"
"chr1","73998230","73998325","chr14","72788973","72789068","2","1209257"
"chr1","73999044","73999113","chr14","72789791","72789860","1","1209253"
"chr1","74015953","74016258","chr14","72807777","72808083","7","1208176"
"chr1","74022220","74022322","chr14","72814057","72814159","2","1208163"
"chr1","74033254","74033561","chr14","72824947","72825253","6","1208307"
"chr1","74052800","74052927","chr14","72844030","72844163","7","1208770"
"chr1","74071369","74071676","chr14","72862125","72862431","7","1209244"
"chr1","74087830","74088126","chr14","72876675","72876971","12","1211155"
"chr1","74114875","74115112","chr14","72903852","72904081","18","1211023"
"chr1","74129338","74129643","chr14","72918345","72918650","16","1210993"
"chr1","74130872","74131176","chr14","72919888","72920189","40","1210984"
"chr1","74135866","74136165","chr14","72925008","72925307","11","1210858"
"chr1","74141577","74141833","chr14","72930688","72930943","9","1210889"
"chr1","74143541","74143837","chr1","33010955","33011254","50","41132586"
"chr1","74155334","74155614","chr14","72946064","72946353","19","1209270"
"chr1","74163148","74163441","chr14","72951416","72951725","35","1211732"
"chr1","74185616","74185914","chr9","60537590","60537885","48","13648026"
"chr1","74209026","74209299","chr14","72997976","72998250","12","1211050"
"chr1","74210360","74210647","chr14","72999318","72999604","7","1211042"
"chr1","74223864","74224161","chr14","73016021","73016307","26","1207843"
"chr1","74233412","74233658","chr14","73025208","73025454","8","1208204"
"chr1","74238941","74238981","chr9","22971194","22971237","7","51267747"
"chr1","74238982","74239163","chr7","33639198","33639379","43","40599784"
"chr1","74242202","74242472","chr14","73033994","73034268","8","1208208"
"chr1","74243870","74244164","chr14","73035790","73036087","8","1208080"
"chr1","74249442","74249757","chr14","73041676","73042001","16","1207766"
"chr1","74253870","74254153","chr14","73046117","73046400","5","1207753"
"chr1","74259268","74259522","chr14","73051289","73051577","44","1207979"
"chr1","74260217","74260462","chr14","73052590","73052835","4","1207627"
"chr1","74277251","74277375","chr14","73070336","73070454","9","1206915"
"chr1","74280169","74280455","chr14","73072919","73073205","10","1207250"
"chr1","74286008","74286290","chr14","73078936","73079220","3","1207072"
"chr1","74301422","74301554","chr13","42970669","42970807","27","31330753"
"chr1","74301555","74301870","chr14","73095153","73095468","9","1206402"
"chr1","74335603","74335765","chr3","42064302","42064465","28","32271301"
"chr1","74335768","74336046","chr14","73128983","73129286","38","1206785"
"chr1","74343422","74343722","chr14","73136656","73136956","12","1206766"
"chr1","74346893","74347199","chr14","73140425","73140725","16","1206468"
"chr1","74381124","74381251","chr14","73174812","73174939","2","1206312"
"chr1","74384902","74385011","chr14","73178581","73178687","5","1206321"
"chr1","74400694","74401001","chr14","73194624","73194931","6","1206070"
"chr1","74401539","74401622","chr14","73195471","73195555","6","1206068"
"chr1","74418139","74418442","chr14","73211756","73212051","16","1206383"
"chr1","74420956","74421219","chr11","100794196","100794458","56","26373240"
"chr1","74424113","74424375","chr14","73222611","73222873","11","1201502"
"chr1","74451098","74451385","chr14","73249915","73250202","3","1201183"
"chr1","74482118","74482419","chr14","73280772","73281078","10","1201346"
"chr1","74493349","74493652","chr7","123563020","123563331","67","49069671"
"chr1","74505697","74505979","chr14","73304654","73304946","14","1201043"
"chr1","74509229","74509514","chr14","73308196","73308487","14","1201033"
"chr1","74510573","74510829","chr14","73309548","73309804","13","1201025"
"chr1","74516521","74516798","chr14","73315969","73316246","3","1200552"
"chr1","74577978","74578278","chr14","73378666","73378972","10","1199312"
"chr1","74652251","74652543","chr14","73454558","73454850","4","1197693"
"chr1","74747532","74747842","chr14","73550147","73550453","8","1197385"
"chr1","74776920","74777205","chr14","73580861","73581158","20","1196059"
"chr1","74781796","74781913","chr14","73584927","73585042","3","1196869"
"chr1","74781957","74782220","chr14","73585072","73585342","13","1196885"
"chr1","74786009","74786324","chr14","73588658","73588963","15","1197351"
"chr1","74800083","74800366","chr2","135820200","135820485","55","61020117"
"chr1","74808557","74808834","chr14","73611142","73611450","37","1197415"
"chr1","74964728","74965011","chr14","73767783","73768065","15","1196945"
"chr1","75141411","75141700","chr14","73946743","73947033","7","1194668"
"chr1","75199124","75199434","chr1","20944520","20944832","68","54254604"
"chr1","75260005","75260334","chr2","182243139","182243459","73","106983134"
"chr1","75402055","75402332","chr14","74206613","74206890","9","1195442"
"chr1","75439673","75439977","chr14","74243795","74244095","11","1195878"
"chr1","75554268","75554565","chr14","74351972","74352269","5","1202296"
"chr1","75584443","75584667","chr14","74383409","74383636","8","1201034"
"chr1","75595794","75595980","chr3","37177589","37177771","43","38418205"
"chr1","75596041","75596155","chr4","41685326","41685443","26","33910715"
"chr1","75625401","75625695","chr14","74421669","74421957","19","1203732"
"chr1","75741755","75742035","chr13","23887456","23887734","65","51854299"
"chr1","75772408","75772727","chr13","70897947","70898255","82","4874461"
"chr1","75800250","75800510","chr14","74589682","74589942","3","1210568"
"chr1","75804883","75805185","chr14","74594449","74594750","12","1210434"
"chr1","75875561","75875872","chr5","172587347","172587650","67","96711786"
"chr1","76060099","76060395","chr14","74834185","74834486","7","1225914"
"chr1","76197038","76197348","chr14","74969682","74969995","16","1227356"
"chr1","76206793","76207033","chr1","64146265","64146492","63","12060528"
"chr1","76496387","76496564","chr14","75270205","75270382","3","1226182"
"chr1","76554845","76555005","chr14","75331617","75331774","8","1223228"
"chr1","76577062","76577341","chr14","75353372","75353651","6","1223690"
"chr1","76604466","76604579","chr14","75381063","75381176","3","1223403"
"chr1","76617921","76618269","chr2","67546556","67546901","16","9071365"
"chr1","76655055","76655367","chr14","75428154","75428450","25","1226901"
"chr1","76751878","76752181","chr7","52404382","52404685","68","24347496"
"chr1","76770507","76770800","chr14","75550938","75551232","6","1219569"
"chr1","76797033","76797321","chr14","75575357","75575645","5","1221676"
"chr1","76811631","76811929","chr14","75589895","75590197","24","1221736"
"chr1","76819657","76819959","chr1","33010955","33011254","61","43808702"
"chr1","76829227","76829522","chrX","15783794","15784082","53","61045433"
"chr1","76839160","76839345","chr6","148306943","148307115","45","71467783"
"chr1","76840362","76840642","chr7","147051823","147052102","58","70211461"
"chr1","76840697","76840710","chr1","72742630","72742643","2","4098067"
"chr1","76919445","76919610","chr20","32334821","32334984","30","44584624"
"chr1","76941340","76941645","chr14","75720757","75721056","15","1220583"
"chr1","76945258","76945562","chr14","75724627","75724933","11","1220631"
"chr1","77014614","77014894","chr14","75793986","75794274","15","1220628"
"chr1","77021446","77021764","chr14","75800719","75801037","3","1220727"
"chr1","77064777","77065031","chr14","75841771","75842025","2","1223006"
"chr1","77067651","77067971","chr14","75844629","75844945","13","1223022"
"chr1","77109061","77109330","chr14","75884811","75885077","8","1224250"
"chr1","77128486","77128786","chr14","75904195","75904495","4","1224291"
"chr1","77134745","77135042","chr14","75910453","75910750","5","1224292"
"chr1","77135928","77136137","chr14","75911635","75911844","4","1224293"
"chr1","77137195","77137476","chr14","75912902","75913183","9","1224293"
"chr1","77144019","77144196","chr14","75919710","75919889","5","1224309"
"chr1","77144360","77144640","chr14","75920053","75920327","10","1224307"
"chr1","77149311","77149427","chr14","75924978","75925093","2","1224333"
"chr1","77149523","77149824","chr14","75925187","75925490","8","1224336"
"chr1","77154291","77154578","chr14","75932781","75933076","15","1221510"
"chr1","77181416","77181717","chr14","75952249","75952550","9","1229167"
"chr1","77211791","77212077","chr14","75981723","75981999","17","1230068"
"chr1","77213452","77213735","chr14","75983380","75983663","2","1230072"
"chr1","77216087","77216165","chr14","75986009","75986087","2","1230078"
"chr1","77216468","77216688","chr14","75986390","75986610","5","1230078"
"chr1","77227085","77227379","chr14","75998388","75998682","6","1228697"
"chr1","77254425","77254716","chr14","76025391","76025678","12","1229034"
"chr1","77320548","77320839","chr14","76091971","76092239","29","1228577"
"chr1","77336705","77337016","chr12","62799016","62799324","53","14537689"
"chr1","77391068","77391368","chr14","76162875","76163180","15","1228193"
"chr1","77407660","77407746","chrX","16355595","16355680","15","61052065"
"chr1","77414973","77415259","chr14","76187622","76187908","7","1227351"
"chr1","77421133","77421436","chr14","76193454","76193757","7","1227679"
"chr1","77468910","77469206","chr14","76241210","76241506","2","1227700"
"chr1","77469354","77469654","chr14","76241654","76241955","7","1227700"
"chr1","77481167","77481483","chr14","76253128","76253445","6","1228039"
"chr1","77500240","77500507","chr14","76272259","76272526","9","1227981"
"chr1","77504549","77504826","chr14","76276533","76276819","18","1228016"
"chr1","77514312","77514432","chr16","49600162","49600281","22","27914150"
"chr1","77514862","77515060","chr8","20257594","20257789","35","57257268"
"chr1","77535804","77535999","chr14","76307995","76308188","2","1227809"
"chr1","77550951","77551132","chr14","76323183","76323365","9","1227768"
"chr1","77578281","77578577","chr14","76350571","76350867","5","1227710"
"chr1","77580244","77580554","chr14","76352531","76352840","6","1227713"
"chr1","77610104","77610396","chr14","76370214","76370506","3","1239890"
"chr1","77620486","77620749","chr17","23631138","23631409","63","53989348"
"chr1","77651958","77652271","chr14","76405455","76405765","9","1246503"
"chr1","77671669","77671965","chr14","76425095","76425392","5","1246574"
"chr1","77680858","77681148","chr14","76434074","76434375","16","1246784"
"chr1","77694022","77694333","chr14","76447280","76447589","11","1246742"
"chr1","77784945","77785251","chr14","76539642","76539964","29","1245303"
"chr1","77865959","77866260","chr14","76617750","76618052","3","1248209"
"chr1","77899646","77899846","chr14","76650809","76651009","3","1248837"
"chr1","77910360","77910543","chr14","76658251","76658434","3","1252109"
"chr1","77941206","77941467","chr14","76688665","76688927","11","1252541"
"chr1","77975062","77975139","chr14","76721906","76721983","0","1253156"
"chr1","77978505","77978801","chr14","76725379","76725675","2","1253126"
"chr1","78051133","78051341","chr14","76797332","76797540","5","1253801"
"chr1","78080224","78080528","chr14","76826447","76826746","13","1253777"
"chr1","78081678","78081883","chr14","76827897","76828101","7","1253781"
"chr1","78113834","78114097","chr14","76859059","76859322","10","1254775"
"chr1","78138619","78138940","chr14","76883893","76884210","16","1254726"
"chr1","78142393","78142692","chr14","76887635","76887940","13","1254758"
"chr1","78179420","78179692","chr14","76925460","76925734","8","1253960"
"chr1","78203322","78203615","chr14","76949036","76949322","10","1254286"
"chr1","78246084","78246233","chr19","33231639","33231774","35","45014445"
"chr1","78287030","78287113","chr14","77032325","77032408","1","1254705"
"chr1","78309802","78310089","chr14","77054050","77054351","32","1255752"
"chr1","78334970","78335173","chr14","77079923","77080126","3","1255047"
"chr1","78350902","78351179","chr14","77096323","77096596","9","1254579"
"chr1","78378122","78378300","chr4","123504803","123504965","70","45126681"
"chr1","78433727","78433951","chr14","77177323","77177547","6","1256404"
"chr1","78546688","78546974","chr14","77294515","77294798","9","1252173"
"chr1","78553346","78553628","chr14","77301039","77301335","22","1252307"
"chr1","78682195","78682475","chr14","77429745","77430025","3","1252450"
"chr1","78744565","78744886","chr14","77491089","77491396","17","1253476"
"chr1","78771027","78771174","chr1","119425525","119425657","39","40654498"
"chr1","79002117","79002255","chr1","13743522","13743663","26","65258595"
"chr1","79002256","79002342","chr17","15752105","15752197","40","63250151"
"chr1","79002343","79002591","chr18","42984739","42984984","53","36017604"
"chr1","79002914","79003206","chr14","77748738","77749030","6","1254176"
"chr1","79123289","79123619","chr14","77864232","77864568","21","1259057"
"chr1","79190010","79190289","chr14","77939495","77939773","6","1250515"
"chr1","79335518","79335832","chr14","78094951","78095269","63","1240567"
"chr1","79428848","79429128","chr14","78187080","78187362","11","1241768"
"chr1","79511205","79511504","chrX","105819753","105820054","74","26308548"
"chr1","79546778","79546896","chr3","170234130","170234248","22","90687352"
"chr1","79592048","79592344","chr14","78345995","78346291","6","1246053"
"chr1","79633517","79633650","chr14","78387290","78387423","3","1246227"
"chr1","79681798","79682078","chr14","78436714","78436996","13","1245084"
"chr1","79726948","79727260","chr14","78481940","78482251","6","1245008"
"chr1","79810917","79811121","chr16","45301217","45301409","52","34509700"
"chr1","79883079","79883391","chr14","78634831","78635148","20","1248248"
"chr1","79908107","79908146","chr1","46432746","46432787","10","33475361"
"chr1","80003093","80003394","chr14","78751983","78752285","8","1251110"
"chr1","80021863","80022214","chr14","78772203","78772537","33","1249660"
"chr1","80166502","80166792","chr14","78921093","78921376","10","1245409"
"chr1","80180115","80180253","chr14","78933561","78933713","16","1246554"
"chr1","80180305","80180340","chr1","1980648","1980684","10","78199657"
"chr1","80468737","80469035","chr14","79211822","79212126","12","1256915"
"chr1","80512469","80512784","chr14","79262807","79263119","32","1249662"
"chr1","80575103","80575409","chr14","79320582","79320886","8","1254521"
"chr1","80594348","80594650","chr14","79342118","79342420","8","1252230"
"chr1","80598002","80598138","chr17","87719481","87719614","37","7121479"
"chr1","80645918","80646248","chr19","48646889","48647203","77","31999029"
"chr1","80696447","80696737","chr14","79439198","79439491","6","1257249"
"chr1","80748610","80748857","chr14","79486186","79486433","4","1262424"
"chr1","80749487","80749543","chr14","79487058","79487114","4","1262429"
"chr1","80789296","80789592","chr14","79526343","79526650","54","1262953"
"chr1","80789634","80789847","chr1","93016186","93016399","43","12226552"
"chr1","80845051","80845239","chr14","79560717","79560910","8","1284334"
"chr1","80846402","80846541","chr14","79567944","79568083","2","1278458"
"chr1","80870242","80870534","chr14","79615424","79615734","22","1254818"
"chr1","80876656","80876931","chr14","79607490","79607765","4","1269166"
"chr1","80914352","80914416","chr3","49241333","49241397","13","31673019"
"chr1","80914693","80914994","chr5","36631339","36631642","72","44283354"
"chr1","80918491","80918767","chr14","79676464","79676740","16","1242027"
"chr1","81001833","81001996","chr18","38073773","38073932","35","42928060"
"chr1","81015770","81016040","chr7","75720603","75720873","76","5295167"
"chr1","81070680","81070956","chr14","79676464","79676740","15","1394216"
"chr1","81077514","81077799","chr14","79683316","79683600","15","1394198"
"chr1","81117734","81117885","chr3","67258291","67258436","38","13859443"
"chr1","81144553","81144835","chr14","79793186","79793467","9","1351367"
"chr1","81154458","81154751","chr14","79806227","79806522","7","1348231"
"chr1","81158293","81158587","chr14","79809267","79809556","13","1349026"
"chr1","81181025","81181176","chr1","15506373","15506526","33","65674652"
"chr1","81199814","81200102","chr12","98035076","98035363","69","16835262"
"chr1","81225198","81225467","chr13","41054163","41054437","60","40171035"
"chr1","81230425","81230731","chr16","46515364","46515663","61","34715061"
"chr1","81236866","81237032","chr14","79843594","79843760","6","1393272"
"chr1","81242141","81242430","chrX","120356258","120356539","58","39114117"
"chr1","81303520","81303651","chr14","79914318","79914449","1","1389202"
"chr1","81368352","81368655","chr14","79938772","79939099","36","1429580"
"chr1","81406504","81406771","chr14","79971280","79971550","8","1435224"
"chr1","81423098","81423270","chr14","68136549","68136708","43","13286549"
"chr1","81474013","81474287","chrX","21956129","21956396","69","59517884"
"chr1","81475524","81475636","chr2","87322923","87323035","19","5847399"
"chr1","81502134","81502431","chr14","80054746","80055045","17","1447388"
"chr1","81505222","81505479","chr14","80058098","80058358","8","1447124"
"chr1","81542285","81542443","chr3","55268081","55268241","34","26274204"
"chr1","81542469","81542587","chr14","9000001","9000120","22","72542468"
"chr1","81644897","81645182","chr14","80209180","80209480","42","1435717"
"chr1","81645192","81645325","chr4","119142322","119142454","19","37497130"
"chr1","81775543","81775654","chr14","80327500","80327611","3","1448043"
"chr1","82031678","82031981","chr14","80564524","80564822","26","1467154"
"chr1","82067543","82067801","chr14","80599081","80599345","31","1468462"
"chr1","82068158","82068175","chr1","87667990","87668009","3","5599832"
"chr1","82154527","82154689","chr14","80680058","80680220","10","1474469"
"chr1","82171681","82171944","chr14","80697398","80697660","8","1474283"
"chr1","82172061","82172184","chr16","71453452","71453570","33","10718609"
"chr1","82232895","82233190","chr14","80749508","80749818","27","1483387"
"chr1","82471981","82472219","chr14","80989817","80990077","33","1482164"
"chr1","82522106","82522356","chr14","81036504","81036755","5","1485602"
"chr1","82527918","82528220","chr14","81042009","81042297","22","1485909"
"chr1","82600133","82600434","chr14","81113454","81113754","7","1486679"
"chr1","82716519","82716647","chr14","81235395","81235523","5","1481124"
"chr1","82759116","82759415","chr14","81275765","81276065","13","1483351"
"chr1","83046330","83046624","chr14","81574254","81574548","6","1472076"
"chr1","83254478","83254639","chr9","108828367","108828524","32","25573889"
"chr1","83391172","83391466","chr8","111690619","111690914","71","28299447"
"chr1","83426162","83426336","chr14","81962638","81962811","6","1463524"
"chr1","83531598","83531803","chr14","82068139","82068344","4","1463459"
"chr1","83569727","83569999","chr14","82106195","82106467","6","1463532"
"chr1","83577257","83577547","chr14","82113731","82114019","18","1463526"
"chr1","83590713","83591002","chr14","82127168","82127460","10","1463545"
"chr1","83643551","83643808","chr14","82185384","82185642","8","1458167"
"chr1","83661123","83661434","chr14","82203507","82203819","31","1457616"
"chr1","83712199","83712512","chr14","82254997","82255309","5","1457202"
"chr1","83903647","83903915","chr14","82441400","82441668","6","1462247"
"chr1","83954799","83955064","chr3","17465926","17466180","73","66488873"
"chr1","84005388","84005671","chr14","82541907","82542190","5","1463481"
"chr1","84045599","84045900","chr14","82582341","82582643","8","1463258"
"chr1","84047420","84047538","chr12","91911148","91911263","20","7863728"
"chr1","84047575","84047717","chr1","13399085","13399226","40","70648490"
"chr1","84047723","84047967","chr14","82584458","82584702","5","1463265"
"chr1","84212742","84212862","chr14","82754785","82754905","6","1457957"
"chr1","84218840","84219129","chr14","82760893","82761193","25","1457947"
"chr1","84236468","84236701","chr14","82779207","82779439","6","1457261"
"chr1","84266775","84266853","chr6","143182053","143182129","21","58915278"
"chr1","84332485","84332808","chr14","82877673","82877950","58","1454812"
"chr1","84410747","84411027","chr14","82942571","82942851","12","1468176"
"chr1","84473696","84473995","chr14","83007960","83008259","6","1465736"
"chr1","84518319","84518616","chr14","83051992","83052288","12","1466327"
"chr1","84530029","84530310","chr14","83063447","83063732","14","1466582"
"chr1","84552053","84552338","chr14","83083736","83084032","18","1468317"
"chr1","84565093","84565204","chr1","21838633","21838735","34","62726460"
"chr1","84595659","84595906","chr14","83125048","83125295","10","1470611"
"chr1","84636753","84637023","chr14","83165415","83165686","7","1471338"
"chr1","84644021","84644222","chr14","83172627","83172814","18","1471394"
"chr1","84754115","84754426","chr14","83280252","83280556","11","1473863"
"chr1","84769659","84769845","chr11","38369515","38369683","40","46400144"
"chr1","84769891","84770161","chr9","92718527","92718801","48","7948636"
"chr1","84774154","84774447","chr14","83298601","83298894","6","1475553"
"chr1","84796396","84796683","chr14","83320721","83321008","15","1475675"
"chr1","84836925","84837211","chrX","49902292","49902576","49","34934633"
"chr1","84841087","84841251","chr12","93463713","93463873","31","8622626"
"chr1","84875793","84876098","chr14","83393551","83393856","5","1482242"
"chr1","84902105","84902402","chr14","83419098","83419392","16","1483007"
"chr1","84930246","84930543","chr14","83447967","83448264","12","1482279"
"chr1","84930573","84930878","chr10","90739438","90739709","97","5808865"
"chr1","84951482","84951625","chr5","101392148","101392288","22","16440666"
"chr1","84951932","84952093","chr11","50271411","50271572","30","34680521"
"chr1","84954734","84954912","chr7","77811923","77812126","60","7142811"
"chr1","84970117","84970417","chr14","83489062","83489364","8","1481055"
"chr1","84972496","84972788","chr14","83491436","83491727","5","1481060"
"chr1","84974237","84974526","chr14","83493015","83493304","9","1481222"
"chr1","84981187","84981393","chr20","26993039","26993219","73","57988148"
"chr1","84992139","84992353","chr14","83510835","83511049","6","1481304"
"chr1","85017040","85017282","chr14","83535498","83535729","16","1481542"
"chr1","85017688","85017981","chr14","83536138","83536432","10","1481550"
"chr1","85019238","85019531","chr14","83537631","83537954","35","1481607"
"chr1","85022644","85022923","chr14","83540952","83541216","17","1481692"
"chr1","85026256","85026563","chr14","83544587","83544885","16","1481669"
"chr1","85031300","85031438","chr14","83550112","83550245","7","1481188"
"chr1","85038649","85038924","chr14","83557204","83557490","34","1481445"
"chr1","85046694","85046980","chr14","83569847","83570133","7","1476847"
"chr1","85059666","85059963","chr14","83583399","83583689","12","1476267"
"chr1","85062908","85063216","chr14","83586639","83586938","56","1476269"
"chr1","85071480","85071540","chr20","10976550","10976613","11","74094930"
"chr1","85073583","85073853","chr14","83596415","83596719","50","1477168"
"chr1","85073867","85074051","chr20","56244616","56244776","53","28829251"
"chr1","85074470","85074581","chr14","83597001","83597111","6","1477469"
"chr1","85080232","85080392","chr14","83604588","83604752","7","1475644"
"chr1","85080434","85080555","chr14","83604774","83604893","3","1475660"
"chr1","85080558","85080806","chr14","83604896","83605145","7","1475662"
"chr1","85082784","85083060","chr14","83607128","83607403","4","1475656"
"chr1","85088485","85088785","chr14","83612663","83612965","12","1475822"
"chr1","85099336","85099644","chr14","83623561","83623868","21","1475775"
"chr1","85102187","85102497","chr14","83626370","83626672","14","1475817"
"chr1","85130642","85130945","chr14","83653790","83654093","9","1476852"
"chr1","85130981","85131088","chr11","43960970","43961075","22","41170011"
"chr1","85148136","85148415","chr14","83674756","83675043","19","1473380"
"chr1","85177076","85177335","chr14","83707576","83707835","6","1469500"
"chr1","85202779","85202855","chr7","106089161","106089239","17","20886382"
"chr1","85203415","85203716","chr14","83731204","83731503","12","1472211"
"chr1","85211619","85211951","chr19","12878349","12878677","61","72333270"
"chr1","85223192","85223451","chr14","83754249","83754510","12","1468943"
"chr1","85235148","85235444","chr14","83766165","83766464","12","1468983"
"chr1","85254210","85254496","chr8","29000610","29000896","73","56253600"
"chr1","85264410","85264532","chr1","21418811","21418933","17","63845599"
"chr1","85266586","85266893","chr14","83792905","83793212","9","1473681"
"chr1","85288392","85288539","chr3","3776853","3777003","27","81511539"
"chr1","85288546","85288849","chr14","83813510","83813813","9","1475036"
"chr1","85325859","85326187","chr20","11373791","11374095","72","73952068"
"chr1","85391333","85391622","chr14","83922387","83922663","24","1468946"
"chr1","85650039","85650332","chr14","84184855","84185150","8","1465184"
"chr1","85739474","85739746","chr14","84272597","84272869","9","1466877"
"chr1","85756683","85756979","chr14","84289795","84290096","12","1466888"
"chr1","85773060","85773339","chr14","84306127","84306406","9","1466933"
"chr1","85899769","85900064","chr14","84432131","84432424","8","1467638"
"chr1","85900143","85900222","chr3","45654124","45654206","16","40246019"
"chr1","86006704","86006771","chr14","114903398","114903465","16","28896694"
"chr1","86006783","86006847","chr6","46377755","46377820","23","39629028"
"chr1","86006897","86007167","chr14","84535739","84536010","10","1471158"
"chr1","86201299","86201476","chr9","73575378","73575563","40","12625921"
"chr1","86232943","86233191","chr14","84755774","84756061","43","1477169"
"chr1","86257918","86258139","chr14","84780944","84781165","4","1476974"
"chr1","86290731","86290949","chr14","84812185","84812401","8","1478546"
"chr1","86345093","86345383","chr14","84863740","84864037","13","1481353"
"chr1","86348733","86349040","chr14","84867409","84867712","11","1481324"
"chr1","86352705","86352925","chr14","84871043","84871263","2","1481662"
"chr1","86362741","86362990","chr20","2899227","2899498","87","83463514"
"chr1","86362991","86363101","chr8","69590703","69590817","30","16772288"
"chr1","86375082","86375373","chr14","84893954","84894247","9","1481128"
"chr1","86462625","86462743","chr11","122559106","122559224","17","36096481"
"chr1","86513500","86513804","chr14","85027251","85027555","8","1486249"
"chr1","86513807","86514098","chr4","35119120","35119410","52","51394687"
"chr1","86520295","86520529","chr7","115106507","115106743","54","28586212"
"chr1","86521480","86521766","chr11","121302123","121302418","64","34780643"
"chr1","86573718","86574027","chr14","85084602","85084911","8","1489116"
"chr1","86591073","86591352","chr14","67728740","67729016","63","18862333"
"chr1","86886549","86886815","chr5","33703173","33703447","54","53183376"
"chr1","87013635","87013928","chr14","85509401","85509707","26","1504234"
"chr1","87111318","87111616","chr14","85604288","85604586","6","1507030"
"chr1","87111659","87111963","chr14","85604628","85604934","11","1507031"
"chr1","87116521","87116589","chr4","84248550","84248617","15","2867971"
"chr1","87125185","87125502","chr14","85617864","85618183","15","1507321"
"chr1","87174344","87174638","chr14","85665046","85665339","5","1509298"
"chr1","87186317","87186621","chr14","85676375","85676673","11","1509942"
"chr1","87210534","87210835","chr14","85699723","85700014","18","1510811"
"chr1","87216576","87216858","chr14","85705123","85705404","13","1511453"
"chr1","87228410","87228691","chr14","85716821","85717111","14","1511589"
"chr1","87230800","87231100","chr14","85719324","85719625","6","1511476"
"chr1","87253102","87253421","chr14","85741185","85741508","21","1511917"
"chr1","87290574","87290856","chr14","85775806","85776121","41","1514768"
"chr1","87301951","87302230","chr14","85787050","85787332","7","1514901"
"chr1","87332821","87333130","chr14","85817767","85818074","6","1515054"
"chr1","87366384","87366717","chr14","85849973","85850307","5","1516411"
"chr1","87374553","87374809","chr14","85858045","85858336","43","1516508"
"chr1","87383143","87383457","chr14","85866641","85866940","18","1516502"
"chr1","87399169","87399480","chr14","85882974","85883279","15","1516195"
"chr1","87496391","87496650","chr14","85975464","85975722","7","1520927"
"chr1","87524848","87525148","chr14","86003127","86003442","18","1521721"
"chr1","87552502","87552729","chr14","86030552","86030780","6","1521950"
"chr1","87581019","87581326","chr14","86058211","86058510","15","1522808"
"chr1","87602519","87602822","chr14","86079895","86080198","5","1522624"
"chr1","87711452","87711733","chr14","86189212","86189494","9","1522240"
"chr1","87904335","87904592","chr14","86385168","86385458","63","1519167"
"chr1","87904614","87904900","chr14","86385168","86385458","12","1519446"
"chr1","87924879","87925196","chr14","86408618","86408932","9","1516261"
"chr1","87925214","87925344","chr16","49111618","49111740","25","38813596"
"chr1","88091889","88092162","chr14","86576901","86577171","8","1514988"
"chr1","88313177","88313343","chr14","86798031","86798198","5","1515146"
"chr1","88591111","88591213","chr14","87065616","87065718","1","1525495"
"chr1","88622335","88622567","chr14","87094638","87094906","52","1527697"
"chr1","88622628","88622786","chr7","38567520","38567681","31","50055108"
"chr1","88652925","88653224","chr14","87123554","87123851","14","1529371"
"chr1","88654377","88654655","chr14","87124812","87125094","17","1529565"
"chr1","88675384","88675675","chr14","87142972","87143263","8","1532412"
"chr1","88868320","88868615","chr1","159614491","159614771","63","70746171"
"chr1","88877891","88878168","chr14","87292913","87293190","3","1584978"
"chr1","88989849","88990115","chr14","87401940","87402206","7","1587909"
"chr1","89019137","89019457","chr1","50966532","50966843","67","38052605"
"chr1","89035754","89036040","chr14","87446071","87446358","11","1589683"
"chr1","89089754","89090067","chr14","87503974","87504301","23","1585780"
"chr1","89202935","89203224","chr14","87603250","87603555","24","1599685"
"chr1","89334615","89334911","chr12","12937852","12938121","95","76396763"
"chr1","89350068","89350342","chr14","87751086","87751402","64","1598982"
"chr1","89489498","89489771","chr14","87886560","87886832","6","1602938"
"chr1","89498331","89498622","chr5","158962682","158962956","80","69464351"
"chr1","89533122","89533296","chr14","87930927","87931111","18","1602195"
"chr1","89771593","89771714","chr14","88168913","88169048","16","1602680"
"chr1","89880738","89881024","chr14","88277750","88278036","13","1602988"
"chr1","89948634","89948939","chr8","68808553","68808854","64","21140081"
"chr1","89986989","89987261","chr4","103392528","103392783","57","13405539"
"chr1","90081184","90081275","chr14","88386372","88386472","10","1694812"
"chr1","90081288","90081347","chr9","54903000","54903057","13","35178288"
"chr1","90081348","90081447","chr14","88386372","88386472","15","1694976"
"chr1","90196458","90196762","chr14","88506511","88506811","20","1689947"
"chr1","90208983","90209257","chr14","88518652","88518926","12","1690331"
"chr1","90218979","90219261","chr14","88532803","88533084","6","1686176"
"chr1","90239045","90239355","chr14","88550639","88550919","38","1688406"
"chr1","90497715","90497989","chr14","88788516","88788789","3","1709199"
"chr1","90519382","90519691","chr14","88808516","88808825","8","1710866"
"chr1","90618793","90619014","chr14","88904586","88904801","26","1714207"
"chr1","90771019","90771300","chr4","68672748","68673030","54","22098271"
"chr1","90788422","90788719","chr14","89074043","89074337","14","1714379"
"chr1","90809328","90809640","chr14","89094795","89095083","34","1714533"
"chr1","91103613","91103929","chr14","89388017","89388311","41","1715596"
"chr1","91194281","91194550","chr14","89456790","89457062","19","1737491"
"chr1","91211694","91211857","chr14","89473502","89473665","2","1738192"
"chr1","91232129","91232340","chr1","139457966","139458178","55","48225837"
"chr1","91232828","91232890","chr20","10976550","10976613","16","80256278"
"chr1","91263724","91264032","chr14","89523610","89523918","8","1740114"
"chr1","91430984","91431239","chr14","89699922","89700153","34","1731062"
"chr1","91436554","91436796","chr3","110249716","110249950","60","18813162"
"chr1","91436868","91437052","chrX","68323213","68323392","47","23113655"
"chr1","91450473","91450586","chr7","55585828","55585939","23","35864645"
"chr1","91501359","91501670","chr14","89771154","89771472","27","1730205"
"chr1","91566644","91566941","chr14","89843358","89843655","16","1723286"
"chr1","91568822","91569103","chr14","89849132","89849413","5","1719690"
"chr1","91585271","91585374","chr14","89865694","89865797","3","1719577"
"chr1","91777473","91777629","chr14","90050977","90051117","21","1726496"
"chr1","91777669","91777821","chr14","90051169","90051333","24","1726500"
"chr1","91948549","91948862","chr14","90212845","90213159","7","1735704"
"chr1","92050288","92050421","chr1","21721800","21721934","26","70328488"
"chr1","92050461","92050482","chr13","84148589","84148606","6","7901872"
"chr1","92050538","92050698","chr1","137945830","137945989","25","45895292"
"chr1","92068881","92069184","chr14","90326171","90326474","10","1742710"
"chr1","92069201","92069329","chr12","64783013","64783135","28","27286188"
"chr1","92074565","92074785","chr20","32220718","32220934","49","59853847"
"chr1","92076426","92076691","chr1","163219521","163219784","57","71143095"
"chr1","92090393","92090687","chr14","90347165","90347459","9","1743228"
"chr1","92093324","92093651","chr14","90350544","90350849","32","1742780"
"chr1","92164618","92164920","chr14","90417803","90418100","15","1746815"
"chr1","92175019","92175331","chr1","196770235","196770543","57","104595216"
"chr1","92190565","92190856","chr3","109526834","109527120","57","17336269"
"chr1","92220060","92220288","chr14","90470370","90470598","7","1749690"
"chr1","92315082","92315371","chr14","90562380","90562669","10","1752702"
"chr1","92324570","92324840","chr9","66532724","66532995","62","25791846"
"chr1","92377431","92377562","chr7","161224165","161224284","32","68846734"
"chr1","92377564","92377823","chr14","90624080","90624349","40","1753484"
"chr1","92445893","92446207","chr14","90696678","90696998","11","1749215"
"chr1","92653492","92653789","chr14","90891142","90891439","10","1762350"
"chr1","92657823","92658100","chr14","90895489","90895766","5","1762334"
"chr1","92872105","92872269","chr14","91107119","91107290","9","1764986"
"chr1","92886009","92886298","chr14","91120350","91120632","17","1765659"
"chr1","92889227","92889408","chr11","64297155","64297331","39","28592072"
"chr1","92944308","92944440","chr13","84752135","84752271","30","8192173"
"chr1","93181425","93181603","chr14","91426284","91426458","11","1755141"
"chr1","93211460","93211738","chr14","91455525","91455803","8","1755935"
"chr1","93256814","93256935","chr14","91501462","91501591","11","1755352"
"chr1","93295388","93295663","chr14","91537161","91537451","26","1758227"
"chr1","93297805","93298106","chr14","91539578","91539875","7","1758227"
"chr1","93363391","93363659","chr14","91604633","91604910","15","1758758"
"chr1","93371906","93372207","chr14","91612651","91612952","12","1759255"
"chr1","93391089","93391374","chr14","91631976","91632262","6","1759113"
"chr1","93404960","93405236","chr14","91644243","91644519","2","1760717"
"chr1","93408290","93408548","chr14","91649635","91649893","5","1758655"
"chr1","93409047","93409352","chr14","91650390","91650699","8","1758657"
"chr1","93421462","93421617","chr20","4128397","4128536","34","89293065"
"chr1","93435361","93435673","chr14","91675928","91676256","33","1759433"
"chr1","93441596","93441713","chrX","108971246","108971363","16","15529650"
"chr1","93448751","93449067","chr14","91687355","91687676","9","1761396"
"chr1","93460676","93460909","chr14","91698795","91699050","28","1761881"
"chr1","93461417","93461563","chr2","67925671","67925816","38","25535746"
"chr1","93461839","93461977","chr10","30781278","30781412","22","62680561"
"chr1","93462376","93462675","chr14","91700693","91700992","7","1761683"
"chr1","93490121","93490424","chr14","91728505","91728807","8","1761616"
"chr1","93490740","93490990","chr14","91729143","91729398","48","1761597"
"chr1","93493677","93493943","chr14","91732301","91732566","6","1761376"
"chr1","93502166","93502463","chr4","17176207","17176507","52","76325959"
"chr1","93503549","93503696","chrX","77786366","77786510","23","15717183"
"chr1","93503960","93504025","chr14","91742386","91742452","2","1761574"
"chr1","93505172","93505467","chr14","91743596","91743889","5","1761576"
"chr1","93536605","93536874","chr14","91774923","91775195","9","1761682"
"chr1","93544377","93544547","chr14","91782474","91782636","18","1761903"
"chr1","93594346","93594651","chr14","91831206","91831516","13","1763140"
"chr1","93600404","93600683","chr14","91837530","91837813","11","1762874"
"chr1","93612673","93612833","chr14","91849696","91849866","17","1762977"
"chr1","93612861","93612976","chr14","91849901","91850017","4","1762960"
"chr1","93617427","93617723","chr14","91852077","91852373","11","1765350"
"chr1","93623528","93623839","chr14","91857646","91857953","14","1765882"
"chr1","93626399","93626722","chr14","91861206","91861520","48","1765193"
"chr1","93628795","93629071","chr14","91863339","91863612","6","1765456"
"chr1","93652822","93652962","chr19","6193325","6193461","20","87459497"
"chr1","93653589","93653749","chr14","91889255","91889429","17","1764334"
"chr1","93687698","93688005","chr14","91922712","91923018","6","1764986"
"chr1","93739381","93739554","chr14","91975583","91975756","21","1763798"
"chr1","93739588","93739713","chr14","91975794","91975915","6","1763794"
"chr1","93762855","93763083","chr14","12286781","12286986","77","81476074"
"chr1","93768335","93768615","chr4","124731368","124731651","61","30963033"
"chr1","93795400","93795682","chr14","92030055","92030328","22","1765345"
"chr1","93828180","93828487","chr14","92064678","92064985","5","1763502"
"chr1","93855652","93855941","chr14","92090917","92091206","10","1764735"
"chr1","93864392","93864681","chr14","92099305","92099565","33","1765087"
"chr1","93880370","93880549","chr14","92114996","92115174","6","1765374"
"chr1","93880626","93880642","chr11","51521060","51521073","5","42359566"
"chr1","93881256","93881327","chr14","92115873","92115944","0","1765383"
"chr1","93881461","93881536","chr14","92116078","92116153","1","1765383"
"chr1","93911720","93912030","chr14","92146488","92146797","10","1765232"
"chr1","93944605","93944895","chr11","125705007","125705304","47","31760402"
"chr1","93948397","93948685","chr14","92182124","92182410","6","1766273"
"chr1","93949512","93949821","chr14","92183227","92183536","4","1766285"
"chr1","94054450","94054766","chr14","92274483","92274785","39","1779967"
"chr1","94077333","94077619","chr14","92297885","92298195","43","1779448"
"chr1","94165871","94165916","chr14","92387146","92387191","1","1778725"
"chr1","94166343","94166589","chr14","92387575","92387814","17","1778768"
"chr1","94177315","94177627","chr13","46319379","46319675","68","47857936"
"chr1","94229572","94229671","chr14","92448286","92448385","2","1781286"
"chr1","94257566","94257875","chr14","92472979","92473289","18","1784587"
"chr1","94258063","94258372","chr14","92473406","92473717","11","1784657"
"chr1","94263788","94263951","chr20","66786288","66786451","42","27477500"
"chr1","94264240","94264414","chr6","58082549","58082722","55","36181691"
"chr1","94266836","94266903","chr2","86476520","86476585","11","7790316"
"chr1","94267279","94267565","chr14","92481644","92481926","25","1785635"
"chr1","94271882","94272175","chr14","92486976","92487259","29","1784906"
"chr1","94272218","94272484","chr14","92486976","92487259","43","1785242"
"chr1","94276121","94276407","chr14","92492011","92492299","19","1784110"
"chr1","94280649","94280860","chr14","92496668","92496879","13","1783981"
"chr1","94283638","94283929","chr14","92499408","92499707","17","1784230"
"chr1","94285805","94286121","chrX","138546860","138547170","75","44261055"
"chr1","94314595","94314788","chr3","80795189","80795371","55","13519406"
"chr1","94320847","94321132","chr14","92534612","92534895","16","1786235"
"chr1","94400416","94400545","chr14","92614000","92614105","26","1786416"
"chr1","94462065","94462315","chr14","92678483","92678771","44","1783582"
"chr1","94496919","94497084","chr14","92712615","92712783","4","1784304"
"chr1","94499481","94499792","chr14","92715187","92715496","10","1784294"
"chr1","94538723","94539003","chr14","92752859","92753160","26","1785864"
"chr1","94684831","94684971","chr10","25392135","25392275","26","69292696"
"chr1","94719584","94719740","chr14","92928075","92928227","9","1791509"
"chr1","94752603","94752872","chr14","92959820","92960092","10","1792783"
"chr1","94772768","94773061","chr14","92978472","92978765","16","1794296"
"chr1","94802404","94802707","chr14","92998547","92998853","13","1803857"
"chr1","94833656","94833733","chr14","93024912","93024996","8","1808744"
"chr1","94834894","94834984","chr14","93026177","93026267","7","1808717"
"chr1","94838810","94839105","chr14","93030092","93030387","9","1808718"
"chr1","94850147","94850451","chr14","93047081","93047385","8","1803066"
"chr1","94864920","94865107","chr14","93061794","93061979","10","1803126"
"chr1","94916606","94916715","chr1","16081694","16081810","30","78834912"
"chr1","94937245","94937537","chr14","93132993","93133285","19","1804252"
"chr1","95153257","95153377","chr12","33213442","33213552","31","61939815"
"chr1","95153378","95153579","chrX","19112486","19112681","56","76040892"
"chr1","95261684","95261994","chr14","93447544","93447857","18","1814140"
"chr1","95377779","95378062","chr14","93561159","93561458","28","1816620"
"chr1","95422825","95423061","chr15","43644601","43644833","49","51778224"
"chr1","95464894","95465078","chrX","107339105","107339290","36","11874211"
"chr1","95490503","95490772","chr14","93681906","93682187","24","1808597"
"chr1","95491351","95491527","chr20","23254642","23254804","59","72236709"
"chr1","95491548","95491818","chr14","93682756","93683028","8","1808792"
"chr1","95491857","95491875","chr6","135941415","135941432","3","40449558"
"chr1","95498670","95498967","chr14","93691117","93691421","10","1807553"
"chr1","95542997","95543168","chr14","93733283","93733454","1","1809714"
"chr1","95599999","95600290","chr14","93790022","93790312","6","1809977"
"chr1","95763012","95763291","chr14","93953982","93954272","23","1809030"
"chr1","95805788","95806087","chr1","28978297","28978584","58","66827491"
"chr1","95809594","95809875","chr14","94001131","94001419","30","1808463"
"chr1","95827580","95827688","chr10","27140525","27140637","18","68687055"
"chr1","95827768","95827934","chr1","129720178","129720342","40","33892410"
"chr1","95864824","95865107","chr14","94053662","94053925","25","1811162"
"chr1","95900079","95900307","chr6","169500535","169500753","82","73600456"
"chr1","95954602","95954906","chr14","94146415","94146720","18","1808187"
"chr1","95982308","95982608","chr14","94175129","94175418","20","1807179"
"chr1","96205349","96205602","chr14","94393312","94393592","39","1812037"
"chr1","96318871","96319164","chr14","10387983","10388276","67","85930888"
"chr1","96401059","96401107","chr15","6815216","6815259","9","89585843"
"chr1","96401167","96401439","chr8","94443526","94443804","68","1957641"
"chr1","96614637","96614697","chr8","92567790","92567854","13","4046847"
"chr1","96757452","96757757","chr14","94770091","94770400","14","1987361"
"chr1","96840571","96840873","chr14","94852793","94853095","10","1987778"
"chr1","96894269","96894379","chr14","94904445","94904555","4","1989824"
"chr1","96917759","96918030","chr14","94927791","94928060","14","1989968"
"chr1","96922063","96922257","chrX","7455669","7455856","48","89466394"
"chr1","96922868","96923172","chr11","49468649","49468943","71","47454219"
"chr1","96941156","96941193","chr7","159514506","159514543","6","62573350"
"chr1","96941198","96941374","chr1","188751467","188751638","47","91810269"
"chr1","96944844","96945151","chr14","94956713","94957006","26","1988131"
"chr1","96975486","96975778","chr14","94985132","94985428","15","1990354"
"chr1","97023074","97023289","chr6","61679011","61679231","61","35344063"
"chr1","97041500","97041630","chr14","95049440","95049569","3","1992060"
"chr1","97042991","97043128","chr14","95050923","95051072","14","1992068"
"chr1","97194344","97194591","chr14","95208948","95209193","7","1985396"
"chr1","97194663","97194675","chr14","95209269","95209281","0","1985394"
"chr1","97298063","97298373","chr14","95312595","95312905","13","1985468"
"chr1","97342135","97342427","chr14","95357299","95357595","11","1984836"
"chr1","97346392","97346685","chr14","95361895","95362172","24","1984497"
"chr1","97482364","97482480","chr14","95493730","95493846","2","1988634"
"chr1","97614585","97614646","chr10","79598512","79598573","11","18016073"
"chr1","97629919","97630203","chr14","95631300","95631584","3","1998619"
"chr1","97758367","97758679","chr14","95756478","95756786","15","2001889"
"chr1","97779108","97779182","chrX","28233042","28233115","18","69546066"
"chr1","97779227","97779421","chr1","67267341","67267514","73","30511886"
"chr1","98121680","98121997","chr14","96112567","96112896","26","2009113"
"chr1","98191627","98191696","chr18","51499572","51499640","10","46692055"
"chr1","98191711","98191794","chr10","79901110","79901187","17","18290601"
"chr1","98200819","98201118","chr14","96198633","96198919","14","2002186"
"chr1","98271285","98271498","chr14","96263190","96263401","8","2008095"
"chr1","98316968","98317257","chr7","65087706","65087997","55","33229262"
"chr1","98342041","98342345","chr14","96330985","96331264","35","2011056"
"chr1","98362950","98363260","chr14","96351318","96351629","30","2011632"
"chr1","98363274","98363478","chr14","96351643","96351844","10","2011631"
"chr1","98582564","98582865","chr16","23687884","23688182","56","74894680"
"chr1","98599590","98599885","chrX","36812579","36812875","61","61787011"
"chr1","98693011","98693250","chr14","96561140","96561396","28","2131871"
"chr1","98744098","98744376","chr14","96607568","96607841","16","2136530"
"chr1","98745259","98745322","chr14","96608713","96608776","1","2136546"
"chr1","98840656","98840813","chr10","27501941","27502094","26","71338715"
"chr1","98867150","98867447","chr14","96731082","96731372","22","2136068"
"chr1","98878365","98878493","chr19","40758560","40758690","22","58119805"
"chr1","98878661","98878820","chr4","33667113","33667266","42","65211548"
"chr1","98939008","98939312","chrX","60143324","60143625","63","38795684"
"chr1","98943450","98943762","chr14","96806365","96806694","36","2137085"
"chr1","98973712","98974004","chr14","96835977","96836275","16","2137735"
"chr1","99033325","99033632","chr14","96897956","96898262","11","2135369"
"chr1","99035830","99036138","chr14","96900137","96900446","16","2135693"
"chr1","99088676","99088786","chr2","21100657","21100766","14","77988019"
"chr1","99088945","99089018","chr19","16548141","16548212","11","82540804"
"chr1","99093154","99093330","chr14","96957938","96958123","13","2135216"
"chr1","99105465","99105781","chr14","96969887","96970208","24","2135578"
"chr1","99118352","99118633","chr4","27763002","27763281","55","71355350"
"chr1","99128409","99128711","chr14","96991558","96991879","29","2136851"
"chr1","99131465","99131782","chr14","96994622","96994934","14","2136843"
"chr1","99202724","99202871","chr9","51842355","51842499","33","47360369"
"chr1","99209699","99209921","chr20","43259759","43259977","45","55949940"
"chr1","99222863","99223134","chr14","97081939","97082206","12","2140924"
"chr1","99227267","99227555","chr14","97084809","97085120","32","2142458"
"chr1","99233279","99233495","chr14","97088519","97088732","14","2144760"
"chr1","99238441","99238609","chr16","56769527","56769696","34","42468914"
"chr1","99238620","99238680","chr5","80684202","80684260","9","18554418"
"chr1","99238694","99239000","chr14","97095563","97095871","21","2143131"
"chr1","99245198","99245503","chr10","85181699","85182000","60","14063499"
"chr1","99246197","99246332","chr14","97103201","97103336","9","2142996"
"chr1","99246762","99247059","chr14","97103785","97104076","25","2142977"
"chr1","99247777","99248063","chr14","97104812","97105124","42","2142965"
"chr1","99265741","99266042","chr10","50389396","50389695","52","48876345"
"chr1","99268060","99268329","chr5","12288935","12289203","49","86979125"
"chr1","99287356","99287636","chr14","97142843","97143121","15","2144513"
"chr1","99300887","99301182","chr14","97155375","97155670","9","2145512"
"chr1","99303013","99303285","chr14","97157434","97157697","16","2145579"
"chr1","99307763","99307902","chr12","64467093","64467231","31","34840670"
"chr1","99307920","99307966","chr16","67696765","67696807","10","31611155"
"chr1","99312822","99313021","chr15","74405610","74405806","53","24907212"
"chr1","99313256","99313311","chr19","1460569","1460627","25","97852687"
"chr1","99313371","99313493","chr1","48746228","48746346","19","50567143"
"chr1","99315078","99315378","chr14","97171788","97172064","37","2143290"
"chr1","99324230","99324497","chr14","97180676","97180939","15","2143554"
"chr1","99333831","99334133","chr14","97191167","97191465","19","2142664"
"chr1","99337303","99337597","chr16","41671981","41672272","48","57665322"
"chr1","99342304","99342560","chr14","97200144","97200403","13","2142160"
"chr1","99356863","99357172","chr14","97215439","97215704","53","2141424"
"chr1","99363462","99363762","chr14","97221644","97221949","20","2141818"
"chr1","99364180","99364427","chr7","74684329","74684571","57","24679851"
"chr1","99396598","99396873","chr14","97255119","97255398","8","2141479"
"chr1","99400763","99401070","chr14","97259304","97259604","11","2141459"
"chr1","99416774","99417081","chr14","97275861","97276173","16","2140913"
"chr1","99420668","99420939","chr14","97279899","97280198","34","2140769"
"chr1","99421290","99421398","chr14","97280549","97280656","3","2140741"
"chr1","99424163","99424441","chr9","27680847","27681122","57","71743316"
"chr1","99436043","99436336","chr14","97295329","97295621","4","2140714"
"chr1","99441012","99441295","chr14","97300278","97300561","8","2140734"
"chr1","99441338","99441617","chr20","51441069","51441349","70","48000269"
"chr1","99442199","99442499","chr18","3924478","3924775","60","95517721"
"chr1","99479726","99479966","chr1","87500243","87500462","54","11979483"
"chr1","99481088","99481258","chr10","14073549","14073720","32","85407539"
"chr1","99481567","99481608","chr1","1980648","1980684","9","97500919"
"chr1","99498132","99498282","chr14","97354327","97354484","9","2143805"
"chr1","99501295","99501502","chr14","97357644","97357856","10","2143651"
"chr1","99501573","99501755","chr14","97357919","97358085","19","2143654"
"chr1","99501793","99501910","chr14","97358137","97358253","6","2143656"
"chr1","99512433","99512729","chr20","56474616","56474907","55","43037817"
"chr1","99521658","99521941","chr14","97377881","97378165","11","2143777"
"chr1","99532542","99532837","chr2","128859686","128859982","52","29327144"
"chr1","99533023","99533301","chr14","97388756","97389034","6","2144267"
"chr1","99543623","99543909","chr14","97399023","97399317","23","2144600"
"chr1","99552148","99552438","chr14","97408097","97408390","28","2144051"
"chr1","99573014","99573167","chr5","1888026","1888179","33","97684988"
"chr1","99577230","99577411","chr14","97432488","97432652","30","2144742"
"chr1","99584464","99584747","chr14","97439213","97439495","9","2145251"
"chr1","99588705","99589010","chr14","97443460","97443762","8","2145245"
"chr1","99592205","99592352","chr14","97446965","97447113","7","2145240"
"chr1","99592654","99592838","chr14","97447415","97447591","23","2145239"
"chr1","99610484","99610783","chr14","97465109","97465401","16","2145375"
"chr1","99624540","99624842","chr14","97479022","97479312","23","2145518"
"chr1","99638335","99638591","chr11","82356415","82356666","63","17281920"
"chr1","99641217","99641578","chr14","97495032","97495323","75","2146185"
"chr1","99641768","99641987","chr14","97495514","97495732","5","2146254"
"chr1","99664034","99664329","chr14","97514529","97514827","8","2149505"
"chr1","99665270","99665567","chr14","97515760","97516058","13","2149510"
"chr1","99666963","99667247","chr14","97517412","97517696","5","2149551"
"chr1","99674064","99674359","chr14","97524319","97524615","9","2149745"
"chr1","99689673","99689834","chr14","97539630","97539791","1","2150043"
"chr1","99689928","99690266","chr14","97539893","97540224","17","2150035"
"chr1","99708521","99708719","chr8","115582971","115583158","42","15874450"
"chr1","99716341","99716635","chr14","97566230","97566529","11","2150111"
"chr1","99716830","99717137","chr14","97566721","97567031","8","2150109"
"chr1","99720400","99720681","chr9","94819338","94819611","56","4901062"
"chr1","99720771","99720875","chr17","43478798","43478904","20","56241973"
"chr1","99741313","99741609","chr14","97590786","97591082","5","2150527"
"chr1","99746239","99746495","chr16","29754254","29754514","71","69991985"
"chr1","99756396","99756709","chr14","97605152","97605468","13","2151244"
"chr1","99805767","99806042","chr14","97654870","97655151","8","2150897"
"chr1","99829970","99830210","chr14","97679468","97679710","6","2150502"
"chr1","99832111","99832339","chr14","97681580","97681815","8","2150531"
"chr1","99852014","99852295","chr14","97699677","97699979","25","2152337"
"chr1","99880260","99880568","chr14","97728457","97728766","9","2151803"
"chr1","99888536","99888833","chr2","48440676","48440976","54","51447860"
"chr1","99903418","99903720","chr14","97749735","97750037","7","2153683"
"chr1","99908833","99909093","chr14","97755021","97755262","37","2153812"
"chr1","99938337","99938495","chr12","93466662","93466820","28","6471675"
"chr1","99938507","99938595","chr7","129187735","129187815","21","29249228"
"chr1","99945172","99945346","chr14","97790304","97790478","1","2154868"
"chr1","99951845","99952154","chr14","97796588","97796893","14","2155257"
"chr1","99995305","99995592","chr14","97843293","97843579","7","2152012"
"chr1","99996662","99996987","chr14","97844495","97844769","63","2152167"
"chr1","99999041","99999293","chr4","119117536","119117799","64","19118495"
"chr1","100023481","100023786","chr14","97863796","97864103","16","2159685"
"chr1","100024290","100024455","chr1","185781085","185781244","39","85756795"
"chr1","100030186","100030466","chr14","97873751","97874040","19","2156435"
"chr1","100033640","100033931","chr14","97877194","97877469","24","2156446"
"chr1","100048502","100048639","chr14","97891172","97891312","4","2157330"
"chr1","100050160","100050306","chr14","106501654","106501805","38","6451494"
"chr1","100054104","100054395","chr14","97896764","97897054","5","2157340"
"chr1","100062956","100063252","chr14","97905127","97905422","5","2157829"
"chr1","100070056","100070360","chr14","97912373","97912675","16","2157683"
"chr1","100145628","100145912","chr14","97987826","97988112","10","2157802"
"chr1","100170424","100170679","chr14","98012901","98013158","8","2157523"
"chr1","100212238","100212355","chr14","98050563","98050680","0","2161675"
"chr1","100230267","100230576","chr14","98069039","98069353","12","2161228"
"chr1","100261045","100261350","chr14","98096743","98097050","16","2164302"
"chr1","100290033","100290088","chr14","98125217","98125272","0","2164816"
"chr1","100292643","100292921","chr14","98127860","98128139","14","2164783"
"chr1","100341460","100341739","chr14","98178468","98178740","13","2162992"
"chr1","100344570","100344729","chr14","98181567","98181726","5","2163003"
"chr1","100358491","100358561","chr14","98194937","98195006","1","2163554"
"chr1","100383959","100384061","chr1","121563071","121563171","20","21179112"
"chr1","100461600","100461830","chr11","62691828","62692054","60","37769772"
"chr1","100535555","100535793","chr4","81009580","81009821","73","19525975"
"chr1","100865165","100865475","chr14","98708320","98708629","7","2156845"
"chr1","101172084","101172395","chr2","76587906","76588205","63","24584178"
"chr1","101261566","101261694","chr1","12465516","12465643","29","88796050"
"chr1","101261997","101262094","chr1","2156714","2156806","31","99105283"
"chr1","101264367","101264454","chr7","63626727","63626811","14","37637640"
"chr1","101270492","101270780","chr14","99127614","99127894","15","2142878"
"chr1","101347682","101347949","chr14","99205436","99205703","6","2142246"
"chr1","101359194","101359484","chr14","99216965","99217255","3","2142229"
"chr1","101363958","101364254","chr10","51006911","51007211","53","50357047"
"chr1","101384540","101384790","chr14","99242317","99242566","11","2142223"
"chr1","101412896","101412969","chr16","64300901","64300971","15","37111995"
"chr1","101414388","101414685","chr14","99272777","99273074","5","2141611"
"chr1","101424063","101424370","chr4","152226280","152226592","56","50802217"
"chr1","101430733","101431024","chr14","99289060","99289351","9","2141673"
"chr1","101467898","101468181","chr14","99326270","99326551","14","2141628"
"chr1","101471444","101471751","chr6","70501055","70501362","64","30970389"
"chr1","101472119","101472393","chr14","99330500","99330774","5","2141619"
"chr1","101555985","101556268","chr14","99415134","99415428","22","2140851"
"chr1","101569573","101569900","chr20","56990358","56990671","72","44579215"
"chr1","101614354","101614664","chr14","99474881","99475191","8","2139473"
"chr1","101617401","101617712","chr4","20062475","20062773","71","81554926"
"chr1","101617718","101618024","chr14","99478249","99478540","25","2139469"
"chr1","101620181","101620478","chr14","99480715","99481017","12","2139466"
"chr1","101624984","101625089","chr14","99485481","99485586","2","2139503"
"chr1","101631155","101631455","chr14","99492267","99492567","4","2138888"
"chr1","101631611","101631761","chr4","19980979","19981130","35","81650632"
"chr1","101632737","101633014","chr14","99493849","99494126","6","2138888"
"chr1","101641275","101641562","chr14","99502116","99502400","20","2139159"
"chr1","101642591","101642734","chr3","104055274","104055407","45","2412683"
"chr1","101642888","101643057","chr14","99503731","99503900","2","2139157"
"chr1","101643363","101643542","chr14","99504203","99504381","6","2139160"
"chr1","101649995","101650238","chr14","99510862","99511090","20","2139133"
"chr1","101651183","101651243","chr14","99512031","99512088","6","2139152"
"chr1","101652376","101652685","chr14","99513270","99513585","14","2139106"
"chr1","101664455","101664736","chr14","99525561","99525834","16","2138894"
"chr1","101677360","101677672","chr14","99537978","99538282","19","2139382"
"chr1","101683356","101683642","chr14","99543979","99544286","30","2139377"
"chr1","101686547","101686693","chr10","2060472","2060601","42","99626075"
"chr1","101709045","101709311","chr14","99569151","99569424","15","2139894"
"chr1","101710402","101710703","chr14","99570525","99570827","15","2139877"
"chr1","101720171","101720449","chr14","99580447","99580720","17","2139724"
"chr1","101735965","101736281","chr14","99597037","99597332","26","2138928"
"chr1","101762833","101763120","chr14","99622507","99622794","7","2140326"
"chr1","101811463","101811774","chr14","99672917","99673231","14","2138546"
"chr1","101823589","101823901","chr14","99685166","99685474","12","2138423"
"chr1","101845923","101846220","chr14","99709583","99709881","4","2136340"
"chr1","101878814","101879099","chr14","99742063","99742345","15","2136751"
"chr1","101909916","101910230","chr14","99771743","99772057","13","2138173"
"chr1","102004728","102005040","chr14","99863340","99863652","7","2141388"
"chr1","102015154","102015455","chr14","99873551","99873852","3","2141603"
"chr1","102132679","102132974","chr14","99990152","99990447","8","2142527"
"chr1","102134899","102135184","chr14","99992370","99992652","9","2142529"
"chr1","102150069","102150134","chr14","100007447","100007512","0","2142622"
"chr1","102162574","102162709","chr14","100019548","100019688","10","2143026"
"chr1","102273875","102274146","chr14","100128297","100128571","11","2145578"
"chr1","102428531","102428633","chr7","129979248","129979346","21","27550717"
"chr1","102428644","102428711","chr3","40058589","40058650","19","62370055"
"chr1","102461073","102461232","chr14","63608556","63608715","24","38852517"
"chr1","102486452","102486656","chr14","100609395","100609599","5","1877057"
"chr1","102497008","102497283","chr14","100619764","100620039","8","1877244"
"chr1","102522705","102522917","chr14","100646165","100646380","12","1876540"
"chr1","102554929","102555199","chr14","100680632","100680933","42","1874297"
"chr1","102608855","102608887","chr4","85142517","85142547","11","17466338"
"chr1","102609120","102609197","chr14","100730582","100730654","5","1878538"
"chr1","102625705","102625865","chrX","49524523","49524692","22","53101182"
"chr1","102630513","102630617","chr8","21204109","21204213","22","81426404"
"chr1","102675457","102675747","chr14","100794414","100794703","6","1881043"
"chr1","102858973","102859288","chr14","100977049","100977363","11","1881924"
"chr1","102898740","102899037","chr14","101014420","101014717","4","1884320"
"chr1","102918680","102918768","chr15","83176624","83176708","24","19742056"
"chr1","102922926","102923155","chr3","103437927","103438127","58","515001"
"chr1","102928352","102928641","chr14","101045639","101045927","5","1882713"
"chr1","102951322","102951623","chr14","101067123","101067424","5","1884199"
"chr1","102952939","102953286","chr9","102140549","102140874","85","812390"
"chr1","102959002","102959269","chr14","101074616","101074880","14","1884386"
"chr1","102987330","102987501","chr14","101101885","101102057","3","1885445"
"chr1","102990883","102991038","chr14","101105408","101105563","2","1885475"
"chr1","103002115","103002424","chr14","101116126","101116436","15","1885989"
"chr1","103006243","103006544","chr14","101120224","101120520","11","1886019"
"chr1","103006600","103006902","chr14","101120576","101120885","24","1886024"
"chr1","103008909","103009165","chr14","101122881","101123144","17","1886028"
"chr1","103041156","103041458","chr14","101155639","101155941","7","1885517"
"chr1","103041905","103042173","chr1","4156865","4157121","56","98885040"
"chr1","103098156","103098418","chr14","101212817","101213079","2","1885339"
"chr1","103112754","103113000","chr14","101228382","101228629","9","1884372"
"chr1","103113006","103113303","chr14","101228635","101228932","10","1884371"
"chr1","103116470","103116727","chr14","101231996","101232249","4","1884474"
"chr1","103136972","103137263","chr14","101251863","101252154","1","1885109"
"chr1","103142082","103142300","chr14","101257062","101257280","2","1885020"
"chr1","103152541","103152788","chr14","101267514","101267776","19","1885027"
"chr1","103155194","103155480","chr14","101270157","101270443","5","1885037"
"chr1","103158235","103158461","chr14","101273347","101273573","3","1884888"
"chr1","103161487","103161768","chr14","101276599","101276901","26","1884888"
"chr1","103162277","103162521","chr14","101277405","101277648","12","1884872"
"chr1","103166628","103166925","chr14","101281757","101282050","8","1884871"
"chr1","103166927","103167216","chr14","101282051","101282341","8","1884876"
"chr1","103175478","103175626","chr14","101290814","101290970","9","1884664"
"chr1","103177568","103177723","chr6","51237371","51237524","28","51940197"
"chr1","103241514","103241787","chr14","101356210","101356464","41","1885304"
"chr1","103246603","103246653","chr12","80492486","80492530","12","22754117"
"chr1","103246697","103246912","chr14","101362261","101362461","19","1884436"
"chr1","103249160","103249455","chr14","101365013","101365303","8","1884147"
"chr1","103254163","103254453","chr14","101371189","101371479","3","1882974"
"chr1","103264854","103265137","chr14","101379679","101379963","5","1885175"
"chr1","103266278","103266543","chr8","67288416","67288676","55","35977862"
"chr1","103266870","103267165","chr8","91933713","91934004","59","11333157"
"chr1","103269807","103269975","chr14","101385578","101385746","2","1884229"
"chr1","103282188","103282377","chr14","101398406","101398591","9","1883782"
"chr1","103282459","103282634","chr14","101398406","101398591","23","1884053"
"chr1","103290691","103290987","chr14","101406625","101406922","6","1884066"
"chr1","103305560","103305778","chr14","101420438","101420656","4","1885122"
"chr1","103307261","103307554","chr14","101422141","101422453","25","1885120"
"chr1","103319158","103319273","chrX","108971246","108971363","13","5652088"
"chr1","103338417","103338720","chr14","101453872","101454178","14","1884545"
"chr1","103358112","103358209","chr10","30495521","30495610","29","72862591"
"chr1","103385237","103385525","chr8","139057439","139057732","59","35672202"
"chr1","103397918","103398216","chr14","101514662","101514965","11","1883256"
"chr1","103456181","103456464","chrX","120356258","120356539","54","16900077"
"chr1","103464204","103464501","chr14","101583483","101583782","11","1880721"
"chr1","103475114","103475282","chr10","71163370","71163544","35","32311744"
"chr1","103475293","103475373","chr14","115374895","115374976","17","11899602"
"chr1","103475374","103475612","chr6","120370512","120370732","51","16895138"
"chr1","103508005","103508305","chr14","101627986","101628285","7","1880019"
"chr1","103565152","103565445","chr14","101686251","101686550","13","1878901"
"chr1","103587347","103587646","chr14","101708087","101708393","13","1879260"
"chr1","103622203","103622495","chr14","101741166","101741460","12","1881037"
"chr1","103649309","103649620","chr14","101766286","101766600","5","1883023"
"chr1","103663722","103664019","chr14","101780737","101781038","13","1882985"
"chr1","103700786","103701100","chr14","101818235","101818520","35","1882551"
"chr1","103724703","103724993","chr14","101841371","101841659","27","1883332"
"chr1","103769493","103769571","chrX","122790606","122790686","13","19021113"
"chr1","103789956","103790249","chr14","101900168","101900468","17","1889788"
"chr1","103790616","103790904","chr14","101900835","101901123","10","1889781"
"chr1","103877141","103877433","chr14","101986386","101986678","6","1890755"
"chr1","104070009","104070094","chr14","102157531","102157611","6","1912478"
"chr1","104094192","104094464","chr14","102181334","102181606","13","1912858"
"chr1","104254786","104255088","chr14","102343003","102343309","8","1911783"
"chr1","104315198","104315505","chr14","102402760","102403071","7","1912438"
"chr1","104342857","104342976","chr14","102431116","102431236","3","1911741"
"chr1","104378614","104378766","chr14","102467675","102467827","5","1910939"
"chr1","104380739","104380959","chr14","102469795","102470014","6","1910944"
"chr1","104397063","104397157","chr7","30852013","30852106","16","73545050"
"chr1","104445965","104446263","chr14","102535654","102535956","17","1910311"
"chr1","104612108","104612391","chr14","102702110","102702393","3","1909998"
"chr1","104870626","104870789","chr14","102951888","102952044","10","1918738"
"chr1","104931392","104931700","chr2","90678952","90679257","56","14252440"
"chr1","105000359","105000498","chr14","103078686","103078825","2","1921673"
"chr1","105017861","105018147","chr14","103095936","103096223","4","1921925"
"chr1","105037050","105037177","chr14","103114896","103115023","3","1922154"
"chr1","105058980","105059141","chr14","103135431","103135593","4","1923549"
"chr1","105145110","105145211","chr13","60774400","60774496","27","44370710"
"chr1","105145276","105145569","chr9","57648963","57649252","56","47496313"
"chr1","105167948","105168111","chr4","35083225","35083392","28","70084723"
"chr1","105170615","105170909","chr14","103245616","103245907","14","1924999"
"chr1","105173635","105173930","chr6","78448208","78448505","47","26725427"
"chr1","105177294","105177599","chr14","103251762","103252058","16","1925532"
"chr1","105205677","105205979","chr14","103278802","103279110","15","1926875"
"chr1","105222581","105222906","chr14","103297498","103297821","15","1925083"
"chr1","105223360","105223643","chr14","103298589","103298874","6","1924771"
"chr1","105232625","105232916","chr14","103306024","103306312","15","1926601"
"chr1","105244891","105245037","chr18","13639021","13639159","23","91605870"
"chr1","105245187","105245265","chr1","31252960","31253021","24","73992227"
"chr1","105246148","105246425","chr14","103318610","103318883","15","1927538"
"chr1","105247289","105247375","chr11","52148157","52148238","26","53099132"
"chr1","105250892","105251029","chr14","103322715","103322852","3","1928177"
"chr1","105251303","105251459","chr14","103323129","103323285","2","1928174"
"chr1","105261079","105261250","chr14","103333164","103333331","8","1927915"
"chr1","105269425","105269526","chr20","66804889","66804973","29","38464536"
"chr1","105270049","105270181","chrX","16131461","16131590","29","89138588"
"chr1","105270467","105270615","chr10","31972968","31973110","28","73297499"
"chr1","105281754","105281901","chr15","68324961","68325102","30","36956793"
"chr1","105284781","105285089","chr14","103356185","103356488","9","1928596"
"chr1","105293637","105293937","chr3","28898267","28898572","59","76395370"
"chr1","105297487","105297590","chr14","103366885","103366988","2","1930602"
"chr1","105299884","105300181","chr14","103370638","103370925","17","1929246"
"chr1","105304472","105304786","chr14","103375291","103375575","45","1929181"
"chr1","105306431","105306746","chr3","14485595","14485905","60","90820836"
"chr1","105339298","105339591","chr14","103408162","103408451","11","1931136"
"chr1","105356962","105357265","chr14","103420794","103421090","18","1936168"
"chr1","105358422","105358616","chr14","103422039","103422232","9","1936383"
"chr1","105358806","105358895","chr8","10739085","10739171","19","94619721"
"chr1","105372336","105372643","chr14","103435194","103435497","11","1937142"
"chr1","105383902","105384191","chr14","103446788","103447082","15","1937114"
"chr1","105391327","105391431","chr14","103453558","103453662","2","1937769"
"chr1","105391435","105391569","chr14","103453666","103453802","3","1937769"
"chr1","105397765","105398067","chr14","103458624","103458925","10","1939141"
"chr1","105419157","105419433","chr14","103480840","103481130","24","1938317"
"chr1","105475882","105475980","chr8","24110377","24110470","25","81365505"
"chr1","105478621","105478903","chr14","103537381","103537660","19","1941240"
"chr1","105488936","105489237","chr14","103547426","103547736","12","1941510"
"chr1","105503143","105503453","chr14","103561503","103561817","11","1941640"
"chr1","105699519","105699683","chr14","103752936","103753100","1","1946583"
"chr1","105699718","105699778","chr3","93479670","93479728","16","12220048"
"chr1","105699789","105699920","chr1","197470217","197470347","31","91770428"
"chr1","105717827","105717955","chr14","103770089","103770217","1","1947738"
"chr1","105746273","105746489","chr20","38144069","38144276","70","67602204"
"chr1","105746490","105746717","chr2","20951111","20951335","47","84795379"
"chr1","105746718","105746875","chr16","18819593","18819742","28","86927125"
"chr1","105752929","105753030","chr14","103798561","103798674","17","1954368"
"chr1","105765434","105765744","chr14","103810423","103810737","19","1955011"
"chr1","105774074","105774359","chr14","103818864","103819151","11","1955210"
"chr1","105798168","105798308","chr14","103843211","103843345","13","1954957"
"chr1","105798594","105798754","chr14","103843650","103843831","30","1954944"
"chr1","105840847","105841163","chr14","103886088","103886383","22","1954759"
"chr1","105863103","105863293","chr10","27501941","27502094","58","78361162"
"chr1","105874697","105874979","chr14","103919259","103919568","32","1955438"
"chr1","105887755","105888052","chr14","103931688","103931984","3","1956067"
"chr1","106059017","106059329","chr1","201690228","201690514","70","95631211"
"chr1","106091034","106091132","chr14","104124529","104124627","4","1966505"
"chr1","106106526","106106815","chr14","104139777","104140070","19","1966749"
"chr1","106115352","106115632","chr14","104148454","104148736","11","1966898"
"chr1","106364413","106364717","chr14","104387050","104387346","18","1977363"
"chr1","106405125","106405347","chr3","12164373","12164601","48","94240752"
"chr1","106407884","106408186","chr14","104429283","104429596","23","1978601"
"chr1","106773619","106773770","chr14","104781900","104782053","15","1991719"
"chr1","106776864","106777136","chr3","39170785","39171040","71","67606079"
"chr1","106823199","106823508","chr14","104831273","104831595","23","1991926"
"chr1","106857887","106858234","chr14","104864935","104865242","46","1992952"
"chr1","106894706","106894961","chr14","104901281","104901575","49","1993425"
"chr1","106894962","106895147","chr7","37755730","37755904","49","69139232"
"chr1","106910156","106910441","chr10","62655662","62655957","51","44254494"
"chr1","106914788","106915093","chr14","104921231","104921532","15","1993557"
"chr1","106942684","106942961","chr14","104947721","104948002","16","1994963"
"chr1","106975553","106975840","chr14","104980073","104980365","9","1995480"
"chr1","106991415","106991589","chr14","104996131","104996309","5","1995284"
"chr1","106993726","106994013","chr14","104998447","104998724","23","1995279"
"chr1","107019116","107019413","chr14","105024041","105024340","9","1995075"
"chr1","107020115","107020426","chr14","105025041","105025349","5","1995074"
"chr1","107030805","107031111","chr2","44479814","44480118","66","62550991"
"chr1","107034083","107034198","chr14","105038560","105038671","7","1995523"
"chr1","107034226","107034397","chr14","105038709","105038875","8","1995517"
"chr1","107035385","107035695","chr14","105039959","105040274","36","1995426"
"chr1","107037829","107038136","chr14","105042165","105042473","7","1995664"
"chr1","107099383","107099505","chr14","105103750","105103867","8","1995633"
"chr1","107108604","107108885","chr14","105112313","105112588","15","1996291"
"chr1","107112538","107112710","chr14","105116080","105116251","15","1996458"
"chr1","107113031","107113178","chr14","105116556","105116704","9","1996475"
"chr1","107132150","107132219","chr17","67439122","67439192","13","39693028"
"chr1","107152487","107152815","chr14","105154405","105154736","6","1998082"
"chr1","107172054","107172357","chr14","105173959","105174262","6","1998095"
"chr1","107194423","107194651","chr18","42604168","42604388","47","64590255"
"chr1","107203142","107203444","chr14","105204457","105204768","18","1998685"
"chr1","107297966","107298243","chr14","105300283","105300560","6","1997683"
"chr1","107358492","107358791","chr14","105359711","105360021","23","1998781"
"chr1","107577475","107577665","chr14","105574684","105574870","10","2002791"
"chr1","107609955","107610028","chr17","67439122","67439192","15","40170833"
"chr1","107622822","107623131","chr9","124562233","124562545","58","16939411"
"chr1","107686208","107686472","chr14","105682252","105682513","9","2003956"
"chr1","107744208","107744562","chr14","105741209","105741575","27","2002999"
"chr1","107761542","107761832","chr14","105758167","105758447","21","2003375"
"chr1","107764670","107764975","chr14","105761925","105762226","12","2002745"
"chr1","107796661","107796735","chr14","105794239","105794316","5","2002422"
"chr1","107798600","107798782","chr14","105795945","105796131","13","2002655"
"chr1","107819374","107819707","chr14","105817367","105817680","26","2002007"
"chr1","107919404","107919679","chr14","105914979","105915254","11","2004425"
"chr1","107959100","107959392","chr14","105954091","105954388","13","2005009"
"chr1","108000699","108000995","chr14","105994457","105994764","16","2006242"
"chr1","108001505","108001791","chr14","105995033","105995320","7","2006472"
"chr1","108049643","108049923","chr14","106039416","106039704","16","2010227"
"chr1","108099486","108099784","chr14","106086862","106087152","13","2012624"
"chr1","108119541","108119830","chr14","106106294","106106583","8","2013247"
"chr1","108133197","108133502","chr14","106119849","106120154","5","2013348"
"chr1","108135653","108135916","chr14","106123001","106123266","14","2012652"
"chr1","108164548","108164858","chr14","106152261","106152570","7","2012287"
"chr1","108165964","108166231","chr2","50890744","50890985","63","57275220"
"chr1","108166309","108166428","chr1","48746228","48746346","14","59420081"
"chr1","108171648","108171940","chr8","26989790","26990076","57","81181858"
"chr1","108175690","108175980","chr14","106163755","106164044","15","2011935"
"chr1","108180355","108180659","chr14","106168722","106169033","19","2011633"
"chr1","108229088","108229363","chr14","106215941","106216213","8","2013147"
"chr1","108256699","108257009","chr14","106243688","106243993","8","2013011"
"chr1","108260989","108261269","chr1","140975768","140976051","62","32714779"
"chr1","108277529","108277761","chr3","157960899","157961104","78","49683370"
"chr1","108278057","108278192","chr2","172227852","172227991","33","63949795"
"chr1","108283826","108283973","chr3","172626119","172626265","31","64342293"
"chr1","108300319","108300594","chr14","106287247","106287519","13","2013072"
"chr1","108318426","108318724","chr14","106304443","106304739","7","2013983"
"chr1","108322142","108322428","chr14","106308145","106308429","8","2013997"
"chr1","108330133","108330398","chr14","106315932","106316197","6","2014201"
"chr1","108341947","108342246","chr14","106327829","106328128","6","2014118"
"chr1","108352242","108352548","chr14","106338150","106338461","10","2014092"
"chr1","108367223","108367520","chr14","106353041","106353319","23","2014182"
"chr1","108376154","108376449","chr14","106361295","106361592","9","2014859"
"chr1","108383013","108383309","chr14","106368161","106368457","14","2014852"
"chr1","108386271","108386446","chr14","106371421","106371599","11","2014850"
"chr1","108389322","108389500","chrX","112453371","112453542","40","4064049"
"chr1","108395697","108395852","chr14","106380855","106381013","13","2014842"
"chr1","108396866","108397168","chr14","106382030","106382332","4","2014836"
"chr1","108397776","108398068","chr14","106382859","106383151","4","2014917"
"chr1","108401223","108401263","chr12","65135088","65135128","5","43266135"
"chr1","108402534","108402809","chr14","106386638","106386913","4","2015896"
"chr1","108404213","108404355","chr14","106388128","106388270","1","2016085"
"chr1","108419667","108419973","chr14","106403083","106403389","7","2016584"
"chr1","108443678","108443970","chr14","106426288","106426597","26","2017390"
"chr1","108484048","108484350","chr14","106466457","106466752","17","2017591"
"chr1","108484796","108484946","chr14","106467206","106467357","2","2017590"
"chr1","108484983","108485099","chr14","106467381","106467497","1","2017602"
"chr1","108505017","108505192","chr14","106488116","106488293","9","2016901"
"chr1","108517089","108517346","chr14","106501018","106501278","12","2016071"
"chr1","108517656","108517711","chr1","201815901","201815958","10","93298245"
"chr1","108517722","108517878","chr14","106501654","106501805","11","2016068"
"chr1","108519841","108520038","chr14","106503769","106503967","7","2016072"
"chr1","108520218","108520330","chr14","106504147","106504259","4","2016071"
"chr1","108524914","108525064","chr17","7238332","7238490","40","101286582"
"chr1","108525141","108525224","chr14","106509309","106509390","2","2015832"
"chr1","108527803","108528103","chr1","48496736","48497043","85","60031067"
"chr1","108530877","108531142","chr14","106514713","106515013","39","2016164"
"chr1","108580687","108580855","chr14","106488116","106488293","15","2092571"
"chr1","108581708","108581981","chr14","106566293","106566563","6","2015415"
"chr1","108586399","108586672","chr1","23507916","23508187","68","85078483"
"chr1","108597175","108597227","chr12","95723167","95723218","13","12874008"
"chr1","108608735","108609044","chr14","106593423","106593728","11","2015312"
"chr1","108610697","108611017","chr14","106595364","106595683","9","2015333"
"chr1","108616796","108617081","chr13","42501441","42501727","50","66115355"
"chr1","108617836","108618125","chrX","15783794","15784082","44","92834042"
"chr1","108629811","108630124","chr14","106613501","106613809","15","2016310"
"chr1","108633893","108634178","chr14","106617579","106617863","12","2016314"
"chr1","108638507","108638817","chr14","106622176","106622486","10","2016331"
"chr1","108640158","108640456","chr4","41658028","41658329","54","66982130"
"chr1","108644201","108644473","chr15","75886295","75886575","67","32757906"
"chr1","108651384","108651684","chr14","106634612","106634912","7","2016772"
"chr1","108653085","108653242","chr11","110402020","110402179","32","1748935"
"chr1","108653546","108653830","chr14","106636762","106637047","7","2016784"
"chr1","108685135","108685220","chr4","104181246","104181321","18","4503889"
"chr1","108707797","108708103","chr14","106690201","106690506","16","2017596"
"chr1","108720778","108721072","chr14","106703190","106703483","14","2017588"
"chr1","108746495","108746789","chr14","106729100","106729394","6","2017395"
"chr1","108782206","108782500","chr14","106765708","106766000","17","2016498"
"chr1","108798483","108798786","chr14","106782314","106782608","12","2016169"
"chr1","108799355","108799671","chr14","106783178","106783493","8","2016177"
"chr1","108867227","108867508","chr14","106851755","106852037","13","2015472"
"chr1","108894285","108894446","chr14","106878795","106878956","8","2015490"
"chr1","108906583","108906904","chr14","106891087","106891406","14","2015496"
"chr1","108932813","108932930","chr3","166718726","166718843","17","57785913"
"chr1","108940129","108940342","chr9","39713780","39713999","49","69226349"
"chr1","108940381","108940500","chr3","38999520","38999646","25","69940861"
"chr1","108959343","108959495","chr14","106946710","106946862","9","2012633"
"chr1","108972004","108972325","chr11","116117475","116117793","60","7145471"
"chr1","109130819","109131121","chr14","107114952","107115253","11","2015867"
"chr1","109174621","109174911","chr14","107158406","107158699","9","2016215"
"chr1","109274101","109274409","chr14","107256342","107256644","12","2017759"
"chr1","109306765","109307050","chr14","107286960","107287259","18","2019805"
"chr1","109319980","109320237","chr14","107299329","107299586","4","2020651"
"chr1","109333867","109333993","chr1","28356634","28356762","25","80977233"
"chr1","109351878","109352187","chr14","107330065","107330375","13","2021813"
"chr1","109414773","109415058","chr14","107385714","107386011","20","2029059"
"chr1","109438324","109438479","chr14","107406938","107407107","14","2031386"
"chr1","109466207","109466478","chr19","8462124","8462391","48","101004083"
"chr1","109543433","109543738","chr14","107503489","107503771","29","2039944"
"chr1","109544793","109544936","chr14","107722628","107722773","35","1822165"
"chr1","109561770","109561932","chr10","33729906","33730077","33","75831864"
"chr1","109584284","109584575","chr3","125668650","125668925","66","16084366"
"chr1","109587571","109587843","chr12","93468174","93468441","45","16119397"
"chr1","109598650","109598959","chr14","107557635","107557932","21","2041015"
"chr1","109626376","109626688","chr14","107584848","107585160","11","2041528"
"chr1","109636615","109636916","chr14","107593624","107593925","3","2042991"
"chr1","109663652","109663949","chr14","107623962","107624269","21","2039690"
"chr1","109665914","109666202","chr14","107626074","107626359","14","2039840"
"chr1","109670878","109671012","chr6","133234948","133235082","25","23564070"
"chr1","109682746","109683002","chr14","107640563","107640819","3","2042183"
"chr1","109686367","109686543","chr14","107644152","107644332","7","2042215"
"chr1","109712126","109712435","chr14","107668223","107668531","12","2043903"
"chr1","109719009","109719306","chr14","107673950","107674248","9","2045059"
"chr1","109723368","109723651","chr14","107678622","107678902","6","2044746"
"chr1","109724453","109724766","chr14","107679725","107680016","23","2044728"
"chr1","109732172","109732456","chr14","107687981","107688267","11","2044191"
"chr1","109747357","109747634","chr2","179090546","179090823","68","69343189"
"chr1","109750821","109751125","chr14","107708018","107708323","5","2042803"
"chr1","109754321","109754382","chr2","115596700","115596762","17","5842379"
"chr1","109756998","109757297","chr3","12783650","12783947","51","96973348"
"chr1","109768534","109768679","chr14","107722628","107722773","6","2045906"
"chr1","109772813","109772984","chr14","107727063","107727234","1","2045750"
"chr1","109773173","109773458","chr14","107727423","107727707","2","2045750"
"chr1","109780078","109780388","chr14","107736136","107736446","8","2043942"
"chr1","109794818","109795094","chr14","107747480","107747763","13","2047338"
"chr1","109801272","109801574","chr14","107753321","107753622","5","2047951"
"chr1","109812006","109812316","chr14","107764365","107764660","30","2047641"
"chr1","109815453","109815557","chr14","107767974","107768085","10","2047479"
"chr1","109827861","109828170","chr14","107780651","107780958","8","2047210"
"chr1","109839546","109839839","chr14","107792734","107793032","10","2046812"
"chr1","109844385","109844693","chr14","107797637","107797945","13","2046748"
"chr1","109861191","109861234","chr10","30883951","30883993","9","78977240"
"chr1","109861237","109861394","JH681938","2363","2511","49","109858874"
"chr1","109865941","109866252","chr14","107819356","107819655","15","2046585"
"chr1","109922712","109922870","chr14","107876330","107876490","5","2046382"
"chr1","109923168","109923198","chr14","107876789","107876827","9","2046379"
"chr1","109923860","109924156","chr14","107877188","107877483","6","2046672"
"chr1","109939146","109939426","chr14","107893150","107893432","8","2045996"
"chr1","109944971","109945274","chr14","107899299","107899599","7","2045672"
"chr1","109954701","109954835","chr14","107909510","107909644","5","2045191"
"chr1","109955137","109955298","chr14","107909942","107910103","2","2045195"
"chr1","109959800","109960110","chr7","79844700","79844999","69","30115100"
"chr1","109971903","109972019","chr14","107926550","107926667","5","2045353"
"chr1","109973631","109973928","chr14","107928272","107928571","10","2045359"
"chr1","109979205","109979502","chr14","107934489","107934791","35","2044716"
"chr1","109987218","109987391","chr1","23757540","23757709","33","86229678"
"chr1","109989595","109989875","chr14","107945394","107945674","5","2044201"
"chr1","110063491","110063701","chr14","108021556","108021763","9","2041935"
"chr1","110069803","110069907","chr14","108037762","108037866","6","2032041"
"chr1","110085350","110085531","chr1","192373931","192374104","31","82288581"
"chr1","110092264","110092554","chr14","108052441","108052735","10","2039823"
"chr1","110102333","110102554","chr2","92729193","92729434","65","17373140"
"chr1","110102577","110102696","chr14","108062376","108062502","12","2040201"
"chr1","110115060","110115231","chr14","108069127","108069297","5","2045933"
"chr1","110133543","110133666","chr1","17969919","17970043","17","92163624"
"chr1","110150307","110150583","chr14","108104448","108104711","15","2045859"
"chr1","110150586","110150708","chr14","108104718","108104834","6","2045868"
"chr1","110154905","110155156","chr14","108110562","108110823","13","2044343"
"chr1","110156989","110157284","chr14","108115660","108115925","41","2041329"
"chr1","110164793","110165061","chr14","108120857","108121132","14","2043936"
"chr1","110181076","110181417","chr1","54810598","54810929","80","55370478"
"chr1","110194113","110194418","chr14","108144787","108145092","5","2049326"
"chr1","110196021","110196329","chr14","108146702","108147003","9","2049319"
"chr1","110196502","110196568","chr10","80981007","80981065","15","29215495"
"chr1","110196894","110197174","chr14","108147879","108148159","6","2049015"
"chr1","110200576","110200864","chr14","108151348","108151634","5","2049228"
"chr1","110203859","110204133","chr16","21317898","21318176","47","88885961"
"chr1","110207962","110208053","chr14","108159523","108159614","1","2048439"
"chr1","110221802","110221958","chr14","108177896","108178052","3","2043906"
"chr1","110222177","110222287","chr14","108178277","108178403","17","2043900"
"chr1","110222616","110222952","chr1","48009647","48009984","87","62212969"
"chr1","110231020","110231281","chr14","108187186","108187446","6","2043834"
"chr1","110236137","110236433","chr14","108192266","108192562","10","2043871"
"chr1","110236824","110237129","chr14","108193535","108193814","30","2043289"
"chr1","110250091","110250382","chr14","108207168","108207462","10","2042923"
"chr1","110250725","110250972","chr14","108207805","108208052","8","2042920"
"chr1","110250981","110251101","chr11","116377417","116377535","33","6126436"
"chr1","110304025","110304338","chr14","108261202","108261514","7","2042823"
"chr1","110309209","110309521","chr14","108264745","108265057","9","2044464"
"chr1","110336622","110336727","chr9","34756877","34756992","21","75579745"
"chr1","110341164","110341392","chr8","88735492","88735714","62","21605672"
"chr1","110346164","110346251","chrX","15704023","15704112","19","94642141"
"chr1","110347784","110348075","chr14","108306299","108306590","5","2041485"
"chr1","110353728","110354026","chr14","108312251","108312549","3","2041477"
"chr1","110359638","110359963","chr5","19479173","19479458","112","90880465"
"chr1","110362755","110363052","chr14","108320710","108321005","8","2042045"
"chr1","110368860","110369030","chr14","108328748","108328916","5","2040112"
"chr1","110369628","110369757","chr14","108329514","108329643","0","2040114"
"chr1","110378259","110378398","chr2","172227852","172227991","33","61849593"
"chr1","110378411","110378706","chr14","108336961","108337224","36","2041450"
"chr1","110381306","110381532","chr14","108339606","108339862","33","2041700"
"chr1","110386171","110386423","chr6","67845567","67845781","86","42540604"
"chr1","110393439","110393725","chr14","108352621","108352914","19","2040818"
"chr1","110393731","110394024","chr14","108352621","108352914","37","2041110"
"chr1","110408864","110408968","chr3","52513656","52513757","34","57895208"
"chr1","110409559","110409697","chr2","172227852","172227991","34","61818293"
"chr1","110416973","110417229","chr14","108379160","108379416","6","2037813"
"chr1","110436814","110437136","chr14","108400163","108400484","12","2036651"
"chr1","110439892","110440201","chr14","108403313","108403623","4","2036579"
"chr1","110443963","110444260","chr14","108407237","108407528","17","2036726"
"chr1","110452604","110452891","chr14","108416308","108416595","7","2036296"
"chr1","110455710","110456013","chr14","108420039","108420343","7","2035671"
"chr1","110456723","110456997","chr9","92718527","92718801","53","17738196"
"chr1","110457171","110457313","chr16","52855317","52855451","28","57601854"
"chr1","110457621","110457784","chrX","14387257","14387417","31","96070364"
"chr1","110472306","110472602","chr14","108436812","108437101","12","2035494"
"chr1","110497191","110497365","chr14","108461676","108461851","5","2035515"
"chr1","110497626","110497755","chr14","108462125","108462254","2","2035501"
"chr1","110499043","110499328","chr14","108463549","108463834","6","2035494"
"chr1","110513016","110513056","chr6","74911936","74911976","6","35601080"
"chr1","110513091","110513342","chr18","43114453","43114707","57","67398638"
"chr1","110521679","110521807","chr10","78707427","78707552","30","31814252"
"chr1","110533848","110534177","chrX","92923465","92923769","70","17610383"
"chr1","110539776","110539818","chr1","218687351","218687396","10","108147575"
"chr1","110539832","110540001","chr3","34083106","34083268","38","76456726"
"chr1","110541029","110541340","chr14","108506624","108506930","11","2034405"
"chr1","110545259","110545567","chr14","108510808","108511109","15","2034451"
"chr1","110552680","110552743","chr2","25992584","25992648","11","84560096"
"chr1","110572735","110573049","chr1","112392013","112392327","61","1819278"
"chr1","110574124","110574413","chr14","108541288","108541579","11","2032836"
"chr1","110585233","110585515","chr14","108551709","108551983","16","2033524"
"chr1","110588101","110588131","chr16","24501142","24501175","9","86086959"
"chr1","110588380","110588493","chr14","108554840","108554959","8","2033540"
"chr1","110595510","110595634","chr7","8273751","8273873","18","102321759"
"chr1","110601780","110601941","chr7","53483520","53483679","35","57118260"
"chr1","110602252","110602401","chr6","144630022","144630156","31","34027770"
"chr1","110605122","110605332","chr14","108571373","108571583","6","2033749"
"chr1","110608524","110608802","chr2","91916301","91916587","66","18692223"
"chr1","110616669","110616980","chr14","108582959","108583241","39","2033710"
"chr1","110623898","110624204","chr14","108594520","108594834","14","2029378"
"chr1","110628780","110629088","chr10","30221212","30221500","104","80407568"
"chr1","110639562","110639873","chr14","108609747","108610056","7","2029815"
"chr1","110640808","110640939","chr6","143037757","143037891","23","32396949"
"chr1","110641245","110641331","chr3","162289100","162289178","24","51647855"
"chr1","110657335","110657627","chr14","108628330","108628621","6","2029005"
"chr1","110659822","110660139","chr14","108630984","108631301","4","2028838"
"chr1","110664304","110664589","chr8","10034943","10035230","51","100629361"
"chr1","110666212","110666526","chr14","108636764","108637076","7","2029448"
"chr1","110669968","110670223","chr14","108640494","108640765","21","2029474"
"chr1","110700273","110700567","chr14","108670983","108671314","52","2029290"
"chr1","110700606","110700616","chr1","64229866","64229876","0","46470740"
"chr1","110702761","110703117","chr10","20853642","20853971","89","89849119"
"chr1","110705833","110706139","chr14","108676760","108677066","6","2029073"
"chr1","110709149","110709431","chr14","108679765","108680046","6","2029384"
"chr1","110722201","110722507","chr14","108692442","108692751","8","2029759"
"chr1","110729356","110729620","chr14","108700239","108700503","7","2029117"
"chr1","110764008","110764217","chr4","42686105","42686316","39","68077903"
"chr1","110768202","110768494","chr14","108739536","108739831","11","2028666"
"chr1","110774621","110774919","chr14","108745378","108745664","18","2029243"
"chr1","110777690","110777986","chr14","108748093","108748390","9","2029597"
"chr1","110778575","110778877","chr14","108748979","108749282","4","2029596"
"chr1","110781897","110782012","chr14","108752910","108753025","1","2028987"
"chr1","110782300","110782595","chr14","108753317","108753608","13","2028983"
"chr1","110793955","110794263","chr14","108764799","108765110","12","2029156"
"chr1","110797119","110797381","chr14","108767643","108767905","26","2029476"
"chr1","110821943","110822058","chr1","146722928","146723043","20","35900985"
"chr1","110829935","110830215","chr14","108793899","108794185","34","2036036"
"chr1","110910901","110911220","chr14","108871653","108871925","56","2039248"
"chr1","110921974","110922287","chr14","108882694","108882996","19","2039280"
"chr1","110930554","110930852","chr14","108891270","108891571","12","2039284"
"chr1","110932491","110932802","chr14","108893326","108893633","11","2039165"
"chr1","110962287","110962331","chr1","214144715","214144760","8","103182428"
"chr1","110962628","110962787","chr14","108922578","108922733","8","2040050"
"chr1","111022703","111022808","chr14","108980039","108980144","1","2042664"
"chr1","111210612","111210915","chr14","109160689","109160990","9","2049923"
"chr1","111248266","111248484","chr14","109196745","109196963","2","2051521"
"chr1","111249178","111249460","chr14","109197653","109197934","7","2051525"
"chr1","111250307","111250487","chr14","109198790","109198963","19","2051517"
"chr1","111371808","111372131","chr14","109318332","109318667","18","2053476"
"chr1","111447584","111447825","chr14","109392419","109392660","3","2055165"
"chr1","111462964","111463287","chr14","109405249","109405566","14","2057715"
"chr1","111473798","111474076","chr14","109415027","109415305","11","2058771"
"chr1","111489579","111489765","chr1","13693527","13693709","47","97796052"
"chr1","111549301","111549458","chr14","109487871","109488028","3","2061430"
"chr1","111598906","111599218","chr14","109535565","109535877","4","2063341"
"chr1","111666787","111667087","chr14","109605445","109605745","6","2061342"
"chr1","111675116","111675390","chr14","109613603","109613892","22","2061513"
"chr1","111677442","111677734","chr14","109615954","109616245","5","2061488"
"chr1","111712232","111712421","chrX","43657953","43658129","44","68054279"
"chr1","111729376","111729531","chr14","109667118","109667273","0","2062258"
"chr1","111766869","111767168","chr14","109704371","109704669","7","2062498"
"chr1","111768031","111768323","chr14","109705512","109705824","26","2062519"
"chr1","111772463","111772730","chr14","61318712","61318987","66","50453751"
"chr1","111802377","111802649","chr14","109739202","109739489","26","2063175"
"chr1","111819879","111820086","chr9","106344289","106344481","45","5475590"
"chr1","111836131","111836389","chr14","109772418","109772685","13","2063713"
"chr1","111851670","111851967","chr14","109787520","109787829","14","2064150"
"chr1","111858431","111858728","chr14","109794076","109794371","9","2064355"
"chr1","111862916","111863145","chr14","109798378","109798607","1","2064538"
"chr1","111882511","111882811","chr11","106156559","106156863","51","5725952"
"chr1","111895451","111895753","chr14","109831496","109831792","12","2063955"
"chr1","111899801","111899968","chr14","109835864","109836019","14","2063937"
"chr1","111902119","111902374","chr14","109838210","109838494","32","2063909"
"chr1","111926904","111927198","chr14","109863169","109863465","8","2063735"
"chr1","111932529","111932812","chr14","109868215","109868480","43","2064314"
"chr1","111934579","111934877","chr14","109869956","109870250","23","2064623"
"chr1","111934882","111935014","chr1","55418558","55418689","24","56516324"
"chr1","111950005","111950295","chr14","109883072","109883362","10","2066933"
"chr1","111976674","111976990","chr9","39935312","39935614","76","72041362"
"chr1","112004015","112004291","chr3","125030767","125031037","52","13026752"
"chr1","112011215","112011506","chr14","109941782","109942077","15","2069433"
"chr1","112015773","112016029","chr17","52479243","52479509","61","59536530"
"chr1","112028919","112029120","chr14","109958231","109958432","12","2070688"
"chr1","112053479","112053654","chr19","30336916","30337083","36","81716563"
"chr1","112153718","112153854","chr10","59994419","59994557","25","52159299"
"chr1","112153857","112154157","chr14","110075347","110075648","17","2078510"
"chr1","112181736","112182052","chr14","110100406","110100694","38","2081330"
"chr1","112214372","112214679","chr14","110131261","110131578","43","2083111"
"chr1","112396376","112396550","chr14","110302459","110302613","26","2093917"
"chr1","112431325","112431630","chr10","30001295","30001591","48","82430030"
"chr1","112437577","112437933","chr2","83895226","83895555","108","28542351"
"chr1","112547711","112548035","chr16","25211732","25212053","62","87335979"
"chr1","112582899","112583076","chr14","110492718","110492865","33","2090181"
"chr1","112583388","112583510","chr1","159985961","159986084","19","47402573"
"chr1","112604991","112605284","chr14","110515493","110515786","5","2089498"
"chr1","112612721","112613017","chr14","110523222","110523518","11","2089499"
"chr1","112650170","112650388","chr14","110559071","110559289","4","2091099"
"chr1","112675803","112676079","chr14","110582983","110583247","20","2092820"
"chr1","112736585","112736746","chr6","54589288","54589448","27","58147297"
"chr1","112770321","112770613","chr14","110677544","110677852","71","2092777"
"chr1","112773776","112774080","chr14","110680587","110680894","8","2093189"
"chr1","112789956","112790088","chr14","110696713","110696845","2","2093243"
"chr1","112797248","112797335","chr15","91385659","91385747","20","21411589"
"chr1","112798032","112798185","chr14","110704839","110704992","3","2093193"
"chr1","112815098","112815276","chr14","110729454","110729618","20","2085644"
"chr1","112822008","112822323","chr14","110721677","110721991","11","2100331"
"chr1","112837359","112837637","chr14","110740828","110741106","9","2096531"
"chr1","112847176","112847482","chr14","110750051","110750358","8","2097125"
"chr1","112851461","112851762","chr14","110754370","110754667","10","2097091"
"chr1","112851929","112852007","chr9","95214091","95214171","10","17637838"
"chr1","112872164","112872452","chr14","110772699","110772977","25","2099465"
"chr1","112887720","112887770","chr4","154580698","154580747","8","41692978"
"chr1","112887860","112888094","chr2","82890576","82890799","43","29997284"
"chr1","112896294","112896602","chr14","110795875","110796181","19","2100419"
"chr1","112900759","112901055","chr14","110800510","110800808","7","2100249"
"chr1","112911230","112911525","chr14","110811231","110811525","13","2099999"
"chr1","112927735","112928036","chr14","110827737","110828039","16","2099998"
"chr1","112947207","112947509","chr14","110844595","110844895","9","2102612"
"chr1","112964596","112964717","chrX","108971246","108971363","23","3993350"
"chr1","112968905","112969196","chr15","13353715","13354012","76","99615190"
"chr1","112977281","112977580","chr14","110874321","110874621","13","2102960"
"chr1","112990255","112990430","chr14","110886652","110886826","7","2103603"
"chr1","112993139","112993443","chr14","110889539","110889843","7","2103600"
"chr1","113007922","113008228","chr14","110904359","110904665","10","2103563"
"chr1","113011955","113012264","chr14","110908414","110908725","18","2103541"
"chr1","113012573","113012876","chr14","110909034","110909337","10","2103539"
"chr1","113033071","113033363","chr14","110928548","110928845","15","2104523"
"chr1","113072686","113072959","chr14","110966737","110967011","9","2105949"
"chr1","113119080","113119364","chr14","111012291","111012577","9","2106789"
"chr1","113164749","113164976","chr14","111057120","111057351","9","2107629"
"chr1","113197040","113197304","chr14","111088318","111088582","6","2108722"
"chr1","113206300","113206582","chr14","111096884","111097158","46","2109416"
"chr1","113316638","113316949","chr14","111201401","111201714","17","2115237"
"chr1","113654572","113654871","chr6","73753256","73753561","50","39901316"
"chr1","113660343","113660639","chr14","111540225","111540517","9","2120118"
"chr1","113750188","113750498","chr14","111628793","111629101","13","2121395"
"chr1","113812108","113812409","chr14","111688697","111688999","6","2123411"
"chr1","113826389","113826657","chr14","111702858","111703126","6","2123531"
"chr1","113859757","113859883","chr14","111735431","111735557","3","2124326"
"chr1","113860211","113860408","chr14","111735901","111736068","32","2124310"
"chr1","113947023","113947286","chrX","37704861","37705119","70","76242162"
"chr1","113947354","113947654","chr14","111816536","111816813","26","2130818"
"chr1","113983144","113983435","chr14","111852598","111852887","11","2130546"
"chr1","113987413","113987532","chr14","111857408","111857527","3","2130005"
"chr1","114009111","114009415","chr11","84977457","84977763","65","29031654"
"chr1","114014152","114014428","chr14","111885969","111886266","23","2128183"
"chr1","114038598","114038910","chr14","111908795","111909107","6","2129803"
"chr1","114044262","114044567","chr14","111913053","111913357","6","2131209"
"chr1","114050111","114050385","chr14","111921937","111922211","3","2128174"
"chr1","114064323","114064630","chr14","111935247","111935557","12","2129076"
"chr1","114075513","114075648","chr14","111946095","111946234","12","2129418"
"chr1","114099543","114099557","chr14","111970063","111970077","0","2129480"
"chr1","114099599","114099873","chr14","111970151","111970433","14","2129448"
"chr1","114108757","114109046","chr14","111980140","111980429","6","2128617"
"chr1","114116203","114116402","chr14","111987372","111987571","5","2128831"
"chr1","114178676","114178902","chr1","139342737","139342961","42","25164061"
"chr1","114185517","114185700","chr14","112053544","112053736","16","2131973"
"chr1","114263251","114263560","chr14","112133469","112133772","15","2129782"
"chr1","114263968","114264268","chr14","112134176","112134479","8","2129792"
"chr1","114267131","114267231","chr14","112137385","112137485","0","2129746"
"chr1","114268600","114268886","chr14","112138830","112139126","19","2129770"
"chr1","114274357","114274444","chr4","2744439","2744523","19","111529918"
"chr1","114274704","114275016","chr14","112143914","112144215","21","2130790"
"chr1","114278169","114278332","chr4","119074513","119074677","33","4796344"
"chr1","114278361","114278521","chr20","56565352","56565487","51","57713009"
"chr1","114299366","114299661","chr14","112168223","112168518","6","2131143"
"chr1","114300479","114300624","chr1","19798597","19798734","40","94501882"
"chr1","114302422","114302486","chrX","46880988","46881052","18","67421434"
"chr1","114306249","114306440","chr14","112174910","112175102","9","2131339"
"chr1","114387308","114387602","chr14","112253284","112253578","5","2134024"
"chr1","114411322","114411632","chrX","87136676","87136987","52","27274646"
"chr1","114415898","114416139","chr14","112281205","112281445","6","2134693"
"chr1","114431666","114431926","chr14","112293754","112294037","29","2137912"
"chr1","114437736","114438041","chr14","112299966","112300260","23","2137770"
"chr1","114442082","114442290","chr14","112304747","112304969","23","2137335"
"chr1","114455675","114455797","chr20","19814709","19814828","22","94640966"
"chr1","114456560","114456833","chr14","112319862","112320135","1","2136698"
"chr1","114476778","114476952","chr14","112338730","112338908","14","2138048"
"chr1","114484117","114484424","chr14","112346048","112346355","8","2138069"
"chr1","114491664","114491780","chr14","112353527","112353645","4","2138137"
"chr1","114494988","114495165","chr14","112357021","112357196","2","2137967"
"chr1","114495472","114495618","chr14","112357498","112357643","2","2137974"
"chr1","114522005","114522276","chr14","112392253","112392524","4","2129752"
"chr1","114528045","114528195","chrX","43758173","43758335","33","70769872"
"chr1","114533551","114533854","chr14","112403293","112403575","31","2130258"
"chr1","114541317","114541627","chr14","112411736","112412024","25","2129581"
"chr1","114542542","114542857","chr14","112412959","112413273","12","2129583"
"chr1","114552189","114552501","chr14","112422341","112422653","7","2129848"
"chr1","114553518","114553835","chr14","112423670","112423984","13","2129848"
"chr1","114588516","114588806","chr14","112458779","112459067","11","2129737"
"chr1","114613215","114613526","chr14","112482804","112483115","20","2130411"
"chr1","114631328","114631617","chr14","112499655","112499944","3","2131673"
"chr1","114643074","114643334","chr1","35072734","35072997","63","79570340"
"chr1","114650401","114650702","chr17","6616556","6616863","53","108033845"
"chr1","114655147","114655410","chr11","91304643","91304917","63","23350504"
"chr1","114659189","114659476","chr14","112526292","112526599","27","2132897"
"chr1","114659488","114659546","chr2","81925444","81925497","14","32734044"
"chr1","114660349","114660583","chr14","112527097","112527342","17","2133252"
"chr1","114698411","114698712","chr14","112564223","112564524","13","2134188"
"chr1","114720432","114720719","chr14","112585781","112586068","3","2134651"
"chr1","114724162","114724394","chr14","112588769","112589046","69","2135393"
"chr1","114725222","114725512","chr14","112589865","112590155","7","2135357"
"chr1","114729382","114729679","chr14","112593562","112593852","13","2135820"
"chr1","114734425","114734599","chr14","112598621","112598800","9","2135804"
"chr1","114743419","114743704","chr14","112607500","112607780","12","2135919"
"chr1","114757946","114758131","chrX","51044685","51044857","43","63713261"
"chr1","114777586","114777904","chr14","112640705","112641020","12","2136881"
"chr1","114791531","114791778","chr14","112654525","112654768","17","2137006"
"chr1","114801792","114802052","chr14","112664597","112664843","20","2137195"
"chr1","114833567","114833885","chr2","47735644","47735958","63","67097923"
"chr1","114836436","114836554","chr1","34512524","34512644","29","80323912"
"chr1","114841602","114841750","chr14","112701364","112701510","5","2140238"
"chr1","114849650","114849801","chr14","112710326","112710475","17","2139324"
"chr1","114861210","114861501","chr14","112721176","112721482","27","2140034"
"chr1","114863002","114863126","chr1","41160156","41160285","31","73702846"
"chr1","114876982","114877283","chr14","112736276","112736575","11","2140706"
"chr1","114883506","114883632","chr14","112742980","112743106","3","2140526"
"chr1","114883633","114883691","chr14","112743107","112743165","2","2140526"
"chr1","114903674","114903826","chr19","34130811","34130947","38","80772863"
"chr1","114938150","114938450","chr3","35716819","35717138","65","79221331"
"chr1","114939000","114939277","chr14","112798574","112798883","35","2140426"
"chr1","114953733","114953891","chr11","97458042","97458175","42","17495691"
"chr1","115000537","115000612","chr14","112859368","112859445","5","2141169"
"chr1","115016953","115017266","chrX","45761033","45761338","52","69255920"
"chr1","115034861","115035128","chr14","112893028","112893294","12","2141833"
"chr1","115054222","115054339","chr14","112911823","112911940","3","2142399"
"chr1","115069734","115070018","chr14","112926244","112926528","6","2143490"
"chr1","115089333","115089645","chr14","112944698","112945008","13","2144635"
"chr1","115109200","115109494","chr7","24667258","24667557","61","90441942"
"chr1","115115103","115115403","chr14","112969959","112970251","13","2145144"
"chr1","115115722","115116016","chr14","112970570","112970861","6","2145152"
"chr1","115117185","115117489","chr14","112972026","112972327","8","2145159"
"chr1","115145947","115146231","chr14","112999472","112999756","10","2146475"
"chr1","115154864","115155155","chr1","57570685","57570961","56","57584179"
"chr1","115173116","115173273","chr13","37888752","37888912","31","77284364"
"chr1","115257344","115257640","chr14","113136706","113137003","9","2120638"
"chr1","115265365","115265685","chr14","113145075","113145377","31","2120290"
"chr1","115272073","115272381","chr14","113151725","113152026","13","2120348"
"chr1","115305559","115305844","chr14","113185073","113185355","14","2120486"
"chr1","115332662","115332826","chr2","184466213","184466380","29","69133551"
"chr1","115367730","115367963","chr14","113234893","113235127","3","2132837"
"chr1","115370352","115370635","chr7","133844053","133844332","79","18473701"
"chr1","115397412","115397709","chr14","113262496","113262792","8","2134916"
"chr1","115447364","115447463","chr20","49228494","49228595","21","66218870"
"chr1","115447474","115447750","chr14","113336538","113336850","44","2110936"
"chr1","115484105","115484355","chr14","113374156","113374409","13","2109949"
"chr1","115538947","115539108","chr20","23254642","23254804","49","92284305"
"chr1","115539187","115539273","chr9","34116356","34116443","16","81422831"
"chr1","115543889","115544182","chr14","56933672","56933959","55","58610217"
"chr1","115667908","115668132","chr8","95484101","95484325","56","20183807"
"chr1","115697256","115697491","chr14","113590410","113590641","8","2106846"
"chr1","115824895","115825023","chr14","113714794","113714923","1","2110101"
"chr1","115836650","115836931","chr14","113726740","113727021","7","2109910"
"chr1","115881447","115881739","chr14","113770293","113770582","14","2111154"
"chr1","115905581","115905862","chr14","113794327","113794609","3","2111254"
"chr1","115914906","115915017","chr14","61420461","61420567","19","54494445"
"chr1","115936722","115936994","chr14","113824926","113825201","12","2111796"
"chr1","115950839","115951119","chr14","113839339","113839619","6","2111500"
"chr1","115954371","115954666","chr14","113842877","113843174","8","2111494"
"chr1","115955812","115955992","chr14","113844322","113844498","8","2111490"
"chr1","115956120","115956326","chr4","161686089","161686291","49","45729969"
"chr1","115978063","115978359","chr14","113866284","113866571","19","2111779"
"chr1","116003120","116003434","chr14","113891951","113892252","44","2111169"
"chr1","116024001","116024311","chr14","113913508","113913822","13","2110493"
"chr1","116050709","116051014","chrX","50269867","50270166","55","65780842"
"chr1","116070999","116071316","chr14","113953807","113954122","15","2117192"
"chr1","116076879","116077174","chr14","113959628","113959921","6","2117251"
"chr1","116119111","116119300","chr14","114001539","114001730","8","2117572"
"chr1","116371386","116371623","chr14","114240914","114241150","5","2130472"
"chr1","116382108","116382397","chr14","114251232","114251526","7","2130876"
"chr1","116449196","116449500","chr14","114315434","114315734","10","2133762"
"chr1","116506559","116506865","chr14","114373131","114373442","23","2133428"
"chr1","116591634","116591916","chr14","114457337","114457619","6","2134297"
"chr1","116606761","116607076","chr14","114473248","114473542","24","2133513"
"chr1","116610955","116611267","chr14","114477444","114477770","22","2133511"
"chr1","116620879","116621099","chr17","6541119","6541317","78","110079760"
"chr1","116621373","116621443","chr14","114488152","114488220","2","2133221"
"chr1","116633554","116633844","chr14","114500001","114500252","48","2133553"
"chr1","116634933","116635248","chr14","114501669","114501977","21","2133264"
"chr1","116638421","116638714","chr4","154788495","154788796","55","38150074"
"chr1","116639959","116640234","chr14","114506507","114506784","8","2133452"
"chr1","116647459","116647741","chr14","114513950","114514232","2","2133509"
"chr1","116652565","116652863","chr14","114519339","114519636","8","2133226"
"chr1","116655125","116655449","chr14","114521907","114522231","7","2133218"
"chr1","116674192","116674487","chr14","114539966","114540261","4","2134226"
"chr1","116682024","116682117","chr14","114549680","114549773","2","2132344"
"chr1","116683003","116683302","chr14","114550658","114550952","11","2132345"
"chr1","116683704","116684018","chr14","114551352","114551659","18","2132352"
"chr1","116705150","116705278","chr14","114574017","114574143","3","2131133"
"chr1","116708506","116708671","chr14","114577013","114577197","23","2131493"
"chr1","116708686","116708994","chr14","114577528","114577871","39","2131158"
"chr1","116727551","116727689","chr14","72844030","72844163","30","43883521"
"chr1","116738903","116739039","chr20","22206450","22206577","20","94532453"
"chr1","116746099","116746358","chr14","114616088","114616331","23","2130011"
"chr1","116751659","116751965","chr14","114622236","114622546","19","2129423"
"chr1","116758140","116758426","chr14","114628727","114629013","14","2129413"
"chr1","116763292","116763494","chr14","114633886","114634088","3","2129406"
"chr1","116764062","116764357","chr14","114634648","114634943","15","2129414"
"chr1","116774689","116774984","chr14","114644830","114645128","15","2129859"
"chr1","116777444","116777739","chr14","114647558","114647865","31","2129886"
"chr1","116778077","116778385","chr14","114648220","114648524","18","2129857"
"chr1","116801937","116802151","chr14","114671958","114672191","24","2129979"
"chr1","116802535","116802832","chr14","114672575","114672872","8","2129960"
"chr1","116874747","116874932","chr14","114739035","114739222","8","2135712"
"chr1","116877889","116878184","chr3","89172238","89172528","52","27705651"
"chr1","116961669","116961950","chr14","114840450","114840732","7","2121219"
"chr1","117013909","117013976","chr14","114903398","114903465","3","2110511"
"chr1","117097711","117097818","chr14","114984620","114984727","2","2113091"
"chr1","117097895","117098059","chr14","114984804","114984971","6","2113091"
"chr1","117115992","117116127","chr14","115003833","115003961","8","2112159"
"chr1","117129096","117129365","chr14","115016740","115017024","23","2112356"
"chr1","117134519","117134788","chr14","115021905","115022175","7","2112614"
"chr1","117144908","117145194","chr2","96503618","96503911","58","20641290"
"chr1","117148456","117148600","chr14","115035774","115035918","7","2112682"
"chr1","117150362","117150672","chr14","115037683","115037976","31","2112679"
"chr1","117165393","117165682","chr2","27695871","27696154","53","89469522"
"chr1","117165796","117166100","chr6","14110092","14110396","56","103055704"
"chr1","117197940","117198246","chr14","115087179","115087478","12","2110761"
"chr1","117199670","117199833","chr14","115088820","115088985","9","2110850"
"chr1","117199906","117200176","chr14","115089058","115089328","2","2110848"
"chr1","117221532","117221817","chr14","115110722","115111006","3","2110810"
"chr1","117269581","117269887","chr14","115158962","115159270","29","2110619"
"chr1","117272695","117272862","chr3","66744113","66744285","41","50528582"
"chr1","117273089","117273180","chr1","206822965","206823056","24","89549876"
"chr1","117276718","117277021","chr14","115165855","115166158","4","2110863"
"chr1","117298306","117298615","chr14","115187318","115187630","17","2110988"
"chr1","117306282","117306580","chr14","115194958","115195260","16","2111324"
"chr1","117312994","117313132","chr11","60527399","60527534","31","56785595"
"chr1","117327012","117327339","chr14","115216806","115217128","14","2110206"
"chr1","117328260","117328569","chr14","115218040","115218358","16","2110220"
"chr1","117342442","117342738","chr1","130575181","130575476","64","13232739"
"chr1","117350951","117351223","chr14","115240279","115240567","21","2110672"
"chr1","117353012","117353305","chr14","115242368","115242600","66","2110644"
"chr1","117354118","117354411","chr14","115243475","115243768","11","2110643"
"chr1","117360012","117360310","chr14","115249364","115249661","5","2110648"
"chr1","117385201","117385494","chr14","115275460","115275773","32","2109741"
"chr1","117397974","117398260","chr14","115288216","115288505","16","2109758"
"chr1","117406843","117407157","chr14","115297635","115297949","9","2109208"
"chr1","117425006","117425286","chr14","115316265","115316566","34","2108741"
"chr1","117442149","117442450","chr19","40898600","40898905","50","76543549"
"chr1","117448109","117448399","chr14","115339542","115339832","6","2108567"
"chr1","117522088","117522375","chr14","115408963","115409262","19","2113125"
"chr1","117644226","117644532","chr1","14612826","14613129","60","103031400"
"chr1","117715205","117715490","chr14","115602855","115603139","7","2112350"
"chr1","117809712","117809920","chr14","115694623","115694838","10","2115089"
"chr1","117923947","117924130","chr14","115809490","115809673","4","2114457"
"chr1","118018166","118018329","chr14","115907507","115907655","26","2110659"
"chr1","118096866","118097044","chr14","115986416","115986584","14","2110450"
"chr1","118097089","118097272","chr12","62574820","62574998","42","55522269"
"chr1","118156595","118156721","chr9","57895123","57895243","40","60261472"
"chr1","118156895","118156990","chr2","102721735","102721840","23","15435160"
"chr1","118230438","118230754","chr14","116106209","116106536","22","2124229"
"chr1","118281608","118281911","chr14","116156349","116156655","13","2125259"
"chr1","118316727","118317015","chr14","116190341","116190613","19","2126386"
"chr1","118343392","118343678","chr14","116216321","116216607","3","2127071"
"chr1","118345808","118345926","chrX","117872956","117873068","28","472852"
"chr1","118352616","118352758","chr4","151931883","151932019","38","33579267"
"chr1","118379038","118379079","chr13","37767567","37767609","8","80611471"
"chr1","118379135","118379388","chr14","54159535","54159779","64","64219600"
"chr1","118501573","118501856","chr14","116367868","116368151","8","2133705"
"chr1","118525100","118525365","chr14","116390746","116391011","2","2134354"
"chr1","118551333","118551423","chr14","116416749","116416839","1","2134584"
"chr1","118582833","118583126","chr14","116447219","116447515","12","2135614"
"chr1","118628098","118628223","chr14","116490587","116490712","3","2137511"
"chr1","118628483","118628649","chr14","116490998","116491163","5","2137485"
"chr1","118884057","118884368","chr14","116741482","116741787","15","2142575"
"chr1","119032373","119032679","chr14","116885169","116885487","15","2147204"
"chr1","119109425","119109709","chr14","116959955","116960241","26","2149470"
"chr1","119272752","119273016","chr14","117117920","117118184","3","2154832"
"chr1","119339368","119339653","chr10","59443884","59444176","54","59895484"
"chr1","119359628","119359934","chr14","117204473","117204779","5","2155155"
"chr1","119443022","119443307","chr14","117285415","117285704","16","2157607"
"chr1","119726108","119726384","chr14","117564799","117565094","30","2161309"
"chr1","119805806","119805928","chr14","117641100","117641222","1","2164706"
"chr1","119833439","119833713","chr14","117668656","117668896","42","2164783"
"chr1","119876901","119877000","chr19","20333420","20333521","28","99543481"
"chr1","119885138","119885432","chr13","60733163","60733461","64","59151975"
"chr1","119890071","119890355","chr14","117724591","117724896","27","2165480"
"chr1","119927663","119927951","chr14","117762365","117762655","15","2165298"
"chr1","119962127","119962417","chr14","68805278","68805567","9","51156849"
"chr1","119962419","119962579","chr7","25941776","25941912","41","94020643"
"chr1","120066387","120066655","chr14","117884527","117884810","21","2181860"
"chr1","120127333","120127640","chrX","96318063","96318367","51","23809270"
"chr1","120138683","120138885","chr14","117952797","117952998","5","2185886"
"chr1","120139493","120139593","chr14","117953605","117953705","2","2185888"
"chr1","120190205","120190409","chr14","118006032","118006232","6","2184173"
"chr1","120204287","120204518","chr14","118019689","118019920","4","2184598"
"chr1","120235998","120236196","chr14","118050245","118050477","39","2185753"
"chr1","120309132","120309277","chr14","118123181","118123304","25","2185951"
"chr1","120310018","120310176","chr14","118124076","118124234","3","2185942"
"chr1","120366795","120367094","chr14","118179535","118179828","10","2187260"
"chr1","120369221","120369511","chr14","118181471","118181757","6","2187750"
"chr1","120376528","120376833","chr14","118195876","118196180","11","2180652"
"chr1","120379066","120379369","chr14","118198417","118198720","5","2180649"
"chr1","120406865","120407190","chr14","118225784","118226075","41","2181081"
"chr1","120432766","120433058","chr14","118250867","118251160","13","2181899"
"chr1","120446215","120446514","chr17","72807838","72808128","64","47638377"
"chr1","120482639","120482942","chr14","118301622","118301930","12","2181017"
"chr1","120595034","120595161","chr18","50055634","50055758","28","70539400"
"chr1","120621758","120622061","chr14","118440935","118441241","11","2180823"
"chr1","120642227","120642522","chr14","118461239","118461538","13","2180988"
"chr1","120666373","120666676","chrX","62003133","62003420","80","58663240"
"chr1","120710156","120710458","chr14","118535207","118535488","27","2174949"
"chr1","120747287","120747413","chr14","118571277","118571403","1","2176010"
"chr1","120761468","120761768","chr14","118585598","118585897","9","2175870"
"chr1","120835952","120836117","chr14","118661917","118662069","18","2174035"
"chr1","120855223","120855511","chr14","118681565","118681853","10","2173658"
"chr1","120884914","120885069","chr9","84993746","84993904","34","35891168"
"chr1","120885101","120885112","chr9","75783886","75783897","1","45101215"
"chr1","120906191","120906325","chr6","31305357","31305486","29","89600834"
"chr1","120909763","120910054","chr14","118732912","118733203","6","2176851"
"chr1","120954667","120954788","chr14","6669230","6669349","20","114285437"
"chr1","120965753","120966052","chr14","118785140","118785441","10","2180613"
"chr1","120970599","120970915","chr14","118789987","118790303","17","2180612"
"chr1","120974808","120975067","chr14","118794181","118794421","34","2180627"
"chr1","120976888","120977193","chr14","118796774","118797080","9","2180114"
"chr1","120988813","120989097","chr2","27695871","27696154","68","93292942"
"chr1","120992870","120993015","chr14","118812059","118812202","4","2180811"
"chr1","120993319","120993484","chr18","13429646","13429816","26","107563673"
"chr1","121008644","121008943","chr14","118828037","118828335","8","2180607"
"chr1","121012711","121013012","chr14","118832435","118832718","25","2180276"
"chr1","121030479","121030782","chr14","118848281","118848578","17","2182198"
"chr1","121033076","121033335","chr14","118850859","118851154","42","2182217"
"chr1","121043787","121044057","chr14","118859898","118860156","15","2183889"
"chr1","121047077","121047382","chr4","103468600","103468909","53","17578477"
"chr1","121061822","121062139","chr14","118876638","118876955","7","2185184"
"chr1","121065991","121066279","chr14","118880866","118881154","11","2185125"
"chr1","121068613","121068903","chr14","118883430","118883720","20","2185183"
"chr1","121083683","121083941","chr14","118897645","118897917","19","2186038"
"chr1","121092648","121092974","chr14","118906656","118906983","8","2185992"
"chr1","121093573","121093839","chr14","118907600","118907858","14","2185973"
"chr1","121096994","121097274","chr14","118910926","118911206","1","2186068"
"chr1","121098445","121098748","chr14","118912372","118912675","4","2186073"
"chr1","121117604","121117847","chr14","118929675","118929918","6","2187929"
"chr1","121121729","121121972","chr14","118929675","118929918","6","2192054"
"chr1","121137316","121137632","chr5","49358011","49358315","73","71779305"
"chr1","121142633","121142918","chr14","118950836","118951143","31","2191797"
"chr1","121146898","121147155","chr13","60546863","60547121","67","60600035"
"chr1","121164639","121164957","chr14","118972962","118973280","5","2191677"
"chr1","121183773","121184078","chr14","118992607","118992905","17","2191166"
"chr1","121212281","121212571","chr14","119019621","119019922","12","2192660"
"chr1","121217904","121218220","chr14","119025029","119025344","10","2192875"
"chr1","121233081","121233415","chr14","119039700","119040037","14","2193381"
"chr1","121243743","121244014","chr14","119049832","119050102","5","2193911"
"chr1","121251752","121252051","chr14","119057978","119058280","20","2193774"
"chr1","121306554","121306824","chr14","119123206","119123483","15","2183348"
"chr1","121350120","121350427","chr14","119168752","119169034","31","2181368"
"chr1","121365571","121365761","chr14","119183869","119184056","11","2181702"
"chr1","121368460","121368760","chr14","119186546","119186864","21","2181914"
"chr1","121368854","121369149","chr14","119186940","119187230","16","2181914"
"chr1","121379229","121379525","chr16","2646247","2646538","57","118732982"
"chr1","121400846","121401132","chr14","119218487","119218765","12","2182359"
"chr1","121405431","121405733","chr14","119223035","119223351","20","2182396"
"chr1","121408432","121408608","chr16","7042202","7042378","37","114366230"
"chr1","121417602","121417745","chr3","148580967","148581112","27","27163365"
"chr1","121435069","121435312","chr14","119255409","119255657","14","2179660"
"chr1","121436728","121437017","chrX","37147240","37147532","57","84289488"
"chr1","121442914","121443079","chr5","33892887","33893052","31","87550027"
"chr1","121444317","121444623","chr14","119264758","119265031","44","2179559"
"chr1","121444768","121445069","chr14","119265209","119265510","6","2179559"
"chr1","121445916","121446213","chr14","119266365","119266654","10","2179551"
"chr1","121450746","121451033","chr14","119270365","119270618","37","2180381"
"chr1","121459556","121459843","chr14","119279436","119279685","45","2180120"
"chr1","121476799","121476944","chr11","121092295","121092441","26","384504"
"chr1","121521114","121521424","chr14","119340067","119340377","2","2181047"
"chr1","121526759","121527066","chr14","119345721","119346034","12","2181038"
"chr1","121560415","121560738","chr19","33355872","33356175","67","88204543"
"chr1","121561319","121561612","chr2","83637244","83637544","71","37924075"
"chr1","121563667","121563970","chr2","167799189","167799489","59","46235522"
"chr1","121596386","121596703","chr14","119414161","119414474","8","2182225"
"chr1","121689811","121690093","chr14","119499712","119499984","21","2190099"
"chr1","121696219","121696537","chr14","119511282","119511601","10","2184937"
"chr1","121731933","121732043","chr14","119547113","119547223","4","2184820"
"chr1","121760424","121760713","chr14","119573296","119573597","20","2187128"
"chr1","121805401","121805605","chr14","119618680","119618883","3","2186721"
"chr1","121861308","121861619","chrX","142116490","142116801","55","20255182"
"chr1","121889533","121889827","chr2","56721997","56722291","66","65167536"
"chr1","121901537","121901737","chr7","42418992","42419183","46","79482545"
"chr1","121989409","121989547","chr3","176368925","176369052","39","54379516"
"chr1","122010880","122011179","chr14","119832285","119832585","15","2178595"
"chr1","122049544","122049830","chr14","119876967","119877251","11","2172577"
"chr1","122082171","122082476","chr14","119910594","119910848","65","2171577"
"chr1","122160282","122160570","chr14","119989482","119989773","16","2170800"
"chr1","122186889","122187195","chr14","120015457","120015762","6","2171432"
"chr1","122269433","122269746","chr14","120099954","120100259","15","2169479"
"chr1","122526190","122526502","chr14","120359555","120359873","18","2166635"
"chr1","122536907","122537182","chr14","120370201","120370474","11","2166706"
"chr1","122561769","122562059","chr14","120394491","120394786","13","2167278"
"chr1","122569574","122569873","chr14","120402357","120402643","20","2167217"
"chr1","122617338","122617494","chr14","120450685","120450839","8","2166653"
"chr1","122625697","122625993","chr7","37465729","37466023","62","85159968"
"chr1","122652883","122653186","chr14","120486542","120486850","38","2166341"
"chr1","122743968","122744209","chr14","120579321","120579564","8","2164647"
"chr1","122749022","122749253","chr14","120584369","120584600","4","2164653"
"chr1","122756850","122757141","chr14","120592116","120592415","20","2164734"
"chr1","122784318","122784478","chr14","120619528","120619688","1","2164790"
"chr1","122954774","122955068","chr14","120788765","120789066","16","2166009"
"chr1","122960291","122960570","chr14","120794300","120794579","15","2165991"
"chr1","123001284","123001580","chr14","120835268","120835571","19","2166016"
"chr1","123001625","123001719","chr2","132448586","132448677","27","9446961"
"chr1","123103353","123103642","chr14","120934341","120934636","12","2169012"
"chr1","123140314","123140479","chr18","18006699","18006868","39","105133615"
"chr1","123146806","123147094","chr14","120976605","120976935","60","2170201"
"chr1","123249907","123250175","chr14","121074718","121074977","13","2175189"
"chr1","123458397","123458456","chr10","79598512","79598573","13","43859885"
"chr1","123488562","123488577","chr2","86482117","86482131","6","37006445"
"chr1","123509852","123510134","chr14","121320372","121320643","18","2189480"
"chr1","123748038","123748347","chr14","121562832","121563141","10","2185206"
"chr1","123976067","123976343","chr14","121783965","121784240","9","2192102"
"chr1","123983361","123983674","chr14","121791234","121791541","12","2192127"
"chr1","124191163","124191437","chr14","121990529","121990803","11","2200634"
"chr1","124440747","124441104","chr14","122244785","122245135","29","2195962"
"chr1","124505563","124505862","chr15","9567078","9567337","101","114938485"
"chr1","124686453","124686751","chr14","122488448","122488742","9","2198005"
"chr1","124781077","124781300","chr14","122582728","122582951","6","2198349"
"chr1","124822315","124822542","chr14","122619036","122619307","56","2203279"
"chr1","124944229","124944536","chr14","122733744","122734052","9","2210485"
"chr1","124980248","124980558","chr14","122770023","122770316","26","2210225"
"chr1","125116543","125116791","chr14","122905357","122905604","9","2211186"
"chr1","125117726","125118020","chr14","122906653","122906948","12","2211073"
"chr1","125133593","125133903","chr14","122922040","122922350","14","2211553"
"chr1","125145197","125145510","chr9","32668102","32668409","61","92477095"
"chr1","125157254","125157339","chr1","190655363","190655447","25","65498109"
"chr1","125166369","125166664","chr14","122953493","122953789","10","2212876"
"chr1","125233071","125233282","chr14","123018065","123018276","1","2215006"
"chr1","125300254","125300556","chr10","27716388","27716677","67","97583866"
"chr1","125361922","125362181","chr14","123144411","123144670","8","2217511"
"chr1","125851718","125851829","chr14","123619961","123620067","7","2231757"
"chr1","125865224","125865552","chr8","20198406","20198709","78","105666818"
"chr1","126009443","126009745","chr14","123771997","123772298","10","2237446"
"chr2","3801017","3801283","chr10","3945379","3945645","5","144362"
"chr2","4849633","4849923","chr14","64329026","64329321","55","59479393"
"chr2","7470844","7471140","chr7","17805090","17805394","70","10334246"
"chr2","32767916","32768218","chr10","38111699","38112001","7","5343783"
"chr2","56885212","56885493","chr10","28161097","28161376","12","28724115"
"chr2","81264399","81264676","chr3","9261879","9262156","7","72002520"
"chr2","81657754","81657916","chr3","8870850","8871004","10","72786904"
"chr2","87556081","87556436","chr3","2910606","2910877","95","84645475"
"chr2","36904","37187","chr10","39358","39645","9","2454"
"chr2","115189","115352","chr10","148925","149088","6","33736"
"chr2","137112","137274","chr10","171150","171312","6","34038"
"chr2","139803","140102","chr10","173791","174089","6","33988"
"chr2","145693","145994","chr10","179097","179373","37","33404"
"chr2","217347","217650","chr10","251265","251568","10","33918"
"chr2","228674","228982","chr10","266364","266668","13","37690"
"chr2","236026","236317","chr10","272957","273247","2","36931"
"chr2","237662","237954","chr10","274588","274879","10","36926"
"chr2","237955","238113","chr10","274880","275038","4","36925"
"chr2","243924","244085","chr10","284071","284232","19","40147"
"chr2","245179","245299","chr1","85858415","85858535","25","85613236"
"chr2","246256","246315","chr1","4205227","4205277","21","3958971"
"chr2","247582","247717","chr10","284533","284662","8","36951"
"chr2","314621","314910","chr11","115941293","115941577","65","115626672"
"chr2","323001","323305","chr10","369038","369342","15","46037"
"chr2","329623","329859","chr10","376522","376758","11","46899"
"chr2","332353","332639","chr10","379260","379549","16","46907"
"chr2","332713","332751","chr14","10413145","10413185","8","10080432"
"chr2","333349","333360","chr1","1476117","1476130","3","1142768"
"chr2","355653","355950","chr3","52144875","52145171","61","51789222"
"chr2","387412","387696","chr10","435831","436104","13","48419"
"chr2","404746","405036","chr10","461633","461928","12","56887"
"chr2","406324","406483","chr10","463482","463641","3","57158"
"chr2","420490","420789","chr10","469328","469629","22","48838"
"chr2","425680","425971","chr10","476667","476958","6","50987"
"chr2","428676","428980","chr10","480189","480480","19","51513"
"chr2","438152","438292","chr10","489988","490124","9","51836"
"chr2","438598","438626","chr10","490426","490459","5","51828"
"chr2","443614","443890","chr10","20776910","20777184","68","20333296"
"chr2","445458","445743","chr10","497348","497633","8","51890"
"chr2","453784","453992","chr10","506014","506227","7","52230"
"chr2","462503","462746","chr10","514505","514748","1","52002"
"chr2","476265","476401","chr15","3262224","3262356","21","2785959"
"chr2","480501","480783","chrX","120356258","120356539","55","119875757"
"chr2","504916","505206","chr10","558511","558809","15","53595"
"chr2","507662","507966","chr10","561268","561572","6","53606"
"chr2","513475","513603","chr10","567160","567288","2","53685"
"chr2","516676","516910","chr10","570979","571211","12","54303"
"chr2","517507","517642","chr10","572120","572255","2","54613"
"chr2","518255","518435","chr10","572862","573058","39","54607"
"chr2","525366","525653","chr10","580000","580269","30","54634"
"chr2","542594","542783","chr7","43805717","43805894","44","43263123"
"chr2","542946","543094","chr3","33984321","33984470","27","33441375"
"chr2","548936","549234","chr10","608172","608466","13","59236"
"chr2","553989","554281","chr10","612934","613230","16","58945"
"chr2","558651","558815","chr10","604882","605050","10","46231"
"chr2","608767","609025","chr10","662957","663215","5","54190"
"chr2","617814","618132","chr4","36126419","36126732","64","35508605"
"chr2","630981","631283","chr10","685601","685883","24","54620"
"chr2","681102","681341","chr9","54641286","54641526","46","53960184"
"chr2","683669","683952","chr10","737053","737336","5","53384"
"chr2","702022","702323","chr19","37342753","37343049","58","36640731"
"chr2","706640","707004","chr10","767365","767721","18","60725"
"chr2","770007","770294","chr6","156887783","156888072","45","156117776"
"chr2","871902","872213","chr12","101156642","101156945","61","100284740"
"chr2","909117","909423","chr10","979087","979400","16","69970"
"chr2","1078512","1078781","chr11","100927137","100927404","49","99848625"
"chr2","1083667","1083809","chrX","6936247","6936384","28","5852580"
"chr2","1170589","1170744","chr10","1262312","1262466","6","91723"
"chr2","1188574","1188701","chr10","1279037","1279153","14","90463"
"chr2","1207501","1207810","chr10","1298112","1298425","12","90611"
"chr2","1230092","1230270","chr10","1318760","1318937","11","88668"
"chr2","1237837","1238002","chr20","51372605","51372771","41","50134768"
"chr2","1251472","1251737","chr10","1340892","1341170","18","89420"
"chr2","1281130","1281418","chr10","1370856","1371144","6","89726"
"chr2","1290758","1290877","chr10","1380809","1380924","6","90051"
"chr2","1291842","1292128","chr10","1381903","1382189","8","90061"
"chr2","1301018","1301097","chr10","1392104","1392183","5","91086"
"chr2","1301267","1301438","chr10","1392349","1392520","3","91082"
"chr2","1304694","1304824","chr10","1395863","1395993","5","91169"
"chr2","1305781","1306066","chr10","1396953","1397238","5","91172"
"chr2","1330082","1330364","chr10","1421559","1421851","14","91477"
"chr2","1357614","1357910","chr10","1449222","1449519","9","91608"
"chr2","1371980","1372288","chr10","1462699","1463020","17","90719"
"chr2","1375609","1375916","chr10","1465983","1466291","7","90374"
"chr2","1379107","1379294","chr10","1469481","1469678","18","90374"
"chr2","1381582","1381716","chr10","1471984","1472118","5","90402"
"chr2","1405229","1405533","chr4","152226280","152226592","54","150821051"
"chr2","1413033","1413233","chr10","1504730","1504930","7","91697"
"chr2","1501738","1501910","chr10","1591961","1592137","7","90223"
"chr2","1511182","1511480","chr10","1601623","1601919","16","90441"
"chr2","1551828","1552108","chr10","1642061","1642342","9","90233"
"chr2","1646022","1646309","chr10","1734213","1734500","11","88191"
"chr2","1713518","1713815","chr10","1802393","1802690","8","88875"
"chr2","1761470","1761775","chr10","1846291","1846589","16","84821"
"chr2","1826603","1826883","chr10","1911876","1912155","6","85273"
"chr2","1853386","1853485","chr10","1941062","1941162","1","87676"
"chr2","1856561","1856785","chr15","99486679","99486907","45","97630118"
"chr2","1895340","1895546","chr10","1983069","1983280","8","87729"
"chr2","1948475","1948621","chr8","7046763","7046905","29","5098288"
"chr2","1949215","1949392","chr3","42298682","42298860","32","40349467"
"chr2","1962835","1962969","chr10","2054546","2054680","1","91711"
"chr2","1963276","1963446","chr10","2054989","2055155","9","91713"
"chr2","1971437","1971711","chr10","2063493","2063775","12","92056"
"chr2","1986802","1987110","chr10","2079426","2079727","12","92624"
"chr2","2037141","2037273","chr10","2130477","2130608","3","93336"
"chr2","2059593","2059793","chr16","48745480","48745675","44","46685887"
"chr2","2064257","2064533","chr10","2157526","2157814","31","93269"
"chr2","2066117","2066289","chrX","107430136","107430308","30","105364019"
"chr2","2069451","2069716","chr10","2163251","2163516","7","93800"
"chr2","2070137","2070428","chr16","48708199","48708491","64","46638062"
"chr2","2073164","2073338","chr1","23872213","23872387","38","21799049"
"chr2","2076617","2076933","chr10","2170716","2171032","12","94099"
"chr2","2083101","2083385","chr10","2177646","2177931","6","94545"
"chr2","2087547","2087649","chr10","2182075","2182174","4","94528"
"chr2","2096541","2096780","chr10","2191210","2191441","13","94669"
"chr2","2123317","2123620","chr10","2218703","2219006","8","95386"
"chr2","2126820","2127095","chr10","2222196","2222473","9","95376"
"chr2","2128700","2128965","chr14","7881124","7881383","71","5752424"
"chr2","2129000","2129269","chr9","56778958","56779238","71","54649958"
"chr2","2134145","2134468","chr8","35744192","35744506","85","33610047"
"chr2","2149217","2149524","chr10","34374299","34374608","52","32225082"
"chr2","2154760","2155069","chr10","2247424","2247733","11","92664"
"chr2","2159417","2159709","chr10","2252135","2252416","20","92718"
"chr2","2159761","2160063","chr10","2252468","2252768","6","92707"
"chr2","2186935","2187202","chr10","2281931","2282198","9","94996"
"chr2","2224813","2225112","chr10","2320503","2320808","18","95690"
"chr2","2233375","2233613","chr10","2329076","2329311","8","95701"
"chr2","2239431","2239567","chr7","42422566","42422701","27","40183135"
"chr2","2297371","2297665","chr10","2389982","2390288","23","92611"
"chr2","2368177","2368321","chr10","2464482","2464626","2","96305"
"chr2","2645975","2646275","chr10","2789820","2790109","16","143845"
"chr2","2676095","2676389","chr10","2820698","2820993","6","144603"
"chr2","2741919","2742229","chr10","2888216","2888526","10","146297"
"chr2","2754962","2755037","chr5","1907853","1907924","22","847109"
"chr2","2775807","2776090","chr10","2917380","2917672","22","141573"
"chr2","2777218","2777501","chr10","2918793","2919077","8","141575"
"chr2","3080772","3081054","chr6","109764005","109764287","54","106683233"
"chr2","3259808","3260110","chr10","3404992","3405285","18","145184"
"chr2","3448176","3448531","chr10","3585409","3585769","18","137233"
"chr2","3501986","3502288","chr7","63411783","63412087","56","59909797"
"chr2","3522788","3523103","chr10","3659889","3660199","15","137101"
"chr2","3616744","3616785","chr9","88952092","88952131","6","85335348"
"chr2","3667995","3668297","chr8","20300239","20300534","64","16632244"
"chr2","3793991","3794178","chr1","86061439","86061630","45","82267448"
"chr2","3797208","3797362","chr7","53483520","53483679","32","49686312"
"chr2","3829444","3829539","chr1","85609056","85609152","26","81779612"
"chr2","3830152","3830216","chr11","52937047","52937110","18","49106895"
"chr2","3852504","3852812","chr10","3996080","3996389","13","143576"
"chr2","3945072","3945371","chr10","4084680","4084982","9","139608"
"chr2","4059087","4059389","chr10","4198814","4199117","8","139727"
"chr2","4184768","4184971","chr10","4326174","4326375","8","141406"
"chr2","4188829","4189135","chr10","4330235","4330541","7","141406"
"chr2","4231414","4231690","chr10","4373519","4373800","9","142105"
"chr2","4388173","4388417","chr1","21524287","21524533","66","17136114"
"chr2","4442715","4443028","chr10","4585621","4585935","5","142906"
"chr2","4535135","4535427","chr10","4676997","4677289","4","141862"
"chr2","4613334","4613623","chr10","4759434","4759722","15","146100"
"chr2","4629005","4629306","chr10","4774597","4774905","12","145592"
"chr2","4629383","4629398","chr3","45082311","45082327","3","40452928"
"chr2","4644341","4644471","chr18","55530271","55530403","22","50885930"
"chr2","4692277","4692583","chr7","49571405","49571710","57","44879128"
"chr2","4753170","4753479","chr20","22228159","22228458","62","17474989"
"chr2","4905310","4905463","chr10","5051531","5051693","18","146221"
"chr2","4962834","4963069","chr15","5787628","5787863","43","824794"
"chr2","4969727","4969924","chr10","5114079","5114267","13","144352"
"chr2","5029387","5029659","chr10","5173072","5173344","7","143685"
"chr2","5048408","5048501","chr20","29451684","29451771","22","24403276"
"chr2","5050324","5050631","chr10","5193956","5194279","36","143632"
"chr2","5057496","5057641","chr10","5201921","5202088","28","144425"
"chr2","5064735","5064900","chr6","37049871","37050037","31","31985136"
"chr2","5083224","5083527","chr1","147345415","147345724","76","142262191"
"chr2","5091845","5091944","chr10","5236397","5236500","4","144552"
"chr2","5093979","5094138","chr10","5238533","5238692","3","144554"
"chr2","5121899","5122163","chr10","5267342","5267612","12","145443"
"chr2","5144047","5144375","chr10","5290046","5290374","4","145999"
"chr2","5154609","5154891","chr10","5300577","5300858","7","145968"
"chr2","5170425","5170704","chr10","5316572","5316855","10","146147"
"chr2","5193744","5193897","chr10","5342823","5342976","2","149079"
"chr2","5210779","5211058","chr10","5359629","5359908","10","148850"
"chr2","5218480","5218762","chr10","5366763","5367045","6","148283"
"chr2","5407820","5407984","chr1","28686490","28686641","39","23278670"
"chr2","5495243","5495425","chr10","5645795","5645975","6","150552"
"chr2","5495697","5495821","chr10","5646245","5646369","1","150548"
"chr2","5526673","5526986","chr5","172501806","172502112","60","166975133"
"chr2","5572394","5572721","chr16","24432706","24433006","74","18860312"
"chr2","5590977","5591298","chr10","5738879","5739200","3","147902"
"chr2","5612750","5612963","chr10","5762074","5762273","16","149324"
"chr2","5620469","5620542","chr5","121746064","121746139","15","116125595"
"chr2","5625520","5625640","chr10","5774651","5774775","4","149131"
"chr2","5641169","5641289","chr3","148560962","148561079","15","142919793"
"chr2","5695213","5695510","chr10","5844364","5844672","14","149151"
"chr2","5706851","5707001","chr17","27005847","27006006","41","21298996"
"chr2","5707160","5707317","chr20","14811688","14811838","35","9104528"
"chr2","5742379","5742682","chr10","5892872","5893171","14","150493"
"chr2","5743676","5743974","chr10","5894154","5894457","7","150478"
"chr2","5744506","5744815","chr10","5894995","5895306","7","150489"
"chr2","5751059","5751257","chr10","5903334","5903528","12","152275"
"chr2","5808647","5808917","chr10","5961724","5961994","4","153077"
"chr2","5817994","5818249","chr10","5971045","5971296","11","153051"
"chr2","5832728","5832866","chr10","5986079","5986210","14","153351"
"chr2","5834042","5834306","chr10","5987386","5987657","10","153344"
"chr2","5838768","5839034","chr10","5992326","5992593","10","153558"
"chr2","5850572","5850774","chr3","150279005","150279189","69","144428433"
"chr2","5857564","5857863","chr10","6013804","6014082","30","156240"
"chr2","5917899","5918181","chr10","6074940","6075222","6","157041"
"chr2","5931733","5932039","chr10","6088225","6088505","45","156492"
"chr2","5946340","5946499","chr15","84969614","84969772","28","79023274"
"chr2","5952359","5952663","chr10","6108848","6109155","13","156489"
"chr2","5961312","5961611","chr10","6117777","6118078","10","156465"
"chr2","6048225","6048508","chr10","6203839","6204122","8","155614"
"chr2","6090702","6091007","chr10","6246134","6246432","19","155432"
"chr2","6226429","6226753","chr10","70877668","70878003","93","64651239"
"chr2","6253336","6253576","chr10","6407540","6407808","28","154204"
"chr2","6283146","6283448","chr10","6437317","6437618","5","154171"
"chr2","6296487","6296793","chr10","6450352","6450649","15","153865"
"chr2","6344293","6344463","chrX","37752435","37752603","28","31408142"
"chr2","6348403","6348707","chr10","6506830","6507130","17","158427"
"chr2","6362591","6362897","chr10","6520990","6521302","11","158399"
"chr2","6369403","6369659","chr10","6527827","6528117","42","158424"
"chr2","6387995","6388279","chr3","12644640","12644921","42","6256645"
"chr2","6494190","6494484","chr10","6651323","6651625","11","157133"
"chr2","6582735","6583046","chr13","41851851","41852159","59","35269116"
"chr2","6626497","6626622","chr10","6784709","6784838","8","158212"
"chr2","6626757","6626925","chr1","194327415","194327573","35","187700658"
"chr2","6668255","6668368","chr10","6827648","6827762","4","159393"
"chr2","6673669","6673842","chrX","45495721","45495896","32","38822052"
"chr2","6681372","6681676","chr10","6844744","6845044","9","163372"
"chr2","6729825","6730085","chr15","90558074","90558331","64","83828249"
"chr2","6740536","6740879","chr10","6903010","6903345","16","162474"
"chr2","6796167","6796442","chr10","6958956","6959235","14","162789"
"chr2","6812139","6812434","chr10","6975173","6975470","9","163034"
"chr2","6823818","6824046","chr3","12721755","12721980","48","5897937"
"chr2","6825534","6825821","chr10","6987874","6988161","10","162340"
"chr2","6837187","6837485","chr10","6999184","6999482","6","161997"
"chr2","6872460","6872639","chr10","7034412","7034591","6","161952"
"chr2","6872744","6872860","chr10","7034694","7034812","2","161950"
"chr2","6900628","6900898","chrX","120356258","120356539","61","113455630"
"chr2","7077438","7077768","chr10","7229747","7230066","29","152309"
"chr2","7128561","7128858","chr10","7280920","7281227","22","152359"
"chr2","7142894","7143174","chr10","7295197","7295479","21","152303"
"chr2","7155788","7156090","chr10","7307613","7307918","9","151825"
"chr2","7175217","7175554","chr10","7327089","7327398","42","151872"
"chr2","7184651","7184950","chr10","7335820","7336132","20","151169"
"chr2","7192855","7193162","chr10","7344210","7344517","14","151355"
"chr2","7194288","7194588","chr10","7345959","7346255","10","151671"
"chr2","7239531","7239635","chr7","32728549","32728652","22","25489018"
"chr2","7240727","7240741","chr11","110786140","110786150","5","103545413"
"chr2","7246946","7247252","chr10","7399597","7399902","15","152651"
"chr2","7274060","7274369","chr10","7426601","7426905","18","152541"
"chr2","7316122","7316436","chr10","7469670","7469986","10","153548"
"chr2","7320718","7321009","chr10","7474268","7474566","18","153550"
"chr2","7325934","7326228","chr8","36041346","36041638","48","28715412"
"chr2","7338390","7338667","chr10","7492665","7492947","10","154275"
"chr2","7356003","7356308","chr10","7509952","7510257","11","153949"
"chr2","7366316","7366593","chr10","16674147","16674428","60","9307831"
"chr2","7387169","7387452","chr10","7540945","7541228","12","153776"
"chr2","7388852","7389013","chr10","7542626","7542804","22","153774"
"chr2","7405369","7405677","chr10","7559753","7560061","12","154384"
"chr2","7416554","7416858","chr1","121377373","121377674","51","113960819"
"chr2","7418936","7419236","chr10","7572809","7573108","6","153873"
"chr2","7429187","7429479","chr10","7583253","7583546","5","154066"
"chr2","7441647","7441809","chr13","96680698","96680854","42","89239051"
"chr2","7446773","7446998","chr10","7600942","7601166","6","154169"
"chr2","7452765","7453120","chr2","177072817","177073158","75","169620052"
"chr2","7455760","7455877","chr10","7609919","7610036","0","154159"
"chr2","7469289","7469569","chr10","435831","436104","59","7033458"
"chr2","7473421","7473712","chr5","19479173","19479458","58","12005752"
"chr2","7495249","7495459","chr10","7654172","7654382","4","158923"
"chr2","7499044","7499340","chr10","7659228","7659524","8","160184"
"chr2","7512591","7512732","chr20","13400200","13400348","28","5887609"
"chr2","7521707","7521987","chr10","7682749","7683029","2","161042"
"chr2","7534571","7534757","chr2","46840892","46841030","71","39306321"
"chr2","7541054","7541376","chr10","7703741","7704056","20","162687"
"chr2","7546257","7546559","chr10","7709045","7709346","12","162788"
"chr2","7555437","7555758","chr20","12145142","12145455","60","4589705"
"chr2","7561166","7561467","chr10","7723801","7724102","8","162635"
"chr2","7565292","7565595","chr10","7727911","7728214","8","162619"
"chr2","7569764","7570044","chr8","10034943","10035230","49","2465179"
"chr2","7572431","7572814","chr2","9978927","9979303","103","2406496"
"chr2","7573201","7573382","chr10","7733576","7733757","1","160375"
"chr2","7573695","7573821","chr14","8515254","8515376","23","941559"
"chr2","7584262","7584418","chr10","7743563","7743726","15","159301"
"chr2","7585849","7585982","chr16","7024616","7024754","34","561233"
"chr2","7600942","7601250","chr10","7760229","7760540","7","159287"
"chr2","7609961","7610255","chr10","7769229","7769523","3","159268"
"chr2","7620251","7620317","chr1","44746983","44747047","13","37126732"
"chr2","7620320","7620471","chr2","128542628","128542781","26","120922308"
"chr2","7624996","7625293","chr7","121200714","121201002","51","113575718"
"chr2","7625771","7625818","chr15","20149189","20149229","9","12523418"
"chr2","7625873","7626038","chr10","7784943","7785108","4","159070"
"chr2","7648046","7648340","chr10","7807209","7807500","11","159163"
"chr2","7648791","7649075","chr10","7807955","7808239","5","159164"
"chr2","7665082","7665396","chrX","46852707","46853016","66","39187625"
"chr2","7685002","7685212","chr10","7844540","7844751","3","159538"
"chr2","7689153","7689459","chrX","49626487","49626796","53","41937334"
"chr2","7694871","7695153","chr10","7854334","7854616","10","159463"
"chr2","7723721","7724023","chr3","150376105","150376398","62","142652384"
"chr2","7744489","7744766","chr10","7903779","7904056","12","159290"
"chr2","7745349","7745549","chr10","7904630","7904836","12","159281"
"chr2","7764496","7764785","chr10","7924308","7924597","4","159812"
"chr2","7767674","7767894","chr10","7927502","7927721","8","159828"
"chr2","7779643","7779942","chr10","7939244","7939527","22","159601"
"chr2","7781263","7781359","chr10","7940850","7940944","3","159587"
"chr2","7815394","7815700","chr10","7973988","7974290","9","158594"
"chr2","7824115","7824416","chr10","7984025","7984327","5","159910"
"chr2","7825946","7826098","chr10","7985849","7986001","2","159903"
"chr2","7826453","7826500","chr10","7986367","7986414","0","159914"
"chr2","7852309","7852603","chr10","8013625","8013919","8","161316"
"chr2","7886651","7886961","chr10","8048039","8048348","10","161388"
"chr2","7934394","7934689","chr10","8095710","8096004","11","161316"
"chr2","7983177","7983231","chr10","8142840","8142892","3","159663"
"chr2","7996040","7996334","chr10","8155601","8155895","13","159561"
"chr2","8057231","8057518","chr10","8214675","8214965","12","157444"
"chr2","8122573","8122592","chr6","90997773","90997789","4","82875200"
"chr2","8122619","8122879","chr10","8282060","8282326","15","159441"
"chr2","8248825","8249124","chr10","8408208","8408506","11","159383"
"chr2","8321151","8321188","chr10","8479801","8479835","3","158650"
"chr2","8321223","8321380","chr10","8479859","8480016","5","158636"
"chr2","8391427","8391691","chr10","8549099","8549363","8","157672"
"chr2","8465617","8465924","chr12","38458678","38458979","63","29993061"
"chr2","8814373","8814658","chr10","8990922","8991231","33","176549"
"chr2","8932982","8933241","chr10","9105030","9105288","12","172048"
"chr2","9041224","9041511","chr10","9208624","9208910","23","167400"
"chr2","9100463","9100750","chr10","9267647","9267937","9","167184"
"chr2","9181618","9181873","chr10","9356740","9356996","6","175122"
"chr2","9373465","9373749","chr10","9549226","9549507","11","175761"
"chr2","9405842","9406099","chr10","9589427","9589684","9","183585"
"chr2","9443915","9444215","chr10","9627450","9627756","16","183535"
"chr2","9489132","9489415","chr10","9672592","9672875","7","183460"
"chr2","9502871","9503109","chr10","9686033","9686294","55","183162"
"chr2","9513912","9514205","chr10","9700278","9700571","2","186366"
"chr2","9527785","9528080","chr10","27004201","27004490","67","17476416"
"chr2","9562435","9562741","chr10","9749833","9750143","42","187398"
"chr2","9586758","9586886","chr10","9774240","9774376","10","187482"
"chr2","9597148","9597452","chr10","9784781","9785092","15","187633"
"chr2","9623485","9623791","chr10","9812652","9812948","17","189167"
"chr2","9640585","9640895","chr10","9828536","9828847","8","187951"
"chr2","9650563","9650874","chr10","9838530","9838841","6","187967"
"chr2","9771614","9771879","chr10","9956596","9956871","19","184982"
"chr2","9816419","9816691","chr10","10002556","10002824","19","186137"
"chr2","9873644","9873925","chr10","10059870","10060151","6","186226"
"chr2","9875704","9875985","chr10","10061958","10062253","22","186254"
"chr2","9918162","9918439","chr12","99670053","99670336","62","89751891"
"chr2","9942996","9943284","chr10","10128156","10128443","18","185160"
"chr2","9949448","9949740","chr10","10134698","10135000","15","185250"
"chr2","9958620","9958811","chr3","56622966","56623153","46","46664346"
"chr2","9997992","9998307","chr10","10183832","10184149","10","185840"
"chr2","10053739","10054043","chr10","10242189","10242493","6","188450"
"chr2","10081992","10082112","chr10","10271012","10271131","4","189020"
"chr2","10082411","10082589","chr10","10271438","10271589","33","189027"
"chr2","10131935","10132111","chr2","95243764","95243941","36","85111829"
"chr2","10157165","10157451","chr10","10346978","10347281","24","189813"
"chr2","10162540","10162820","chr10","10351908","10352187","12","189368"
"chr2","10171167","10171374","chr10","10360292","10360486","18","189125"
"chr2","10208639","10208959","chr10","10395887","10396206","12","187248"
"chr2","10217041","10217294","chr10","10404032","10404285","4","186991"
"chr2","10219201","10219506","chr10","10405907","10406214","19","186706"
"chr2","10225696","10225970","chr10","10414359","10414632","13","188663"
"chr2","10230388","10230687","chr1","213637248","213637554","70","203406860"
"chr2","10230728","10231007","chr10","10418379","10418658","4","187651"
"chr2","10236380","10236684","chr10","10424304","10424608","6","187924"
"chr2","10251416","10251677","chr10","10438730","10438990","7","187314"
"chr2","10252235","10252527","chr10","10439868","10440142","44","187633"
"chr2","10262018","10262184","chr11","132026911","132027082","33","121764893"
"chr2","10274428","10274720","chr10","10461256","10461548","2","186828"
"chr2","10285575","10285789","chr10","10472976","10473179","16","187401"
"chr2","10287449","10287611","chr10","10475179","10475334","7","187730"
"chr2","10308534","10308832","chr10","10496576","10496874","9","188042"
"chr2","10312642","10312920","chr10","10502730","10503028","29","190088"
"chr2","10340048","10340164","chr16","49012802","49012919","20","38672754"
"chr2","10344971","10345011","chr6","148291297","148291342","9","137946326"
"chr2","10345013","10345096","chr7","124228351","124228440","26","113883338"
"chr2","10345420","10345515","chr10","10537082","10537177","3","191662"
"chr2","10357538","10357805","chr19","14767334","14767604","61","4409796"
"chr2","10357984","10358289","chr10","10556244","10556551","14","198260"
"chr2","10361396","10361520","chr10","10559975","10560109","12","198579"
"chr2","10374966","10375096","chr3","87574600","87574729","25","77199634"
"chr2","10376206","10376346","chr11","84387535","84387667","29","74011329"
"chr2","10379022","10379186","chr9","108993260","108993425","36","98614238"
"chr2","10388333","10388638","chrX","46200808","46201119","63","35812475"
"chr2","10389545","10389604","chr10","10595898","10595957","2","206353"
"chr2","10389621","10389741","chr10","10595974","10596096","5","206353"
"chr2","10391067","10391216","chr3","36805916","36806054","34","26414849"
"chr2","10394200","10394475","chr10","10599597","10599869","9","205397"
"chr2","10407635","10407717","chr9","29729329","29729400","21","19321694"
"chr2","10408693","10408844","chr20","22283921","22284068","32","11875228"
"chr2","10417578","10417731","chr10","10620182","10620342","24","202604"
"chr2","10419899","10420184","chr10","10623694","10623979","17","203795"
"chr2","10450005","10450211","chr9","25989257","25989459","46","15539252"
"chr2","10459584","10459859","chr10","10664807","10665070","15","205223"
"chr2","10475536","10475850","chr10","10682409","10682718","13","206873"
"chr2","10480660","10480946","chr10","10687852","10688139","9","207192"
"chr2","10484111","10484398","chr10","10690969","10691256","10","206858"
"chr2","10499260","10499523","chr4","36062293","36062565","56","25563033"
"chr2","10508039","10508335","chr10","10712054","10712350","8","204015"
"chr2","10514204","10514478","chr10","10719920","10720191","46","205716"
"chr2","10517881","10518165","chr10","10723339","10723623","9","205458"
"chr2","10534658","10534949","chr10","10740348","10740629","15","205690"
"chr2","10538136","10538300","chr10","10743914","10744057","29","205778"
"chr2","10539555","10539846","chr10","10745333","10745624","6","205778"
"chr2","10551305","10551599","chr10","10756521","10756819","18","205216"
"chr2","10561366","10561484","chr10","10766596","10766714","1","205230"
"chr2","10561516","10561678","chr10","10766756","10766915","8","205240"
"chr2","10597229","10597493","chr10","10802547","10802811","6","205318"
"chr2","10613702","10614000","chr10","62124284","62124586","53","51510582"
"chr2","10614358","10614649","chr10","10821171","10821469","18","206813"
"chr2","10631694","10631989","chr10","10840008","10840306","16","208314"
"chr2","10633539","10633828","chr10","10841527","10841813","14","207988"
"chr2","10642058","10642361","chr10","10850743","10851044","4","208685"
"chr2","10647573","10647717","chr10","10856234","10856374","6","208661"
"chr2","10661735","10662031","chr10","10870425","10870724","10","208690"
"chr2","10685277","10685557","chr9","93075273","93075546","57","82389996"
"chr2","10711896","10712188","chr10","10920047","10920328","15","208151"
"chr2","10796205","10796355","chr10","73205193","73205337","36","62408988"
"chr2","10817401","10817674","chr10","11025220","11025505","18","207819"
"chr2","10830649","10830800","chr10","11038230","11038362","21","207581"
"chr2","10892059","10892350","chr10","11099616","11099905","14","207557"
"chr2","10898719","10899040","chr10","11106508","11106795","42","207789"
"chr2","10996295","10996592","chr10","11203578","11203865","19","207283"
"chr2","11060307","11060611","chr3","9039630","9039934","56","2020677"
"chr2","11126273","11126398","chr10","11331946","11332071","3","205673"
"chr2","11126667","11126826","chr10","11332343","11332505","4","205676"
"chr2","11171609","11171901","chr10","11378081","11378373","3","206472"
"chr2","11175598","11175901","chr10","11381756","11382059","10","206158"
"chr2","11233666","11233803","chr10","11438648","11438785","3","204982"
"chr2","11234097","11234293","chr10","11439079","11439275","6","204982"
"chr2","11273622","11273878","chr10","11478631","11478889","6","205009"
"chr2","11278674","11278967","chr10","11483698","11483991","7","205024"
"chr2","11299466","11299759","chr10","11504635","11504929","6","205169"
"chr2","11314981","11315105","chrX","41760475","41760598","16","30445494"
"chr2","11315134","11315291","chr1","135158414","135158570","37","123843280"
"chr2","11322537","11322866","chr10","12090238","12090558","67","767701"
"chr2","11386544","11386811","chr10","11590740","11591007","33","204196"
"chr2","11398727","11399022","chr10","11602996","11603282","36","204269"
"chr2","11492035","11492314","chrX","46288847","46289129","53","34796812"
"chr2","11505546","11505852","chr10","11711374","11711674","21","205828"
"chr2","11507567","11507870","chr10","11713399","11713701","4","205832"
"chr2","11575065","11575351","chr10","11779516","11779812","11","204451"
"chr2","11641351","11641658","chr10","11848787","11849098","11","207436"
"chr2","11653363","11653664","chr10","11868350","11868651","11","214987"
"chr2","11679247","11679425","chr11","122274374","122274548","46","110595127"
"chr2","11681208","11681502","chr10","11894916","11895224","42","213708"
"chr2","11689758","11690043","chr2","47863409","47863701","56","36173651"
"chr2","11721267","11721305","chr11","6600613","6600651","8","5120654"
"chr2","11721327","11721613","chr2","83466811","83467096","66","71745484"
"chr2","11738108","11738415","chr10","11951736","11952048","18","213628"
"chr2","11758617","11758915","chr10","11972301","11972605","13","213684"
"chr2","11770487","11770681","chr10","11983909","11984117","22","213422"
"chr2","11775287","11775413","chr10","11988503","11988629","4","213216"
"chr2","11780471","11780768","chr10","11993724","11994026","15","213253"
"chr2","11796808","11796935","chr9","39250120","39250247","34","27453312"
"chr2","11796966","11797032","chr4","15059931","15059997","12","3262965"
"chr2","11837498","11837774","chr7","17235007","17235268","54","5397509"
"chr2","11839937","11840208","chr3","153706714","153706983","56","141866777"
"chr2","11858744","11859033","chr10","12069643","12069932","4","210899"
"chr2","11860556","11860863","chr10","12071453","12071751","25","210897"
"chr2","11865598","11865913","chr10","12076894","12077193","28","211296"
"chr2","11867984","11868303","chr3","51622492","51622797","60","39754508"
"chr2","11870123","11870430","chr10","12081143","12081448","9","211020"
"chr2","11874843","11875135","chr10","12085984","12086282","16","211141"
"chr2","11879155","11879465","chr10","12090238","12090558","30","211083"
"chr2","11883405","11883698","chr10","12094902","12095195","4","211497"
"chr2","11890058","11890364","chr10","12101473","12101782","9","211415"
"chr2","11895833","11896122","chr10","12114305","12114594","14","218472"
"chr2","11914566","11914685","chr10","12126702","12126827","8","212136"
"chr2","11916261","11916339","chr10","12128714","12128792","0","212453"
"chr2","11930853","11931152","chr16","22294372","22294673","51","10363519"
"chr2","11936055","11936345","chr10","12144021","12144322","16","207966"
"chr2","11944264","11944568","chr10","12151268","12151577","17","207004"
"chr2","11945516","11945812","chr10","12152525","12152821","8","207009"
"chr2","11952208","11952490","chr10","12159941","12160227","12","207733"
"chr2","11953933","11954196","chr10","12161660","12161923","3","207727"
"chr2","11954756","11955068","chr10","12162485","12162798","6","207729"
"chr2","11958070","11958356","chr10","12165027","12165313","5","206957"
"chr2","11963014","11963312","chr10","12173486","12173784","8","210472"
"chr2","11970252","11970531","chr10","12180280","12180561","4","210028"
"chr2","11979451","11979755","chr10","12189247","12189557","12","209796"
"chr2","12002876","12003164","chr6","109582888","109583178","53","97580012"
"chr2","12004341","12004579","chr2","55097561","55097800","47","43093220"
"chr2","12004933","12005005","chr10","84244444","84244518","12","72239511"
"chr2","12007862","12008015","chr16","45439753","45439906","25","33431891"
"chr2","12010705","12010975","chr10","12223102","12223383","26","212397"
"chr2","12014113","12014266","chr10","12227119","12227268","6","213006"
"chr2","12017549","12017729","chr10","12230289","12230468","7","212740"
"chr2","12025306","12025596","chr10","12236711","12237012","17","211405"
"chr2","12048636","12048821","chr10","12263463","12263647","5","214827"
"chr2","12051076","12051216","chr10","12265925","12266065","6","214849"
"chr2","12051522","12051695","chr10","12266371","12266546","8","214849"
"chr2","12064813","12065071","chr10","12280561","12280838","26","215748"
"chr2","12065387","12065686","chr10","50389396","50389695","59","38324009"
"chr2","12069288","12069584","chr10","12289119","12289401","21","219831"
"chr2","12073154","12073280","chr10","12286075","12286221","21","212921"
"chr2","12075011","12075282","chr10","40422569","40422837","52","28347558"
"chr2","12080390","12080550","chr9","106181530","106181693","28","94101140"
"chr2","12101637","12101930","chr10","12320548","12320841","3","218911"
"chr2","12117996","12118309","chr10","12189247","12189557","47","71251"
"chr2","12140122","12140404","chr10","12360657","12360931","13","220535"
"chr2","12145050","12145345","chr14","9608187","9608480","84","2536863"
"chr2","12149225","12149531","chr10","12369598","12369918","25","220373"
"chr2","12152887","12153181","chr1","138961578","138961868","55","126808691"
"chr2","12191349","12191608","chr10","12413907","12414170","16","222558"
"chr2","12202012","12202097","chr10","12423984","12424069","1","221972"
"chr2","12208255","12208520","JH683180","3739","4004","7","12204516"
"chr2","12208523","12208774","chr10","79671695","79671946","62","67463172"
"chr2","12209970","12210244","JH683180","5437","5712","6","12204533"
"chr2","12214133","12214438","JH683180","9635","9935","13","12204498"
"chr2","12220844","12221163","chr4","152226280","152226592","68","140005436"
"chr2","12224007","12224300","chr10","12430186","12430478","10","206179"
"chr2","12237442","12237732","chr10","12444166","12444471","26","206724"
"chr2","12243282","12243572","chr10","12450063","12450367","18","206781"
"chr2","12250029","12250315","chr10","12457642","12457925","18","207613"
"chr2","12254072","12254236","chr10","12461698","12461857","6","207626"
"chr2","12256106","12256239","chr10","12463729","12463862","4","207623"
"chr2","12262501","12262616","chr10","12468703","12468820","9","206202"
"chr2","12262904","12263098","chr10","12469087","12469292","25","206183"
"chr2","12279171","12279493","chr6","113187049","113187371","65","100907878"
"chr2","12285593","12285874","chr19","37393644","37393929","50","25108051"
"chr2","12293436","12293651","chr10","12503237","12503448","8","209801"
"chr2","12293914","12294040","chr10","12503715","12503847","11","209801"
"chr2","12311688","12311985","chr2","94953803","94954104","59","82642115"
"chr2","12333670","12333962","chr1","125070092","125070386","56","112736422"
"chr2","12336051","12336198","chr10","12544650","12544795","5","208599"
"chr2","12336482","12336625","chr10","12545079","12545221","2","208597"
"chr2","12341874","12342112","chr10","12550587","12550823","13","208713"
"chr2","12345342","12345641","chr10","27004201","27004490","76","14658859"
"chr2","12370891","12371023","chr10","12578613","12578745","6","207722"
"chr2","12371185","12371349","chr10","12578906","12579071","8","207721"
"chr2","12372095","12372404","chr10","12579891","12580174","32","207796"
"chr2","12375804","12376107","chr10","12583574","12583875","18","207770"
"chr2","12381405","12381717","chr10","12589130","12589442","9","207725"
"chr2","12419624","12419925","chr10","12625772","12626073","6","206148"
"chr2","12446137","12446442","chr13","41851851","41852159","64","29405714"
"chr2","12454291","12454304","chr6","50494769","50494782","1","38040478"
"chr2","12454349","12454497","chr2","97434782","97434928","26","84980433"
"chr2","12477205","12477457","chr10","12684136","12684430","48","206931"
"chr2","12492945","12493250","chr10","12699938","12700242","11","206993"
"chr2","12503327","12503613","chr10","12710160","12710452","13","206833"
"chr2","12512848","12513139","chr10","12720989","12721290","19","208141"
"chr2","12615330","12615648","chr10","12824796","12825117","15","209466"
"chr2","12645847","12646156","chr10","12854248","12854529","35","208401"
"chr2","12689922","12690219","chr10","12897546","12897847","10","207624"
"chr2","12760304","12760579","chr10","12968245","12968520","3","207941"
"chr2","12776963","12777215","chr10","12984616","12984868","4","207653"
"chr2","12794169","12794503","chr10","13001821","13002157","15","207652"
"chr2","12803425","12803721","chr10","13010819","13011135","41","207394"
"chr2","12824699","12824815","chr13","60731646","60731762","14","47906947"
"chr2","12854456","12854660","chr10","13061292","13061496","7","206836"
"chr2","12856192","12856345","chr10","13063054","13063208","6","206862"
"chr2","12856346","12856522","chr10","78633782","78633960","26","65777436"
"chr2","12856849","12856983","chr10","13063533","13063667","0","206684"
"chr2","12904464","12904749","chr5","53361343","53361626","50","40456879"
"chr2","12905904","12906189","chr10","13108485","13108770","8","202581"
"chr2","12906220","12906395","chr10","13108801","13108992","24","202581"
"chr2","12910532","12910828","chr10","13113104","13113402","9","202572"
"chr2","12914477","12914780","chr7","37314940","37315240","50","24400463"
"chr2","12963619","12963939","chr10","13166562","13166889","13","202943"
"chr2","12976357","12976651","chr10","13179580","13179896","36","203223"
"chr2","12980493","12980618","chr1","128286221","128286345","20","115305728"
"chr2","12982726","12982946","chr10","13184116","13184336","4","201390"
"chr2","12984353","12984657","chr10","13185745","13186061","22","201392"
"chr2","12999193","12999490","chr10","13202517","13202808","11","203324"
"chr2","13000915","13001212","chr10","13204209","13204502","17","203294"
"chr2","13026434","13026577","chr10","13229449","13229595","6","203015"
"chr2","13030866","13031015","chr10","13233921","13234070","2","203055"
"chr2","13058651","13058946","chr10","13261612","13261898","19","202961"
"chr2","13061701","13061984","chr10","13264994","13265277","2","203293"
"chr2","13073471","13073739","chr10","13276725","13276991","5","203254"
"chr2","13087040","13087172","chr10","13290273","13290407","6","203233"
"chr2","13088022","13088318","chr10","13291245","13291541","10","203223"
"chr2","13091435","13091714","chr10","13294432","13294711","6","202997"
"chr2","13100648","13100920","chr10","13303893","13304169","6","203245"
"chr2","13108053","13108162","chr10","13311778","13311883","13","203725"
"chr2","13121380","13121674","chr10","13325949","13326243","2","204569"
"chr2","13122987","13123085","chr10","13327555","13327653","0","204568"
"chr2","13125241","13125535","chr10","13329793","13330088","16","204552"
"chr2","13128861","13129099","chr6","58198059","58198294","50","45069198"
"chr2","13137811","13138103","chr10","13341825","13342117","4","204014"
"chr2","13158406","13158588","chr7","111321162","111321340","32","98162756"
"chr2","13161381","13161535","chr11","30557931","30558081","34","17396550"
"chr2","13163579","13163859","chr10","13358073","13358364","15","194494"
"chr2","13173447","13173739","chr2","69611206","69611505","54","56437759"
"chr2","13176615","13176737","chr1","46567899","46568019","22","33391284"
"chr2","13178081","13178243","chr10","13376113","13376274","2","198032"
"chr2","13182370","13182679","chr10","13380386","13380699","12","198016"
"chr2","13185013","13185273","chr10","13383020","13383273","17","198007"
"chr2","13186559","13186830","chr10","13384534","13384805","6","197975"
"chr2","13187289","13187562","chr10","13385272","13385545","5","197983"
"chr2","13190306","13190599","chr10","13389158","13389451","3","198852"
"chr2","13200873","13201150","chr10","13402076","13402353","4","201203"
"chr2","13206862","13206987","chr10","13404344","13404469","4","197482"
"chr2","13207290","13207449","chr10","13404771","13404929","3","197481"
"chr2","13218287","13218588","chr10","13416791","13417060","36","198504"
"chr2","13234284","13234568","chr10","13432690","13432994","28","198406"
"chr2","13242937","13243170","chr10","13441328","13441539","31","198391"
"chr2","13245917","13246196","chr10","13444267","13444548","37","198350"
"chr2","13248440","13248749","chr10","13447335","13447642","12","198895"
"chr2","13250938","13251239","chr6","143180168","143180469","59","129929230"
"chr2","13253172","13253440","chrX","18856473","18856748","68","5603301"
"chr2","13255363","13255656","chr10","13453613","13453906","8","198250"
"chr2","13255836","13256122","chr10","13454066","13454352","6","198230"
"chr2","13258294","13258563","chr14","28361285","28361548","47","15102991"
"chr2","13259162","13259317","chr10","13457748","13457908","6","198586"
"chr2","13260332","13260480","chr10","13458936","13459084","3","198604"
"chr2","13262002","13262287","chr10","13460467","13460766","24","198465"
"chr2","13264780","13265078","chr10","13463267","13463565","12","198487"
"chr2","13275347","13275499","chr10","13473510","13473662","4","198163"
"chr2","13275799","13275944","chr10","13473959","13474105","2","198160"
"chr2","13276316","13276433","chr3","55268266","55268384","14","41991950"
"chr2","13277324","13277646","chr10","13475474","13475806","22","198150"
"chr2","13279477","13279553","chr10","13477994","13478070","3","198517"
"chr2","13279646","13279757","chr10","13478164","13478262","32","198518"
"chr2","13280062","13280199","chr10","13478569","13478704","7","198507"
"chr2","13291307","13291611","chr10","13490162","13490465","10","198855"
"chr2","13292584","13292778","chr10","13491435","13491629","3","198851"
"chr2","13293087","13293206","chr10","13491948","13492067","2","198861"
"chr2","13307100","13307316","chr10","13506062","13506276","12","198962"
"chr2","13318050","13318378","chr8","50720438","50720758","74","37402388"
"chr2","13322399","13322710","chr10","13521305","13521616","17","198906"
"chr2","13326332","13326624","chr10","13525912","13526204","7","199580"
"chr2","13327943","13328299","chr10","13527505","13527851","29","199562"
"chr2","13335035","13335346","chr10","13537009","13537322","13","201974"
"chr2","13336439","13336744","chr10","13538404","13538707","10","201965"
"chr2","13344785","13345084","chr10","13546882","13547181","3","202097"
"chr2","13354697","13354947","chr10","13557223","13557473","5","202526"
"chr2","13364454","13364760","chr10","13565660","13565966","6","201206"
"chr2","13369436","13369759","chr16","16052511","16052822","71","2683075"
"chr2","13412299","13412426","chr2","3073849","3073977","29","10338450"
"chr2","13424970","13425070","chr10","13626357","13626456","4","201387"
"chr2","13425783","13426075","chr10","13627169","13627460","4","201386"
"chr2","13461601","13461770","chr10","13662843","13663010","5","201242"
"chr2","13462083","13462094","chr5","58058740","58058751","0","44596657"
"chr2","13478230","13478277","chr10","13680304","13680355","4","202074"
"chr2","13498208","13498503","chr10","13698722","13699014","12","200514"
"chr2","13507376","13507680","chrX","42115609","42115917","58","28608233"
"chr2","13508733","13508984","chr10","13709653","13709905","10","200920"
"chr2","13518048","13518362","chr10","13718829","13719144","10","200781"
"chr2","13526239","13526535","chr10","13726977","13727273","10","200738"
"chr2","13595258","13595568","chr10","13798418","13798717","20","203160"
"chr2","13631984","13632298","chr10","13834104","13834410","26","202120"
"chr2","13642634","13642930","chr10","13844876","13845167","12","202242"
"chr2","13652579","13652873","chr10","13854845","13855138","10","202266"
"chr2","13708930","13709222","chr10","13911137","13911432","16","202207"
"chr2","13719791","13720074","chr10","13921703","13922002","54","201912"
"chr2","13734775","13735094","chr10","13935044","13935363","8","200269"
"chr2","13741411","13741723","chr10","13941290","13941594","10","199879"
"chr2","13758994","13759158","chr10","13959257","13959420","6","200263"
"chr2","13761145","13761342","chr3","42500040","42500230","49","28738895"
"chr2","13770722","13771034","chr10","13970994","13971300","14","200272"
"chr2","13787211","13787425","chr6","126459791","126459998","57","112672580"
"chr2","13794537","13794684","chr10","13995972","13996119","2","201435"
"chr2","13794685","13794997","chr10","13996120","13996428","8","201435"
"chr2","13796473","13796647","chr10","13997905","13998079","7","201432"
"chr2","13802590","13802746","chr10","14005143","14005298","5","202553"
"chr2","13831550","13831839","chr10","14034187","14034476","5","202637"
"chr2","13847907","13848204","chr10","14050580","14050877","5","202673"
"chr2","13870301","13870481","chr10","14073549","14073720","13","203248"
"chr2","13870482","13870789","chr10","14073756","14074039","34","203274"
"chr2","13894651","13894953","chr10","14098635","14098937","4","203984"
"chr2","13897219","13897523","chr7","42951017","42951323","64","29053798"
"chr2","13900868","13901181","chr10","14105413","14105722","15","204545"
"chr2","13915584","13915800","chr10","14117161","14117353","28","201577"
"chr2","13919788","13920103","chr10","14121645","14121963","7","201857"
"chr2","13930044","13930212","chr9","18505614","18505754","49","4575570"
"chr2","13937112","13937408","chr4","70894857","70895154","54","56957745"
"chr2","13947689","13947891","chr15","173065","173269","38","13774624"
"chr2","13957526","13957838","chr10","14158885","14159196","14","201359"
"chr2","13962640","13962902","chr10","14164006","14164278","16","201366"
"chr2","13966988","13967161","chr10","14168613","14168786","2","201625"
"chr2","13967730","13967865","chr10","14169395","14169530","7","201665"
"chr2","13973203","13973508","chr10","14174999","14175305","7","201796"
"chr2","13977645","13977972","chr10","14179346","14179666","15","201701"
"chr2","13980011","13980072","chr10","14181700","14181761","1","201689"
"chr2","13982501","13982806","chr10","14184184","14184493","13","201683"
"chr2","13998216","13998496","chr14","14864487","14864770","62","866271"
"chr2","13999147","13999287","chr2","172227852","172227991","26","158228705"
"chr2","13999323","13999629","chr10","14200709","14201016","7","201386"
"chr2","14001570","14001713","chr10","14203589","14203732","2","202019"
"chr2","14003327","14003614","chr10","14205463","14205738","15","202136"
"chr2","14003780","14004097","chr10","14205916","14206231","9","202136"
"chr2","14011230","14011532","chr10","14213042","14213348","13","201812"
"chr2","14013467","14013643","chr7","36696527","36696709","43","22683060"
"chr2","14041926","14042228","chr10","14229003","14229310","11","187077"
"chr2","14048734","14049003","chr11","121352926","121353191","68","107304192"
"chr2","14054548","14054771","chr14","63078607","63078826","47","49024059"
"chr2","14054772","14055060","chr10","14248131","14248407","17","193359"
"chr2","14068697","14068988","chr10","14258811","14259102","1","190114"
"chr2","14074513","14074719","chr13","118913344","118913512","75","104838831"
"chr2","14081249","14081380","chr10","14272014","14272145","4","190765"
"chr2","14087523","14087776","chr10","14278616","14278863","24","191093"
"chr2","14091039","14091336","chr10","14282000","14282300","15","190961"
"chr2","14103878","14104101","chrX","122752694","122752910","48","108648816"
"chr2","14118645","14118958","chr10","14309351","14309664","5","190706"
"chr2","14128078","14128340","chr10","14319164","14319434","9","191086"
"chr2","14133548","14133841","chr10","14324630","14324923","5","191082"
"chr2","14147686","14147828","chr10","14338748","14338890","5","191062"
"chr2","14148384","14148529","chr2","172227852","172227991","22","158079468"
"chr2","14149335","14149466","chr11","64166825","64166954","17","50017490"
"chr2","14152925","14153068","chr10","14343983","14344126","2","191058"
"chr2","14153424","14153608","chr10","14344482","14344671","12","191058"
"chr2","14164328","14164619","chr10","14358246","14358537","11","193918"
"chr2","14181720","14182059","chr10","14376728","14377071","14","195008"
"chr2","14183416","14183707","chr10","14378383","14378672","12","194967"
"chr2","14185394","14185621","chr10","14380350","14380581","8","194956"
"chr2","14196069","14196129","chr12","77810918","77810980","9","63614849"
"chr2","14196133","14196309","chr1","41192813","41192993","38","26996680"
"chr2","14206394","14206538","chr10","14406009","14406153","4","199615"
"chr2","14206842","14207019","chr10","14406468","14406635","15","199626"
"chr2","14209751","14210048","chr16","56905701","56906006","50","42695950"
"chr2","14216833","14217128","chr10","14416662","14416967","26","199829"
"chr2","14234053","14234160","chr10","14434496","14434603","2","200443"
"chr2","14238080","14238259","chr10","14438534","14438722","11","200454"
"chr2","14243606","14243883","chr10","14444408","14444685","6","200802"
"chr2","14250688","14250985","chr1","120040550","120040851","57","105789862"
"chr2","14256655","14256914","chr10","14454672","14454931","5","198017"
"chr2","14264934","14265096","chr10","14462717","14462877","4","197783"
"chr2","14276874","14277161","chr10","14475420","14475703","29","198546"
"chr2","14282390","14282493","chr10","14481263","14481366","1","198873"
"chr2","14285115","14285379","chr10","14484606","14484870","2","199491"
"chr2","14291074","14291151","chr10","14490852","14490934","6","199778"
"chr2","14294188","14294485","chr10","14494407","14494708","10","200219"
"chr2","14317551","14317847","chr10","14520294","14520592","11","202743"
"chr2","14318998","14319170","chr11","38369515","38369683","28","24050517"
"chr2","14331558","14331893","chr10","14534272","14534605","5","202714"
"chr2","14337014","14337256","chr10","14539762","14539999","9","202748"
"chr2","14348500","14348807","chr10","14552042","14552345","13","203542"
"chr2","14352201","14352505","chr10","14555743","14556046","8","203542"
"chr2","14356542","14356836","chr10","14560111","14560411","10","203569"
"chr2","14357531","14357795","chr12","93978163","93978427","57","79620632"
"chr2","14358440","14358734","chr10","14562108","14562401","5","203668"
"chr2","14360022","14360158","chr10","14563682","14563817","3","203660"
"chr2","14360474","14360635","chr10","14564133","14564294","6","203659"
"chr2","14373721","14374028","chr10","14578705","14579007","11","204984"
"chr2","14374799","14374948","chr10","14579784","14579941","10","204985"
"chr2","14375778","14376096","chr10","14580779","14581081","30","205001"
"chr2","14376760","14377060","chr10","14581745","14582049","19","204985"
"chr2","14384424","14384729","chr10","14589704","14590013","8","205280"
"chr2","14389798","14389814","chr6","72760333","72760347","4","58370535"
"chr2","14389845","14389962","chr10","14595402","14595518","5","205557"
"chr2","14398896","14399139","chr10","14604793","14605026","17","205897"
"chr2","14430753","14431060","chr10","14635973","14636277","7","205220"
"chr2","14431631","14431851","chr10","14636862","14637077","8","205231"
"chr2","14457583","14457772","chr7","133478930","133479119","35","119021347"
"chr2","14475536","14475709","chr5","105137254","105137434","37","90661718"
"chr2","14490848","14491175","chr10","14697846","14698169","13","206998"
"chr2","14497439","14497740","chr10","14704771","14705071","7","207332"
"chr2","14497913","14498211","chr10","14705228","14705526","5","207315"
"chr2","14536886","14537188","chr10","14743584","14743890","8","206698"
"chr2","14565855","14565971","chr10","14772826","14772942","8","206971"
"chr2","14588816","14588948","chr10","2130477","2130608","25","12458339"
"chr2","14589523","14589695","chr6","58082549","58082722","36","43493026"
"chr2","14594080","14594392","chr10","14800833","14801146","10","206753"
"chr2","14598845","14599140","chr5","89976441","89976731","69","75377596"
"chr2","14608373","14608423","chr1","12171232","12171281","9","2437141"
"chr2","14608424","14608526","chr5","135158660","135158762","15","120550236"
"chr2","14615838","14615976","chr10","20553832","20553965","24","5937994"
"chr2","14632511","14632641","chr10","14839231","14839358","6","206720"
"chr2","14638754","14639053","chr10","14845377","14845680","7","206623"
"chr2","14650053","14650356","chr10","14857301","14857598","12","207248"
"chr2","14653524","14653818","chr10","14861079","14861365","12","207555"
"chr2","14655587","14655872","chr10","14863118","14863403","8","207531"
"chr2","14665051","14665351","chr10","14873435","14873731","11","208384"
"chr2","14674826","14675135","chr4","152226280","152226592","48","137551454"
"chr2","14676869","14677169","chr10","14885431","14885726","12","208562"
"chr2","14688218","14688511","chr10","14896883","14897176","10","208665"
"chr2","14710937","14711250","chr10","14919588","14919902","5","208651"
"chr2","14712339","14712636","chr10","14920969","14921274","11","208630"
"chr2","14723959","14724084","chr7","110909587","110909712","28","96185628"
"chr2","14740335","14740632","chr10","14949886","14950183","6","209551"
"chr2","14744631","14744836","chr1","30228392","30228598","36","15483761"
"chr2","14744913","14744976","chr10","16885873","16885925","17","2140960"
"chr2","14767202","14767474","chr10","14978206","14978489","20","211004"
"chr2","14768274","14768398","chr10","14979323","14979445","4","211049"
"chr2","14776679","14776853","chr10","14984028","14984207","12","207349"
"chr2","14777732","14777859","chr1","127802671","127802794","25","113024939"
"chr2","14780765","14781022","chr10","14993573","14993830","7","212808"
"chr2","14781750","14782054","chr10","14994233","14994547","13","212483"
"chr2","14788705","14788728","chr13","36025545","36025568","3","21236840"
"chr2","14788756","14788832","chr4","86041743","86041821","20","71252987"
"chr2","14790768","14790909","chr7","66814609","66814747","33","52023841"
"chr2","14792228","14792519","chr10","15006889","15007175","22","214661"
"chr2","14800496","14800720","chr10","15014567","15014758","35","214071"
"chr2","14802668","14802995","chr1","117864292","117864587","82","103061624"
"chr2","14814984","14815267","chr2","27695871","27696154","60","12880887"
"chr2","14830567","14830750","chr10","15047228","15047395","21","216661"
"chr2","14830769","14831071","chr10","15047752","15048063","19","216983"
"chr2","14833731","14834021","chr10","15051048","15051339","10","217317"
"chr2","14847368","14847673","chr10","15064422","15064727","8","217054"
"chr2","14847810","14848109","chr10","15064869","15065168","6","217059"
"chr2","14850454","14850763","chr10","15067506","15067815","7","217052"
"chr2","14850977","14851272","chr10","15068335","15068629","7","217358"
"chr2","14855818","14856101","chr11","39405312","39405599","72","24549494"
"chr2","14865950","14866132","chr1","66887413","66887590","41","52021463"
"chr2","14866416","14866552","chr6","132308916","132309054","19","117442500"
"chr2","14872936","14873222","chr10","15093626","15093912","4","220690"
"chr2","14884994","14885287","chr10","15106052","15106346","13","221058"
"chr2","14896304","14896583","chr10","15118449","15118731","6","222145"
"chr2","14896605","14896891","chr10","15118741","15119043","21","222136"
"chr2","14913198","14913461","chr10","15135132","15135395","5","221934"
"chr2","14921722","14922005","chr10","15143704","15143986","3","221982"
"chr2","14926818","14926956","chr10","15149133","15149270","3","222315"
"chr2","14927254","14927446","chr10","15149568","15149763","5","222314"
"chr2","14929173","14929468","chr10","15151472","15151768","8","222299"
"chr2","14934229","14934541","chr10","15156367","15156679","8","222138"
"chr2","14934704","14934960","chr10","15156841","15157097","4","222137"
"chr2","14935261","14935468","chr10","15157395","15157593","10","222134"
"chr2","14945660","14945759","chr15","36041109","36041208","23","21095449"
"chr2","14946807","14947109","chr10","15168761","15169058","8","221954"
"chr2","14951128","14951431","chr10","15173082","15173378","15","221954"
"chr2","14952080","14952372","chr10","15174023","15174311","7","221943"
"chr2","14956603","14956885","chr10","15178568","15178853","10","221965"
"chr2","14959116","14959431","chr10","15182019","15182310","24","222903"
"chr2","14996174","14996468","chr10","15220100","15220394","6","223926"
"chr2","15013973","15014132","chr10","15237884","15238052","16","223911"
"chr2","15022776","15023052","chr10","15246994","15247270","4","224218"
"chr2","15028657","15028956","chr10","15253302","15253619","21","224645"
"chr2","15035298","15035591","chr10","15260475","15260753","20","225177"
"chr2","15036199","15036499","chr12","98040741","98041039","70","83004542"
"chr2","15037315","15037560","chr10","15262492","15262739","9","225177"
"chr2","15053250","15053478","chr10","15279168","15279397","13","225918"
"chr2","15054111","15054385","chr10","15280041","15280315","3","225930"
"chr2","15060329","15060633","chr10","15286243","15286533","21","225914"
"chr2","15065012","15065129","chr1","25027457","25027573","20","9962445"
"chr2","15067072","15067249","chr8","27352041","27352214","30","12284969"
"chr2","15071250","15071490","chr6","131929768","131930021","54","116858518"
"chr2","15082716","15082807","chr4","125390544","125390634","19","110307828"
"chr2","15107342","15107481","chr10","15324813","15324952","5","217471"
"chr2","15108555","15108856","chr10","15331006","15331315","16","222451"
"chr2","15118413","15118720","chr10","15328758","15329065","8","210345"
"chr2","15122410","15122660","chr15","5787628","5787863","48","9334782"
"chr2","15136176","15136461","chr10","15355121","15355406","7","218945"
"chr2","15137708","15137779","chr10","15356653","15356724","3","218945"
"chr2","15139992","15140295","chr10","15358939","15359242","10","218947"
"chr2","15237777","15237951","chr2","78119868","78120033","32","62882091"
"chr2","15286946","15287227","chr10","15507946","15508228","3","221000"
"chr2","15300340","15300506","chr10","15521544","15521707","12","221204"
"chr2","15330133","15330455","chr10","15551146","15551448","28","221013"
"chr2","15336431","15336446","chr20","66354928","66354943","2","51018497"
"chr2","15336488","15336822","chr10","15557514","15557854","22","221026"
"chr2","15355354","15355553","chr5","142436236","142436432","42","127080882"
"chr2","15388623","15388915","chr7","25185886","25186189","57","9797263"
"chr2","15447123","15447415","chr10","15669328","15669620","8","222205"
"chr2","15594432","15594712","chr10","15845454","15845736","7","251022"
"chr2","15649049","15649338","chr10","15899231","15899520","4","250182"
"chr2","15675334","15675594","chr10","15925433","15925691","6","250099"
"chr2","15677143","15677432","chr10","15927249","15927554","25","250106"
"chr2","15695842","15696125","chr10","15946020","15946303","9","250178"
"chr2","15723454","15723676","chr10","15972715","15972915","23","249261"
"chr2","15737092","15737268","chr10","15986404","15986580","9","249312"
"chr2","15737309","15737424","chr10","15986613","15986728","4","249304"
"chr2","15797535","15797828","chr10","16047846","16048137","15","250311"
"chr2","15846905","15847218","chr10","16098415","16098728","9","251510"
"chr2","15858357","15858609","chr10","16110172","16110424","11","251815"
"chr2","15867397","15867694","chr10","16117158","16117472","27","249761"
"chr2","15908235","15908525","chr10","16158151","16158441","5","249916"
"chr2","16002476","16002767","chr10","16251060","16251337","19","248584"
"chr2","16076021","16076304","chr10","16339790","16340073","5","263769"
"chr2","16102427","16102697","chr10","16380545","16380813","12","278118"
"chr2","16128557","16128568","chr3","94256245","94256256","1","78127688"
"chr2","16128630","16128920","chr10","16406916","16407248","49","278286"
"chr2","16139191","16139480","chr10","16417899","16418188","8","278708"
"chr2","16173880","16174210","chr10","16452126","16452468","21","278246"
"chr2","16182571","16182862","chr10","16460214","16460505","5","277643"
"chr2","16202829","16203124","chr20","27237939","27238231","58","11035110"
"chr2","16210188","16210500","chr10","16487838","16488146","15","277650"
"chr2","16212433","16212719","chr10","16489959","16490288","50","277526"
"chr2","16222923","16223215","chr10","16501000","16501292","12","278077"
"chr2","16225179","16225478","chr11","84342642","84342940","50","68117463"
"chr2","16235482","16235637","chr10","16513501","16513652","14","278019"
"chr2","16278197","16278449","chr18","16208325","16208588","48","69872"
"chr2","16303482","16303760","chr10","16583607","16583898","19","280125"
"chr2","16310989","16311270","chr10","16591279","16591560","14","280290"
"chr2","16312600","16312874","chr10","16592885","16593159","1","280285"
"chr2","16322187","16322463","chr10","16602479","16602755","7","280292"
"chr2","16326174","16326481","chr9","110607036","110607336","61","94280862"
"chr2","16332329","16332549","chr10","16622722","16622942","4","290393"
"chr2","16333045","16333175","chr10","16623439","16623569","5","290394"
"chr2","16339097","16339403","chr10","16629468","16629773","3","290371"
"chr2","16340457","16340594","chr1","93308587","93308724","22","76968130"
"chr2","16342001","16342304","chr10","16632335","16632639","8","290334"
"chr2","16344081","16344162","chr14","64339385","64339467","15","47995304"
"chr2","16351520","16351837","chr10","16643495","16643814","9","291975"
"chr2","16353120","16353390","chr10","16645087","16645357","5","291967"
"chr2","16354204","16354445","chr10","16646163","16646403","6","291959"
"chr2","16356005","16356290","chrX","46288847","46289129","50","29932842"
"chr2","16360244","16360512","chr10","16652310","16652578","8","292066"
"chr2","16360821","16360875","chr10","16652879","16652933","0","292058"
"chr2","16363160","16363440","chr10","16655218","16655509","14","292058"
"chr2","16374634","16374921","chr10","16666972","16667248","16","292338"
"chr2","16377831","16378136","chr10","16670162","16670470","6","292331"
"chr2","16379181","16379316","chr10","16671320","16671454","3","292139"
"chr2","16382021","16382302","chr10","16674147","16674428","8","292126"
"chr2","16383495","16383647","chr10","16675619","16675771","1","292124"
"chr2","16384981","16385363","chr10","16677101","16677396","90","292120"
"chr2","16390851","16391005","chr1","67267341","67267514","58","50876490"
"chr2","16392037","16392165","chr1","25467746","25467863","29","9075709"
"chr2","16413753","16413963","chr2","62437600","62437816","44","46023847"
"chr2","16414326","16414620","chr1","110242381","110242668","72","93828055"
"chr2","16415865","16416143","chr10","16708533","16708811","8","292668"
"chr2","16425532","16425803","chr10","16718446","16718717","7","292914"
"chr2","16425831","16425847","chr10","16718740","16718756","1","292909"
"chr2","16428436","16428560","chr10","16721351","16721479","4","292915"
"chr2","16428714","16428956","chr10","16721633","16721876","14","292919"
"chr2","16438448","16438589","chr10","16734607","16734748","6","296159"
"chr2","16438872","16439027","chr10","16735033","16735194","11","296161"
"chr2","16441492","16441671","chr10","16737665","16737844","4","296173"
"chr2","16449946","16450082","chr12","93618464","93618599","20","77168518"
"chr2","16450383","16450545","chr3","149612299","149612461","40","133161916"
"chr2","16458936","16459009","chr10","16810599","16810672","0","351663"
"chr2","16459300","16459537","chr10","16810955","16811200","15","351655"
"chr2","16461048","16461369","chr10","16812699","16813020","6","351651"
"chr2","16469298","16469450","chr10","16813917","16814081","18","344619"
"chr2","16469854","16470131","chr10","16814471","16814746","11","344617"
"chr2","16486159","16486461","chr10","16835732","16836031","13","349573"
"chr2","16490914","16491231","chr9","89388691","89388999","54","72897777"
"chr2","16492273","16492547","chr10","16847548","16847842","28","355275"
"chr2","16496123","16496434","chr10","16851961","16852277","20","355838"
"chr2","16503519","16503797","chr3","32929954","32930229","71","16426435"
"chr2","16505100","16505242","chr10","16860186","16860328","5","355086"
"chr2","16522013","16522248","chr10","16891016","16891251","2","369003"
"chr2","16528648","16528789","chr4","85201726","85201872","36","68673078"
"chr2","16544063","16544146","chr10","16912381","16912464","2","368318"
"chr2","16568683","16568982","chr10","16936693","16936991","12","368010"
"chr2","16570775","16570901","chr8","47972157","47972283","21","31401382"
"chr2","16575755","16576047","chr10","16942915","16943211","12","367160"
"chr2","16580839","16581149","chr10","16947350","16947667","23","366511"
"chr2","16582225","16582526","chr10","16948732","16949034","6","366507"
"chr2","16591058","16591105","chr10","16958176","16958223","0","367118"
"chr2","16597887","16598209","chr10","16965352","16965675","13","367465"
"chr2","16608876","16609184","chr10","16976567","16976848","32","367691"
"chr2","16631090","16631426","chr10","16997085","16997421","5","365995"
"chr2","16641617","16641936","chr10","17007698","17008021","11","366081"
"chr2","16679546","16679764","chr10","17044382","17044600","8","364836"
"chr2","16700587","16700934","chr2","51142020","51142358","82","34441433"
"chr2","16708302","16708575","chr10","17073255","17073526","6","364953"
"chr2","16711332","16711464","chr1","1286964","1287097","19","15424368"
"chr2","16711621","16711914","chr10","17076567","17076862","6","364946"
"chr2","16716123","16716421","chr10","17081355","17081663","21","365232"
"chr2","16718776","16719086","chr10","17084016","17084335","44","365240"
"chr2","16721419","16721706","chr10","17086817","17087130","48","365398"
"chr2","16734377","16734687","chr10","17100384","17100697","16","366007"
"chr2","16743096","16743387","chr10","17109417","17109722","29","366321"
"chr2","16752365","16752536","chr18","38200135","38200298","35","21447770"
"chr2","16766628","16766925","chr10","17133650","17133957","15","367022"
"chr2","16786828","16787102","chr10","17160734","17161014","9","373906"
"chr2","16788442","16788721","chr10","17162354","17162637","11","373912"
"chr2","16807327","16807643","chr10","17181240","17181559","10","373913"
"chr2","16814823","16815125","chr10","17188739","17189032","15","373916"
"chr2","16827825","16827874","chr5","35257680","35257726","9","18429855"
"chr2","16828185","16828363","chr19","1864380","1864550","34","14963805"
"chr2","16833531","16833810","chr10","17207174","17207452","5","373643"
"chr2","16841435","16841742","chr10","17220051","17220362","23","378616"
"chr2","16859183","16859348","chr3","78718150","78718316","24","61858967"
"chr2","16859393","16859503","chr8","16939496","16939614","23","80103"
"chr2","16873018","16873247","chr10","17251638","17251864","14","378620"
"chr2","16875903","16876179","chr10","17254530","17254839","38","378627"
"chr2","16885098","16885250","chr10","17264565","17264716","2","379467"
"chr2","16906330","16906621","chr10","17285621","17285912","8","379291"
"chr2","16918880","16919104","chr1","93016186","93016399","48","76097306"
"chr2","16950974","16951282","chr10","17331176","17331482","9","380202"
"chr2","17017018","17017315","chr10","17396159","17396462","12","379141"
"chr2","17030060","17030358","chr10","17409221","17409520","8","379161"
"chr2","17063017","17063285","chr10","17447104","17447380","17","384087"
"chr2","17119485","17119784","chr10","17506241","17506540","5","386756"
"chr2","17124490","17124778","chr10","17511248","17511527","18","386758"
"chr2","17167768","17168068","chr1","2881933","2882226","65","14285835"
"chr2","17182136","17182418","chr1","159614491","159614771","55","142432355"
"chr2","17188611","17188859","chr10","17574773","17575019","10","386162"
"chr2","17220331","17220499","chr10","17606488","17606653","5","386157"
"chr2","17225832","17226134","chr10","17611963","17612264","9","386131"
"chr2","17235819","17236087","chr10","17622240","17622506","13","386421"
"chr2","17240767","17241046","chr10","17627122","17627401","12","386355"
"chr2","17277292","17277453","chr11","110402020","110402179","32","93124728"
"chr2","17280065","17280215","chr10","17666676","17666822","6","386611"
"chr2","17300296","17300594","chr11","120580872","120581167","55","103280576"
"chr2","17307813","17308024","chr10","17694862","17695068","9","387049"
"chr2","17327836","17328149","chr10","17714883","17715197","18","387047"
"chr2","17342921","17343060","chr10","17739746","17739885","1","396825"
"chr2","17357629","17357923","chr10","17754886","17755177","6","397257"
"chr2","17407955","17408225","chr10","17795500","17795770","8","387545"
"chr2","17446935","17447114","chr10","17835131","17835311","4","388196"
"chr2","17459453","17459516","chr7","130508232","130508298","9","113048779"
"chr2","17459517","17459677","chr15","348992","349161","37","17110525"
"chr2","17462343","17462634","chr10","17850865","17851158","8","388522"
"chr2","17463732","17464002","chr10","17852259","17852529","5","388527"
"chr2","17472175","17472475","chr10","17860646","17860944","8","388471"
"chr2","17545736","17546029","chr10","17934072","17934367","14","388336"
"chr2","17626274","17626570","chr10","18014472","18014768","6","388198"
"chr2","17682592","17682897","chr10","18071312","18071617","4","388720"
"chr2","17689145","17689267","chr9","93987286","93987404","22","76298141"
"chr2","17696861","17697155","chr10","18085837","18086134","18","388976"
"chr2","17701794","17702110","chr1","204842844","204843149","75","187141050"
"chr2","17739272","17739568","chr4","35119120","35119410","55","17379848"
"chr2","17786623","17786931","chr10","18177191","18177497","9","390568"
"chr2","17788776","17788986","chr10","18179665","18179875","11","390889"
"chr2","17805051","17805334","chr10","18195618","18195901","7","390567"
"chr2","17812822","17813102","chr10","18202576","18202861","6","389754"
"chr2","17814369","17814663","chr10","18204118","18204421","13","389749"
"chr2","17879830","17880139","chr10","18272816","18273125","7","392986"
"chr2","17882217","17882511","chr10","18275151","18275445","4","392934"
"chr2","17887514","17887816","chr10","18280424","18280715","15","392910"
"chr2","17902670","17902885","chr10","18294015","18294230","6","391345"
"chr2","17902945","17903178","chr10","18294290","18294523","4","391345"
"chr2","17912636","17912937","chr10","18304612","18304905","15","391976"
"chr2","17918759","17918962","chr10","18310742","18310943","4","391983"
"chr2","17931108","17931388","chr10","18323585","18323863","11","392477"
"chr2","17949927","17950223","chr10","18347523","18347817","7","397596"
"chr2","17965197","17965370","chr10","18358359","18358534","8","393162"
"chr2","17965678","17965792","chr10","18358842","18358957","3","393164"
"chr2","17968755","17968818","chr20","10976550","10976613","13","6992205"
"chr2","17969931","17970232","chr10","18366549","18366827","24","396618"
"chr2","17970233","17970390","chr10","18366850","18367008","3","396617"
"chr2","17981316","17981651","chr10","18378282","18378616","7","396966"
"chr2","17998609","17998890","chr10","18395621","18395895","10","397012"
"chr2","18007910","18008203","chr10","18404826","18405118","5","396916"
"chr2","18028037","18028324","chr14","12742109","12742393","68","5285928"
"chr2","18036932","18037213","chr10","18433876","18434148","14","396944"
"chr2","18057982","18058261","chr10","18455347","18455625","11","397365"
"chr2","18061049","18061316","chr2","48551701","48551975","58","30490652"
"chr2","18066320","18066434","chr11","82221244","82221360","27","64154924"
"chr2","18066439","18066484","chr16","41987012","41987055","8","23920573"
"chr2","18070358","18070484","chr20","929087","929213","30","17141271"
"chr2","18071223","18071384","chr2","100069015","100069158","47","81997792"
"chr2","18105768","18105884","chr10","18501950","18502066","5","396182"
"chr2","18202675","18202952","chr10","18607039","18607327","13","404364"
"chr2","18284121","18284438","chr10","18691704","18692020","10","407583"
"chr2","18382125","18382416","chr10","18804263","18804554","3","422138"
"chr2","18400518","18400817","chr10","18820190","18820493","8","419672"
"chr2","18404623","18404936","chr10","18824317","18824629","6","419694"
"chr2","18411524","18411728","chr10","18831137","18831337","7","419613"
"chr2","18411997","18412116","chr10","18831611","18831729","1","419614"
"chr2","18438092","18438420","chr10","18858123","18858427","30","420031"
"chr2","18438428","18438723","chr10","18858435","18858730","9","420007"
"chr2","18469385","18469726","chr10","18889924","18890257","32","420539"
"chr2","18489506","18489809","chr10","18909115","18909412","29","419609"
"chr2","18499055","18499333","chr10","18918672","18918950","8","419617"
"chr2","18503449","18503674","chr10","18923284","18923511","9","419835"
"chr2","18524736","18525035","chr10","18945160","18945457","15","420424"
"chr2","18526622","18526929","chr10","18947073","18947376","10","420451"
"chr2","18552577","18552880","chr10","18973551","18973857","7","420974"
"chr2","18554959","18555265","chr10","18975858","18976169","27","420899"
"chr2","18738263","18738482","chr10","19166852","19167076","16","428589"
"chr2","18754294","18754614","chr10","19183155","19183438","45","428861"
"chr2","18771529","18771844","chr10","19200403","19200717","12","428874"
"chr2","18794974","18795248","chr10","19225142","19225419","6","430168"
"chr2","18812210","18812515","chr10","19242873","19243179","6","430663"
"chr2","18817998","18818296","chr10","19248804","19249105","15","430806"
"chr2","18836205","18836352","chr13","31261894","31262026","33","12425689"
"chr2","18847097","18847236","chr10","19277949","19278088","4","430852"
"chr2","18883520","18883752","chr10","19313819","19314051","9","430299"
"chr2","18895452","18895750","chr10","19325202","19325507","16","429750"
"chr2","18930934","18931233","chr10","19359938","19360230","12","429004"
"chr2","18941571","18941904","chr10","19369948","19370253","40","428377"
"chr2","18944127","18944439","chr10","19372489","19372801","12","428362"
"chr2","18951042","18951357","chr10","19379354","19379657","19","428312"
"chr2","18965582","18965772","chr10","19392795","19392985","4","427213"
"chr2","18968788","18969090","chr10","19396155","19396461","10","427367"
"chr2","18970769","18971080","chr10","19398164","19398478","9","427395"
"chr2","18983550","18983859","chr10","19412336","19412649","15","428786"
"chr2","19006551","19006717","chr7","38789439","38789604","34","19782888"
"chr2","19006744","19006860","chr2","136376620","136376738","18","117369876"
"chr2","19026297","19026564","chr10","19455213","19455485","7","428916"
"chr2","19035489","19035778","chr10","19464660","19464936","45","429171"
"chr2","19069850","19070178","chr10","19499434","19499767","15","429584"
"chr2","19071504","19071565","chr6","128013284","128013341","19","108941780"
"chr2","19072581","19072878","chr10","19502176","19502473","11","429595"
"chr2","19084532","19084826","chr10","19513628","19513927","14","429096"
"chr2","19096557","19096784","chr8","28856625","28856853","54","9760068"
"chr2","19108758","19109050","chr10","19537904","19538196","12","429146"
"chr2","19161712","19161846","chr10","19590333","19590467","4","428621"
"chr2","19188665","19188965","chr10","19616911","19617194","22","428246"
"chr2","19210912","19211205","chr10","19638858","19639156","15","427946"
"chr2","19255141","19255394","chr10","19682703","19682991","40","427562"
"chr2","19258569","19258895","chr10","19685378","19685704","10","426809"
"chr2","19259892","19260068","chr10","19686701","19686877","0","426809"
"chr2","19268492","19268778","chr10","19695400","19695693","16","426908"
"chr2","19272274","19272573","chr10","19699187","19699478","10","426913"
"chr2","19312869","19313197","chr10","19742333","19742662","14","429464"
"chr2","19313520","19313810","chr10","19742982","19743274","9","429462"
"chr2","19337383","19337667","chr9","28967529","28967817","49","9630146"
"chr2","19340484","19340623","chr20","32367895","32368031","28","13027411"
"chr2","19352311","19352619","chr10","19782252","19782552","17","429941"
"chr2","19353213","19353520","chr10","19783159","19783468","6","429946"
"chr2","19358654","19358902","chr10","60347932","60348186","54","40989278"
"chr2","19363629","19363902","chr10","19794755","19795028","9","431126"
"chr2","19395689","19395998","chrX","15697361","15697669","61","3698328"
"chr2","19440280","19440485","chr13","53892039","53892240","42","34451759"
"chr2","19444956","19445101","chr10","19872472","19872610","11","427516"
"chr2","19452367","19452382","chr7","149225337","149225352","3","129772970"
"chr2","19455343","19455618","chr10","19883858","19884133","5","428515"
"chr2","19475226","19475539","chr10","19901351","19901663","7","426125"
"chr2","19475937","19475986","chr10","19902057","19902106","1","426120"
"chr2","19476454","19476726","chr9","56456050","56456320","63","36979596"
"chr2","19492235","19492365","chr16","56131331","56131460","21","36639096"
"chr2","19505014","19505302","chr10","19934942","19935238","23","429928"
"chr2","19514996","19515124","chr10","19945204","19945332","3","430208"
"chr2","19521977","19522271","chr10","19952169","19952462","8","430192"
"chr2","19541491","19541793","chr3","172298971","172299269","60","152757480"
"chr2","19545411","19545638","chr10","19975838","19976052","46","430427"
"chr2","19553492","19553762","chr5","137741677","137741944","51","118188185"
"chr2","19573142","19573284","chr10","72116415","72116555","22","52543273"
"chr2","19574305","19574585","chr1","43269471","43269754","56","23695166"
"chr2","19579907","19580181","chr10","20009878","20010152","10","429971"
"chr2","19609378","19609674","chr10","20038058","20038353","18","428680"
"chr2","19623417","19623575","chr10","20052239","20052392","7","428822"
"chr2","19628348","19628525","chr1","42760062","42760237","33","23131714"
"chr2","19628559","19628687","chr1","18409954","18410078","22","1218605"
"chr2","19633308","19633570","chr10","20062367","20062638","11","429059"
"chr2","19637148","19637417","chr10","20066129","20066413","21","428981"
"chr2","19638909","19639211","chr13","88964386","88964687","71","69325477"
"chr2","19641137","19641436","chr2","97499012","97499310","57","77857875"
"chr2","19656140","19656403","chr10","20084732","20084995","10","428592"
"chr2","19706685","19706699","chr1","13821976","13821987","3","5884709"
"chr2","19706864","19706930","chr16","60193976","60194040","12","40487112"
"chr2","19731096","19731406","chr10","20161692","20161995","17","430596"
"chr2","19796048","19796378","chr10","20228061","20228360","61","432013"
"chr2","19814485","19814765","chr10","20246435","20246712","13","431950"
"chr2","19830758","19831036","chr10","20262648","20262930","22","431890"
"chr2","19886075","19886376","chr10","20318705","20319003","14","432630"
"chr2","19934104","19934398","chr10","20366365","20366659","5","432261"
"chr2","19958127","19958423","chr10","20390934","20391230","10","432807"
"chr2","19963634","19963925","chr10","20396458","20396743","9","432824"
"chr2","19985966","19986259","chr10","20417697","20417998","20","431731"
"chr2","20004753","20005058","chr10","20435742","20436045","10","430989"
"chr2","20025108","20025414","chr10","78486271","78486565","56","58461163"
"chr2","20030589","20030773","chrX","15997136","15997312","42","4033453"
"chr2","20036840","20037117","chrX","90717934","90718213","47","70681094"
"chr2","20042842","20042909","chr10","20471867","20471935","3","429025"
"chr2","20055642","20055981","chr10","20484881","20485210","18","429239"
"chr2","20074508","20074800","chr10","20505930","20506238","21","431422"
"chr2","20081881","20082167","chr4","35119120","35119410","45","15037239"
"chr2","20085024","20085209","chr7","109558275","109558459","32","89473251"
"chr2","20085210","20085433","chr1","81786243","81786461","39","61701033"
"chr2","20094954","20095228","chr8","81019140","81019414","63","60924186"
"chr2","20095316","20095612","chr10","20529719","20530014","9","434403"
"chr2","20105297","20105584","chr10","20540007","20540294","7","434710"
"chr2","20111573","20111738","chr10","20546292","20546457","5","434719"
"chr2","20112015","20112161","chr10","20546732","20546879","5","434717"
"chr2","20115501","20115512","chr1","166255009","166255020","2","146139508"
"chr2","20116141","20116282","chr1","34081212","34081346","24","13965071"
"chr2","20118361","20118439","chr1","112516638","112516708","28","92398277"
"chr2","20120329","20120587","chr10","20555646","20555904","6","435317"
"chr2","20121577","20121694","chr10","20556901","20557018","5","435324"
"chr2","20131428","20131715","chr1","113923965","113924259","64","93792537"
"chr2","20155432","20155724","chr10","20604091","20604384","4","448659"
"chr2","20176166","20176447","chr7","5973279","5973568","61","14202887"
"chr2","20179259","20179544","chr10","20629456","20629741","8","450197"
"chr2","20197308","20197418","chr11","59572694","59572803","23","39375386"
"chr2","20209368","20209672","chr10","20658754","20659055","11","449386"
"chr2","20212572","20212869","chr10","20661960","20662260","7","449388"
"chr2","20221032","20221319","chr10","20670580","20670867","9","449548"
"chr2","20242000","20242301","chr10","20690852","20691165","20","448852"
"chr2","20285340","20285619","chr10","20733883","20734167","13","448543"
"chr2","20287659","20287988","chr10","20736213","20736543","5","448554"
"chr2","20294337","20294468","chr10","20742900","20743034","6","448563"
"chr2","20295423","20295729","chr10","20743984","20744290","2","448561"
"chr2","20319454","20319762","chr12","62799016","62799324","52","42479562"
"chr2","20320815","20321097","chr11","122124868","122125153","61","101804053"
"chr2","20321953","20322241","chr3","178010044","178010346","68","157688091"
"chr2","20323348","20323663","chrX","41341410","41341721","60","21018062"
"chr2","20326870","20327137","chr11","51937307","51937574","64","31610437"
"chr2","20334291","20334588","chr10","20774680","20774977","22","440389"
"chr2","20334825","20335129","chr10","20775214","20775513","14","440389"
"chr2","20336531","20336805","chr10","20776910","20777184","8","440379"
"chr2","20336826","20337105","chr3","173597806","173598081","48","153260980"
"chr2","20350531","20350655","chr10","20791325","20791449","2","440794"
"chr2","20350953","20351022","chr4","27924851","27924917","18","7573898"
"chr2","20351025","20351064","chr6","83048189","83048225","11","62697164"
"chr2","20360842","20361024","chr10","20801504","20801686","10","440662"
"chr2","20361328","20361460","chr10","20801991","20802126","12","440663"
"chr2","20400776","20400967","chr10","20834057","20834248","11","433281"
"chr2","20401421","20401714","chr10","20834700","20834991","7","433279"
"chr2","20407530","20407753","chr10","20840832","20841059","14","433302"
"chr2","20413135","20413427","chr9","91846604","91846897","55","71433469"
"chr2","20419975","20420305","chr10","20853642","20853971","12","433667"
"chr2","20436762","20437040","chr10","20869374","20869652","4","432612"
"chr2","20463895","20464203","chr10","20896875","20897178","16","432980"
"chr2","20575486","20575762","chr10","21011465","21011752","49","435979"
"chr2","20629338","20629388","chr7","161629769","161629818","10","141000431"
"chr2","20648424","20648728","chr10","21084328","21084631","9","435904"
"chr2","20750076","20750382","chr10","21187057","21187364","9","436981"
"chr2","20758909","20759215","chr10","21195780","21196086","13","436871"
"chr2","20768241","20768402","chr10","21204569","21204730","4","436328"
"chr2","20883124","20883320","chr10","21322096","21322292","4","438972"
"chr2","20883363","20883437","chr10","21322335","21322410","1","438972"
"chr2","20887322","20887590","chr10","21326209","21326487","14","438887"
"chr2","20969807","20970083","chr10","21410204","21410483","9","440397"
"chr2","21069418","21069715","chr10","21509461","21509759","12","440043"
"chr2","21233898","21234191","chr10","21674752","21675032","22","440854"
"chr2","21274690","21274974","chr10","21715456","21715740","8","440766"
"chr2","21309301","21309476","chr18","24170607","24170784","40","2861306"
"chr2","21340386","21340502","chr11","43758289","43758404","16","22417903"
"chr2","21340543","21340708","chr15","105589286","105589452","28","84248743"
"chr2","21434870","21435052","chr10","21875828","21875987","32","440958"
"chr2","21598007","21598308","chr10","22041198","22041491","43","443191"
"chr2","21659042","21659351","chr10","22102954","22103265","15","443912"
"chr2","21705143","21705222","chr10","22149448","22149514","13","444305"
"chr2","21705512","21705684","chr10","22149807","22149989","13","444295"
"chr2","21728683","21728995","chr10","22173956","22174259","19","445273"
"chr2","21776811","21777080","chr10","22222890","22223155","10","446079"
"chr2","21908591","21908889","chr10","22355183","22355481","6","446592"
"chr2","21951327","21951453","chr10","22398342","22398429","40","447015"
"chr2","22003650","22003906","chr10","22451210","22451464","12","447560"
"chr2","22032537","22032802","chr10","22479712","22479977","3","447175"
"chr2","22045214","22045510","chr10","22492432","22492740","27","447218"
"chr2","22102534","22102657","chr1","215728370","215728487","32","193625836"
"chr2","22125489","22125608","chr10","22580120","22580239","2","454631"
"chr2","22125663","22125886","chr10","22580294","22580496","22","454631"
"chr2","22152430","22152725","chr10","22607642","22607934","8","455212"
"chr2","22197793","22198067","chr6","140268191","140268486","74","118070398"
"chr2","22221113","22221409","chr10","22677036","22677332","3","455923"
"chr2","22254052","22254347","chr10","22710228","22710529","16","456176"
"chr2","22268838","22269136","chr10","22725276","22725579","15","456438"
"chr2","22305112","22305383","chr18","42762980","42763243","61","20457868"
"chr2","22338108","22338180","chr10","22795109","22795181","1","457001"
"chr2","22387437","22387712","chr10","22844888","22845164","9","457451"
"chr2","22429259","22429549","chr10","22888939","22889251","26","459680"
"chr2","22435160","22435336","chr10","22894488","22894664","4","459328"
"chr2","22435681","22435824","chr10","22894983","22895126","4","459302"
"chr2","22445840","22446134","chr10","22904524","22904810","14","458684"
"chr2","22449834","22449967","chr10","2464482","2464626","28","19985352"
"chr2","22454004","22454138","chr10","22913984","22914118","2","459980"
"chr2","22469392","22469677","chr10","22928075","22928390","36","458683"
"chr2","22483404","22483558","chr4","153678863","153679021","40","131195459"
"chr2","22530050","22530352","chr10","22988372","22988674","5","458322"
"chr2","22553687","22553962","chr10","23012428","23012699","8","458741"
"chr2","22556114","22556415","chr10","23014813","23015125","17","458699"
"chr2","22569910","22570214","chr10","23025851","23026166","16","455941"
"chr2","22586617","22586917","chr10","23042583","23042870","17","455966"
"chr2","22625284","22625550","chr10","23081218","23081484","5","455934"
"chr2","22663180","22663447","chr10","23113787","23114039","17","450607"
"chr2","22671268","22671329","chr10","23121863","23121924","1","450595"
"chr2","22738545","22738795","chr3","48299686","48299946","63","25561141"
"chr2","22740930","22741225","chr10","23190551","23190846","9","449621"
"chr2","22744735","22745017","chr10","23194050","23194332","7","449315"
"chr2","22752201","22752502","chr10","23201513","23201808","14","449312"
"chr2","22756181","22756453","chr10","23205661","23205891","48","449480"
"chr2","22765115","22765423","chr1","14530707","14531005","74","8234408"
"chr2","22770293","22770515","chr10","23220758","23220980","8","450465"
"chr2","22770550","22770841","chr10","23221018","23221310","16","450468"
"chr2","22784660","22784975","chr10","23235231","23235546","3","450571"
"chr2","22796357","22796661","chr10","23248135","23248446","13","451778"
"chr2","22798090","22798226","chr7","5302274","5302409","24","17495816"
"chr2","22799345","22799630","chr7","17731182","17731473","53","5068163"
"chr2","22800431","22800733","chr7","23300364","23300662","45","499933"
"chr2","22810490","22810808","chr11","106948181","106948495","70","84137691"
"chr2","22834874","22835028","chr10","23268405","23268562","12","433531"
"chr2","22849128","22849436","chr10","23282719","23283026","7","433591"
"chr2","22854978","22855286","chr10","23282719","23283026","7","427741"
"chr2","22864506","22864813","chr10","23292233","23292541","6","427727"
"chr2","22867423","22867719","chr10","23295114","23295414","8","427691"
"chr2","22900048","22900348","chr10","23327960","23328230","36","427912"
"chr2","22900377","22900405","chr6","73953878","73953903","3","51053501"
"chr2","22911308","22911617","chr10","23338743","23339053","10","427435"
"chr2","22943020","22943147","chr8","117677159","117677284","19","94734139"
"chr2","22943188","22943376","chr10","37889717","37889905","34","14946529"
"chr2","23046672","23046968","chr10","23475190","23475486","7","428518"
"chr2","23051443","23051751","chr10","23479961","23480269","7","428518"
"chr2","23243598","23243888","chr10","23672881","23673170","8","429283"
"chr2","23276218","23276499","chr10","23705361","23705664","29","429143"
"chr2","23306325","23306617","chr10","23734715","23735011","8","428390"
"chr2","23310758","23311026","chr10","23739148","23739411","12","428390"
"chr2","23392799","23392899","chr10","23821224","23821324","2","428425"
"chr2","23690803","23691078","chr10","24112825","24113100","10","422022"
"chr2","23712289","23712570","chr10","24134061","24134341","6","421772"
"chr2","23807330","23807358","chr4","161170103","161170130","5","137362773"
"chr2","23807385","23807666","chr4","35128891","35129172","59","11321506"
"chr2","23808526","23808822","chr10","24230592","24230888","7","422066"
"chr2","23916353","23916563","chr10","24339289","24339498","12","422936"
"chr2","24006551","24006709","chr10","24434030","24434187","2","427479"
"chr2","24006735","24006850","chr10","24434213","24434328","1","427478"
"chr2","24148632","24148936","chr10","24573793","24574072","34","425161"
"chr2","24330676","24330981","chr10","24759040","24759324","33","428364"
"chr2","24577245","24577536","chr10","25012221","25012514","5","434976"
"chr2","24591189","24591464","chr10","25025818","25026105","17","434629"
"chr2","24602204","24602518","chr10","25036800","25037112","8","434596"
"chr2","24650885","24651193","chr10","25085674","25085982","4","434789"
"chr2","24674743","24675046","chr10","25109841","25110146","3","435098"
"chr2","24706241","24706548","chr10","25141682","25141989","6","435441"
"chr2","24715157","24715277","chr10","25150584","25150705","4","435427"
"chr2","24728793","24728999","chr10","25163943","25164149","3","435150"
"chr2","24794722","24794869","chr10","25228820","25228972","6","434098"
"chr2","24796625","24796764","chr1","9667266","9667402","28","15129359"
"chr2","24796765","24796839","chr14","118955492","118955568","16","94158727"
"chr2","24815216","24815501","chr17","383189","383476","59","24432027"
"chr2","24817811","24818122","chr10","25252049","25252359","5","434238"
"chr2","24874815","24875133","chr10","25307282","25307601","25","432467"
"chr2","24902673","24902985","chr3","35716819","35717138","66","10814146"
"chr2","24907660","24907976","chr10","25340802","25341116","11","433142"
"chr2","24913537","24913820","chr10","25346675","25346955","8","433138"
"chr2","24918435","24918742","chr10","25351574","25351880","13","433139"
"chr2","24945947","24946260","chr10","25379208","25379504","26","433261"
"chr2","24974316","24974489","chr10","25408429","25408612","11","434113"
"chr2","24977607","24977773","chr10","25411711","25411877","6","434104"
"chr2","24978068","24978202","chr10","25412177","25412311","8","434109"
"chr2","24991407","24991704","chr10","25425293","25425590","4","433886"
"chr2","25008820","25008984","chr18","18006699","18006868","34","7002121"
"chr2","25010134","25010222","chr10","25445045","25445133","1","434911"
"chr2","25017309","25017428","chr10","25452216","25452335","1","434907"
"chr2","25017429","25017729","chr10","25452336","25452652","28","434907"
"chr2","25017730","25017915","chr10","25452653","25452819","21","434923"
"chr2","25024729","25025020","chr10","25459645","25459936","7","434916"
"chr2","25043983","25044194","chr1","30228392","30228598","40","5184409"
"chr2","25061655","25061720","chr2","115596700","115596762","11","90535045"
"chr2","25064789","25065100","chr10","25499501","25499812","9","434712"
"chr2","25065104","25065262","chr8","24195232","24195396","39","869872"
"chr2","25121099","25121392","chr10","25554560","25554863","30","433461"
"chr2","25122010","25122289","chr10","25555459","25555732","19","433449"
"chr2","25135998","25136307","chr10","25568085","25568399","9","432087"
"chr2","25155581","25155857","chr3","139028255","139028536","69","113872674"
"chr2","25173585","25173857","chr10","25602696","25602969","6","429111"
"chr2","25246077","25246368","chr10","25674757","25675053","13","428680"
"chr2","25247168","25247468","chr10","25675846","25676142","7","428678"
"chr2","25252243","25252404","chr19","30817957","30818117","31","5565714"
"chr2","25273353","25273603","chr10","25700771","25701019","8","427418"
"chr2","25275626","25275935","chr10","25703052","25703366","11","427426"
"chr2","25280635","25280927","chr10","42476896","42477184","56","17196261"
"chr2","25284174","25284457","chr10","25712248","25712544","27","428074"
"chr2","25293724","25293885","chr1","93519854","93520015","26","68226130"
"chr2","25294191","25294319","chr13","19492404","19492536","26","5801787"
"chr2","25294406","25294699","chr10","25722529","25722818","13","428123"
"chr2","25300003","25300172","chr5","153156043","153156217","32","127856040"
"chr2","25300759","25301068","chr8","21726484","21726802","75","3574275"
"chr2","25311053","25311314","chr10","25739262","25739518","14","428209"
"chr2","25317845","25318013","chr10","25745737","25745905","7","427892"
"chr2","25326224","25326419","chr10","25753725","25753919","10","427501"
"chr2","25367374","25367643","chr10","25796531","25796800","4","429157"
"chr2","25371655","25371976","chr10","25800800","25801116","12","429145"
"chr2","25373197","25373374","chr8","63049295","63049453","46","37676098"
"chr2","25373418","25373550","chr1","57408775","57408910","22","32035357"
"chr2","25385566","25385855","chr10","25814828","25815117","10","429262"
"chr2","25389974","25390280","chr10","25819266","25819571","7","429292"
"chr2","25390928","25391215","chr10","25820221","25820509","6","429293"
"chr2","25397990","25398267","chr10","25827507","25827784","2","429517"
"chr2","25424593","25424897","chr10","25855767","25856066","20","431174"
"chr2","25446934","25447247","chr10","25875336","25875649","2","428402"
"chr2","25454421","25454692","chr10","25882824","25883094","18","428403"
"chr2","25469389","25469676","chr10","25897647","25897954","25","428258"
"chr2","25469679","25469979","chr10","25897957","25898257","3","428278"
"chr2","25478971","25479272","chr10","25907238","25907516","30","428267"
"chr2","25501615","25501912","chr10","25932004","25932301","8","430389"
"chr2","25562616","25562920","chr10","25993782","25994084","10","431166"
"chr2","25583569","25583865","chr15","36674290","36674587","50","11090721"
"chr2","25597132","25597408","chr10","26028752","26029029","9","431620"
"chr2","25605262","25605422","chr10","26976171","26976331","29","1370909"
"chr2","25611900","25612219","chr10","26043681","26044000","11","431781"
"chr2","25618439","25618751","chr10","26050260","26050565","11","431821"
"chr2","25627621","25627903","chr10","26059826","26060100","16","432205"
"chr2","25665478","25665711","chr10","26097501","26097739","15","432023"
"chr2","25673289","25673577","chr10","26105293","26105579","9","432004"
"chr2","25691876","25692183","chr1","56606441","56606741","61","30914565"
"chr2","25721594","25721902","chr10","26154117","26154424","13","432523"
"chr2","25731256","25731536","chr10","26163765","26164058","18","432509"
"chr2","25741242","25741544","chr10","26173450","26173750","8","432208"
"chr2","25758537","25758827","chr10","26191292","26191578","10","432755"
"chr2","25799550","25799759","chr1","152512596","152512805","43","126713046"
"chr2","25820544","25820623","chr10","26254226","26254305","4","433682"
"chr2","25856005","25856317","chrX","96318063","96318367","68","70462058"
"chr2","25876543","25876839","chr10","26310575","26310872","6","434032"
"chr2","25877044","25877209","chr10","26311078","26311243","7","434034"
"chr2","25910751","25911044","chr10","26345965","26346258","5","435214"
"chr2","25966186","25966345","chr10","26400429","26400588","2","434243"
"chr2","25975549","25975843","chr10","26409487","26409793","20","433938"
"chr2","26016933","26017068","chr14","30882625","30882756","22","4865692"
"chr2","26029831","26029950","chr10","26463317","26463436","0","433486"
"chr2","26030259","26030453","chr10","26463744","26463937","12","433485"
"chr2","26040738","26041024","chr10","26473799","26474085","4","433061"
"chr2","26049934","26050243","chr13","84452913","84453227","56","58402979"
"chr2","26057625","26057937","chr18","68278627","68278929","65","42221002"
"chr2","26061505","26061729","chr10","26494206","26494428","6","432701"
"chr2","26063262","26063413","chr10","26495960","26496111","2","432698"
"chr2","26064268","26064380","chr10","26496963","26497076","1","432695"
"chr2","26064583","26064889","chr10","26497275","26497583","10","432692"
"chr2","26070253","26070558","chr10","26503489","26503790","11","433236"
"chr2","26073188","26073455","chr10","26506547","26506821","18","433359"
"chr2","26110403","26110699","chr10","26538216","26538517","12","427813"
"chr2","26115353","26115676","chr10","26542830","26543157","17","427477"
"chr2","26116669","26116965","chr10","26544171","26544467","9","427502"
"chr2","26131888","26132135","chr10","26559299","26559546","6","427411"
"chr2","26134476","26134732","chr10","26561887","26562143","4","427411"
"chr2","26136412","26136694","chr10","26563824","26564106","7","427412"
"chr2","26140269","26140556","chr10","26567671","26567972","17","427402"
"chr2","26153401","26153704","chr7","45269231","45269537","61","19115830"
"chr2","26162518","26162819","chr10","26589690","26589989","24","427172"
"chr2","26167334","26167488","chr4","31611641","31611789","35","5444307"
"chr2","26172075","26172366","chr10","26599027","26599318","11","426952"
"chr2","26183478","26183774","chr10","26610776","26611053","26","427298"
"chr2","26195598","26195904","chr10","26623008","26623310","15","427410"
"chr2","26199949","26200243","chr10","26627338","26627641","11","427389"
"chr2","26205530","26205832","chr10","26633214","26633519","14","427684"
"chr2","26219583","26219882","chr18","1325947","1326250","48","24893636"
"chr2","26257259","26257569","chr10","26684368","26684675","8","427109"
"chr2","26261575","26261883","chr10","26689013","26689315","12","427438"
"chr2","26286025","26286344","chr10","26713906","26714192","49","427881"
"chr2","26290928","26291157","chr1","144402707","144402909","63","118111779"
"chr2","26308478","26308673","chr10","26736994","26737190","1","428516"
"chr2","26315059","26315384","chr10","26742963","26743263","34","427904"
"chr2","26316919","26317208","chr14","55839880","55840167","42","29522961"
"chr2","26349176","26349423","chr7","112170415","112170662","56","85821239"
"chr2","26374935","26375070","chr10","26802096","26802221","12","427161"
"chr2","26375072","26375372","chr10","26802223","26802523","5","427151"
"chr2","26378361","26378654","chr10","38038057","38038338","60","11659696"
"chr2","26410744","26411027","chr10","26836324","26836608","4","425580"
"chr2","26416431","26416616","chr10","26842020","26842197","9","425589"
"chr2","26417944","26418099","chr10","26843793","26843948","1","425849"
"chr2","26425281","26425556","chr10","26850838","26851113","9","425557"
"chr2","26443797","26444100","chr10","26869618","26869921","6","425821"
"chr2","26447879","26448158","chr10","26873670","26873949","5","425791"
"chr2","26452348","26452651","chr10","26877843","26878136","19","425495"
"chr2","26472658","26472955","chr10","26898177","26898474","8","425519"
"chr2","26478260","26478535","chr10","26904177","26904476","36","425917"
"chr2","26480063","26480274","chrX","122752694","122752910","47","96272631"
"chr2","26482492","26482802","chr10","28843155","28843464","61","2360663"
"chr2","26499770","26500000","chr15","30206767","30207007","43","3706997"
"chr2","26508595","26508902","chr9","102340368","102340668","62","75831773"
"chr2","26518491","26518600","chr10","26950322","26950431","1","431831"
"chr2","26527161","26527248","chr10","26958746","26958817","16","431585"
"chr2","26528158","26528460","chr10","26959740","26960043","8","431582"
"chr2","26532915","26533081","chr10","26964497","26964663","5","431582"
"chr2","26535569","26535719","chr10","26967138","26967284","7","431569"
"chr2","26536531","26536628","chr10","26968102","26968199","4","431571"
"chr2","26541385","26541671","chr10","26972949","26973236","9","431564"
"chr2","26541807","26542054","chr10","26973378","26973626","9","431571"
"chr2","26560163","26560460","chr10","26991257","26991554","5","431094"
"chr2","26572902","26573062","chr10","27003730","27003880","12","430828"
"chr2","26573401","26573690","chr10","27004201","27004490","6","430800"
"chr2","26576369","26576598","chr10","27007151","27007380","7","430782"
"chr2","26585076","26585286","chr19","42124398","42124609","42","15539322"
"chr2","26586602","26586895","chr10","27017129","27017422","6","430527"
"chr2","26590077","26590378","chr10","27020601","27020914","19","430524"
"chr2","26598773","26598932","chr10","27125031","27125189","7","526258"
"chr2","26660434","26660570","chr10","44276128","44276264","5","17615694"
"chr2","26676338","26676457","chr20","18172133","18172254","28","8504205"
"chr2","26831240","26831541","chr10","44101564","44101863","31","17270324"
"chr2","26952756","26953041","chr10","43979573","43979858","10","17026817"
"chr2","27060917","27061212","chr10","43866853","43867126","30","16805936"
"chr2","27178223","27178521","chr10","43744572","43744849","24","16566349"
"chr2","27277516","27277797","chr10","43644367","43644648","9","16366851"
"chr2","27377294","27377643","chr13","22262744","22263068","86","5114550"
"chr2","27450995","27451303","chr10","43469917","43470225","1","16018922"
"chr2","27563445","27563745","chr10","43355017","43355313","7","15791572"
"chr2","27586852","27587148","chr10","43331576","43331874","11","15744724"
"chr2","27599646","27599955","chr10","43318755","43319064","7","15719109"
"chr2","27613327","27613621","chr10","43305106","43305395","10","15691779"
"chr2","27631024","27631320","chr10","43287462","43287758","5","15656438"
"chr2","27639526","27639819","chr10","43279045","43279364","34","15639519"
"chr2","27642012","27642275","chr10","43276627","43276886","10","15634615"
"chr2","27678573","27678880","chr10","43239780","43240081","9","15561207"
"chr2","27708437","27708625","chr10","43209882","43210076","19","15501445"
"chr2","27708928","27709062","chr10","43209453","43209587","3","15500525"
"chr2","27720928","27721199","chr10","43197015","43197300","24","15476087"
"chr2","27722841","27723172","chr11","52125758","52126092","87","24402917"
"chr2","27738986","27739254","chr10","43178720","43178992","15","15439734"
"chr2","27783417","27783726","chr10","43135026","43135314","27","15351609"
"chr2","27794269","27794534","chr10","43124187","43124452","5","15329918"
"chr2","27797849","27798155","chr10","43120557","43120863","6","15322708"
"chr2","27806087","27806394","chr10","43112365","43112669","11","15306278"
"chr2","27813791","27814009","chr10","89915538","89915755","45","62101747"
"chr2","27961306","27961615","chr10","42953146","42953456","41","14991840"
"chr2","28030160","28030469","chr7","111283263","111283566","53","83253103"
"chr2","28203982","28204165","chr10","42707952","42708136","4","14503970"
"chr2","28242843","28243138","chr10","42668589","42668884","3","14425746"
"chr2","28245017","28245303","chr10","42666410","42666712","22","14421393"
"chr2","28296242","28296538","chr10","42615356","42615652","7","14319114"
"chr2","28398360","28398552","chr10","42509926","42510118","3","14111566"
"chr2","28418631","28418929","chr10","42492192","42492501","20","14073561"
"chr2","28433757","28434045","chr10","42476896","42477184","1","14043139"
"chr2","28447827","28447985","chr10","42463480","42463643","7","14015653"
"chr2","28511924","28512224","chr10","42394918","42395201","21","13882994"
"chr2","28523000","28523309","chr10","42383395","42383702","16","13860395"
"chr2","28671330","28671414","chr10","42236620","42236704","1","13565290"
"chr2","28718760","28719053","chr10","42190735","42191029","9","13471975"
"chr2","28776161","28776474","chr10","42133160","42133472","7","13356999"
"chr2","28793426","28793697","chr4","152212584","152212861","59","123419158"
"chr2","28923286","28923583","chr13","25750407","25750700","58","3172879"
"chr2","28938877","28939071","chr10","41969553","41969751","7","13030676"
"chr2","28939074","28939171","chr10","41969449","41969550","9","13030375"
"chr2","28956357","28956666","chr10","41951950","41952257","15","12995593"
"chr2","29076281","29076518","chr10","41829424","41829684","30","12753143"
"chr2","29092905","29093189","chr10","41813130","41813422","15","12720225"
"chr2","29317856","29318156","chr10","41596325","41596624","10","12278469"
"chr2","29345397","29345662","chr10","41568193","41568456","6","12222796"
"chr2","29379562","29379737","chr10","41533495","41533644","31","12153933"
"chr2","29600476","29600753","chr10","41312556","41312835","6","11712080"
"chr2","29604885","29605035","chr19","38610168","38610324","37","9005283"
"chr2","29605217","29605345","chr5","4552373","4552499","29","25052844"
"chr2","29628692","29628941","chr10","41285844","41286093","6","11657152"
"chr2","29653516","29653719","chr10","41260810","41261013","4","11607294"
"chr2","29715984","29716096","chr10","41196121","41196233","0","11480137"
"chr2","29793500","29793793","chr10","41124523","41124823","12","11331023"
"chr2","29867396","29867693","chr10","41059414","41059712","5","11192018"
"chr2","29898957","29899187","chr10","41017600","41017831","7","11118643"
"chr2","30142985","30143285","chr19","28718617","28718918","45","1424368"
"chr2","30332317","30332608","chr10","40579623","40579914","6","10247306"
"chr2","30345078","30345366","chr10","40566908","40567192","9","10221830"
"chr2","30421231","30421468","chr10","40485533","40485770","4","10064302"
"chr2","30485077","30485345","chr10","40422569","40422837","1","9937492"
"chr2","30585729","30586034","chr10","40325758","40326071","18","9740029"
"chr2","30639020","30639367","chr10","40272238","40272565","36","9633218"
"chr2","30741265","30741550","chr10","40169082","40169385","29","9427817"
"chr2","30777085","30777350","chr10","40133562","40133835","23","9356477"
"chr2","30814532","30814829","chr10","40096722","40097011","10","9282190"
"chr2","30846863","30847092","chr10","40063797","40064027","6","9216934"
"chr2","30890607","30890780","chr10","40019776","40019949","1","9129169"
"chr2","30930718","30931027","chr10","39979674","39979986","15","9048956"
"chr2","30934327","30934413","chr10","39976252","39976338","2","9041925"
"chr2","30936723","30936959","chr10","39973400","39973635","4","9036677"
"chr2","31117646","31117935","chr10","39787343","39787632","5","8669697"
"chr2","31136794","31137091","chr10","39768206","39768503","11","8631412"
"chr2","31183619","31183907","chr10","39721608","39721894","14","8537989"
"chr2","31200181","31200487","chr10","39704597","39704913","20","8504416"
"chr2","31244253","31244421","chr10","39661050","39661218","0","8416797"
"chr2","31269314","31269613","chr10","39635371","39635669","7","8366057"
"chr2","31291779","31292063","chr10","39612854","39613147","19","8321075"
"chr2","31510370","31510671","chr10","39400252","39400550","28","7889882"
"chr2","31623841","31623983","chr10","5886739","5886875","24","25737102"
"chr2","31681753","31681921","chr10","39230075","39230230","18","7548322"
"chr2","31685193","31685478","chr10","39226501","39226786","7","7541308"
"chr2","31827691","31828001","chr10","39084854","39085150","20","7257163"
"chr2","31860212","31860491","chr10","39051514","39051793","9","7191302"
"chr2","31901803","31902095","chr10","39010165","39010457","12","7108362"
"chr2","31905310","31905538","chr10","39006729","39006959","3","7101419"
"chr2","31908722","31908956","chr10","39003308","39003541","3","7094586"
"chr2","31915954","31916266","chr10","38996044","38996357","5","7080090"
"chr2","31987030","31987326","chr10","38921403","38921696","19","6934373"
"chr2","31991447","31991736","chr10","38916971","38917258","10","6925524"
"chr2","32018982","32019299","chr10","38887701","38888018","6","6868719"
"chr2","32037208","32037460","chr10","38868599","38868879","36","6831391"
"chr2","32041149","32041439","chr10","38864386","38864676","22","6823237"
"chr2","32088444","32088741","chr15","1865582","1865875","59","30222862"
"chr2","32099264","32099521","chr10","38808827","38809084","9","6709563"
"chr2","32102434","32102739","chr10","38805630","38805939","12","6703196"
"chr2","32109196","32109494","chr10","38798821","38799120","4","6689625"
"chr2","32115890","32116109","chr10","38792358","38792576","9","6676468"
"chr2","32145739","32146048","chr10","38762840","38763144","8","6617101"
"chr2","32158285","32158572","chrX","107244313","107244601","54","75086028"
"chr2","32170631","32170723","chr10","38737621","38737713","6","6566990"
"chr2","32183972","32184111","chr14","55629066","55629203","29","23445094"
"chr2","32184725","32184935","chr3","10354029","10354239","47","21830696"
"chr2","32191982","32192323","chr10","38716126","38716459","15","6524144"
"chr2","32208791","32209081","chr10","38699338","38699645","42","6490547"
"chr2","32227329","32227638","chr10","38681124","38681406","33","6453795"
"chr2","32227876","32227945","chr10","38680821","38680890","2","6452945"
"chr2","32238032","32238343","chr10","38670472","38670791","10","6432440"
"chr2","32263202","32263334","chr10","38640023","38640147","21","6376821"
"chr2","32273928","32274242","chr10","38629061","38629362","15","6355133"
"chr2","32277377","32277509","chr10","38625851","38625984","4","6348474"
"chr2","32309518","32309810","chr10","38593776","38594065","14","6284258"
"chr2","32317212","32317522","chr10","38586372","38586675","19","6269160"
"chr2","32319365","32319677","chr9","22454562","22454871","45","9864803"
"chr2","32321156","32321461","chr10","38584182","38584486","9","6263026"
"chr2","32332509","32332795","chr10","38572855","38573141","5","6240346"
"chr2","32335016","32335319","chr10","38570608","38570932","33","6235592"
"chr2","32335371","32335672","chr10","38570252","38570549","14","6234881"
"chr2","32337176","32337462","chr10","38568474","38568771","22","6231298"
"chr2","32341435","32341744","chr10","38564332","38564636","13","6222897"
"chr2","32372085","32372396","chr10","38535034","38535311","49","6162949"
"chr2","32377391","32377693","chr10","38532332","38532638","12","6154941"
"chr2","32392152","32392453","chr1","93315325","93315621","54","60923173"
"chr2","32396071","32396383","chr10","38512151","38512461","11","6116080"
"chr2","32402772","32403090","chr10","38504944","38505259","17","6102172"
"chr2","32403102","32403399","chr10","38504617","38504932","27","6101515"
"chr2","32407621","32407910","chr10","38500001","38500259","34","6092380"
"chr2","32410414","32410706","chr10","38496367","38496659","6","6085953"
"chr2","32410922","32411003","chr10","38496074","38496151","6","6085152"
"chr2","32411402","32411578","chr10","69547738","69547924","41","37136336"
"chr2","32418459","32418729","chr10","38487850","38488119","14","6069391"
"chr2","32419881","32420194","chr10","38486383","38486696","5","6066502"
"chr2","32422701","32423008","chr7","123308324","123308634","76","90885623"
"chr2","32427372","32427668","chr10","38478377","38478704","39","6051005"
"chr2","32429707","32430029","chr10","38476007","38476341","24","6046300"
"chr2","32436401","32436687","chr10","38469410","38469697","9","6033009"
"chr2","32436871","32437168","chr10","38468930","38469227","5","6032059"
"chr2","32437880","32438204","chr10","38461295","38461595","34","6023415"
"chr2","32444696","32444981","chr10","38460131","38460412","13","6015435"
"chr2","32447451","32447766","chr10","38457343","38457658","13","6009892"
"chr2","32448537","32448842","chr10","38456289","38456599","13","6007752"
"chr2","32451677","32451956","chr10","38453146","38453426","4","6001469"
"chr2","32452955","32453251","chr10","38451522","38451820","8","5998567"
"chr2","32461266","32461571","chr10","38443194","38443495","15","5981928"
"chr2","32477070","32477125","chr14","63550794","63550854","17","31073724"
"chr2","32477438","32477579","chr7","113045922","113046055","29","80568484"
"chr2","32480405","32480694","chrX","15942617","15942912","76","16537788"
"chr2","32486949","32487171","chr10","38417081","38417303","6","5930132"
"chr2","32489515","32489802","chr10","38414458","38414745","7","5924943"
"chr2","32491439","32491606","chr10","38412680","38412838","17","5921241"
"chr2","32495103","32495228","chr10","38409109","38409234","6","5914006"
"chr2","32501817","32502084","chr10","38402054","38402318","15","5900237"
"chr2","32503722","32503940","chr10","38400161","38400379","2","5896439"
"chr2","32508804","32509109","chr10","38395424","38395730","17","5886620"
"chr2","32511846","32512195","chr10","38392357","38392647","70","5880511"
"chr2","32515242","32515535","chr10","38389117","38389410","3","5873875"
"chr2","32517578","32517863","chr10","38386817","38387103","7","5869239"
"chr2","32518721","32518878","chr10","38385809","38385968","4","5867088"
"chr2","32519241","32519556","chr10","38385146","38385460","7","5865905"
"chr2","32528478","32528831","chr20","39145658","39145995","97","6617180"
"chr2","32552577","32552879","chr10","38352340","38352624","20","5799763"
"chr2","32554361","32554556","chr10","38350663","38350857","5","5796302"
"chr2","32554818","32554943","chr10","38350276","38350401","4","5795458"
"chr2","32557408","32557709","chr10","38347496","38347796","7","5790088"
"chr2","32567360","32567657","chr10","38337182","38337466","16","5769822"
"chr2","32568527","32568693","chr10","38336150","38336316","1","5767623"
"chr2","32572932","32573205","chr10","38331926","38332202","9","5758994"
"chr2","32582090","32582211","chr2","125961045","125961156","26","93378955"
"chr2","32590403","32590693","chr10","38314121","38314406","15","5723718"
"chr2","32593171","32593455","chr10","38311950","38312234","7","5718779"
"chr2","32596194","32596229","chr10","38299371","38299406","1","5703177"
"chr2","32601901","32602225","chr10","38283888","38284212","13","5681987"
"chr2","32602465","32602604","chr3","139264455","139264574","41","106661990"
"chr2","32612426","32612713","chr10","38273755","38274042","8","5661329"
"chr2","32623822","32624128","chr10","38261696","38262008","13","5637874"
"chr2","32625034","32625174","chr3","162197994","162198125","29","129572960"
"chr2","32644713","32645014","chr10","38240142","38240443","9","5595429"
"chr2","32677007","32677301","chr10","38202957","38203251","7","5525950"
"chr2","32683718","32683939","chr10","38196358","38196573","12","5512640"
"chr2","32715407","32715702","chr10","38165123","38165425","16","5449716"
"chr2","32764359","32764670","chr10","38115261","38115572","12","5350902"
"chr2","32787660","32787896","chr10","38092046","38092282","5","5304386"
"chr2","32811241","32811529","chr10","38067901","38068176","21","5256660"
"chr2","32839788","32839950","chr10","76934170","76934333","29","44094382"
"chr2","32843555","32843846","chr10","38033514","38033802","10","5189959"
"chr2","32897996","32898154","chr10","37977034","37977188","10","5079038"
"chr2","32909118","32909406","chr10","37966217","37966517","20","5057099"
"chr2","32915242","32915326","chr10","37960614","37960698","0","5045372"
"chr2","32915393","32915476","chr10","37960465","37960548","2","5045072"
"chr2","32918427","32918734","chr7","25185886","25186189","64","7732541"
"chr2","32928469","32928592","chr2","47509577","47509704","24","14581108"
"chr2","32940336","32940618","chr10","37935691","37935970","4","4995355"
"chr2","32942047","32942333","chr10","37934548","37934834","9","4992501"
"chr2","32960184","32960388","chr2","113767336","113767527","44","80807152"
"chr2","32960745","32961015","chr10","37916146","37916436","29","4955401"
"chr2","32966358","32966670","chr10","37910168","37910482","15","4943810"
"chr2","32975095","32975382","chr10","37901387","37901684","18","4926292"
"chr2","32981958","32982125","chr16","69600142","69600306","29","36618184"
"chr2","32989960","32990113","chr10","37885625","37885802","27","4895665"
"chr2","32994855","32994920","chr10","37881033","37881097","2","4886178"
"chr2","32995519","32995820","chr10","37880127","37880443","20","4884608"
"chr2","32999261","32999424","chr9","37728872","37729024","44","4729611"
"chr2","33002260","33002544","chr7","38191002","38191287","57","5188742"
"chr2","33007526","33007810","chr5","33703173","33703447","50","695647"
"chr2","33010485","33010547","chr10","37864906","37864967","4","4854421"
"chr2","33014481","33014605","chr10","37860025","37860149","8","4845544"
"chr2","33014839","33014932","chr10","37859702","37859789","12","4844863"
"chr2","33015230","33015433","chr10","37859197","37859399","4","4843967"
"chr2","33018804","33018867","chr9","26325629","26325688","21","6693175"
"chr2","33018968","33019285","chr20","622680","623014","77","32396288"
"chr2","33022560","33022868","chr10","37851623","37851929","12","4829063"
"chr2","33026358","33026643","chr10","37844162","37844444","9","4817804"
"chr2","33027166","33027338","chr10","37843467","37843635","9","4816301"
"chr2","33027429","33027630","chr10","37842888","37843079","12","4815459"
"chr2","33027927","33028054","chr10","37842465","37842592","1","4814538"
"chr2","33030668","33030991","chr10","37839172","37839455","48","4808504"
"chr2","33035407","33035704","chr10","37833613","37833903","16","4798206"
"chr2","33038371","33038492","chr1","113701135","113701250","30","80662764"
"chr2","33038533","33038721","chr11","65274947","65275125","46","32236414"
"chr2","33040108","33040425","chr10","37829357","37829663","18","4789249"
"chr2","33050761","33050832","chr10","37820695","37820766","2","4769934"
"chr2","33053443","33053594","chr10","37817722","37817873","7","4764279"
"chr2","33053858","33053991","chr10","37817324","37817454","4","4763466"
"chr2","33056318","33056353","chr6","83048189","83048225","6","49991871"
"chr2","33071068","33071364","chr10","37801060","37801346","17","4729992"
"chr2","33086511","33086626","chr10","37786444","37786559","1","4699933"
"chr2","33091396","33091683","chr10","37781355","37781650","16","4689959"
"chr2","33091695","33091869","chr10","37781169","37781345","7","4689474"
"chr2","33091913","33092026","chr10","37781012","37781125","4","4689099"
"chr2","33092776","33093092","chr10","37779944","37780267","17","4687168"
"chr2","33103600","33103901","chr10","37769109","37769412","9","4665509"
"chr2","33104629","33104769","chr10","37768221","37768361","4","4663592"
"chr2","33108156","33108433","chr10","37764664","37764949","27","4656508"
"chr2","33121683","33121992","chr10","37751424","37751731","11","4629741"
"chr2","33127123","33127401","chr10","37746028","37746306","3","4618905"
"chr2","33136217","33136529","chr10","37736752","37737059","16","4600535"
"chr2","33143007","33143322","chr1","130517517","130517816","69","97374510"
"chr2","33157230","33157516","chr10","37716097","37716378","12","4558867"
"chr2","33161259","33161546","chr10","37712048","37712344","15","4550789"
"chr2","33214771","33214937","chrX","138367397","138367560","31","105152626"
"chr2","33214972","33215084","chr4","6825919","6826030","19","26389053"
"chr2","33215169","33215349","chr10","37658317","37658510","13","4443148"
"chr2","33218547","33218754","chr10","37654930","37655137","10","4436383"
"chr2","33227282","33227591","chr10","37646715","37647007","20","4419433"
"chr2","33232492","33232788","chr10","37641511","37641822","24","4409019"
"chr2","33247499","33247791","chr10","37626452","37626743","6","4378953"
"chr2","33260164","33260448","chr10","37613813","37614097","2","4353649"
"chr2","33261007","33261312","chr10","37612947","37613250","12","4351940"
"chr2","33288261","33288571","chr10","37586035","37586329","20","4297774"
"chr2","33304156","33304451","chr10","37571843","37572147","17","4267687"
"chr2","33320787","33321062","chr2","44400493","44400771","52","11079706"
"chr2","33323041","33323329","chr10","37550644","37550932","6","4227603"
"chr2","33335944","33336264","chr6","124425016","124425321","81","91089072"
"chr2","33358322","33358614","chr10","37514959","37515251","11","4156637"
"chr2","33375908","33376177","chr20","38674730","38675011","64","5298822"
"chr2","33406480","33406760","chr10","37463769","37464060","15","4057289"
"chr2","33415444","33415720","chr10","37454766","37455076","43","4039322"
"chr2","33519452","33519719","chr10","23327960","23328230","50","10191492"
"chr2","33534759","33534948","chr20","4756426","4756604","43","28778333"
"chr2","33537185","33537498","chr10","35641521","35641829","8","2104336"
"chr2","33544976","33545295","chr10","35649219","35649540","8","2104243"
"chr2","33545904","33546208","chr10","35650149","35650453","8","2104245"
"chr2","33564359","33564657","chr10","35668635","35668923","14","2104276"
"chr2","33568725","33569032","chr10","35673012","35673318","9","2104287"
"chr2","33575517","33575826","chr10","35679937","35680242","9","2104420"
"chr2","33588335","33588391","chr10","35692332","35692386","2","2103997"
"chr2","33597441","33597544","chr10","35701268","35701370","4","2103827"
"chr2","33598607","33598905","chr10","35702742","35703043","4","2104135"
"chr2","33611733","33612059","chr10","35716152","35716449","32","2104419"
"chr2","33617105","33617359","chr8","68882795","68883049","50","35265690"
"chr2","33618859","33618984","chr12","57945501","57945626","23","24326642"
"chr2","33621356","33621664","chr10","35722497","35722806","9","2101141"
"chr2","33625558","33625672","chr10","35726577","35726691","0","2101019"
"chr2","33652942","33653230","chr10","35753791","35754079","6","2100849"
"chr2","33654297","33654584","chr10","35755145","35755433","5","2100848"
"chr2","33657999","33658292","chr10","35758880","35759177","12","2100881"
"chr2","33662192","33662455","chr10","35763081","35763343","5","2100889"
"chr2","33671279","33671575","chr10","35774002","35774295","7","2102723"
"chr2","33675826","33676125","chr10","35778538","35778841","10","2102712"
"chr2","33690517","33690821","chr10","35793238","35793550","8","2102721"
"chr2","33711192","33711500","chr10","35813743","35814047","11","2102551"
"chr2","33720879","33721163","chr7","111446207","111446498","44","77725328"
"chr2","33732122","33732434","chr10","35837471","35837788","10","2105349"
"chr2","33737234","33737544","chr10","35839501","35839806","13","2102267"
"chr2","33742413","33742426","chr10","71215622","71215633","3","37473209"
"chr2","33742722","33742890","chr10","35844967","35845130","9","2102245"
"chr2","33769333","33769623","chr10","35872259","35872542","14","2102926"
"chr2","33772380","33772476","chr19","25480204","25480305","20","8292176"
"chr2","33774758","33774894","chr16","46715220","46715359","35","12940462"
"chr2","33778116","33778411","chr10","35882908","35883203","10","2104792"
"chr2","33803634","33803827","chr12","6886799","6886980","52","26916835"
"chr2","33807231","33807559","chr10","35917643","35917973","6","2110412"
"chr2","33814314","33814384","chr3","38739239","38739313","22","4924925"
"chr2","33817547","33817832","chr10","35929660","35929946","5","2112113"
"chr2","33823300","33823457","chr10","35937619","35937776","1","2114319"
"chr2","33823504","33823619","chr10","35937827","35937942","4","2114323"
"chr2","33830296","33830682","chr6","66186762","66187102","113","32356466"
"chr2","33833375","33833559","chr10","35948273","35948457","5","2114898"
"chr2","33855408","33855533","chr10","35970038","35970181","20","2114630"
"chr2","33869281","33869595","chr10","35985730","35986040","8","2116449"
"chr2","33880537","33880848","chr10","35991690","35992001","7","2111153"
"chr2","33883803","33883980","chr10","36000741","36000903","19","2116938"
"chr2","33884311","33884387","chr10","36002327","36002403","5","2118016"
"chr2","33886540","33886836","chr10","36004477","36004773","11","2117937"
"chr2","33890432","33890735","chr10","36008345","36008648","11","2117913"
"chr2","33894416","33894530","chr10","36012636","36012750","0","2118220"
"chr2","33894843","33895034","chr10","36013075","36013259","12","2118232"
"chr2","33915203","33915376","chr16","42030742","42030915","43","8115539"
"chr2","33918139","33918415","chr10","36037703","36037979","3","2119564"
"chr2","33918426","33918594","chr10","36037990","36038154","8","2119564"
"chr2","33928729","33929004","chr10","36048459","36048766","34","2119730"
"chr2","33929005","33929139","chr5","12262075","12262204","26","21666930"
"chr2","33944488","33944794","chr10","36065405","36065719","16","2120917"
"chr2","33947946","33948244","chr10","36068873","36069170","7","2120927"
"chr2","33959346","33959642","chr10","36079933","36080228","9","2120587"
"chr2","33964597","33964882","chr10","36085168","36085453","8","2120571"
"chr2","33970991","33971101","chr10","36092124","36092234","3","2121133"
"chr2","33975331","33975707","chr10","36096450","36096832","14","2121119"
"chr2","34003876","34004194","chr10","36125820","36126142","10","2121944"
"chr2","34006729","34007005","chr10","36128989","36129267","7","2122260"
"chr2","34017804","34017955","chr10","36139901","36140054","5","2122097"
"chr2","34027258","34027380","chr2","63595089","63595210","23","29567831"
"chr2","34027406","34027564","chr3","34083106","34083268","41","55700"
"chr2","34028456","34028583","chr10","36150195","36150308","14","2121739"
"chr2","34031421","34031709","chr10","36153160","36153422","32","2121739"
"chr2","34045473","34045783","chr10","36166969","36167277","6","2121496"
"chr2","34055787","34056089","chr10","36177620","36177914","13","2121833"
"chr2","34072050","34072293","chr10","36193781","36194024","5","2121731"
"chr2","34074158","34074444","chr10","36195887","36196174","6","2121729"
"chr2","34087136","34087527","chr8","95756411","95756772","117","61669275"
"chr2","34098917","34099192","chr10","36220429","36220703","6","2121512"
"chr2","34102546","34102831","chr10","36224398","36224683","5","2121852"
"chr2","34103816","34104108","chr10","36225666","36225960","6","2121850"
"chr2","34114697","34115013","chr10","36236758","36237061","18","2122061"
"chr2","34124606","34124722","chr10","36247319","36247435","5","2122713"
"chr2","34124749","34124924","chr10","36247459","36247627","13","2122710"
"chr2","34127200","34127416","chr10","36250239","36250455","5","2123039"
"chr2","34132031","34132310","chr10","36255089","36255369","4","2123058"
"chr2","34136518","34136616","chr10","36259411","36259506","4","2122893"
"chr2","34136651","34136796","chr10","36259554","36259701","3","2122903"
"chr2","34156538","34156826","chr10","36277495","36277783","4","2120957"
"chr2","34161773","34162071","chr10","36282739","36283037","4","2120966"
"chr2","34168958","34169265","chr10","36290038","36290311","45","2121080"
"chr2","34206014","34206300","chr10","36326249","36326533","19","2120235"
"chr2","34220587","34220897","chr10","36340110","36340415","12","2119523"
"chr2","34264443","34264748","chr10","36383517","36383823","6","2119074"
"chr2","34289444","34289752","chr10","36409494","36409800","22","2120050"
"chr2","34305272","34305578","chr10","36425025","36425329","9","2119753"
"chr2","34399497","34399804","chr3","157420204","157420510","55","123020707"
"chr2","34405133","34405372","chr10","36524803","36525031","21","2119670"
"chr2","34407544","34407734","chr10","36527145","36527335","2","2119601"
"chr2","34415085","34415231","chr11","44976604","44976745","26","10561519"
"chr2","34415803","34416101","chr10","36535508","36535807","7","2119705"
"chr2","34443245","34443506","chr10","36562968","36563229","2","2119723"
"chr2","34458403","34458524","chr10","36575285","36575403","11","2116882"
"chr2","34458827","34458980","chr10","36576010","36576177","20","2117183"
"chr2","34478181","34478368","chr10","36590552","36590714","29","2112371"
"chr2","34478668","34478797","JH680287","3994","4124","21","34474674"
"chr2","34479216","34479516","chr1","14767405","14767708","59","19711811"
"chr2","34500292","34500594","chr10","36613038","36613343","10","2112746"
"chr2","34500938","34501243","chr10","36613687","36613992","9","2112749"
"chr2","34504121","34504340","chr19","7681207","7681420","48","26822914"
"chr2","34523707","34524011","chr10","36637744","36638047","14","2114037"
"chr2","34528927","34529086","chr10","36640337","36640507","14","2111410"
"chr2","34566088","34566257","chr10","36678473","36678641","4","2112385"
"chr2","34570915","34571225","chr10","36683316","36683625","10","2112401"
"chr2","34586802","34587112","chr10","36699204","36699514","7","2112402"
"chr2","34630209","34630492","chr10","36742266","36742568","25","2112057"
"chr2","34633428","34633698","chr10","36745492","36745765","7","2112064"
"chr2","34639662","34639887","chr10","36751744","36751971","6","2112082"
"chr2","34642076","34642385","chr10","36754392","36754699","9","2112316"
"chr2","34650622","34650757","chr10","36762206","36762341","0","2111584"
"chr2","34651058","34651254","chr1","89414757","89414948","43","54763699"
"chr2","34656266","34656572","chr10","36768085","36768390","6","2111819"
"chr2","34658708","34659007","chr10","36770535","36770835","5","2111827"
"chr2","34675741","34676009","chr10","36788049","36788317","4","2112308"
"chr2","34680190","34680460","chr10","36792504","36792774","8","2112314"
"chr2","34681963","34682265","chr10","36794257","36794559","9","2112294"
"chr2","34696168","34696456","chr10","36817188","36817472","8","2121020"
"chr2","34714047","34714341","chr10","36835145","36835423","21","2121098"
"chr2","34717745","34718024","chrX","120356258","120356539","59","85638513"
"chr2","34723476","34723710","chr10","36845240","36845474","8","2121764"
"chr2","34780903","34781189","chr10","36903774","36904060","9","2122871"
"chr2","34804198","34804524","chr10","36931297","36931622","10","2127099"
"chr2","34817325","34817626","chr10","36939735","36940036","5","2122410"
"chr2","34871978","34872247","chr9","56456050","56456320","52","21584072"
"chr2","34892357","34892666","chr10","37064501","37064807","21","2172144"
"chr2","34906670","34906887","chr10","37078957","37079172","6","2172287"
"chr2","34908303","34908415","chr10","37079299","37079406","10","2170996"
"chr2","34910669","34910987","chr5","33855910","33856221","56","1054759"
"chr2","34952725","34953027","chr10","37123639","37123944","30","2170914"
"chr2","34999774","35000000","chr5","172667431","172667658","48","137667657"
"chr2","35012811","35013109","chr10","37184122","37184416","13","2171311"
"chr2","35015119","35015255","chr10","37186212","37186356","11","2171093"
"chr2","35015351","35015396","chr10","37186452","37186497","3","2171101"
"chr2","35032621","35032646","chr15","17841003","17841024","5","17191618"
"chr2","35032674","35032943","chr10","37205021","37205318","35","2172347"
"chr2","35062385","35062694","chr10","37234374","37234684","13","2171989"
"chr2","35179845","35179859","chr5","78083124","78083137","1","42903279"
"chr2","35179943","35180236","chr10","37352954","37353268","25","2173011"
"chr2","35205927","35206235","chr4","35026306","35026610","64","179621"
"chr2","35208153","35208452","chr15","93850264","93850563","68","58642111"
"chr2","35211590","35211887","chr10","58114464","58114763","18","22902874"
"chr2","35215644","35215819","chr19","29617749","29617917","32","5597895"
"chr2","35216179","35216399","chr10","58119043","58119267","8","22902864"
"chr2","35232198","35232501","chr7","37314940","37315240","64","2082742"
"chr2","35243733","35243965","chr10","58146925","58147160","9","22903192"
"chr2","35244942","35245001","chrX","45491347","45491400","12","10246405"
"chr2","35246961","35247259","chr10","58151914","58152208","26","22904953"
"chr2","35250261","35250554","chr10","58155224","58155514","11","22904963"
"chr2","35260344","35260647","chr6","126818576","126818881","60","91558232"
"chr2","35260746","35260869","chr10","58165450","58165573","6","22904704"
"chr2","35268378","35268691","chr14","18988612","18988922","62","16279766"
"chr2","35277984","35278295","chr10","58176891","58177200","14","22898907"
"chr2","35278299","35278441","chr10","58177204","58177344","5","22898905"
"chr2","35279921","35280214","chr10","58178822","58179116","11","22898901"
"chr2","35378882","35379166","chr10","33056808","33057092","3","2322074"
"chr2","35384331","35384614","chr10","33062255","33062538","4","2322076"
"chr2","35388672","35388976","chr10","33067086","33067389","9","2321586"
"chr2","35390259","35390550","chr10","33068670","33068963","7","2321589"
"chr2","35394578","35394873","chr10","33073346","33073641","12","2321232"
"chr2","35402785","35403052","chr10","33081857","33082124","6","2320928"
"chr2","35412011","35412182","chr10","33091770","33091940","2","2320241"
"chr2","35419776","35420080","chr10","33099851","33100151","8","2319925"
"chr2","35436778","35436996","chr10","33118324","33118521","28","2318454"
"chr2","35437878","35437937","chr10","33119389","33119448","0","2318489"
"chr2","35437940","35437988","chr6","148291297","148291342","7","112853357"
"chr2","35438154","35438395","chr10","33119665","33119905","2","2318489"
"chr2","35438785","35439105","chrX","44566163","44566473","60","9127378"
"chr2","35441784","35442080","chr10","33123642","33123952","24","2318142"
"chr2","35450440","35450749","chr10","33132457","33132765","8","2317983"
"chr2","35451512","35451788","chr11","50254076","50254361","59","14802564"
"chr2","35467625","35467869","chr10","33156388","33156637","14","2311237"
"chr2","35471581","35471743","chr10","33160348","33160507","4","2311233"
"chr2","35473480","35473645","chr19","5234935","5235087","38","30238545"
"chr2","35478130","35478398","chr1","64867733","64867995","46","29389603"
"chr2","35498982","35499286","chr10","33187331","33187637","17","2311651"
"chr2","35501523","35501823","chr10","33189877","33190177","7","2311646"
"chr2","35504598","35504765","chr10","33192958","33193129","9","2311640"
"chr2","35517251","35517547","chr10","33206451","33206741","11","2310800"
"chr2","35528465","35528765","chr10","33217466","33217763","6","2310999"
"chr2","35535233","35535289","chr7","55940485","55940543","14","20405252"
"chr2","35535290","35535447","chr10","33229906","33230064","5","2305384"
"chr2","35543796","35543991","chr1","41266660","41266863","54","5722864"
"chr2","35552370","35552688","chr10","33247594","33247912","9","2304776"
"chr2","35560810","35560980","chr3","88036953","88037106","50","52476143"
"chr2","35610651","35610791","chr13","87642991","87643131","8","52032340"
"chr2","35727242","35727536","chr10","32827994","32828279","29","2899248"
"chr2","35776668","35776891","chr10","32776690","32776917","12","2999978"
"chr2","35803145","35803437","chr10","32751459","32751782","42","3051686"
"chr2","35806901","35807194","chr10","32747715","32748014","11","3059186"
"chr2","35865833","35866114","chr10","32690587","32690870","21","3175246"
"chr2","35872663","35872835","chr5","23452414","23452564","50","12420249"
"chr2","35874132","35874424","chr10","32682443","32682733","13","3191689"
"chr2","35904553","35904857","chr10","32650547","32650852","9","3254006"
"chr2","35910864","35910981","chr16","50725703","50725815","17","14814839"
"chr2","35914275","35914540","chr10","32640905","32641170","7","3273370"
"chr2","35922085","35922374","chr10","32632973","32633228","37","3289112"
"chr2","35923758","35924055","chr10","32631303","32631583","23","3292455"
"chr2","35924135","35924262","chr10","32631076","32631203","5","3293059"
"chr2","35937836","35938133","chr10","32610776","32611080","13","3327060"
"chr2","35942863","35943029","chr2","62431728","62431895","27","26488865"
"chr2","35943324","35943452","chr9","61018962","61019094","22","25075638"
"chr2","35949727","35950027","chr10","32603783","32604088","10","3345944"
"chr2","35953979","35954142","chr2","187026390","187026555","42","151072411"
"chr2","35970456","35970604","chr1","131071330","131071474","40","95100874"
"chr2","35978191","35978326","chr10","32559799","32559934","1","3418392"
"chr2","35978614","35978695","chr10","32559420","32559501","3","3419194"
"chr2","35982978","35983283","chr1","48055886","48056174","78","12072908"
"chr2","35985794","35986080","chr10","32565849","32566135","5","3419945"
"chr2","36002044","36002340","chr10","32546183","32546476","9","3455861"
"chr2","36003175","36003438","chr10","32545084","32545347","8","3458091"
"chr2","36013650","36013919","chr10","32526295","32526564","5","3487355"
"chr2","36014186","36014351","chr10","32525861","32526028","6","3488325"
"chr2","36024409","36024718","chr10","32521739","32522048","9","3502670"
"chr2","36051507","36051580","chr16","19265400","19265474","23","16786107"
"chr2","36052723","36053022","chr10","32490041","32490341","6","3562682"
"chr2","36067530","36067818","chr10","32473422","32473704","10","3594108"
"chr2","36068935","36069234","chr10","32472218","32472523","12","3596717"
"chr2","36075771","36076025","chr10","32465114","32465369","16","3610657"
"chr2","36076829","36077135","chr10","32463993","32464298","3","3612836"
"chr2","36084342","36084622","chr10","32455837","32456123","17","3628505"
"chr2","36119278","36119529","chr5","35333761","35334004","70","785517"
"chr2","36120056","36120278","chr10","32419453","32419661","17","3700603"
"chr2","36122642","36122752","chr10","32415902","32416012","1","3706740"
"chr2","36123032","36123194","chr5","4584887","4585053","32","31538145"
"chr2","36123733","36124013","chr10","32421234","32421518","10","3702499"
"chr2","36128530","36128797","chr10","32411655","32411932","15","3716875"
"chr2","36129215","36129369","chr10","32411089","32411243","4","3718126"
"chr2","36136739","36136927","chr10","32403836","32404026","6","3732903"
"chr2","36155765","36156049","chr10","32385728","32386012","4","3770037"
"chr2","36156529","36156710","chr10","32385066","32385241","8","3771463"
"chr2","36159373","36159677","chr10","32381445","32381749","7","3777928"
"chr2","36160076","36160374","chr10","32380742","32381039","6","3779334"
"chr2","36173618","36173903","chr10","32367537","32367825","8","3806081"
"chr2","36174565","36174828","chr10","32366611","32366873","3","3807954"
"chr2","36242026","36242198","chr10","32296896","32297033","41","3945130"
"chr2","36242199","36242433","chr10","32296659","32296896","7","3945540"
"chr2","36260427","36260551","chr10","32278596","32278720","1","3981831"
"chr2","36269908","36270042","chr12","93481566","93481700","24","57211658"
"chr2","36290385","36290535","chr10","32247914","32248061","6","4042471"
"chr2","36290882","36291185","chr10","32247268","32247569","3","4043614"
"chr2","36292349","36292654","chr10","32245788","32246090","8","4046561"
"chr2","36303459","36303764","chr10","32235858","32236149","19","4067601"
"chr2","36307002","36307287","chr10","32232317","32232640","43","4074685"
"chr2","36321030","36321329","chr10","32218049","32218348","6","4102981"
"chr2","36342662","36342931","chr10","32196192","32196461","3","4146470"
"chr2","36347625","36347877","chr10","32191109","32191375","16","4156516"
"chr2","36368261","36368569","chr10","32170087","32170394","12","4198174"
"chr2","36401708","36402015","chr10","32137479","32137782","15","4264229"
"chr2","36409922","36410181","chr10","32129378","32129636","4","4280544"
"chr2","36457542","36457840","chr10","32081303","32081601","6","4376239"
"chr2","36464388","36464671","chr10","32074429","32074712","1","4389959"
"chr2","36494131","36494418","chr10","32044173","32044460","3","4449958"
"chr2","36502041","36502349","chr10","32036153","32036457","7","4465888"
"chr2","36538333","36538564","chr10","31994959","31995190","3","4543374"
"chr2","36540790","36541100","chr10","31992382","31992685","16","4548408"
"chr2","36567387","36567681","chr10","31970440","31970736","7","4596947"
"chr2","36603316","36603627","chr10","31934111","31934420","9","4669205"
"chr2","36609770","36610066","chr10","31927372","31927668","4","4682398"
"chr2","36611547","36611839","chr10","31925593","31925885","5","4685954"
"chr2","36614066","36614359","chr10","31923098","31923368","27","4690968"
"chr2","36620633","36620755","chr10","31917068","31917190","3","4703565"
"chr2","36627819","36628182","chr10","31909332","31909698","13","4718487"
"chr2","36629159","36629331","chr10","31908037","31908204","7","4721122"
"chr2","36629789","36630057","chr10","31907315","31907579","8","4722474"
"chr2","36630811","36630964","chr10","31906406","31906562","5","4724405"
"chr2","36631264","36631301","chr10","31906076","31906111","2","4725188"
"chr2","36631600","36631724","chr10","31905652","31905778","8","4725948"
"chr2","36636390","36636705","chr10","31900801","31901116","7","4735589"
"chr2","36638571","36638859","chr10","31899002","31899293","11","4739569"
"chr2","36639820","36639943","chr4","33514863","33514986","16","3124957"
"chr2","36642002","36642289","chr10","31895806","31896094","7","4746196"
"chr2","36646047","36646358","chr12","101848701","101849011","49","65202654"
"chr2","36651745","36652051","chr10","31891455","31891767","13","4760290"
"chr2","36671230","36671510","chr6","113172866","113173152","53","76501636"
"chr2","36671570","36671892","chr10","31864685","31864999","36","4806885"
"chr2","36683196","36683364","chr7","65916701","65916865","35","29233505"
"chr2","36687373","36687679","chrX","120625866","120626177","70","83938493"
"chr2","36691728","36692030","chr10","31848368","31848669","5","4843360"
"chr2","36697268","36697563","chr10","31842822","31843117","8","4854446"
"chr2","36704295","36704604","chr7","147310304","147310607","55","110606009"
"chr2","36711934","36712137","chr10","31824679","31824886","8","4887255"
"chr2","36712837","36713142","chr10","31823380","31823678","19","4889457"
"chr2","36715180","36715337","chr10","31821200","31821336","24","4893980"
"chr2","36715627","36715780","chr10","31820757","31820909","6","4894870"
"chr2","36731029","36731186","chr11","110402020","110402179","28","73670991"
"chr2","36741087","36741401","chr10","31796639","31796953","5","4944448"
"chr2","36748611","36748900","chrX","15783794","15784082","55","20964817"
"chr2","36751337","36751609","chr10","31787903","31788175","8","4963434"
"chr2","36752811","36753099","chr9","56456050","56456320","71","19703239"
"chr2","36754744","36755049","chr10","31784509","31784813","5","4970235"
"chr2","36756067","36756368","chr10","31783211","31783509","14","4972856"
"chr2","36778832","36779087","chr10","31760496","31760751","9","5018336"
"chr2","36779976","36780260","chr10","31759318","31759604","8","5020658"
"chr2","36781182","36781454","chr10","31758114","31758403","31","5023068"
"chr2","36849624","36849891","chr10","31690001","31690267","7","5159623"
"chr2","36860202","36860366","chr8","8098939","8099101","29","28761263"
"chr2","36866919","36867161","chr10","31672425","31672666","9","5194494"
"chr2","36869729","36870033","chr10","31669561","31669869","12","5200168"
"chr2","36878151","36878457","chr10","31661920","31662214","34","5216231"
"chr2","36908111","36908440","chr10","31630448","31630782","12","5277663"
"chr2","36915875","36916114","chr5","21840062","21840305","57","15075813"
"chr2","36916223","36916289","chr1","6641003","6641065","8","30275220"
"chr2","36920997","36921286","chr10","31617720","31618009","3","5303277"
"chr2","36931983","36932253","chr10","31607000","31607270","7","5324983"
"chr2","36936029","36936197","chr10","31602902","31603070","1","5333127"
"chr2","36962401","36962700","chr10","31574691","31574984","13","5387710"
"chr2","36963895","36964184","chrX","120684016","120684310","57","83720121"
"chr2","36967358","36967639","chr10","31568412","31568729","39","5398946"
"chr2","36978979","36979297","chr10","31559592","31559914","9","5419387"
"chr2","36998639","36998776","chr4","114009314","114009449","25","77010675"
"chr2","37000964","37001216","chr10","31538232","31538484","7","5462732"
"chr2","37006000","37006314","chr10","31533079","31533395","17","5472921"
"chr2","37011130","37011322","chr10","31528344","31528536","2","5482786"
"chr2","37017870","37018154","chr10","31520893","31521205","32","5496977"
"chr2","37022242","37022466","chr10","31514134","31514358","1","5508108"
"chr2","37027608","37027895","chr10","31508688","31508999","28","5518920"
"chr2","37042605","37042788","chr11","66104687","66104863","31","29062082"
"chr2","37042804","37043115","chr10","31493508","31493817","11","5549296"
"chr2","37058623","37058792","chr10","31481443","31481612","2","5577180"
"chr2","37067547","37067690","chr10","31473394","31473541","8","5594153"
"chr2","37067782","37067959","chr10","31473129","31473306","9","5594653"
"chr2","37089907","37090000","chr17","77491750","77491842","15","40401843"
"chr2","37090025","37090328","chr10","31448435","31448737","3","5641590"
"chr2","37090347","37090653","chr10","31448106","31448416","9","5642241"
"chr2","37094471","37094701","chr10","31443132","31443362","4","5651339"
"chr2","37097131","37097437","chr12","93674950","93675246","59","56577819"
"chr2","37101117","37101424","chr8","76693606","76693909","56","39592489"
"chr2","37102275","37102414","chr10","31428297","31428436","1","5673978"
"chr2","37102713","37102869","chr10","31427839","31427995","3","5674874"
"chr2","37112597","37112724","chr10","31420501","31420635","16","5692096"
"chr2","37124994","37125294","chr17","74036630","74036927","64","36911636"
"chr2","37160828","37161096","chr10","31369171","31369439","10","5791657"
"chr2","37168703","37168775","chr10","31361502","31361572","5","5807201"
"chr2","37176216","37176319","chr10","31353938","31354036","6","5822278"
"chr2","37176707","37176815","chr10","31353437","31353548","4","5823270"
"chr2","37178693","37178984","chr10","31351258","31351549","7","5827435"
"chr2","37187204","37187312","chr10","31353437","31353548","4","5833767"
"chr2","37189190","37189481","chr10","31351258","31351549","7","5837932"
"chr2","37193957","37194113","chr8","40804523","40804676","31","3610566"
"chr2","37197200","37197469","chr10","31343782","31344051","1","5853418"
"chr2","37203590","37203877","chr10","31332642","31332929","6","5870948"
"chr2","37203887","37204058","chr10","76870098","76870247","31","39666211"
"chr2","37206164","37206457","chr10","31327394","31327660","31","5878770"
"chr2","37211884","37212177","chr10","31327394","31327660","31","5884490"
"chr2","37222771","37223079","chr8","24917586","24917896","72","12305185"
"chr2","37228546","37228700","chr10","31309873","31310037","14","5918673"
"chr2","37230303","37230433","chr10","31309425","31309557","11","5920878"
"chr2","37232366","37232500","chr1","13051263","13051399","22","24181103"
"chr2","37237386","37237644","chr10","31300286","31300551","22","5937100"
"chr2","37239546","37239846","chr10","31298096","31298395","8","5941450"
"chr2","37243234","37243429","chr10","31294990","31295189","12","5948244"
"chr2","37243508","37243527","chr1","1498200","1498214","9","35745308"
"chr2","37250002","37250317","chr10","31288108","31288414","14","5961894"
"chr2","37252986","37253287","chr10","31285137","31285431","16","5967849"
"chr2","37254296","37254590","chr10","31283834","31284126","7","5970462"
"chr2","37254591","37254686","chr9","79667891","79667989","25","42413300"
"chr2","37266656","37266740","chr9","13509590","13509671","18","23757066"
"chr2","37275052","37275262","chr10","31262976","31263186","10","6012076"
"chr2","37310563","37310867","chr10","31215196","31215499","8","6095367"
"chr2","37369246","37369524","chr10","31170386","31170664","9","6198860"
"chr2","37371728","37372026","chr10","31167882","31168180","9","6203846"
"chr2","37433167","37433447","chr10","31105730","31106010","5","6327437"
"chr2","37469443","37469738","chr10","31072949","31073244","10","6396494"
"chr2","37488193","37488472","chr10","31053269","31053578","45","6434924"
"chr2","37514142","37514437","chr10","31027273","31027568","7","6486869"
"chr2","37540626","37540930","chr10","30999552","30999843","17","6541074"
"chr2","37568078","37568346","chr10","30970834","30971102","6","6597244"
"chr2","37601550","37601841","chr10","30936548","30936839","6","6665002"
"chr2","37622609","37622915","chr10","30915449","30915751","5","6707160"
"chr2","37629799","37630103","chr10","30907821","30908124","4","6721978"
"chr2","37644446","37644725","chr10","30892235","30892514","12","6752211"
"chr2","37647331","37647620","chr10","30889650","30889939","4","6757681"
"chr2","37664375","37664624","chr10","30871658","30871908","12","6792717"
"chr2","37666742","37667013","chr10","30868969","30869253","19","6797773"
"chr2","37668641","37668799","chr7","53483520","53483679","24","15814879"
"chr2","37668845","37668873","chr5","4095836","4095866","6","33573009"
"chr2","37668882","37668913","chr5","4095836","4095866","5","33573046"
"chr2","37668979","37669062","chr20","63570083","63570164","21","25901104"
"chr2","37675948","37676239","chr10","30863702","30863995","8","6812246"
"chr2","37677185","37677430","chr10","30862509","30862758","6","6814676"
"chr2","37684245","37684551","chr10","30854728","30855020","23","6829517"
"chr2","37689913","37690116","chr10","30848839","30849042","3","6841074"
"chr2","37692193","37692483","chr10","30846512","30846808","13","6845681"
"chr2","37693296","37693602","chr10","30845086","30845392","7","6848210"
"chr2","37696414","37696715","chr10","30841790","30842091","6","6854624"
"chr2","37699618","37699680","chr10","30838686","30838748","4","6860932"
"chr2","37700824","37701124","chr10","30837426","30837726","4","6863398"
"chr2","37713251","37713470","chr10","30824593","30824810","11","6888658"
"chr2","37716038","37716216","chr7","127252042","127252214","32","89536004"
"chr2","37717511","37717815","chr10","30816731","30817035","6","6900780"
"chr2","37719365","37719651","chr10","30818375","30818654","12","6900990"
"chr2","37721342","37721643","chr10","30820532","30820824","22","6900810"
"chr2","37723706","37723919","chr10","30814572","30814786","2","6909134"
"chr2","37730313","37730324","chr1","41526213","41526224","1","3795900"
"chr2","37730924","37731103","chr10","30805995","30806173","14","6924929"
"chr2","37732890","37733168","chr10","30804016","30804246","51","6928874"
"chr2","37737837","37737984","chr10","30799179","30799326","3","6938658"
"chr2","37738649","37738774","chr10","30798389","30798513","4","6940260"
"chr2","37751544","37751844","chr10","30782236","30782533","11","6969308"
"chr2","37755516","37755727","chr10","30777740","30777948","11","6977776"
"chr2","37758327","37758625","chr10","30773852","30774160","13","6984475"
"chr2","37766919","37767207","chr10","30764924","30765212","4","7001995"
"chr2","37780583","37780671","chr10","30747614","30747702","0","7032969"
"chr2","37786146","37786284","chr10","30740775","30740906","9","7045371"
"chr2","37789135","37789425","chr10","30752668","30752957","4","7036467"
"chr2","37789441","37789573","chr7","130856224","130856355","25","93066783"
"chr2","37789609","37789717","chr11","3041400","3041514","21","34748209"
"chr2","37789791","37789889","JH681574","5539","5626","28","37784252"
"chr2","37790494","37790633","chr7","155375051","155375186","30","117584557"
"chr2","37815803","37816079","chr19","48370959","48371231","56","10555156"
"chr2","37816878","37817065","chr10","30705240","30705428","8","7111638"
"chr2","37819754","37819848","chr18","68971711","68971804","17","31151957"
"chr2","37820776","37820902","chr10","30701053","30701179","2","7119723"
"chr2","37824674","37824785","chr10","30697170","30697281","3","7127504"
"chr2","37830955","37831227","chr10","30690459","30690728","8","7140496"
"chr2","37835200","37835548","chr10","30685585","30685961","39","7149615"
"chr2","37861812","37862088","chr10","30659707","30659989","9","7202105"
"chr2","37869142","37869417","chr10","30652604","30652884","11","7216538"
"chr2","37870276","37870422","chr3","111337921","111338069","34","73467645"
"chr2","37876583","37876864","chr10","30645163","30645478","40","7231420"
"chr2","37902287","37902487","chr20","2647274","2647471","49","35255013"
"chr2","37914081","37914389","chr16","24873799","24874106","60","13040282"
"chr2","37915885","37916151","chr3","124339037","124339313","70","86423152"
"chr2","37916600","37916748","chr10","30604467","30604615","2","7312133"
"chr2","37917059","37917199","chr10","30604017","30604157","2","7313042"
"chr2","37926861","37927155","chr10","30594459","30594751","12","7332402"
"chr2","37930525","37930609","chr10","30591019","30591103","1","7339506"
"chr2","37932725","37933028","chr10","30588561","30588838","40","7344164"
"chr2","37935052","37935353","chr10","30586246","30586550","8","7348806"
"chr2","37943011","37943320","chr10","30577945","30578252","10","7365066"
"chr2","37948768","37948841","chr10","30572893","30572966","4","7375875"
"chr2","37981271","37981554","chr16","9651863","9652154","55","28329408"
"chr2","37997258","37997544","chr10","30525715","30525998","10","7471543"
"chr2","38015276","38015542","chr5","33703173","33703447","53","4312103"
"chr2","38038536","38038721","chr11","18689401","18689563","49","19349135"
"chr2","38044891","38045203","chr10","30478046","30478355","8","7566845"
"chr2","38045251","38045545","chr10","30477713","30477996","15","7567538"
"chr2","38049948","38050247","chr10","30473071","30473368","3","7576877"
"chr2","38052593","38052722","chr10","30470610","30470736","5","7581983"
"chr2","38059495","38059792","chr2","78493440","78493742","54","40433945"
"chr2","38063121","38063397","chr10","30459835","30460111","5","7603286"
"chr2","38064546","38064856","chr10","30458111","30458416","13","7606435"
"chr2","38070452","38070717","chr10","30452387","30452680","33","7618065"
"chr2","38082015","38082187","chr11","6988011","6988177","30","31094004"
"chr2","38090621","38090932","chr5","142565235","142565540","43","104474614"
"chr2","38105971","38106248","chr10","30415175","30415477","36","7690796"
"chr2","38107489","38107640","chr10","30413800","30413951","7","7693689"
"chr2","38107937","38108072","chr10","30413372","30413502","9","7694565"
"chr2","38115341","38115488","chrX","56752692","56752834","36","18637351"
"chr2","38115783","38115918","chr3","45484155","45484296","31","7368372"
"chr2","38122904","38123137","chr10","30398335","30398568","10","7724569"
"chr2","38156748","38157048","chr10","30364206","30364509","9","7792542"
"chr2","38159501","38159620","chrX","121071223","121071342","20","82911722"
"chr2","38159665","38159838","chr3","42298682","42298860","32","4139017"
"chr2","38163719","38163902","chr10","30357806","30357989","4","7805913"
"chr2","38164198","38164338","chr10","30357370","30357510","3","7806828"
"chr2","38168450","38168736","chr11","12635787","12636070","48","25532663"
"chr2","38175418","38175685","chr10","30343704","30343952","25","7831714"
"chr2","38176639","38176930","chr10","30342429","30342713","19","7834210"
"chr2","38179573","38179749","chr1","14122728","14122905","33","24056845"
"chr2","38180045","38180188","chr14","118812059","118812202","18","80632014"
"chr2","38194889","38195210","chr10","30325811","30326101","35","7869078"
"chr2","38196729","38197036","chr10","30323625","30323922","16","7873104"
"chr2","38217932","38218238","chr10","30302587","30302844","59","7915345"
"chr2","38243911","38244079","chr10","30277756","30277924","0","7966155"
"chr2","38263317","38263608","chr10","30256989","30257281","5","8006328"
"chr2","38266932","38267231","chr10","30253684","30253985","4","8013248"
"chr2","38269730","38269967","chr10","30250950","30251187","1","8018780"
"chr2","38293135","38293354","chr10","30229254","30229470","11","8063881"
"chr2","38301133","38301422","chr10","30221212","30221500","14","8079921"
"chr2","38363977","38364138","chr19","4066487","4066651","32","34297490"
"chr2","38369349","38369649","chr10","51488295","51488589","65","13118946"
"chr2","38385280","38385577","chr10","30134089","30134394","9","8251191"
"chr2","38385786","38386063","chr10","30133610","30133887","5","8252176"
"chr2","38412206","38412508","chr15","22258204","22258505","43","16154002"
"chr2","38432438","38432725","chr13","8013742","8014045","60","30418696"
"chr2","38466997","38467100","chr9","55667711","55667807","23","17200714"
"chr2","38501935","38502241","chr10","30020950","30021256","7","8480985"
"chr2","38505492","38505806","chr10","30017069","30017381","11","8488423"
"chr2","38508020","38508307","chr17","31302062","31302355","52","7205958"
"chr2","38520927","38521222","chr10","30001295","30001591","11","8519632"
"chr2","38522432","38522737","chr1","115286446","115286750","47","76764014"
"chr2","38541662","38541825","chr10","29981190","29981353","3","8560472"
"chr2","38554855","38554963","chr10","29968877","29968985","1","8585978"
"chr2","38556143","38556306","chr2","86795301","86795463","28","48239158"
"chr2","38558039","38558328","chr10","29965228","29965505","14","8592811"
"chr2","38564772","38565071","chr10","29958186","29958472","19","8606586"
"chr2","38565218","38565512","chr10","29957745","29958039","6","8607473"
"chr2","38572064","38572345","chr10","29950462","29950743","8","8621602"
"chr2","38586741","38587010","chr10","29935133","29935397","21","8651608"
"chr2","38615891","38616042","chr10","29903427","29903605","31","8712464"
"chr2","38628306","38628516","chr10","29896710","29896919","5","8731596"
"chr2","38628835","38629093","chr11","121352926","121353191","54","82724091"
"chr2","38632265","38632461","chr10","29895057","29895265","16","8737208"
"chr2","38635309","38635616","chr10","29886789","29887096","3","8748520"
"chr2","38637726","38638034","chr10","29884369","29884677","1","8753357"
"chr2","38638401","38638693","chr14","7580044","7580328","65","31058357"
"chr2","38643636","38643757","chr10","29878177","29878309","13","8765459"
"chr2","38652364","38652690","chr10","29868023","29868350","11","8784341"
"chr2","38662401","38662563","chr10","29858480","29858642","3","8803921"
"chr2","38669452","38669531","chr7","129187735","129187815","20","90518283"
"chr2","38669760","38669898","chr6","131494129","131494271","24","92824369"
"chr2","38672836","38673127","chr9","42493265","42493562","55","3820429"
"chr2","38674316","38674590","chr10","29847263","29847535","19","8827053"
"chr2","38674651","38674789","chrX","14387467","14387602","25","24287184"
"chr2","38677881","38678179","chr10","29842810","29843108","12","8835071"
"chr2","38684004","38684213","chr10","29838041","29838285","37","8845963"
"chr2","38685325","38685635","chr10","29836639","29836944","11","8848686"
"chr2","38689160","38689276","chr3","154543697","154543812","19","115854537"
"chr2","38689306","38689339","chr10","29832942","29832975","0","8856364"
"chr2","38690104","38690243","chr10","29832342","29832477","4","8857762"
"chr2","38694908","38695204","chr10","29827385","29827667","22","8867523"
"chr2","38695940","38696148","chr16","46842140","46842348","47","8146200"
"chr2","38700307","38700414","chr10","29821692","29821799","1","8878615"
"chr2","38700414","38700557","chr10","29821558","29821690","12","8878856"
"chr2","38705496","38705790","chr10","29816379","29816674","2","8889117"
"chr2","38712371","38712671","chr10","29809548","29809848","6","8902823"
"chr2","38713524","38713822","chr10","29808403","29808693","14","8905121"
"chr2","38721502","38721664","chr10","29800569","29800735","4","8920933"
"chr2","38726439","38726731","chr10","29795520","29795817","9","8930919"
"chr2","38731953","38732267","chr7","158585944","158586255","85","119853991"
"chr2","38738058","38738337","chr10","29783940","29784225","11","8954118"
"chr2","38738661","38738952","chr10","29783013","29783304","10","8955648"
"chr2","38742262","38742560","chr10","29779475","29779772","5","8962787"
"chr2","38744436","38744729","chr7","45349520","45349818","61","6605084"
"chr2","38757059","38757222","chr2","50687182","50687343","29","11930123"
"chr2","38757534","38757837","chr10","29764615","29764913","9","8992919"
"chr2","38759386","38759663","chr10","29762799","29763072","13","8996587"
"chr2","38762096","38762161","chr10","29760177","29760243","4","9001919"
"chr2","38762334","38762444","chr10","29759894","29760004","0","9002440"
"chr2","38762544","38762691","chr10","29759651","29759802","12","9002893"
"chr2","38773733","38774017","chr10","29747791","29748077","8","9025942"
"chr2","38777146","38777438","chr1","138961578","138961868","67","100184432"
"chr2","38790487","38790757","chr10","29730473","29730754","19","9060014"
"chr2","38798135","38798421","chr10","29721949","29722235","4","9076186"
"chr2","38803288","38803558","chr10","29716475","29716748","6","9086813"
"chr2","38817451","38817678","chr10","29702122","29702340","17","9115329"
"chr2","38818336","38818420","chr10","29701381","29701465","1","9116955"
"chr2","38820685","38820969","chr10","29698829","29699115","16","9121856"
"chr2","38822152","38822369","chr7","159803714","159803930","35","120981562"
"chr2","38836927","38837216","chr10","29682806","29683092","10","9154121"
"chr2","38837241","38837404","chr10","29682618","29682781","6","9154623"
"chr2","38838345","38838468","chr10","29681558","29681683","5","9156787"
"chr2","38838746","38838948","chr10","29681078","29681281","2","9157668"
"chr2","38845002","38845282","chr10","29674697","29674986","16","9170305"
"chr2","38862908","38863013","chr10","29656657","29656754","11","9206251"
"chr2","38880955","38881256","chr10","29638301","29638602","9","9242654"
"chr2","38891666","38891954","chr10","29626859","29627152","7","9264807"
"chr2","38892411","38892481","chr10","29626335","29626405","4","9266076"
"chr2","38892483","38892785","chr10","29626031","29626332","3","9266452"
"chr2","38896211","38896351","chr10","29622171","29622311","3","9274040"
"chr2","38897456","38897759","chr2","163495107","163495408","52","124597651"
"chr2","38906491","38906560","chr10","29611349","29611418","1","9295142"
"chr2","38913268","38913581","chr10","29605236","29605549","7","9308032"
"chr2","38913597","38913896","chr10","29604920","29605220","7","9308677"
"chr2","38931973","38932282","chr10","29585843","29586157","18","9346130"
"chr2","38940653","38940866","chr10","29575932","29576140","11","9364721"
"chr2","38946663","38946922","chr10","29569161","29569442","32","9377502"
"chr2","38947448","38947762","chr10","29568427","29568740","13","9379021"
"chr2","38950163","38950469","chr10","29565727","29566034","6","9384436"
"chr2","38953815","38954154","chr9","110926911","110927231","81","71973096"
"chr2","38955083","38955231","chr10","29560678","29560834","15","9394405"
"chr2","38958972","38959277","chr10","29556645","29556949","6","9402327"
"chr2","38962973","38963278","chr10","29552654","29552963","9","9410319"
"chr2","38966392","38966540","chrX","16522438","16522587","27","22443954"
"chr2","38967059","38967226","chr1","23367594","23367768","49","15599465"
"chr2","38969138","38969442","chr10","29546479","29546781","25","9422659"
"chr2","38970790","38970913","chr9","43471821","43471943","20","4501031"
"chr2","38970921","38971221","chr10","29544416","29544717","6","9426505"
"chr2","38977668","38977979","chr10","29537457","29537773","8","9440211"
"chr2","38979178","38979436","chr10","29535468","29535726","4","9443710"
"chr2","38979448","38979562","chr10","29535346","29535456","7","9444102"
"chr2","38981744","38982032","chr10","29531387","29531693","20","9450357"
"chr2","38985014","38985306","chr10","29528593","29528886","9","9456421"
"chr2","38986835","38987135","chr10","29529672","29529972","7","9457163"
"chr2","38999227","38999519","chr10","29520982","29521276","4","9478245"
"chr2","39030168","39030463","chr10","29490092","29490386","10","9540076"
"chr2","39045762","39046063","chr10","29473696","29473992","11","9572066"
"chr2","39058536","39058842","chr1","111241949","111242237","76","72183413"
"chr2","39066166","39066368","chr11","75214508","75214716","53","36148342"
"chr2","39071290","39071597","chr16","26045115","26045411","56","13026175"
"chr2","39079108","39079418","chr10","29438964","29439272","3","9640144"
"chr2","39085227","39085526","chr10","29433989","29434288","1","9651238"
"chr2","39095403","39095670","chr10","29428856","29429116","10","9666547"
"chr2","39097143","39097476","chr10","29421620","29421942","19","9675523"
"chr2","39104302","39104646","chr10","29414434","29414762","21","9689868"
"chr2","39105547","39105611","chr10","29413462","29413509","17","9692085"
"chr2","39105905","39106081","chr10","29412993","29413168","2","9692912"
"chr2","39124584","39124882","chr10","29393326","29393624","11","9731258"
"chr2","39127308","39127429","chr6","162438658","162438779","16","123311350"
"chr2","39127755","39128036","chr10","29390161","29390446","10","9737594"
"chr2","39132283","39132414","chr10","29385637","29385768","2","9746646"
"chr2","39132718","39132883","chr10","29385162","29385333","9","9747556"
"chr2","39135770","39135987","chr10","29382391","29382611","6","9753379"
"chr2","39138702","39139017","chr10","29379366","29379681","6","9759336"
"chr2","39139659","39139958","chr10","29378575","29378877","7","9761084"
"chr2","39141101","39141387","chr10","29377057","29377354","18","9764044"
"chr2","39142345","39142641","chr10","29375803","29376098","7","9766542"
"chr2","39143878","39144177","chr10","29373349","29373648","5","9770529"
"chr2","39145899","39146206","chr10","29371322","29371624","11","9774577"
"chr2","39149821","39150134","chr10","29367387","29367700","8","9782434"
"chr2","39160181","39160489","chr10","29357408","29357687","29","9802773"
"chr2","39161987","39162312","chr10","29355592","29355909","11","9806395"
"chr2","39169897","39170196","chr10","29347999","29348301","6","9821898"
"chr2","39173870","39174154","chr10","29344041","29344325","4","9829829"
"chr2","39184786","39185085","chr10","29332976","29333276","8","9851810"
"chr2","39188282","39188596","chr10","29329269","29329583","8","9859013"
"chr2","39189117","39189426","chr10","29328435","29328748","7","9860682"
"chr2","39198733","39198881","chr10","29318941","29319087","4","9879792"
"chr2","39205565","39205870","chr1","19461262","19461565","61","19744303"
"chr2","39207814","39208108","chr10","59443884","59444176","75","20236070"
"chr2","39212532","39212819","chr10","29304589","29304871","8","9907943"
"chr2","39235398","39235696","chr10","29282243","29282542","4","9953155"
"chr2","39277989","39278289","chr10","29240472","29240773","7","10037517"
"chr2","39324979","39325290","chr10","29192819","29193129","16","10132160"
"chr2","39342814","39343122","chr10","29174611","29174922","12","10168203"
"chr2","39350771","39351068","chr10","29166350","29166647","11","10184421"
"chr2","39365126","39365415","chr10","29153060","29153349","5","10212066"
"chr2","39378760","39379126","chr3","46330527","46330868","87","6951767"
"chr2","39380135","39380415","chr3","125030767","125031037","70","85650632"
"chr2","39383823","39384122","chr10","29132810","29133110","14","10251013"
"chr2","39387659","39387767","chr10","29129366","29129474","3","10258293"
"chr2","39387850","39388132","chr10","29129009","29129285","13","10258841"
"chr2","39388522","39388704","chr15","1504864","1505044","45","37883658"
"chr2","39405403","39405512","chr6","165327290","165327396","17","125921887"
"chr2","39405539","39405702","chr2","43232993","43233164","33","3827454"
"chr2","39411626","39411792","chr10","29108830","29108996","4","10302796"
"chr2","39413466","39413782","chr10","29105822","29106129","23","10307644"
"chr2","39415967","39416126","chr10","29103461","29103622","7","10312506"
"chr2","39416228","39416239","chr9","75783886","75783897","0","36367658"
"chr2","39416324","39416599","chr10","29102887","29103159","15","10313437"
"chr2","39425959","39426258","chr10","29094180","29094485","16","10331779"
"chr2","39428601","39428716","chr10","29091404","29091519","1","10337197"
"chr2","39429021","39429219","chr10","29090903","29091101","2","10338118"
"chr2","39434188","39434481","chr10","29085321","29085614","7","10348867"
"chr2","39440573","39440877","chr10","29078884","29079190","8","10361689"
"chr2","39448647","39448955","chr10","29071247","29071557","9","10377400"
"chr2","39459721","39460023","chr10","29060074","29060377","6","10399647"
"chr2","39470653","39470791","chr15","3262224","3262356","31","36208429"
"chr2","39472516","39472784","chr10","29047313","29047589","8","10425203"
"chr2","40488606","40488920","chr10","27462106","27462420","2","13026500"
"chr2","40587837","40588059","chr1","48386277","48386498","43","7798440"
"chr2","40699770","40700079","chr10","44546181","44546490","8","3846411"
"chr2","40704461","40704749","chr10","44550885","44551161","21","3846424"
"chr2","40705365","40705643","chr18","24851539","24851816","68","15853826"
"chr2","40721010","40721248","chr3","64364982","64365220","49","23643972"
"chr2","40816827","40817129","chr10","44663753","44664052","7","3846926"
"chr2","40900821","40901091","chr10","44746966","44747237","5","3846145"
"chr2","40971482","40971773","chr10","44817286","44817583","25","3845804"
"chr2","40977201","40977383","chr9","32368160","32368331","47","8609041"
"chr2","40977409","40977526","chrX","90545041","90545157","23","49567632"
"chr2","41191862","41192009","chr9","801634","801780","28","40390228"
"chr2","41192434","41192596","chr3","38028233","38028396","33","3164201"
"chr2","41193877","41194166","chr9","56489709","56489997","64","15295832"
"chr2","41195471","41195788","chr10","45041867","45042184","18","3846396"
"chr2","41268040","41268292","chr10","45116149","45116401","5","3848109"
"chr2","41540822","41541039","chr10","45385009","45385227","8","3844187"
"chr2","41544578","41544886","chr10","45388769","45389077","7","3844191"
"chr2","41639129","41639424","chr10","45478176","45478474","9","3839047"
"chr2","41801261","41801551","chr10","45641619","45641909","7","3840358"
"chr2","41889216","41889500","chr10","45726005","45726288","6","3836789"
"chr2","41988430","41988641","chr20","30892700","30892904","47","11095730"
"chr2","42035410","42035697","chr10","45881326","45881613","3","3845916"
"chr2","42075489","42075801","chr10","45919998","45920312","7","3844509"
"chr2","42130774","42131073","chr7","24667258","24667557","44","17463516"
"chr2","42173857","42174145","chr10","46018341","46018629","3","3844484"
"chr2","42256546","42256793","chr11","31468757","31469007","60","10787789"
"chr2","42278092","42278392","chr10","46125322","46125622","5","3847230"
"chr2","42454384","42454668","chr10","46307260","46307543","15","3852876"
"chr2","42459475","42459768","chr10","46312256","46312550","7","3852781"
"chr2","42483497","42483739","chr10","46337450","46337692","9","3853953"
"chr2","42554357","42554524","chr10","46418579","46418743","7","3864222"
"chr2","42562006","42562303","chr10","46426223","46426520","12","3864217"
"chr2","42562320","42562582","chr20","40406981","40407253","67","2155339"
"chr2","42623835","42624131","chr10","46488992","46489286","12","3865157"
"chr2","42644356","42644659","chr10","46508511","46508815","9","3864155"
"chr2","42656255","42656531","chr14","32043128","32043400","61","10613127"
"chr2","42664564","42664868","chr10","46528281","46528585","8","3863717"
"chr2","42669230","42669499","chr10","46532983","46533255","12","3863753"
"chr2","42681110","42681388","chr10","46545124","46545399","19","3864014"
"chr2","42694210","42694488","chr10","46558638","46558917","19","3864428"
"chr2","42709669","42709961","chr10","46573689","46573975","15","3864020"
"chr2","42742369","42742586","chr10","46607265","46607480","7","3864896"
"chr2","42751664","42751947","chr10","46615089","46615370","10","3863425"
"chr2","42752594","42752885","chr10","46616612","46616934","35","3864018"
"chr2","42765065","42765247","chr10","46629315","46629496","6","3864250"
"chr2","42801229","42801555","chr10","46656508","46656819","20","3855279"
"chr2","42801572","42801862","chr16","40134964","40135247","61","2666608"
"chr2","42823054","42823361","chr10","46677909","46678215","12","3854855"
"chr2","42856914","42857195","chr10","46711867","46712158","19","3854953"
"chr2","42878084","42878383","chr7","24667258","24667557","49","18210826"
"chr2","42910289","42910633","chr10","46766966","46767264","56","3856677"
"chr2","42932499","42932726","chr10","2191210","2191441","65","40741289"
"chr2","42938409","42938716","chr10","46793848","46794160","11","3855439"
"chr2","42957276","42957570","chr10","46812705","46813003","30","3855429"
"chr2","43049527","43049825","chr10","46908115","46908413","16","3858588"
"chr2","43196165","43196279","chr10","47057934","47058048","3","3861769"
"chr2","43196324","43196511","chr10","47058106","47058292","5","3861782"
"chr2","43218953","43219256","chr3","11962384","11962686","52","31256569"
"chr2","43280457","43280752","chr10","47140853","47141131","19","3860396"
"chr2","43290494","43290796","chr10","47150867","47151169","10","3860373"
"chr2","43291179","43291478","chr10","47151552","47151849","15","3860373"
"chr2","43335238","43335494","chr17","75333338","75333591","64","31998100"
"chr2","43424317","43424614","chr10","47288874","47289170","5","3864557"
"chr2","43627406","43627544","chr10","47498411","47498549","2","3871005"
"chr2","43651131","43651414","chr10","47522289","47522583","14","3871158"
"chr2","43673927","43674199","chr10","47545155","47545427","4","3871228"
"chr2","43711689","43711980","chr10","47582412","47582705","11","3870723"
"chr2","43821888","43822162","chr2","48551701","48551975","53","4729813"
"chr2","43823017","43823296","chr10","47694145","47694424","11","3871128"
"chr2","43840147","43840423","chr10","47710923","47711222","31","3870776"
"chr2","43869035","43869264","chr10","47739770","47739991","14","3870735"
"chr2","43870693","43871043","chr10","47741448","47741792","18","3870755"
"chr2","43889351","43889540","chr3","42064302","42064465","51","1825049"
"chr2","43893538","43893794","chr10","47764488","47764743","4","3870950"
"chr2","43897970","43898221","chr12","68299856","68300109","64","24401886"
"chr2","43963062","43963399","chr5","174518085","174518409","73","130555023"
"chr2","44044325","44044666","chr5","21126409","21126742","84","22917916"
"chr2","44116254","44116527","chr10","47984870","47985141","7","3868616"
"chr2","44117675","44117924","chr10","47986268","47986546","34","3868593"
"chr2","44299032","44299290","chr10","48171049","48171326","29","3872017"
"chr2","44314894","44315073","chr10","48186909","48187087","7","3872015"
"chr2","44315099","44315213","chr10","48187118","48187232","1","3872019"
"chr2","44344397","44344648","chr10","48216490","48216741","3","3872093"
"chr2","44382629","44382900","chr10","48254056","48254329","12","3871427"
"chr2","44441800","44441937","chr4","37524649","37524789","28","6917151"
"chr2","44475478","44475765","chr10","48348416","48348694","20","3872938"
"chr2","44489696","44489928","chr11","44714634","44714867","69","224938"
"chr2","44700980","44701288","chr10","48577051","48577356","7","3876071"
"chr2","44745777","44746052","chr10","48627191","48627469","11","3881414"
"chr2","44792137","44792408","chr1","93208213","93208447","73","48416076"
"chr2","45071971","45072254","chr10","48955174","48955451","15","3883203"
"chr2","45124873","45125165","chr10","49008839","49009096","37","3883966"
"chr2","45133608","45133923","chr10","49017311","49017623","15","3883703"
"chr2","45191266","45191479","chr10","49075424","49075637","3","3884158"
"chr2","45203740","45204030","chr7","80023535","80023829","48","34819795"
"chr2","45301449","45301579","chr10","49185678","49185808","1","3884229"
"chr2","45393981","45394269","chr8","10034943","10035230","55","35359038"
"chr2","45412899","45413178","chr10","49297788","49298065","14","3884889"
"chr2","45419186","45419478","chr10","49304078","49304367","7","3884892"
"chr2","45483355","45483615","chr1","139950695","139950963","61","94467340"
"chr2","45525162","45525477","chr9","106530616","106530926","71","61005454"
"chr2","45544317","45544610","chr5","97097926","97098207","73","51553609"
"chr2","45546959","45547229","chr10","49437308","49437573","8","3890349"
"chr2","45558820","45559042","chr10","49446574","49446795","16","3887754"
"chr2","45581683","45581915","chr10","49470035","49470260","10","3888352"
"chr2","45617456","45617634","chr7","80517313","80517495","35","34899857"
"chr2","45667959","45668229","chr10","49557139","49557411","14","3889180"
"chr2","45782440","45782721","chr9","90524786","90525060","68","44742346"
"chr2","45782766","45782779","chrX","44510769","44510781","1","1271997"
"chr2","45783579","45783883","chr11","27134052","27134352","64","18649527"
"chr2","45855644","45855935","chr6","28709057","28709328","38","17146587"
"chr2","45972488","45972697","chr10","49701039","49701241","18","3728551"
"chr2","45987752","45988053","chr10","49716895","49717188","20","3729143"
"chr2","45988118","45988264","chr14","3185257","3185403","26","42802861"
"chr2","45992976","45993078","chr10","56112880","56112983","20","10119904"
"chr2","45993270","45993417","chr19","697383","697526","36","45295887"
"chr2","46159643","46159892","chr10","49889027","49889304","35","3729384"
"chr2","46402900","46403197","chr10","50134511","50134816","24","3731611"
"chr2","46407599","46407878","chr10","50139195","50139510","49","3731596"
"chr2","46450121","46450414","chr3","39028401","39028699","60","7421720"
"chr2","46495052","46495341","chr10","50226223","50226526","19","3731171"
"chr2","46505690","46506010","chr10","50236946","50237243","32","3731256"
"chr2","46550706","46550875","chr10","50282988","50283161","8","3732282"
"chr2","46601604","46601885","chrX","4492963","4493240","52","42108641"
"chr2","46603195","46603505","chr10","50336611","50336923","9","3733416"
"chr2","46604922","46605032","chr3","67500454","67500564","20","20895532"
"chr2","46605086","46605262","chr2","132918545","132918717","38","86313459"
"chr2","46608087","46608388","chr10","50341333","50341631","11","3733246"
"chr2","46613500","46613577","chr10","22795109","22795181","19","23818391"
"chr2","46628909","46629211","chr20","63123965","63124258","72","16495056"
"chr2","46641881","46642236","chr10","50375668","50376023","6","3733787"
"chr2","46656287","46656442","chr9","92923276","92923427","27","46266989"
"chr2","46656443","46656613","chr1","113697359","113697521","35","67040916"
"chr2","46719846","46720004","chr19","14673246","14673394","49","32046600"
"chr2","46740340","46740694","chr10","50473800","50474104","63","3733460"
"chr2","46741221","46741516","chr10","50474631","50474926","6","3733410"
"chr2","46759650","46759955","chr10","50492998","50493297","15","3733348"
"chr2","46780231","46780457","chr10","50513997","50514223","9","3733766"
"chr2","46790234","46790550","chr10","50524393","50524697","21","3734159"
"chr2","46791807","46792131","chr10","50525953","50526270","11","3734146"
"chr2","46816324","46816621","chr10","50550657","50550955","11","3734333"
"chr2","46835858","46836144","chr10","50569899","50570185","8","3734041"
"chr2","46891969","46892057","chr10","50626720","50626803","8","3734751"
"chr2","46907077","46907364","chr10","50641796","50642084","14","3734719"
"chr2","46914887","46915158","chr10","50649558","50649845","38","3734671"
"chr2","46931149","46931461","chr10","50665902","50666209","10","3734753"
"chr2","46935636","46935936","chr10","50669547","50669847","9","3733911"
"chr2","46940012","46940177","chr11","122274374","122274548","46","75334362"
"chr2","46964883","46965194","chr10","50698431","50698742","5","3733548"
"chr2","46968615","46968895","chr10","50701827","50702107","12","3733212"
"chr2","46979875","46979968","chr10","50712930","50713013","10","3733055"
"chr2","46981672","46981958","chr10","50714704","50715017","37","3733032"
"chr2","47012933","47013217","chr5","72345461","72345731","72","25332528"
"chr2","47020252","47020286","chr1","198805795","198805828","5","151785543"
"chr2","47025039","47025240","chr7","132247001","132247195","46","85221962"
"chr2","47039240","47039537","chr10","50772540","50772840","9","3733300"
"chr2","47039546","47039867","chr10","50772849","50773153","22","3733303"
"chr2","47045971","47046267","chr10","50779224","50779521","8","3733253"
"chr2","47048696","47048978","chr7","26975056","26975341","53","20073640"
"chr2","47053382","47053678","chr10","50786296","50786590","12","3732914"
"chr2","47060625","47060856","chr10","50793536","50793767","5","3732911"
"chr2","47062540","47062670","chr10","50795273","50795389","16","3732733"
"chr2","47073839","47074124","chr10","50807544","50807831","14","3733705"
"chr2","47081971","47082184","chr10","50816329","50816542","5","3734358"
"chr2","47122618","47122799","chr10","50856336","50856517","6","3733718"
"chr2","47136687","47136971","chrX","56731261","56731541","53","9594574"
"chr2","47141677","47141982","chr3","12783650","12783947","59","34358027"
"chr2","47171942","47172166","chr10","50905887","50906113","7","3733945"
"chr2","47177177","47177332","chr10","50911141","50911298","7","3733964"
"chr2","47206598","47206914","chr10","50941678","50941974","31","3735080"
"chr2","47211989","47212108","chr10","50947016","50947135","7","3735027"
"chr2","47212419","47212600","chr10","50947450","50947632","5","3735031"
"chr2","47223404","47223621","chr10","50958433","50958648","4","3735029"
"chr2","47227391","47227500","chr1","139358754","139358864","28","92131363"
"chr2","47230704","47231006","chr10","50965762","50966065","8","3735058"
"chr2","47241533","47241812","chr10","50976300","50976579","10","3734767"
"chr2","47271532","47271833","chr10","51006911","51007211","3","3735379"
"chr2","47282290","47282414","chr10","51017572","51017695","5","3735282"
"chr2","47354457","47354659","chr10","51088252","51088481","32","3733795"
"chr2","47395136","47395426","chr14","7153919","7154206","59","40241217"
"chr2","47418973","47419094","chr10","51127964","51128085","3","3708991"
"chr2","47448478","47448778","chr10","51159580","51159880","12","3711102"
"chr2","47460615","47460917","chr10","51171386","51171692","9","3710771"
"chr2","47487606","47487914","chr10","51199661","51199973","12","3712055"
"chr2","47562521","47562786","chr10","51276833","51277106","13","3714312"
"chr2","47578056","47578314","chr10","51292663","51292921","7","3714607"
"chr2","47591160","47591301","chr10","51305506","51305664","19","3714346"
"chr2","47595487","47595780","chr10","51309834","51310130","11","3714347"
"chr2","47597664","47597950","chr10","51311914","51312195","9","3714250"
"chr2","47658957","47659249","chr10","51370333","51370627","18","3711376"
"chr2","47663595","47663710","chr10","51375271","51375386","6","3711676"
"chr2","47667935","47668100","chr3","159807816","159807973","29","112139881"
"chr2","47668557","47668688","chr1","196381119","196381250","24","148712562"
"chr2","47678447","47678753","chr7","159108069","159108371","49","111429622"
"chr2","47702398","47702688","chr10","51411907","51412198","9","3709509"
"chr2","47709318","47709600","chr3","9375353","9375637","56","38333965"
"chr2","47712765","47712894","chr10","51421649","51421778","0","3708884"
"chr2","47722687","47722991","chr10","51436722","51437027","8","3714035"
"chr2","47730801","47730959","chr10","51444852","51445025","19","3714051"
"chr2","47780366","47780601","chr10","51470946","51471181","6","3690580"
"chr2","47794809","47795093","chr10","51485367","51485650","12","3690558"
"chr2","47797765","47798075","chr10","51488295","51488589","28","3690530"
"chr2","47845177","47845480","chr10","51536643","51536949","10","3691466"
"chr2","47855040","47855309","chr10","51547829","51548084","29","3692789"
"chr2","47887952","47888254","chr10","51581386","51581688","7","3693434"
"chr2","47913147","47913224","chr10","51607274","51607352","2","3694127"
"chr2","47996119","47996231","chr10","51691597","51691709","2","3695478"
"chr2","48058627","48058929","chr10","51759423","51759721","14","3700796"
"chr2","48065880","48066190","chr10","51768425","51768741","17","3702545"
"chr2","48290277","48290441","chr10","51993893","51994042","19","3703616"
"chr2","48305781","48306073","chr10","52009284","52009594","25","3703503"
"chr2","48334873","48335168","chr10","52038592","52038886","8","3703719"
"chr2","48345503","48345805","chr4","7327839","7328133","65","41017664"
"chr2","48346993","48347274","chr10","52050812","52051095","7","3703819"
"chr2","48384621","48384912","chr6","42260255","42260550","53","6124366"
"chr2","48518167","48518291","chr5","159052477","159052589","39","110534310"
"chr2","48592422","48592728","chr10","52298573","52298885","25","3706151"
"chr2","48614298","48614609","chr10","52320526","52320837","12","3706228"
"chr2","48646528","48646827","chr12","96408497","96408795","74","47761969"
"chr2","48660064","48660366","chr10","52366606","52366906","9","3706542"
"chr2","48730246","48730499","chr10","52436478","52436745","20","3706232"
"chr2","48741620","48741926","chr10","52448193","52448477","50","3706573"
"chr2","48765134","48765435","chr10","52470817","52471119","8","3705683"
"chr2","48820063","48820367","chr10","52524808","52525109","17","3704745"
"chr2","48833046","48833315","chr10","52540014","52540282","15","3706968"
"chr2","48847707","48847862","chr10","52554777","52554940","11","3707070"
"chr2","48882970","48883081","chr5","44376152","44376269","25","4506818"
"chr2","48886080","48886388","chr10","52592813","52593122","10","3706733"
"chr2","48888440","48888582","chr3","146153164","146153310","40","97264724"
"chr2","48890689","48890980","chr10","52599372","52599659","12","3708683"
"chr2","48893359","48893629","chr10","52602046","52602317","11","3708687"
"chr2","48943408","48943587","chr10","52652455","52652633","14","3709047"
"chr2","48943893","48944025","chr10","52652935","52653067","3","3709042"
"chr2","48965473","48965626","chr10","52674439","52674592","3","3708966"
"chr2","48967583","48967878","chr10","52676813","52677109","20","3709230"
"chr2","48972380","48972678","chr10","52681943","52682242","11","3709563"
"chr2","48979122","48979392","chr10","52688637","52688919","15","3709515"
"chr2","49125187","49125475","chr10","52844513","52844793","14","3719326"
"chr2","49132281","49132602","chr10","52851859","52852182","22","3719578"
"chr2","49173808","49174099","chr10","52898820","52899112","12","3725012"
"chr2","49261191","49261510","chr10","52983441","52983759","10","3722250"
"chr2","49266587","49266870","chr10","52988846","52989129","11","3722259"
"chr2","49287131","49287422","chr10","53009761","53010052","12","3722630"
"chr2","49315787","49316074","chr10","53038191","53038477","6","3722404"
"chr2","49374682","49374952","chr10","53102100","53102383","22","3727418"
"chr2","49386123","49386348","chr10","53113867","53114109","19","3727744"
"chr2","49398572","49398847","chr10","53126314","53126589","6","3727742"
"chr2","49427113","49427400","chr10","53154567","53154855","9","3727454"
"chr2","49431657","49431960","chr10","53159104","53159405","7","3727447"
"chr2","49479965","49480271","chr10","53207160","53207454","16","3727195"
"chr2","49512275","49512446","chr6","160787805","160787970","45","111275530"
"chr2","49576749","49577002","chr10","53304768","53305009","18","3728019"
"chr2","49585186","49585460","chr10","53312493","53312769","6","3727307"
"chr2","49685510","49685809","chr10","53411401","53411699","10","3725891"
"chr2","49688943","49689037","chr10","53414803","53414898","7","3725860"
"chr2","49697347","49697636","chr10","53422892","53423181","3","3725545"
"chr2","49701033","49701168","chr10","53426589","53426724","2","3725556"
"chr2","49701466","49701631","chr10","53427022","53427190","14","3725556"
"chr2","49713937","49714235","chr10","53439625","53439923","6","3725688"
"chr2","49723933","49724233","chr10","53449762","53450062","3","3725829"
"chr2","49748194","49748285","chr10","53474131","53474222","2","3725937"
"chr2","49749136","49749460","chr10","53475082","53475398","15","3725946"
"chr2","49760015","49760275","chr10","53486040","53486302","5","3726025"
"chr2","49764741","49764915","chr10","53490781","53490955","7","3726040"
"chr2","49792640","49792940","chr10","53519163","53519472","19","3726523"
"chr2","49808281","49808569","chr10","53534931","53535230","22","3726650"
"chr2","49811094","49811355","chr10","53537763","53538024","14","3726669"
"chr2","49814148","49814324","chr14","62644580","62644753","37","12830432"
"chr2","49814632","49814763","chr10","53541352","53541483","8","3726720"
"chr2","49819900","49820179","chr10","53546710","53546996","16","3726810"
"chr2","49855357","49855666","chr10","53581795","53582113","20","3726438"
"chr2","49881602","49881881","chr10","53608196","53608479","20","3726594"
"chr2","49991997","49992145","chr3","155218912","155219045","49","105226915"
"chr2","50021753","50022057","chr10","53748866","53749181","28","3727113"
"chr2","50045912","50046198","chr10","53773552","53773839","10","3727640"
"chr2","50056051","50056361","chr10","11894916","11895224","65","38161135"
"chr2","50059004","50059297","chr10","53786883","53787176","9","3727879"
"chr2","50130199","50130416","chr10","53858863","53859076","9","3728664"
"chr2","50158230","50158522","chr10","53886783","53887082","16","3728553"
"chr2","50187430","50187731","chr7","49571405","49571710","47","616025"
"chr2","50191233","50191349","chr10","53918149","53918264","2","3726916"
"chr2","50205454","50205749","chr10","53933171","53933471","9","3727717"
"chr2","50211779","50212082","chr10","53943777","53944096","23","3731998"
"chr2","50219018","50219321","chr10","53943777","53944096","23","3724759"
"chr2","50227219","50227499","chr10","53952009","53952289","6","3724790"
"chr2","50241773","50241939","chr10","53966525","53966683","11","3724752"
"chr2","50244501","50244773","chr10","53969255","53969527","5","3724754"
"chr2","50247929","50248224","chr14","99480715","99481017","60","49232786"
"chr2","50251809","50252088","chr10","53975043","53975322","7","3723234"
"chr2","50260736","50261016","chr10","53984030","53984310","6","3723294"
"chr2","50267463","50267753","chr2","97499012","97499310","57","47231549"
"chr2","50274009","50274210","chr6","152469263","152469434","58","102195254"
"chr2","50279640","50279931","chr10","54003119","54003386","26","3723479"
"chr2","50281941","50282081","chr10","54005393","54005535","2","3723452"
"chr2","50298996","50299289","chr10","54023006","54023299","5","3724010"
"chr2","50304329","50304612","chr10","54028309","54028592","2","3723980"
"chr2","50333253","50333465","chr10","54057238","54057442","10","3723985"
"chr2","50348094","50348385","chr10","54071971","54072266","11","3723877"
"chr2","50390703","50391006","chr10","54115015","54115318","4","3724312"
"chr2","50404426","50404576","chr10","54128763","54128915","7","3724337"
"chr2","50404610","50404715","chr10","54128945","54129050","3","3724335"
"chr2","50406208","50406355","chr10","54130792","54130940","4","3724584"
"chr2","50406750","50406801","chr10","54131337","54131388","0","3724587"
"chr2","50435830","50436151","chr10","54160396","54160713","7","3724566"
"chr2","50465450","50465705","chr10","54190224","54190479","2","3724774"
"chr2","50589320","50589612","chr10","54314196","54314488","9","3724876"
"chr2","50612738","50613034","chr10","54337618","54337913","14","3724880"
"chr2","50629180","50629530","chr10","54354057","54354384","27","3724877"
"chr2","50671601","50671903","chr10","54394715","54395024","24","3723114"
"chr2","50754037","50754315","chr10","54477302","54477578","9","3723265"
"chr2","50768473","50768755","chr10","54491555","54491837","7","3723082"
"chr2","50784112","50784423","chr10","54507169","54507476","15","3723057"
"chr2","50809095","50809294","chr10","54531851","54532048","9","3722756"
"chr2","50818878","50819176","chr10","54541212","54541520","19","3722334"
"chr2","50840727","50841035","chr10","54565185","54565498","14","3724458"
"chr2","50854376","50854662","chr10","54578795","54579090","14","3724419"
"chr2","50861626","50861680","chrX","939789","939841","10","49921837"
"chr2","50861681","50861853","chr16","56769527","56769696","42","5907846"
"chr2","50881677","50881852","chr10","54606139","54606313","5","3724462"
"chr2","50926867","50927171","chr1","129228117","129228422","64","78301250"
"chr2","50927796","50928071","chr10","54651873","54652148","7","3724077"
"chr2","51138756","51139059","chr10","54851723","54852016","26","3712967"
"chr2","51218186","51218484","chr10","54930931","54931222","22","3712745"
"chr2","51302722","51303028","chr10","55010107","55010414","15","3707385"
"chr2","51311053","51311355","chr10","55018699","55019003","21","3707646"
"chr2","51381412","51381758","chr18","28095533","28095834","98","23285879"
"chr2","51452949","51453253","chr10","55159140","55159444","6","3706191"
"chr2","51539788","51540090","chr10","55245039","55245341","11","3705251"
"chr2","51548772","51548869","chr10","55254058","55254163","12","3705286"
"chr2","51612730","51613028","chr10","55318060","55318354","21","3705330"
"chr2","51623807","51624091","chr10","55329162","55329448","17","3705355"
"chr2","51771710","51771834","chr14","67957556","67957680","16","16185846"
"chr2","51817573","51817868","chr10","55519112","55519407","8","3701539"
"chr2","52001973","52002259","chr10","55706152","55706441","26","3704179"
"chr2","52002544","52002853","chr10","55706730","55707014","41","3704186"
"chr2","52050700","52050966","chr10","55754727","55755020","30","3704027"
"chr2","52087030","52087111","chr3","44070211","44070296","15","8016819"
"chr2","52087379","52087556","chr10","55791613","55791780","23","3704234"
"chr2","52104581","52104704","chr10","55808955","55809065","14","3704374"
"chr2","52104738","52104909","chr10","55809144","55809332","26","3704406"
"chr2","52244526","52244845","chr10","55950471","55950791","5","3705945"
"chr2","52253694","52253831","chr10","55958945","55959087","7","3705251"
"chr2","52253905","52254083","chr10","55959139","55959315","6","3705234"
"chr2","52283686","52283804","chr3","84174277","84174400","22","31890591"
"chr2","52283848","52283859","chr1","56387287","56387297","2","4103439"
"chr2","52289927","52290227","chr10","55995111","55995376","40","3705184"
"chr2","52303904","52304057","chr9","86631758","86631910","28","34327854"
"chr2","52383188","52383463","chr11","93604681","93604934","72","41221493"
"chr2","52389409","52389711","chr10","56094381","56094676","21","3704972"
"chr2","52402005","52402155","chr10","58325263","58325414","4","5923258"
"chr2","52440641","52440944","chr1","23074912","23075201","25","29365729"
"chr2","52445988","52446047","chr20","5048738","5048794","13","47397250"
"chr2","52457284","52457563","chr1","23088211","23088487","11","29369073"
"chr2","52458773","52459087","chr10","58360438","58360744","20","5901665"
"chr2","52556706","52556992","chr17","72807838","72808128","71","20251132"
"chr2","52575150","52575407","chr10","58309698","58309974","46","5734548"
"chr2","52590496","52590657","chr10","58325263","58325414","20","5734767"
"chr2","52668595","52668740","chr1","23515316","23515459","33","29153279"
"chr2","52669963","52670113","chr14","103323129","103323285","43","50653166"
"chr2","52775982","52776284","chr7","65554767","65555089","34","12778785"
"chr2","52806565","52806631","chr20","14309840","14309907","17","38496725"
"chr2","52847482","52847787","chr10","56356252","56356554","9","3508770"
"chr2","53336566","53336785","chr10","56893293","56893513","6","3556727"
"chr2","53355377","53355441","chr6","81693033","81693092","12","28337656"
"chr2","53381805","53381850","chr10","31369460","31369504","6","22012345"
"chr2","53381849","53381878","chr11","45327618","45327650","6","8054231"
"chr2","53381879","53382167","chr10","56935998","56936294","17","3554119"
"chr2","53390779","53391073","chr10","56944870","56945164","5","3554091"
"chr2","53407080","53407367","chr10","56961141","56961425","8","3554061"
"chr2","53487123","53487314","chr10","57040756","57040947","1","3553633"
"chr2","53529711","53529967","chr10","57083792","57084046","17","3554081"
"chr2","53582899","53582950","chr7","154654825","154654875","8","101071926"
"chr2","53758073","53758377","chr10","35583641","35583945","8","18174432"
"chr2","53759114","53759417","chr10","35582597","35582905","12","18176517"
"chr2","53761407","53761711","chr10","35580009","35580297","26","18181398"
"chr2","53767198","53767463","chr10","35573797","35574064","5","18193401"
"chr2","53772224","53772532","chr10","35568704","35569013","16","18203520"
"chr2","53781262","53781558","chr10","35559252","35559553","14","18222010"
"chr2","53788480","53788773","chr10","35552051","35552355","14","18236429"
"chr2","53805316","53805600","chr10","35535561","35535860","22","18269755"
"chr2","53813619","53813940","chr10","35528989","35529314","15","18284630"
"chr2","53823937","53824240","chr10","35518387","35518657","38","18305550"
"chr2","53827078","53827235","chr10","35515398","35515558","6","18311680"
"chr2","53833049","53833366","chr10","35509216","35509522","14","18323833"
"chr2","53833781","53834094","chr10","35508489","35508801","3","18325292"
"chr2","53840567","53840850","chr10","35501740","35502023","5","18338827"
"chr2","53864499","53864680","chr10","35482599","35482799","22","18381900"
"chr2","53866901","53867197","chr10","35473515","35473820","19","18393386"
"chr2","53895374","53895663","chr10","35444786","35445084","12","18450588"
"chr2","53899870","53900164","chr10","35440288","35440582","6","18459582"
"chr2","53940553","53940701","chr11","62948847","62948992","25","9008294"
"chr2","53940702","53940749","chr2","156993426","156993469","10","103052724"
"chr2","53966027","53966298","chr10","35373349","35373619","9","18592678"
"chr2","53989004","53989146","chr10","35345408","35345572","26","18643596"
"chr2","54006787","54006910","chr20","50991370","50991497","30","3015417"
"chr2","54007218","54007354","chr1","10892276","10892410","27","43114942"
"chr2","54014196","54014463","chr10","35317864","35318131","5","18696332"
"chr2","54015614","54015827","chr10","35316492","35316709","9","18699122"
"chr2","54025878","54026182","chr20","39705042","39705349","61","14320836"
"chr2","54027574","54027883","chr10","35303838","35304147","15","18723736"
"chr2","54035551","54035796","chr10","66914544","66914791","53","12878993"
"chr2","54045680","54045966","chr3","89172238","89172528","50","35126558"
"chr2","54060736","54061045","chr10","35269830","35270142","19","18790906"
"chr2","54087857","54088154","chr10","35241790","35242087","7","18846067"
"chr2","54105780","54105936","chr10","35224557","35224713","5","18881223"
"chr2","54110603","54110925","chr10","35219521","35219843","21","18891082"
"chr2","54119352","54119418","chr10","35210909","35210975","4","18908443"
"chr2","54128968","54129222","chr10","35201431","35201671","21","18927537"
"chr2","54152690","54152991","chr10","35176541","35176843","17","18976149"
"chr2","54185599","54185764","chr10","35142063","35142225","5","19043536"
"chr2","54185790","54185901","chr10","35141927","35142040","2","19043863"
"chr2","54217402","54217685","chr10","35110586","35110877","10","19106816"
"chr2","54223383","54223693","chr14","62153460","62153766","55","7930077"
"chr2","54252410","54252704","chr10","35074991","35075277","17","19177419"
"chr2","54268210","54268487","chr13","26875713","26876000","55","27392497"
"chr2","54271451","54271769","chr9","89513889","89514205","63","35242438"
"chr2","54287969","54288221","chr10","35039800","35040052","5","19248169"
"chr2","54294690","54294825","chr3","162197994","162198125","28","107903304"
"chr2","54316470","54316758","chr10","35011641","35011925","11","19304829"
"chr2","54316979","54317287","chr10","35011099","35011408","8","19305880"
"chr2","54328359","54328646","chr10","34999606","34999910","25","19328753"
"chr2","54331031","54331339","chr10","34996912","34997244","28","19334119"
"chr2","54377238","54377556","chr10","34949907","34950178","49","19427331"
"chr2","54395263","54395421","chr10","34932021","34932173","8","19463242"
"chr2","54436550","54436802","chr10","34892818","34893100","42","19543732"
"chr2","54444313","54444615","chr10","34885027","34885322","13","19559286"
"chr2","54485964","54486243","chr10","34841280","34841559","7","19644684"
"chr2","54510061","54510260","chr5","13004468","13004663","52","41505593"
"chr2","54703540","54703837","chr10","34623068","34623372","22","20080472"
"chr2","54736422","54736484","chr10","34590576","34590638","1","20145846"
"chr2","54820161","54820374","chr10","34506723","34506951","35","20313438"
"chr2","54875520","54875798","chr4","112784516","112784799","58","57908996"
"chr2","54892423","54892696","chr10","34456003","34456308","37","20436420"
"chr2","54929681","54929991","chr10","34396339","34396648","40","20533342"
"chr2","54985716","54986030","chr10","34396339","34396648","14","20589377"
"chr2","55007705","55008014","chr10","34374299","34374608","3","20633406"
"chr2","55027368","55027597","chr10","34355014","34355243","6","20672354"
"chr2","55043405","55043698","chr10","34338034","34338327","10","20705371"
"chr2","55058027","55058308","chr15","98876601","98876890","82","43818574"
"chr2","55082137","55082316","chr10","34298785","34298963","7","20783352"
"chr2","55082350","55082456","chr10","34298645","34298751","1","20783705"
"chr2","55176362","55176648","chr10","34200125","34200408","5","20976237"
"chr2","55201208","55201367","chr10","34175240","34175399","5","21025968"
"chr2","55207325","55207638","chr10","34169286","34169600","13","21038039"
"chr2","55211021","55211302","chr10","34163487","34163765","18","21047534"
"chr2","55221285","55221578","chr10","34153409","34153707","17","21067876"
"chr2","55233044","55233239","chr13","88656442","88656638","39","33423398"
"chr2","55233772","55234062","chr10","34142416","34142703","17","21091356"
"chr2","55242660","55242968","chr10","34133540","34133848","4","21109120"
"chr2","55248848","55249129","chr10","34127393","34127673","7","21121455"
"chr2","55253379","55253673","chr10","34122956","34123246","9","21130423"
"chr2","55284045","55284230","chr3","113772097","113772263","44","58488052"
"chr2","55319478","55319774","chr10","34057016","34057312","3","21262462"
"chr2","55335982","55336257","chr10","34027062","34027373","46","21308920"
"chr2","55385960","55386181","chr2","147695112","147695327","45","92309152"
"chr2","55396510","55396736","chr7","79785291","79785518","46","24388781"
"chr2","55531673","55531964","chr10","33830863","33831155","16","21700810"
"chr2","55564811","55565111","chr10","33802253","33802553","11","21762558"
"chr2","55594135","55594385","chr10","33773822","33774062","13","21820313"
"chr2","55649746","55649945","chr10","33714426","33714619","16","21935320"
"chr2","55650660","55650980","chr10","33713362","33713682","11","21937298"
"chr2","55651949","55652241","chr10","33712216","33712508","9","21939733"
"chr2","55661703","55661990","chr10","33702525","33702816","18","21959178"
"chr2","55693444","55693733","chr10","33670424","33670712","9","22023020"
"chr2","55695238","55695400","chr8","40914201","40914362","31","14781037"
"chr2","55697311","55697613","chr10","33665739","33666041","12","22031572"
"chr2","55704942","55705250","chr10","33658124","33658406","33","22046818"
"chr2","55745782","55746088","chr10","33610964","33611275","15","22134818"
"chr2","55781789","55782086","chr10","33570510","33570808","12","22211279"
"chr2","55820919","55821206","chr10","33531835","33532112","16","22289084"
"chr2","55898523","55898814","chr10","33453629","33453919","10","22444894"
"chr2","55902848","55903163","chr10","33449281","33449596","8","22453567"
"chr2","55920036","55920319","chr10","33432049","33432333","3","22487987"
"chr2","55925130","55925431","chr10","33427296","33427597","8","22497834"
"chr2","55926160","55926436","chr10","33426280","33426567","22","22499880"
"chr2","55932125","55932223","chr10","33418899","33418997","3","22513226"
"chr2","55935197","55935364","chr10","33415772","33415943","12","22519425"
"chr2","55939859","55940160","chr10","33410997","33411298","6","22528862"
"chr2","55948866","55949177","chr10","33401975","33402287","11","22546891"
"chr2","55967824","55968102","chr10","33383176","33383456","8","22584648"
"chr2","55977510","55977787","chr10","33373455","33373734","8","22604055"
"chr2","55985743","55985846","chr10","33365521","33365631","9","22620222"
"chr2","55998252","55998573","chr16","49029165","49029475","72","6969087"
"chr2","56013053","56013353","chr10","33336935","33337222","20","22676118"
"chr2","56013414","56013713","chrX","45888228","45888520","59","10125186"
"chr2","56016471","56016733","chr10","33333943","33334206","7","22682528"
"chr2","56016804","56017096","chr10","33333577","33333872","9","22683227"
"chr2","56018226","56018506","chr10","33332157","33332441","7","22686069"
"chr2","56039338","56039640","chr10","33311164","33311460","12","22728174"
"chr2","56049497","56049811","chr10","33301209","33301523","5","22748288"
"chr2","56051276","56051510","chr10","33299524","33299757","5","22751752"
"chr2","56051846","56052154","chr10","33298876","33299187","11","22752970"
"chr2","56055673","56055797","chr18","12999568","12999690","19","43056105"
"chr2","56060815","56060995","chr2","135387748","135387927","37","79326933"
"chr2","56069900","56070023","chr10","33281195","33281339","22","22788705"
"chr2","56070055","56070263","chr10","33280989","33281172","36","22789066"
"chr2","56074601","56074791","chr5","172541176","172541358","51","116466575"
"chr2","56078751","56078817","chr10","33274305","33274371","2","22804446"
"chr2","56127530","56127834","chr10","28993139","28993444","8","27134391"
"chr2","56138391","56138629","chr10","28982048","28982284","8","27156343"
"chr2","56139759","56140033","chr10","28980634","28980927","22","27159125"
"chr2","56156722","56157024","chr10","28964153","28964455","8","27192569"
"chr2","56184963","56185079","chrX","108971246","108971363","18","52786283"
"chr2","56185144","56185216","chr7","123743220","123743291","20","67558076"
"chr2","56207898","56208184","chr10","28912190","28912483","10","27295708"
"chr2","56216393","56216649","chr10","28903716","28903975","8","27312677"
"chr2","56222890","56223184","chr10","28896890","28897177","8","27326000"
"chr2","56255638","56255941","chr10","28862828","28863131","6","27392810"
"chr2","56260544","56260843","chr10","28857922","28858224","8","27402622"
"chr2","56262626","56262910","chr10","28855549","28855840","34","27407077"
"chr2","56264173","56264308","chr10","28854130","28854265","3","27410043"
"chr2","56264623","56264801","chr10","28853653","28853827","11","27410970"
"chr2","56274587","56274889","chr10","28843155","28843464","11","27431432"
"chr2","56277375","56277469","chr10","83270668","83270762","12","26993293"
"chr2","56292162","56292487","chr10","28825064","28825389","7","27467098"
"chr2","56313803","56314098","chr10","28804342","28804637","5","27509461"
"chr2","56321824","56321974","chr10","28796117","28796267","3","27525707"
"chr2","56322438","56322728","chr16","41671981","41672272","51","14650457"
"chr2","56325396","56325517","chr10","28793034","28793159","8","27532362"
"chr2","56342193","56342504","chr10","28775877","28776188","4","27566316"
"chr2","56355392","56355556","chr10","28762674","28762839","3","27592718"
"chr2","56357622","56357871","chr10","28760348","28760611","20","27597274"
"chr2","56369649","56369859","chr10","28748647","28748867","13","27621002"
"chr2","56388806","56389104","chr10","28730261","28730559","9","27658545"
"chr2","56389365","56389673","chr10","28729680","28730003","18","27659685"
"chr2","56397311","56397613","chrX","15697361","15697669","56","40699950"
"chr2","56401619","56401940","chr10","28722097","28722418","4","27679522"
"chr2","56428097","56428264","chr10","28690826","28690996","7","27737271"
"chr2","56428274","56428548","chr10","28690540","28690816","6","27737734"
"chr2","56431465","56431686","chr10","28688665","28688889","5","27742800"
"chr2","56451232","56451551","chr10","58015324","58015648","13","1564092"
"chr2","56463839","56464142","chr3","87135109","87135403","70","30671270"
"chr2","56478090","56478326","chr10","28655212","28655447","9","27822878"
"chr2","56487277","56487573","chr10","28645663","28645960","7","27841614"
"chr2","56488346","56488652","chr10","28644587","28644889","11","27843759"
"chr2","56492605","56492871","chr10","28639352","28639650","41","27853253"
"chr2","56495315","56495474","chr10","28637060","28637219","1","27858255"
"chr2","56498457","56498629","chr10","28634605","28634779","5","27863852"
"chr2","56498957","56499101","chr10","28634131","28634275","5","27864826"
"chr2","56501174","56501469","chr10","28631755","28632046","9","27869419"
"chr2","56509662","56509935","chr10","28623165","28623443","12","27886497"
"chr2","56519285","56519361","chr10","28612489","28612565","1","27906796"
"chr2","56520468","56520638","chr5","118526326","118526488","26","62005858"
"chr2","56520666","56520786","chr12","95217434","95217551","22","38696768"
"chr2","56523507","56523730","chr10","28607267","28607490","6","27916240"
"chr2","56535750","56536029","chr10","28595301","28595585","36","27940449"
"chr2","56536030","56536308","chr10","28595301","28595585","8","27940729"
"chr2","56536809","56537086","chr10","28594494","28594769","5","27942315"
"chr2","56537360","56537575","chrX","16781389","16781597","59","39755971"
"chr2","56541419","56541706","chr18","1168344","1168635","58","55373075"
"chr2","56556074","56556365","chr10","28574338","28574631","9","27981736"
"chr2","56572008","56572345","chr10","28558317","28558651","17","28013691"
"chr2","56598566","56598851","chr10","28537424","28537711","8","28061142"
"chr2","56599976","56600276","chr10","28532158","28532457","9","28067818"
"chr2","56610753","56611038","chr10","28518520","28518795","21","28092233"
"chr2","56631114","56631222","chr10","28498433","28498541","5","28132681"
"chr2","56631877","56632075","chr10","28497522","28497716","9","28134355"
"chr2","56635991","56636106","chr3","55180473","55180591","33","1455518"
"chr2","56637430","56637580","chr10","28491562","28491712","3","28145868"
"chr2","56641158","56641417","chr11","93604681","93604934","65","36963523"
"chr2","56652158","56652227","chr5","140710371","140710442","26","84058213"
"chr2","56652532","56652683","chr2","62491066","62491214","31","5838534"
"chr2","56659838","56660132","chr10","28440325","28440619","8","28219513"
"chr2","56660443","56660729","chr10","28439722","28440008","7","28220721"
"chr2","56661994","56662255","chr10","28434064","28434245","91","28227930"
"chr2","56662256","56662565","chr10","28433726","28434016","23","28228530"
"chr2","56662566","56662635","chr12","42167733","42167802","14","14494833"
"chr2","56667433","56667537","chr3","170580820","170580922","19","113913387"
"chr2","56667893","56668116","chr2","82890576","82890799","48","26222683"
"chr2","56669960","56670231","chr5","73133788","73134060","55","16463828"
"chr2","56682216","56682495","chr10","28415531","28415786","28","28266685"
"chr2","56682796","56682832","chr10","28415199","28415231","5","28267597"
"chr2","56683689","56683991","chr14","106514713","106515013","55","49831024"
"chr2","56705083","56705200","chr10","28401985","28402102","2","28303098"
"chr2","56705205","56705271","chr1","112516638","112516708","22","55811433"
"chr2","56714494","56714799","chr15","5023540","5023842","51","51690954"
"chr2","56716311","56716447","chr3","107030279","107030424","39","50313968"
"chr2","56717528","56717810","chr16","996804","997095","52","55720724"
"chr2","56726737","56726899","chr10","28320967","28321127","5","28405770"
"chr2","56731929","56732198","chr10","28315222","28315494","14","28416707"
"chr2","56735561","56735841","chr10","28311572","28311852","7","28423989"
"chr2","56742066","56742367","chr10","28304754","28305055","4","28437312"
"chr2","56767023","56767329","chr10","28281462","28281769","5","28485561"
"chr2","56774016","56774310","chr10","28274512","28274806","4","28499504"
"chr2","56781506","56781688","chr10","28267251","28267431","11","28514255"
"chr2","56793646","56793754","chr11","116389929","116390043","29","59596283"
"chr2","56794661","56794823","chr8","118347227","118347388","36","61552566"
"chr2","56811036","56811237","chr11","49287499","49287705","42","7523537"
"chr2","56824604","56824917","chr10","28225919","28226230","9","28598685"
"chr2","56837253","56837421","chr10","28209439","28209605","3","28627814"
"chr2","56837726","56837871","chr10","28208998","28209143","3","28628728"
"chr2","56840081","56840394","chr10","28206463","28206779","7","28633618"
"chr2","56842258","56842445","chr10","28204416","28204591","13","28637842"
"chr2","56842777","56842908","chr10","28203954","28204085","3","28638823"
"chr2","56843883","56844095","chr10","28202781","28202978","29","28641102"
"chr2","56859685","56859975","chr10","28178267","28178557","6","28681418"
"chr2","56860470","56860758","chr10","28177483","28177772","5","28682987"
"chr2","56861508","56861738","chr16","41210751","41210968","50","15650757"
"chr2","56870340","56870517","chr10","28176078","28176254","8","28694262"
"chr2","56880594","56880894","chr10","28165723","28166026","7","28714871"
"chr2","56881411","56881704","chr10","28164896","28165194","12","28716515"
"chr2","56897552","56897838","chr10","28147078","28147364","1","28750474"
"chr2","56912957","56913262","chr10","28131975","28132279","6","28780982"
"chr2","56929554","56929840","chr10","28114383","28114674","9","28815171"
"chr2","56987800","56988079","chr10","28055276","28055564","14","28932524"
"chr2","56990361","56990656","chr10","28052684","28052992","20","28937677"
"chr2","56991254","56991547","chr10","28051799","28052092","9","28939455"
"chr2","57000699","57001004","chr10","28042330","28042645","14","28958369"
"chr2","57095144","57095154","chr5","138006916","138006926","1","80911772"
"chr2","57095464","57095602","chr10","27946051","27946189","2","29149413"
"chr2","57103770","57104058","chr10","27937589","27937877","4","29166181"
"chr2","57114151","57114336","chr1","215791541","215791705","43","158677390"
"chr2","57114917","57115216","chr9","94884447","94884742","47","37769530"
"chr2","57116289","57116408","chr10","27924927","27925054","8","29191362"
"chr2","57131919","57132132","chr10","27909328","27909542","10","29222591"
"chr2","57136826","57137120","chr10","27903858","27904155","15","29232968"
"chr2","57139016","57139314","chr10","27901672","27901975","8","29237344"
"chr2","57177936","57178219","chr10","27863694","27864002","33","29314242"
"chr2","57208524","57208834","chr10","27833789","27834099","8","29374735"
"chr2","57223694","57223995","chr10","27816997","27817299","5","29406697"
"chr2","57233873","57234100","chr10","27806677","27806893","14","29427196"
"chr2","57239842","57240081","chr10","27800696","27800935","11","29439146"
"chr2","57271426","57271602","chr10","27769607","27769788","13","29501819"
"chr2","57271904","57272046","chr10","27769151","27769292","9","29502753"
"chr2","57274898","57275034","chr10","27766173","27766309","3","29508725"
"chr2","57275340","57275568","chr10","27765643","27765871","5","29509697"
"chr2","57293003","57293153","chr10","27748659","27748809","3","29544344"
"chr2","57299388","57299660","chr10","27742128","27742421","23","29557260"
"chr2","57303197","57303497","chr10","27738277","27738577","11","29564920"
"chr2","57308683","57308785","chr10","56112880","56112983","20","1195803"
"chr2","57308799","57308853","chr10","27732923","27732977","1","29575876"
"chr2","57308854","57309134","chr10","27732643","27732922","7","29576211"
"chr2","57312173","57312328","chr10","27729463","27729618","2","29582710"
"chr2","57312624","57312650","chr16","8579227","8579250","9","48733397"
"chr2","57312944","57313035","chr10","27728714","27728805","1","29584230"
"chr2","57317734","57318015","chr10","27723598","27723879","6","29594136"
"chr2","57365787","57366009","chr20","57037584","57037793","68","328203"
"chr2","57369325","57369679","chr10","27672259","27672613","3","29697066"
"chr2","57369968","57370233","chr10","27671711","27671977","7","29698257"
"chr2","57381933","57382118","chr10","27659183","27659380","30","29722750"
"chr2","57389150","57389453","chr10","27651885","27652188","1","29737265"
"chr2","57391667","57391965","chr10","27649399","27649697","9","29742268"
"chr2","57412104","57412317","chr10","27628420","27628632","7","29783684"
"chr2","57413576","57413886","chr10","27626869","27627179","8","29786707"
"chr2","57416160","57416463","chr1","63861722","63862025","62","6445562"
"chr2","57419102","57419385","chr10","27621680","27621963","6","29797422"
"chr2","57419765","57420090","chr10","27620976","27621300","12","29798789"
"chr2","57422013","57422312","chr10","27618874","27619173","5","29803139"
"chr2","57427845","57427957","chr20","17667801","17667909","24","39760044"
"chr2","57428197","57428262","chr18","1444475","1444538","11","55983722"
"chr2","57428851","57428959","chr10","27610820","27610928","4","29818031"
"chr2","57430905","57431067","chr19","50846122","50846285","38","6584783"
"chr2","57440771","57441042","chr10","27598390","27598662","4","29842381"
"chr2","57443099","57443272","chr10","27596458","27596630","9","29846641"
"chr2","57446144","57446451","chr1","128667973","128668280","60","71221829"
"chr2","57454948","57455251","chr10","27584545","27584857","15","29870403"
"chr2","57456840","57457134","chr10","27582669","27582961","7","29874171"
"chr2","57457142","57457374","chr10","27582429","27582661","4","29874713"
"chr2","57468067","57468368","chr4","36593951","36594258","64","20874116"
"chr2","57475807","57476088","chr10","27563761","27564042","7","29912046"
"chr2","57488526","57488751","chr7","42721249","42721463","48","14767277"
"chr2","57507194","57507331","chr10","27419958","27420095","3","30087236"
"chr2","57507921","57508047","chr10","27419241","27419367","3","30088680"
"chr2","57508774","57509055","chr10","27418241","27418522","3","30090533"
"chr2","57510615","57510931","chr10","27416140","27416457","13","30094475"
"chr2","57513103","57513424","chr10","27413854","27414175","11","30099249"
"chr2","57518590","57518692","chr10","27408084","27408192","8","30110506"
"chr2","57544458","57544762","chr1","156859121","156859419","63","99314663"
"chr2","57553499","57553636","chr2","69671546","69671678","28","12118047"
"chr2","57553941","57554121","chr5","52192928","52193107","42","5361013"
"chr2","57555467","57555645","chr10","27367086","27367261","7","30188381"
"chr2","57567879","57567964","chr10","27354140","27354225","0","30213739"
"chr2","57624184","57624496","chr10","27293608","27293920","15","30330576"
"chr2","57626920","57627180","chr10","27290905","27291174","20","30336015"
"chr2","57633018","57633317","chr2","78493440","78493742","52","20860422"
"chr2","57635065","57635366","chr10","27282548","27282849","11","30352517"
"chr2","57652573","57652757","chr10","27263140","27263324","3","30389433"
"chr2","57652759","57652835","chr10","27263062","27263138","1","30389697"
"chr2","57659756","57660061","chr10","27255916","27256223","7","30403840"
"chr2","57661337","57661566","chr14","67933090","67933306","49","10271753"
"chr2","57670537","57670773","chr10","27245733","27245969","4","30424804"
"chr2","57671367","57671676","chr10","27244535","27244840","13","30426832"
"chr2","57674432","57674690","chr10","27240351","27240609","6","30434081"
"chr2","57685882","57686068","chr5","31612602","31612782","46","26073280"
"chr2","57687072","57687366","chr10","27227229","27227520","5","30459843"
"chr2","57695609","57695921","chr10","27218658","27218970","4","30476951"
"chr2","57703442","57703759","chr10","27209894","27210211","5","30493548"
"chr2","57703917","57704199","chr10","27209454","27209737","3","30494463"
"chr2","57704225","57704253","chr10","27209394","27209421","1","30494831"
"chr2","57704685","57704997","chr10","27208328","27208637","7","30496357"
"chr2","57706546","57706838","chr10","27206486","27206768","25","30500060"
"chr2","57731837","57732127","chr16","45581187","45581480","63","12150650"
"chr2","57735954","57736241","JH682353","5862","6152","6","57730092"
"chr2","57736670","57736961","JH682353","5140","5435","9","57731530"
"chr2","57804662","57804957","chr3","12140807","12141103","9","45663855"
"chr2","57821384","57821644","chr3","12154198","12154459","8","45667186"
"chr2","57822122","57822419","chr3","12154948","12155245","7","45667174"
"chr2","57832746","57832981","chr3","12164373","12164601","24","45668373"
"chr2","57838987","57839276","chr3","12170703","12170991","8","45668284"
"chr2","57853279","57853546","chr3","12185042","12185320","16","45668237"
"chr2","57886938","57887225","chr3","12219141","12219428","5","45667797"
"chr2","57897641","57897932","chr3","12229834","12230125","3","45667807"
"chr2","57974110","57974401","chr3","12306191","12306477","8","45667919"
"chr2","57981284","57981577","chr3","12312688","12312979","6","45668596"
"chr2","58019053","58019345","chr3","12350619","12350921","19","45668434"
"chr2","58035634","58035943","chr20","68993107","68993413","56","10957473"
"chr2","58038133","58038439","chr3","12369774","12370061","22","45668359"
"chr2","58047421","58047720","chr13","53097153","53097452","52","4950268"
"chr2","58048936","58049219","chr3","12381091","12381384","13","45667845"
"chr2","58065991","58066277","chr3","12397728","12398017","10","45668263"
"chr2","58087750","58087996","chr16","45465581","45465823","59","12622169"
"chr2","58093811","58094128","chr3","12425542","12425859","5","45668269"
"chr2","58152117","58152442","chr3","12485295","12485601","35","45666822"
"chr2","58194819","58195112","chr3","12528470","12528752","22","45666349"
"chr2","58201191","58201479","chr3","12534808","12535095","4","45666383"
"chr2","58202174","58202454","chr3","12535789","12536069","3","45666385"
"chr2","58204971","58205274","chr3","12538606","12538901","13","45666365"
"chr2","58210940","58211229","chr3","12544855","12545144","12","45666085"
"chr2","58228725","58229016","chr9","50779900","50780188","47","7448825"
"chr2","58259161","58259467","chr15","24338848","24339150","55","33920313"
"chr2","58261945","58262257","chr3","12603774","12604072","20","45658171"
"chr2","58267201","58267358","chr3","12598546","12598703","3","45668655"
"chr2","58268093","58268387","chr3","12599422","12599718","14","45668671"
"chr2","58270328","58270633","chr3","12601658","12601964","8","45668670"
"chr2","58280309","58280609","chr3","12613595","12613900","11","45666714"
"chr2","58280867","58281191","chr3","12614170","12614481","17","45666697"
"chr2","58282059","58282347","chr3","12615349","12615636","6","45666710"
"chr2","58301768","58302084","chr3","12634740","12635056","18","45667028"
"chr2","58302672","58302962","chr3","12635314","12635607","10","45667358"
"chr2","58311710","58311994","chr3","12644640","12644921","6","45667070"
"chr2","58318587","58318872","chr3","12651928","12652223","15","45666659"
"chr2","58377528","58377823","chr3","12711148","12711428","26","45666380"
"chr2","58388109","58388338","chr3","12721755","12721980","11","45666354"
"chr2","58388637","58388940","chr3","12722294","12722595","9","45666343"
"chr2","58405236","58405556","chr3","12738812","12739145","27","45666424"
"chr2","58427818","58428105","chr3","12761728","12762007","12","45666090"
"chr2","58430748","58431008","chr3","12764653","12764913","6","45666095"
"chr2","58435331","58435581","chr3","12769214","12769465","11","45666117"
"chr2","58449862","58450160","chr3","12783650","12783947","8","45666212"
"chr2","58470282","58470561","chr3","12803692","12804001","35","45666590"
"chr2","58485767","58485993","chr3","12818192","12818418","2","45667575"
"chr2","58487440","58487674","chr15","60339511","60339756","60","1852071"
"chr2","58518273","58518602","chr3","12851847","12852176","9","45666426"
"chr2","58519600","58519982","chr3","12851847","12852176","60","45667753"
"chr2","58531614","58531927","chr3","12864375","12864685","36","45667239"
"chr2","58555890","58556198","chr3","12889258","12889565","12","45666632"
"chr2","58557737","58557992","chr3","12891114","12891366","9","45666623"
"chr2","58569353","58569656","chr3","12903389","12903692","11","45665964"
"chr2","58575114","58575237","chrX","43910158","43910278","25","14664956"
"chr2","58575545","58575803","chr3","12909685","12909944","7","45665860"
"chr2","58583169","58583467","chr3","12917735","12918036","13","45665434"
"chr2","58652529","58652820","chr3","12984176","12984467","8","45668353"
"chr2","58653139","58653409","chr3","12984786","12985069","21","45668353"
"chr2","58661838","58662040","chr3","12994117","12994313","12","45667721"
"chr2","58666228","58666493","chr3","12998521","12998784","5","45667707"
"chr2","58671430","58671737","chr3","13004043","13004349","8","45667387"
"chr2","58672836","58673115","chr3","13005448","13005731","8","45667388"
"chr2","58684857","58685151","chr3","13017449","13017734","11","45667408"
"chr2","58692958","58693255","chr3","13025282","13025576","9","45667676"
"chr2","58698019","58698330","chr3","13030222","13030532","10","45667797"
"chr2","58704261","58704533","chr3","13036778","13037050","6","45667483"
"chr2","58709303","58709576","chr3","13041794","13042067","1","45667509"
"chr2","58716189","58716485","chr3","13048699","13048995","8","45667490"
"chr2","58725406","58725705","chr3","13060928","13061240","19","45664478"
"chr2","58736151","58736447","chr7","159108069","159108371","51","100371918"
"chr2","58742881","58743176","chr1","12717003","12717299","55","46025878"
"chr2","58752165","58752447","chr9","42581241","42581525","59","16170924"
"chr2","58755269","58755558","chr3","13091569","13091862","12","45663700"
"chr2","58765279","58765579","chr3","13101563","13101870","18","45663716"
"chr2","58774288","58774566","chr3","13111125","13111403","3","45663163"
"chr2","58799329","58799605","chr3","13137695","13137995","32","45661634"
"chr2","58800526","58800850","chr3","13139201","13139523","10","45661325"
"chr2","58810863","58811169","chr3","13154524","13154830","8","45656339"
"chr2","58829673","58829892","chr3","13173386","13173598","15","45656287"
"chr2","58831745","58832035","chr3","13175448","13175743","13","45656297"
"chr2","58839351","58839640","chr3","13183108","13183397","1","45656243"
"chr2","58860729","58861012","chr3","13204282","13204565","5","45656447"
"chr2","58872432","58872732","chr3","13216198","13216500","15","45656234"
"chr2","58884487","58884794","chr3","13228283","13228586","15","45656204"
"chr2","58896561","58896864","chrX","68009933","68010228","60","9113372"
"chr2","58897383","58897684","chr3","13242891","13243192","2","45654492"
"chr2","58906420","58906590","chr14","19255679","19255843","33","39650741"
"chr2","58906618","58906672","chr5","10510658","10510711","8","48395960"
"chr2","58906987","58907071","chr3","13252526","13252611","3","45654461"
"chr2","58911879","58912162","chr13","26875713","26876000","56","32036166"
"chr2","58919623","58919891","chr5","72345461","72345731","52","13425838"
"chr2","58922866","58923154","chr3","13265365","13265613","42","45657501"
"chr2","58936466","58936619","chr8","36032718","36032852","37","22903748"
"chr2","58943827","58944116","chr1","120040550","120040851","63","61096723"
"chr2","58946936","58947226","chr3","13287835","13288125","1","45659101"
"chr2","58965156","58965457","chr3","13306082","13306381","12","45659074"
"chr2","58971111","58971220","chr3","13311891","13311994","8","45659220"
"chr2","58977864","58978131","chr3","13318506","13318779","14","45659358"
"chr2","58993851","58994179","chr3","13334990","13335300","25","45658861"
"chr2","59007715","59007920","chrX","16742280","16742479","56","42265435"
"chr2","59011084","59011298","chr6","134348570","134348782","41","75337486"
"chr2","59014498","59014738","chr3","13361213","13361495","47","45653285"
"chr2","59043043","59043212","chr3","13389301","13389470","6","45653742"
"chr2","59043242","59043361","chr3","13389497","13389616","1","45653745"
"chr2","59060226","59060524","chr3","13406427","13406720","8","45653799"
"chr2","59077015","59077275","chr1","66652260","66652518","62","7575245"
"chr2","59079602","59079914","chr3","13425813","13426125","16","45653789"
"chr2","59089056","59089319","chr3","13434831","13435088","16","45654225"
"chr2","59102460","59102756","chr3","13447808","13448104","18","45654652"
"chr2","59116649","59116957","chr3","13464395","13464687","30","45652254"
"chr2","59188961","59189250","chr3","13536905","13537197","10","45652056"
"chr2","59202755","59203067","chr3","13550289","13550597","15","45652466"
"chr2","59213210","59213518","chr3","13560801","13561109","9","45652409"
"chr2","59233733","59234042","chr3","13581455","13581762","13","45652278"
"chr2","59247973","59248231","chr3","13595768","13596027","6","45652205"
"chr2","59314968","59315271","chr3","13662397","13662684","25","45652571"
"chr2","59324222","59324450","chr3","13671539","13671768","4","45652683"
"chr2","59338945","59339242","chrX","120653297","120653591","47","61314352"
"chr2","59362226","59362311","chr4","2744439","2744523","20","56617787"
"chr2","59362641","59362853","chr19","3890980","3891189","53","55471661"
"chr2","59388702","59388721","chr16","6749199","6749215","8","52639503"
"chr2","59389023","59389066","chr1","18855109","18855152","4","40533914"
"chr2","59423950","59424252","chr3","13774603","13774905","10","45649347"
"chr2","59426175","59426497","chr3","13776825","13777148","8","45649350"
"chr2","59445020","59445306","chr3","13795614","13795899","14","45649406"
"chr2","59447003","59447294","chr3","13797595","13797882","13","45649408"
"chr2","59458234","59458493","chr3","13808996","13809268","16","45649238"
"chr2","59495125","59495450","chr3","13845845","13846163","14","45649280"
"chr2","59512181","59512445","chr3","13863133","13863396","5","45649048"
"chr2","59513463","59513742","chr3","13864404","13864683","7","45649059"
"chr2","59550600","59550898","chr3","13901757","13902097","45","45648843"
"chr2","59585407","59585524","chr4","106049528","106049640","16","46464121"
"chr2","59595953","59596225","chr3","13947821","13948093","9","45648132"
"chr2","59614076","59614404","chr3","13967421","13967719","40","45646655"
"chr2","59648133","59648361","chr3","14002351","14002579","10","45645782"
"chr2","59648487","59648627","chr6","124305142","124305277","29","64656655"
"chr2","59648978","59649149","chr7","36378179","36378355","39","23270799"
"chr2","59654894","59655114","chr13","54311484","54311709","49","5343410"
"chr2","59655352","59655402","chr19","8511202","8511252","10","51144150"
"chr2","59708563","59708863","chr3","14062374","14062673","13","45646189"
"chr2","59724034","59724338","chr9","30891184","30891475","58","28832850"
"chr2","59749699","59750006","chr3","14105328","14105633","8","45644371"
"chr2","59770030","59770332","chr3","14125565","14125872","10","45644465"
"chr2","59802751","59803048","chr3","14157980","14158275","8","45644771"
"chr2","59820118","59820397","chr3","14174391","14174669","3","45645727"
"chr2","59852523","59852810","chr3","14207107","14207399","21","45645416"
"chr2","59864678","59864864","chr3","14219279","14219411","56","45645399"
"chr2","59873043","59873319","chr3","14227639","14227910","15","45645404"
"chr2","59885137","59885419","chr3","14239853","14240131","13","45645284"
"chr2","59926749","59927052","chr13","103281587","103281886","51","43354838"
"chr2","59938390","59938704","chr3","14290905","14291209","27","45647485"
"chr2","59949746","59950057","chr3","14302205","14302523","32","45647541"
"chr2","60003597","60003893","chr3","14355339","14355635","10","45648258"
"chr2","60072378","60072689","chr3","14427415","14427725","11","45644963"
"chr2","60130839","60131140","chr3","14485595","14485905","15","45645244"
"chr2","60131934","60132216","chr3","14486707","14487006","24","45645227"
"chr2","60135088","60135390","chr3","14489822","14490123","15","45645266"
"chr2","60144158","60144407","chr3","14499155","14499404","6","45645003"
"chr2","60153676","60153958","chr3","14509790","14510072","12","45643886"
"chr2","60164775","60165067","chr3","14520922","14521233","30","45643853"
"chr2","60177156","60177469","chr3","14533050","14533365","12","45644106"
"chr2","60218766","60219006","chr3","14599197","14599447","18","45619569"
"chr2","60224785","60225066","chr3","14604367","14604647","9","45620418"
"chr2","60264547","60264697","chr10","65746323","65746471","30","5481776"
"chr2","60264732","60264844","chr9","54998795","54998906","15","5265937"
"chr2","60273609","60273922","chr3","14654253","14654561","15","45619356"
"chr2","60281269","60281572","chr3","14661900","14662207","22","45619369"
"chr2","60328275","60328592","chr2","50127207","50127512","70","10201068"
"chr2","60354635","60354927","chr3","14729845","14730148","40","45624790"
"chr2","60356406","60356692","chr3","14731978","14732270","24","45624428"
"chr2","60358392","60358565","chr3","14735187","14735360","2","45623205"
"chr2","60365045","60365247","chr3","14742169","14742371","8","45622876"
"chr2","60402451","60402494","chr3","14779703","14779746","1","45622748"
"chr2","60402649","60402945","chr3","2797380","2797675","65","57605269"
"chr2","60465590","60465878","chr3","14843540","14843829","6","45622050"
"chr2","60473771","60474063","chr3","14848941","14849204","36","45624830"
"chr2","60475929","60476082","chr3","14850859","14851008","14","45625070"
"chr2","60479375","60479435","chr7","126552400","126552456","15","66073025"
"chr2","60479437","60479591","chr2","186575055","186575207","36","126095618"
"chr2","60483650","60483881","chr3","14863397","14863628","4","45620253"
"chr2","60484345","60484632","chr3","14864090","14864376","10","45620255"
"chr2","60494441","60494705","chr7","17235007","17235268","44","43259434"
"chr2","60496846","60497135","chr3","14873263","14873554","11","45623583"
"chr2","60525329","60525535","chr3","14901865","14902072","4","45623464"
"chr2","60525880","60525993","chr3","14902372","14902485","2","45623508"
"chr2","60527321","60527634","chr3","14903812","14904125","9","45623509"
"chr2","60542786","60543124","chr3","14919334","14919673","14","45623452"
"chr2","60543701","60543839","chr10","20553832","20553965","21","39989869"
"chr2","60544636","60544797","chr3","14921393","14921561","14","45623243"
"chr2","60544835","60544955","chr3","14921587","14921707","3","45623248"
"chr2","60548427","60548727","chr3","14925160","14925460","9","45623267"
"chr2","60562391","60562684","chr3","14939790","14940082","4","45622601"
"chr2","60563948","60564230","chr3","14941333","14941615","9","45622615"
"chr2","60580744","60581040","chr3","14958967","14959270","15","45621777"
"chr2","60591089","60591397","chr3","14969399","14969705","12","45621690"
"chr2","60591998","60592097","chr3","14970315","14970414","3","45621683"
"chr2","60596808","60597075","chr3","14975541","14975804","19","45621267"
"chr2","60599632","60599810","chr3","14978405","14978578","6","45621227"
"chr2","60614495","60614621","chr2","47509577","47509704","25","13104918"
"chr2","60619034","60619385","chr3","14995645","14995996","11","45623389"
"chr2","60619619","60619913","chr3","14996198","14996499","25","45623421"
"chr2","60656245","60656539","chr3","15032958","15033252","14","45623287"
"chr2","60667570","60667759","chr3","15041866","15042057","6","45625704"
"chr2","60670113","60670396","chr3","15045435","15045718","7","45624678"
"chr2","60673071","60673257","chr1","93759595","93759762","58","33086524"
"chr2","60683125","60683427","chr3","15058487","15058787","7","45624638"
"chr2","60684920","60685277","chr3","15060603","15060953","14","45624317"
"chr2","60690604","60690900","chr3","15066357","15066652","14","45624247"
"chr2","60695051","60695222","chr3","15070815","15070986","2","45624236"
"chr2","60703465","60703742","chr3","15083698","15084008","41","45619767"
"chr2","60749832","60750000","chr3","15130963","15131131","4","45618869"
"chr2","60750297","60750362","chr3","15131428","15131493","1","45618869"
"chr2","60758229","60758452","chr3","15139419","15139630","15","45618810"
"chr2","60758759","60758849","chr3","15139936","15140025","5","45618823"
"chr2","60797290","60797591","chr3","15178426","15178727","8","45618864"
"chr2","60806243","60806573","chr3","15187351","15187678","22","45618892"
"chr2","60845745","60845850","chr3","15226051","15226156","3","45619694"
"chr2","60873202","60873511","chr3","15253407","15253717","10","45619795"
"chr2","60885539","60885815","chr7","123143333","123143620","60","62257794"
"chr2","60893435","60893741","chr3","15273702","15274009","5","45619733"
"chr2","60898036","60898326","chr3","15278316","15278606","2","45619720"
"chr2","60907867","60908128","chr3","15287735","15287997","9","45620132"
"chr2","60927264","60927577","chr3","15307028","15307341","9","45620236"
"chr2","60958817","60959098","chr3","15337975","15338269","24","45620842"
"chr2","60979216","60979505","chr3","15358706","15358994","6","45620510"
"chr2","61113606","61113755","chr3","15494854","15494998","11","45618752"
"chr2","61158718","61159012","chr3","15539356","15539649","11","45619362"
"chr2","61178851","61179067","chr3","15559785","15560015","20","45619066"
"chr2","61245903","61246013","chr19","40190589","40190699","16","21055314"
"chr2","61300030","61300337","chr13","46319379","46319675","70","14980651"
"chr2","61325225","61325378","chr3","15619136","15619289","7","45706089"
"chr2","61326945","61327063","chr3","15620828","15620944","5","45706117"
"chr2","61405864","61406037","chr7","106427382","106427546","36","45021518"
"chr2","61467538","61467685","chr3","15753173","15753322","4","45714365"
"chr2","61528488","61528708","chr3","15813167","15813402","20","45715321"
"chr2","61622627","61622928","chr3","15907135","15907443","20","45715492"
"chr2","61714332","61714431","chr3","16014630","16014729","1","45699702"
"chr2","61723465","61723675","chr3","16024077","16024297","13","45699388"
"chr2","61724030","61724091","chr3","16024652","16024713","0","45699378"
"chr2","61757756","61758045","chr3","16058856","16059145","5","45698900"
"chr2","61800909","61801027","chr3","16112419","16112537","5","45688490"
"chr2","61802594","61802747","chr3","15619136","15619289","7","46183458"
"chr2","61973521","61973601","chr3","16297185","16297265","1","45676336"
"chr2","61985933","61986039","chr3","16309489","16309595","6","45676444"
"chr2","62003377","62003673","chr3","16326968","16327234","36","45676409"
"chr2","62029823","62029962","chr3","16355632","16355771","5","45674191"
"chr2","62057178","62057473","chr3","16382985","16383280","5","45674193"
"chr2","62066464","62066739","chr3","16391435","16391711","2","45675029"
"chr2","62085624","62085928","chr3","16411958","16412260","8","45673666"
"chr2","62212475","62212767","chr3","16540450","16540758","21","45672025"
"chr2","62278424","62278732","chr3","16606690","16606983","25","45671734"
"chr2","62341884","62342173","chr3","16671095","16671387","12","45670789"
"chr2","62358127","62358433","chr3","16687210","16687516","8","45670917"
"chr2","62363838","62364136","chr3","16692771","16693079","14","45671067"
"chr2","62439862","62440166","chr3","16768917","16769223","17","45670945"
"chr2","62497009","62497279","chr13","16871875","16872155","61","45625134"
"chr2","62600147","62600463","chr3","16928253","16928565","10","45671894"
"chr2","62637525","62637804","chr3","16967530","16967801","14","45669995"
"chr2","62679311","62679392","chr3","17012242","17012323","3","45667069"
"chr2","62707925","62708220","chr3","17041036","17041329","15","45666889"
"chr2","62743160","62743453","chr3","17077648","17077938","22","45665512"
"chr2","62758597","62758874","chr3","17093467","17093778","39","45665130"
"chr2","62777768","62778056","chr12","97798388","97798677","53","35020620"
"chr2","62781632","62781935","chr3","17116229","17116532","4","45665403"
"chr2","62820538","62820836","chr3","17157262","17157560","11","45663276"
"chr2","62824356","62824671","chr3","17160908","17161207","28","45663448"
"chr2","62895740","62896026","chr3","17231960","17232245","8","45663780"
"chr2","62945627","62945872","chr3","17281122","17281308","63","45664505"
"chr2","63069972","63070276","chr3","17405849","17406153","9","45664123"
"chr2","63080688","63080978","chr3","17416665","17416956","6","45664023"
"chr2","63081984","63082290","chr9","91721026","91721333","64","28639042"
"chr2","63083507","63083775","chr3","17420336","17420604","11","45663171"
"chr2","63101613","63101903","chr3","17438433","17438741","21","45663180"
"chr2","63110272","63110508","chr3","17446994","17447231","7","45663278"
"chr2","63120163","63120321","chr3","17456872","17457030","2","45663291"
"chr2","63124730","63125049","chr3","17461279","17461600","33","45663451"
"chr2","63129377","63129631","chr3","17465926","17466180","6","45663451"
"chr2","63150771","63150923","chr3","17488614","17488765","3","45662157"
"chr2","63172290","63172513","chr3","17511479","17511702","4","45660811"
"chr2","63175753","63176043","chr3","17515228","17515518","6","45660525"
"chr2","63188075","63188371","chr3","17528219","17528516","11","45659856"
"chr2","63193385","63193685","chr3","17533520","17533821","8","45659865"
"chr2","63203761","63204066","chr3","17543929","17544231","5","45659832"
"chr2","63221044","63221215","chr3","17562232","17562395","14","45658812"
"chr2","63228437","63228586","chr3","17569898","17570056","11","45658539"
"chr2","63228596","63228810","chr18","16392466","16392684","44","46836130"
"chr2","63241387","63241672","chr3","104066726","104067014","63","40825339"
"chr2","63268462","63268766","chr3","17613960","17614263","9","45654502"
"chr2","63269645","63269970","chr3","17615143","17615467","7","45654502"
"chr2","63279787","63280077","chr3","17625199","17625488","12","45654588"
"chr2","63285730","63285820","chr3","17631641","17631731","2","45654089"
"chr2","63295835","63296113","chr3","17641818","17642098","5","45654017"
"chr2","63352769","63353077","chr3","17697582","17697881","19","45655187"
"chr2","63356659","63356828","chr3","17703339","17703512","13","45653320"
"chr2","63368014","63368316","chr3","17714595","17714898","10","45653419"
"chr2","63370498","63370796","chr3","17717270","17717557","20","45653228"
"chr2","63370834","63370909","chr3","17717595","17717670","1","45653239"
"chr2","63507326","63507601","chr3","17862098","17862373","12","45645228"
"chr2","63516085","63516370","chr3","17870669","17870954","5","45645416"
"chr2","63563207","63563503","chr3","17921650","17921946","9","45641557"
"chr2","63607397","63607691","chr3","17966383","17966678","9","45641014"
"chr2","63641591","63641732","chr6","173935444","173935587","20","110293853"
"chr2","63757723","63758030","chr3","18112679","18112987","5","45645044"
"chr2","63813683","63813977","chr3","18168550","18168844","3","45645133"
"chr2","64096161","64096300","chr1","41210201","41210331","33","22885960"
"chr2","64096869","64096994","chr13","9241378","9241499","25","54855491"
"chr2","64111753","64112040","chr3","18475086","18475375","8","45636667"
"chr2","64207774","64208044","chr3","18568918","18569192","12","45638856"
"chr2","64263503","64263810","chr3","18626933","18627262","29","45636570"
"chr2","64330348","64330619","chr3","18698652","18698954","48","45631696"
"chr2","64360675","64360977","chr3","18735718","18736015","21","45624957"
"chr2","64391215","64391414","chr3","18766234","18766433","2","45624981"
"chr2","64502199","64502493","chr3","18873865","18874151","11","45628334"
"chr2","64520613","64520759","chr10","29028509","29028649","40","35492104"
"chr2","64539869","64540170","chr3","18908348","18908644","17","45631521"
"chr2","64619174","64619232","chr4","38518328","38518382","13","26100846"
"chr2","64621156","64621426","chr3","18989398","18989666","9","45631758"
"chr2","64663323","64663613","chr3","19038056","19038346","9","45625267"
"chr2","64830925","64831219","chr3","19204117","19204411","7","45626808"
"chr2","64861735","64861833","chr3","19234535","19234641","11","45627200"
"chr2","64945432","64945747","chr3","19317616","19317912","31","45627816"
"chr2","65241021","65241316","chr3","19613357","19613663","16","45627664"
"chr2","65331743","65331910","chr6","3072966","3073123","43","62258777"
"chr2","65356169","65356322","chr3","19727194","19727344","4","45628975"
"chr2","65406638","65406949","chr3","19780071","19780387","19","45626567"
"chr2","65443612","65443918","chr3","19816750","19817056","7","45626862"
"chr2","65556877","65557176","chr3","19931912","19932211","8","45624965"
"chr2","65596622","65596862","chr3","19970630","19970877","11","45625992"
"chr2","65601475","65601779","chr3","19975445","19975753","19","45626030"
"chr2","65698946","65699216","chr3","20073763","20074033","12","45625183"
"chr2","65788161","65788447","chr3","20165410","20165696","8","45622751"
"chr2","65829361","65829645","chr3","20209727","20210048","45","45619634"
"chr2","65865009","65865263","chr3","20245377","20245631","6","45619632"
"chr2","65870466","65870661","chr8","135962588","135962771","45","70092122"
"chr2","65922338","65922654","chr3","20302377","20302692","11","45619961"
"chr2","65935372","65935662","chr3","20315397","20315687","3","45619975"
"chr2","65981274","65981559","chr3","20360347","20360631","4","45620927"
"chr2","65999313","65999563","chr3","20378932","20379182","5","45620381"
"chr2","66004534","66004649","chr9","26103194","26103306","25","39901340"
"chr2","66015634","66015882","chr3","20396571","20396777","50","45619063"
"chr2","66017268","66017425","chr3","20398231","20398388","6","45619037"
"chr2","66017533","66017606","chr3","20398496","20398569","2","45619037"
"chr2","66017610","66017782","chr15","40950145","40950323","35","25067465"
"chr2","66020898","66021177","chr3","20401856","20402150","23","45619042"
"chr2","66045282","66045569","chr7","156021146","156021434","62","89975864"
"chr2","66069154","66069451","chr3","20449743","20450030","18","45619411"
"chr2","66074484","66074782","chr3","20455166","20455464","6","45619318"
"chr2","66112400","66112561","chr3","20493039","20493200","1","45619361"
"chr2","66173529","66173814","chr3","20554498","20554777","9","45619031"
"chr2","66195933","66196226","chr19","27639596","27639887","68","38556337"
"chr2","66264087","66264361","chr3","20657225","20657504","9","45606862"
"chr2","66334248","66334542","chr3","20727506","20727800","7","45606742"
"chr2","66342757","66342943","chr3","20736052","20736254","26","45606705"
"chr2","66350222","66350521","chr16","44745004","44745304","58","21605218"
"chr2","66362663","66362813","chr9","23614371","23614519","36","42748292"
"chr2","66379927","66380226","chr3","20772169","20772462","21","45607758"
"chr2","66408010","66408314","chr3","20800607","20800918","20","45607403"
"chr2","66419833","66420129","chr11","110324226","110324522","60","43904393"
"chr2","66434549","66434879","chr10","58391737","58392082","44","8042812"
"chr2","66443560","66443835","chr6","126650613","126650885","64","60207053"
"chr2","66465775","66466077","chr15","106136512","106136811","48","39670737"
"chr2","66533036","66533342","chr3","20875132","20875433","6","45657904"
"chr2","66541693","66541972","chr20","20159744","20160024","51","46381949"
"chr2","66573890","66573946","chr10","16885873","16885925","12","49688017"
"chr2","66575416","66575716","chr3","20920197","20920499","11","45655219"
"chr2","66587397","66587699","chr3","20932337","20932639","8","45655060"
"chr2","66605083","66605381","chr3","20947960","20948256","13","45657123"
"chr2","66646044","66646337","chr3","20990067","20990354","17","45655977"
"chr2","66663167","66663445","chr3","21007154","21007431","14","45656013"
"chr2","66794257","66794535","chr3","21145845","21146125","7","45648412"
"chr2","66815507","66815816","chr3","21167103","21167418","14","45648404"
"chr2","66822677","66822965","chr3","21173766","21174062","9","45648911"
"chr2","67067272","67067445","chr3","21415091","21415230","38","45652181"
"chr2","67117754","67117872","chr3","21466062","21466180","5","45651692"
"chr2","67117918","67118091","chr3","21466235","21466408","4","45651683"
"chr2","67434907","67435206","chr3","21785876","21786173","16","45649031"
"chr2","67585762","67586060","chr3","21933297","21933599","21","45652465"
"chr2","67617241","67617542","chr3","21969445","21969746","2","45647796"
"chr2","67643169","67643476","chr3","21995694","21996004","19","45647475"
"chr2","67687412","67687716","chr3","22040455","22040759","8","45646957"
"chr2","67688254","67688531","chr3","22041304","22041579","12","45646950"
"chr2","67692592","67692884","chr3","22045650","22045943","10","45646942"
"chr2","67705040","67705334","chr3","22057517","22057802","19","45647523"
"chr2","67715861","67716185","chr3","22067392","22067690","35","45648469"
"chr2","67744670","67744971","chr3","22095905","22096206","10","45648765"
"chr2","67751623","67751910","chr3","22102563","22102853","15","45649060"
"chr2","67929654","67929938","chr3","22274605","22274889","14","45655049"
"chr2","67979483","67979785","chr3","22324955","22325254","10","45654528"
"chr2","68158864","68159164","chr3","22511795","22512064","46","45647069"
"chr2","68432884","68433056","chr3","22774453","22774649","29","45658431"
"chr2","68502077","68502274","chr3","22835596","22835795","5","45666481"
"chr2","68502570","68502649","chr3","22836092","22836171","2","45666478"
"chr2","68529091","68529311","chr3","22862231","22862451","16","45666860"
"chr2","68530614","68530914","chr3","22863755","22864070","21","45666859"
"chr2","68604535","68604853","chr1","12196555","12196857","73","56407980"
"chr2","68625723","68626026","chr3","22957900","22958196","16","45667823"
"chr2","68654093","68654239","chr3","22986114","22986265","14","45667979"
"chr2","68654312","68654429","chr3","12584319","12584437","26","56069993"
"chr2","68668702","68668995","chr3","23000672","23000965","8","45668030"
"chr2","68731831","68732022","chr3","23064910","23065090","17","45666921"
"chr2","68766474","68766803","chr3","23101797","23102072","62","45664677"
"chr2","68822231","68822535","chr6","61041618","61041916","64","7780613"
"chr2","68878500","68878812","chr3","23230564","23230872","11","45647936"
"chr2","68972350","68972581","chr3","23323103","23323334","10","45649247"
"chr2","69212802","69213011","chr3","23561957","23562166","6","45650845"
"chr2","69247689","69247873","chr10","74539826","74540014","55","5292137"
"chr2","69247907","69247929","chr1","191136964","191136985","4","121889057"
"chr2","69292657","69292961","chr3","23644678","23644986","20","45647979"
"chr2","69349434","69349619","chr2","2087549","2087730","16","67261885"
"chr2","69406266","69406407","chr3","160740297","160740432","33","91334031"
"chr2","69433990","69434268","chr3","12644640","12644921","58","56789350"
"chr2","69442557","69442788","JH679894","282","514","5","69442275"
"chr2","69504029","69504292","chr13","72828429","72828689","73","3324400"
"chr2","69580033","69580351","chr6","28637143","28637446","33","40942890"
"chr2","69595460","69595597","chr2","87101974","87102112","27","17506514"
"chr2","69659287","69659454","chr18","13429646","13429816","35","56229641"
"chr2","69659496","69659601","chr14","21470897","21470997","26","48188599"
"chr2","69697532","69697847","chr3","23770061","23770377","21","45927471"
"chr2","69707433","69707706","chr3","23787189","23787459","13","45920244"
"chr2","69707717","69707986","chr3","23787470","23787758","22","45920247"
"chr2","69733592","69733874","chr3","23807849","23808133","11","45925743"
"chr2","69766206","69766490","chr3","23835513","23835808","19","45930693"
"chr2","69768627","69768918","chr3","23838050","23838341","10","45930577"
"chr2","69784088","69784204","chr3","23853334","23853448","5","45930754"
"chr2","69817324","69817367","chr3","23885843","23885885","2","45931481"
"chr2","69817685","69817908","chr3","23886199","23886422","2","45931486"
"chr2","69915055","69915371","chr3","23984176","23984481","16","45930879"
"chr2","69925430","69925738","chr3","23994274","23994582","8","45931156"
"chr2","69927433","69927713","chr3","23996275","23996555","7","45931158"
"chr2","69987664","69987950","chr3","24063937","24064225","16","45923727"
"chr2","70030707","70030980","chr3","24107552","24107824","9","45923155"
"chr2","70044749","70045055","chr3","24118753","24119055","16","45925996"
"chr2","70070343","70070641","chr3","24145487","24145795","26","45924856"
"chr2","70085059","70085144","chrX","55284355","55284439","35","14800704"
"chr2","70093323","70093483","chr3","24193723","24193888","6","45899600"
"chr2","70171986","70172044","chr3","24274563","24274621","0","45897423"
"chr2","70172047","70172176","chr5","94185945","94186058","35","24013898"
"chr2","70172217","70172295","chr7","40687982","40688058","23","29484235"
"chr2","70235431","70235722","chr3","24338644","24338954","36","45896787"
"chr2","70270955","70271268","chr3","24376672","24376985","9","45894283"
"chr2","70461053","70461325","chr16","30705335","30705605","58","39755718"
"chr2","70486573","70486738","chrX","14138574","14138739","32","56347999"
"chr2","70509084","70509268","chr2","48536192","48536378","45","21972892"
"chr2","70547261","70547542","chr17","27854216","27854497","55","42693045"
"chr2","70563635","70563753","chr3","24664202","24664321","4","45899433"
"chr2","70563779","70563961","chr3","24664346","24664529","8","45899433"
"chr2","70617545","70617838","chr3","24720039","24720333","6","45897506"
"chr2","70692425","70692763","chr19","14375828","14376182","103","56316597"
"chr2","70779876","70779945","chr3","24882028","24882097","2","45897848"
"chr2","70889646","70889939","chr3","24990000","24990293","9","45899646"
"chr2","70967810","70968103","chr3","25069285","25069581","9","45898525"
"chr2","71047207","71047491","chr3","25148671","25148954","11","45898536"
"chr2","71147059","71147378","chr3","25253887","25254207","6","45893172"
"chr2","71259567","71259905","chr6","66186762","66187102","81","5072805"
"chr2","71293651","71293942","chr3","25397319","25397611","15","45896332"
"chr2","71449958","71450262","chr3","25553455","25553759","10","45896503"
"chr2","71584419","71584621","chr3","25692058","25692260","9","45892361"
"chr2","71709501","71709801","chr3","25817423","25817724","13","45892078"
"chr2","71753627","71753905","chr3","25861745","25862024","7","45891882"
"chr2","71804354","71804457","chr3","25914948","25915054","12","45889406"
"chr2","71938418","71938684","chr3","26051132","26051398","13","45887286"
"chr2","72002316","72002624","chr3","26117691","26117995","14","45884625"
"chr2","72043857","72044036","chr3","26159464","26159641","8","45884393"
"chr2","72077897","72078181","chr3","26198414","26198698","13","45879483"
"chr2","72184465","72184782","chr3","26304736","26305049","15","45879729"
"chr2","72188601","72188906","chr3","26308957","26309266","18","45879644"
"chr2","72203348","72203624","chr3","26329252","26329529","10","45874096"
"chr2","72306630","72306928","chr5","74573818","74574118","51","2267188"
"chr2","72378822","72379121","chr14","107286960","107287259","62","34908138"
"chr2","72530615","72530915","chr3","26647984","26648284","9","45882631"
"chr2","72656952","72657255","chr3","26770442","26770745","4","45886510"
"chr2","72713455","72713730","chr3","26828777","26829066","19","45884678"
"chr2","73132166","73132458","chrX","44872889","44873177","59","28259277"
"chr2","73177097","73177366","chr3","27303863","27304161","36","45873234"
"chr2","73289123","73289429","chr3","27411015","27411334","30","45878108"
"chr2","73305446","73305756","chr3","27428874","27429187","9","45876572"
"chr2","73391103","73391332","chr3","27508303","27508532","4","45882800"
"chr2","73611811","73612093","chr16","32410867","32411152","65","41200944"
"chr2","73709914","73710212","chr3","27831890","27832180","16","45878024"
"chr2","73724932","73725299","chr16","69245717","69246070","98","4479215"
"chr2","73810533","73810805","chr3","37900761","37901036","60","35909772"
"chr2","73871326","73871641","chr1","203490003","203490305","72","129618677"
"chr2","73928010","73928390","chr7","22259549","22259919","116","51668461"
"chr2","73955647","73955794","chr2","172227852","172227991","19","98272205"
"chr2","74003466","74003739","chr3","28140244","28140520","13","45863222"
"chr2","74068666","74068807","chr3","28204342","28204476","13","45864324"
"chr2","74069144","74069328","chr3","28204798","28204982","6","45864346"
"chr2","74151952","74152259","chr3","28288762","28289065","18","45863190"
"chr2","74167458","74167765","chr3","28304923","28305206","38","45862535"
"chr2","74334460","74334769","chr3","28477774","28478085","14","45856686"
"chr2","74528689","74528956","chr3","28681218","28681520","42","45847471"
"chr2","74708331","74708516","chr13","47285224","47285397","35","27423107"
"chr2","74729561","74729872","chr3","28886165","28886462","26","45843396"
"chr2","74730729","74730963","chr3","28887313","28887544","15","45843416"
"chr2","74742429","74742737","chr3","28898267","28898572","8","45844162"
"chr2","74765686","74765800","chr3","28920254","28920369","8","45845432"
"chr2","74765919","74766227","chr3","28920488","28920809","22","45845431"
"chr2","74789236","74789553","chr11","117091343","117091653","69","42302107"
"chr2","74792651","74792955","chr3","28947894","28948198","6","45844757"
"chr2","74800889","74801135","chr1","44051317","44051557","65","30749572"
"chr2","74840292","74840598","chr3","28992753","28993059","3","45847539"
"chr2","74841085","74841362","chr3","28993546","28993851","40","45847539"
"chr2","74852177","74852289","chr2","77533066","77533185","20","2680889"
"chr2","74860135","74860284","chr3","29014041","29014189","9","45846094"
"chr2","74860338","74860352","chr3","29014220","29014234","0","45846118"
"chr2","74868508","74868774","chr3","29022295","29022568","16","45846213"
"chr2","74897178","74897481","chr3","29045660","29045961","8","45851518"
"chr2","74931458","74931760","chr3","29077899","29078201","7","45853559"
"chr2","74957460","74957765","chr3","29105151","29105464","13","45852309"
"chr2","74970818","74971006","chr3","29117947","29118135","3","45852871"
"chr2","74972754","74972853","chr3","29119885","29119984","5","45852869"
"chr2","74977144","74977349","chr13","35317577","35317785","47","39659567"
"chr2","74984719","74985012","chr3","29132207","29132502","4","45852512"
"chr2","75000029","75000318","chr3","29147508","29147796","5","45852521"
"chr2","75016750","75017034","chr3","29160133","29160417","10","45856617"
"chr2","75017208","75017491","chr3","29160597","29160880","7","45856611"
"chr2","75019040","75019324","chr3","29162424","29162697","23","45856616"
"chr2","75032470","75032711","chr3","29178636","29178877","5","45853834"
"chr2","75035127","75035419","chr3","29181416","29181721","16","45853711"
"chr2","75058931","75059229","chr1","196391727","196392029","53","121332796"
"chr2","75059465","75059845","chr5","158935074","158935422","121","83875609"
"chr2","75084213","75084506","chr3","29233882","29234175","3","45850331"
"chr2","75096492","75096789","chr3","29247887","29248181","8","45848605"
"chr2","75111820","75111996","chr3","29260171","29260346","4","45851649"
"chr2","75114636","75114759","chr1","127802671","127802794","26","52688035"
"chr2","75120849","75121133","chr3","29268783","29269066","2","45852066"
"chr2","75128395","75128692","chr3","29277566","29277863","13","45850829"
"chr2","75131661","75131941","chr3","29279058","29279338","8","45852603"
"chr2","75143555","75143858","chr3","29291801","29292082","28","45851754"
"chr2","75160030","75160353","chr3","29308428","29308756","16","45851602"
"chr2","75166651","75166974","chr7","158585944","158586255","64","83419293"
"chr2","75172071","75172374","chr3","29320428","29320739","15","45851643"
"chr2","75322173","75322482","chr3","29470897","29471201","10","45851276"
"chr2","75440427","75440584","chr3","29600912","29601066","9","45839515"
"chr2","75450568","75450866","chr3","29611403","29611723","49","45839165"
"chr2","75455485","75455700","chr3","29616351","29616580","19","45839134"
"chr2","75482758","75482998","chr3","29644374","29644613","8","45838384"
"chr2","75540185","75540470","chr3","29699958","29700268","35","45840227"
"chr2","75640000","75640189","chr3","29800962","29801151","5","45839038"
"chr2","75696171","75696453","chr1","54916700","54916978","54","20779471"
"chr2","75701135","75701211","chr3","29861012","29861083","6","45840123"
"chr2","75732086","75732396","chr3","29892433","29892715","44","45839653"
"chr2","75733547","75733840","chr3","29893799","29894092","12","45839748"
"chr2","75735194","75735502","chr13","41851851","41852159","63","33883343"
"chr2","75795465","75795771","chr3","29955290","29955587","15","45840175"
"chr2","76041012","76041196","chr3","30201354","30201538","11","45839658"
"chr2","76084891","76085209","chr3","30244268","30244586","5","45840623"
"chr2","76113084","76113164","chr3","30272779","30272859","0","45840305"
"chr2","76113293","76113474","chr3","30272988","30273172","4","45840305"
"chr2","76160419","76160634","chr3","30320506","30320711","15","45839913"
"chr2","76194907","76195203","chr3","30355963","30356234","30","45838944"
"chr2","76308959","76309168","chr20","49108978","49109183","39","27199981"
"chr2","76388289","76388619","chr3","30565066","30565376","31","45823223"
"chr2","76503491","76503780","chr3","30690034","30690324","4","45813457"
"chr2","76512386","76512636","chr3","30698958","30699211","7","45813428"
"chr2","76631027","76631336","chr3","30819073","30819385","18","45811954"
"chr2","76862721","76862949","chr3","31052621","31052849","9","45810100"
"chr2","76879794","76880059","chrX","7754021","7754287","60","69125773"
"chr2","76900616","76900936","chr3","31090167","31090486","8","45810449"
"chr2","76915871","76916148","chr3","31105221","31105498","7","45810650"
"chr2","76951353","76951658","chr3","31140632","31140933","10","45810721"
"chr2","77117062","77117358","chr3","31311173","31311479","19","45805889"
"chr2","77138816","77138996","chr3","31331980","31332157","6","45806836"
"chr2","77313224","77313521","chr3","31507491","31507814","36","45805733"
"chr2","77324824","77325140","chr2","177261106","177261421","75","99936282"
"chr2","77346637","77346934","chr3","31544064","31544359","8","45802573"
"chr2","77367179","77367454","chr3","31565408","31565683","17","45801771"
"chr2","77399890","77400215","chr3","31598066","31598390","12","45801824"
"chr2","77404859","77405173","chr3","31603251","31603572","15","45801608"
"chr2","77424424","77424692","chr3","31622283","31622555","18","45802141"
"chr2","77438175","77438310","chr3","31635326","31635443","19","45802849"
"chr2","77560570","77560654","chr1","58740674","58740760","12","18819896"
"chr2","77562887","77563176","chr3","31759671","31759980","26","45803216"
"chr2","77569970","77570249","chr3","31766817","31767100","15","45803153"
"chr2","77624072","77624380","chr3","31817200","31817509","11","45806872"
"chr2","77633975","77634260","chr3","31827067","31827352","15","45806908"
"chr2","77641407","77641671","chr3","31835878","31836138","20","45805529"
"chr2","77701587","77701894","chr3","31902371","31902679","17","45799216"
"chr2","77797196","77797503","chr3","32001816","32002122","11","45795380"
"chr2","77811944","77812251","chr3","32016845","32017151","13","45795099"
"chr2","77836076","77836373","chr3","32041074","32041368","15","45795002"
"chr2","77953079","77953370","chr6","166490321","166490614","66","88537242"
"chr2","77967796","77968096","chr3","32166956","32167262","13","45800840"
"chr2","77979071","77979369","chr3","32178026","32178326","12","45801045"
"chr2","77981397","77981587","chr3","32180669","32180859","7","45800728"
"chr2","78076029","78076334","chr3","32278313","32278621","15","45797716"
"chr2","78117398","78117515","chr3","32329778","32329895","5","45787620"
"chr2","78118167","78118502","chr3","32330538","32330852","32","45787629"
"chr2","78247851","78248016","chr1","23596488","23596653","31","54651363"
"chr2","78365602","78365881","chr6","106275071","106275352","29","27909469"
"chr2","78403032","78403324","chr3","32535078","32535364","14","45867954"
"chr2","78433303","78433480","chr16","18166958","18167135","36","60266345"
"chr2","78435963","78436289","chr1","216385363","216385697","77","137949400"
"chr2","78505102","78505405","chr3","12087017","12087320","12","66418085"
"chr2","78542877","78543183","chr14","11896019","11896327","63","66646858"
"chr2","78599958","78600250","chr3","11983741","11984033","5","66616217"
"chr2","78615263","78615538","chr3","11968468","11968743","15","66646795"
"chr2","78619525","78619670","chr3","11964317","11964463","2","66655208"
"chr2","78621309","78621617","chr3","11962384","11962686","13","66658925"
"chr2","78682525","78682652","chr5","353024","353149","25","78329501"
"chr2","78682805","78682977","chr7","15802966","15803143","40","62879839"
"chr2","78691625","78691897","chr3","11890879","11891151","3","66800746"
"chr2","78710226","78710497","chr3","11872360","11872634","12","66837866"
"chr2","78728582","78728753","chr11","124217507","124217665","33","45488925"
"chr2","78728763","78728809","chr4","20337879","20337923","5","58390884"
"chr2","78733457","78733770","chr3","11849004","11849315","23","66884453"
"chr2","78753945","78754276","chr3","11827883","11828209","26","66926062"
"chr2","78898567","78898892","chr3","11681671","11681994","10","67216896"
"chr2","78958806","78959106","chr3","11621117","11621416","9","67337689"
"chr2","79016651","79016928","chr3","11564270","11564547","13","67452381"
"chr2","79026612","79026917","chr3","11554886","11555188","11","67471726"
"chr2","79054409","79054704","chr3","11527210","11527504","9","67527199"
"chr2","79104479","79104736","chrX","111975908","111976168","69","32871429"
"chr2","79126000","79126152","chr19","16369426","16369572","33","62756574"
"chr2","79126726","79126852","chr1","19748519","19748641","24","59378207"
"chr2","79189339","79189632","chr3","11393853","11394161","24","67795486"
"chr2","79230343","79230474","chr3","11352882","11353015","18","67877461"
"chr2","79291864","79292155","chr3","11291178","11291469","7","68000686"
"chr2","79535113","79535405","chr3","11049888","11050206","29","68485225"
"chr2","79691120","79691417","chr3","10894160","10894457","10","68796960"
"chr2","79741528","79741823","chr3","10842594","10842866","32","68898934"
"chr2","79788617","79788861","chr3","10796027","10796275","15","68992590"
"chr2","79817687","79817979","chr3","10766925","10767217","9","69050762"
"chr2","79821957","79822245","chr13","108163992","108164277","53","28342035"
"chr2","79823423","79823502","chr3","10761706","10761770","18","69061717"
"chr2","79833335","79833448","chr3","10751739","10751848","14","69081596"
"chr2","79863342","79863575","chr3","10720902","10721132","11","69142440"
"chr2","79875981","79876239","chr1","67528842","67529110","52","12347139"
"chr2","79950531","79950813","chr3","10599052","10599333","19","69351479"
"chr2","79962374","79962527","chr3","10587325","10587479","4","69375049"
"chr2","80005127","80005433","chr3","10543012","10543316","9","69462115"
"chr2","80037039","80037333","chr3","10511547","10511836","13","69525492"
"chr2","80052987","80053273","chr20","2899227","2899498","63","77153760"
"chr2","80082948","80083250","chr3","10465490","10465792","13","69617458"
"chr2","80113427","80113601","chr3","10435668","10435842","6","69677759"
"chr2","80114588","80114707","chr3","10434565","10434685","4","69680023"
"chr2","80115849","80115999","chr2","77734436","77734584","27","2381413"
"chr2","80116635","80116750","chr3","42913151","42913268","24","37203484"
"chr2","80124663","80124842","chr8","136041581","136041762","40","55916918"
"chr2","80125258","80125541","chr3","10424101","10424415","38","69701157"
"chr2","80134556","80134835","chr3","10414718","10414998","6","69719838"
"chr2","80137779","80138092","chr3","10410248","10410561","7","69727531"
"chr2","80140023","80140317","chr3","10408041","10408336","10","69731982"
"chr2","80146989","80147286","chr3","10386989","10387310","35","69760000"
"chr2","80168330","80168635","chr12","62799016","62799324","62","17369314"
"chr2","80178580","80178853","chr3","10371841","10372124","17","69806739"
"chr2","80180537","80180722","chr3","10369958","10370139","12","69810579"
"chr2","80186569","80186740","chr3","10363258","10363430","2","69823311"
"chr2","80188410","80188681","chr3","10361319","10361590","6","69827091"
"chr2","80190636","80190944","chrX","46200808","46201119","56","33989828"
"chr2","80191770","80192024","chr3","10357666","10357914","21","69834104"
"chr2","80195549","80195769","chr3","10354029","10354239","13","69841520"
"chr2","80215893","80216036","chr10","14521743","14521885","31","65694150"
"chr2","80217645","80217948","chr3","10329557","10329865","20","69888088"
"chr2","80226684","80226990","chr3","10319564","10319871","13","69907120"
"chr2","80232460","80232624","chr3","10313827","10313991","3","69918633"
"chr2","80233057","80233185","chr6","167269323","167269454","17","87036266"
"chr2","80239079","80239369","chr3","10308243","10308538","16","69930836"
"chr2","80263248","80263507","chr3","10283064","10283323","9","69980184"
"chr2","80266077","80266373","chr15","10624352","10624650","67","69641725"
"chr2","80271391","80271671","chr3","10275111","10275392","3","69996280"
"chr2","80274762","80274900","chr20","56351459","56351594","36","23923303"
"chr2","80276361","80276450","chr3","10270011","10270105","6","70006350"
"chr2","80280193","80280473","chr3","10265974","10266264","20","70014219"
"chr2","80281776","80282060","chr3","10264403","10264686","4","70017373"
"chr2","80288017","80288257","chr3","10258119","10258359","6","70029898"
"chr2","80295641","80295839","chr7","120531145","120531344","41","40235504"
"chr2","80300882","80301201","chr3","10243088","10243399","21","70057794"
"chr2","80313345","80313642","chr6","61041618","61041916","63","19271727"
"chr2","80314318","80314516","chr3","10224625","10224823","5","70089693"
"chr2","80314809","80314950","chr3","10224187","10224332","9","70090622"
"chr2","80329227","80329443","chr7","106385824","106386035","56","26056597"
"chr2","80330035","80330333","chr3","10209051","10209343","17","70120984"
"chr2","80340545","80340822","chr3","10197599","10197876","3","70142946"
"chr2","80344006","80344292","chr3","10194115","10194401","10","70149891"
"chr2","80352118","80352226","chr19","3646710","3646819","29","76705408"
"chr2","80353300","80353482","chr3","10184552","10184759","30","70168748"
"chr2","80369057","80369307","chr3","10168857","10169107","8","70200200"
"chr2","80373442","80373737","chr3","10164450","10164744","13","70208992"
"chr2","80374176","80374474","chr3","10163718","10164026","31","70210458"
"chr2","80374885","80375166","chr3","10163024","10163306","9","70211861"
"chr2","80381490","80381801","chr4","152226280","152226592","55","71844790"
"chr2","80386056","80386271","chr3","10152123","10152337","9","70233933"
"chr2","80389159","80389455","chr3","10148933","10149223","12","70240226"
"chr2","80390850","80391125","chr3","10147306","10147581","15","70243544"
"chr2","80402481","80402621","chr3","10135839","10135979","4","70266642"
"chr2","80409876","80410113","chr3","10128317","10128554","11","70281559"
"chr2","80410427","80410560","chr3","10127874","10128007","3","70282553"
"chr2","80415200","80415338","chr9","19767173","19767318","31","60648027"
"chr2","80422843","80423136","chr3","10114914","10115207","14","70307929"
"chr2","80429754","80429895","chr11","92398675","92398825","36","11968921"
"chr2","80434253","80434412","chr3","10103537","10103656","43","70330716"
"chr2","80434413","80434712","chr3","10103240","10103535","9","70331173"
"chr2","80435869","80436178","chr3","10101754","10102063","12","70334115"
"chr2","80440488","80440629","chr3","10097330","10097493","24","70343158"
"chr2","80442949","80443238","chr3","10094705","10095007","23","70348244"
"chr2","80450110","80450407","chr3","10085566","10085889","41","70364544"
"chr2","80487286","80487588","chr3","10049063","10049372","29","70438223"
"chr2","80491078","80491372","chr3","10045303","10045596","6","70445775"
"chr2","80507921","80508227","chr3","10028457","10028762","14","70479464"
"chr2","80518663","80518971","chr3","10017845","10018151","15","70500818"
"chr2","80591449","80591643","chr3","9941391","9941569","24","70650058"
"chr2","80591766","80591898","chr15","38579742","38579873","23","42012024"
"chr2","80601597","80601910","chrX","15486605","15486916","59","65114992"
"chr2","80644485","80644793","chr3","9887088","9887392","25","70757397"
"chr2","80646219","80646516","chr3","9885358","9885654","6","70760861"
"chr2","80655348","80655582","chr3","9876689","9876924","7","70778659"
"chr2","80661734","80662005","chr10","23327960","23328230","52","57333774"
"chr2","80668166","80668467","chr3","9869197","9869494","8","70798969"
"chr2","80706540","80706822","chr3","9831319","9831617","30","70875221"
"chr2","80707127","80707397","chr3","9830747","9831017","9","70876380"
"chr2","80742664","80742966","chr3","9794929","9795242","18","70947735"
"chr2","80748759","80748977","chr3","9788846","9789060","17","70959913"
"chr2","80750161","80750454","chr3","9787354","9787664","30","70962807"
"chr2","80759513","80759675","chr11","109860880","109861035","30","29101367"
"chr2","80788795","80789099","chr3","9745193","9745497","4","71043602"
"chr2","80795573","80795781","chr15","6130205","6130419","41","74665368"
"chr2","80812903","80813210","chr3","9721706","9722012","36","71091197"
"chr2","80825377","80825645","chr3","9708432","9708700","3","71116945"
"chr2","80838469","80838767","chr3","9695654","9695944","15","71142815"
"chr2","80878358","80878639","chr3","9654193","9654500","34","71224165"
"chr2","80879823","80880107","chr3","9654193","9654500","31","71225630"
"chr2","80882579","80882860","chr3","9651461","9651742","5","71231118"
"chr2","80910826","80911131","chr3","9622585","9622901","18","71288241"
"chr2","80912378","80912671","chr3","9621044","9621326","20","71291334"
"chr2","80922540","80922817","chr3","9610894","9611168","13","71311646"
"chr2","80927795","80928102","chr3","9605618","9605919","11","71322177"
"chr2","80930500","80930797","chr17","6616556","6616863","47","74313944"
"chr2","80933013","80933306","chr3","9600417","9600715","9","71332596"
"chr2","80954895","80955192","chr3","9578326","9578628","13","71376569"
"chr2","80957301","80957597","chr3","9576813","9577110","7","71380488"
"chr2","80962628","80962890","chr3","9571660","9571933","19","71390968"
"chr2","80971966","80972243","chr3","9562571","9562856","17","71409395"
"chr2","80975055","80975344","chr3","9559462","9559760","23","71415593"
"chr2","80981783","80982074","chr3","9551145","9551433","15","71430638"
"chr2","80984715","80985024","chr3","9547509","9547814","9","71437206"
"chr2","80990272","80990439","chr3","9542098","9542255","15","71448174"
"chr2","80990468","80990495","chr1","53082167","53082195","6","27908301"
"chr2","80990521","80990811","chr3","9541724","9542002","21","71448797"
"chr2","80999829","80999997","chrX","97841720","97841891","37","16841891"
"chr2","81005331","81005612","chr3","9523731","9524015","19","71481600"
"chr2","81011857","81012165","chr3","9515672","9515971","22","71496185"
"chr2","81013161","81013204","chr3","9514634","9514677","1","71498527"
"chr2","81013884","81014015","chr3","9513796","9513954","31","71500088"
"chr2","81014488","81014795","chr17","6616556","6616863","42","74397932"
"chr2","81018878","81018998","chr3","9509348","9509467","2","71509530"
"chr2","81019298","81019466","chr3","9508887","9509050","11","71510411"
"chr2","81022091","81022388","chr2","102550796","102551069","64","21528705"
"chr2","81023820","81024105","chr3","9504242","9504527","4","71519578"
"chr2","81032514","81032809","chr3","9494865","9495160","6","71537649"
"chr2","81043149","81043346","chr3","9484002","9484198","2","71559147"
"chr2","81111740","81111829","chr3","9414804","9414893","0","71696936"
"chr2","81111831","81112121","chr3","9414516","9414802","11","71697315"
"chr2","81143568","81143879","chr3","9382438","9382748","8","71761130"
"chr2","81150339","81150623","chr3","9375353","9375637","8","71774986"
"chr2","81171090","81171371","chr3","9354417","9354701","15","71816673"
"chr2","81172326","81172411","chr3","9353376","9353462","2","71818950"
"chr2","81205779","81206065","chr3","9319873","9320159","3","71885906"
"chr2","81210258","81210550","chr3","9315404","9315700","6","71894854"
"chr2","81220344","81220598","chr3","9305279","9305532","8","71915065"
"chr2","81235441","81235744","chr3","9290353","9290657","9","71945088"
"chr2","81271309","81271567","chr3","9255021","9255279","14","72016288"
"chr2","81277263","81277545","chr9","54541366","54541657","57","26735897"
"chr2","81277899","81278185","chr3","9247855","9248141","9","72030044"
"chr2","81283499","81283660","chr3","9242730","9242891","1","72040769"
"chr2","81284038","81284179","chr3","9242212","9242352","3","72041826"
"chr2","81298670","81298952","chr3","9229460","9229726","24","72069210"
"chr2","81301300","81301589","chr11","50254076","50254361","58","31047224"
"chr2","81302985","81303112","chr16","22932775","22932908","19","58370210"
"chr2","81303405","81303582","chr7","19517713","19517888","29","61785692"
"chr2","81304639","81304923","chr3","9223229","9223513","5","72081410"
"chr2","81313573","81313858","chr3","9214300","9214584","8","72099273"
"chr2","81313885","81313906","chr3","9214251","9214272","0","72099634"
"chr2","81322972","81323256","chr3","9205008","9205306","19","72117964"
"chr2","81332748","81332918","chr3","9195637","9195807","3","72137111"
"chr2","81368742","81369020","chr3","9159953","9160207","27","72208789"
"chr2","81401735","81402047","chr12","62799016","62799324","56","18602719"
"chr2","81420484","81420774","chr3","9108482","9108772","3","72312002"
"chr2","81447370","81447545","chr3","9082025","9082200","6","72365345"
"chr2","81461513","81461773","chr9","6398719","6399006","62","75062794"
"chr2","81474814","81475086","chr20","1239714","1239984","64","80235100"
"chr2","81476920","81477222","chr3","9052515","9052814","14","72424405"
"chr2","81488619","81488827","chr3","9041275","9041491","16","72447344"
"chr2","81490167","81490468","chr3","9039630","9039934","13","72450537"
"chr2","81527775","81528078","chr3","9006566","9006866","9","72521209"
"chr2","81534494","81534797","chr3","8994963","8995264","20","72539531"
"chr2","81588770","81589053","chr3","8941309","8941592","8","72647461"
"chr2","81597244","81597426","chr3","8933000","8933181","6","72664244"
"chr2","81661098","81661235","chr3","8867465","8867602","4","72793633"
"chr2","81705587","81705928","chr2","51467652","51467983","86","30237935"
"chr2","81732972","81733292","chr3","8795742","8796076","22","72937230"
"chr2","81895283","81895595","chr3","8629430","8629701","54","73265853"
"chr2","81938065","81938365","chr3","8587098","8587398","8","73350967"
"chr2","82035615","82035915","chr3","8485256","8485539","32","73550359"
"chr2","82133997","82134079","chr3","8385639","8385721","0","73748358"
"chr2","82264688","82265016","chr3","8255514","8255804","47","74009174"
"chr2","82374713","82375017","chr3","8143183","8143486","24","74231530"
"chr2","82424683","82424978","chr3","8095075","8095369","6","74329608"
"chr2","82614540","82614824","chr3","7902699","7902966","25","74711841"
"chr2","82703774","82704015","chr3","7814709","7814950","4","74889065"
"chr2","82726303","82726606","chr7","39988343","39988638","47","42737960"
"chr2","82729898","82730195","chr3","7788684","7788981","4","74941214"
"chr2","82741237","82741446","chr3","7777375","7777581","13","74963862"
"chr2","82791065","82791368","chr3","7727374","7727673","10","75063691"
"chr2","82813564","82813694","chr3","7703824","7703974","26","75109740"
"chr2","82814069","82814227","chr3","7703291","7703449","8","75110778"
"chr2","82828900","82829210","chr3","7688281","7688616","31","75140619"
"chr2","82861664","82861873","chr3","7655313","7655517","14","75206351"
"chr2","82871128","82871443","chr3","7645772","7646081","17","75225356"
"chr2","82882454","82882750","chr3","7634881","7635185","15","75247573"
"chr2","82954162","82954239","chr3","7561445","7561526","7","75392717"
"chr2","83099974","83100269","chr3","7414819","7415114","10","75685155"
"chr2","83104987","83105107","chr7","19596811","19596930","30","63508176"
"chr2","83176481","83176787","chr3","7338819","7339125","7","75837662"
"chr2","83181733","83182061","chr3","7333492","7333822","9","75848241"
"chr2","83196238","83196426","chr3","7319451","7319654","18","75876787"
"chr2","83206942","83207189","chr3","7308128","7308383","14","75898814"
"chr2","83220012","83220332","chr6","143542879","143543191","68","60322867"
"chr2","83226371","83226660","chr8","24814774","24815076","70","58411597"
"chr2","83237688","83237947","chr3","7277662","7277915","12","75960026"
"chr2","83241534","83241792","chr4","43105703","43105947","73","40135831"
"chr2","83242593","83242754","chr3","7272086","7272254","9","75970507"
"chr2","83248510","83248814","chr3","40382841","40383151","59","42865669"
"chr2","83252241","83252509","chr3","7262284","7262551","6","75989957"
"chr2","83264573","83264830","chr3","7249418","7249675","8","76015155"
"chr2","83268203","83268337","chr3","7246257","7246391","4","76021946"
"chr2","83268635","83268652","chr3","7245941","7245959","3","76022694"
"chr2","83268951","83269141","chr10","31437574","31437756","41","51831377"
"chr2","83269142","83269211","chr4","27924851","27924917","17","55344291"
"chr2","83269513","83269623","chr14","54825789","54825899","26","28443724"
"chr2","83271183","83271245","chr2","153520780","153520840","12","70249597"
"chr2","83271469","83271710","chr19","36575939","36576163","62","46695530"
"chr2","83273364","83273535","chr3","7241981","7242152","7","76031383"
"chr2","83274315","83274458","chr3","7241078","7241205","20","76033237"
"chr2","83274729","83274897","chr3","7240318","7240484","4","76034411"
"chr2","83304283","83304541","chr3","7208345","7208614","20","76095938"
"chr2","83314146","83314368","chr11","110383049","110383272","47","27068903"
"chr2","83324574","83324853","chr3","7187037","7187315","5","76137537"
"chr2","83334010","83334151","chr3","7176538","7176679","5","76157472"
"chr2","83352722","83352990","chr3","7156646","7156914","7","76196076"
"chr2","83376302","83376599","chr3","7132375","7132671","9","76243927"
"chr2","83377745","83378040","chr3","7131254","7131551","11","76246491"
"chr2","83382039","83382296","chr3","7126991","7127260","13","76255048"
"chr2","83382757","83383020","chr3","7126269","7126533","4","76256488"
"chr2","83383553","83383786","chr16","22668545","22668784","57","60715008"
"chr2","83385491","83385778","chr3","7123438","7123730","10","76262053"
"chr2","83386484","83386744","chr3","7122143","7122403","6","76264341"
"chr2","83390099","83390363","chr3","7118201","7118465","5","76271898"
"chr2","83407231","83407525","chr3","7101058","7101357","7","76306173"
"chr2","83420856","83421165","chr3","7087610","7087894","37","76333246"
"chr2","83430977","83431277","chr1","21109084","21109381","49","62321893"
"chr2","83434562","83434847","chr3","7072708","7072999","13","76361854"
"chr2","83457346","83457642","chr3","7049270","7049561","11","76408076"
"chr2","83490158","83490275","chr3","7016654","7016769","3","76473504"
"chr2","83502145","83502205","chr7","39038812","39038876","13","44463333"
"chr2","83502256","83502286","chr13","36192546","36192579","10","47309710"
"chr2","83502708","83503092","chr3","76278684","76279065","102","7224024"
"chr2","83511939","83512116","chr3","6995205","6995389","17","76516734"
"chr2","83512158","83512310","chr3","6995025","6995152","28","76517133"
"chr2","83516599","83516834","chr3","6990520","6990757","10","76526079"
"chr2","83517227","83517506","chr3","6989857","6990132","6","76527370"
"chr2","83589202","83589507","chr3","6918093","6918401","17","76671109"
"chr2","83626007","83626300","chr3","6881553","6881849","14","76744454"
"chr2","83642404","83642689","chr3","6865472","6865772","21","76776932"
"chr2","83644016","83644125","chr3","6864044","6864155","6","76779972"
"chr2","83660508","83660792","chr10","38033514","38033802","50","45626994"
"chr2","83678656","83678969","chr3","6822167","6822480","8","76856489"
"chr2","83705427","83705555","chr3","6798396","6798511","17","76907031"
"chr2","83720754","83721057","chr3","6783215","6783515","14","76937539"
"chr2","83767569","83767782","chr3","6732106","6732315","13","77035463"
"chr2","83779227","83779527","chr3","6720412","6720708","17","77058815"
"chr2","83887848","83888150","chr3","6610571","6610867","12","77277277"
"chr2","83896803","83897066","chr3","6601681","6601959","19","77295122"
"chr2","83965573","83965646","chr13","46870270","46870337","11","37095303"
"chr2","84057051","84057365","chr3","6442916","6443225","16","77614135"
"chr2","84059612","84059731","chr15","25629621","25629741","21","58429991"
"chr2","84059762","84059947","chr3","2024698","2024867","37","82035064"
"chr2","84127636","84127947","chr3","6367844","6368125","36","77759792"
"chr2","84234967","84235059","chr7","110334063","110334148","37","26099096"
"chr2","84235092","84235188","chr1","994671","994766","37","83240421"
"chr2","84235349","84235463","chr16","68306485","68306601","23","15928864"
"chr2","84256654","84256988","chr3","6231958","6232295","9","78024696"
"chr2","84286985","84287054","chr16","49442937","49443006","14","34844048"
"chr2","84346044","84346358","chrX","121188280","121188585","58","36842236"
"chr2","84385547","84385841","chr3","6097966","6098240","24","78287581"
"chr2","84395154","84395444","chr3","6088199","6088504","30","78306955"
"chr2","84435637","84435916","chr3","6048492","6048765","23","78387145"
"chr2","84477857","84478147","chr3","6006144","6006428","12","78471713"
"chr2","84485162","84485462","chr3","5998872","5999162","21","78486290"
"chr2","84492072","84492369","chr1","24655680","24655979","54","59836392"
"chr2","84524885","84525143","chr3","5959282","5959539","4","78565603"
"chr2","84537768","84537938","chrX","49524523","49524692","27","35013245"
"chr2","84537968","84538061","chr20","20835624","20835714","20","63702344"
"chr2","84574772","84575034","chr3","5908636","5908898","11","78666136"
"chr2","84674370","84674661","chr3","5805982","5806292","27","78868388"
"chr2","84700433","84700754","chr3","5780711","5781025","29","78919722"
"chr2","84715805","84716125","chr3","5765151","5765460","13","78950654"
"chr2","84778682","84778819","chr3","5702460","5702602","12","79076222"
"chr2","84794360","84794378","chr10","10594930","10594946","5","74199430"
"chr2","84794745","84794899","chr11","6394722","6394881","38","78400023"
"chr2","84878994","84879234","chr3","5597848","5598087","12","79281146"
"chr2","84890671","84890941","chr3","5586200","5586475","26","79304471"
"chr2","84897972","84898212","chr3","5597848","5598087","12","79300124"
"chr2","84909649","84909919","chr3","5586200","5586475","26","79323449"
"chr2","84942369","84942556","chr3","5554807","5554990","11","79387562"
"chr2","85029757","85029936","chrX","15997136","15997312","35","69032621"
"chr2","85056884","85057075","chr3","5438508","5438666","39","79618376"
"chr2","85057116","85057202","chr3","5438396","5438487","9","79618720"
"chr2","85109949","85110255","chr3","5385326","5385627","10","79724623"
"chr2","85172612","85172929","chr3","5322183","5322470","35","79850429"
"chr2","85172934","85173235","chr3","5321869","5322178","16","79851065"
"chr2","85183808","85183945","chr3","5311378","5311515","4","79872430"
"chr2","85235908","85235945","chr3","5258572","5258609","0","79977336"
"chr2","85236328","85236389","chr3","5258130","5258191","0","79978198"
"chr2","85259000","85259283","chr3","5235745","5236029","13","80023255"
"chr2","85295248","85295377","chr3","5199770","5199900","5","80095478"
"chr2","85295425","85295586","chr3","5199582","5199734","22","80095843"
"chr2","85316864","85317164","chr3","5178254","5178565","17","80138610"
"chr2","85344331","85344621","chr3","5150564","5150852","8","80193767"
"chr2","85347208","85347500","chr3","5147732","5148024","6","80199476"
"chr2","85389338","85389647","chr3","5103903","5104207","11","80285435"
"chr2","85395354","85395646","chr3","5098211","5098501","11","80297143"
"chr2","85457198","85457485","chr3","5038920","5039216","17","80418278"
"chr2","85482992","85483159","chr15","6812040","6812207","33","78670952"
"chr2","85496329","85496497","chr3","5009731","5009901","16","80486598"
"chr2","85537636","85537793","chr3","4968390","4968522","26","80569246"
"chr2","85537803","85538089","chr3","4968089","4968355","34","80569714"
"chr2","85539105","85539394","chr3","4966798","4967091","32","80572307"
"chr2","85541719","85542010","chr3","4964189","4964480","9","80577530"
"chr2","85565076","85565382","chr3","4941293","4941590","18","80623783"
"chr2","85596429","85596691","chr3","4909680","4909961","30","80686749"
"chr2","85638685","85638993","chr3","4867377","4867703","24","80771308"
"chr2","85675452","85675754","chr3","4821813","4822121","29","80853639"
"chr2","85679333","85679630","chr3","4829827","4830123","17","80849506"
"chr2","85698218","85698363","chr12","93466662","93466820","33","7768444"
"chr2","85710320","85710604","chr13","19687027","19687314","69","66023293"
"chr2","85728623","85728913","chr3","4774602","4774883","26","80954021"
"chr2","85739779","85740062","chr3","4763420","4763691","35","80976359"
"chr2","85743092","85743246","chr3","4761015","4761169","1","80982077"
"chr2","85755447","85755792","chr3","4747213","4747559","6","81008234"
"chr2","85782970","85783110","chr3","4719525","4719666","5","81063445"
"chr2","85805098","85805389","chr3","4696701","4696989","25","81108397"
"chr2","85817151","85817435","chr3","4683050","4683341","17","81134101"
"chr2","85879521","85879678","chr19","48253295","48253452","24","37626226"
"chr2","85896257","85896573","chr3","4604365","4604660","29","81291892"
"chr2","85930946","85931225","chr3","4569780","4570059","5","81361166"
"chr2","85945783","85946101","chr3","4555055","4555373","12","81390728"
"chr2","85948005","85948137","chr17","87719481","87719614","29","1771476"
"chr2","85948177","85948202","chrX","124671246","124671266","7","38723069"
"chr2","85948211","85948284","chr3","4552855","4552928","3","81395356"
"chr2","85960276","85960512","chr3","4540384","4540622","6","81419892"
"chr2","85986833","85987070","chr3","4514038","4514275","5","81472795"
"chr2","86077309","86077603","chr3","4420886","4421180","21","81656423"
"chr2","86083100","86083395","chr3","4415123","4415418","6","81667977"
"chr2","86128298","86128621","chr3","4369156","4369477","9","81759142"
"chr2","86164453","86164772","chr3","4331319","4331637","19","81833134"
"chr2","86194980","86195255","chr3","4302249","4302523","17","81892731"
"chr2","86220960","86221262","chrX","123826110","123826413","52","37605150"
"chr2","86226221","86226531","chr3","4271633","4271946","11","81954588"
"chr2","86236867","86237052","chr3","4260807","4261004","20","81976060"
"chr2","86277433","86277591","chrX","27884976","27885136","32","58392457"
"chr2","86277627","86277729","chr15","6139004","6139107","20","80138623"
"chr2","86309498","86309810","chr10","71178749","71179059","65","15130749"
"chr2","86346571","86346779","chr11","78238543","78238741","55","8108028"
"chr2","86348480","86348651","chr3","4146239","4146410","5","82202241"
"chr2","86378822","86379123","chr3","4115840","4116143","14","82262982"
"chr2","86433998","86434206","chr6","172901574","172901781","54","86467576"
"chr2","86498684","86498811","chr3","3997895","3998023","3","82500789"
"chr2","86588199","86588505","chr16","36598397","36598710","73","49989802"
"chr2","86683408","86683700","chr3","39028401","39028699","57","47655007"
"chr2","86692621","86692912","chr3","3800328","3800629","17","82892293"
"chr2","86714755","86714922","chr3","3776853","3777003","22","82937902"
"chr2","86762566","86762729","chr3","3724727","3724891","5","83037839"
"chr2","86763028","86763164","chr3","3724287","3724423","2","83038741"
"chr2","86763568","86763763","chr3","3720882","3721121","46","83042686"
"chr2","86768805","86768889","chr3","47617372","47617450","22","39151433"
"chr2","86778374","86778680","chr14","6799945","6800241","54","79978429"
"chr2","86779209","86779420","chr3","3703610","3703818","17","83075599"
"chr2","86780009","86780138","chr3","3702887","3703018","3","83077122"
"chr2","86785134","86785426","chr3","3699231","3699524","10","83085903"
"chr2","86812671","86813002","chr3","3671941","3672217","60","83140730"
"chr2","86834772","86835076","chr3","3645812","3646124","14","83188960"
"chr2","86841400","86841690","chr3","3635201","3635496","16","83206199"
"chr2","86846045","86846343","chr3","3640545","3640839","13","83205500"
"chr2","86868681","86868982","chr3","3610570","3610878","19","83258111"
"chr2","86888867","86889174","chr3","3589295","3589583","29","83299572"
"chr2","86892301","86892588","chr7","64495027","64495315","45","22397274"
"chr2","86914431","86914604","chr3","3572745","3572929","13","83341686"
"chr2","86929108","86929397","chr3","3551446","3551735","7","83377662"
"chr2","86930184","86930310","chr1","25577027","25577159","29","61353157"
"chr2","86940358","86940518","chr3","3540491","3540651","2","83399867"
"chr2","86942883","86943181","chr3","3537902","3538195","33","83404981"
"chr2","86969394","86969642","chr3","3508575","3508857","39","83460819"
"chr2","86972438","86972737","chr3","3505584","3505883","9","83466854"
"chr2","86984306","86984615","chr3","3490849","3491162","11","83493457"
"chr2","86988009","86988316","chr3","3490849","3491162","12","83497160"
"chr2","86998599","86998902","chr3","3475823","3476126","8","83522776"
"chr2","87044269","87044558","chr3","3429065","3429363","23","83615204"
"chr2","87056633","87056928","chr3","3416738","3417030","10","83639895"
"chr2","87122623","87122903","chr3","3351026","3351306","2","83771597"
"chr2","87198900","87199194","chr3","3271616","3271911","5","83927284"
"chr2","87247021","87247328","chr3","3222533","3222844","13","84024488"
"chr2","87314387","87314685","chr3","3157809","3158111","13","84156578"
"chr2","87387461","87387758","chr3","3089806","3090114","22","84297655"
"chr2","87390740","87390878","chr3","3086679","3086815","6","84304061"
"chr2","87391172","87391356","chr3","3085255","3085440","10","84305917"
"chr2","87397291","87397422","chr3","3079750","3079881","6","84317541"
"chr2","87417508","87417786","chr3","3058189","3058467","9","84359319"
"chr2","87472380","87472686","chr3","3001602","3001902","18","84470778"
"chr2","87494343","87494643","chr3","2974227","2974529","17","84520116"
"chr2","87507906","87508217","chr2","56423825","56424133","53","31084081"
"chr2","87512196","87512351","chr3","2958685","2958840","2","84553511"
"chr2","87516963","87517249","chr7","115474282","115474567","50","27957319"
"chr2","87521833","87522118","chr12","89683420","89683718","55","2161587"
"chr2","87540894","87541190","chr3","2923554","2923848","9","84617340"
"chr2","87542009","87542277","chr3","2922146","2922393","31","84619863"
"chr2","87547764","87548070","chr1","196114195","196114504","64","108566431"
"chr2","87559318","87559548","chr3","2898628","2898856","9","84660690"
"chr2","87559829","87559996","chr3","2898180","2898347","5","84661649"
"chr2","87561286","87561595","chr3","2896266","2896565","20","84665020"
"chr2","87567363","87567513","chr3","2903291","2903443","6","84664072"
"chr2","87592818","87592959","chr7","43497058","43497204","37","44095760"
"chr2","87611417","87611715","chr3","2850213","2850511","11","84761204"
"chr2","87615621","87615899","chr3","2846079","2846356","17","84769542"
"chr2","87629633","87629689","chr1","22407920","22407976","16","65221713"
"chr2","87651637","87651936","chr3","61427841","61428151","64","26223796"
"chr2","87652865","87653158","chr3","2807544","2807837","7","84845321"
"chr2","87655381","87655644","chr12","100161471","100161727","56","12506090"
"chr2","87661151","87661444","chr3","2797380","2797675","10","84863771"
"chr2","87688925","87689044","chr3","2768409","2768528","1","84920516"
"chr2","87701956","87702135","chr15","29920208","29920384","39","57781748"
"chr2","87712871","87713155","chr12","94935618","94935909","50","7222747"
"chr2","87738208","87738288","chr14","66178125","66178206","11","21560083"
"chr2","87738605","87738631","chr11","8917374","8917397","9","78821231"
"chr2","87738931","87739115","chr1","19748026","19748210","44","67990905"
"chr2","87739116","87739279","chr3","2720911","2721071","8","85018205"
"chr2","87754023","87754314","chrX","46046489","46046783","42","41707534"
"chr2","87755557","87755846","chr3","2702841","2703127","13","85052716"
"chr2","87760482","87760754","chr3","2697660","2697933","16","85062822"
"chr2","87767384","87767595","chr3","2690438","2690649","3","85076946"
"chr2","87768242","87768532","chr3","109526834","109527120","52","21758592"
"chr2","87790104","87790359","chr3","2667314","2667582","17","85122790"
"chr2","87790362","87790640","chr3","2667034","2667311","7","85123328"
"chr2","87817375","87817504","chr7","39566754","39566887","23","48250621"
"chr2","87843469","87843760","chr3","2611031","2611324","7","85232438"
"chr2","87868967","87869258","chr3","2585656","2585947","4","85283311"
"chr2","87873334","87873620","chr3","2581207","2581493","10","85292127"
"chr2","87899286","87899584","chr15","22361292","22361589","48","65537994"
"chr2","87942647","87942899","chr3","2508710","2508962","5","85433937"
"chr2","87981501","87981780","chr3","2467085","2467364","6","85514416"
"chr2","88004681","88004951","chr3","2443494","2443769","9","85561187"
"chr2","88079457","88079503","chr2","146977856","146977899","18","58898399"
"chr2","88116767","88117051","chr3","2325079","2325363","4","85791688"
"chr2","88121858","88122157","chr8","91933713","91934004","51","3811855"
"chr2","88122170","88122483","chr3","2319344","2319658","4","85802826"
"chr2","88136461","88136714","chr3","2306037","2306283","18","85830424"
"chr2","88151315","88151397","chrX","9916331","9916401","29","78234984"
"chr2","88172983","88173187","chr20","67472352","67472550","41","20700631"
"chr2","88268648","88268714","chr3","2178041","2178107","0","86090607"
"chr2","88364984","88365272","chr3","2072295","2072578","70","86292689"
"chr2","88389909","88390208","chr3","2046064","2046361","14","86343845"
"chr2","88428606","88428723","chr3","2005803","2005911","14","86422803"
"chr2","88436802","88437110","chr3","1996728","1997034","12","86440074"
"chr2","88504276","88504520","chr15","71055087","71055340","48","17449189"
"chr2","88509166","88509343","chr20","22278419","22278593","33","66230747"
"chr2","88631673","88631983","chr3","1790937","1791244","23","86840736"
"chr2","88685893","88686051","chr3","1734742","1734893","9","86951151"
"chr2","88734064","88734376","chr3","1683080","1683389","6","87050984"
"chr2","88761636","88761806","chr6","65596425","65596592","26","23165211"
"chr2","88769976","88770246","chr3","1645399","1645675","12","87124577"
"chr2","88789720","88790020","chr3","1624570","1624870","11","87165150"
"chr2","88814226","88814429","chr3","1600572","1600774","3","87213654"
"chr2","88830145","88830465","chr3","1584912","1585232","4","87245233"
"chr2","88844729","88845037","chr3","1570389","1570696","10","87274340"
"chr2","88888406","88888707","chr3","1525350","1525648","5","87363056"
"chr2","88893571","88893868","chr3","1520164","1520462","4","87373407"
"chr2","89234294","89234600","chr3","1170308","1170615","8","88063986"
"chr2","89286298","89286474","chr3","1115136","1115313","1","88171162"
"chr2","89286771","89286821","chr3","1114788","1114839","4","88171983"
"chr2","89287765","89287934","chr19","16659241","16659406","21","72628524"
"chr2","89310996","89311280","chr3","1090342","1090626","6","88220654"
"chr2","89322960","89323213","chr3","1077047","1077305","10","88245913"
"chr2","89517143","89517439","chr3","879461","879754","6","88637682"
"chr2","89527895","89528094","chr3","868591","868791","6","88659304"
"chr2","89647910","89648188","chr3","750515","750794","8","88897395"
"chr2","89689583","89689878","chr3","710781","711076","4","88978802"
"chr2","89690899","89691058","chr3","709297","709459","8","88981602"
"chr2","89726351","89726568","chr3","673055","673269","13","89053296"
"chr2","89762712","89763004","chr3","635774","636074","16","89126938"
"chr2","89769830","89770027","chr3","620582","620774","15","89149248"
"chr2","89770378","89770491","chr3","620120","620233","7","89150258"
"chr2","89784803","89785117","chr3","613381","613695","13","89171422"
"chr2","89806612","89806630","chr6","90997773","90997789","4","1191161"
"chr2","89806768","89806920","chr3","591418","591565","11","89215350"
"chr2","89807976","89808253","chr3","590074","590351","5","89217902"
"chr2","89840828","89841134","chr3","555817","556123","13","89285011"
"chr2","89855086","89855379","chr3","540990","541281","7","89314096"
"chr2","89867362","89867661","chr3","528729","529029","4","89338633"
"chr2","89871015","89871304","chr3","525066","525356","10","89345949"
"chr2","89883651","89883813","chr10","10585694","10585857","39","79297957"
"chr2","89894588","89894884","chr3","501432","501701","39","89393156"
"chr2","89898635","89898779","chrX","60518750","60518900","24","29379885"
"chr2","89898946","89899240","chr7","34211238","34211540","75","55687708"
"chr2","89912860","89913139","chr3","486756","487039","7","89426104"
"chr2","89918871","89919006","chr3","473778","473913","6","89445093"
"chr2","89919856","89920040","chr3","472708","472892","10","89447148"
"chr2","89921553","89921849","chr3","470325","470645","28","89451228"
"chr2","89922529","89922810","chr3","469371","469677","31","89453158"
"chr2","89927701","89927863","chr5","165543741","165543899","39","75616040"
"chr2","89934134","89934422","chr3","454191","454501","36","89479943"
"chr2","89941621","89941921","chr3","447287","447587","6","89494334"
"chr2","89942625","89942799","chr1","23872213","23872387","33","66070412"
"chr2","89944344","89944633","chr14","106106294","106106583","65","16161950"
"chr2","89949588","89949855","chr18","71609259","71609530","54","18340329"
"chr2","89971671","89971915","chr15","99486679","99486907","48","9515008"
"chr2","89979830","89980113","chr3","405752","406037","20","89574078"
"chr2","89992129","89992416","chr6","133951729","133952022","55","43959600"
"chr2","90020928","90021206","chr3","359994","360272","4","89660934"
"chr2","90023116","90023295","chr3","357905","358084","3","89665211"
"chr2","90026583","90026881","chr3","354282","354580","11","89672301"
"chr2","90044258","90044414","chr3","335224","335380","4","89709034"
"chr2","90047367","90047645","chr3","331968","332245","5","89715399"
"chr2","90049090","90049215","chr7","106492413","106492535","20","16443323"
"chr2","90057512","90057814","chr3","321639","321939","14","89735873"
"chr2","90062232","90062505","chr3","317064","317337","8","89745168"
"chr2","90073865","90074095","chr3","305399","305631","9","89768466"
"chr2","90178699","90178999","chr10","38417804","38418098","69","51760895"
"chr2","90190129","90190434","chr3","193823","194125","18","89996306"
"chr2","90231312","90231461","chr16","51097787","51097931","57","39133525"
"chr2","90270614","90270902","chr3","112001","112288","5","90158613"
"chr2","90321426","90321726","chr3","60253","60548","12","90261173"
"chr2","90328417","90328705","chr3","51448","51737","5","90276969"
"chr3","91226064","91226331","chr17","89946765","89947030","12","1279299"
"chr3","6422306","6422579","chrX","123074686","123074948","59","116652380"
"chr3","7733147","7733468","chr17","7867636","7867936","40","134489"
"chr3","14810915","14811211","chr17","15058473","15058779","11","247558"
"chr3","23330620","23330918","chr17","23712561","23712859","5","381941"
"chr3","29884304","29884591","chr17","10902080","10902366","55","18982224"
"chr3","327","595","chr1","200631863","200632136","24","200631536"
"chr3","11511","11778","chr1","200631863","200632136","25","200620352"
"chr3","36278","36436","chr17","46289","46461","18","10011"
"chr3","41632","41841","chr17","51643","51852","6","10011"
"chr3","42065","42330","chr17","52076","52341","9","10011"
"chr3","42423","42462","chr17","52436","52475","1","10013"
"chr3","42709","43009","chr17","52723","53017","10","10014"
"chr3","50088","50402","chr17","61007","61322","8","10919"
"chr3","50403","50484","chr6","53245174","53245256","13","53194771"
"chr3","75225","75519","chr17","85332","85619","17","10107"
"chr3","83030","83323","chr11","71265265","71265555","58","71182235"
"chr3","84184","84309","chr17","93288","93415","5","9104"
"chr3","108062","108243","chr17","124082","124253","15","16020"
"chr3","111256","111579","chr17","127511","127834","4","16255"
"chr3","117128","117411","chr17","133651","133945","14","16523"
"chr3","119120","119204","chr14","115374895","115374976","19","115255775"
"chr3","119308","119582","chr17","135732","136009","10","16424"
"chr3","147442","147686","chr11","31585135","31585379","51","31437693"
"chr3","158153","158427","chr17","174061","174335","9","15908"
"chr3","186637","186943","chr17","203779","204083","9","17142"
"chr3","193961","194179","chr9","6030499","6030716","47","5836538"
"chr3","223692","223875","chr17","247301","247465","28","23609"
"chr3","240952","241247","chr8","61749821","61750128","57","61508869"
"chr3","246205","246324","chr17","269107","269221","16","22902"
"chr3","253270","253588","chr17","277791","278078","35","24521"
"chr3","258370","258678","chr17","282803","283083","34","24433"
"chr3","277622","277926","chr14","67858510","67858813","66","67580888"
"chr3","289211","289500","chr17","314497","314805","22","25286"
"chr3","293771","294048","chr17","318596","318874","16","24825"
"chr3","294143","294342","chr14","50745436","50745648","53","50451293"
"chr3","299475","299569","chr1","33351344","33351436","19","33051869"
"chr3","327012","327283","chr17","353081","353374","30","26069"
"chr3","331862","332143","chr17","367448","367730","16","35586"
"chr3","332621","332742","chr4","118775455","118775575","22","118442834"
"chr3","355170","355455","chr17","383189","383476","5","28019"
"chr3","362433","362654","chr17","391573","391793","6","29140"
"chr3","365541","365812","chr17","394575","394848","14","29034"
"chr3","393385","393513","chr14","120413917","120414031","39","120020532"
"chr3","394158","394261","chr14","73178581","73178687","26","72784423"
"chr3","396881","397173","chr17","425848","426149","16","28967"
"chr3","404158","404344","chr17","433157","433343","6","28999"
"chr3","409320","409613","chr17","438318","438611","7","28998"
"chr3","417368","417668","chr17","446792","447086","24","29424"
"chr3","475558","475842","chr17","500723","501011","8","25165"
"chr3","488242","488537","chr17","518006","518301","6","29764"
"chr3","497239","497525","chr17","527013","527301","11","29774"
"chr3","513542","513844","chr17","542074","542380","8","28532"
"chr3","514601","514892","chr17","543137","543428","2","28536"
"chr3","537442","537726","chr2","85895640","85895939","61","85358198"
"chr3","542755","543034","chr17","577328","577607","9","34573"
"chr3","569598","569840","chr17","614472","614714","15","44874"
"chr3","592090","592390","chr17","638703","639009","14","46613"
"chr3","598666","598961","chr17","645327","645632","26","46661"
"chr3","599264","599575","chr17","645939","646227","34","46675"
"chr3","611992","612271","chr17","657627","657906","5","45635"
"chr3","810179","810410","chr17","868870","869112","21","58691"
"chr3","816847","816955","chr1","17138352","17138455","23","16321505"
"chr3","818545","818871","chr17","877579","877896","17","59034"
"chr3","825419","825705","chr17","890611","890935","49","65192"
"chr3","840829","841114","chr17","907062","907349","12","66233"
"chr3","855053","855347","chr17","921950","922251","16","66897"
"chr3","871997","872020","chr7","41635140","41635166","3","40763143"
"chr3","872065","872376","chr20","43447378","43447653","84","42575313"
"chr3","899224","899519","chr17","967243","967538","7","68019"
"chr3","904826","905105","chr17","972378","972655","22","67552"
"chr3","916423","916646","chr17","983921","984147","12","67498"
"chr3","919833","920105","chr17","987419","987696","9","67586"
"chr3","968545","968850","chr17","1036977","1037286","11","68432"
"chr3","979799","980082","chr4","30480281","30480570","68","29500482"
"chr3","987299","987583","chr17","1057798","1058082","8","70499"
"chr3","994616","994750","chr17","1064758","1064892","3","70142"
"chr3","995062","995229","chr17","1065497","1065651","15","70435"
"chr3","996407","996714","chr17","1066830","1067136","9","70423"
"chr3","1027612","1027778","chr17","1102097","1102256","13","74485"
"chr3","1028092","1028141","chr17","1102568","1102623","7","74476"
"chr3","1035039","1035361","chr17","1109916","1110188","59","74877"
"chr3","1052994","1053133","chr17","1115764","1115903","6","62770"
"chr3","1056388","1056699","chr17","1119180","1119492","8","62792"
"chr3","1057711","1058014","chr5","153578498","153578798","61","152520787"
"chr3","1061634","1061939","chr17","1134166","1134474","12","72532"
"chr3","1064532","1064628","chr11","50331449","50331541","24","49266917"
"chr3","1069633","1069907","chr17","1142710","1142998","24","73077"
"chr3","1075500","1075726","chr17","1150397","1150632","19","74897"
"chr3","1076200","1076354","chr14","32601710","32601868","36","31525510"
"chr3","1076915","1077061","chr19","34859244","34859380","41","33782329"
"chr3","1078380","1078677","chr17","1153766","1154063","8","75386"
"chr3","1083627","1083846","chr17","1159258","1159486","14","75631"
"chr3","1085263","1085535","chr14","7881124","7881383","59","6795861"
"chr3","1085875","1086158","chr17","1161511","1161786","15","75636"
"chr3","1093715","1093998","chr17","1169706","1169998","18","75991"
"chr3","1096326","1096611","chr17","1172657","1172908","49","76331"
"chr3","1101013","1101288","chr14","55255210","55255479","63","54154197"
"chr3","1114777","1115063","chr11","50254076","50254361","57","49139299"
"chr3","1115658","1115827","chr7","38789439","38789604","32","37673781"
"chr3","1116647","1116941","chr17","1201190","1201460","30","84543"
"chr3","1122050","1122204","chr17","1192177","1192331","3","70127"
"chr3","1137388","1137682","chr17","1211286","1211583","12","73898"
"chr3","1141641","1141992","chr1","129206989","129207342","64","128065348"
"chr3","1148361","1148554","chr17","1222527","1222723","7","74166"
"chr3","1149650","1149950","chr17","1237068","1237371","12","87418"
"chr3","1157689","1157840","chr1","9591669","9591814","39","8433980"
"chr3","1158293","1158357","chr7","106782751","106782813","16","105624458"
"chr3","1158382","1158520","chr11","117298622","117298758","22","116140240"
"chr3","1164206","1164396","chr1","139026361","139026552","48","137862155"
"chr3","1167816","1167984","chr3","173716711","173716883","29","172548895"
"chr3","1177874","1178094","chr17","1260835","1261055","2","82961"
"chr3","1178390","1178460","chr17","1261366","1261436","1","82976"
"chr3","1182395","1182464","chr20","51493915","51493978","15","50311520"
"chr3","1198761","1198930","chr17","1282604","1282759","14","83843"
"chr3","1199265","1199385","chr17","1283114","1283234","4","83849"
"chr3","1201357","1201670","chr20","50445603","50445912","68","49244246"
"chr3","1218049","1218354","chr17","1301952","1302246","20","83903"
"chr3","1224040","1224342","chr17","1307753","1308055","5","83713"
"chr3","1254357","1254650","chr17","1338463","1338768","21","84106"
"chr3","1254812","1255108","chr17","1338930","1339229","6","84118"
"chr3","1260739","1260981","chr17","1344475","1344712","9","83736"
"chr3","1262424","1262650","chrX","86386609","86386821","55","85124185"
"chr3","1274589","1274882","chr17","1357678","1357974","6","83089"
"chr3","1292683","1292976","chr17","1376609","1376911","24","83926"
"chr3","1297820","1298118","chr17","1382918","1383220","7","85098"
"chr3","1308168","1308272","chr17","1397474","1397577","6","89306"
"chr3","1308994","1309192","chr17","1398301","1398525","44","89307"
"chr3","1310081","1310199","chr17","1399423","1399542","3","89342"
"chr3","1447139","1447434","chr17","1511626","1511922","10","64487"
"chr3","1449754","1450064","chr17","1514556","1514868","12","64802"
"chr3","1476703","1477015","chr17","19459573","19459881","34","17982870"
"chr3","1498560","1498878","chr17","1573272","1573589","15","74712"
"chr3","1500001","1500095","chr14","6842015","6842109","12","5342014"
"chr3","1517602","1517907","chr17","1591331","1591636","8","73729"
"chr3","1520890","1521197","chr20","58909415","58909724","54","57388525"
"chr3","1540493","1540777","chr17","1616118","1616402","9","75625"
"chr3","1561997","1562303","chr1","41895656","41895951","64","40333659"
"chr3","1579032","1579339","chr17","1657080","1657389","10","78048"
"chr3","1586238","1586524","chr6","168310873","168311167","55","166724635"
"chr3","1595749","1596049","chr7","48559857","48560164","59","46964108"
"chr3","1620279","1620570","chr17","1701131","1701422","7","80852"
"chr3","1636570","1636846","chr17","1718140","1718382","38","81570"
"chr3","1640688","1641003","chr17","1722300","1722621","16","81612"
"chr3","1687146","1687456","chr17","1769324","1769614","31","82178"
"chr3","1690570","1690737","chr11","6394722","6394881","32","4704152"
"chr3","1805327","1805616","chr6","166241667","166241965","65","164436340"
"chr3","1859239","1859530","chr17","1939857","1940149","8","80618"
"chr3","1903250","1903548","chr17","1984782","1985080","3","81532"
"chr3","1907483","1907768","chr3","35702628","35702913","81","33795145"
"chr3","2016091","2016395","chr17","2098291","2098602","15","82200"
"chr3","2059067","2059345","chr17","2141140","2141428","21","82073"
"chr3","2069896","2070189","chr17","2152012","2152305","12","82116"
"chr3","2111066","2111212","chr13","27948673","27948818","28","25837607"
"chr3","2121973","2122240","chr17","2209230","2209509","25","87257"
"chr3","2145010","2145184","chr10","87423992","87424165","37","85278982"
"chr3","2165116","2165428","chr17","2252083","2252379","20","86967"
"chr3","2187818","2188110","chr17","2274794","2275082","21","86976"
"chr3","2271718","2271852","chr12","83163546","83163695","33","80891828"
"chr3","2402267","2402558","chr17","2486530","2486822","11","84263"
"chr3","2441875","2442058","chr17","2523037","2523222","12","81162"
"chr3","2500001","2500090","chr17","2577677","2577778","15","77676"
"chr3","2528522","2528785","chr17","2606041","2606304","9","77519"
"chr3","2737697","2737994","chr17","2815217","2815509","15","77520"
"chr3","2844000","2844270","chr1","26518528","26518793","59","23674528"
"chr3","2854172","2854492","chr17","2933579","2933885","23","79407"
"chr3","2873321","2873456","chr3","37387839","37387976","22","34514518"
"chr3","2894527","2894795","chr17","2974076","2974351","12","79549"
"chr3","2915592","2915887","chr6","171012102","171012386","45","168096510"
"chr3","2965524","2965835","chr17","3019992","3020294","23","54468"
"chr3","2966131","2966210","chr12","93854964","93855037","17","90888833"
"chr3","2968845","2969111","chr17","3023159","3023373","58","54314"
"chr3","3193240","3193526","chr17","3242791","3243076","11","49551"
"chr3","3283283","3283587","chr17","3336286","3336596","21","53003"
"chr3","3480285","3480547","chr17","3538515","3538777","5","58230"
"chr3","3487752","3488062","chr17","3545983","3546291","13","58231"
"chr3","3490838","3491108","chr17","3549078","3549348","13","58240"
"chr3","3529954","3530078","chr17","3588061","3588162","29","58107"
"chr3","3579877","3580133","chr17","3639697","3639953","6","59820"
"chr3","3586301","3586471","chr7","49358419","49358594","31","45772118"
"chr3","3586505","3586624","chr4","25627171","25627287","25","22040666"
"chr3","3616599","3616911","chr17","3677668","3677996","27","61069"
"chr3","3628050","3628347","chr17","3689780","3690078","11","61730"
"chr3","3638177","3638375","chr1","33778568","33778757","67","30140391"
"chr3","3674266","3674547","chr17","3739815","3740096","6","65549"
"chr3","3694387","3694625","chr1","161877205","161877427","61","158182818"
"chr3","3732912","3733065","chr17","3801507","3801660","5","68595"
"chr3","3733384","3733417","chr4","28411478","28411506","8","24678094"
"chr3","3733462","3733565","chr8","41186290","41186390","24","37452828"
"chr3","3734691","3734831","chr3","45393756","45393887","38","41659065"
"chr3","3750905","3751211","chr17","3820026","3820332","12","69121"
"chr3","3752378","3752465","chr12","13512090","13512171","23","9759712"
"chr3","3754797","3754895","chr17","3825498","3825596","3","70701"
"chr3","3870552","3870906","chr17","3946562","3946915","24","76010"
"chr3","3882967","3883246","chr17","3960498","3960777","10","77531"
"chr3","3970732","3970806","chr3","40018998","40019074","11","36048266"
"chr3","3970820","3970953","chr17","4049149","4049298","29","78329"
"chr3","3974423","3974580","chr17","4052789","4052944","7","78366"
"chr3","4006515","4006796","chr17","4086560","4086841","10","80045"
"chr3","4009466","4009759","chr17","4089519","4089796","31","80053"
"chr3","4013015","4013315","chr17","4093499","4093800","10","80484"
"chr3","4013606","4013862","chr17","4094100","4094349","12","80494"
"chr3","4018473","4018766","chr17","4098662","4098955","5","80189"
"chr3","4019784","4020090","chr19","41362885","41363193","60","37343101"
"chr3","4041648","4041821","chr17","4120525","4120686","20","78877"
"chr3","4073059","4073361","chr10","83115162","83115461","56","79042103"
"chr3","4080576","4080768","chr17","4159290","4159478","10","78714"
"chr3","4089667","4089807","chr19","9122351","9122486","38","5032684"
"chr3","4091434","4091586","chr17","3801507","3801660","5","289927"
"chr3","4103388","4103713","chr17","3796386","3796699","41","307002"
"chr3","4104512","4104817","chr17","4186333","4186632","15","81821"
"chr3","4120208","4120511","chr17","4201996","4202299","5","81788"
"chr3","4126687","4126935","chr17","4209511","4209759","5","82824"
"chr3","4127923","4128245","chr17","4210750","4211080","13","82827"
"chr3","4133814","4134051","chr17","4216615","4216853","9","82801"
"chr3","4143606","4143895","chr17","4226292","4226590","23","82686"
"chr3","4171200","4171506","chr17","4253891","4254197","14","82691"
"chr3","4175489","4175610","chr17","4258187","4258308","2","82698"
"chr3","4200606","4200905","chr17","4282134","4282436","9","81528"
"chr3","4209377","4209526","chr17","4290897","4291046","2","81520"
"chr3","4213454","4213733","chr16","55561701","55561972","72","51348247"
"chr3","4219766","4219896","chr17","4296686","4296816","2","76920"
"chr3","4220284","4220571","chr17","4297204","4297491","5","76920"
"chr3","4246823","4247088","chr17","4324885","4325154","14","78062"
"chr3","4255245","4255564","chr17","4333333","4333633","33","78088"
"chr3","4259747","4260055","chr17","4333333","4333633","53","73586"
"chr3","4270024","4270288","chr17","4346576","4346840","3","76552"
"chr3","4294589","4294867","chr17","4373253","4373532","7","78664"
"chr3","4297797","4298091","chr17","4376465","4376759","4","78668"
"chr3","4336326","4336522","chr18","27823366","27823540","58","23487040"
"chr3","4338279","4338571","chr17","4417680","4417971","14","79401"
"chr3","4356761","4357067","chr17","4435480","4435777","20","78719"
"chr3","4357118","4357424","chr17","4435828","4436130","23","78710"
"chr3","4371777","4372067","chr16","22907502","22907793","49","18535725"
"chr3","4376532","4376818","chr17","4455904","4456189","6","79372"
"chr3","4377798","4378096","chr17","4456997","4457275","26","79199"
"chr3","4411120","4411418","chr17","4490500","4490800","16","79380"
"chr3","4413961","4414277","chr7","33675616","33675892","85","29261655"
"chr3","4420672","4420964","chr17","4497008","4497300","10","76336"
"chr3","4428518","4428777","chr17","4505152","4505411","5","76634"
"chr3","4429982","4430284","chr17","4506960","4507262","10","76978"
"chr3","4436305","4436610","chr17","4514227","4514512","31","77922"
"chr3","4447352","4447624","chr17","4527357","4527626","7","80005"
"chr3","4459444","4459745","chr17","4537971","4538276","10","78527"
"chr3","4461344","4461615","chr17","4539883","4540154","9","78539"
"chr3","4464695","4464988","chr12","94935618","94935909","50","90470923"
"chr3","4483310","4483580","chr17","4565789","4566090","38","82479"
"chr3","4489513","4489821","chr17","4571710","4572018","7","82197"
"chr3","4513729","4514036","chr6","169559105","169559409","59","165045376"
"chr3","4532534","4532751","chr17","4619295","4619522","28","86761"
"chr3","4554390","4554681","chr17","4641924","4642215","9","87534"
"chr3","4586694","4586876","chrX","62813073","62813257","34","58226379"
"chr3","4590606","4590893","chr17","4679682","4679968","6","89076"
"chr3","4630585","4630860","chr17","4722876","4723150","11","92291"
"chr3","4655967","4656273","chr17","4748149","4748455","9","92182"
"chr3","4679759","4680070","chr4","22161175","22161484","69","17481416"
"chr3","4684937","4685246","chr17","4775930","4776238","6","90993"
"chr3","4685592","4685652","chr10","16885873","16885925","18","12200281"
"chr3","4692495","4692718","chr17","4783483","4783707","6","90988"
"chr3","4698814","4699127","chr17","4791410","4791731","17","92596"
"chr3","4701940","4702232","chr17","4794539","4794843","21","92599"
"chr3","4710497","4710689","chr17","4804161","4804350","7","93664"
"chr3","4710986","4711042","chr17","4804647","4804703","1","93661"
"chr3","4718355","4718474","chr17","4811507","4811619","8","93152"
"chr3","4745619","4745920","chr17","4837586","4837866","32","91967"
"chr3","4800810","4801085","chr17","4907620","4907895","6","106810"
"chr3","4809246","4809546","chr17","4916045","4916346","9","106799"
"chr3","4819597","4819754","chr17","4926416","4926578","17","106819"
"chr3","4823263","4823335","chr17","4930115","4930187","0","106852"
"chr3","4856734","4857024","chr17","4963398","4963689","15","106664"
"chr3","4870558","4870834","chr17","4977608","4977873","40","107050"
"chr3","4892701","4892853","chr17","5000224","5000396","28","107523"
"chr3","4902341","4902647","chr17","5008827","5009134","13","106486"
"chr3","4905184","4905479","chr17","5011680","5011976","6","106496"
"chr3","4915255","4915553","chr17","5021656","5021952","21","106401"
"chr3","4974737","4975031","chr17","5081239","5081508","33","106502"
"chr3","4998492","4998775","chr17","5111947","5112265","43","113455"
"chr3","5001621","5001919","chr17","5115067","5115362","14","113446"
"chr3","5013401","5013682","chr17","5126656","5126933","15","113255"
"chr3","5023462","5023675","chr17","5136699","5136911","16","113237"
"chr3","5060614","5060918","chr17","5171054","5171380","40","110440"
"chr3","5092536","5092828","chr17","5204277","5204548","32","111741"
"chr3","5098156","5098437","chr17","5207619","5207900","3","109463"
"chr3","5100390","5100560","chr17","5209860","5210044","19","109470"
"chr3","5103919","5104220","chr17","5213410","5213711","5","109491"
"chr3","5112251","5112330","chr2","94669427","94669495","19","89557176"
"chr3","5117144","5117203","chr17","5229220","5229284","8","112076"
"chr3","5160006","5160304","chr17","5272304","5272604","20","112298"
"chr3","5166419","5166714","chr17","5278725","5279017","7","112306"
"chr3","5172027","5172344","chr17","5284729","5285044","11","112702"
"chr3","5274461","5274757","chr17","5387607","5387898","13","113146"
"chr3","5349558","5349851","chr17","5463048","5463330","30","113490"
"chr3","5414502","5414799","chr17","5529636","5529930","18","115134"
"chr3","5439205","5439501","chr17","5554010","5554312","11","114805"
"chr3","5441221","5441504","chr5","129690196","129690475","61","124248975"
"chr3","5453896","5454183","chr17","5568293","5568580","11","114397"
"chr3","5563111","5563393","chr17","5681619","5681902","9","118508"
"chr3","5595862","5596104","chr17","5715768","5716001","15","119906"
"chr3","5614190","5614493","chr17","5734415","5734705","26","120225"
"chr3","5627343","5627636","chr17","5747807","5748103","14","120464"
"chr3","5650513","5650683","chr20","10428154","10428328","45","4777641"
"chr3","5650686","5650747","chr1","31252960","31253021","13","25602274"
"chr3","5717392","5717730","chr17","5838034","5838371","19","120642"
"chr3","5718902","5719009","chr17","5839525","5839637","6","120623"
"chr3","5723787","5723998","chr17","5844348","5844559","8","120561"
"chr3","5739365","5739656","chr17","5862820","5863111","7","123455"
"chr3","5758280","5758348","chr8","92567790","92567854","13","86809510"
"chr3","5780979","5781111","chr17","5905939","5906070","3","124960"
"chr3","5781406","5781552","chr17","5906366","5906515","11","124960"
"chr3","5829827","5830126","chr17","5958215","5958519","15","128388"
"chr3","5834799","5835147","chr3","51484266","51484563","105","45649467"
"chr3","5836811","5837113","chr17","5965002","5965302","18","128191"
"chr3","5853355","5853632","chr17","5981726","5982004","6","128371"
"chr3","5858092","5858226","chr7","159780317","159780449","22","153922225"
"chr3","5929024","5929319","chr17","6057940","6058245","28","128916"
"chr3","5930702","5930922","chr20","48981396","48981605","36","43050694"
"chr3","6047068","6047348","chr17","6173879","6174148","17","126811"
"chr3","6062132","6062434","chr17","6188981","6189283","9","126849"
"chr3","6089599","6089891","chr17","6216404","6216697","7","126805"
"chr3","6123604","6123812","chr8","69729004","69729200","43","63605400"
"chr3","6133254","6133286","chr14","107726307","107726340","4","101593053"
"chr3","6133566","6133788","chr1","101149837","101150046","62","95016271"
"chr3","6167755","6167920","chr2","125169883","125170040","36","119002128"
"chr3","6188092","6188390","chr17","6316223","6316526","12","128131"
"chr3","6193773","6193912","chr17","6321798","6321933","16","128025"
"chr3","6212528","6212840","chr17","6340082","6340394","4","127554"
"chr3","6328605","6328917","chr17","6455242","6455550","12","126637"
"chr3","6348396","6348614","chrX","50716939","50717149","53","44368543"
"chr3","6356012","6356286","chr17","6486983","6487257","8","130971"
"chr3","6359018","6359309","chr5","129862657","129862956","60","123503639"
"chr3","6372881","6373189","chr17","6504020","6504322","14","131139"
"chr3","6393158","6393454","chr17","6525729","6526029","9","132571"
"chr3","6404394","6404547","chr17","6536700","6536854","2","132306"
"chr3","6404893","6405002","chr17","6537204","6537313","2","132311"
"chr3","6408780","6409017","chr17","6541119","6541317","42","132339"
"chr3","6410645","6410905","chr17","6542931","6543191","5","132286"
"chr3","6424340","6424630","chr17","6553752","6554044","7","129412"
"chr3","6425154","6425474","chr17","6554438","6554757","13","129284"
"chr3","6430093","6430384","chr17","6566181","6566472","2","136088"
"chr3","6430829","6431124","chr17","6566914","6567211","9","136085"
"chr3","6441616","6441888","chr17","6577658","6577931","11","136042"
"chr3","6470942","6471245","chr17","6608186","6608499","24","137244"
"chr3","6475166","6475460","chr17","6614631","6614925","7","139465"
"chr3","6477101","6477413","chr17","6616556","6616863","8","139455"
"chr3","6497323","6497617","chr17","6636704","6636994","16","139381"
"chr3","6506573","6506860","chr17","6645967","6646254","10","139394"
"chr3","6527482","6527648","chr15","98470586","98470760","32","91943104"
"chr3","6527679","6527689","chr10","71215622","71215633","2","64687943"
"chr3","6557154","6557436","chr17","6696273","6696569","55","139119"
"chr3","6587493","6587795","chr17","6726384","6726687","19","138891"
"chr3","6604301","6604470","chr17","6743050","6743217","14","138749"
"chr3","6614584","6614891","chr17","6753955","6754267","14","139371"
"chr3","6642076","6642227","chr7","38707944","38708096","35","32065868"
"chr3","6691202","6691481","chr17","6831246","6831526","13","140044"
"chr3","6695045","6695197","chr17","6835120","6835280","12","140075"
"chr3","6706864","6707149","chr17","6846963","6847248","3","140099"
"chr3","6763658","6763901","chr17","6906651","6906894","10","142993"
"chr3","6780524","6780821","chr17","6923427","6923739","31","142903"
"chr3","6786355","6786642","chr17","6929289","6929576","5","142934"
"chr3","6889870","6890162","chr2","167664248","167664541","50","160774378"
"chr3","6903745","6904062","chr17","7030859","7031176","10","127114"
"chr3","6947575","6947788","chr17","7081638","7081829","41","134063"
"chr3","6968262","6968437","chr17","7102823","7102998","4","134561"
"chr3","6968784","6968918","chr17","7103307","7103441","6","134523"
"chr3","6973309","6973400","chr4","102420454","102420545","29","95447145"
"chr3","6985130","6985284","chr19","13060538","13060678","40","6075408"
"chr3","6992333","6992439","chr17","7126276","7126383","4","133943"
"chr3","7000560","7000866","chr17","7134108","7134413","9","133548"
"chr3","7008324","7008618","chr17","7141858","7142167","32","133534"
"chr3","7060939","7061245","chr17","7194762","7195068","5","133823"
"chr3","7068155","7068452","chr17","7203790","7204083","9","135635"
"chr3","7101872","7102032","chr17","7238332","7238490","18","136460"
"chr3","7106534","7106656","chr17","7242900","7243022","6","136366"
"chr3","7110060","7110365","chr17","7246395","7246672","31","136335"
"chr3","7110892","7111017","chr18","14900755","14900881","24","7789863"
"chr3","7122504","7122798","chr17","7259709","7260003","4","137205"
"chr3","7127235","7127546","chr17","7264356","7264664","13","137121"
"chr3","7141986","7142303","chr17","7279090","7279401","18","137104"
"chr3","7145301","7145501","chr13","53892039","53892240","36","46746738"
"chr3","7146218","7146496","chr17","7283269","7283549","16","137051"
"chr3","7159774","7160065","chr17","7296452","7296742","10","136678"
"chr3","7160680","7160991","chr9","95344439","95344745","49","88183759"
"chr3","7167306","7167463","chr17","7303986","7304143","2","136680"
"chr3","7167861","7168015","chr3","39206512","39206646","38","32038651"
"chr3","7176326","7176637","chr17","7312916","7313229","18","136590"
"chr3","7186332","7186635","chr17","7330253","7330550","9","143921"
"chr3","7188423","7188682","chr17","7332338","7332597","1","143915"
"chr3","7190054","7190264","chr17","7333862","7334072","5","143808"
"chr3","7194674","7194959","chr17","7325121","7325406","8","130447"
"chr3","7198546","7198668","chr1","179016694","179016818","20","171818148"
"chr3","7205580","7205913","chr17","7340288","7340600","27","134708"
"chr3","7210880","7211168","chr17","7345562","7345853","9","134682"
"chr3","7211782","7212067","chr1","5100267","5100553","66","2111515"
"chr3","7220288","7220586","chr8","17792531","17792835","62","10572243"
"chr3","7227382","7227690","chr17","7362438","7362732","26","135056"
"chr3","7229261","7229471","chr17","7364310","7364520","7","135049"
"chr3","7231011","7231069","chr10","16885873","16885925","18","9654862"
"chr3","7231796","7232075","chr17","7366527","7366806","5","134731"
"chr3","7233150","7233456","chr17","7368189","7368480","28","135039"
"chr3","7237977","7238250","chrX","19290086","19290364","61","12052109"
"chr3","7239115","7239401","chr17","7374610","7374895","6","135495"
"chr3","7240753","7240981","chr14","66905967","66906187","52","59665214"
"chr3","7246224","7246499","chr17","7381743","7382013","13","135519"
"chr3","7254088","7254207","chr17","7389434","7389553","1","135346"
"chr3","7257934","7258241","chr5","142275718","142276035","71","135017784"
"chr3","7266663","7266964","chr17","7402657","7402954","10","135994"
"chr3","7273003","7273078","chr1","171246159","171246235","11","163973156"
"chr3","7273081","7273174","chr17","7409252","7409350","7","136171"
"chr3","7284629","7284913","chr17","7420793","7421077","3","136164"
"chr3","7290612","7290890","chr17","7426752","7427026","14","136140"
"chr3","7296448","7296725","chr17","7432623","7432904","8","136175"
"chr3","7297118","7297162","chrX","95249467","95249509","10","87952349"
"chr3","7297383","7297393","chr1","171692205","171692216","5","164394822"
"chr3","7301272","7301502","chr20","24872974","24873204","55","17571702"
"chr3","7302923","7303225","chr17","7437469","7437760","15","134546"
"chr3","7304540","7304836","chr14","52879118","52879412","54","45574578"
"chr3","7312861","7313160","chr17","7448335","7448634","4","135474"
"chr3","7324040","7324141","chr17","7459441","7459546","6","135401"
"chr3","7351103","7351413","chr10","80976143","80976451","72","73625040"
"chr3","7400378","7400676","chr17","7536530","7536820","16","136152"
"chr3","7409113","7409410","chr5","147933990","147934269","66","140524877"
"chr3","7417326","7417578","chr17","7552010","7552262","3","134684"
"chr3","7444119","7444412","chr17","7579181","7579474","8","135062"
"chr3","7486437","7486660","chr4","7539481","7539702","44","53044"
"chr3","7505934","7506220","chr17","7640830","7641114","3","134896"
"chr3","7522193","7522459","chr17","7657256","7657522","7","135063"
"chr3","7531019","7531303","chr17","7666227","7666512","8","135208"
"chr3","7559977","7560264","chr17","7695196","7695483","9","135219"
"chr3","7628916","7629050","chr17","7764477","7764611","1","135561"
"chr3","7631153","7631273","chr15","35833656","35833776","15","28202503"
"chr3","7631380","7631560","chrX","1974259","1974432","35","5657121"
"chr3","7640228","7640501","chr17","7775636","7775893","25","135408"
"chr3","7681759","7682069","chr17","7817134","7817476","38","135375"
"chr3","7684635","7684921","chr17","7819943","7820238","15","135308"
"chr3","7743159","7743239","chr17","7877709","7877789","1","134550"
"chr3","7754199","7754504","chrX","7035515","7035828","53","718684"
"chr3","7766103","7766409","chr17","7902311","7902618","15","136208"
"chr3","7775539","7775621","chr17","7911903","7911967","18","136364"
"chr3","7797710","7798006","chr17","7935057","7935377","28","137347"
"chr3","7828465","7828765","chr17","7968510","7968813","13","140045"
"chr3","7831291","7831586","chr17","7969402","7969696","13","138111"
"chr3","7836172","7836484","chr17","7974260","7974546","31","138088"
"chr3","7845380","7845611","chr17","7984062","7984293","5","138682"
"chr3","7886182","7886307","chr11","98024443","98024564","19","90138261"
"chr3","7892142","7892427","chr17","8021550","8021827","23","129408"
"chr3","8055483","8055672","chr17","8183932","8184120","7","128449"
"chr3","8125728","8125987","chr17","8251111","8251389","32","125383"
"chr3","8383885","8384004","chr17","8508861","8508980","3","124976"
"chr3","8417585","8417804","chr17","8546992","8547215","13","129407"
"chr3","8451063","8451370","chr17","8580769","8581067","15","129706"
"chr3","8469744","8470062","chr17","8598949","8599265","17","129205"
"chr3","8480571","8480870","chr3","86430795","86431095","50","77950224"
"chr3","8481893","8482193","chr17","8610642","8610934","25","128749"
"chr3","8483392","8483560","chr16","71545626","71545796","33","63062234"
"chr3","8569681","8569991","chr17","8701321","8701630","12","131640"
"chr3","8678848","8679142","chr17","8825760","8826061","24","146912"
"chr3","8702574","8702856","chr17","8849158","8849440","5","146584"
"chr3","8796704","8796996","chr17","8949806","8950092","17","153102"
"chr3","8798053","8798285","chr17","8951150","8951382","6","153097"
"chr3","8814492","8814797","chr11","98121981","98122292","72","89307489"
"chr3","8819231","8819519","chr17","8972507","8972815","26","153276"
"chr3","8859123","8859419","chr17","9012229","9012525","7","153106"
"chr3","8872935","8873232","chr17","9026161","9026466","13","153226"
"chr3","8879143","8879446","chr17","9032328","9032620","17","153185"
"chr3","9130835","9131126","chr17","9285595","9285892","12","154760"
"chr3","9234403","9234692","chr17","9390001","9390291","9","155598"
"chr3","9247603","9247675","chr1","44746983","44747047","20","35499380"
"chr3","9248479","9248695","chr19","17372331","17372550","45","8123852"
"chr3","9249419","9249716","chr17","9405008","9405300","14","155589"
"chr3","9282157","9282464","chrX","134712980","134713291","55","125430823"
"chr3","9285111","9285406","chr17","9440676","9440970","11","155565"
"chr3","9304300","9304585","chr17","9459700","9460009","41","155400"
"chr3","9316684","9316961","chr17","9472698","9472980","9","156014"
"chr3","9326471","9326735","chr17","9482508","9482805","50","156037"
"chr3","9331667","9331971","chr17","9487718","9488032","25","156051"
"chr3","9331972","9332084","chr10","81249941","81250063","28","71917969"
"chr3","9340304","9340608","chr17","9496586","9496897","13","156282"
"chr3","9350998","9351123","chr17","9504564","9504689","4","153566"
"chr3","9351250","9351364","chr1","21556103","21556211","39","12204853"
"chr3","9360163","9360327","chr17","9515846","9516018","14","155683"
"chr3","9360640","9360785","chr17","9516316","9516464","13","155676"
"chr3","9365754","9366037","chr17","9521709","9521989","11","155955"
"chr3","9374191","9374493","chr17","9530065","9530376","18","155874"
"chr3","9379385","9379706","chr17","9535310","9535628","13","155925"
"chr3","9382327","9382626","chr17","9538242","9538543","15","155915"
"chr3","9399217","9399517","chr17","9556180","9556477","8","156963"
"chr3","9409093","9409391","chr17","9564512","9564805","17","155419"
"chr3","9412794","9413072","chr17","9568136","9568422","17","155342"
"chr3","9413805","9413993","chr17","9569148","9569352","27","155343"
"chr3","9434158","9434463","chr17","9588180","9588472","39","154022"
"chr3","9437892","9438043","chr10","13063054","13063208","30","3625162"
"chr3","9438087","9438207","chr4","33514863","33514986","16","24076776"
"chr3","9461863","9462178","chr17","9616486","9616807","25","154623"
"chr3","9472947","9473251","chr17","9628026","9628334","10","155079"
"chr3","9473252","9473429","chr17","9628335","9628512","7","155083"
"chr3","9478422","9478517","chr17","9633516","9633612","2","155094"
"chr3","9479519","9479770","chr17","9634616","9634864","9","155097"
"chr3","9489950","9490220","chr17","9644132","9644399","7","154182"
"chr3","9515952","9516224","chr13","41054163","41054437","62","31538211"
"chr3","9518471","9518755","chr17","9670227","9670518","26","151756"
"chr3","9523788","9524006","chr17","9676099","9676312","13","152311"
"chr3","9591638","9591962","chr17","9742562","9742891","12","150924"
"chr3","9690824","9691111","chr17","9841458","9841748","9","150634"
"chr3","9734665","9734979","chr16","42390761","42391062","59","32656096"
"chr3","9741220","9741519","chr17","9892493","9892792","5","151273"
"chr3","9750889","9751205","chr4","59265179","59265483","64","49514290"
"chr3","9793873","9794167","chr17","9941278","9941567","17","147405"
"chr3","9801349","9801486","chr17","9948352","9948479","14","147003"
"chr3","9864667","9864965","chr3","178010044","178010346","73","168145377"
"chr3","9963899","9964199","chr17","10112589","10112887","14","148690"
"chr3","10071912","10072206","chr17","10222848","10223140","11","150936"
"chr3","10276264","10276434","chr3","78718150","78718316","32","68441886"
"chr3","10298296","10298566","chr6","65772660","65772931","54","55474364"
"chr3","10339599","10339888","chr17","10501272","10501585","37","161673"
"chr3","10353031","10353337","chr17","10514759","10515063","14","161728"
"chr3","10512124","10512428","chr17","10692728","10693028","9","180604"
"chr3","10527853","10528158","chr17","10708252","10708551","18","180399"
"chr3","10561884","10562181","chr17","10746485","10746785","18","184601"
"chr3","10597299","10597394","chr17","10782653","10782748","2","185354"
"chr3","10673560","10673872","chr17","10880484","10880796","10","206924"
"chr3","10694736","10695021","chr17","10902080","10902366","7","207344"
"chr3","10745526","10745784","chr17","10952355","10952613","5","206829"
"chr3","10842225","10842518","chr17","11048293","11048587","11","206068"
"chr3","10885872","10886185","chr17","11094534","11094846","9","208662"
"chr3","10954545","10954712","chr17","11162452","11162619","1","207907"
"chr3","10970219","10970506","chr17","11178621","11178908","12","208402"
"chr3","10977316","10977536","chr17","11185677","11185898","3","208361"
"chr3","10988160","10988453","chr17","11196857","11197152","9","208697"
"chr3","11083384","11083636","chr17","11292182","11292434","3","208798"
"chr3","11087053","11087199","chr17","11296067","11296213","4","209014"
"chr3","11115230","11115372","chr17","11324299","11324441","5","209069"
"chr3","11115671","11115817","chr17","11324742","11324887","9","209071"
"chr3","11190211","11190440","chr17","11398459","11398688","3","208248"
"chr3","11215026","11215083","chr5","159002076","159002138","14","147787050"
"chr3","11215187","11215292","chr10","6546419","6546525","16","4668768"
"chr3","11230383","11230698","chr17","11437851","11438170","13","207468"
"chr3","11232157","11232457","chr17","11439931","11440224","12","207774"
"chr3","11235589","11235868","chr17","11441330","11441610","8","205741"
"chr3","11236368","11236666","chr17","11442110","11442379","36","205742"
"chr3","11242154","11242441","chr17","11449364","11449648","11","207210"
"chr3","11246869","11247160","chr12","99689911","99690212","55","88443042"
"chr3","11267115","11267359","chr17","11474671","11474925","15","207556"
"chr3","11273149","11273445","chr17","11480634","11480920","16","207485"
"chr3","11273851","11273899","chrX","62920364","62920413","13","51646513"
"chr3","11273901","11274032","chr19","28213603","28213739","23","16939702"
"chr3","11290501","11290713","chr17","11498092","11498303","25","207591"
"chr3","11290784","11291116","chr9","93852874","93853186","76","82562090"
"chr3","11294089","11294371","chr17","11501675","11501973","22","207586"
"chr3","11313420","11313693","chr17","11521595","11521875","12","208175"
"chr3","11348905","11349206","chr17","11561596","11561885","17","212691"
"chr3","11361749","11362036","chr2","97022915","97023209","58","85661166"
"chr3","11372019","11372292","chr17","11581962","11582233","8","209943"
"chr3","11386235","11386515","chr17","11594823","11595102","6","208588"
"chr3","11404988","11405281","chr17","11613416","11613708","8","208428"
"chr3","11410590","11410905","chr17","11618512","11618828","10","207922"
"chr3","11453835","11454123","chr17","11661914","11662196","12","208079"
"chr3","11457433","11457731","chr17","11665501","11665810","19","208068"
"chr3","11533908","11534135","chr17","11741018","11741239","12","207110"
"chr3","11542471","11542746","chr20","25880316","25880597","64","14337845"
"chr3","11638355","11638642","chr17","11841184","11841484","24","202829"
"chr3","11658887","11659174","chr17","11843163","11843451","8","184276"
"chr3","11785735","11786030","chr17","11977595","11977889","6","191860"
"chr3","11794462","11794739","chr17","11986388","11986672","16","191926"
"chr3","11796592","11796900","chr19","37146750","37147058","55","25350158"
"chr3","11866805","11866898","chr17","12055413","12055495","12","188608"
"chr3","11867614","11867627","chr6","13692991","13693004","3","1825377"
"chr3","11897128","11897433","chr17","12086125","12086430","10","188997"
"chr3","11928009","11928299","chr17","12113828","12114118","5","185819"
"chr3","11948253","11948549","chr17","12133357","12133654","17","185104"
"chr3","11990170","11990324","chr19","5234935","5235087","29","6755235"
"chr3","11990330","11990417","chr7","56849195","56849280","22","44858865"
"chr3","11991824","11992104","chr17","12179818","12180098","9","187994"
"chr3","12034046","12034339","chr1","31731694","31731981","61","19697648"
"chr3","12043308","12043607","chr17","12231396","12231685","20","188088"
"chr3","12052022","12052312","chr17","12240055","12240355","13","188033"
"chr3","12084956","12085255","chr17","12272273","12272571","11","187317"
"chr3","12117285","12117585","chr17","12304577","12304877","4","187292"
"chr3","12134052","12134176","chr20","10136157","10136277","22","1997895"
"chr3","12176449","12176721","chr12","80823770","80824037","59","68647321"
"chr3","12180588","12180897","chr17","12368241","12368545","14","187653"
"chr3","12209642","12209926","chr6","106720990","106721272","53","94511348"
"chr3","12237373","12237640","chr17","12424662","12424935","12","187289"
"chr3","12292443","12292722","chr17","12484114","12484400","10","191671"
"chr3","12303389","12303668","chr17","12495144","12495442","28","191755"
"chr3","12321120","12321219","chr17","12514068","12514165","6","192948"
"chr3","12375283","12375454","chr17","12567198","12567369","4","191915"
"chr3","12399732","12400030","chr17","12592056","12592353","8","192324"
"chr3","12476793","12477083","chr17","12673498","12673799","26","196705"
"chr3","12503281","12503612","chr17","12699912","12700209","39","196631"
"chr3","12612240","12612511","chr17","12808435","12808706","10","196195"
"chr3","12624774","12625066","chr17","12820918","12821214","8","196144"
"chr3","12633173","12633405","chr17","12829608","12829843","9","196435"
"chr3","12668095","12668404","chr17","12864092","12864401","20","195997"
"chr3","12697948","12698257","chr17","12902375","12902700","20","204427"
"chr3","12714498","12714777","chr17","12919439","12919753","41","204941"
"chr3","12749685","12749981","chr17","12960483","12960779","9","210798"
"chr3","12764817","12765146","chr17","12975575","12975894","24","210758"
"chr3","12803261","12803456","chr17","13014079","13014273","6","210818"
"chr3","12803917","12804014","chr17","13014736","13014833","2","210819"
"chr3","12943530","12943702","chr4","153955031","153955201","37","141011501"
"chr3","12943736","12943848","chr4","128076232","128076344","15","115132496"
"chr3","13107365","13107677","chr13","42100035","42100348","57","28992670"
"chr3","13112143","13112433","chr17","13338168","13338472","20","226025"
"chr3","13142341","13142644","chr17","13368835","13369134","14","226494"
"chr3","13156754","13157051","chr17","13383241","13383540","6","226487"
"chr3","13265083","13265306","chr3","130001871","130002091","61","116736788"
"chr3","13305293","13305591","chr17","13536004","13536297","14","230711"
"chr3","13335960","13336256","chr17","13562866","13563162","7","226906"
"chr3","13420944","13421226","chr17","13646775","13647060","11","225831"
"chr3","13492856","13493149","chr17","13718802","13719109","34","225946"
"chr3","13523553","13523693","chr17","13751422","13751571","16","227869"
"chr3","13523851","13523943","chr19","12845215","12845287","39","678636"
"chr3","13523981","13524103","chr17","13751851","13751973","5","227870"
"chr3","13597119","13597417","chr17","13835555","13835864","24","238436"
"chr3","13607159","13607364","chr17","13846425","13846632","9","239266"
"chr3","13611468","13611778","chr17","13850714","13851021","15","239246"
"chr3","13614279","13614550","chr17","13853524","13853799","11","239245"
"chr3","13680790","13681079","chr17","13920886","13921175","11","240096"
"chr3","13743315","13743473","chr17","13983574","13983732","5","240259"
"chr3","13922665","13922967","chr17","14163079","14163373","21","240414"
"chr3","13972352","13972634","chr17","14212739","14213021","8","240387"
"chr3","14009536","14009850","chr4","21577512","21577826","66","7567976"
"chr3","14044970","14045250","chr17","14284175","14284455","4","239205"
"chr3","14058353","14058653","chr17","14296989","14297288","13","238636"
"chr3","14086976","14087288","chr17","14328379","14328687","8","241403"
"chr3","14119760","14119963","chr17","51643","51852","42","14068117"
"chr3","14145727","14146033","chr17","14386724","14387029","17","240997"
"chr3","14202506","14202732","chr17","14442291","14442518","9","239785"
"chr3","14207354","14207613","chr17","14447150","14447418","20","239796"
"chr3","14223828","14224131","chr17","14463698","14464002","8","239870"
"chr3","14227118","14227413","chr17","14466996","14467289","5","239878"
"chr3","14291259","14291546","chr17","14543267","14543591","49","252008"
"chr3","14390288","14390456","chr17","14643762","14643948","23","253474"
"chr3","14486338","14486646","chr17","14741963","14742262","18","255625"
"chr3","14502285","14502586","chr6","166241667","166241965","49","151739382"
"chr3","14527939","14528236","chr17","14783735","14784041","19","255796"
"chr3","14534570","14534848","chr17","14790165","14790443","3","255595"
"chr3","14573431","14573723","chr17","14821389","14821680","13","247958"
"chr3","14584237","14584527","chr17","14831536","14831825","10","247299"
"chr3","14597508","14597818","chr2","99544921","99545226","48","84947413"
"chr3","14611769","14612081","chr17","14859097","14859377","41","247328"
"chr3","14682200","14682529","chr17","14929645","14929975","12","247445"
"chr3","14696740","14696917","chr17","14944249","14944426","6","247509"
"chr3","14718665","14718964","chr17","14966102","14966411","15","247437"
"chr3","14740013","14740322","chr2","65066733","65067031","58","50326720"
"chr3","14781783","14781842","chr1","38920498","38920555","14","24138715"
"chr3","14781843","14782128","chr17","15029377","15029687","34","247534"
"chr3","14814577","14814862","chr17","15062143","15062428","5","247566"
"chr3","14866380","14866662","chr17","15111565","15111846","10","245185"
"chr3","14907108","14907270","chr17","15154782","15154944","3","247674"
"chr3","14926666","14926938","chr3","173934944","173935225","56","159008278"
"chr3","14930080","14930400","chr17","15177252","15177560","19","247172"
"chr3","14950419","14950724","chr17","15197547","15197852","5","247128"
"chr3","14993618","14993802","chr19","42390762","42390907","57","27397144"
"chr3","14994633","14994814","chr17","15258405","15258586","3","263772"
"chr3","14999325","14999606","chr17","15263039","15263332","19","263714"
"chr3","15098370","15098643","chr17","15352829","15353113","18","254459"
"chr3","15100744","15101041","chr17","15355202","15355499","9","254458"
"chr3","15232388","15232672","chr17","15482632","15482917","7","250244"
"chr3","15253410","15253707","chr17","15502591","15502884","13","249181"
"chr3","15267918","15268229","chr17","15517332","15517639","14","249414"
"chr3","15336624","15336938","chr17","15586277","15586584","30","249653"
"chr3","15337705","15337997","chr17","15587361","15587668","23","249656"
"chr3","15342478","15342613","chr17","15592233","15592372","9","249755"
"chr3","15342915","15343092","chr17","15592668","15592854","17","249753"
"chr3","15360020","15360320","chr17","15609732","15610017","20","249712"
"chr3","15405794","15405900","chr7","121004297","121004381","40","105598503"
"chr3","15409350","15409661","chr17","15659331","15659642","8","249981"
"chr3","15422286","15422595","chr13","7105780","7106090","51","8316506"
"chr3","15429432","15429741","chr17","15678447","15678750","25","249015"
"chr3","15435119","15435391","chr17","15683972","15684244","11","248853"
"chr3","15454321","15454620","chr17","15703168","15703463","14","248847"
"chr3","15469023","15469329","chr17","15715176","15715487","20","246153"
"chr3","15472644","15473044","chr13","61336963","61337313","128","45864319"
"chr3","15476177","15476344","chr1","152928618","152928784","40","137452441"
"chr3","15476778","15477069","chr17","15723397","15723689","9","246619"
"chr3","15478219","15478334","chr17","15724834","15724947","3","246615"
"chr3","15496425","15496734","chr17","15742548","15742859","11","246123"
"chr3","15538459","15538739","chr17","15784406","15784684","8","245947"
"chr3","15564519","15564759","chr17","15810299","15810539","4","245780"
"chr3","15575588","15575913","chr17","15822468","15822777","28","246880"
"chr3","15576132","15576269","chr7","15394911","15395040","33","181221"
"chr3","15644223","15644472","chr17","15891695","15891944","5","247472"
"chr3","15648408","15648610","chr17","15895836","15896060","23","247428"
"chr3","15669562","15669610","chr17","15917195","15917243","0","247633"
"chr3","15669723","15669811","chr17","15917356","15917444","3","247633"
"chr3","15809453","15809719","chr17","16063970","16064224","21","254517"
"chr3","15952934","15953234","chr17","16207286","16207580","42","254352"
"chr3","16034454","16034744","chr17","16288905","16289195","8","254451"
"chr3","16139041","16139198","chr15","8627944","8628113","17","7511097"
"chr3","16221706","16221860","chr17","16473088","16473241","4","251382"
"chr3","16233531","16233848","chr17","16489577","16489891","12","256046"
"chr3","16234327","16234596","chr17","16490357","16490626","10","256030"
"chr3","16250804","16251075","chr17","16507128","16507400","5","256324"
"chr3","16377021","16377193","chr17","16643948","16644158","42","266927"
"chr3","16436714","16436883","chr17","16704966","16705130","10","268252"
"chr3","16502357","16502511","chr3","178210714","178210870","32","161708357"
"chr3","16527731","16528020","chr17","16795576","16795871","36","267845"
"chr3","16655313","16655595","chr17","16929847","16930139","18","274534"
"chr3","16705739","16706034","chr17","16982356","16982664","27","276617"
"chr3","16729072","16729345","chrX","6605464","6605752","66","10123608"
"chr3","16770210","16770515","chr17","17027326","17027628","15","257116"
"chr3","16898773","16898892","chr17","17155453","17155572","5","256680"
"chr3","17083481","17083780","chr17","17346936","17347247","18","263455"
"chr3","17094205","17094355","chr8","28902234","28902382","27","11808029"
"chr3","17094391","17094513","chrX","21055438","21055556","26","3961047"
"chr3","17169919","17170220","chr17","17435948","17436253","17","266029"
"chr3","17211908","17212240","chr17","17478236","17478519","64","266328"
"chr3","17320159","17320288","chr17","17585289","17585429","15","265130"
"chr3","17382096","17382366","chr10","22222890","22223155","56","4840794"
"chr3","17383559","17383864","chr17","17652441","17652743","19","268882"
"chr3","17385611","17385918","chr17","17654410","17654720","13","268799"
"chr3","17393890","17394200","chr17","17662727","17663030","21","268837"
"chr3","17447614","17447931","chr17","17716225","17716542","6","268611"
"chr3","17568296","17568583","chr19","9205904","9206200","69","8362392"
"chr3","17614504","17614726","chr17","17879776","17879999","9","265272"
"chr3","17636800","17637095","chr17","17903396","17903683","14","266596"
"chr3","17686265","17686396","chr15","39542579","39542711","22","21856314"
"chr3","17770807","17770983","chr17","18040840","18041015","9","270033"
"chr3","17781539","17781836","chr17","18051527","18051818","11","269988"
"chr3","17821293","17821401","chr17","18096515","18096623","5","275222"
"chr3","17821761","17821959","chr17","18096997","18097200","26","275236"
"chr3","17822207","17822480","chr17","18097456","18097728","7","275249"
"chr3","17839320","17839623","chr17","18114149","18114446","17","274829"
"chr3","17870843","17871121","chr17","18146956","18147234","7","276113"
"chr3","17963859","17964159","chr17","18238886","18239182","18","275027"
"chr3","18029975","18030261","chr17","18285965","18286251","10","255990"
"chr3","18030398","18030695","chr17","18286398","18286692","10","256000"
"chr3","18036548","18036839","chr2","172936939","172937233","63","154900391"
"chr3","18057971","18058279","chr17","18313903","18314203","21","255932"
"chr3","18066325","18066626","chr17","18322245","18322544","11","255920"
"chr3","18182528","18182686","chr17","18445768","18445934","11","263240"
"chr3","18182999","18183137","chr17","18446252","18446391","4","263253"
"chr3","18191380","18191667","chr17","18454693","18454969","13","263313"
"chr3","18280843","18280946","chr17","18546560","18546666","7","265717"
"chr3","18350130","18350417","chr17","18616928","18617221","13","266798"
"chr3","18494664","18494940","chr17","18763303","18763579","4","268639"
"chr3","18588883","18589049","chr20","26993039","26993219","55","8404156"
"chr3","18695466","18695736","chr17","18966238","18966507","14","270772"
"chr3","18703581","18703882","chr17","18973778","18974070","18","270197"
"chr3","18760778","18761100","chr17","19033597","19033921","14","272819"
"chr3","18769081","18769389","chr17","19041917","19042234","19","272836"
"chr3","18814321","18814628","chr17","19088209","19088518","10","273888"
"chr3","18870213","18870471","chr17","19143778","19144069","40","273565"
"chr3","18886138","18886433","chr8","93286549","93286843","44","74400411"
"chr3","18936352","18936633","chr17","19209604","19209879","13","273252"
"chr3","18972530","18972836","chr17","19245610","19245916","10","273080"
"chr3","18979234","18979534","chr17","19252262","19252576","24","273028"
"chr3","18995927","18996061","chr2","79243789","79243922","33","60247862"
"chr3","19004190","19004486","chr17","19278057","19278339","20","273867"
"chr3","19037470","19037548","chr17","19311129","19311207","1","273659"
"chr3","19044811","19044992","chr17","19320103","19320260","25","275292"
"chr3","19051972","19052273","chr17","19328206","19328507","9","276234"
"chr3","19081931","19082215","chr6","88163921","88164222","63","69081990"
"chr3","19084449","19084770","chr17","19366648","19366941","38","282199"
"chr3","19086963","19087275","chr6","156944499","156944809","51","137857536"
"chr3","19087805","19087985","chr17","19371809","19371989","3","284004"
"chr3","19088283","19088423","chr17","19372292","19372431","5","284009"
"chr3","19090721","19091023","chr17","19374748","19375047","10","284027"
"chr3","19111440","19111525","chr8","137894325","137894409","18","118782885"
"chr3","19112180","19112489","chr17","19399012","19399312","15","286832"
"chr3","19119939","19120190","chr17","19405611","19405863","10","285672"
"chr3","19125989","19126177","chr17","19411706","19411894","3","285717"
"chr3","19128189","19128458","chr17","19414223","19414487","11","286034"
"chr3","19137611","19137817","chr17","19423229","19423438","11","285618"
"chr3","19138553","19138657","chr17","19424178","19424282","6","285625"
"chr3","19152342","19152630","chr17","19437599","19437888","12","285257"
"chr3","19172581","19172889","chr17","19459573","19459881","7","286992"
"chr3","19200913","19201212","chr17","19522819","19523124","14","321906"
"chr3","19214810","19215023","chr17","19541805","19542018","3","326995"
"chr3","19216212","19216518","chr17","19543516","19543816","13","327304"
"chr3","19228948","19229238","chr17","19556307","19556594","17","327359"
"chr3","19247448","19247705","chr17","19574701","19574954","11","327253"
"chr3","19252004","19252288","chr17","19579192","19579476","4","327188"
"chr3","19252990","19253195","chr9","25989257","25989459","56","6736267"
"chr3","19282333","19282629","chr17","19609928","19610222","10","327595"
"chr3","19295075","19295370","chr17","19622637","19622933","5","327562"
"chr3","19312992","19313268","chr17","19640598","19640884","18","327606"
"chr3","19314485","19314799","chrX","15697361","15697669","63","3617124"
"chr3","19316476","19316775","chr13","90648508","90648811","64","71332032"
"chr3","19326501","19326715","chr17","19654917","19655130","4","328416"
"chr3","19352513","19352814","chr17","19680632","19680939","20","328119"
"chr3","19353774","19354011","chr17","19681878","19682115","5","328104"
"chr3","19356552","19356840","chr17","19684645","19684933","5","328093"
"chr3","19363342","19363612","chr17","19692045","19692315","7","328703"
"chr3","19367532","19367637","chr17","19696240","19696344","2","328708"
"chr3","19367936","19368114","chr17","19696649","19696823","10","328713"
"chr3","19368523","19368813","chr6","52097346","52097632","64","32728823"
"chr3","19380395","19380688","chr17","19709361","19709655","4","328966"
"chr3","19382787","19382952","chr17","19711751","19711916","1","328964"
"chr3","19406829","19406957","chr17","19737484","19737606","14","330655"
"chr3","19407708","19407789","chr17","19738366","19738447","5","330658"
"chr3","19411877","19412054","chr17","19742837","19743015","10","330960"
"chr3","19443569","19443701","chr17","19781046","19781178","2","337477"
"chr3","19443899","19444008","chr17","19781381","19781489","2","337482"
"chr3","19476818","19477111","chr17","19817128","19817424","16","340310"
"chr3","19490801","19491132","chr17","19831427","19831757","12","340626"
"chr3","19504622","19504927","chr17","19844980","19845278","17","340358"
"chr3","19509237","19509338","chr17","19849630","19849731","4","340393"
"chr3","19526048","19526171","chr17","19862932","19863061","15","336884"
"chr3","19543078","19543377","chr17","19880260","19880538","38","337182"
"chr3","19556683","19556933","chr17","19893841","19894091","10","337158"
"chr3","19560455","19560626","chr9","88967166","88967333","28","69406711"
"chr3","19560656","19560754","chr5","20259577","20259676","18","698921"
"chr3","19593332","19593493","chrX","141531520","141531674","35","121938188"
"chr3","19597022","19597317","chr17","19935264","19935558","7","338242"
"chr3","19603289","19603586","chr17","19941401","19941698","8","338112"
"chr3","19607244","19607521","chr9","93763976","93764227","85","74156732"
"chr3","19631795","19631921","chr17","19969516","19969642","2","337721"
"chr3","19640815","19641120","chr17","19978484","19978789","6","337669"
"chr3","19647930","19648156","chr17","19984960","19985186","7","337030"
"chr3","19650171","19650466","chr17","19987219","19987514","12","337048"
"chr3","19713070","19713366","chr10","34885027","34885322","60","15171957"
"chr3","19724088","19724378","chr17","20049079","20049367","10","324991"
"chr3","19725825","19726118","chr17","20050823","20051127","24","324998"
"chr3","19731460","19731753","chr17","20054460","20054766","21","323000"
"chr3","19752616","19752916","chr7","82518846","82519140","58","62766230"
"chr3","19761114","19761412","chr17","20090153","20090448","8","329039"
"chr3","19827010","19827299","chr17","20154749","20155043","8","327739"
"chr3","19878795","19879026","chr17","20206549","20206781","9","327754"
"chr3","19881653","19881839","chr17","20209713","20209899","4","328060"
"chr3","19967067","19967364","chr17","20296283","20296596","17","329216"
"chr3","19969418","19969724","chr17","20298649","20298955","11","329231"
"chr3","19981491","19981767","chr17","20310679","20310947","18","329188"
"chr3","20040820","20041099","chr17","20370932","20371222","19","330112"
"chr3","20152151","20152449","chr17","20480273","20480571","4","328122"
"chr3","20178445","20178757","chr17","20507187","20507492","19","328742"
"chr3","20194016","20194318","chr17","20523311","20523627","27","329295"
"chr3","20212980","20213296","chr17","20542874","20543185","19","329894"
"chr3","20218104","20218354","chr20","13434727","13434978","58","6783377"
"chr3","20306668","20306965","chr17","20653892","20654194","12","347224"
"chr3","20334148","20334437","chr17","20683077","20683365","9","348929"
"chr3","20336520","20336797","chr17","20685765","20686040","17","349245"
"chr3","20349401","20349548","chr11","103384632","103384781","31","83035231"
"chr3","20352185","20352494","chr17","20701756","20702067","10","349571"
"chr3","20358664","20358967","chr17","20708469","20708785","20","349805"
"chr3","20361566","20361862","chr17","20711414","20711711","8","349848"
"chr3","20368216","20368506","chr17","20718562","20718851","10","350346"
"chr3","20376051","20376220","chr17","20726412","20726581","3","350361"
"chr3","20427450","20427789","chr17","20778222","20778566","24","350772"
"chr3","20452198","20452485","chr17","20806675","20806961","10","354477"
"chr3","20594526","20594829","chr17","20955354","20955650","21","360828"
"chr3","20736725","20737044","chr17","21097632","21097951","16","360907"
"chr3","20801737","20801838","chr17","21163417","21163518","3","361680"
"chr3","20886560","20886695","chr4","24203833","24203951","28","3317273"
"chr3","20983587","20983879","chr17","21350563","21350855","11","366976"
"chr3","21006819","21006891","chr17","21374282","21374354","7","367463"
"chr3","21057248","21057559","chr17","21422806","21423117","11","365558"
"chr3","21073354","21073528","chr1","26004811","26004989","44","4931457"
"chr3","21100838","21100960","chr17","21469405","21469526","3","368567"
"chr3","21101002","21101148","chr2","67925671","67925816","29","46824669"
"chr3","21138624","21138926","chr17","21507022","21507324","2","368398"
"chr3","21224994","21225291","chr17","21612075","21612372","10","387081"
"chr3","21231750","21232029","chr17","21618802","21619106","38","387052"
"chr3","21358086","21358378","chr2","91206018","91206308","58","69847932"
"chr3","21388803","21389054","chr17","21781988","21782237","10","393185"
"chr3","21415206","21415486","chr17","21808210","21808482","20","393004"
"chr3","21416242","21416547","chr17","21809200","21809505","11","392958"
"chr3","21506445","21506753","chr17","21898896","21899201","13","392451"
"chr3","21527518","21527818","chr17","21920060","21920360","11","392542"
"chr3","21531035","21531344","chr17","21923591","21923897","12","392556"
"chr3","21535795","21536113","chr17","21928352","21928661","22","392557"
"chr3","21677924","21678214","chr17","22076316","22076606","10","398392"
"chr3","21685072","21685346","chr17","22083430","22083704","9","398358"
"chr3","21730662","21730950","chr17","22128740","22129028","4","398078"
"chr3","21846651","21846937","chr17","22249873","22250169","21","403222"
"chr3","21861312","21861595","chr17","22263707","22263990","8","402395"
"chr3","21877983","21878268","chr17","22280112","22280396","5","402129"
"chr3","21925994","21926265","chr9","54279262","54279542","66","32353268"
"chr3","22044656","22044863","chr17","22447250","22447458","8","402594"
"chr3","22269760","22270073","chr17","22671599","22671896","28","401839"
"chr3","22299412","22299721","chr17","22701300","22701609","7","401888"
"chr3","22453585","22453888","chr17","22853892","22854181","21","400307"
"chr3","22520806","22521110","chr17","22917319","22917616","9","396513"
"chr3","22562795","22563131","chr17","22959647","22959960","27","396852"
"chr3","22568903","22569117","chr17","22965726","22965940","7","396823"
"chr3","22570362","22570481","chr17","22967191","22967308","4","396829"
"chr3","22571489","22571800","chr17","22968299","22968606","13","396810"
"chr3","22594838","22595078","chr17","22991322","22991523","41","396484"
"chr3","22601133","22601414","chr17","22997570","22997850","32","396437"
"chr3","22607846","22608146","chr17","23004336","23004635","8","396490"
"chr3","22614472","22614739","chr17","23010976","23011246","14","396504"
"chr3","22630386","22630647","chr17","23025691","23025969","23","395305"
"chr3","22643487","22643758","chr17","23038798","23039071","7","395311"
"chr3","22646305","22646605","chr17","23041621","23041913","13","395316"
"chr3","22647724","22648050","chrX","45623197","45623527","87","22975473"
"chr3","22656536","22656651","chr3","55268266","55268384","16","32611730"
"chr3","22658723","22659011","chr17","23054061","23054349","8","395338"
"chr3","22662624","22662731","chr17","23057969","23058076","1","395345"
"chr3","22667106","22667411","chr17","23061704","23062005","16","394598"
"chr3","22680130","22680411","chr17","23073590","23073871","8","393460"
"chr3","22687556","22687818","chr17","23081101","23081363","3","393545"
"chr3","22697336","22697613","chr17","23090845","23091130","14","393509"
"chr3","22702357","22702626","chr17","23096212","23096496","22","393855"
"chr3","22705119","22705411","chr17","23098962","23099256","13","393843"
"chr3","22708907","22709210","chr17","23104279","23104581","7","395372"
"chr3","22722006","22722307","chr17","23117618","23117913","13","395612"
"chr3","22732694","22732843","chr17","23130726","23130854","24","398032"
"chr3","22737914","22738148","chr17","23136120","23136346","20","398206"
"chr3","22748006","22748209","chr17","23145848","23146037","19","397842"
"chr3","22756895","22756905","chr9","112320401","112320412","2","89563506"
"chr3","22757191","22757350","chr17","23155627","23155784","6","398436"
"chr3","22787908","22788229","chr17","23190026","23190346","7","402118"
"chr3","22817940","22818129","chr11","38369515","38369683","49","15551575"
"chr3","22858691","22858975","chr17","23255781","23256042","30","397090"
"chr3","22866734","22867002","chr13","23887456","23887734","62","1020722"
"chr3","22898943","22899257","chr17","23286004","23286326","24","387061"
"chr3","22912395","22912679","chr17","23299262","23299537","33","386867"
"chr3","22925960","22926247","chr17","23310265","23310552","11","384305"
"chr3","22927164","22927471","chr17","23311470","23311777","8","384306"
"chr3","22934323","22934436","chr17","23318652","23318766","3","384329"
"chr3","22940302","22940591","chr17","23324306","23324595","11","384004"
"chr3","22950290","22950575","chr17","23334644","23334930","17","384354"
"chr3","22960766","22961066","chr17","23345132","23345442","20","384366"
"chr3","22965905","22966020","chr12","95217434","95217551","15","72251529"
"chr3","22974117","22974399","chr17","23358258","23358578","48","384141"
"chr3","22976631","22976913","chr17","23360807","23361106","28","384176"
"chr3","23004320","23004594","chr17","23388190","23388463","3","383870"
"chr3","23075808","23076041","chr15","56016075","56016314","46","32940267"
"chr3","23097872","23098170","chr17","23476847","23477142","21","378975"
"chr3","23112737","23112868","chr9","62015958","62016081","34","38903221"
"chr3","23139675","23139968","chr17","23521244","23521537","7","381569"
"chr3","23148139","23148279","chr12","69903661","69903801","30","46755522"
"chr3","23148551","23148666","chr1","54838761","54838872","28","31690210"
"chr3","23151473","23151613","chr12","69903661","69903801","30","46752188"
"chr3","23151885","23152000","chr1","54838761","54838872","28","31686876"
"chr3","23153669","23153980","chr17","23534243","23534552","14","380574"
"chr3","23155104","23155418","chr17","23535791","23536097","11","380687"
"chr3","23169234","23169517","chr17","23547925","23548210","6","378691"
"chr3","23184755","23185031","chr17","23566904","23567180","8","382149"
"chr3","23189018","23189329","chr3","130226668","130226979","66","107037650"
"chr3","23191345","23191632","chr17","23573692","23573962","27","382347"
"chr3","23193233","23193500","chr17","23575562","23575829","5","382329"
"chr3","23198390","23198681","chr8","44115676","44115967","56","20917286"
"chr3","23209550","23209853","chr17","23591360","23591655","22","381810"
"chr3","23219603","23219920","chr17","23601339","23601653","16","381736"
"chr3","23221164","23221457","chr17","23603080","23603370","10","381916"
"chr3","23223488","23223783","chrX","46852707","46853016","56","23629219"
"chr3","23232223","23232268","chr1","214144715","214144760","7","190912492"
"chr3","23232269","23232435","chr6","169794377","169794541","43","146562108"
"chr3","23238437","23238721","chr7","19804332","19804614","62","3434105"
"chr3","23241689","23241991","chr17","23622879","23623181","16","381190"
"chr3","23249912","23250191","chr17","23631138","23631409","18","381226"
"chr3","23257674","23257963","chr17","23639648","23639923","20","381974"
"chr3","23262336","23262501","chr1","93519854","93520015","34","70257518"
"chr3","23273349","23273638","chr17","23656531","23656844","33","383182"
"chr3","23277341","23277645","chr17","23660437","23660742","12","383096"
"chr3","23288691","23288821","chr17","23671773","23671896","11","383082"
"chr3","23300767","23301037","chr17","23683842","23684112","9","383075"
"chr3","23310258","23310556","chr10","53449762","53450062","67","30139504"
"chr3","23311317","23311610","chr17","9941278","9941567","62","13370039"
"chr3","23312427","23312699","chr17","23694947","23695222","36","382520"
"chr3","23323825","23324039","chr17","23705776","23705990","4","381951"
"chr3","23338202","23338523","chr17","23720137","23720441","32","381935"
"chr3","23347918","23348103","chr17","23730068","23730253","7","382150"
"chr3","23358582","23358669","chr1","171807118","171807203","24","148448536"
"chr3","23359585","23359874","chr17","23749761","23750055","9","390176"
"chr3","23371093","23371359","chr17","23752022","23752302","17","380929"
"chr3","23393529","23393778","chr17","23774870","23775118","5","381341"
"chr3","23410489","23410796","chr17","23792992","23793288","19","382503"
"chr3","23418368","23418659","chr17","23801256","23801545","9","382888"
"chr3","23423646","23423778","chr17","23806624","23806756","1","382978"
"chr3","23427744","23427953","chr17","23810711","23810948","30","382967"
"chr3","23437667","23437945","chr1","43269471","43269754","55","19831804"
"chr3","23443130","23443438","chrX","14385128","14385432","59","9058002"
"chr3","23449758","23450032","chr16","67932374","67932645","41","44482616"
"chr3","23452507","23452807","chr1","163551503","163551805","60","140098996"
"chr3","23455001","23455063","chr1","6641003","6641065","8","16813998"
"chr3","23455066","23455117","chr2","99989151","99989203","8","76534085"
"chr3","23457999","23458041","chr5","324650","324693","8","23133349"
"chr3","23465333","23465439","chr17","23829449","23829556","4","364116"
"chr3","23465777","23465832","chr6","65604634","65604691","12","42138857"
"chr3","23477666","23477827","chr10","12204892","12205055","26","11272774"
"chr3","23480038","23480154","chr2","94934531","94934637","23","71454493"
"chr3","23494634","23494814","chr17","23860634","23860812","12","366000"
"chr3","23507805","23507855","chr19","828808","828856","13","22678997"
"chr3","23508968","23509243","chr17","23875525","23875800","7","366557"
"chr3","23510118","23510408","chr17","23876667","23876955","14","366549"
"chr3","23510530","23510821","chr17","23877077","23877368","10","366547"
"chr3","23513622","23513842","chr17","23880473","23880664","32","366851"
"chr3","23514107","23514244","chr17","23880968","23881104","3","366861"
"chr3","23516343","23516642","chr17","23883203","23883502","5","366860"
"chr3","23520796","23521087","chr17","23887678","23887969","9","366882"
"chr3","23521154","23521452","chr17","23888036","23888334","17","366882"
"chr3","23529767","23529845","chr1","130442089","130442168","14","106912322"
"chr3","23530697","23530962","chr17","23897868","23898152","35","367171"
"chr3","23542763","23543050","chr17","23909920","23910207","11","367157"
"chr3","23555289","23555585","chr17","23922473","23922781","22","367184"
"chr3","23555784","23556072","chr17","23922980","23923271","9","367196"
"chr3","23568368","23568663","chr1","21109084","21109381","51","2459284"
"chr3","23573931","23574237","chr17","23940022","23940328","20","366091"
"chr3","23574757","23575060","chr17","23940858","23941163","17","366101"
"chr3","23575784","23575900","chr17","23941890","23942004","8","366106"
"chr3","23576575","23576876","chr17","23942675","23942979","21","366100"
"chr3","23578433","23578707","chr17","23944551","23944815","15","366118"
"chr3","23586061","23586341","chr10","82949030","82949297","75","59362969"
"chr3","23593468","23593751","chr17","23959890","23960172","14","366422"
"chr3","23600486","23600806","chr17","23966890","23967223","26","366404"
"chr3","23657369","23657649","chr17","24028382","24028661","9","371013"
"chr3","23678580","23678694","chr17","24049723","24049837","2","371143"
"chr3","23681989","23682208","chr17","24053174","24053386","12","371185"
"chr3","23747810","23748000","chr17","24119423","24119621","11","371613"
"chr3","23750486","23750640","chr17","24122291","24122445","4","371805"
"chr3","23778534","23778803","chr17","24153428","24153696","3","374894"
"chr3","23824264","23824562","chr17","24199604","24199902","2","375340"
"chr3","23848832","23849124","chr17","24223711","24224003","11","374879"
"chr3","23868874","23869042","chr17","24243767","24243934","1","374893"
"chr3","23948088","23948399","chr17","24321602","24321912","11","373514"
"chr3","24021076","24021245","chr12","64016875","64017043","35","39995799"
"chr3","24032525","24032772","chr17","24405623","24405865","10","373098"
"chr3","24055447","24055717","chr6","118149614","118149873","59","94094167"
"chr3","24061928","24062179","chr17","24434892","24435143","7","372964"
"chr3","24075977","24076076","chr17","24449271","24449370","1","373294"
"chr3","24083268","24083567","chr17","24456599","24456899","14","373331"
"chr3","24092497","24092663","chr17","24465817","24465985","7","373320"
"chr3","24169990","24170217","chr17","24544360","24544589","12","374370"
"chr3","24260564","24260879","chr17","24638076","24638389","23","377512"
"chr3","24340641","24340939","chr17","24720650","24720939","17","380009"
"chr3","24341932","24342145","chr17","24721956","24722179","15","380024"
"chr3","24364591","24364849","chr17","24743913","24744170","12","379322"
"chr3","24408522","24408639","chr17","24789577","24789692","5","381055"
"chr3","24408668","24408815","chr17","24789719","24789866","6","381051"
"chr3","24416561","24416678","chr17","24796489","24796607","8","379928"
"chr3","24421124","24421432","chr17","24801385","24801684","12","380261"
"chr3","24427001","24427300","chr17","24807205","24807504","11","380204"
"chr3","24448657","24448968","chr17","24829303","24829615","8","380646"
"chr3","24462808","24462905","chr17","24838302","24838396","8","375494"
"chr3","24479728","24479873","chr17","24855250","24855395","4","375522"
"chr3","24496819","24496911","chr7","67134730","67134822","15","42637911"
"chr3","24503191","24503497","chr17","24874462","24874776","11","371271"
"chr3","24509437","24509538","chr17","24880806","24880907","3","371369"
"chr3","24517396","24517697","chr17","24888422","24888720","7","371026"
"chr3","24529609","24529900","chr17","24899295","24899597","28","369686"
"chr3","24549907","24550041","chr17","24922666","24922800","5","372759"
"chr3","24550329","24550495","chr17","24923089","24923281","40","372760"
"chr3","24575468","24575792","chr17","24948385","24948694","25","372917"
"chr3","24579119","24579418","chr17","24952023","24952325","8","372904"
"chr3","24595734","24596006","chr17","24968578","24968850","5","372844"
"chr3","24621024","24621337","chr17","24994257","24994561","15","373233"
"chr3","24644054","24644226","chr17","25016036","25016209","5","371982"
"chr3","24647594","24647894","chr17","25017841","25018168","40","370247"
"chr3","24651651","24651945","chr17","25021879","25022182","19","370228"
"chr3","24652943","24653250","chr15","21771461","21771764","60","2881482"
"chr3","24683394","24683445","chr3","37074202","37074250","12","12390808"
"chr3","24692717","24693003","chr16","21320831","21321123","51","3371886"
"chr3","24723946","24724257","chr17","25092911","25093223","14","368965"
"chr3","24788658","24788870","chr17","25154549","25154758","9","365891"
"chr3","24867228","24867520","chr17","25234412","25234704","3","367184"
"chr3","24907176","24907243","chr17","25273930","25273992","5","366754"
"chr3","25176395","25176698","chr17","25523870","25524167","11","347475"
"chr3","25178496","25178805","chr17","25526290","25526586","18","347794"
"chr3","25196606","25196919","chrX","126367430","126367732","67","101170824"
"chr3","25199310","25199581","chr3","75090733","75091011","54","49891423"
"chr3","25200217","25200508","chr1","123960326","123960623","63","98760109"
"chr3","25234314","25234576","chr17","25586594","25586856","1","352280"
"chr3","25746441","25746731","chr17","26119755","26120045","5","373314"
"chr3","25800523","25800818","chr10","7709045","7709346","59","18091478"
"chr3","25800833","25801117","chr9","60196443","60196732","58","34395610"
"chr3","25812983","25813292","chr17","26187247","26187515","51","374264"
"chr3","25851141","25851439","chr2","87065671","87065978","57","61214530"
"chr3","25861349","25861632","chr17","26238428","26238711","8","377079"
"chr3","25889236","25889525","chr17","26265902","26266190","5","376666"
"chr3","25943032","25943335","chr17","26322896","26323199","14","379864"
"chr3","25952507","25952792","chr17","26332579","26332862","7","380072"
"chr3","25968709","25968955","chr17","26349631","26349877","10","380922"
"chr3","25978103","25978402","chr17","26359420","26359735","23","381317"
"chr3","25987116","25987392","chr17","26368156","26368432","10","381040"
"chr3","26012393","26012482","chr1","156580024","156580116","20","130567631"
"chr3","26018897","26019075","chr17","26404142","26404322","12","385245"
"chr3","26048507","26048813","chr17","26434274","26434575","14","385767"
"chr3","26063301","26063453","chr17","26449096","26449248","7","385795"
"chr3","26085756","26085946","chr19","6629351","6629529","40","19456405"
"chr3","26090921","26091212","chr17","26477275","26477568","10","386354"
"chr3","26093031","26093313","chr17","26479387","26479683","19","386356"
"chr3","26101986","26102286","chr17","26488355","26488637","22","386369"
"chr3","26107273","26107590","chr2","55193417","55193721","78","29086144"
"chr3","26108464","26108764","chr17","26494794","26495094","7","386330"
"chr3","26135033","26135346","chr17","26521194","26521502","17","386161"
"chr3","26171616","26171915","chr17","26558277","26558575","11","386661"
"chr3","26184641","26184948","chr13","127123568","127123870","52","100938927"
"chr3","26197146","26197269","chr16","44193446","44193572","21","17996300"
"chr3","26307538","26307835","chr16","67297379","67297666","58","40989841"
"chr3","26325432","26325580","chr17","26715617","26715766","2","390185"
"chr3","26378520","26378809","chr17","26763424","26763712","13","384904"
"chr3","26398019","26398317","chr17","26782904","26783203","5","384885"
"chr3","26416105","26416403","chr15","35211025","35211313","58","8794920"
"chr3","26421577","26421879","chr17","26806766","26807065","9","385189"
"chr3","26439258","26439550","chr17","26824228","26824517","15","384970"
"chr3","26442871","26443174","chr17","26827850","26828152","9","384979"
"chr3","26483810","26484068","chr17","26869231","26869511","31","385421"
"chr3","26499547","26499854","chr14","44332085","44332382","64","17832538"
"chr3","26529945","26530152","chr17","26915705","26915912","10","385760"
"chr3","26530715","26530766","chr17","26916505","26916556","1","385790"
"chr3","26532038","26532343","chr17","26917685","26917989","16","385647"
"chr3","26585139","26585432","chr17","26970455","26970748","4","385316"
"chr3","26609012","26609107","chr17","26994388","26994483","1","385376"
"chr3","26615945","26616101","chr6","162057264","162057420","37","135441319"
"chr3","26620533","26620692","chr17","27005847","27006006","1","385314"
"chr3","26722942","26723260","chr17","27107227","27107543","13","384285"
"chr3","26736339","26736630","chr17","27121224","27121514","6","384885"
"chr3","26813803","26814061","chr17","27199378","27199637","7","385575"
"chr3","26854406","26854704","chr17","27241046","27241344","5","386640"
"chr3","26861101","26861437","chr12","30018870","30019196","58","3157769"
"chr3","26864903","26865183","chr20","20986986","20987269","53","5877917"
"chr3","26917932","26918213","chr17","27306073","27306356","9","388141"
"chr3","26918873","26919185","chr17","27307021","27307333","7","388148"
"chr3","26922331","26922418","chr17","27310475","27310562","1","388144"
"chr3","26939749","26940026","chr17","27327680","27327957","5","387931"
"chr3","26964124","26964414","chr17","27351477","27351767","14","387353"
"chr3","26964587","26964892","chr17","27351938","27352243","12","387351"
"chr3","26987036","26987370","chr4","151042390","151042695","81","124055354"
"chr3","27026428","27026720","chr17","27412790","27413082","6","386362"
"chr3","27080471","27080766","chr17","27466356","27466664","18","385885"
"chr3","27091743","27092044","chr17","27477645","27477946","2","385902"
"chr3","27105358","27105633","chr17","27491286","27491561","6","385928"
"chr3","27106312","27106603","chr17","27492240","27492535","13","385928"
"chr3","27108853","27109169","chr17","27494792","27495105","12","385939"
"chr3","27112078","27112375","chr17","27498336","27498633","5","386258"
"chr3","27133106","27133395","chr17","27518670","27518986","28","385564"
"chr3","27133440","27133450","chr8","69920436","69920446","1","42786996"
"chr3","27140837","27141137","chr17","27526369","27526662","13","385532"
"chr3","27142779","27143079","chr17","27528295","27528594","9","385516"
"chr3","27145063","27145361","chr17","27530575","27530882","19","385512"
"chr3","27180087","27180373","chr17","27567262","27567566","22","387175"
"chr3","27188347","27188633","chr17","27575264","27575552","5","386917"
"chr3","27194929","27195194","chr17","27581818","27582037","51","386889"
"chr3","27200276","27200456","chr17","27587494","27587674","3","387218"
"chr3","27205754","27206051","chr17","27593006","27593308","9","387252"
"chr3","27208124","27208444","chr17","27595365","27595666","25","387241"
"chr3","27217706","27218001","chr17","27607237","27607500","46","389531"
"chr3","27219581","27219868","chr17","27609130","27609420","23","389549"
"chr3","27232364","27232676","chr17","27622026","27622338","11","389662"
"chr3","27233332","27233625","chr17","27622985","27623280","8","389653"
"chr3","27243497","27243789","chr17","27633462","27633754","7","389965"
"chr3","27281892","27282161","chr17","27672355","27672620","8","390463"
"chr3","27308717","27308799","chr17","27699103","27699183","2","390386"
"chr3","27318228","27318378","chr1","54839106","54839253","30","27520878"
"chr3","27318380","27318444","chr17","4049071","4049135","10","23269309"
"chr3","27320590","27320890","chr17","27711876","27712177","7","391286"
"chr3","27331078","27331303","chr17","27722284","27722506","7","391206"
"chr3","27339178","27339446","chr17","27730331","27730598","9","391153"
"chr3","27343918","27344192","chr9","90524786","90525060","57","63180868"
"chr3","27348936","27349232","chr17","27739597","27739893","18","390661"
"chr3","27352326","27352614","chr17","27742996","27743284","9","390670"
"chr3","27356435","27356709","chr17","27747112","27747389","11","390677"
"chr3","27379435","27379583","chr2","87632472","87632616","30","60253037"
"chr3","27379588","27379658","chr6","61755949","61756015","16","34376361"
"chr3","27383790","27384077","chr17","27773919","27774206","10","390129"
"chr3","27386367","27386668","chr17","27776528","27776833","10","390161"
"chr3","27391325","27391563","chr17","27781811","27782049","4","390486"
"chr3","27393297","27393594","chr17","27784097","27784394","11","390800"
"chr3","27394955","27395257","chr17","27786073","27786373","8","391118"
"chr3","27396439","27396734","chr17","27787558","27787856","12","391119"
"chr3","27411743","27412030","chr17","27802082","27802369","5","390339"
"chr3","27421338","27421633","chr15","13558721","13559012","49","13862617"
"chr3","27424152","27424457","chr11","27134052","27134352","53","290100"
"chr3","27429855","27430148","chr17","27814490","27814782","8","384635"
"chr3","27436442","27436714","chr3","87956224","87956498","55","60519782"
"chr3","27459474","27459772","chr17","27843916","27844215","6","384442"
"chr3","27469507","27469787","chr17","27854216","27854497","6","384709"
"chr3","27471687","27471976","chr17","27856402","27856701","18","384715"
"chr3","27484079","27484326","chr17","27868831","27869083","11","384752"
"chr3","27488729","27488866","chr17","27873439","27873576","1","384710"
"chr3","27489188","27489383","chr17","27873899","27874094","4","384711"
"chr3","27500306","27500601","chr17","27885005","27885301","7","384699"
"chr3","27509654","27509965","chr17","27893383","27893692","6","383729"
"chr3","27511130","27511431","chr17","27894851","27895152","8","383721"
"chr3","27515988","27516196","chr17","27899738","27899946","4","383750"
"chr3","27517100","27517410","chr17","27900856","27901154","22","383756"
"chr3","27521799","27522069","chr17","27905544","27905813","8","383745"
"chr3","27531449","27531651","chr17","27914717","27914921","13","383268"
"chr3","27531964","27532106","chr17","27915234","27915376","0","383270"
"chr3","27539539","27539751","chr20","21389810","21390025","46","6149729"
"chr3","27539873","27539935","chr10","28919113","28919173","10","1379240"
"chr3","27544068","27544345","chr17","27927826","27928104","8","383758"
"chr3","27546035","27546202","chr17","27929797","27929964","9","383762"
"chr3","27548043","27548317","chr17","27931848","27932120","7","383805"
"chr3","27552441","27552740","chr17","27937394","27937706","19","384953"
"chr3","27558820","27559134","chr17","27943824","27944135","10","385004"
"chr3","27569505","27569807","chr17","27954813","27955114","10","385308"
"chr3","27571414","27571718","chr17","27956725","27957032","10","385311"
"chr3","27573766","27573966","chr14","55572254","55572463","48","27998488"
"chr3","27574441","27574731","chr17","27959582","27959872","13","385141"
"chr3","27578000","27578296","chr17","27963103","27963397","8","385103"
"chr3","27595856","27596078","chr17","27982065","27982277","16","386209"
"chr3","27639308","27639595","chr17","28024692","28024975","7","385384"
"chr3","27645265","27645603","chr3","171607028","171607345","83","143961763"
"chr3","27664102","27664386","chr17","28049094","28049369","19","384992"
"chr3","27669344","27669616","chr17","28054594","28054873","10","385250"
"chr3","27674670","27674957","chr17","28059935","28060220","8","385265"
"chr3","27689138","27689294","chr17","28074691","28074854","10","385553"
"chr3","27691595","27691879","chr17","28077156","28077451","17","385561"
"chr3","27700476","27700752","chr17","28086382","28086658","6","385906"
"chr3","27706796","27707078","chr17","28092386","28092668","3","385590"
"chr3","27743453","27743732","chr17","28127606","28127920","41","384153"
"chr3","27746921","27747169","chr17","28131072","28131322","22","384151"
"chr3","27771892","27772208","chr17","28155755","28156076","17","383863"
"chr3","27775888","27776159","chr17","28159749","28160030","15","383861"
"chr3","27811024","27811334","chr1","47655992","47656304","66","19844968"
"chr3","27818399","27818676","chr17","28197254","28197531","8","378855"
"chr3","27818985","27819276","chr17","28197840","28198141","16","378855"
"chr3","27825528","27825777","chr17","28204362","28204612","3","378834"
"chr3","27842966","27843166","chr17","28225179","28225408","30","382213"
"chr3","27846737","27847001","chr17","28229094","28229358","5","382357"
"chr3","27855625","27855689","chr5","20311447","20311509","9","7544178"
"chr3","27855690","27855815","chr10","30484458","30484572","28","2628768"
"chr3","27884247","27884539","chr17","28266164","28266465","14","381917"
"chr3","27885295","27885553","chr17","28267216","28267468","11","381921"
"chr3","27888726","27888965","chr17","28270661","28270902","8","381935"
"chr3","27903595","27903893","chr17","28286599","28286893","6","383004"
"chr3","27907177","27907459","chr17","28290035","28290315","7","382858"
"chr3","27916934","27917231","chr17","28299771","28300055","18","382837"
"chr3","27921013","27921288","chr17","28304200","28304482","11","383187"
"chr3","27922253","27922562","chr17","28305440","28305745","8","383187"
"chr3","28011800","28012100","chr17","28391676","28391973","9","379876"
"chr3","28012491","28012790","chr17","28392364","28392614","50","379873"
"chr3","28014332","28014634","chr17","28394178","28394468","21","379846"
"chr3","28021183","28021360","chr13","89301427","89301603","37","61280244"
"chr3","28050305","28050534","chr17","28431539","28431756","17","381234"
"chr3","28051667","28051960","chr17","28432888","28433179","13","381221"
"chr3","28088479","28088765","chr17","28470080","28470397","41","381601"
"chr3","28107418","28107723","chr17","28488782","28489082","26","381364"
"chr3","28122299","28122615","chr17","28503671","28503986","2","381372"
"chr3","28122846","28123060","chr17","28504217","28504444","15","381371"
"chr3","28243888","28244198","chr17","28632536","28632819","35","388648"
"chr3","28339269","28339576","chr17","28728206","28728514","2","388937"
"chr3","28347341","28347661","chr17","28735189","28735485","34","387848"
"chr3","28596761","28597059","chr17","28977823","28978130","14","381062"
"chr3","28766445","28766576","chr17","29153555","29153711","28","387110"
"chr3","28819571","28819874","chr17","29205041","29205352","15","385470"
"chr3","28909551","28909729","chr14","67129250","67129427","33","38219699"
"chr3","28909765","28909881","chr7","79775901","79776016","24","50866136"
"chr3","28917969","28918257","chr17","29308743","29309035","15","390774"
"chr3","29005861","29006165","chr17","29397326","29397630","5","391465"
"chr3","29104126","29104412","chr17","29497755","29498041","3","393629"
"chr3","29168792","29169097","chr17","29562581","29562886","13","393789"
"chr3","29175846","29176156","chr17","29566857","29567166","13","391011"
"chr3","29360585","29360898","chr17","29752378","29752689","17","391793"
"chr3","29402952","29403182","chr17","29793971","29794200","4","391019"
"chr3","29432268","29432576","chr17","29823304","29823616","13","391036"
"chr3","29433072","29433164","chr17","29824112","29824199","5","391040"
"chr3","29457751","29458055","chr17","29848794","29849102","8","391043"
"chr3","29514338","29514649","chr17","29900508","29900809","18","386170"
"chr3","29525574","29525885","chr17","29912454","29912783","26","386880"
"chr3","29576169","29576475","chr17","29963177","29963479","22","387008"
"chr3","29606707","29607004","chr17","29995093","29995387","8","388386"
"chr3","29628496","29628799","chr17","30017134","30017438","5","388638"
"chr3","29702481","29702772","chr17","30093084","30093379","9","390603"
"chr3","29734606","29734890","chr12","85753913","85754188","53","56019307"
"chr3","29743615","29743908","chr17","30134731","30135021","10","391116"
"chr3","29803469","29803765","chr17","30195627","30195942","29","392158"
"chr3","29807188","29807289","chr17","30199349","30199449","4","392161"
"chr3","29876838","29877145","chr17","30268832","30269144","15","391994"
"chr3","29885374","29885702","chr7","65130365","65130679","69","35244991"
"chr3","29885885","29886156","chr17","30277877","30278147","12","391992"
"chr3","29891647","29891941","chrX","38833115","38833403","59","8941468"
"chr3","29906657","29906952","chr17","30295795","30296090","9","389138"
"chr3","29921719","29921889","chr2","22959584","22959744","38","6962135"
"chr3","29921928","29922058","chr12","93236996","93237120","22","63315068"
"chr3","29933794","29934039","chr17","30324217","30324461","21","390423"
"chr3","29935571","29935704","chr17","30325994","30326117","15","390423"
"chr3","29980862","29981078","chr17","30369240","30369455","11","388378"
"chr3","29983410","29983478","chr4","43213703","43213773","15","13230293"
"chr3","29987343","29987632","chr17","30375940","30376227","15","388597"
"chr3","30000973","30001278","chrX","3475214","3475508","58","26525759"
"chr3","30025261","30025535","chr17","30415106","30415373","18","389845"
"chr3","30049103","30049387","chr17","30439209","30439492","8","390106"
"chr3","30088208","30088515","chr17","30639284","30639584","25","551076"
"chr3","30095634","30095926","chr4","18851551","18851849","66","11244083"
"chr3","30111539","30111656","chr13","118552882","118552999","31","88441343"
"chr3","30150755","30150772","chr1","34301008","34301023","5","4150253"
"chr3","30150800","30150943","chr17","30576532","30576704","30","425732"
"chr3","30151186","30151325","chr17","30576165","30576304","4","424979"
"chr3","30151576","30151709","chr3","40555344","40555474","26","10403768"
"chr3","30161004","30161263","chr17","30566229","30566489","6","405225"
"chr3","30167944","30168245","chr17","30559289","30559583","12","391345"
"chr3","30169286","30169595","chr17","30557932","30558241","6","388646"
"chr3","30209105","30209369","chr17","30530679","30530941","10","321574"
"chr3","30239060","30239341","chr17","30673734","30673995","27","434674"
"chr3","30239343","30239390","chr1","197359373","197359422","9","167120030"
"chr3","30241970","30242258","chr7","143970611","143970906","67","113728641"
"chr3","30315452","30315744","chr17","1511626","1511922","46","28803826"
"chr3","30318046","30318348","JH680688","17480","17784","13","30300566"
"chr3","30357911","30358076","chr17","30687011","30687177","5","329100"
"chr3","30384900","30385158","chr17","30713427","30713680","11","328527"
"chr3","30390374","30390692","chr17","30719413","30719734","13","329039"
"chr3","30404386","30404699","chr17","30734061","30734381","14","329675"
"chr3","30408136","30408426","chr17","30737830","30738121","10","329694"
"chr3","30412086","30412336","chr17","30741802","30742051","9","329716"
"chr3","30423217","30423529","chr7","13197540","13197849","60","17225677"
"chr3","30435843","30436014","chr17","30764719","30764890","3","328876"
"chr3","30444086","30444377","chr17","30772973","30773257","15","328887"
"chr3","30447270","30447587","chr17","30776002","30776319","4","328732"
"chr3","30454046","30454271","chr17","30782788","30783028","22","328742"
"chr3","30532628","30532902","chrX","61029506","61029778","51","30496878"
"chr3","30566423","30566721","chr17","30897193","30897475","20","330770"
"chr3","30576199","30576499","chr17","30907645","30907944","3","331446"
"chr3","30577585","30577637","chr2","101076980","101077026","13","70499395"
"chr3","30589511","30589635","chr11","111931690","111931822","31","81342179"
"chr3","30623510","30623809","chr17","30967032","30967335","10","343522"
"chr3","30635046","30635211","chr5","103650142","103650309","48","73015096"
"chr3","30635252","30635538","chr17","30968176","30968462","8","332924"
"chr3","30657545","30657844","chr17","30990926","30991226","9","333381"
"chr3","30687848","30688120","chr17","31020958","31021230","9","333110"
"chr3","30697245","30697557","chr17","31030319","31030631","6","333074"
"chr3","30729347","30729607","chr17","31062651","31062916","9","333304"
"chr3","30786635","30786946","chr17","31121113","31121424","5","334478"
"chr3","30818702","30818993","chr20","24878799","24879080","61","5939903"
"chr3","30868022","30868334","chr17","31203703","31203993","30","335681"
"chr3","30908281","30908461","chr17","31244433","31244612","10","336152"
"chr3","30962406","30962697","chr17","31302062","31302355","4","339656"
"chr3","30977940","30978171","chr5","49761189","49761424","70","18783249"
"chr3","31021886","31022168","chr17","31359738","31360020","5","337852"
"chr3","31147625","31147934","chr17","31504352","31504645","19","356727"
"chr3","31210275","31210576","chr17","31572583","31572883","61","362308"
"chr3","31367410","31367708","chr17","31735234","31735532","8","367824"
"chr3","31383663","31383967","chr17","31750927","31751229","10","367264"
"chr3","31478140","31478448","chr3","36984237","36984550","69","5506097"
"chr3","31597353","31597635","chr17","31986701","31987007","43","389348"
"chr3","31605861","31606015","chr17","32000688","32000836","11","394827"
"chr3","31606374","31606518","chr2","89860282","89860410","53","58253908"
"chr3","31637660","31637965","chr17","32032743","32033048","4","395083"
"chr3","31766817","31767102","chr17","32166893","32167178","2","400076"
"chr3","31785261","31785532","chr10","38038057","38038338","72","6252796"
"chr3","31851094","31851414","chr17","32240905","32241226","14","389811"
"chr3","31856593","31856766","chr17","32246359","32246532","4","389766"
"chr3","31877929","31878209","chr17","32267304","32267582","11","389375"
"chr3","31904821","31905106","chr17","32295228","32295513","11","390407"
"chr3","31921640","31921827","chrX","80144837","80145020","58","48223197"
"chr3","31973643","31973889","chr17","32362357","32362603","4","388714"
"chr3","32135391","32135690","chr17","32520749","32521043","12","385358"
"chr3","32202564","32202780","chr17","32587518","32587735","13","384954"
"chr3","32266447","32266715","chr17","32657087","32657355","10","390640"
"chr3","32278765","32279069","chr17","32669374","32669670","20","390609"
"chr3","32315168","32315461","chr17","32705565","32705858","7","390397"
"chr3","32341255","32341553","chrX","17134244","17134545","57","15207011"
"chr3","32383250","32383492","chr17","32776255","32776516","29","393005"
"chr3","32391833","32392137","chr17","32784863","32785168","9","393030"
"chr3","32434646","32434915","chr17","32827733","32828015","23","393087"
"chr3","32504545","32504825","chr17","32897550","32897830","12","393005"
"chr3","32561953","32562216","chr17","32955889","32956152","10","393936"
"chr3","32611337","32611633","chr17","33004332","33004623","15","392995"
"chr3","32641296","32641596","chr17","33033265","33033577","25","391969"
"chr3","32678710","32678921","chr17","33070661","33070869","10","391951"
"chr3","32680590","32680890","chr17","33072547","33072847","12","391957"
"chr3","32703114","32703241","chr4","43561239","43561356","25","10858125"
"chr3","32706071","32706363","chr17","33097483","33097774","8","391412"
"chr3","32740890","32741031","chr8","52169372","52169506","36","19428482"
"chr3","32741058","32741177","chr3","43744134","43744254","21","11003076"
"chr3","32789186","32789462","chr17","33182510","33182787","7","393324"
"chr3","32804178","32804457","chr17","33197193","33197482","23","393015"
"chr3","32873659","32873680","chr9","15522850","15522870","4","17350809"
"chr3","32873724","32873978","chr17","33263656","33263910","15","389932"
"chr3","32881820","32882125","chr17","33272081","33272384","8","390261"
"chr3","33439163","33439450","chr17","33841699","33841999","21","402536"
"chr3","33442281","33442378","chr17","33844509","33844628","26","402228"
"chr3","33442721","33442904","chr17","33844971","33845153","14","402250"
"chr3","33452412","33452702","chr17","33854676","33854965","8","402264"
"chr3","33501024","33501312","chr17","33905165","33905457","10","404141"
"chr3","33916930","33917224","chr17","34338519","34338816","15","421589"
"chr3","34124808","34124924","chr17","34577536","34577652","6","452728"
"chr3","34146744","34146887","chr17","34600120","34600263","3","453376"
"chr3","34329824","34329952","chr17","34784159","34784284","8","454335"
"chr3","34403018","34403267","chrX","44384086","44384335","54","9981068"
"chr3","34403301","34403488","chr17","34852331","34852518","3","449030"
"chr3","34493965","34494095","chr17","34946433","34946561","6","452468"
"chr3","34621094","34621205","chr16","22083558","22083667","31","12537536"
"chr3","34634580","34634790","chr17","35085427","35085640","6","450847"
"chr3","34684350","34684648","chr17","35139626","35139929","29","455276"
"chr3","34688693","34688864","chr17","35143915","35144086","4","455222"
"chr3","34690603","34690879","chr17","35145716","35145988","9","455113"
"chr3","34754927","34755090","chr17","35208393","35208556","9","453466"
"chr3","34862754","34862857","chr8","29781196","29781299","28","5081558"
"chr3","34894511","34894642","chr19","41813759","41813892","34","6919248"
"chr3","34894670","34894786","chr14","105103750","105103867","17","70209080"
"chr3","34908144","34908272","chr6","5925900","5926025","33","28982244"
"chr3","34912318","34912399","chr17","35353595","35353676","1","441277"
"chr3","34946193","34946509","chr19","14279214","14279537","79","20666979"
"chr3","34977740","34977921","chr17","35419357","35419538","8","441617"
"chr3","35220045","35220343","chr17","35664830","35665134","16","444785"
"chr3","35356258","35356570","chr17","35805344","35805642","37","449086"
"chr3","35410774","35411078","chr17","35861832","35862136","4","451058"
"chr3","35452949","35453248","chr17","35903736","35904037","9","450787"
"chr3","35454799","35455099","chr17","35908151","35908451","11","453352"
"chr3","35539750","35540033","chr17","35993588","35993884","25","453838"
"chr3","35565515","35565830","chr17","36018588","36018903","12","453073"
"chr3","35579939","35580241","chr17","36033014","36033317","5","453075"
"chr3","35661012","35661305","chr17","36122041","36122338","16","461029"
"chr3","35723605","35723889","chr17","36187333","36187622","22","463728"
"chr3","35748929","35749029","chr17","36212715","36212815","2","463786"
"chr3","35749466","35749578","chr17","36213252","36213364","2","463786"
"chr3","35792136","35792222","chr17","36256566","36256647","8","464430"
"chr3","35811230","35811357","chr17","36271672","36271800","5","460442"
"chr3","35812095","35812326","chr17","36272522","36272765","21","460427"
"chr3","36130449","36130746","chr17","36589578","36589886","19","459129"
"chr3","36179777","36180039","chr17","36638837","36639099","7","459060"
"chr3","36199588","36199935","chr17","36662201","36662546","9","462613"
"chr3","36268573","36268777","chr17","36729925","36730171","44","461352"
"chr3","36360217","36360354","chr2","87101974","87102112","24","50741757"
"chr3","36414287","36414584","chr17","36880852","36881144","13","466565"
"chr3","36416029","36416045","chr12","83941902","83941919","1","47525873"
"chr3","36416081","36416373","chr17","23090845","23091130","66","13325236"
"chr3","36436036","36436323","chr17","36902810","36903103","14","466774"
"chr3","36499275","36499480","chr17","36965401","36965626","28","466126"
"chr3","36501083","36501309","chr17","36965401","36965626","7","464318"
"chr3","36550610","36550735","chr17","37014924","37015049","2","464314"
"chr3","36579362","36579591","chr17","37043312","37043522","26","463950"
"chr3","36634664","36634974","chr17","37095161","37095466","13","460497"
"chr3","36668778","36669052","chr6","128282524","128282800","58","91613746"
"chr3","36709811","36710055","chr17","37183379","37183623","19","473568"
"chr3","36754645","36754932","chr17","37229678","37229965","21","475033"
"chr3","36802023","36802314","chr17","37276733","37277025","10","474710"
"chr3","36871530","36871797","chr17","37348202","37348469","6","476672"
"chr3","36884427","36884688","chr17","37361092","37361353","13","476665"
"chr3","36956391","36956665","chr17","37432940","37433217","11","476549"
"chr3","36959645","36959923","chr17","37436173","37436451","4","476528"
"chr3","36973267","36973547","chr17","37450595","37450870","15","477328"
"chr3","37000716","37001025","chr17","37477628","37477938","10","476912"
"chr3","37005595","37005895","chrX","96719817","96720114","56","59714222"
"chr3","37187145","37187420","chr17","37675723","37675997","12","488578"
"chr3","37238787","37239085","chr17","37727539","37727837","10","488752"
"chr3","37285976","37286277","chr17","37773736","37774042","17","487760"
"chr3","37312632","37312782","chr17","37800374","37800498","27","487742"
"chr3","37318493","37318752","chr17","37806231","37806487","10","487738"
"chr3","37394769","37395070","chr17","37881915","37882216","3","487146"
"chr3","37471522","37471821","chr17","37958851","37959150","3","487329"
"chr3","37519061","37519169","chr17","38005076","38005196","13","486015"
"chr3","37521707","37522001","chr12","94071413","94071704","54","56549706"
"chr3","37531657","37531911","chr17","38017766","38018020","10","486109"
"chr3","37542297","37542591","chr17","38028426","38028728","16","486129"
"chr3","37599355","37599500","chr17","38085540","38085687","3","486185"
"chr3","37807162","37807439","chr17","38296985","38297262","5","489823"
"chr3","37878811","37879049","chr17","38369593","38369831","5","490782"
"chr3","37911975","37912166","chr17","38402748","38402929","11","490773"
"chr3","37936583","37936883","chr17","38427188","38427470","26","490605"
"chr3","37937120","37937418","chr17","38427720","38428017","3","490600"
"chr3","37972252","37972536","chr17","38462437","38462721","10","490185"
"chr3","37972608","37972911","chr17","38462793","38463096","10","490185"
"chr3","37995607","37995875","chr17","38485581","38485859","20","489974"
"chr3","38018466","38018804","chr17","38508425","38508731","40","489959"
"chr3","38062932","38063227","chr17","38559313","38559607","7","496381"
"chr3","38117042","38117361","chr17","38613362","38613681","12","496320"
"chr3","38165721","38166012","chr17","38663072","38663363","6","497351"
"chr3","38211690","38211985","chr17","38707553","38707844","8","495863"
"chr3","38234442","38234740","chr17","38733738","38734027","15","499296"
"chr3","38322656","38322956","chr17","38824985","38825285","2","502329"
"chr3","38356715","38357019","chr17","38860755","38861059","5","504040"
"chr3","38367549","38367819","chr15","40244211","40244472","81","1876662"
"chr3","38368296","38368604","chrX","86432545","86432851","53","48064249"
"chr3","38504173","38504450","chr17","39014903","39015180","3","510730"
"chr3","38599523","38599833","chr17","39114282","39114594","17","514759"
"chr3","38599971","38600244","chr1","185089625","185089886","73","146489654"
"chr3","38608236","38608562","chr17","39122593","39122904","38","514357"
"chr3","38635883","38636180","chr17","39149903","39150200","6","514020"
"chr3","38706098","38706260","chr17","39219514","39219678","2","513416"
"chr3","38780748","38781039","chr17","39295142","39295433","10","514394"
"chr3","38856157","38856484","chr17","39375810","39376133","22","519653"
"chr3","38874535","38874757","chr17","39396414","39396628","11","521879"
"chr3","38909288","38909565","chr17","39431041","39431319","9","521753"
"chr3","38913277","38913398","chr17","39435565","39435681","13","522288"
"chr3","38913425","38913552","chr17","39435712","39435832","10","522287"
"chr3","38937764","38937989","chr17","39459319","39459553","12","521555"
"chr3","39087451","39087618","chr17","39612893","39613068","14","525442"
"chr3","39145702","39145926","chr17","39701133","39701373","44","555431"
"chr3","39232943","39233216","chr17","39797311","39797584","9","564368"
"chr3","39277854","39278151","chr11","130022674","130022966","98","90744820"
"chr3","39474504","39474625","chr17","40042464","40042585","1","567960"
"chr3","39474657","39474814","chr17","40042613","40042769","4","567956"
"chr3","39649316","39649554","chr20","49548475","49548699","54","9899159"
"chr3","39801887","39801998","JH680385","22245","22367","17","39779642"
"chr3","39958938","39959222","chr9","95117184","95117463","79","55158246"
"chr3","40088094","40088316","chr17","40299649","40299869","6","211555"
"chr3","40098876","40099150","chr11","46980616","46980885","65","6881740"
"chr3","40163292","40163465","chr17","40362641","40362814","6","199349"
"chr3","40166740","40166832","chr4","146141693","146141785","25","105974953"
"chr3","40249622","40249919","chr17","40453513","40453808","6","203891"
"chr3","40383699","40383873","JH680761","4439","4611","4","40379260"
"chr3","40383903","40384018","JH680761","4633","4748","6","40379270"
"chr3","40640923","40641221","chr17","40806723","40807001","22","165800"
"chr3","40726144","40726370","chr17","40897079","40897308","10","170935"
"chr3","41073225","41073375","chr16","42414724","42414874","31","1341499"
"chr3","41073402","41073520","chr2","136376620","136376738","17","95303218"
"chr3","41123987","41124297","chr1","54547550","54547855","62","13423563"
"chr3","41204824","41204956","JH681437","1009","1141","4","41203815"
"chr3","41330287","41330594","chr17","41483652","41483956","14","153365"
"chr3","41344293","41344593","chr3","52144875","52145171","57","10800582"
"chr3","41388283","41388600","chr17","41558316","41558661","37","170033"
"chr3","41402131","41402477","chr17","41570430","41570728","54","168299"
"chr3","41457661","41457818","chr17","41631605","41631761","2","173944"
"chr3","41457819","41457895","chr16","6545373","6545453","20","34912446"
"chr3","41519188","41519394","chr17","41740052","41740263","12","220864"
"chr3","41539124","41539243","chr1","139358754","139358864","40","97819630"
"chr3","41622722","41623037","chr17","41837505","41837817","16","214783"
"chr3","41662050","41662361","chr17","41877434","41877766","30","215384"
"chr3","41662376","41662683","chr17","41877782","41878101","23","215406"
"chr3","41706312","41706396","chr17","41919656","41919740","2","213344"
"chr3","41939071","41939362","chr17","42355311","42355603","4","416240"
"chr3","41953077","41953368","chr17","42369780","42370071","5","416703"
"chr3","41983814","41984136","chr17","42411603","42411925","22","427789"
"chr3","42194858","42194958","chr17","42640150","42640246","6","445292"
"chr3","42206128","42206397","chr17","42626374","42626643","8","420246"
"chr3","42292389","42292700","chr2","167799189","167799489","61","125506800"
"chr3","42326357","42326632","chr17","42768110","42768386","6","441753"
"chr3","42470948","42471198","chr17","42916159","42916409","4","445211"
"chr3","42574166","42574415","chr9","92260138","92260387","64","49685972"
"chr3","42638067","42638368","chr17","43083260","43083561","5","445193"
"chr3","42716192","42716476","chr17","43440521","43440800","19","724329"
"chr3","42836739","42837061","chr5","71999233","71999543","89","29162494"
"chr3","43041125","43041428","chr17","43494482","43494787","6","453357"
"chr3","43070921","43071235","chr17","43525017","43525323","13","454096"
"chr3","43123736","43123971","JH680923","12209","12444","6","43111527"
"chr3","43162012","43162337","chr17","43575489","43575800","27","413477"
"chr3","43312979","43313261","chr17","43718276","43718550","16","405297"
"chr3","44556597","44556892","chr17","43884989","43885291","13","671608"
"chr3","44643841","44644135","chr17","43980724","43981018","5","663117"
"chr3","44848102","44848191","chr17","44185261","44185350","4","662841"
"chr3","44888387","44888661","chr17","44228819","44229074","40","659568"
"chr3","44894135","44894394","chr17","44234910","44235225","59","659225"
"chr3","44897604","44897735","chr20","49090292","49090429","26","4192688"
"chr3","44897797","44897948","chr11","45671909","45672068","31","774112"
"chr3","44899542","44899853","chr17","44242038","44242346","16","657504"
"chr3","44971127","44971233","chr17","44313541","44313647","1","657586"
"chr3","45120349","45120634","chr17","44467263","44467539","39","653086"
"chr3","45248917","45249216","chr17","44606139","44606432","13","642778"
"chr3","45266819","45267059","chr17","44624014","44624253","8","642805"
"chr3","45293887","45294123","chr9","15427057","15427290","55","29866830"
"chr3","45362726","45362875","chr9","86631758","86631910","28","41269032"
"chr3","45362906","45362971","chr5","10510658","10510711","18","34852248"
"chr3","45370646","45370890","chr17","44734054","44734302","7","636592"
"chr3","45438444","45438730","chr17","44801074","44801359","8","637370"
"chr3","45452206","45452515","chr17","44814876","44815209","35","637330"
"chr3","45455331","45455617","chr17","44818061","44818347","9","637270"
"chr3","45478126","45478424","chr17","44840886","44841182","12","637240"
"chr3","45487237","45487291","chr17","44850164","44850219","1","637073"
"chr3","45506990","45507292","chr17","44870179","44870484","12","636811"
"chr3","45516470","45516596","chr17","44879644","44879770","4","636826"
"chr3","45535322","45535535","chr17","44899877","44900096","7","635445"
"chr3","45550857","45551113","chr17","44914673","44914957","33","636184"
"chr3","45562077","45562211","chr17","44926283","44926417","0","635794"
"chr3","45616576","45616756","chr7","59401852","59402031","38","13785276"
"chr3","45616787","45616904","chr3","88036795","88036911","19","42420008"
"chr3","45665098","45665407","chr17","45031100","45031409","5","633998"
"chr3","45709267","45709526","chr17","45075586","45075841","16","633681"
"chr3","45769388","45769695","chr17","45144626","45144932","10","624762"
"chr3","45825213","45825399","chr17","45200813","45201015","17","624400"
"chr3","45839472","45839829","chr17","45215288","45215604","49","624184"
"chr3","45848497","45848811","chr17","45215288","45215604","11","633209"
"chr3","45898127","45898412","chr17","45264367","45264652","5","633760"
"chr3","45997119","45997426","chr17","45364389","45364696","9","632730"
"chr3","46022044","46022158","chr9","88436818","88436931","19","42414774"
"chr3","46063338","46063686","chr17","45430194","45430490","59","633144"
"chr3","46079141","46079354","chr17","45445921","45446134","4","633220"
"chr3","46119706","46120018","chr17","45486481","45486780","20","633225"
"chr3","46120722","46121007","chr17","45487485","45487770","8","633237"
"chr3","46139101","46139379","chr17","45505419","45505694","8","633682"
"chr3","46148719","46149007","chr17","45515000","45515289","6","633719"
"chr3","46463254","46463420","chr17","45848996","45849162","2","614258"
"chr3","46468152","46468446","chr9","94574568","94574863","55","48106416"
"chr3","46498517","46498795","chr17","45885697","45885977","11","612820"
"chr3","46532785","46532864","chr2","136521964","136522046","16","89989179"
"chr3","46560720","46561019","chr17","45949656","45949962","13","611064"
"chr3","46656677","46656975","chr17","46048553","46048848","6","608124"
"chr3","46841742","46842042","chr17","46236573","46236872","7","605169"
"chr3","46893661","46893957","chr17","46289816","46290100","32","603845"
"chr3","46922047","46922313","chr17","46318022","46318304","23","604025"
"chr3","47098767","47099046","chr17","46499564","46499841","9","599203"
"chr3","47136870","47136921","chr17","46538410","46538464","4","598460"
"chr3","47162690","47162936","chr17","46567935","46568178","11","594755"
"chr3","47178065","47178285","chr17","46587316","46587536","2","590749"
"chr3","47231397","47231694","chr14","30200281","30200571","70","17031116"
"chr3","47327560","47327866","chr17","46734897","46735203","9","592663"
"chr3","47346648","47346943","chr17","46754028","46754316","16","592620"
"chr3","47396394","47396645","chr17","46805756","46806007","9","590638"
"chr3","47479457","47479539","chr11","64818561","64818638","22","17339104"
"chr3","47524770","47525059","chr17","46899732","46900002","30","625038"
"chr3","47606839","47607123","chr17","46988689","46988973","14","618150"
"chr3","47851706","47851979","chr17","47237417","47237709","25","614289"
"chr3","47889390","47889529","chr10","17739746","17739885","29","30149644"
"chr3","47889577","47889651","chr2","86100383","86100457","20","38210806"
"chr3","47932088","47932220","chr6","11254105","11254238","25","36677983"
"chr3","47933411","47933495","chr1","187601134","187601209","21","139667723"
"chr3","47999176","47999486","chr1","161980323","161980624","76","113981147"
"chr3","48005321","48005483","chr7","38707944","38708096","44","9297377"
"chr3","48043924","48044213","JH681052","91958","92247","9","47951966"
"chr3","48118553","48118821","JH681052","164409","164684","14","47954144"
"chr3","48200385","48200673","JH681052","245858","246146","17","47954527"
"chr3","48290733","48291049","JH681052","334648","334964","8","47956085"
"chr3","48362442","48362791","JH681052","402841","403190","16","47959601"
"chr3","48505121","48505247","JH681052","548447","548583","11","47956674"
"chr3","48524673","48524879","JH681052","568216","568422","5","47956457"
"chr3","48758985","48759253","JH681052","783871","784125","21","47975114"
"chr3","48827836","48828146","JH681052","854368","854678","12","47973468"
"chr3","48836843","48837141","JH681052","863733","864031","4","47973110"
"chr3","49152582","49152875","chr17","47598236","47598519","22","1554346"
"chr3","49280334","49280664","chr17","47723948","47724265","22","1556386"
"chr3","49352122","49352424","chr17","47797592","47797893","6","1554530"
"chr3","49375300","49375434","chr17","47825627","47825758","6","1549673"
"chr3","49471896","49472066","chr17","47934148","47934322","10","1537748"
"chr3","49487116","49487297","chr17","47949408","47949592","8","1537708"
"chr3","49490634","49490823","chr17","47952927","47953110","33","1537707"
"chr3","49553214","49553559","chr3","148940439","148940769","93","99387225"
"chr3","49559934","49560126","chr17","48022779","48022971","5","1537155"
"chr3","49611059","49611396","chr1","31113174","31113485","104","18497885"
"chr3","49635242","49635557","chr17","48104290","48104606","21","1530952"
"chr3","49650535","49650858","chr17","48122106","48122423","30","1528429"
"chr3","49712282","49712560","chr17","48183844","48184141","31","1528438"
"chr3","49725353","49725495","chr17","48196833","48196988","16","1528520"
"chr3","49725540","49725660","chr17","48197041","48197161","1","1528499"
"chr3","49746165","49746356","chr17","48219802","48219993","2","1526363"
"chr3","49746613","49746714","chr17","48220250","48220351","4","1526363"
"chr3","49891843","49892144","chr17","48369870","48370172","8","1521973"
"chr3","49898631","49898873","chr17","48376621","48376863","5","1522010"
"chr3","49959010","49959130","chr3","55268266","55268384","23","5309256"
"chr3","49959175","49959387","chr17","48438732","48438902","47","1520443"
"chr3","49982903","49983187","chr17","48462983","48463267","7","1519920"
"chr3","50098054","50098198","chr17","48576242","48576386","2","1521812"
"chr3","50502590","50502900","chr17","49010376","49010686","8","1492214"
"chr3","50544772","50545035","chr17","49051702","49051941","27","1493070"
"chr3","50586742","50587020","chr17","49094179","49094457","1","1492563"
"chr3","50607234","50607477","chr17","49114700","49114962","27","1492534"
"chr3","50622162","50622473","chr17","49133130","49133445","9","1489032"
"chr3","50702976","50703274","chr17","49214724","49215024","13","1488252"
"chr3","50738549","50738842","chr17","49250504","49250795","9","1488045"
"chr3","50747754","50748059","chr7","25185886","25186189","69","25561868"
"chr3","50753293","50753556","chr7","73368770","73369018","60","22615477"
"chr3","50769035","50769297","chr17","49280806","49281066","9","1488229"
"chr3","50769889","50770185","chr17","49281655","49281941","13","1488234"
"chr3","50787177","50787464","chr17","49298949","49299235","10","1488228"
"chr3","50806884","50807028","chr17","49318535","49318679","3","1488349"
"chr3","50807316","50807493","chr17","49319070","49319223","26","1488246"
"chr3","50812991","50813291","chr17","49324746","49325065","24","1488245"
"chr3","50834863","50835187","chr17","49348892","49349225","17","1485971"
"chr3","50842191","50842490","chr17","49356373","49356674","14","1485818"
"chr3","50864033","50864241","chr17","49378755","49378962","7","1485278"
"chr3","50872744","50872901","chrX","16894143","16894296","41","33978601"
"chr3","50874108","50874357","chr3","36736557","36736796","62","14137551"
"chr3","50930355","50930634","chr17","49450975","49451282","34","1479380"
"chr3","50961522","50961791","chr17","49481284","49481552","10","1480238"
"chr3","51000614","51000897","chr17","49520452","49520739","10","1480162"
"chr3","51038798","51039092","chr17","49558163","49558453","14","1480635"
"chr3","51078257","51078567","chr17","49600020","49600322","19","1478237"
"chr3","51196028","51196298","chr17","49721651","49721921","3","1474377"
"chr3","51331614","51331879","chr17","49866615","49866891","22","1464999"
"chr3","51331990","51332189","chr8","5809101","5809306","64","45522889"
"chr3","51351103","51351174","chr3","149404364","149404432","13","98053261"
"chr3","51417964","51418112","chr19","2871066","2871219","32","48546898"
"chr3","51418138","51418171","chr16","16180940","16180972","4","35237198"
"chr3","51441958","51442236","chr17","49974979","49975249","13","1466979"
"chr3","51475792","51475921","chr17","50008395","50008524","0","1467397"
"chr3","51480313","51480467","chr2","95278399","95278545","42","43798086"
"chr3","51543445","51543763","chr17","50076214","50076523","14","1467231"
"chr3","51592628","51592921","chr17","50122601","50122898","13","1470027"
"chr3","51712259","51712534","chr17","50240364","50240626","16","1471895"
"chr3","51729618","51729905","chr17","50257787","50258074","6","1471831"
"chr3","51876253","51876565","chr17","50406562","50406875","9","1469691"
"chr3","51880197","51880477","chr17","50410507","50410772","20","1469690"
"chr3","51894114","51894427","chr17","50424421","50424737","13","1469693"
"chr3","51955573","51955888","chr17","50486618","50486933","15","1468955"
"chr3","51981222","51981509","chr17","50512387","50512674","6","1468835"
"chr3","52000663","52000793","chr17","50531622","50531752","0","1469041"
"chr3","52060623","52060935","chr17","50591761","50592073","6","1468862"
"chr3","52065349","52065636","chr17","50596490","50596776","9","1468859"
"chr3","52072461","52072772","chr17","50603569","50603888","16","1468892"
"chr3","52095812","52096122","chr17","50628820","50629121","13","1466992"
"chr3","52098427","52098581","chr17","50631400","50631554","1","1467027"
"chr3","52106501","52106766","chr17","50639470","50639724","19","1467031"
"chr3","52119160","52119456","chr17","50652130","50652424","12","1467030"
"chr3","52129411","52129713","chr17","50662538","50662833","13","1466873"
"chr3","52130050","52130266","chr17","50663170","50663372","17","1466880"
"chr3","52134566","52134742","chr17","50667672","50667845","5","1466894"
"chr3","52139807","52140109","chr17","50673457","50673759","8","1466350"
"chr3","52141370","52141617","chr1","30529279","30529534","73","21612091"
"chr3","52149585","52149635","chr17","50682844","50682894","1","1466741"
"chr3","52150021","52150182","chr17","50683197","50683378","25","1466824"
"chr3","52161781","52162089","chr17","50694663","50694966","7","1467118"
"chr3","52169976","52170250","chr17","50706143","50706417","5","1463833"
"chr3","52170953","52171126","chr17","50707128","50707301","3","1463825"
"chr3","52176554","52176891","chr19","50488094","50488418","93","1688460"
"chr3","52178807","52178956","chr17","50716528","50716677","3","1462279"
"chr3","52186001","52186298","chr17","50725402","50725703","8","1460599"
"chr3","52214406","52214708","chr17","50754420","50754712","14","1459986"
"chr3","52221172","52221454","chr17","50761251","50761531","9","1459921"
"chr3","52224491","52224774","chr17","50764596","50764882","7","1459895"
"chr3","52224880","52225177","chr17","50764988","50765285","8","1459892"
"chr3","52227905","52228273","chr17","50767992","50768361","17","1459913"
"chr3","52239637","52239923","chr17","50780698","50780985","7","1458939"
"chr3","52251656","52251954","chr17","50793522","50793811","21","1458134"
"chr3","52254288","52254455","chr17","50796131","50796301","20","1458157"
"chr3","52260189","52260411","chr17","50802262","50802483","4","1457927"
"chr3","52262922","52263050","chr10","49185678","49185808","31","3077244"
"chr3","52263299","52263457","chrX","21074706","21074858","34","31188593"
"chr3","52266161","52266460","chr17","50809019","50809318","6","1457142"
"chr3","52281053","52281351","chr17","50825057","50825354","9","1455996"
"chr3","52295761","52295993","chr10","17251638","17251864","50","35044123"
"chr3","52306621","52306719","chr17","50849967","50850065","1","1456654"
"chr3","52308521","52308807","chr17","50851879","50852169","9","1456642"
"chr3","52315926","52316231","chr17","50859358","50859652","17","1456568"
"chr3","52324908","52325218","chr17","50868637","50868947","12","1456271"
"chr3","52337968","52338265","chr17","50881658","50881955","10","1456310"
"chr3","52341616","52341919","chr17","50885110","50885413","3","1456506"
"chr3","52351855","52352013","chrX","61049663","61049821","40","8697808"
"chr3","52355287","52355582","chr17","50898433","50898732","11","1456854"
"chr3","52368227","52368483","chr17","50911603","50911887","42","1456624"
"chr3","52425449","52425746","chr17","50971382","50971679","14","1454067"
"chr3","52435082","52435290","chr17","50983259","50983467","5","1451823"
"chr3","52468998","52469308","chr17","51016479","51016759","38","1452519"
"chr3","52472931","52473213","chr11","113504484","113504772","56","61031553"
"chr3","52474422","52474724","chr17","51021991","51022289","26","1452431"
"chr3","52504569","52504758","chr17","51050260","51050467","21","1454309"
"chr3","52513771","52514055","chr17","51059757","51060041","4","1454014"
"chr3","52539525","52539831","chr17","51085198","51085505","2","1454327"
"chr3","52592340","52592631","chr17","51138420","51138711","7","1453920"
"chr3","52642160","52642457","chr17","51187603","51187890","24","1454557"
"chr3","52644741","52644959","chr17","51190178","51190391","14","1454563"
"chr3","52771973","52772278","chr17","51321360","51321663","8","1450613"
"chr3","52845392","52845526","chr16","22932775","22932908","20","29912617"
"chr3","52845528","52845817","chr17","51395608","51395897","21","1449920"
"chr3","52904087","52904400","chr17","51458285","51458598","10","1445802"
"chr3","52912830","52913140","chr17","51466650","51466950","22","1446180"
"chr3","52931610","52931865","chr8","9359062","9359328","65","43572548"
"chr3","52952614","52952899","chr17","51508118","51508390","17","1444496"
"chr3","53059926","53060195","chr17","51623480","51623749","8","1436446"
"chr3","53081028","53081308","chr17","51643100","51643379","4","1437928"
"chr3","53105503","53105780","chr17","51667282","51667583","31","1438221"
"chr3","53127448","53127746","chr17","51689928","51690223","10","1437520"
"chr3","53209146","53209416","chr17","51772644","51772914","6","1436502"
"chr3","53278439","53278739","chr17","51843435","51843735","5","1435004"
"chr3","53279654","53279927","chr17","51844663","51844936","8","1434991"
"chr3","53286776","53287064","chr17","51851742","51852021","13","1435034"
"chr3","53293326","53293634","chr17","51858137","51858437","23","1435189"
"chr3","53310605","53310919","chr17","51876620","51876935","14","1433985"
"chr3","53417810","53418131","chr1","110427152","110427466","60","57009342"
"chr3","53541267","53541516","chr17","52112960","52113184","32","1428307"
"chr3","53615984","53616247","chr17","52201296","52201560","8","1414688"
"chr3","53633550","53633778","chr17","52218543","52218734","44","1415007"
"chr3","53697993","53698230","chr6","58198059","58198294","48","4500066"
"chr3","53778994","53779278","chr17","52362939","52363223","10","1416055"
"chr3","53788518","53788822","chr17","52372257","52372592","38","1416261"
"chr3","53806901","53807161","chr17","52391627","52391887","10","1415274"
"chr3","53826094","53826387","chr17","52409310","52409603","6","1416784"
"chr3","53874593","53874876","chr17","52455607","52455889","7","1418986"
"chr3","53886988","53887263","chr17","52467897","52468172","7","1419091"
"chr3","53895149","53895467","chr17","52476070","52476390","19","1419079"
"chr3","53953308","53953613","chr17","52532107","52532413","6","1421201"
"chr3","53954095","53954402","chr4","32671028","32671330","65","21283067"
"chr3","53956037","53956292","chr17","52534934","52535198","14","1421103"
"chr3","53958311","53958478","chr17","52537197","52537375","15","1421114"
"chr3","53983105","53983316","chr17","52563139","52563352","12","1419966"
"chr3","53989662","53989832","chr9","88967166","88967333","39","34977504"
"chr3","53989881","53989997","chr1","197410292","197410412","25","143420411"
"chr3","54044145","54044460","chr17","52624740","52625044","17","1419405"
"chr3","54189476","54189755","chr17","52774799","52775092","18","1414677"
"chr3","54192031","54192231","chr17","52776589","52776789","3","1415442"
"chr3","54230110","54230361","chr17","52814459","52814710","4","1415651"
"chr3","54254073","54254389","chr17","52837766","52838082","6","1416307"
"chr3","54320106","54320379","chr17","52902928","52903191","23","1417178"
"chr3","54371522","54371813","chr17","52954910","52955201","8","1416612"
"chr3","54454345","54454638","chr17","53030272","53030593","44","1424073"
"chr3","54462200","54462272","chr17","53045573","53045645","2","1416627"
"chr3","54526272","54526369","chr17","53106387","53106473","13","1419885"
"chr3","54540311","54540605","chr17","53120407","53120701","3","1419904"
"chr3","54559550","54559719","chr1","23596488","23596653","37","30963062"
"chr3","54559790","54559854","chr3","119501423","119501486","13","64941633"
"chr3","54603815","54604116","chr17","53184301","53184613","21","1419514"
"chr3","54615037","54615248","chr15","6130205","6130419","40","48484832"
"chr3","54615604","54615614","chr17","72898186","72898196","1","18282582"
"chr3","54617409","54617529","chr17","53198812","53198931","3","1418597"
"chr3","54617555","54617719","chr17","53198984","53199148","5","1418571"
"chr3","54631639","54631945","chr17","53212747","53213034","34","1418892"
"chr3","54632321","54632445","chr17","53213406","53213530","3","1418915"
"chr3","54658809","54659118","chr17","53239671","53239983","15","1419138"
"chr3","54709119","54709393","chr17","53288741","53289015","5","1420378"
"chr3","54726873","54727160","chr7","125147857","125148143","51","70420984"
"chr3","54731520","54731817","chr17","53313731","53314039","22","1417789"
"chr3","54751454","54751571","chr1","19501947","19502059","23","35249507"
"chr3","54763713","54764000","chr17","53344258","53344545","10","1419455"
"chr3","54782494","54782779","chr17","53363396","53363659","30","1419098"
"chr3","54921133","54921437","chr17","53506657","53506964","17","1414476"
"chr3","54970148","54970447","chr17","53555720","53556022","11","1414428"
"chr3","54982000","54982276","chr17","53567294","53567568","11","1414706"
"chr3","54997227","54997515","chr17","53582518","53582806","6","1414709"
"chr3","55264818","55264923","chr17","53864759","53864864","0","1400059"
"chr3","55369251","55369472","chr17","53981615","53981853","20","1387636"
"chr3","55532486","55532508","chr3","50813734","50813755","7","4718752"
"chr3","55533960","55534034","chr6","8905671","8905741","15","46628289"
"chr3","55604970","55605235","chr17","54214596","54214855","26","1390374"
"chr3","55623334","55623635","chr17","54233016","54233326","16","1390318"
"chr3","55641049","55641299","chr17","54250403","54250661","17","1390646"
"chr3","55655130","55655419","chr17","54264684","54264990","23","1390446"
"chr3","55710462","55710711","chr17","54320946","54321192","7","1389516"
"chr3","55731984","55732287","chr17","54342695","54342998","3","1389289"
"chr3","55882538","55882825","chr17","54498832","54499138","35","1383706"
"chr3","55885231","55885529","chr17","54501553","54501860","16","1383678"
"chr3","55887776","55887907","chr17","54504110","54504240","2","1383666"
"chr3","55890734","55891015","chr17","54507056","54507337","5","1383678"
"chr3","55995760","55996064","chr17","54617400","54617706","12","1378360"
"chr3","56028128","56028435","chr17","54650006","54650301","18","1378122"
"chr3","56042526","56042834","chr17","54664415","54664725","7","1378111"
"chr3","56050973","56051284","chr17","54673164","54673468","17","1377809"
"chr3","56060968","56061218","chr17","54683645","54683895","4","1377323"
"chr3","56072734","56073041","chr17","54695816","54696124","12","1376918"
"chr3","56095639","56095935","chr17","54718665","54718961","4","1376974"
"chr3","56107280","56107424","chr17","54730970","54731114","2","1376310"
"chr3","56109610","56109873","chr7","148800220","148800490","64","92690610"
"chr3","56114406","56114716","chr17","54738056","54738370","12","1376350"
"chr3","56114782","56115069","chr17","54738436","54738724","6","1376346"
"chr3","56128113","56128416","chr1","121637797","121638093","59","65509684"
"chr3","56136542","56136830","chr17","54760265","54760553","6","1376277"
"chr3","56137173","56137484","chr15","93738269","93738575","51","37601096"
"chr3","56139002","56139297","chr17","54762726","54763022","13","1376276"
"chr3","56159589","56159891","chr17","54782861","54783163","7","1376728"
"chr3","56173152","56173457","chr17","54796735","54797036","8","1376417"
"chr3","56192665","56192964","chr17","54816219","54816557","44","1376446"
"chr3","56241602","56241783","chr4","101841066","101841253","42","45599464"
"chr3","56259906","56260181","chr17","54882421","54882697","5","1377485"
"chr3","56261917","56262222","chr17","54884425","54884730","6","1377492"
"chr3","56271247","56271588","chr17","54893776","54894086","35","1377471"
"chr3","56293240","56293543","chr17","54915912","54916216","11","1377328"
"chr3","56307597","56307903","chr17","54930056","54930366","11","1377541"
"chr3","56407727","56407978","chr17","55029486","55029737","15","1378241"
"chr3","56441410","56441713","chr17","55063351","55063641","22","1378059"
"chr3","56452484","56452766","chr17","55074592","55074874","9","1377892"
"chr3","56482186","56482482","chr17","55104437","55104727","16","1377749"
"chr3","56550071","56550283","chr17","55172540","55172744","10","1377531"
"chr3","56596780","56597087","chr17","55218510","55218821","17","1378270"
"chr3","56620393","56620695","chr17","55242243","55242537","11","1378150"
"chr3","56645159","56645457","chr17","55266929","55267235","17","1378230"
"chr3","56747640","56747956","chr17","55371468","55371784","10","1376172"
"chr3","56802147","56802441","chr17","55426010","55426295","9","1376137"
"chr3","56831796","56832018","chr17","55455393","55455615","3","1376403"
"chr3","56930911","56931223","chr17","55555317","55555630","9","1375594"
"chr3","56944187","56944460","chr17","55568911","55569205","22","1375276"
"chr3","57031174","57031473","chr17","55664424","55664723","5","1366750"
"chr3","57199142","57199450","chr6","70501055","70501362","69","13301913"
"chr3","57256813","57257114","chr6","71117228","71117522","60","13860415"
"chr3","57406108","57406415","chr14","83596415","83596719","60","26190307"
"chr3","57428164","57428332","chr17","55837684","55837849","10","1590480"
"chr3","57454900","57455183","chr17","55864272","55864542","18","1590628"
"chr3","57515232","57515521","chr17","55930293","55930605","33","1584939"
"chr3","57532336","57532611","chr17","55944866","55945145","17","1587470"
"chr3","57537129","57537423","chr17","55949665","55949965","14","1587464"
"chr3","57605476","57605771","chr3","123559948","123560236","71","65954472"
"chr3","57681007","57681108","chr17","56098461","56098562","2","1582546"
"chr3","57694144","57694219","chr17","56111947","56112022","1","1582197"
"chr3","57727799","57728055","chr17","56148958","56149209","10","1578841"
"chr3","57728069","57728153","chr17","56149223","56149307","1","1578846"
"chr3","57801663","57801975","chr17","56226674","56226986","8","1574989"
"chr3","57818451","57818701","chr17","56243712","56243961","12","1574739"
"chr3","57832878","57833166","chr1","38774868","38775157","60","19058010"
"chr3","57872494","57872784","chr17","56298511","56298805","11","1573983"
"chr3","57902833","57903133","chr17","56332352","56332652","11","1570481"
"chr3","57916129","57916414","chr17","56346563","56346848","7","1569566"
"chr3","57965257","57965569","chr17","56400614","56400911","23","1564643"
"chr3","57987071","57987337","chr17","56422677","56422957","20","1564394"
"chr3","58205318","58205622","chr17","56648957","56649257","9","1556361"
"chr3","58243828","58244122","chr17","56689405","56689704","11","1554423"
"chr3","58249813","58249968","chr10","10585694","10585857","41","47664119"
"chr3","58250001","58250084","chr14","546445","546529","22","57703556"
"chr3","58250748","58251032","chr17","56695764","56696073","31","1554984"
"chr3","58284016","58284324","chr17","56736573","56736883","19","1547443"
"chr3","58289218","58289496","chrX","90717934","90718213","51","32428716"
"chr3","58295909","58296184","chr17","56748450","56748751","40","1547459"
"chr3","58332899","58333210","chr1","80021988","80022296","71","21689089"
"chr3","58341355","58341509","chr17","56793823","56793977","2","1547532"
"chr3","58357404","58357563","chr14","490793","490953","32","57866611"
"chr3","58361435","58361724","chr17","56814002","56814290","11","1547433"
"chr3","58398273","58398549","chr17","56844158","56844434","10","1554115"
"chr3","58407960","58408272","chr17","56853799","56854113","8","1554161"
"chr3","58490259","58490563","chr8","61749821","61750128","55","3259562"
"chr3","58569523","58569832","chr17","57015715","57016024","11","1553808"
"chr3","58578615","58578900","chr17","57024573","57024857","4","1554042"
"chr3","58712995","58713301","chr17","57153079","57153381","7","1559916"
"chr3","58854416","58854544","chr13","62005594","62005716","23","3151178"
"chr3","59107811","59107992","chr17","57544737","57544930","15","1563074"
"chr3","59171315","59171638","chr17","57607733","57608056","9","1563582"
"chr3","59196697","59196987","chr17","57633134","57633424","4","1563563"
"chr3","59238031","59238318","chr17","57681045","57681332","8","1556986"
"chr3","59279905","59280210","chr17","57723459","57723759","14","1556446"
"chr3","59282506","59282699","chr17","23145848","23146037","55","36136658"
"chr3","59283008","59283132","chr17","57726526","57726658","10","1556482"
"chr3","59315379","59315687","chr17","57761434","57761738","15","1553945"
"chr3","59323415","59323577","chr17","57772052","57772213","4","1551363"
"chr3","59326775","59327064","chr17","57775370","57775659","8","1551405"
"chr3","59333890","59334191","chr17","57784415","57784716","7","1549475"
"chr3","59335690","59335955","chr17","57786123","57786381","9","1549567"
"chr3","59339906","59340219","chr17","57789851","57790164","10","1550055"
"chr3","59368895","59369216","chr17","57819082","57819383","27","1549813"
"chr3","59384709","59385016","chr17","57835598","57835904","13","1549111"
"chr3","59392528","59392839","chr17","57843686","57843997","8","1548842"
"chr3","59395022","59395323","chr17","57846090","57846391","6","1548932"
"chr3","59395906","59396205","chr17","57846973","57847275","11","1548933"
"chr3","59397172","59397489","chr17","57848399","57848721","10","1548773"
"chr3","59402281","59402582","chr17","57853516","57853817","2","1548765"
"chr3","59447400","59447695","chrX","45599398","45599690","58","13848002"
"chr3","59448564","59448729","chr17","57899927","57900076","32","1548637"
"chr3","59536846","59537144","chr17","57989612","57989909","7","1547234"
"chr3","59615836","59616143","chr17","58067632","58067872","71","1548204"
"chr3","59758837","59759150","chr17","58214631","58214944","18","1544206"
"chr3","59811543","59811819","chr17","58267784","58268059","11","1543759"
"chr3","59873183","59873448","chr17","58333736","58334001","3","1539447"
"chr3","59911653","59911851","chr17","58371047","58371276","37","1540606"
"chr3","59931524","59931832","chr10","71331469","71331758","74","11399945"
"chr3","59936514","59936773","chr17","58396158","58396417","2","1540356"
"chr3","59995254","59995424","chr4","33661808","33661971","40","26333446"
"chr3","59995454","59995576","chr9","15480323","15480442","27","44515131"
"chr3","60038996","60039327","chr14","62701507","62701826","66","2662511"
"chr3","60057828","60058145","chr17","58529056","58529382","19","1528772"
"chr3","60109259","60109551","chr16","59087091","59087383","58","1022168"
"chr3","60159447","60159748","chr17","58634292","58634587","15","1525155"
"chr3","60214478","60214774","chr2","50050161","50050451","53","10164317"
"chr3","60283607","60283901","chr17","58764274","58764568","10","1519333"
"chr3","60344747","60344879","chr11","45012693","45012828","21","15332054"
"chr3","60558263","60558573","chr17","59044976","59045286","7","1513287"
"chr3","60573009","60573344","chr4","126014462","126014811","86","65441453"
"chr3","60624228","60624517","chr7","30149330","30149627","72","30474898"
"chr3","60700546","60700820","chr17","59186906","59187169","26","1513640"
"chr3","60718443","60718750","chr17","59210484","59210779","22","1507959"
"chr3","60918804","60918935","chr17","59431338","59431469","11","1487466"
"chr3","60927383","60927672","chr17","59441060","59441346","14","1486323"
"chr3","61185071","61185379","chr17","59694529","59694842","10","1490542"
"chr3","61261861","61262166","chr17","59769894","59770197","14","1491967"
"chr3","61290727","61290973","chr17","59801439","59801688","9","1489288"
"chr3","61329014","61329340","chr17","59839983","59840321","22","1489031"
"chr3","61338575","61338842","chr17","59849743","59850008","10","1488832"
"chr3","61354946","61355223","chr17","59865565","59865845","17","1489381"
"chr3","61371817","61372115","chr17","59883980","59884278","10","1487837"
"chr3","61426201","61426258","chr1","96305796","96305853","3","34879595"
"chr3","61426340","61426401","chr1","96305934","96305995","1","34879594"
"chr3","61448514","61448810","chr17","59926944","59927254","16","1521570"
"chr3","61636132","61636303","chr3","66623530","66623690","41","4987398"
"chr3","61652821","61653105","chr20","4420330","4420618","58","57232491"
"chr3","61656475","61656792","chr1","153420763","153421073","72","91764288"
"chr3","61708311","61708611","chr17","60167163","60167463","7","1541148"
"chr3","61901329","61901611","chr17","60360205","60360490","14","1541124"
"chr3","62067933","62068216","chr17","60508678","60508961","13","1559255"
"chr3","62773121","62773427","chr17","61210252","61210558","7","1562869"
"chr3","62826161","62826373","chr17","61262341","61262548","8","1563820"
"chr3","62837910","62838119","chr1","37428559","37428749","63","25409351"
"chr3","62838207","62838285","chr2","47614777","47614855","19","15223430"
"chr3","62884815","62884964","chr17","61321293","61321443","5","1563522"
"chr3","62945624","62945940","chrX","41341410","41341721","87","21604214"
"chr3","63030145","63030434","chr17","61467313","61467613","20","1562832"
"chr3","63119670","63119973","chr17","61556755","61557058","4","1562915"
"chr3","63134690","63134997","chr17","61571786","61572097","8","1562904"
"chr3","63301858","63302151","chr17","61743404","61743697","10","1558454"
"chr3","63500424","63500713","chr17","61933509","61933798","7","1566915"
"chr3","63503747","63504043","chr17","61936841","61937130","27","1566906"
"chr3","63621210","63621504","chr17","62053066","62053356","10","1568144"
"chr3","63755096","63755402","chr17","62187566","62187842","48","1567530"
"chr3","63832723","63833008","chr2","167664248","167664541","67","103831525"
"chr3","63910439","63910707","chr3","11960652","11960924","68","51949787"
"chr3","63956463","63956751","chr17","62396155","62396445","10","1560308"
"chr3","63975369","63975474","chr1","26521538","26521641","21","37453831"
"chr3","64001011","64001267","chr17","62440005","62440264","7","1561006"
"chr3","64059880","64060023","chr1","47815731","47815867","53","16244149"
"chr3","64089114","64089409","chr17","62526634","62526947","25","1562480"
"chr3","64143906","64144132","chr10","51470946","51471181","60","12672960"
"chr3","64147215","64147373","chrX","29446583","29446745","35","34700632"
"chr3","64152493","64152663","chr19","16773041","16773205","45","47379452"
"chr3","64158374","64158640","chr10","38500001","38500259","65","25658373"
"chr3","64169479","64169782","chr17","62610334","62610652","34","1559145"
"chr3","64196032","64196310","chr17","62634015","62634330","44","1562017"
"chr3","64246718","64247019","chr17","62684808","62685109","2","1561910"
"chr3","64358334","64358608","chr11","112972511","112972776","78","48614177"
"chr3","64507847","64508144","chr17","62949133","62949424","20","1558714"
"chr3","64579637","64579917","chr17","63022534","63022814","8","1557103"
"chr3","64658037","64658330","chr17","63103674","63103952","24","1554363"
"chr3","64700189","64700462","chr17","63144940","63145213","5","1555249"
"chr3","64776622","64776909","chr17","63219926","63220233","34","1556696"
"chr3","64880239","64880534","chr17","63316229","63316524","5","1564010"
"chr3","64913659","64913783","chr17","63349066","63349190","5","1564593"
"chr3","64913807","64914069","chr17","63349211","63349472","11","1564596"
"chr3","65028051","65028364","chr17","63459565","63459881","13","1568486"
"chr3","65059525","65059649","chr17","63490820","63490945","3","1568705"
"chr3","65186409","65186693","chr17","63620405","63620688","5","1566004"
"chr3","65259593","65259901","chr17","63700053","63700364","9","1559540"
"chr3","65294917","65295230","chr17","63735281","63735587","15","1559636"
"chr3","65322199","65322313","chr17","63762487","63762601","5","1559712"
"chr3","65388182","65388299","chr17","63831808","63831923","5","1556374"
"chr3","65388666","65388855","chr17","63832296","63832477","12","1556370"
"chr3","65396725","65397005","chr17","63840079","63840359","11","1556646"
"chr3","65412041","65412116","chr17","63855307","63855382","0","1556734"
"chr3","65455758","65456040","chr1","130506906","130507192","66","65051148"
"chr3","65503962","65504260","chr20","3710011","3710305","69","61793951"
"chr3","65611885","65612152","chr17","64051805","64052075","6","1560080"
"chr3","65715173","65715475","chr17","64161053","64161361","12","1554120"
"chr3","65783027","65783302","chr17","64224959","64225256","32","1558068"
"chr3","66038215","66038472","chr17","64477630","64477894","15","1560585"
"chr3","66057431","66057572","chr7","123683717","123683847","43","57626286"
"chr3","66069259","66069551","chr17","64509428","64509714","10","1559831"
"chr3","66100632","66100812","chr19","10328446","10328629","40","55772186"
"chr3","66100844","66100981","chr4","119142322","119142454","24","53041478"
"chr3","66138496","66138776","chr17","64583898","64584178","3","1554598"
"chr3","66198168","66198470","chr17","64645336","64645623","19","1552832"
"chr3","66319597","66319772","chr1","56885287","56885466","46","9434310"
"chr3","66319803","66319890","chr8","64680760","64680860","25","1639043"
"chr3","66373212","66373467","chr17","64816717","64816974","13","1556495"
"chr3","66404279","66404575","chr17","64844320","64844599","21","1559959"
"chr3","66513791","66514089","chr17","64954003","64954301","10","1559788"
"chr3","66523415","66523579","chr17","64963593","64963750","15","1559822"
"chr3","66523621","66523748","chr17","64963790","64963915","7","1559831"
"chr3","66673633","66673964","chr17","65117711","65118043","9","1555922"
"chr3","66756229","66756535","chr17","65200383","65200692","22","1555846"
"chr3","66783181","66783444","chr17","65229846","65230109","3","1553335"
"chr3","66794978","66795261","chr17","65240919","65241230","39","1554059"
"chr3","66856159","66856461","chr17","65303902","65304205","10","1552257"
"chr3","66994179","66994413","chr15","99486679","99486907","46","32492500"
"chr3","67117500","67117772","chr5","2176433","2176713","61","64941067"
"chr3","67171923","67172196","chr17","65615708","65615984","9","1556215"
"chr3","67181366","67181645","chr17","65625125","65625389","25","1556241"
"chr3","67209225","67209512","chr17","65652609","65652903","21","1556616"
"chr3","67214130","67214271","chr4","107997331","107997451","36","40783201"
"chr3","67321707","67321996","chr17","65766278","65766572","23","1555429"
"chr3","67430051","67430338","chr17","65869386","65869673","9","1560665"
"chr3","67431316","67431520","chr17","65870652","65870856","9","1560664"
"chr3","67447076","67447166","chr17","65886116","65886206","3","1560960"
"chr3","67459104","67459424","chr17","65897551","65897872","3","1561553"
"chr3","67568155","67568451","chr17","66009263","66009548","18","1558892"
"chr3","67589104","67589205","chr16","35887409","35887513","22","31701695"
"chr3","67694898","67695085","chr17","66142734","66142899","47","1552164"
"chr3","67782536","67782857","chr17","66247217","66247541","10","1535319"
"chr3","67793409","67793683","chr19","2321527","2321809","84","65471882"
"chr3","67848243","67848548","chr17","66316480","66316786","9","1531763"
"chr3","67910009","67910308","chr17","66373684","66374001","39","1536325"
"chr3","68030763","68031014","chr17","66497104","66497355","8","1533659"
"chr3","68039332","68039643","chr17","66508590","66508900","9","1530742"
"chr3","68121621","68121901","chr17","66596016","66596296","3","1525605"
"chr3","68264507","68264788","chr17","66738418","66738698","11","1526089"
"chr3","68278781","68279075","chr17","66750160","66750454","5","1528621"
"chr3","68399710","68400019","chr17","66873057","66873364","20","1526653"
"chr3","68457369","68457661","chr17","66934596","66934893","19","1522773"
"chr3","68539467","68539618","chr17","67018878","67019029","1","1520589"
"chr3","68541284","68541594","chr17","67020380","67020686","12","1520904"
"chr3","68779353","68779520","chr15","348992","349161","42","68430361"
"chr3","68781074","68781197","chr6","33320539","33320661","33","35460535"
"chr3","68796522","68796654","chr17","67253400","67253532","2","1543122"
"chr3","68832855","68833015","chr17","67289636","67289796","2","1543219"
"chr3","68942675","68942938","chr17","67396436","67396678","31","1546239"
"chr3","68963481","68963801","chr17","67417572","67417866","30","1545909"
"chr3","68977083","68977388","chr17","67430367","67430672","3","1546716"
"chr3","69047822","69048111","chr17","67500714","67500999","20","1547108"
"chr3","69069776","69070058","chr17","55074592","55074874","60","13995184"
"chr3","69101969","69102259","chr17","67554207","67554493","12","1547762"
"chr3","69357756","69358057","chr17","67809124","67809414","24","1548632"
"chr3","69395072","69395399","chr17","67848312","67848624","27","1546760"
"chr3","69480403","69480698","chr17","67934037","67934335","12","1546366"
"chr3","69574639","69574875","chr17","76231335","76231574","56","6656696"
"chr3","69604824","69604940","chr17","68061046","68061162","0","1543778"
"chr3","69604972","69605129","chr17","68061200","68061355","9","1543772"
"chr3","69765308","69765592","chr17","68278331","68278612","11","1486977"
"chr3","69832541","69832880","chr14","11693329","11693651","86","58139212"
"chr3","69868322","69868429","chr19","40190589","40190699","22","29677733"
"chr3","69934810","69935124","chr17","68445746","68446018","51","1489064"
"chr3","70000831","70001112","chr17","68512845","68513116","17","1487986"
"chr3","70022760","70023042","chr17","68534644","68534961","39","1488116"
"chr3","70087620","70087913","chr10","31970440","31970736","52","38117180"
"chr3","70116783","70117079","chr17","68630091","68630384","32","1486692"
"chr3","70183940","70184224","chr17","68696876","68697160","8","1487064"
"chr3","70197237","70197456","chr17","68710194","68710416","8","1487043"
"chr3","70210097","70210256","chr17","68722747","68722910","6","1487350"
"chr3","70236364","70236642","chr17","68747842","68748120","11","1488522"
"chr3","70261413","70261689","chr17","68773781","68774059","6","1487632"
"chr3","70284004","70284310","chr17","68796366","68796675","5","1487638"
"chr3","70289773","70290064","chr17","68802458","68802760","22","1487315"
"chr3","70301690","70301984","chr17","68814519","68814813","8","1487171"
"chr3","70326212","70326498","chr17","68838851","68839137","7","1487361"
"chr3","70342472","70342759","chr17","68854628","68854941","35","1487844"
"chr3","70555138","70555423","chr15","41006519","41006808","66","29548619"
"chr3","70662668","70662975","chr17","69195135","69195445","20","1467533"
"chr3","70757874","70758141","chr17","69293138","69293405","5","1464736"
"chr3","70763451","70763717","chr17","69298706","69298973","9","1464745"
"chr3","70797715","70797912","chr20","20042595","20042794","61","50755120"
"chr3","70818549","70818850","chr17","69356067","69356364","19","1462482"
"chr3","71000721","71000994","chr17","69545137","69545410","7","1455584"
"chr3","71006749","71006929","chr4","145587958","145588132","31","74581209"
"chr3","71006963","71007080","chr7","46204039","46204155","20","24802924"
"chr3","71017482","71017752","chr1","34739473","34739748","62","36278009"
"chr3","71096040","71096351","chr13","24563268","24563557","71","46532772"
"chr3","71220916","71220990","chr10","22795109","22795181","18","48425807"
"chr3","71303434","71303745","chr17","69849392","69849704","11","1454042"
"chr3","71408239","71408533","chr17","69952526","69952834","25","1455713"
"chr3","71413436","71413712","chr17","69957045","69957328","12","1456391"
"chr3","71537030","71537331","chr6","132255904","132256198","69","60718874"
"chr3","71631221","71631519","chr10","62124284","62124586","58","9506937"
"chr3","71637663","71637813","chr17","70190363","70190515","13","1447300"
"chr3","71667488","71667773","chr10","75574714","75575007","64","3907226"
"chr3","71793945","71794235","chr17","70345559","70345846","12","1448386"
"chr3","71812221","71812515","chr17","70364205","70364499","6","1448016"
"chr3","71822538","71822548","chr6","148154943","148154954","2","76332405"
"chr3","71822580","71822861","chr17","70374581","70374859","13","1447999"
"chr3","71890628","71890961","chr10","17118734","17119050","83","54771894"
"chr3","71974291","71974578","chr17","70526643","70526929","16","1447648"
"chr3","72019166","72019390","chr17","70571485","70571709","9","1447681"
"chr3","72048070","72048359","chr17","70600159","70600476","32","1447911"
"chr3","72069972","72070234","chr17","70620325","70620587","6","1449647"
"chr3","72143047","72143261","chr17","70691622","70691842","9","1451425"
"chr3","72145086","72145392","chr17","70693649","70693936","28","1451437"
"chr3","72145430","72145456","chr4","161170103","161170130","5","89024673"
"chr3","72177714","72178012","chr17","70726736","70727030","15","1450978"
"chr3","72184942","72185244","chr17","70733130","70733434","14","1451812"
"chr3","72211313","72211558","chr17","70758384","70758653","29","1452929"
"chr3","72292493","72292557","chr17","70839894","70839958","3","1452599"
"chr3","72399362","72399649","chr17","70946255","70946542","7","1453107"
"chr3","72420374","72420656","chr17","70967947","70968229","5","1452427"
"chr3","72423662","72423981","chr17","70971226","70971543","18","1452436"
"chr3","72471364","72471652","chr17","71018484","71018772","2","1452880"
"chr3","72488103","72488384","chr17","71035558","71035839","12","1452545"
"chr3","72517098","72517228","chr17","71066965","71067092","8","1450133"
"chr3","72526417","72526723","chr17","71076267","71076559","41","1450150"
"chr3","72535611","72535892","chrX","59933918","59934196","60","12601693"
"chr3","72570738","72571058","chr7","158585944","158586255","74","86015206"
"chr3","72640173","72640462","chr14","100128297","100128571","74","27488124"
"chr3","72679545","72679820","chr17","71232136","71232411","5","1447409"
"chr3","72712037","72712296","chr17","71263669","71263948","32","1448368"
"chr3","72723136","72723432","chr17","71274727","71275023","2","1448409"
"chr3","72745840","72746045","chr17","71297405","71297610","9","1448435"
"chr3","72783180","72783484","chr17","71337621","71337923","11","1445559"
"chr3","72790232","72790539","chr17","71345017","71345308","24","1445215"
"chr3","72794710","72794937","chr17","71349456","71349682","8","1445254"
"chr3","72889748","72890039","chr17","71445348","71445649","20","1444400"
"chr3","72983471","72983728","chr17","71540183","71540457","23","1443288"
"chr3","73047199","73047500","chr7","111283263","111283566","58","38236064"
"chr3","73142024","73142190","chr17","71699283","71699451","5","1442741"
"chr3","73179430","73179739","chr17","71736744","71737051","11","1442686"
"chr3","73184136","73184424","chr17","71741481","71741771","13","1442655"
"chr3","73292793","73293067","chr17","71852249","71852523","6","1440544"
"chr3","73317444","73317753","chr17","71876479","71876788","8","1440965"
"chr3","73322534","73322809","chr17","71881513","71881788","3","1441021"
"chr3","73329165","73329466","chr17","71888083","71888379","10","1441082"
"chr3","73337005","73337311","chr7","41760086","41760391","58","31576919"
"chr3","73351971","73352069","chr3","5317936","5318032","19","68034035"
"chr3","73383258","73383388","chr17","71947525","71947654","4","1435733"
"chr3","73383698","73383885","chr17","71947963","71948160","32","1435735"
"chr3","73416257","73416565","chr17","71980490","71980801","12","1435767"
"chr3","73425296","73425589","chr17","71989560","71989853","7","1435736"
"chr3","73477546","73477780","chr17","72041873","72042107","3","1435673"
"chr3","73516859","73517063","chr1","182184484","182184692","46","108667625"
"chr3","73546404","73546673","chr17","72108774","72109048","12","1437630"
"chr3","73549752","73550061","chr17","72112113","72112412","18","1437639"
"chr3","73572363","73572666","chr17","72134652","72134950","18","1437711"
"chr3","73586854","73587186","chr17","72149450","72149765","29","1437404"
"chr3","73591878","73592171","chr17","72155640","72155946","22","1436238"
"chr3","73604025","73604144","chr7","144623717","144623838","25","71019692"
"chr3","73604659","73604808","chr1","8856801","8856959","37","64747858"
"chr3","73632173","73632479","chr17","72197681","72197992","9","1434492"
"chr3","73636914","73637000","chr17","72202330","72202415","1","1434584"
"chr3","73655452","73655754","chr17","72220302","72220581","37","1435150"
"chr3","73660570","73660697","chr17","72225021","72225148","1","1435549"
"chr3","73664498","73664653","chr7","115979076","115979229","32","42314578"
"chr3","73671866","73672167","chr17","72236585","72236878","14","1435281"
"chr3","73692540","73692721","chr17","72259875","72260055","10","1432665"
"chr3","73708211","73708471","chr1","64867733","64867995","55","8840478"
"chr3","73720209","73720481","chr17","72288468","72288741","10","1431741"
"chr3","73742807","73743089","chr17","72311267","72311551","12","1431540"
"chr3","73745587","73745895","chr17","72314059","72314371","11","1431528"
"chr3","73745955","73746252","chr17","72314430","72314728","16","1431525"
"chr3","73752247","73752555","chr17","72322603","72322919","15","1429644"
"chr3","73812786","73813066","chr17","72388617","72388898","8","1424169"
"chr3","73840352","73840648","chr17","72417684","72417978","9","1422668"
"chr3","73853667","73853855","chr7","42418992","42419183","34","31434675"
"chr3","73919804","73920108","chr17","72499429","72499737","9","1420375"
"chr3","73921247","73921310","chr6","144819998","144820056","16","70898751"
"chr3","73924040","73924186","chr9","19767173","19767318","32","54156867"
"chr3","73937054","73937356","chr17","72516679","72516982","3","1420375"
"chr3","73947299","73947604","chr17","72526689","72526959","41","1420610"
"chr3","73957114","73957238","chr17","72539105","72539229","4","1418009"
"chr3","73972189","73972372","chr17","72554879","72555076","17","1417310"
"chr3","73977008","73977314","chr4","100520256","100520552","75","26543248"
"chr3","73990893","73991006","chr17","72573110","72573229","9","1417783"
"chr3","74018173","74018480","chr7","46240539","46240847","55","27777634"
"chr3","74022399","74022547","chr2","172227852","172227991","43","98205453"
"chr3","74024051","74024355","chr17","72606239","72606544","4","1417812"
"chr3","74048597","74048876","chr17","72630373","72630658","16","1418224"
"chr3","74058227","74058532","chr5","158245217","158245520","58","84186990"
"chr3","74060762","74061050","chr17","72642581","72642862","15","1418181"
"chr3","74079646","74079735","chr17","72662133","72662219","8","1417513"
"chr3","74081685","74082009","chr17","72664170","72664493","15","1417515"
"chr3","74086978","74087273","chr17","72671278","72671575","9","1415700"
"chr3","74087746","74088029","chr17","72672047","72672366","54","1415699"
"chr3","74093930","74094176","chr2","75550330","75550579","59","1456400"
"chr3","74094784","74095070","chr17","72678809","72679095","13","1415975"
"chr3","74099990","74100289","chr17","72684307","72684610","9","1415683"
"chr3","74100348","74100616","chr17","72684669","72684926","20","1415679"
"chr3","74101702","74101967","chr17","72686009","72686274","6","1415693"
"chr3","74107555","74107689","chr17","72691826","72691960","2","1415729"
"chr3","74107849","74107947","chr17","72692112","72692218","9","1415737"
"chr3","74111815","74112122","chr17","72696042","72696347","8","1415773"
"chr3","74115655","74115955","chr17","72699971","72700266","12","1415684"
"chr3","74117147","74117451","chr17","72701458","72701770","13","1415689"
"chr3","74118969","74119147","chr17","72703275","72703451","7","1415694"
"chr3","74127193","74127480","chrX","17120640","17120926","57","57006553"
"chr3","74132569","74132856","chr17","72717841","72718128","10","1414728"
"chr3","74133307","74133604","chr17","72718671","72718968","9","1414636"
"chr3","74140665","74140779","chr17","72726310","72726422","6","1414355"
"chr3","74156642","74156880","chr17","72746769","72746998","18","1409873"
"chr3","74160422","74160694","chr17","72739786","72740058","9","1420636"
"chr3","74163137","74163376","chr17","72748827","72749063","9","1414310"
"chr3","74166830","74167028","chr17","72761678","72761876","3","1405152"
"chr3","74168669","74168718","chr17","72763482","72763531","1","1405187"
"chr3","74169431","74169452","chr17","72764246","72764267","1","1405185"
"chr3","74172013","74172193","chr8","69729004","69729200","45","4443009"
"chr3","74186104","74186231","chr13","117431604","117431728","23","43245500"
"chr3","74189827","74190069","chr17","72779819","72780061","3","1410008"
"chr3","74191934","74191962","chr4","161170103","161170130","4","86978169"
"chr3","74192026","74192297","chr17","72782002","72782303","42","1410024"
"chr3","74200273","74200535","chr3","127738311","127738569","66","53538038"
"chr3","74201207","74201471","chr17","72790199","72790463","4","1411008"
"chr3","74219179","74219403","chr17","72806030","72806254","9","1413149"
"chr3","74219767","74220075","chr7","46598912","46599209","54","27620855"
"chr3","74224133","74224412","chr7","35476945","35477208","72","38747188"
"chr3","74224444","74224743","chr17","72814580","72814863","32","1409864"
"chr3","74226961","74227284","chr17","72817081","72817396","22","1409880"
"chr3","74227739","74228036","chr7","124296708","124296999","62","50068969"
"chr3","74229385","74229590","chr17","72819488","72819694","7","1409897"
"chr3","74231139","74231423","chr17","72825155","72825439","5","1405984"
"chr3","74233061","74233339","chr17","72820796","72821091","22","1412265"
"chr3","74234193","74234488","chr17","72821944","72822245","13","1412249"
"chr3","74237731","74237751","chr20","49089817","49089835","2","25147914"
"chr3","74237836","74238120","chr17","72829646","72829960","39","1408190"
"chr3","74241748","74242048","chr17","72833529","72833822","13","1408219"
"chr3","74245915","74246184","chr17","72837708","72837974","13","1408207"
"chr3","74247398","74247694","chr17","72839189","72839477","18","1408209"
"chr3","74268571","74268865","chr17","72860525","72860819","33","1408046"
"chr3","74269379","74269659","chr17","72861331","72861620","20","1408048"
"chr3","74288428","74288736","chr17","72880935","72881238","12","1407493"
"chr3","74301090","74301390","chr17","72895557","72895853","11","1405533"
"chr3","74307226","74307379","chr1","1658615","1658747","38","72648611"
"chr3","74346838","74346882","chr3","39246422","39246462","17","35100416"
"chr3","74346912","74347014","chr6","133011443","133011533","30","58664531"
"chr3","74422405","74422708","chr11","107092529","107092830","46","32670124"
"chr3","74425502","74425818","chr17","73018523","73018840","6","1406979"
"chr3","74427713","74428004","chr17","73020732","73021026","9","1406981"
"chr3","74518356","74518624","chr7","157971739","157972008","56","83453383"
"chr3","74563093","74563402","chr17","73157089","73157384","18","1406004"
"chr3","74573006","74573105","chr17","73167035","73167133","3","1405971"
"chr3","74630738","74631029","chr17","73252477","73252768","7","1378261"
"chr3","74636822","74637139","chr17","73257953","73258270","12","1378869"
"chr3","74654858","74655169","chr17","73277378","73277697","17","1377480"
"chr3","74688102","74688414","chr17","73311585","73311878","30","1376517"
"chr3","74807773","74807953","chr17","73435789","73435969","7","1371984"
"chr3","74809820","74810090","chr17","73437881","73438123","36","1371939"
"chr3","74813599","74813913","chr20","55866452","55866745","84","18947147"
"chr3","74822609","74822927","chr17","73451210","73451528","13","1371399"
"chr3","74880826","74881127","chr17","73508414","73508713","13","1372412"
"chr3","74916770","74916932","chr14","84218244","84218411","36","9301474"
"chr3","74917294","74917428","chr19","35199881","35200012","22","39717413"
"chr3","74972036","74972316","chr16","40901438","40901720","57","34070598"
"chr3","74991693","74991987","chr17","73618559","73618857","11","1373134"
"chr3","75023228","75023335","chr17","73649758","73649865","3","1373470"
"chr3","75095910","75096196","chr17","73722390","73722680","13","1373520"
"chr3","75131405","75131675","chr17","73757681","73757978","40","1373724"
"chr3","75191328","75191608","chr17","73817745","73818024","11","1373583"
"chr3","75204201","75204486","chr17","73830804","73831108","26","1373397"
"chr3","75264753","75265044","chr17","73891067","73891356","11","1373686"
"chr3","75302940","75303221","chr17","73929241","73929522","11","1373699"
"chr3","75397876","75398137","chr17","74028977","74029242","14","1368899"
"chr3","75405488","75405784","chr17","74036630","74036927","7","1368858"
"chr3","75443788","75444062","chr17","74076585","74076859","5","1367203"
"chr3","75464887","75465167","chr6","133466384","133466659","49","58001497"
"chr3","75472749","75472858","chr17","74105229","74105338","3","1367520"
"chr3","75503000","75503104","chr17","74134844","74134950","2","1368156"
"chr3","75635873","75635995","chr17","74267146","74267266","3","1368727"
"chr3","75636025","75636178","chr17","74267300","74267455","8","1368725"
"chr3","75764052","75764365","chr17","74405456","74405769","10","1358596"
"chr3","75766128","75766451","chr17","74407522","74407842","29","1358606"
"chr3","75812405","75812717","chr13","68768148","68768457","57","7044257"
"chr3","75815552","75815859","chr20","51825333","51825631","70","23990219"
"chr3","75882155","75882458","chr17","74521938","74522248","17","1360217"
"chr3","76017028","76017324","chr17","74662049","74662345","7","1354979"
"chr3","76082644","76082939","chr17","74726750","74727044","6","1355894"
"chr3","76240250","76240463","chr17","74902253","74902463","10","1337997"
"chr3","76387775","76388057","chr17","75048129","75048411","15","1339646"
"chr3","76390813","76391090","chr17","75051181","75051458","6","1339632"
"chr3","76392206","76392493","chr17","75052574","75052861","6","1339632"
"chr3","76402841","76403152","chr17","75062870","75063155","34","1339971"
"chr3","76427579","76427888","chr17","75088921","75089225","14","1338658"
"chr3","76428570","76428888","chr17","75089895","75090225","22","1338675"
"chr3","76465119","76465212","chr17","75127455","75127548","2","1337664"
"chr3","76518755","76519069","chr17","75186951","75187265","4","1331804"
"chr3","76579315","76579516","chr17","75247428","75247629","6","1331887"
"chr3","76587602","76587944","chr17","75255645","75255985","16","1331957"
"chr3","76595048","76595342","chr17","75262712","75263008","9","1332336"
"chr3","76597595","76597871","chr17","75265302","75265577","13","1332293"
"chr3","76599349","76599645","chr17","75267059","75267355","6","1332290"
"chr3","76612376","76612676","chr17","75280784","75281084","5","1331592"
"chr3","76616645","76616953","chr17","75285061","75285371","9","1331584"
"chr3","76617011","76617022","chr3","39984846","39984857","0","36632165"
"chr3","76617458","76617598","chr12","91803945","91804089","25","15186487"
"chr3","76621866","76622167","chr17","75290534","75290835","6","1331332"
"chr3","76641276","76641559","chr17","75310485","75310768","11","1330791"
"chr3","76653331","76653615","chr17","75323058","75323343","8","1330273"
"chr3","76662355","76662647","chr17","75332409","75332690","20","1329946"
"chr3","76663311","76663564","chr17","75333338","75333591","4","1329973"
"chr3","76696545","76696832","chr17","75366271","75366555","5","1330274"
"chr3","76703802","76704095","chr17","75373543","75373838","13","1330259"
"chr3","76743200","76743508","chr17","75415215","75415528","10","1327985"
"chr3","76776764","76777063","chr17","75448705","75449009","13","1328059"
"chr3","76778497","76778795","chr17","75450429","75450726","10","1328068"
"chr3","76789791","76790090","chr6","121841066","121841370","56","45051275"
"chr3","76811751","76811976","chr11","82387520","82387742","53","5575769"
"chr3","76812991","76813288","chr17","75485485","75485787","10","1327506"
"chr3","76819024","76819333","chr17","75491513","75491824","9","1327511"
"chr3","76830037","76830349","chr17","75502576","75502890","6","1327461"
"chr3","76845533","76845813","chr17","75517782","75518062","8","1327751"
"chr3","76858402","76858676","chr17","75531160","75531440","11","1327242"
"chr3","76878710","76879008","chrX","96283975","96284267","55","19405265"
"chr3","76925582","76925771","chr17","75600708","75600895","4","1324874"
"chr3","76938773","76939070","chrX","118956252","118956548","50","42017479"
"chr3","76964411","76964711","chr17","75639468","75639768","8","1324943"
"chr3","77015488","77015780","chr17","75687815","75688108","5","1327673"
"chr3","77022301","77022594","chr17","75694940","75695230","7","1327361"
"chr3","77051787","77052090","chr17","75724636","75724917","30","1327151"
"chr3","77204058","77204344","chr17","75883475","75883764","5","1320583"
"chr3","77246689","77247011","chr17","75925951","75926273","5","1320738"
"chr3","77250780","77251021","chr15","5787628","5787863","48","71463152"
"chr3","77269697","77269995","chr17","75951805","75952101","11","1317892"
"chr3","77273013","77273322","chr17","75951805","75952101","22","1321208"
"chr3","77275727","77275893","chr10","17152176","17152343","32","60123551"
"chr3","77292945","77293042","chr17","75971799","75971896","2","1321146"
"chr3","77307714","77308013","chr17","75987700","75987995","13","1320014"
"chr3","77341273","77341550","chr17","76022138","76022418","8","1319135"
"chr3","77353733","77354027","chr17","76034584","76034880","18","1319149"
"chr3","77358830","77358984","chr5","105024490","105024635","29","27665660"
"chr3","77360005","77360320","chr17","76040845","76041151","14","1319160"
"chr3","77370342","77370639","chr17","76051439","76051736","2","1318903"
"chr3","77375666","77375859","chr17","76056776","76056942","28","1318890"
"chr3","77376152","77376271","chr17","76057262","76057377","8","1318890"
"chr3","77382946","77383228","chr17","76064075","76064357","8","1318871"
"chr3","77404362","77404583","chr17","76085889","76086106","11","1318473"
"chr3","77419683","77419925","chr17","76101381","76101623","10","1318302"
"chr3","77432561","77432637","chr17","76114979","76115055","0","1317582"
"chr3","77436524","77436828","chr17","76119248","76119554","13","1317276"
"chr3","77461221","77461519","chr17","76143651","76143937","21","1317570"
"chr3","77477158","77477443","chr17","76159820","76160134","37","1317338"
"chr3","77546688","77546995","chr5","52032870","52033176","56","25513818"
"chr3","77595673","77595961","chr17","76279461","76279749","7","1316212"
"chr3","77611185","77611342","chr19","12442736","12442895","28","65168449"
"chr3","77636494","77636775","chr17","76320925","76321215","15","1315569"
"chr3","77642816","77642987","chr17","76327260","76327428","7","1315556"
"chr3","77643846","77644154","chr17","76328288","76328595","10","1315558"
"chr3","77669928","77670215","chr17","76355257","76355543","6","1314671"
"chr3","77674928","77675233","chr17","76359906","76360206","13","1315022"
"chr3","77704631","77704920","chr17","76389799","76390096","12","1314832"
"chr3","77713067","77713378","chr17","76398479","76398778","20","1314588"
"chr3","77734683","77734986","chr17","76419949","76420240","36","1314734"
"chr3","77736277","77736568","chr17","76421528","76421819","6","1314749"
"chr3","77770724","77771022","chr13","41851851","41852159","65","35918873"
"chr3","77772708","77773002","chr17","76458449","76458746","22","1314259"
"chr3","77823425","77823574","chrX","45548301","45548451","38","32275124"
"chr3","77841964","77842246","chr17","76538724","76539020","23","1303240"
"chr3","77852598","77852890","chr17","76549985","76550277","9","1302613"
"chr3","77891219","77891524","chr17","76589115","76589411","16","1302104"
"chr3","77899670","77899963","chr6","156887783","156888072","57","78988113"
"chr3","77926061","77926372","chr17","76623795","76624109","12","1302266"
"chr3","77932645","77932955","chr17","76630360","76630666","8","1302285"
"chr3","77945570","77945914","chr17","76643644","76643954","42","1301926"
"chr3","77981878","77981999","chr2","87140260","87140382","18","9158382"
"chr3","78034758","78034983","chr17","76732707","76732929","7","1302051"
"chr3","78074839","78075130","chr5","143220929","143221215","61","65146090"
"chr3","78075546","78075837","chr17","76773725","76774020","19","1301821"
"chr3","78084947","78085103","chr17","76783110","76783252","16","1301837"
"chr3","78103246","78103553","chr17","76798915","76799218","15","1304331"
"chr3","78105663","78105972","chr17","76801332","76801639","9","1304331"
"chr3","78108990","78109294","chr17","76804660","76804962","12","1304330"
"chr3","78110351","78110573","chr17","76806021","76806249","19","1304330"
"chr3","78129549","78129864","chr17","76824927","76825244","14","1304622"
"chr3","78151050","78151111","chr1","33811567","33811625","14","44339483"
"chr3","78152116","78152229","chr17","76847462","76847576","1","1304654"
"chr3","78184466","78184763","chr17","76879924","76880220","6","1304542"
"chr3","78221797","78221940","chr17","76927080","76927223","4","1294717"
"chr3","78239768","78240015","chr17","76945136","76945404","28","1294632"
"chr3","78244206","78244493","chr17","76949571","76949859","15","1294635"
"chr3","78261205","78261499","chr17","76965597","76965872","28","1295608"
"chr3","78264305","78264588","chr17","76968457","76968742","16","1295848"
"chr3","78274720","78274767","chr17","76979273","76979320","0","1295447"
"chr3","78274768","78274920","chr17","76979321","76979462","12","1295447"
"chr3","78282953","78283237","chr17","76987505","76987789","14","1295448"
"chr3","78290547","78290842","chr17","76995278","76995599","32","1295269"
"chr3","78295237","78295452","chr17","77000005","77000189","35","1295232"
"chr3","78321454","78321729","chr17","77026259","77026543","13","1295195"
"chr3","78325951","78326242","chr17","77030796","77031086","15","1295155"
"chr3","78349314","78349382","chr16","25477961","25478031","11","52871353"
"chr3","78366793","78367078","chr18","13398332","13398617","61","64968461"
"chr3","78367082","78367194","chr8","71705519","71705629","17","6661563"
"chr3","78368462","78368728","chr6","127904429","127904700","63","49535967"
"chr3","78371817","78372106","chr17","77069091","77069379","4","1302726"
"chr3","78382751","78383071","chr4","112967486","112967795","71","34584735"
"chr3","78386358","78386691","chr17","77085006","77085331","15","1301352"
"chr3","78408889","78409193","chr17","77107597","77107899","30","1301292"
"chr3","78419118","78419328","chr17","77118000","77118178","39","1301118"
"chr3","78420665","78420915","chr17","77119514","77119763","14","1301151"
"chr3","78426299","78426615","chr17","77124778","77125103","21","1301521"
"chr3","78427690","78427979","chr17","77126174","77126465","4","1301516"
"chr3","78463267","78463576","chr17","77165597","77165912","9","1297670"
"chr3","78466543","78466826","chr17","77168571","77168868","23","1297972"
"chr3","78466907","78466917","chr8","69920436","69920446","0","8546471"
"chr3","78486179","78486479","chr17","77188279","77188579","8","1297900"
"chr3","78489218","78489363","chr3","42064775","42064920","27","36424443"
"chr3","78489364","78489656","chr17","77191465","77191747","14","1297899"
"chr3","78534056","78534183","chr17","77236164","77236292","8","1297892"
"chr3","78537512","78537774","chr17","77239625","77239887","3","1297887"
"chr3","78556078","78556371","chr17","77258901","77259176","31","1297177"
"chr3","78575304","78575596","chr17","77277688","77277980","4","1297616"
"chr3","78583999","78584208","chr17","77286051","77286260","8","1297948"
"chr3","78584238","78584535","chr17","77286289","77286602","34","1297949"
"chr3","78592894","78592970","chr17","77295996","77296072","1","1296898"
"chr3","78595589","78595737","chr12","59189450","59189595","29","19406139"
"chr3","78598164","78598380","chr17","77300959","77301178","11","1297205"
"chr3","78654168","78654492","chr17","77359352","77359654","35","1294816"
"chr3","78655850","78656153","chr17","77359352","77359654","15","1296498"
"chr3","78665660","78665945","chr17","77368954","77369222","22","1296706"
"chr3","78675565","78675673","chr17","77381094","77381202","6","1294471"
"chr3","78683144","78683447","chr17","77391049","77391355","8","1292095"
"chr3","78686388","78686695","chr17","77394794","77395101","10","1291594"
"chr3","78688569","78688864","chr17","77396616","77396911","10","1291953"
"chr3","78718274","78718565","chr17","77427819","77428107","4","1290455"
"chr3","78725539","78725716","chr16","42030742","42030915","33","36694797"
"chr3","78726041","78726144","chr3","10050569","10050672","24","68675472"
"chr3","78727139","78727452","chr17","77436998","77437315","21","1290141"
"chr3","78732178","78732334","chr17","77442028","77442187","5","1290150"
"chr3","78732373","78732514","chr17","77442255","77442380","20","1290118"
"chr3","78756468","78756772","chr17","77466510","77466815","12","1289958"
"chr3","78780392","78780484","chr17","77491750","77491842","2","1288642"
"chr3","78799298","78799616","chr17","77509473","77509765","33","1289825"
"chr3","78804305","78804600","chr17","77514020","77514315","1","1290285"
"chr3","78818733","78818874","chr17","77534754","77534894","6","1283979"
"chr3","78823740","78824026","chr17","77527440","77527703","28","1296300"
"chr3","78829925","78830151","chr17","77539781","77540005","8","1290144"
"chr3","78837150","78837452","chr17","77547014","77547318","5","1290136"
"chr3","78860191","78860482","chr17","77567945","77568230","10","1292246"
"chr3","78869828","78870126","chr17","77577659","77577957","5","1292169"
"chr3","78874661","78874966","chr17","77582489","77582795","11","1292172"
"chr3","78892114","78892372","chr17","77599793","77600064","18","1292321"
"chr3","78897105","78897386","chr17","77604769","77605050","8","1292336"
"chr3","78899301","78899614","chr17","77606635","77606937","30","1292666"
"chr3","78912965","78913087","chr17","77620099","77620229","10","1292866"
"chr3","78913886","78914157","chr17","77621055","77621319","12","1292831"
"chr3","78914778","78914936","chr17","77621940","77622098","1","1292838"
"chr3","78919347","78919658","chr17","77626853","77627164","11","1292494"
"chr3","78931880","78932173","chr17","77639651","77639944","8","1292229"
"chr3","78943323","78943609","chr17","77650403","77650689","7","1292920"
"chr3","78983433","78983734","chr17","77690701","77691002","10","1292732"
"chr3","78983744","78984028","chr9","51491182","51491455","71","27492562"
"chr3","79014008","79014193","chr1","11672372","11672556","38","67341636"
"chr3","79014252","79014531","chr17","77725401","77725679","9","1288851"
"chr3","79016512","79016821","chr17","77727684","77727964","42","1288828"
"chr3","79019192","79019493","chr17","77730330","77730626","17","1288862"
"chr3","79047656","79047950","chr17","77762997","77763292","10","1284659"
"chr3","79055723","79055854","chr17","77771344","77771474","5","1284379"
"chr3","79066335","79066639","chr17","77782174","77782473","16","1284161"
"chr3","79080626","79080688","chr17","77796811","77796873","0","1283815"
"chr3","79099304","79099582","chr17","77815965","77816243","12","1283339"
"chr3","79106350","79106645","chr17","77822698","77822995","15","1283652"
"chr3","79112268","79112564","chr17","77828817","77829114","7","1283451"
"chr3","79128939","79129218","chr17","77847265","77847550","21","1281674"
"chr3","79130916","79131194","chr17","77849247","77849525","12","1281669"
"chr3","79172474","79172620","chr17","77890192","77890338","1","1282282"
"chr3","79241820","79242144","chr17","77955834","77956141","24","1285986"
"chr3","79272633","79272941","chr17","77987018","77987326","8","1285615"
"chr3","79280863","79281166","chr17","77994935","77995246","21","1285928"
"chr3","79330724","79330840","chr20","22365523","22365636","18","56965201"
"chr3","79357800","79358090","chr17","78072934","78073220","7","1284866"
"chr3","79364329","79364610","chr17","78079471","78079752","9","1284858"
"chr3","79400573","79400832","chr17","78114446","78114712","23","1286127"
"chr3","79417081","79417354","chr17","78131437","78131717","12","1285644"
"chr3","79420958","79421257","chr17","78135346","78135652","18","1285612"
"chr3","79443385","79443680","chr17","78158071","78158370","19","1285314"
"chr3","79458451","79458748","chr7","14483821","14484118","67","64974630"
"chr3","79476251","79476414","chr3","178210714","178210870","33","98734463"
"chr3","79476715","79476756","chr2","156993426","156993469","11","77516711"
"chr3","79505979","79506096","chr17","78227711","78227823","7","1278268"
"chr3","79737475","79737782","chr17","78460241","78460542","20","1277234"
"chr3","79767633","79767886","chr17","78489974","78490221","19","1277659"
"chr3","79785233","79785541","chr17","78507533","78507828","19","1277700"
"chr3","79786661","79786970","chrX","10356749","10357062","62","69429912"
"chr3","79924134","79924313","chr17","78641141","78641320","7","1282993"
"chr3","79999133","79999437","chr17","78718668","78718971","13","1280465"
"chr3","80006935","80007114","chr17","78726580","78726759","4","1280355"
"chr3","80052780","80053088","chr17","78773804","78774114","13","1278976"
"chr3","80054737","80055016","chr9","5765156","5765435","63","74289581"
"chr3","80055017","80055060","chr7","91229681","91229728","8","11174664"
"chr3","80240932","80241102","chr7","91442882","91443040","47","11201950"
"chr3","80390649","80390954","chr17","79104306","79104600","26","1286343"
"chr3","80600069","80600196","chr17","79326660","79326787","2","1273409"
"chr3","80687887","80688183","chr13","41312881","41313177","55","39375006"
"chr3","80695291","80695593","chr17","79420289","79420587","10","1275002"
"chr3","80750171","80750303","chr17","79475810","79475927","24","1274361"
"chr3","80833102","80833393","chr17","79559117","79559413","14","1273985"
"chr3","80905830","80906099","chr17","79633334","79633623","29","1272496"
"chr3","81130442","81130739","chr17","79863668","79863977","26","1266774"
"chr3","81170007","81170239","chr17","79899607","79899838","5","1270400"
"chr3","81207784","81208081","chr17","79937743","79938040","8","1270041"
"chr3","81262927","81263078","chr17","79993686","79993837","5","1269241"
"chr3","81271777","81272067","chr17","80002550","80002840","3","1269227"
"chr3","81278247","81278521","chr17","80008972","80009246","3","1269275"
"chr3","81321834","81322140","chr17","80053652","80053959","11","1268182"
"chr3","81354328","81354611","chr17","80086760","80087037","13","1267568"
"chr3","81356834","81357144","chr17","80089271","80089580","9","1267563"
"chr3","81358976","81359095","chr17","80091412","80091531","1","1267564"
"chr3","81359130","81359289","chr17","80091566","80091721","12","1267564"
"chr3","81371903","81372129","chrX","122752694","122752910","48","41380791"
"chr3","81393207","81393480","chr20","9066762","9067027","61","72326445"
"chr3","81393493","81393766","chr20","9066762","9067027","61","72326731"
"chr3","81393842","81394149","chr17","80125937","80126251","14","1267905"
"chr3","81397529","81397819","chr17","80129632","80129919","14","1267897"
"chr3","81404328","81404610","chr7","42249233","42249525","72","39155095"
"chr3","81408078","81408319","chr17","80140184","80140425","9","1267894"
"chr3","81439538","81439652","chr17","80172450","80172564","1","1267088"
"chr3","81465898","81466128","chr17","80199901","80200130","8","1265997"
"chr3","81520581","81520892","chr17","80257299","80257619","21","1263282"
"chr3","81559953","81560250","chr17","80296276","80296570","6","1263677"
"chr3","81623671","81623955","chr17","80361340","80361621","16","1262331"
"chr3","81685190","81685346","chr17","80422026","80422186","11","1263164"
"chr3","81704939","81705169","chr17","80442290","80442523","17","1262649"
"chr3","82022597","82022889","chr17","80765965","80766256","3","1256632"
"chr3","82032566","82032847","chr17","80775626","80775908","10","1256940"
"chr3","82083344","82083643","chr17","80826305","80826590","20","1257039"
"chr3","82094983","82095289","chr17","80837260","80837557","22","1257723"
"chr3","82172461","82172662","chr17","80914431","80914639","33","1258030"
"chr3","82214751","82215053","chr17","80957640","80957942","8","1257111"
"chr3","82261381","82261680","chr17","81006012","81006316","16","1255369"
"chr3","82325219","82325524","chr17","81070150","81070455","12","1255069"
"chr3","82350258","82350554","chr17","81094717","81095009","12","1255541"
"chr3","82492252","82492546","chr17","81233795","81234089","7","1258457"
"chr3","82506646","82506941","chr17","81245669","81245960","14","1260977"
"chr3","82610994","82611292","chr17","81344787","81345082","12","1266207"
"chr3","82639591","82639834","chr8","86607933","86608182","51","3968342"
"chr3","82715827","82716102","chr11","92349408","92349696","65","9633581"
"chr3","82948690","82948828","chr17","81681134","81681271","6","1267556"
"chr3","83134337","83134628","chr17","81863853","81864149","11","1270484"
"chr3","83256085","83256392","chr17","81988464","81988772","19","1267621"
"chr3","83262039","83262194","chr17","81994976","81995144","16","1267063"
"chr3","83262220","83262383","chr17","81995176","81995337","12","1267044"
"chr3","83263652","83263835","chr17","81996614","81996797","2","1267038"
"chr3","83407644","83407959","chr13","41312881","41313177","74","42094763"
"chr3","83414169","83414266","chr11","110032530","110032623","20","26618361"
"chr3","83450725","83451035","chr8","69857809","69858115","68","13592916"
"chr3","83508164","83508444","chr17","82203484","82203764","6","1304680"
"chr3","83703387","83703547","chr17","82447529","82447690","7","1255858"
"chr3","83742518","83742730","chr17","82490408","82490622","10","1252110"
"chr3","83794467","83794719","chr3","33889164","33889417","62","49905303"
"chr3","83821091","83821255","chr1","128809526","128809667","41","44988435"
"chr3","83821333","83821454","chr17","82569629","82569750","2","1251704"
"chr3","83875643","83875817","chr17","82623628","82623802","5","1252015"
"chr3","84446235","84446321","chr17","83203174","83203260","0","1243061"
"chr3","84502100","84502231","chr17","83258883","83259014","8","1243217"
"chr3","84528975","84529285","chr7","122523991","122524302","64","37995016"
"chr3","84531748","84532061","chr17","83288533","83288847","9","1243215"
"chr3","84556414","84556618","chr17","83313212","83313402","17","1243202"
"chr3","84664838","84665053","chr17","83411935","83412151","24","1252903"
"chr3","84676859","84677120","chr17","83423859","83424120","2","1253000"
"chr3","84713118","84713416","chr17","83460399","83460697","10","1252719"
"chr3","84723469","84723731","chr17","83470711","83470973","8","1252758"
"chr3","84749302","84749606","chr11","49930351","49930650","53","34818951"
"chr3","84790146","84790450","chr17","83535501","83535811","20","1254645"
"chr3","84875220","84875473","chr17","83621141","83621396","9","1254079"
"chr3","84978478","84978601","chr17","83725731","83725854","4","1252747"
"chr3","85101939","85102246","chr17","83849289","83849595","15","1252650"
"chr3","85140321","85140613","chr12","92389430","92389722","48","7249109"
"chr3","85198625","85198914","chr17","83946753","83947053","22","1251872"
"chr3","85226348","85226480","chr17","83975209","83975341","1","1251139"
"chr3","85256879","85257187","chr17","84005106","84005423","21","1251773"
"chr3","85270546","85270874","chr17","84018735","84019037","40","1251811"
"chr3","85306303","85306576","chr17","84054414","84054696","24","1251889"
"chr3","85306715","85306790","chr17","84054833","84054908","1","1251882"
"chr3","85310780","85311067","chr17","84058639","84058928","10","1252141"
"chr3","85326868","85327167","chr17","84075445","84075731","27","1251423"
"chr3","85339798","85340105","chr17","84088328","84088630","16","1251470"
"chr3","85358718","85359016","chr17","84107688","84107992","21","1251030"
"chr3","85420374","85420687","chr17","84169409","84169688","47","1250965"
"chr3","85451635","85451929","chr17","84200520","84200814","10","1251115"
"chr3","85472897","85473184","chr17","84221775","84222080","27","1251122"
"chr3","85508495","85508805","chr17","84257551","84257862","6","1250944"
"chr3","85585696","85585980","chr17","84348884","84349172","8","1236812"
"chr3","85634472","85634780","chr17","84403462","84403771","13","1231010"
"chr3","85685653","85685913","chr15","22217770","22218022","70","63467883"
"chr3","85706911","85707212","chr17","84474795","84475086","23","1232116"
"chr3","85726052","85726339","chr17","84493720","84494027","24","1232332"
"chr3","85760418","85760686","chr8","139433213","139433475","65","53672795"
"chr3","85768172","85768475","chr17","84536301","84536578","36","1231871"
"chr3","85774761","85774883","chr1","28960240","28960358","27","56814521"
"chr3","85808062","85808244","chr17","84576395","84576576","11","1231667"
"chr3","85817589","85817889","chr17","84586254","84586550","12","1231335"
"chr3","85852580","85852875","chr17","84620640","84620935","7","1231940"
"chr3","85889290","85889573","chr17","84658329","84658612","12","1230961"
"chr3","85904816","85905133","chr17","84673706","84674020","13","1231110"
"chr3","85959397","85959560","chr17","84728091","84728259","18","1231306"
"chr3","85962129","85962439","chr17","84730722","84731037","17","1231407"
"chr3","86120017","86120200","chr4","123511019","123511203","37","37391002"
"chr3","86120239","86120375","chrX","108971246","108971363","35","22851007"
"chr3","86229607","86229912","chr17","85000030","85000342","23","1229577"
"chr3","86245784","86246058","chr17","85016207","85016492","20","1229577"
"chr3","86249812","86250088","chr7","141373771","141374045","63","55123959"
"chr3","86305102","86305221","chr3","44191768","44191893","25","42113334"
"chr3","86360201","86360349","chr17","85132133","85132281","4","1228068"
"chr3","86509985","86510266","chr17","85277748","85278029","4","1232237"
"chr3","86805582","86805874","chr17","85581641","85581942","17","1223941"
"chr3","86879761","86879840","chr17","85660203","85660282","1","1219558"
"chr3","86880143","86880372","chr17","85660583","85660803","21","1219560"
"chr3","87052186","87052455","chr17","85834452","85834712","24","1217734"
"chr3","87118796","87119099","chr17","85900917","85901220","11","1217879"
"chr3","87148058","87148383","chr13","84452913","84453227","70","2695145"
"chr3","87182993","87183152","chr1","26828797","26828955","32","60354196"
"chr3","87188230","87188530","chr17","85970871","85971171","15","1217359"
"chr3","87208892","87209201","chr17","85994394","85994707","4","1214498"
"chr3","87211872","87211996","chr4","17500554","17500677","22","69711318"
"chr3","87212049","87212224","chr1","152928618","152928784","39","65716569"
"chr3","87225537","87225831","chr17","86010515","86010821","23","1215022"
"chr3","87231129","87231457","chr17","86016876","86017167","56","1214253"
"chr3","87288283","87288476","chr17","86072880","86073073","4","1215403"
"chr3","87313990","87314281","chr17","86098958","86099249","8","1215032"
"chr3","87339808","87340111","chr17","86124624","86124929","17","1215184"
"chr3","87359473","87359791","chr11","107623443","107623751","70","20263970"
"chr3","87475719","87475927","chr10","26685083","26685268","65","60790636"
"chr3","87528198","87528339","chr17","86309996","86310136","1","1218202"
"chr3","87592888","87593183","chr19","16404298","16404593","58","71188590"
"chr3","87653872","87654159","chr17","86434657","86434948","12","1219215"
"chr3","87664751","87665042","chr17","86447287","86447581","11","1217464"
"chr3","87675240","87675559","chr17","86459812","86460144","21","1215428"
"chr3","87855101","87855278","chr3","125233005","125233176","25","37377904"
"chr3","87926778","87927022","chr1","136204419","136204661","64","48277641"
"chr3","87938919","87939183","chr17","86723095","86723359","13","1215824"
"chr3","87980682","87980812","chr17","86759502","86759632","0","1221180"
"chr3","87981110","87981282","chr17","86759930","86760097","8","1221180"
"chr3","88241379","88241688","chr17","87021189","87021503","23","1220190"
"chr3","88255660","88255757","chr6","34671589","34671687","27","53584071"
"chr3","88292843","88293010","chr17","87072364","87072534","8","1220479"
"chr3","88360504","88360653","chr17","87139457","87139610","10","1221047"
"chr3","88406076","88406370","chr17","87185621","87185909","11","1220455"
"chr3","88408720","88409027","chr17","87188041","87188344","14","1220679"
"chr3","88422076","88422377","chr17","87201481","87201779","9","1220595"
"chr3","88425291","88425602","chr17","87204670","87204991","20","1220621"
"chr3","88608309","88608623","chr17","87385913","87386231","18","1222396"
"chr3","88619372","88619600","chr17","87397331","87397561","8","1222041"
"chr3","88659447","88659737","chr17","87437632","87437922","8","1221815"
"chr3","88699023","88699323","chr4","55862516","55862820","53","32836507"
"chr3","88768840","88769108","chr11","96500412","96500682","64","7731572"
"chr3","88774515","88774536","chr11","109627400","109627417","5","20852885"
"chr3","88780810","88781108","chr17","87562554","87562860","16","1218256"
"chr3","88798209","88798512","chr5","36164004","36164312","56","52634205"
"chr3","88805562","88805873","chr17","87589375","87589674","20","1216187"
"chr3","88815686","88815985","chr17","87599656","87599952","11","1216030"
"chr3","88822275","88822454","chr17","87606044","87606223","7","1216231"
"chr3","88822778","88822910","chr17","87606520","87606651","8","1216258"
"chr3","88828135","88828256","JH682662","6020","6141","25","88822115"
"chr3","88829808","88830050","chr17","87613314","87613559","8","1216494"
"chr3","88840790","88841101","chrX","10358011","10358318","54","78482779"
"chr3","88890637","88890950","chr11","641193","641502","66","88249444"
"chr3","88914634","88914810","chr1","163126356","163126532","42","74211722"
"chr3","88941437","88941584","chr17","87719481","87719614","18","1221956"
"chr3","88952887","88953111","chr17","87731362","87731586","6","1221525"
"chr3","88976165","88976466","chr17","87756157","87756457","16","1220008"
"chr3","88985096","88985398","chr17","87765110","87765413","13","1219986"
"chr3","89020006","89020298","chr17","87800979","87801273","13","1219027"
"chr3","89035182","89035491","chr17","87816888","87817197","12","1218294"
"chr3","89067150","89067414","chr14","11758420","11758684","45","77308730"
"chr3","89114071","89114244","chr17","87897284","87897438","30","1216787"
"chr3","89114552","89114584","chr17","87897755","87897787","2","1216797"
"chr3","89134219","89134400","chr17","87917598","87917780","6","1216621"
"chr3","89142696","89142748","chr9","92760983","92761036","10","3618287"
"chr3","89217993","89218161","chr17","87991357","87991525","6","1226636"
"chr3","89256887","89257199","chr17","88030182","88030496","13","1226705"
"chr3","89274252","89274542","chr17","88047721","88048010","6","1226531"
"chr3","89423217","89423384","chr15","7144806","7144976","5","82278411"
"chr3","89479403","89479550","chr17","88251939","88252086","8","1227464"
"chr3","89500683","89500867","chr17","88273343","88273538","17","1227340"
"chr3","89511012","89511315","chr17","88284073","88284373","14","1226939"
"chr3","89511616","89511925","chr17","88284674","88284985","10","1226942"
"chr3","89716604","89716910","chr17","88507291","88507595","13","1209313"
"chr3","89757357","89757638","chr17","88550202","88550485","8","1207155"
"chr3","89913161","89913470","chr3","153060925","153061233","56","63147764"
"chr3","89931325","89931616","chr9","90919856","90920141","51","988531"
"chr3","89996711","89997001","chr17","88709382","88709676","18","1287329"
"chr3","89998632","89998888","chr17","88711296","88711555","9","1287336"
"chr3","90007385","90007597","chr17","88719898","88720112","14","1287487"
"chr3","90029723","90030024","chr17","88742198","88742500","9","1287525"
"chr3","90215445","90215803","chrX","11175740","11176098","96","79039705"
"chr3","90344175","90344353","chr11","115616045","115616222","42","25271870"
"chr3","90451884","90452157","chr17","89160684","89160973","30","1291200"
"chr3","90460093","90460382","chr17","89168943","89169241","31","1291150"
"chr3","90519234","90519532","chr17","89236986","89237284","5","1282248"
"chr3","90576659","90576957","chr17","89294462","89294768","15","1282197"
"chr3","90620955","90621242","chr2","97022915","97023209","49","6401960"
"chr3","90642881","90643170","chr17","89365813","89366110","20","1277068"
"chr3","90646471","90646788","chr17","89369680","89369999","16","1276791"
"chr3","90657146","90657447","chr17","89379839","89380137","13","1277307"
"chr3","90770150","90770452","chr17","89495087","89495389","8","1275063"
"chr3","90827723","90827922","chr17","89549757","89549955","8","1277966"
"chr3","91007126","91007316","chr3","50661547","50661720","55","40345579"
"chr3","91043230","91043506","chr17","89766752","89767033","12","1276478"
"chr3","91044289","91044591","chr17","89767817","89768110","24","1276472"
"chr3","91189749","91189879","chr19","4725810","4725943","27","86463939"
"chr3","91216055","91216229","chr17","89935352","89935526","2","1280703"
"chr3","91241069","91241357","chr8","27951401","27951689","76","63289668"
"chr3","91245965","91246257","chr11","49930351","49930650","68","41315614"
"chr3","91252989","91253283","chr17","89973462","89973756","13","1279527"
"chr3","91274156","91274425","chr17","90003619","90003888","10","1270537"
"chr3","91278599","91278912","chr17","90004178","90004491","5","1274421"
"chr3","91279510","91279798","chr17","90005068","90005377","33","1274442"
"chr3","91289325","91289410","chr17","90016057","90016142","2","1273268"
"chr3","91292949","91293297","chr17","90019711","90020081","28","1273238"
"chr3","91299653","91299787","chr1","19501947","19502059","41","71797706"
"chr3","91325012","91325233","chr17","90056068","90056294","12","1268944"
"chr3","91332954","91333094","chr17","90065624","90065764","2","1267330"
"chr3","91333156","91333430","chr10","29047313","29047589","53","62285843"
"chr3","91338700","91338948","chr17","90071019","90071267","15","1267681"
"chr3","91339993","91340221","chr17","90072366","90072588","12","1267627"
"chr3","91344139","91344422","chr17","90075621","90075904","5","1268518"
"chr3","91345088","91345387","chr17","90076570","90076870","15","1268518"
"chr3","91354375","91354556","chr2","113767336","113767527","49","22412961"
"chr3","91372878","91373048","chr17","90106322","90106504","22","1266556"
"chr3","91396552","91396861","chr17","90129192","90129504","9","1267360"
"chr3","91412986","91413286","chr17","90147207","90147489","27","1265779"
"chr3","91441248","91441424","chr17","90173024","90173197","12","1268224"
"chr3","91466537","91466826","chr1","211157005","211157261","83","119690468"
"chr3","91551083","91551375","chrX","34352442","34352735","2","57198641"
"chr3","91574303","91574531","chr9","94815349","94815573","53","3241046"
"chr3","91586095","91586396","chr17","90312878","90313157","34","1273217"
"chr3","91588558","91588849","chr17","90315244","90315538","7","1273314"
"chr3","91630113","91630207","chr6","61113512","61113607","18","30516601"
"chr3","91671017","91671311","chr17","90396599","90396893","6","1274418"
"chr3","91779921","91780231","chr17","90514548","90514858","9","1265373"
"chr3","91860394","91860688","chr17","90600421","90600715","5","1259973"
"chr3","91926680","91926834","chr1","179541903","179542057","25","87615223"
"chr3","92014376","92014685","chr17","90763493","90763794","15","1250883"
"chr3","92023299","92023606","chr17","90772900","90773204","11","1250399"
"chr3","92036116","92036365","chr20","55847454","55847701","67","36188662"
"chr3","92067717","92067999","chr11","57959300","57959586","72","34108417"
"chr3","92078613","92078718","chr17","90831145","90831250","1","1247468"
"chr3","92078911","92079172","chr17","90831716","90832005","37","1247195"
"chr3","92108071","92108387","chr17","90863119","90863435","8","1244952"
"chr3","92133063","92133331","chr17","90886826","90887096","17","1246237"
"chr4","73531262","73531440","chr6","73380568","73380746","1","150694"
"chr4","85065516","85065834","chr15","6856227","6856545","75","78209289"
"chr4","85589873","85590180","chr6","85716580","85716887","14","126707"
"chr4","3895","4218","JH680099","30662","30966","31","26767"
"chr4","9180","9392","JH680099","35924","36136","3","26744"
"chr4","70071","70391","chr6","1398434","1398751","23","1328363"
"chr4","95293","95434","chr5","46320987","46321125","27","46225694"
"chr4","97129","97354","chr6","1371109","1371336","10","1273980"
"chr4","100910","101203","chr7","160826985","160827290","52","160726075"
"chr4","104682","104995","chr6","1362787","1363097","11","1258105"
"chr4","160258","160530","chr6","1308144","1308418","13","1147886"
"chr4","171074","171350","chr6","1282372","1282691","52","1111298"
"chr4","183697","183748","chr1","100928185","100928237","12","100744488"
"chr4","183749","183887","chr6","843654","843780","41","659905"
"chr4","183918","184226","chr6","10461","10765","12","173457"
"chr4","187254","187459","chr15","75133308","75133523","48","74946054"
"chr4","188822","189082","chr6","1259273","1259532","7","1070451"
"chr4","191552","191846","chr6","1258068","1258368","19","1066516"
"chr4","213503","213672","chr3","171610924","171611096","40","171397421"
"chr4","213770","213949","chr6","96365","96558","19","117405"
"chr4","236376","236565","chr6","120075","120264","5","116301"
"chr4","237539","237670","chr6","121240","121371","4","116299"
"chr4","388774","388977","chr6","278441","278645","13","110333"
"chr4","391847","392122","chr6","281586","281875","26","110261"
"chr4","462546","462713","chr6","65396254","65396415","36","64933708"
"chr4","598166","598459","chr6","522013","522301","18","76153"
"chr4","620159","620461","chr6","522013","522301","59","98146"
"chr4","719224","719363","chr6","585601","585741","3","133623"
"chr4","747411","747638","chr4","107291460","107291686","50","106544049"
"chr4","805112","805369","chr6","666805","667055","13","138307"
"chr4","918111","918270","chr1","117354983","117355144","40","116436872"
"chr4","1060137","1060343","chr6","928155","928359","8","131982"
"chr4","1126870","1127167","chr6","996855","997152","5","130015"
"chr4","1131232","1131518","chr6","1001027","1001313","0","130205"
"chr4","1160381","1160671","chr6","1030877","1031167","9","129504"
"chr4","1170281","1170590","chr6","1040718","1041032","15","129563"
"chr4","1190254","1190565","chr6","1061459","1061771","8","128795"
"chr4","1194739","1195030","chr6","1065931","1066209","20","128808"
"chr4","1241383","1241686","chr6","1114633","1114936","4","126750"
"chr4","1260632","1260918","chr6","1133634","1133923","10","126998"
"chr4","1381786","1382081","chr6","1258068","1258368","14","123718"
"chr4","1382980","1383240","chr6","18995","19255","4","1363985"
"chr4","1384600","1384872","chr6","1260838","1261108","13","123762"
"chr4","1398039","1398344","chr6","10461","10765","7","1387578"
"chr4","1398386","1398513","chr3","44071606","44071723","31","42673220"
"chr4","1398514","1398565","chr1","100928185","100928237","11","99529671"
"chr4","1407156","1407477","chr6","1282372","1282691","9","124784"
"chr4","1424851","1425123","chr6","1308144","1308418","19","116707"
"chr4","1464874","1465183","chr6","52729","53028","21","1412145"
"chr4","1467074","1467287","chr6","35662","35884","18","1431412"
"chr4","1473352","1473565","chr6","35662","35884","18","1437690"
"chr4","1543806","1544117","chr6","1515325","1515636","6","28481"
"chr4","1553007","1553326","chr9","113740769","113741081","61","112187762"
"chr4","1574109","1574458","chr2","88177448","88177811","97","86603339"
"chr4","1617798","1618063","chr6","1597242","1597499","12","20556"
"chr4","1634942","1635245","chr6","1615098","1615395","14","19844"
"chr4","1647546","1647849","chr6","1627614","1627917","11","19932"
"chr4","1789161","1789453","chr6","1772156","1772451","22","17005"
"chr4","2091372","2091648","chr6","2094988","2095281","26","3616"
"chr4","2117064","2117336","chr6","2123211","2123486","12","6147"
"chr4","2306487","2306776","chr6","2314021","2314313","19","7534"
"chr4","2346245","2346547","chr6","2355824","2356142","24","9579"
"chr4","2368244","2368609","chr6","2378032","2378398","19","9788"
"chr4","2467326","2467633","chr6","2477391","2477703","13","10065"
"chr4","2520052","2520276","chr6","2534792","2535014","8","14740"
"chr4","2835807","2836119","chr6","2855218","2855531","13","19411"
"chr4","2881337","2881657","chr6","2900649","2900957","16","19312"
"chr4","2912397","2912708","chr6","2931049","2931362","23","18652"
"chr4","2927371","2927551","chr6","2946318","2946495","14","18947"
"chr4","2927835","2927969","chr1","29633027","29633165","23","26705192"
"chr4","3044821","3045116","chr6","3067079","3067374","12","22258"
"chr4","3050730","3050890","chr6","3072966","3073123","11","22236"
"chr4","3052059","3052139","chr6","3073641","3073711","13","21582"
"chr4","3256639","3256908","chr1","54838215","54838487","76","51581576"
"chr4","3396338","3396649","chr6","3420653","3420960","15","24315"
"chr4","3401578","3401890","chr4","69458363","69458685","75","66056785"
"chr4","3419805","3420086","chr6","3444412","3444693","6","24607"
"chr4","3446099","3446389","chr6","3470800","3471091","10","24701"
"chr4","3448223","3448379","chr6","3472931","3473087","6","24708"
"chr4","3586797","3587108","chr6","3610964","3611275","7","24167"
"chr4","3596895","3597222","chr6","3621767","3622093","19","24872"
"chr4","3693460","3693621","chr16","16228419","16228575","33","12534959"
"chr4","3842165","3842425","chr6","3865276","3865537","20","23111"
"chr4","3855674","3855940","chr6","3876371","3876658","28","20697"
"chr4","3894856","3895163","chr6","3916131","3916437","28","21275"
"chr4","3901915","3902213","chr6","3923262","3923556","18","21347"
"chr4","4037502","4037768","chr6","4075320","4075580","11","37818"
"chr4","4040808","4041088","chr6","4079165","4079443","17","38357"
"chr4","4115138","4115431","chr6","4155783","4156086","23","40645"
"chr4","4316663","4316925","chr4","111698877","111699152","78","107382214"
"chr4","4317758","4318041","chr6","4357880","4358167","25","40122"
"chr4","4358659","4358949","chr6","4402640","4402926","13","43981"
"chr4","4396113","4396391","chr6","4440053","4440331","5","43940"
"chr4","4529519","4529705","chr6","4571041","4571228","7","41522"
"chr4","4541261","4541434","chr6","4582491","4582652","36","41230"
"chr4","4560861","4561134","chr7","159550513","159550789","62","154989652"
"chr4","4688257","4688427","chr1","66887413","66887590","36","62199156"
"chr4","4688494","4688624","chr6","72416569","72416704","31","67728075"
"chr4","4741835","4742119","chr6","4796746","4797030","8","54911"
"chr4","4756541","4756852","chr6","4819625","4819936","14","63084"
"chr4","4771505","4771808","chr6","4836386","4836687","11","64881"
"chr4","4920375","4920591","chr6","4988379","4988599","5","68004"
"chr4","4922224","4922518","chr6","4990216","4990509","12","67992"
"chr4","4986714","4986999","chr6","5054976","5055261","17","68262"
"chr4","5021264","5021584","chr6","5094166","5094463","38","72902"
"chr4","5063135","5063466","chr6","5136064","5136388","17","72929"
"chr4","5137520","5137671","chr6","5212602","5212753","2","75082"
"chr4","5167176","5167278","chr17","76517363","76517464","23","71350187"
"chr4","5167354","5167428","chr6","82279521","82279590","18","77112167"
"chr4","5172727","5172987","chr6","5248107","5248369","7","75380"
"chr4","5311651","5311850","chr6","5383407","5383605","6","71756"
"chr4","5312200","5312298","chr6","5383966","5384064","1","71766"
"chr4","5329066","5329355","chr6","5401244","5401542","21","72178"
"chr4","5407825","5408118","chr1","41710844","41711137","58","36303019"
"chr4","5556999","5557287","chr6","5632108","5632390","14","75109"
"chr4","5637031","5637349","chr6","5713394","5713676","55","76363"
"chr4","5687865","5688144","chr6","5764103","5764393","18","76238"
"chr4","5689393","5689673","chr6","5765643","5765923","11","76250"
"chr4","5729586","5729890","chr6","5806620","5806917","15","77034"
"chr4","5911009","5911311","chr6","5989776","5990080","19","78767"
"chr4","6023946","6024251","chr6","6104173","6104464","26","80227"
"chr4","6111686","6111975","chr6","6192994","6193272","17","81308"
"chr4","6209481","6209771","chr6","6289601","6289893","12","80120"
"chr4","6236612","6236804","chr6","6317094","6317286","5","80482"
"chr4","6256591","6256776","chr6","6336770","6336955","6","80179"
"chr4","6290459","6290772","chr6","6370824","6371133","13","80365"
"chr4","6308091","6308381","chr6","6389441","6389714","24","81350"
"chr4","6319415","6319534","chr19","17732018","17732136","30","11412603"
"chr4","6322181","6322485","chr6","6403490","6403795","17","81309"
"chr4","6331238","6331548","chr6","6412531","6412832","19","81293"
"chr4","6379450","6379740","chr6","6461943","6462220","20","82493"
"chr4","6654509","6654786","chr6","6755906","6756183","3","101397"
"chr4","6671041","6671344","chr6","6771959","6772260","15","100918"
"chr4","6809247","6809460","chr6","6910700","6910913","6","101453"
"chr4","6850673","6850976","chrX","38012671","38012974","3","31161998"
"chr4","6899765","6900056","chr6","7002055","7002344","15","102290"
"chr4","6945067","6945372","chr6","7046363","7046668","9","101296"
"chr4","6964449","6964740","chr6","7065369","7065651","14","100920"
"chr4","6979856","6980132","chr6","7080939","7081215","10","101083"
"chr4","7093091","7093161","chr6","7193047","7193119","3","99956"
"chr4","7093164","7093283","chr6","7193122","7193241","1","99958"
"chr4","7093346","7093654","chr6","7193310","7193620","10","99964"
"chr4","7191057","7191273","chr4","123511019","123511203","53","116319962"
"chr4","7264568","7264748","chr6","7363780","7363958","7","99212"
"chr4","7324828","7325137","chr6","7424719","7425029","8","99891"
"chr4","7393807","7394095","chr6","7493701","7493988","12","99894"
"chr4","7404343","7404633","chr6","7504189","7504495","24","99846"
"chr4","7408067","7408171","chr6","7507907","7508011","2","99840"
"chr4","7417557","7417873","chr6","7517621","7517937","9","100064"
"chr4","7557253","7557559","chr2","76587906","76588205","62","69030653"
"chr4","7562617","7562790","chr6","7664519","7664690","15","101902"
"chr4","7563074","7563084","chr1","166255009","166255020","2","158691935"
"chr4","7563278","7563584","chr6","7665167","7665475","19","101889"
"chr4","7602947","7603255","chr6","7710264","7710563","17","107317"
"chr4","7721234","7721544","chrX","41341410","41341721","55","33620176"
"chr4","7843706","7843869","chr6","7986569","7986738","15","142863"
"chr4","7926718","7926980","chr6","8077855","8078130","23","151137"
"chr4","7953507","7953776","chr6","8104030","8104299","3","150523"
"chr4","8440748","8440955","chr6","8686389","8686600","11","245641"
"chr4","8596800","8597059","chr14","107640563","107640819","49","99043763"
"chr4","8624407","8624695","chr6","8835935","8836231","14","211528"
"chr4","8783670","8783809","chr6","8998847","8998986","7","215177"
"chr4","8849680","8849987","chr6","9065141","9065416","40","215461"
"chr4","8866902","8867195","chr6","9081896","9082189","8","214994"
"chr4","8868452","8868733","chr6","9083413","9083710","28","214961"
"chr4","9022047","9022207","chr4","153678863","153679021","38","144656816"
"chr4","9024663","9024829","chr2","87062754","87062911","41","78038091"
"chr4","9135403","9135616","chr6","9356767","9356945","43","221364"
"chr4","9135912","9136040","chr6","9357244","9357372","4","221332"
"chr4","9359158","9359517","chr3","46330527","46330868","102","36971369"
"chr4","9394452","9394739","chr6","9635594","9635874","34","241142"
"chr4","9578649","9578947","chr6","9820460","9820758","17","241811"
"chr4","9597573","9597703","chr6","9837925","9838055","5","240352"
"chr4","9661019","9661311","chr6","9902325","9902618","13","241306"
"chr4","9681692","9681994","chr6","9922978","9923281","4","241286"
"chr4","9682786","9683088","chr6","9924072","9924380","16","241286"
"chr4","9694966","9695259","chr6","9936340","9936633","9","241374"
"chr4","9713280","9713587","chr6","9954653","9954951","16","241373"
"chr4","9749631","9749907","chr6","9990411","9990683","11","240780"
"chr4","9750711","9751000","chr6","9991488","9991776","22","240777"
"chr4","9782418","9782719","chr2","87211548","87211856","51","77429130"
"chr4","9805332","9805615","chr6","10045870","10046153","11","240538"
"chr4","9805897","9806064","chr15","348992","349161","37","9456905"
"chr4","9806373","9806456","chr1","200695508","200695592","19","190889135"
"chr4","9807461","9807517","chr6","10047699","10047752","4","240238"
"chr4","9809867","9810173","chr6","10050073","10050412","49","240206"
"chr4","9819963","9820273","chr6","10060645","10060956","13","240682"
"chr4","9823152","9823455","chr6","10063854","10064154","7","240702"
"chr4","9829284","9829598","chr6","10070836","10071151","13","241552"
"chr4","9834807","9835068","chr14","5858963","5859236","68","3975844"
"chr4","9840521","9840827","chr6","10083640","10083923","33","243119"
"chr4","9843251","9843434","chr3","95183300","95183488","43","85340049"
"chr4","9849178","9849398","chr6","10092331","10092549","27","243153"
"chr4","9852758","9853005","chr6","10095108","10095355","5","242350"
"chr4","9853668","9853969","chr6","10096013","10096314","8","242345"
"chr4","9862396","9862698","chr10","83020392","83020689","69","73157996"
"chr4","9863986","9864279","chr6","10105317","10105609","13","241331"
"chr4","9875327","9875583","chr6","10117502","10117765","14","242175"
"chr4","9889100","9889221","chr6","10129561","10129682","4","240461"
"chr4","9889256","9889419","chr6","10129714","10129875","4","240458"
"chr4","9906329","9906546","chr6","10148122","10148341","8","241793"
"chr4","9906835","9906939","chr6","10148627","10148731","6","241792"
"chr4","9929148","9929447","chr6","10170951","10171262","16","241803"
"chr4","9945008","9945302","chr6","10187111","10187405","5","242103"
"chr4","9949467","9949759","chr19","10459575","10459867","58","510108"
"chr4","9954922","9955223","chr6","10197032","10197339","10","242110"
"chr4","10015322","10015612","chr6","10258669","10258960","8","243347"
"chr4","10020882","10021184","chr6","10263947","10264252","16","243065"
"chr4","10084628","10084802","chr6","10329079","10329226","30","244451"
"chr4","10089538","10089835","chr6","10333456","10333753","10","243918"
"chr4","10107305","10107607","chr6","10351203","10351510","17","243898"
"chr4","10112719","10113026","chr6","10356615","10356924","13","243896"
"chr4","10131244","10131547","chr6","10375421","10375737","18","244177"
"chr4","10144627","10144922","chr6","10388733","10388997","42","244106"
"chr4","10193014","10193304","chr6","10440280","10440568","10","247266"
"chr4","10259837","10260127","chr6","10508306","10508595","5","248469"
"chr4","10274591","10274877","chr6","10523381","10523678","24","248790"
"chr4","10311509","10311715","chr6","10560633","10560852","19","249124"
"chr4","10441592","10441694","chr6","10690093","10690186","12","248501"
"chr4","10441973","10442180","chr6","10690470","10690682","7","248497"
"chr4","10455941","10456044","chr8","90424021","90424120","22","79968080"
"chr4","10504716","10505017","chr2","85895640","85895939","47","75390924"
"chr4","10666263","10666562","chr6","10921276","10921575","5","255013"
"chr4","10692483","10692753","chr6","10947466","10947771","39","254983"
"chr4","10850858","10851162","chr6","11104289","11104588","6","253431"
"chr4","10855481","10855705","chr6","11108899","11109117","9","253418"
"chr4","10984291","10984601","chr16","9991947","9992246","75","992344"
"chr4","11001286","11001467","chr6","11253885","11254064","5","252599"
"chr4","11001499","11001618","chr6","11254105","11254238","22","252606"
"chr4","11016106","11016276","chr6","11269384","11269557","5","253278"
"chr4","11083118","11083399","chr6","11337677","11337957","18","254559"
"chr4","11120333","11120619","chr6","11376711","11376997","10","256378"
"chr4","11209290","11209591","chr6","11465685","11465986","9","256395"
"chr4","11266780","11267074","chr6","85093499","85093798","60","73826719"
"chr4","11354025","11354336","chr6","11609939","11610250","8","255914"
"chr4","11356235","11356527","chr6","11612138","11612430","5","255903"
"chr4","11441162","11441200","chr5","75142717","75142755","7","63701555"
"chr4","11721474","11721760","chr6","11975994","11976279","10","254520"
"chr4","11756059","11756152","chr11","97618455","97618548","33","85862396"
"chr4","11779467","11779774","chr6","12036716","12037023","16","257249"
"chr4","11851557","11851794","chr6","12123384","12123611","22","271827"
"chr4","11888087","11888362","chr6","12159701","12159976","10","271614"
"chr4","12077547","12077845","chr6","12350074","12350361","18","272527"
"chr4","12092243","12092553","chr6","12365770","12366075","10","273527"
"chr4","12145866","12146026","chr6","12418900","12419048","15","273034"
"chr4","12216889","12216982","chr13","84324846","84324926","28","72107957"
"chr4","12505216","12505511","chr6","12822916","12823215","16","317700"
"chr4","12585096","12585378","chr6","12894064","12894364","21","308968"
"chr4","12602414","12602640","chr6","12911334","12911560","8","308920"
"chr4","12760074","12760363","chr6","13080756","13081029","26","320682"
"chr4","12765443","12765732","chr3","179399156","179399444","61","166633713"
"chr4","12946440","12946731","chr6","13250642","13250933","15","304202"
"chr4","12960868","12961147","chr6","13265962","13266241","3","305094"
"chr4","13057818","13058120","chr6","13360989","13361301","11","303171"
"chr4","13119237","13119532","chr6","13421701","13421990","21","302464"
"chr4","13201750","13202042","chr3","151266637","151266939","63","138064887"
"chr4","13328672","13328983","chr6","13633995","13634307","20","305323"
"chr4","13431892","13432176","chr6","13739092","13739375","14","307200"
"chr4","13531223","13531516","chr6","13837709","13838012","29","306486"
"chr4","13562369","13562542","chr6","113014437","113014607","33","99452068"
"chr4","13562593","13562713","chr20","8874765","8874883","17","4687828"
"chr4","13611280","13611593","chr6","13913263","13913576","11","301983"
"chr4","13653512","13653814","chr6","13960168","13960468","18","306656"
"chr4","13683146","13683444","chr6","13991259","13991557","4","308113"
"chr4","13728694","13728773","chr6","14036702","14036779","9","308008"
"chr4","13728801","13728818","chr7","129870058","129870073","4","116141257"
"chr4","13734572","13734864","chr6","14042630","14042915","12","308058"
"chr4","13749273","13749582","chr6","14057355","14057665","11","308082"
"chr4","13750258","13750539","chr6","14058347","14058623","10","308089"
"chr4","13750580","13750611","chr1","15538255","15538285","1","1787675"
"chr4","13757031","13757183","chr6","14065213","14065365","8","308182"
"chr4","13773377","13773662","chr6","14081899","14082184","7","308522"
"chr4","13775695","13775859","chr6","14084191","14084358","11","308496"
"chr4","13783594","13783733","chr14","54224942","54225083","29","40441348"
"chr4","13783744","13784066","chr6","14091837","14092160","11","308093"
"chr4","13802211","13802515","chr6","14110092","14110396","6","307881"
"chr4","13861399","13861691","chr6","135409832","135410130","60","121548433"
"chr4","13878567","13878696","chr4","25154348","25154476","29","11275781"
"chr4","13879064","13879325","chr5","101656489","101656740","65","87777425"
"chr4","13882091","13882388","chr6","14187232","14187529","15","305141"
"chr4","13895337","13895574","chr6","14200838","14201092","22","305501"
"chr4","13909955","13910250","chr7","151784762","151785058","59","137874807"
"chr4","13937461","13937757","chr10","90862942","90863239","51","76925481"
"chr4","13958499","13958800","chr6","14263421","14263723","10","304922"
"chr4","13995475","13995539","chr7","156214748","156214806","19","142219273"
"chr4","14041832","14042109","chr6","14346815","14347127","42","304983"
"chr4","14128968","14129095","chr9","8339378","8339502","26","5789590"
"chr4","14130129","14130225","chr11","92758608","92758706","19","78628479"
"chr4","14205054","14205338","chr6","14509501","14509784","43","304447"
"chr4","14220580","14220808","chr1","28103093","28103316","57","13882513"
"chr4","14220964","14221039","chr9","119932467","119932539","12","105711503"
"chr4","14274150","14274299","chr10","31821200","31821336","43","17547050"
"chr4","14325584","14325869","chr6","14633995","14634284","13","308411"
"chr4","14348423","14348722","chr6","14657178","14657473","10","308755"
"chr4","14353415","14353706","chr6","14662205","14662490","19","308790"
"chr4","14363175","14363473","chr6","14671987","14672286","7","308812"
"chr4","14365305","14365588","chr1","28978297","28978584","61","14612992"
"chr4","14458277","14458589","chr6","14768666","14768996","30","310389"
"chr4","14498430","14498709","chr6","14808544","14808823","8","310114"
"chr4","14508351","14508637","chr8","10034943","10035230","51","4473408"
"chr4","14509541","14509850","chr6","14820404","14820714","12","310863"
"chr4","14513765","14514071","chr6","14824622","14824915","16","310857"
"chr4","14541840","14542154","chr6","14852701","14853015","15","310861"
"chr4","14544574","14544800","chrX","63326444","63326665","62","48781870"
"chr4","14600167","14600476","chr6","14912758","14913067","17","312591"
"chr4","14617192","14617501","chr6","14930344","14930656","9","313152"
"chr4","14703034","14703157","chr6","15016487","15016619","10","313453"
"chr4","14778586","14778862","chr6","109764005","109764287","51","94985419"
"chr4","14914573","14914885","chr6","15234192","15234503","8","319619"
"chr4","15175208","15175520","chr6","15495669","15495980","17","320461"
"chr4","15563649","15563913","chr6","15892722","15892995","13","329073"
"chr4","15574936","15575231","chr6","15907612","15907917","18","332676"
"chr4","15731188","15731486","chr6","16066247","16066544","9","335059"
"chr4","15864209","15864406","chr6","16199787","16199985","14","335578"
"chr4","15872578","15872744","chr6","16208666","16208832","15","336088"
"chr4","15896043","15896305","chr6","16232098","16232360","11","336055"
"chr4","16017516","16017810","chr6","16353971","16354272","36","336455"
"chr4","16129445","16129716","chr6","16462120","16462394","13","332675"
"chr4","16141763","16142042","chr6","16474358","16474635","13","332595"
"chr4","16181075","16181376","chr6","16513104","16513405","12","332029"
"chr4","16192065","16192383","chr8","39146228","39146535","66","22954163"
"chr4","16302872","16303129","chr6","16640663","16640920","12","337791"
"chr4","16307742","16307954","chr6","16645537","16645752","12","337795"
"chr4","16335001","16335293","chr6","16673585","16673883","13","338584"
"chr4","16349394","16349522","chr14","63745594","63745727","29","47396200"
"chr4","16353453","16353670","chr4","42686105","42686316","55","26332652"
"chr4","16365672","16365945","chr6","16706328","16706593","14","340656"
"chr4","16376666","16376967","chr6","16717290","16717591","10","340624"
"chr4","16420462","16420623","chr6","16762742","16762891","17","342280"
"chr4","16420941","16421077","chr6","16763208","16763343","6","342267"
"chr4","16429596","16429752","chr6","162057264","162057420","37","145627668"
"chr4","16430074","16430375","chr6","16772538","16772838","8","342464"
"chr4","16441092","16441424","chr6","16783987","16784292","39","342895"
"chr4","16444013","16444305","chr6","16786872","16787161","16","342859"
"chr4","16447119","16447417","chr6","16791483","16791785","16","344364"
"chr4","16475835","16476132","chr6","16819421","16819725","25","343586"
"chr4","16476142","16476436","chr6","16819730","16820024","4","343588"
"chr4","16477621","16477906","chr6","16821206","16821490","14","343585"
"chr4","16484549","16484852","chr6","16828517","16828822","10","343968"
"chr4","16490981","16491271","chr6","16835170","16835459","7","344189"
"chr4","16511957","16512243","chr6","16859938","16860223","3","347981"
"chr4","16520013","16520311","chr6","16867542","16867836","12","347529"
"chr4","16536676","16536976","chr6","16884097","16884393","15","347421"
"chr4","16544504","16544807","chr6","16891301","16891583","29","346797"
"chr4","16557428","16557737","chr6","16903974","16904274","31","346546"
"chr4","16561567","16561689","chr6","101945870","101945995","22","85384303"
"chr4","16562261","16562405","chr14","109000001","109000136","37","92437740"
"chr4","16596206","16596508","chr6","16942833","16943140","34","346627"
"chr4","16604611","16604842","chr6","16952661","16952916","32","348050"
"chr4","16627282","16627575","chr6","16975925","16976215","7","348643"
"chr4","16628694","16628788","chr6","16977345","16977439","3","348651"
"chr4","16630190","16630450","chr1","64867733","64867995","40","48237543"
"chr4","16649626","16649812","chr6","16998519","16998700","29","348893"
"chr4","16654584","16654895","chr6","17000001","17000264","59","345417"
"chr4","16656058","16656366","chr6","17001666","17001966","18","345608"
"chr4","16661209","16661494","chr6","17006588","17006876","9","345379"
"chr4","16662622","16662956","chr6","17008006","17008340","8","345384"
"chr4","16667150","16667408","chr2","78855951","78856210","54","62188801"
"chr4","16669604","16669776","chr6","17015291","17015463","3","345687"
"chr4","16685763","16686064","chr6","17030487","17030764","32","344724"
"chr4","16687914","16688229","chr6","17035655","17035932","50","347741"
"chr4","16688232","16688512","chr9","59535695","59535971","61","42847463"
"chr4","16690577","16690747","chr6","17038716","17038886","5","348139"
"chr4","16693770","16693902","chr6","17041903","17042035","7","348133"
"chr4","16710439","16710749","chr6","17060172","17060476","13","349733"
"chr4","16716511","16716809","chr6","17066881","17067179","4","350370"
"chr4","16719308","16719504","chr6","17069659","17069851","8","350351"
"chr4","16722863","16723071","chr6","17073557","17073765","7","350694"
"chr4","16737343","16737634","chr6","17089530","17089824","27","352187"
"chr4","16745088","16745153","chr14","47529196","47529259","12","30784108"
"chr4","16745578","16745803","chr14","4622540","4622776","58","12123038"
"chr4","16746074","16746373","chr6","17098693","17098993","9","352619"
"chr4","16753286","16753601","chr6","17107076","17107389","12","353790"
"chr4","16756154","16756343","chr17","87870105","87870293","35","71113951"
"chr4","16765345","16765648","chr6","17120642","17120941","12","355297"
"chr4","16785696","16785814","chr6","17145033","17145151","1","359337"
"chr4","16785862","16786029","chr6","17145175","17145342","5","359313"
"chr4","16798520","16798735","chr6","17158764","17158992","18","360244"
"chr4","16808737","16809045","chr2","77386203","77386516","67","60577466"
"chr4","16818891","16819190","chr6","17180562","17180859","9","361671"
"chr4","16821310","16821526","chr6","17182963","17183204","29","361653"
"chr4","16901163","16901451","chr6","17262758","17263045","6","361595"
"chr4","16906955","16907256","chr6","17268573","17268875","8","361618"
"chr4","16940411","16940718","chr6","17302904","17303211","10","362493"
"chr4","16945626","16945913","chr6","17308125","17308412","13","362499"
"chr4","16960841","16961134","chr6","17323311","17323598","10","362470"
"chr4","16970211","16970509","chr6","17332889","17333211","30","362678"
"chr4","16972538","16972843","chr6","17335509","17335802","25","362971"
"chr4","16988716","16988774","chr6","17354266","17354324","0","365550"
"chr4","16991482","16991593","chr6","17356958","17357073","5","365476"
"chr4","16991628","16991768","chr6","17357095","17357235","3","365467"
"chr4","16998666","16998905","chr6","17363592","17363819","37","364926"
"chr4","17001082","17001401","chr6","17365957","17366273","15","364875"
"chr4","17037832","17038118","chr19","27639596","27639887","60","10601764"
"chr4","17071821","17072092","chr6","126650613","126650885","53","109578792"
"chr4","17098391","17098695","chr17","28735189","28735485","59","11636798"
"chr4","17124509","17124825","chr13","44540499","44540786","82","27415990"
"chr4","17135043","17135296","chr6","17448760","17449053","68","313717"
"chr4","17147942","17148235","chr6","17448760","17449053","11","300818"
"chr4","17151092","17151373","chr6","17451918","17452199","8","300826"
"chr4","17188933","17189194","chr6","17482057","17482319","6","293124"
"chr4","17256391","17256701","chr6","17550502","17550818","18","294111"
"chr4","17270826","17271103","chr6","17566971","17567247","6","296145"
"chr4","17473568","17473867","chr4","55898902","55899204","57","38425334"
"chr4","17482813","17483066","chr6","17782950","17783212","35","300137"
"chr4","17483846","17483975","chr6","17783981","17784121","16","300135"
"chr4","17488888","17489034","chr6","17789070","17789216","6","300182"
"chr4","17593550","17593848","chr6","17890614","17890917","12","297064"
"chr4","17615789","17616072","chr6","17917964","17918259","21","302175"
"chr4","17829183","17829408","chr6","18122392","18122617","16","293209"
"chr4","17842133","17842418","chr6","18135540","18135825","15","293407"
"chr4","17899845","17900136","chr6","18193767","18194060","17","293922"
"chr4","17936335","17936650","chr6","18237164","18237485","17","300829"
"chr4","18020584","18020896","chr6","18318792","18319103","14","298208"
"chr4","18045576","18045679","chr20","26094778","26094876","22","8049202"
"chr4","18045997","18046048","chr4","123971331","123971378","9","105925334"
"chr4","18257434","18257724","chr6","18556170","18556460","13","298736"
"chr4","18309525","18309823","chr6","18609288","18609587","4","299763"
"chr4","18338859","18339166","chr14","99480715","99481017","75","81141856"
"chr4","18700903","18701115","chr6","19008569","19008784","18","307666"
"chr4","18742451","18742607","chr6","19050646","19050806","10","308195"
"chr4","18765863","18766015","chr2","100069015","100069158","37","81303152"
"chr4","18886806","18887096","chr6","19201486","19201774","8","314680"
"chr4","18976455","18976696","chr6","19292453","19292694","6","315998"
"chr4","18991031","18991196","chr11","131720798","131720962","36","112729767"
"chr4","19065406","19065698","chr6","19380853","19381145","23","315447"
"chr4","19143470","19143771","chr13","36379149","36379449","51","17235679"
"chr4","19231836","19232116","chr6","19547732","19548025","20","315896"
"chr4","19236176","19236382","chr6","19552068","19552272","10","315892"
"chr4","19270469","19270644","chr6","19578797","19578965","18","308328"
"chr4","19302041","19302336","chr6","19608723","19609015","17","306682"
"chr4","19451760","19452071","chr6","19764268","19764577","26","312508"
"chr4","19475112","19475473","chr6","19787811","19788164","33","312699"
"chr4","19599112","19599449","chr6","19911079","19911420","17","311967"
"chr4","19713098","19713391","chr6","20020361","20020642","25","307263"
"chr4","19839590","19839873","chr6","20150764","20151047","4","311174"
"chr4","20024560","20024833","chr6","20337528","20337803","9","312968"
"chr4","20030596","20030899","chr6","20343552","20343857","20","312956"
"chr4","20141392","20141706","chr6","20454960","20455273","10","313568"
"chr4","20173599","20173910","chr6","20487338","20487647","5","313739"
"chr4","20192544","20192854","chr6","20507968","20508278","8","315424"
"chr4","20293534","20293850","chr6","20605910","20606215","25","312376"
"chr4","20354438","20354499","chr12","53654439","53654488","18","33300001"
"chr4","20464248","20464552","chr4","36166510","36166817","70","15702262"
"chr4","20481019","20481312","chrX","46046489","46046783","58","25565470"
"chr4","20525161","20525496","chr6","20843639","20843972","13","318478"
"chr4","20687520","20687674","chr6","21007746","21007900","5","320226"
"chr4","20690370","20690490","chr14","72379408","72379539","38","51689038"
"chr4","20736847","20737142","chr6","21057247","21057553","25","320400"
"chr4","20940453","20940749","chr6","21266496","21266791","10","326043"
"chr4","21013675","21013937","chr3","40367752","40368018","55","19354077"
"chr4","21082137","21082433","chr6","21411955","21412251","3","329818"
"chr4","21107555","21107886","chr6","21481056","21481371","33","373501"
"chr4","21311173","21311451","chr6","21679250","21679540","24","368077"
"chr4","21319038","21319348","chr1","31051488","31051781","76","9732450"
"chr4","21371272","21371546","chr6","21738506","21738780","9","367234"
"chr4","21424604","21424825","chr8","91255459","91255700","64","69830855"
"chr4","21484147","21484420","chr6","21853611","21853885","6","369464"
"chr4","21736580","21736900","chr10","28843155","28843464","59","7106575"
"chr4","21775481","21775592","chr6","22158627","22158738","6","383146"
"chr4","21798032","21798287","chr6","22181737","22181992","12","383705"
"chr4","21806321","21806613","chr6","22190006","22190292","20","383685"
"chr4","21856754","21857029","chr6","22235760","22236074","46","379006"
"chr4","21911562","21911847","chr6","22298832","22299117","10","387270"
"chr4","21921744","21922027","chr6","22309893","22310176","3","388149"
"chr4","21950202","21950493","chr6","22338542","22338833","7","388340"
"chr4","21955807","21956093","chr6","22346890","22347191","27","391083"
"chr4","22082978","22083103","chr9","22920838","22920964","25","837860"
"chr4","22086770","22086984","chr6","22491577","22491791","7","404807"
"chr4","22113442","22113746","chr6","22518890","22519199","15","405448"
"chr4","22172940","22173206","chr9","95117184","95117463","76","72944244"
"chr4","22208469","22208768","chr6","22611727","22612026","10","403258"
"chr4","22375497","22375777","chr6","22781788","22782068","9","406291"
"chr4","22411205","22411477","chr6","22817842","22818115","13","406637"
"chr4","22514445","22514631","chr1","163362341","163362511","50","140847896"
"chr4","22514669","22514787","chr7","125676422","125676542","20","103161753"
"chr4","22531234","22531584","chr6","22937670","22938023","22","406436"
"chr4","22551237","22551529","chr1","109952594","109952891","59","87401357"
"chr4","22581354","22581620","chr6","22989641","22989907","10","408287"
"chr4","22693537","22693834","chr6","23107042","23107340","13","413505"
"chr4","22787738","22787955","chr6","23220164","23220381","13","432426"
"chr4","22876383","22876509","chrX","141462197","141462329","25","118585814"
"chr4","22884187","22884458","chr6","23323701","23323978","15","439514"
"chr4","22899045","22899343","chr6","23338679","23338971","20","439634"
"chr4","22913925","22914209","chr6","23353552","23353826","26","439627"
"chr4","23042666","23042968","chr6","23476822","23477129","14","434156"
"chr4","23061674","23061893","chr14","15680809","15681014","57","7380865"
"chr4","23064879","23064958","chr6","23498992","23499071","1","434113"
"chr4","23065270","23065487","chr6","23499383","23499609","14","434113"
"chr4","23133753","23134066","chr6","23573929","23574225","26","440176"
"chr4","23231708","23232023","chr6","23688728","23689036","19","457020"
"chr4","23246629","23246919","chr6","23700621","23700912","13","453992"
"chr4","23320029","23320347","chr8","75547570","75547888","76","52227541"
"chr4","23323332","23323396","chr20","10976550","10976613","13","12346782"
"chr4","23338665","23338993","chr6","23795838","23796138","32","457173"
"chr4","23359659","23359961","chr6","23816580","23816879","11","456921"
"chr4","23505794","23505918","chr10","81051629","81051755","25","57545835"
"chr4","23505960","23506117","chr8","28144135","28144285","38","4638175"
"chr4","23509514","23509656","chr6","23966400","23966542","6","456886"
"chr4","23540016","23540287","chr6","24005056","24005325","11","465040"
"chr4","23602398","23602696","chr6","24058416","24058714","12","456018"
"chr4","23607400","23607688","chr6","24063426","24063706","22","456026"
"chr4","23670856","23670941","chr11","123062786","123062874","18","99391930"
"chr4","23728789","23729103","chr6","24185458","24185776","22","456669"
"chr4","23793275","23793556","chr6","24250944","24251226","5","457669"
"chr4","23825837","23826159","chr4","153723310","153723616","78","129897473"
"chr4","23918971","23919061","chr15","99095140","99095224","27","75176169"
"chr4","23919327","23919446","chr15","34683273","34683394","23","10763946"
"chr4","24231209","24231485","chr6","24691851","24692126","3","460642"
"chr4","24269642","24269912","chr6","24730207","24730465","24","460565"
"chr4","24332800","24333017","chr11","83801551","83801757","56","59468751"
"chr4","24343189","24343482","chr11","30923500","30923797","62","6580311"
"chr4","24371693","24371916","chr6","24830681","24830904","7","458988"
"chr4","24394348","24394660","chr6","24853594","24853873","46","459246"
"chr4","24466589","24466885","chr6","24923920","24924206","18","457331"
"chr4","24647218","24647466","chr6","25117220","25117501","47","470002"
"chr4","24691151","24691296","chr11","121092295","121092441","31","96401144"
"chr4","24813409","24813586","chr6","25289712","25289887","12","476303"
"chr4","24871744","24872032","chr6","25348725","25349013","11","476981"
"chr4","24904133","24904429","chr6","25380914","25381212","13","476781"
"chr4","25014033","25014124","chr6","25490226","25490317","2","476193"
"chr4","25309017","25309114","chr6","25800799","25800896","2","491782"
"chr4","25309146","25309274","chr6","25800931","25801085","30","491785"
"chr4","25393031","25393313","chr1","56020434","56020716","65","30627403"
"chr4","25396928","25397228","chr10","31493508","31493817","65","6096580"
"chr4","25508473","25508777","chr6","25988325","25988627","13","479852"
"chr4","25591122","25591434","chr6","26073540","26073852","3","482418"
"chr4","25600330","25600593","chr20","40475055","40475323","55","14874725"
"chr4","25698598","25698805","chr6","26170036","26170291","58","471438"
"chr4","25707250","25707554","chr6","26178818","26179135","20","471568"
"chr4","25728198","25728503","chr6","26210361","26210684","41","482163"
"chr4","25911406","25911530","chr6","26396122","26396246","3","484716"
"chr4","26000091","26000386","chr6","26483544","26483838","10","483453"
"chr4","26056323","26056620","chr6","26541385","26541690","13","485062"
"chr4","26059736","26059894","chr6","26544839","26545005","15","485103"
"chr4","26103541","26103851","chr6","26588050","26588365","19","484509"
"chr4","26139666","26139794","chr4","150640516","150640642","33","124500850"
"chr4","26151494","26151804","chr6","26644382","26644679","27","492888"
"chr4","26183604","26183854","chr7","18180916","18181180","69","8002688"
"chr4","26281911","26282167","chr6","26774356","26774635","33","492445"
"chr4","26301686","26301980","chr6","26793390","26793698","50","491704"
"chr4","26313869","26314167","chr6","26805698","26806006","20","491829"
"chr4","26323391","26323613","chr6","26815574","26815796","12","492183"
"chr4","26463671","26463959","chr6","26956007","26956294","9","492336"
"chr4","26534907","26535215","chr6","27026585","27026890","12","491678"
"chr4","26713390","26713699","chrX","21182475","21182776","65","5530915"
"chr4","26765382","26765508","chr6","27265495","27265638","23","500113"
"chr4","26906294","26906482","chr1","66887413","66887590","49","39981119"
"chr4","27134324","27134553","chr8","5809101","5809306","56","21325223"
"chr4","27686681","27686947","chr6","28212089","28212378","35","525408"
"chr4","27987423","27987599","chr6","28517347","28517530","19","529924"
"chr4","27998092","27998370","chr3","12644640","12644921","58","15353452"
"chr4","28006417","28006664","chr6","28536587","28536832","14","530170"
"chr4","28088111","28088387","chr6","28614769","28615046","10","526658"
"chr4","28111239","28111557","chr6","28637143","28637446","21","525904"
"chr4","28140651","28140942","chr6","28665443","28665754","66","524792"
"chr4","28146001","28146276","chr6","28670378","28670655","11","524377"
"chr4","28282620","28282909","chr6","28805264","28805547","15","522644"
"chr4","28390997","28391321","chr6","28921721","28922013","45","530724"
"chr4","28435504","28435779","chr2","147581856","147582131","60","119146352"
"chr4","28705788","28706055","chr6","29177133","29177400","9","471345"
"chr4","28774597","28774919","chr6","29241985","29242293","26","467388"
"chr4","28782278","28782589","chr6","29248863","29249174","11","466585"
"chr4","28851412","28851681","chr1","37915334","37915601","65","9063922"
"chr4","28877005","28877295","chr6","29341480","29341768","10","464475"
"chr4","28945647","28945965","chr6","29412704","29413016","19","467057"
"chr4","28996287","28996569","chr6","29464868","29465150","9","468581"
"chr4","29053655","29053794","chr6","29527886","29528029","6","474231"
"chr4","29254623","29254932","chr6","29732936","29733247","23","478313"
"chr4","29304914","29305203","chr16","51501548","51501829","70","22196634"
"chr4","29310777","29310854","chr5","102000001","102000077","20","72689224"
"chr4","29331214","29331440","chr15","9880433","9880654","47","19450781"
"chr4","29558448","29558573","chr6","30012999","30013124","5","454551"
"chr4","29599033","29599336","chr6","30054877","30055195","32","455844"
"chr4","29671577","29671873","chr6","30148721","30149018","9","477144"
"chr4","29682653","29682954","chr6","30159734","30160038","20","477081"
"chr4","29719635","29719925","chr6","30197127","30197405","17","477492"
"chr4","29729478","29729750","chr6","30207739","30208009","10","478261"
"chr4","29739266","29739538","chr6","30207739","30208009","10","468473"
"chr4","29831614","29831836","chr6","30301114","30301332","9","469500"
"chr4","29944321","29944631","chr6","30421128","30421439","13","476807"
"chr4","30031569","30031826","chr6","30511233","30511504","25","479664"
"chr4","30202700","30203013","chr6","30683572","30683871","21","480872"
"chr4","30206549","30206828","chr6","30687399","30687691","20","480850"
"chr4","30212848","30213124","chr6","30693530","30693784","43","480682"
"chr4","30217616","30217902","chr6","30698272","30698557","10","480656"
"chr4","30232278","30232448","chrX","1573064","1573227","30","28659214"
"chr4","30315255","30315545","chr6","30798303","30798583","27","483048"
"chr4","30350708","30350831","chr6","30832647","30832770","2","481939"
"chr4","30378319","30378618","chr6","30859879","30860178","9","481560"
"chr4","30487746","30488032","chr6","30966787","30967073","6","479041"
"chr4","30496473","30496656","chr6","30975561","30975758","20","479088"
"chr4","30541756","30542042","chr6","31020392","31020678","7","478636"
"chr4","30581055","30581324","chr6","31060509","31060814","38","479454"
"chr4","30637362","30637647","chr7","87747971","87748262","59","57110609"
"chr4","30653976","30654275","chr6","31133530","31133829","10","479554"
"chr4","30654793","30655025","chr6","31134344","31134576","1","479551"
"chr4","30676086","30676380","chr6","31156269","31156562","4","480183"
"chr4","30686432","30686879","chr3","76278684","76279065","151","45592252"
"chr4","30719184","30719489","chr6","31199877","31200184","16","480693"
"chr4","30721497","30721780","chr6","31202277","31202549","19","480780"
"chr4","30741076","30741360","chr6","31222035","31222319","4","480959"
"chr4","30741741","30742033","chr6","31222697","31222992","12","480956"
"chr4","30762385","30762677","chr6","31245821","31246113","5","483436"
"chr4","30780095","30780393","chr6","31264379","31264676","14","484284"
"chr4","30781690","30781946","chr6","31265954","31266237","31","484264"
"chr4","30814623","30814937","chr6","31291521","31291827","29","476898"
"chr4","30818161","30818438","chr6","31295012","31295309","25","476851"
"chr4","30824133","30824430","chr6","31301071","31301365","14","476938"
"chr4","30828681","30828824","chr6","31305578","31305721","4","476897"
"chr4","30838682","30838977","chr6","31315125","31315418","5","476443"
"chr4","30844991","30845115","chr6","31321530","31321654","1","476539"
"chr4","30845411","30845587","chr6","31321960","31322130","11","476549"
"chr4","30848044","30848318","chr6","31324482","31324777","29","476438"
"chr4","30876634","30876799","chr6","31353252","31353417","4","476618"
"chr4","30892662","30892941","chr6","31369287","31369577","26","476625"
"chr4","30904017","30904268","chr6","31380652","31380910","13","476635"
"chr4","30908944","30909220","chr6","31385611","31385900","19","476667"
"chr4","30915005","30915311","chr6","31391702","31392008","12","476697"
"chr4","30923060","30923268","chr6","31399754","31399962","4","476694"
"chr4","30925304","30925592","chr6","31401998","31402295","22","476694"
"chr4","30933330","30933490","chr6","31409990","31410151","9","476660"
"chr4","30933805","30933963","chr6","31410476","31410633","4","476671"
"chr4","30966634","30966940","chr6","31443208","31443513","14","476574"
"chr4","30983280","30983570","chr6","31459401","31459694","11","476121"
"chr4","31024388","31024678","chr6","31500331","31500621","7","475943"
"chr4","31038814","31039130","chr6","31523503","31523798","34","484689"
"chr4","31039308","31039612","chr6","31523976","31524283","9","484668"
"chr4","31091104","31091240","chr11","111581793","111581928","33","80490689"
"chr4","31091368","31091506","chr6","132243968","132244102","26","101152600"
"chr4","31092191","31092311","chr6","31568190","31568307","4","475999"
"chr4","31096743","31097032","chr6","31572711","31573000","6","475968"
"chr4","31112923","31113229","chr6","31588938","31589238","12","476015"
"chr4","31121597","31121763","chr6","31597953","31598148","32","476356"
"chr4","31150535","31150833","chr6","31626452","31626750","12","475917"
"chr4","31156300","31156466","chr3","77273639","77273797","34","46117339"
"chr4","31161236","31161544","chr14","99480715","99481017","66","68319479"
"chr4","31173484","31173793","chr6","31653921","31654216","21","480437"
"chr4","31178427","31178709","chr8","26423847","26424135","54","4754580"
"chr4","31184983","31185281","chr2","164269237","164269534","57","133084254"
"chr4","31197839","31198027","chr6","31678203","31678391","2","480364"
"chr4","31200249","31200403","chr6","31680606","31680761","4","480357"
"chr4","31245564","31245849","chr6","31724488","31724781","15","478924"
"chr4","31251263","31251541","chr6","31735378","31735656","5","484115"
"chr4","31260519","31260625","chr14","67453658","67453756","10","36193139"
"chr4","31262352","31262506","chrX","106861512","106861669","30","75599160"
"chr4","31270524","31270829","chr6","31746538","31746841","16","476014"
"chr4","31284512","31284665","chr6","31760154","31760289","21","475642"
"chr4","31285289","31285448","chr3","38428298","38428454","32","7143009"
"chr4","31299274","31299560","chrX","37837556","37837843","52","6538282"
"chr4","31314207","31314507","chr2","97022915","97023209","54","65708708"
"chr4","31339785","31340070","chr6","31815259","31815543","8","475474"
"chr4","31347772","31348076","chr6","31823927","31824227","16","476155"
"chr4","31383290","31383571","chr6","31858468","31858761","16","475178"
"chr4","31391717","31392014","chr6","31867023","31867317","15","475306"
"chr4","31415200","31415407","chr6","31890755","31890963","5","475555"
"chr4","31427986","31428298","chr6","31903530","31903834","23","475544"
"chr4","31456241","31456523","chr6","31936964","31937245","5","480723"
"chr4","31464830","31465112","chr6","31944872","31945169","28","480042"
"chr4","31468459","31468775","chr6","31948522","31948837","11","480063"
"chr4","31474792","31475010","chr19","6297627","6297844","61","25177165"
"chr4","31475361","31475491","chr20","49944202","49944334","18","18468841"
"chr4","31475492","31475767","chr6","31952028","31952314","49","476536"
"chr4","31484070","31484375","chr6","31963857","31964152","18","479787"
"chr4","31492454","31492660","chr6","31973259","31973465","8","480805"
"chr4","31492945","31493233","chr6","31973768","31974045","20","480823"
"chr4","31502580","31502889","chr6","31989306","31989615","12","486726"
"chr4","31505808","31506022","chr6","31992531","31992764","26","486723"
"chr4","31508612","31508910","chr6","31995352","31995648","8","486740"
"chr4","31509537","31509737","chr6","31996273","31996472","2","486736"
"chr4","31514844","31515126","chr6","32001536","32001818","9","486692"
"chr4","31525902","31526172","chr11","25373394","25373661","66","6152508"
"chr4","31551161","31551471","chr6","32039929","32040233","11","488768"
"chr4","31561110","31561397","chr18","14307211","14307495","54","17253899"
"chr4","31561837","31562120","chr6","32050642","32050927","6","488805"
"chr4","31574069","31574385","chr6","32062627","32062954","21","488558"
"chr4","31575406","31575474","chr6","32063994","32064062","5","488588"
"chr4","31576068","31576359","chr6","32064654","32064945","5","488586"
"chr4","31608163","31608454","chr6","32099046","32099345","16","490883"
"chr4","31620422","31620696","chr6","32118755","32119029","2","498333"
"chr4","31634633","31634923","chr6","32133434","32133725","10","498801"
"chr4","31637766","31637975","chr6","32136578","32136786","4","498812"
"chr4","31639699","31639944","chr6","32138514","32138759","5","498815"
"chr4","31641633","31641864","chr5","71934527","71934759","54","40292894"
"chr4","31645178","31645496","chr6","32144004","32144346","31","498826"
"chr4","31646287","31646587","chr7","122518704","122518988","95","90872417"
"chr4","31649649","31649943","chr3","176288014","176288302","63","144638365"
"chr4","31655949","31656216","chr6","32147109","32147376","6","491160"
"chr4","31668118","31668200","chr6","32159567","32159647","4","491449"
"chr4","31670723","31671022","chr6","32161826","32162125","7","491103"
"chr4","31675251","31675520","chr6","32166674","32166943","3","491423"
"chr4","31679552","31679834","chr6","32170855","32171137","6","491303"
"chr4","31681528","31681838","chr6","32173089","32173413","18","491561"
"chr4","31688213","31688410","chr6","32179802","32179998","4","491589"
"chr4","31688484","31688717","chr6","32180085","32180303","21","491601"
"chr4","31688744","31689044","chr6","32180330","32180640","17","491586"
"chr4","31705272","31705539","chr6","32196703","32196975","12","491431"
"chr4","31708968","31709268","chr6","32200405","32200705","5","491437"
"chr4","31710026","31710179","chr4","42538418","42538573","36","10828392"
"chr4","31710183","31710373","chr6","32201603","32201803","12","491420"
"chr4","31710374","31710416","chr1","125184004","125184047","14","93473630"
"chr4","31710720","31710807","chr6","32202153","32202240","1","491433"
"chr4","31710919","31711212","chr6","32202680","32202955","37","491761"
"chr4","31711983","31712265","chr6","32203729","32204011","7","491746"
"chr4","31713078","31713367","chr6","32204824","32205113","6","491746"
"chr4","31725628","31725923","chr6","32218038","32218333","4","492410"
"chr4","31728958","31729248","chr6","32221370","32221660","2","492412"
"chr4","31734683","31735004","chr6","32227099","32227423","13","492416"
"chr4","31746596","31746911","chr6","32244038","32244364","16","497442"
"chr4","31758035","31758153","chr6","32247553","32247670","5","489518"
"chr4","31759717","31760016","chr6","32250212","32250511","13","490495"
"chr4","31762604","31762898","chr6","32254443","32254750","29","491839"
"chr4","31769280","31769352","chr16","25477961","25478031","11","6291319"
"chr4","31769801","31769846","chr1","54500597","54500644","10","22730796"
"chr4","31803231","31803342","chr6","32298743","32298854","5","495512"
"chr4","31805074","31805242","chr2","43232993","43233164","35","11427919"
"chr4","31808004","31808299","chr6","32304304","32304599","6","496300"
"chr4","31808811","31808984","chr6","32305107","32305286","11","496296"
"chr4","31810652","31810784","chr6","32306926","32307058","8","496274"
"chr4","31811118","31811279","chr6","32307372","32307532","7","496254"
"chr4","31811972","31812211","chr6","32308216","32308455","11","496244"
"chr4","31813346","31813651","chr6","32309589","32309874","27","496243"
"chr4","31829656","31829923","chr6","32325678","32325946","10","496022"
"chr4","31833106","31833404","chr6","32329100","32329402","19","495994"
"chr4","31857174","31857332","chr6","32352973","32353145","17","495799"
"chr4","31857632","31857773","chr6","32353444","32353585","2","495812"
"chr4","31868435","31868723","chr10","38038057","38038338","53","6169622"
"chr4","31892877","31893010","chr6","32389707","32389840","1","496830"
"chr4","31911604","31911700","chr6","32407208","32407304","3","495604"
"chr4","31913407","31913713","chr15","74219376","74219673","43","42305969"
"chr4","31913717","31913996","chr4","70977884","70978164","53","39064167"
"chr4","31916409","31916681","chr6","32413089","32413399","49","496680"
"chr4","31924243","31924537","chr6","32420630","32420926","6","496387"
"chr4","31958129","31958429","chr6","32460271","32460579","14","502142"
"chr4","32001564","32001857","chr6","32507923","32508216","4","506359"
"chr4","32015043","32015284","chr16","31810732","31810970","50","204311"
"chr4","32046295","32046603","chr6","32556750","32557055","7","510455"
"chr4","32081841","32082139","chr6","32585656","32585937","23","503815"
"chr4","32192716","32192949","chr6","32697939","32698171","5","505223"
"chr4","32204956","32205194","chr5","20552173","20552400","62","11652783"
"chr4","32205195","32205285","chr10","61758492","61758586","23","29553297"
"chr4","32205311","32205466","chr1","188666756","188666909","35","156461445"
"chr4","32243936","32244072","chr6","32764165","32764302","7","520229"
"chr4","32263294","32263432","chr6","32783391","32783545","16","520097"
"chr4","32263723","32263907","chr6","32783834","32784020","19","520111"
"chr4","32317283","32317592","chr6","32838479","32838789","4","521196"
"chr4","32406445","32406759","chr6","32928091","32928409","19","521646"
"chr4","32417178","32417297","chr6","32938721","32938840","2","521543"
"chr4","32420630","32420895","chr6","32941984","32942275","50","521354"
"chr4","32462563","32462848","chr6","32990205","32990477","23","527642"
"chr4","32471102","32471373","chr6","32998632","32998907","21","527530"
"chr4","32497812","32497868","chr6","33025210","33025267","3","527398"
"chr4","32498208","32498450","chr6","33025607","33025849","5","527399"
"chr4","32608588","32608872","chr6","33135465","33135749","5","526877"
"chr4","32642698","32643003","chr6","33172697","33173003","16","529999"
"chr4","32686443","32686502","chr6","33215730","33215788","4","529287"
"chr4","32698109","32698370","chr10","22222890","22223155","51","10475219"
"chr4","32716985","32717254","chr15","102473693","102473948","73","69756708"
"chr4","32724297","32724604","chr6","33253564","33253869","11","529267"
"chr4","32744417","32744723","chr6","33272583","33272888","5","528166"
"chr4","32748235","32748537","chr6","33276393","33276695","10","528158"
"chr4","32787759","32788053","chr12","32855535","32855828","50","67776"
"chr4","32790023","32790149","chr6","33320539","33320661","12","530516"
"chr4","32813534","32813799","chr6","33344043","33344309","5","530509"
"chr4","32835596","32835847","chr6","33366038","33366296","18","530442"
"chr4","33066751","33067039","chr6","33598853","33599139","8","532102"
"chr4","33137711","33137997","chr6","33670284","33670570","10","532573"
"chr4","33204902","33205099","chr6","33737202","33737401","6","532300"
"chr4","33205397","33205513","chr6","33737699","33737815","4","532302"
"chr4","33229424","33229703","chr6","33761650","33761942","16","532226"
"chr4","33271481","33271781","chr6","33803654","33803954","15","532173"
"chr4","33294461","33294739","chr6","33826317","33826595","13","531856"
"chr4","33319606","33319905","chr6","33851494","33851789","20","531888"
"chr4","33330994","33331272","chr6","33862801","33863105","34","531807"
"chr4","33334371","33334562","chr6","33866955","33867140","14","532584"
"chr4","33382025","33382291","chr6","33915052","33915317","10","533027"
"chr4","33409259","33409401","chr19","640332","640467","33","32768927"
"chr4","33414993","33415269","chr6","33948293","33948574","9","533300"
"chr4","33420436","33420755","chr6","33953767","33954067","29","533331"
"chr4","33445592","33445844","chrX","10662739","10662988","43","22782853"
"chr4","33447065","33447219","chr6","168856261","168856393","42","135409196"
"chr4","33464274","33464479","chr6","33996602","33996761","46","532328"
"chr4","33466669","33466975","chr6","33998985","33999291","10","532316"
"chr4","33476325","33476602","chr6","34008626","34008903","8","532301"
"chr4","33479237","33479379","chr6","34011535","34011677","5","532298"
"chr4","33483120","33483296","chr7","130181126","130181299","36","96698006"
"chr4","33502448","33502749","chr6","34034903","34035188","23","532455"
"chr4","33506595","33506865","chr6","34038731","34039001","11","532136"
"chr4","33512918","33513162","chr6","34045050","34045294","10","532132"
"chr4","33520661","33520937","chr4","148588692","148588953","67","115068031"
"chr4","33531067","33531368","chr6","34063830","34064140","19","532763"
"chr4","33533972","33534258","chr6","34066760","34067047","10","532788"
"chr4","33542921","33543217","chr16","73796312","73796573","95","40253391"
"chr4","33544867","33545172","chr6","34078538","34078844","12","533671"
"chr4","33545329","33545494","chr6","34079000","34079166","5","533671"
"chr4","33548702","33548987","chr18","16527311","16527586","59","17021391"
"chr4","33554783","33555061","chr10","38038057","38038338","53","4483274"
"chr4","33555414","33555685","chr6","34090159","34090421","37","534745"
"chr4","33562782","33563078","chr6","34099117","34099413","7","536335"
"chr4","33584659","33584948","chr6","34121357","34121646","10","536698"
"chr4","33655817","33656086","chr3","51350764","51351038","64","17694947"
"chr4","33666869","33667180","chr6","34202750","34203061","4","535881"
"chr4","33671490","33671779","chr6","34207367","34207652","12","535877"
"chr4","33680379","33680685","chr6","34216262","34216597","44","535883"
"chr4","33694338","33694455","chr6","34230199","34230316","2","535861"
"chr4","33694545","33694806","chr6","34230406","34230659","18","535861"
"chr4","33697485","33697777","chr6","34233344","34233644","13","535859"
"chr4","33723687","33723971","chr14","22507021","22507307","51","11216666"
"chr4","33735284","33735588","chr6","34271219","34271517","16","535935"
"chr4","33778205","33778508","chr6","33100388","33100695","52","677817"
"chr4","33780378","33780664","chr6","34314241","34314555","42","533863"
"chr4","33793831","33793991","chr6","34327676","34327836","5","533845"
"chr4","33811841","33812158","chr2","78493440","78493742","62","44681599"
"chr4","33833655","33833829","chr6","34367005","34367179","7","533350"
"chr4","33833909","33834035","chr6","34367259","34367385","2","533350"
"chr4","33917411","33917552","chr15","99199241","99199381","27","65281830"
"chr4","33928686","33928892","chr6","34456205","34456410","7","527519"
"chr4","33928894","33929147","chr6","34456412","34456665","0","527518"
"chr4","33931986","33932289","chr6","34459504","34459802","15","527518"
"chr4","33944651","33944862","chr6","34472434","34472645","2","527783"
"chr4","33979542","33979830","chr6","34507420","34507720","23","527878"
"chr4","34052285","34052515","chr6","34582149","34582376","11","529864"
"chr4","34052540","34052589","chr6","34582401","34582450","0","529861"
"chr4","34088131","34088426","chr6","34617559","34617858","12","529428"
"chr4","34183505","34183809","chr6","34722042","34722346","6","538537"
"chr4","34208609","34208918","chr6","34746761","34747066","14","538152"
"chr4","34224106","34224309","chr6","34770493","34770696","7","546387"
"chr4","34243012","34243323","chr7","130656007","130656307","59","96412995"
"chr4","34276992","34277283","chr10","13389158","13389451","54","20887834"
"chr4","34278469","34278753","chr6","34828325","34828608","6","549856"
"chr4","34298900","34299068","chr6","34848430","34848586","18","549530"
"chr4","34310673","34310971","chr6","34860248","34860546","8","549575"
"chr4","34321152","34321460","chr6","34870627","34870942","19","549475"
"chr4","34325992","34326300","chr6","34875516","34875826","7","549524"
"chr4","34398217","34398439","chr2","62437600","62437816","45","28039383"
"chr4","34416580","34416870","chr6","34967757","34968035","24","551177"
"chr4","34424732","34425017","chr6","34975857","34976139","15","551125"
"chr4","34497197","34497437","chr6","35049797","35050039","7","552600"
"chr4","34612799","34613082","chr6","35183190","35183473","2","570391"
"chr4","34624928","34625208","chr12","94445603","94445883","79","59820675"
"chr4","34663861","34664026","chr16","51202968","51203133","33","16539107"
"chr4","34694262","34694469","chr6","35266842","35267046","6","572580"
"chr4","34850319","34850600","chr6","35423930","35424211","7","573611"
"chr4","34904289","34904604","chr2","47544943","47545258","66","12640654"
"chr4","34908915","34909198","chr1","159614491","159614771","57","124705576"
"chr4","34922050","34922321","chr6","35495825","35496098","5","573775"
"chr4","34970186","34970486","chr6","35543416","35543711","12","573230"
"chr4","34977401","34977541","chr6","35550600","35550740","2","573199"
"chr4","34980947","34981228","chr6","35554147","35554428","5","573200"
"chr4","35011580","35011867","chr13","46975605","46975891","69","11964025"
"chr4","35070011","35070315","chr6","35646970","35647279","18","576959"
"chr4","35105695","35106003","chr6","35683283","35683591","4","577588"
"chr4","35110051","35110311","chr6","35687636","35687896","4","577585"
"chr4","35120628","35120888","chr6","35687636","35687896","4","567008"
"chr4","35164089","35164318","chr6","35733838","35734067","7","569749"
"chr4","35223876","35224132","chr6","35794161","35794417","6","570285"
"chr4","35353837","35354121","chr6","35922962","35923230","24","569125"
"chr4","35364245","35364537","chr6","35933712","35934005","9","569467"
"chr4","35414930","35415215","chr6","35991221","35991506","3","576291"
"chr4","35431232","35431510","chr10","18565243","18565512","65","16865989"
"chr4","35459576","35459689","chr1","19501947","19502059","25","15957629"
"chr4","35465386","35465655","chr6","36041293","36041566","8","575907"
"chr4","35569590","35569900","chr12","99475927","99476241","59","63906337"
"chr4","35606714","35606895","chr4","12234719","12234900","34","23371995"
"chr4","35606923","35607041","chr2","186930465","186930582","18","151323542"
"chr4","35659157","35659463","chr6","36235994","36236304","19","576837"
"chr4","35696097","35696371","chr6","36272988","36273260","7","576891"
"chr4","35717006","35717288","chr6","36294185","36294468","1","577179"
"chr4","35728115","35728324","chr6","36311685","36311902","13","583570"
"chr4","35784499","35784793","chr15","6035135","6035426","66","29749364"
"chr4","35806380","35806678","chr6","36390506","36390808","11","584126"
"chr4","35814261","35814558","chr6","36398403","36398701","6","584142"
"chr4","35887373","35887658","chr6","36472211","36472496","5","584838"
"chr4","35904718","35904951","chr6","36489480","36489704","17","584762"
"chr4","35909024","35909290","chr6","36493989","36494256","5","584965"
"chr4","35947269","35947525","chr6","36530728","36530988","8","583459"
"chr4","35979154","35979448","chr6","36562023","36562317","5","582869"
"chr4","35990309","35990513","chr6","36573987","36574191","5","583678"
"chr4","35990815","35990948","chr6","36574496","36574628","4","583681"
"chr4","36000336","36000620","chr6","36584007","36584305","26","583671"
"chr4","36002206","36002408","chr6","36585891","36586088","9","583685"
"chr4","36024399","36024510","chr6","36608309","36608420","0","583910"
"chr4","36051075","36051387","chr6","36639320","36639619","18","588245"
"chr4","36056689","36056953","chr6","36644938","36645202","5","588249"
"chr4","36063232","36063294","chr8","95757445","95757504","11","59694213"
"chr4","36065081","36065327","chr6","36653693","36653937","5","588612"
"chr4","36066472","36066583","chr20","4975317","4975429","25","31091155"
"chr4","36077211","36077509","chr6","36664972","36665270","3","587761"
"chr4","36080320","36080626","chr6","36668070","36668376","7","587750"
"chr4","36083430","36083591","chr6","36674013","36674172","8","590583"
"chr4","36085651","36085939","chr6","36678611","36678904","9","592960"
"chr4","36091933","36092240","chr6","36684870","36685174","6","592937"
"chr4","36094004","36094292","chr6","134251498","134251796","47","98157494"
"chr4","36103061","36103198","chr6","36696240","36696370","8","593179"
"chr4","36103199","36103476","chr6","36696378","36696657","7","593179"
"chr4","36103477","36103487","chr11","6725648","6725658","2","29377829"
"chr4","36120036","36120337","chr6","36713233","36713540","12","593197"
"chr4","36122374","36122680","chr6","36715477","36715783","2","593103"
"chr4","36138998","36139300","chr6","36732677","36732982","13","593679"
"chr4","36151866","36152163","chr2","101508511","101508813","72","65356645"
"chr4","36153604","36153888","chr6","36747530","36747811","7","593926"
"chr4","36170408","36170693","chr6","36771571","36771860","12","601163"
"chr4","36173671","36173849","chr6","36774523","36774696","16","600852"
"chr4","36174147","36174198","chr6","36774992","36775043","0","600845"
"chr4","36176676","36176976","chr6","36777875","36778173","11","601199"
"chr4","36187043","36187253","chr6","36787842","36788048","12","600799"
"chr4","36187804","36188085","chr6","36788593","36788873","7","600789"
"chr4","36195706","36196009","chr11","84090062","84090361","60","47894356"
"chr4","36201905","36202222","chr6","36799565","36799867","21","597660"
"chr4","36209212","36209522","chr6","36807130","36807440","13","597918"
"chr4","36210637","36210907","chr6","36808863","36809134","12","598226"
"chr4","36212536","36212851","chr10","33247594","33247912","70","2964942"
"chr4","36216010","36216241","chr7","63131804","63132028","62","26915794"
"chr4","36216268","36216543","chr6","36813563","36813838","6","597295"
"chr4","36217046","36217355","chr6","36814345","36814656","14","597299"
"chr4","36221499","36221791","chr6","36818739","36819003","35","597240"
"chr4","36221865","36222152","chr14","114520367","114520653","59","78298502"
"chr4","36229942","36230249","chr6","36828751","36829060","8","598809"
"chr4","36231344","36231636","chr1","201690228","201690514","64","165458884"
"chr4","36231678","36231832","chr6","93455900","93456063","53","57224222"
"chr4","36239621","36239912","chr6","36837359","36837660","14","597738"
"chr4","36253472","36253769","chr6","36851004","36851302","6","597532"
"chr4","36257118","36257319","chr6","36854502","36854704","5","597384"
"chr4","36257630","36257726","chr6","36854984","36855080","1","597354"
"chr4","36266926","36267224","chr6","36864250","36864548","4","597324"
"chr4","36270099","36270376","chr6","36867420","36867696","7","597321"
"chr4","36280620","36280902","chr6","36876411","36876693","8","595791"
"chr4","36285672","36285969","chr11","12098381","12098651","88","24187291"
"chr4","36291380","36291657","chr6","36886715","36886992","6","595335"
"chr4","36295978","36296288","chr6","36890986","36891290","18","595008"
"chr4","36297746","36298022","chr6","36892786","36893072","16","595040"
"chr4","36383190","36383518","chr6","36980077","36980404","11","596887"
"chr4","36385385","36385691","chr6","36982286","36982591","11","596901"
"chr4","36425213","36425382","chrX","7460432","7460598","37","28964781"
"chr4","36425418","36425534","chr16","43861957","43862073","15","7436539"
"chr4","36472574","36472882","chr6","37076088","37076390","9","603514"
"chr4","36488810","36489096","chr6","37094337","37094642","30","605527"
"chr4","36542137","36542413","chr6","37161314","37161597","17","619177"
"chr4","36706136","36706384","chr6","37323238","37323528","55","617102"
"chr4","36725852","36726018","chr6","37343024","37343193","5","617172"
"chr4","36792829","36793137","chr6","37409120","37409425","10","616291"
"chr4","36917007","36917297","chr6","37532520","37532815","8","615513"
"chr4","36924609","36924736","chr6","37540239","37540358","8","615630"
"chr4","37108408","37108724","chr6","37725441","37725748","14","617033"
"chr4","37122327","37122616","chr6","37739288","37739586","13","616961"
"chr4","37127204","37127504","chr6","37744153","37744453","8","616949"
"chr4","37138184","37138443","chr3","138700033","138700275","55","101561849"
"chr4","37168027","37168345","chr6","37781807","37782126","7","613780"
"chr4","37196602","37196775","chr6","37808592","37808756","10","611990"
"chr4","37206294","37206557","chr6","37818343","37818603","11","612049"
"chr4","37216362","37216631","chr6","37828423","37828692","4","612061"
"chr4","37226292","37226588","chr6","37838321","37838634","22","612029"
"chr4","37245784","37246067","chr6","37857929","37858212","4","612145"
"chr4","37248150","37248439","chr6","37860284","37860573","8","612134"
"chr4","37291717","37291989","chr6","37901918","37902184","13","610201"
"chr4","37322733","37323045","chr6","37933424","37933730","14","610691"
"chr4","37345693","37346024","chr6","37955635","37955965","7","609942"
"chr4","37474048","37474292","chr6","38084432","38084679","6","610384"
"chr4","37499670","37499791","chr6","38109987","38110107","3","610317"
"chr4","37500314","37500607","chr6","38110630","38110923","6","610316"
"chr4","37531628","37531867","chr6","38142712","38142946","15","611084"
"chr4","37532249","37532382","chr6","38143328","38143467","7","611079"
"chr4","37547736","37547990","chr6","38158736","38158993","12","611000"
"chr4","37596639","37596929","chr2","18636694","18636987","53","18959945"
"chr4","37631479","37631697","chr6","38250079","38250297","2","618600"
"chr4","37649612","37649919","chr6","38268566","38268860","20","618954"
"chr4","37657350","37657627","chr6","38276217","38276494","5","618867"
"chr4","37688969","37689188","chr6","38308120","38308311","34","619151"
"chr4","37802884","37803186","chr6","38421792","38422094","7","618908"
"chr4","37842926","37843075","chr19","29400746","29400891","30","8442180"
"chr4","37853480","37853557","chr6","38476362","38476441","2","622882"
"chr4","37867266","37867590","chr6","38489821","38490145","7","622555"
"chr4","37909126","37909402","chrX","44872889","44873177","56","6963763"
"chr4","37912449","37912735","chr6","38536354","38536599","50","623905"
"chr4","37957636","37957809","chr6","38581217","38581398","16","623581"
"chr4","37958276","37958396","chr6","38581848","38581968","1","623572"
"chr4","38242900","38243196","chr6","38876416","38876712","15","633516"
"chr4","38263149","38263446","chr6","38896029","38896331","13","632880"
"chr4","38298023","38298307","chr6","38930792","38931076","9","632769"
"chr4","38476960","38477269","chr6","39110660","39110968","7","633700"
"chr4","38498941","38499167","chr5","72886629","72886857","54","34387688"
"chr4","38530304","38530585","chr6","39166824","39167102","17","636520"
"chr4","38688614","38688920","chr6","39342311","39342616","8","653697"
"chr4","38694078","38694287","chr1","2384179","2384379","51","36309899"
"chr4","38777125","38777412","chr6","39429933","39430237","23","652808"
"chr4","38836096","38836416","chr6","39491662","39491982","10","655566"
"chr4","38980973","38981270","chr6","39641641","39641937","8","660668"
"chr4","39181564","39181860","chr6","39877604","39877895","12","696040"
"chr4","39282194","39282317","chr6","39985034","39985157","2","702840"
"chr4","39317402","39317674","chr6","40019945","40020217","8","702543"
"chr4","39354450","39354757","chr6","40056396","40056703","7","701946"
"chr4","39384694","39385000","chr6","40087218","40087524","4","702524"
"chr4","39414995","39415211","chr6","40117179","40117395","3","702184"
"chr4","39422427","39422722","chr7","38670395","38670697","78","752032"
"chr4","39435296","39435605","chr6","40136791","40137100","8","701495"
"chr4","39446988","39447147","chr6","40147184","40147343","0","700196"
"chr4","39503892","39504180","chr6","40204806","40205095","12","700914"
"chr4","39510555","39510829","chr6","40211415","40211689","13","700860"
"chr4","39526157","39526486","chr6","40227343","40227654","19","701186"
"chr4","39532683","39533000","chr6","40233839","40234155","10","701156"
"chr4","39557052","39557351","chr6","40258041","40258340","5","700989"
"chr4","39558758","39558830","chr1","181872340","181872413","8","142313582"
"chr4","39559771","39560068","chr6","40267882","40268179","2","708111"
"chr4","39562663","39562803","chr6","40270772","40270900","14","708109"
"chr4","39573773","39574088","chr6","40266619","40266935","8","692846"
"chr4","39575029","39575326","chr6","40267882","40268179","2","692853"
"chr4","39575821","39576098","chr6","40275396","40275693","37","699575"
"chr4","39581814","39582111","chr6","40281742","40282046","13","699928"
"chr4","39586011","39586130","chr6","40285944","40286063","2","699933"
"chr4","39589273","39589571","chr6","40289145","40289424","25","699872"
"chr4","39599717","39599990","chr6","40300330","40300603","2","700613"
"chr4","39601175","39601245","chr6","40301794","40301865","3","700619"
"chr4","39604050","39604355","chr6","40304714","40305017","20","700664"
"chr4","39605509","39605817","chr6","40306172","40306480","5","700663"
"chr4","39606171","39606270","chr6","40306838","40306937","3","700667"
"chr4","39615811","39616119","chr6","40315953","40316261","6","700142"
"chr4","39629113","39629415","chr6","40327193","40327495","6","698080"
"chr4","39638627","39638961","chr6","40336645","40336968","15","698018"
"chr4","39665277","39665547","chr6","40364421","40364689","10","699144"
"chr4","39668492","39668692","chr6","40367522","40367722","5","699030"
"chr4","39674618","39674901","chr6","40373641","40373922","11","699023"
"chr4","39747268","39747575","chr6","40444317","40444619","21","697049"
"chr4","39851591","39851927","chr6","40554446","40554784","16","702855"
"chr4","39925956","39926269","chr6","40635639","40635952","6","709683"
"chr4","40472510","40472824","chr6","41203792","41204100","12","731282"
"chr4","40476872","40477152","chr6","41208097","41208377","4","731225"
"chr4","40522944","40523064","chr6","41255012","41255132","5","732068"
"chr4","40523092","40523248","chr6","41255154","41255310","1","732062"
"chr4","40590479","40590772","chr4","152226280","152226592","57","111635801"
"chr4","40623068","40623389","chr6","41354926","41355250","7","731858"
"chr4","40657653","40657934","chr6","41391886","41392181","18","734233"
"chr4","40680619","40680751","chr13","19492404","19492536","25","21188215"
"chr4","40689970","40690251","chr6","41424899","41425180","5","734929"
"chr4","40693005","40693244","chr13","34794996","34795242","45","5898009"
"chr4","40696634","40696944","chr6","41431467","41431778","7","734833"
"chr4","40741296","40741594","chr6","41476633","41476933","11","735337"
"chr4","40780449","40780739","chr6","41522023","41522297","24","741574"
"chr4","40810571","40810849","chr6","41558742","41559021","6","748171"
"chr4","40908801","40909095","chr6","41661642","41661941","10","752841"
"chr4","40954902","40955180","chr1","83790487","83790766","57","42835585"
"chr4","41053016","41053320","chr7","92332842","92333152","55","51279826"
"chr4","41222380","41222648","chr6","41983131","41983399","13","760751"
"chr4","41633560","41633862","chr6","42384280","42384582","6","750720"
"chr4","41673428","41673700","chr6","42430360","42430635","7","756932"
"chr4","41683164","41683462","chr6","42440109","42440397","14","756945"
"chr4","41689783","41690073","chr6","42445649","42445937","25","755866"
"chr4","41690384","41690502","chr10","7392070","7392198","45","34298314"
"chr4","41694433","41694483","chr2","86246709","86246757","16","44552276"
"chr4","41694787","41694956","chr4","146081163","146081333","37","104386376"
"chr4","41711874","41712156","chr6","42468931","42469213","5","757057"
"chr4","41738505","41738779","chr6","42496816","42497091","5","758311"
"chr4","41749017","41749309","chr6","42506455","42506751","12","757438"
"chr4","41753953","41754263","chr1","13297571","13297870","81","28456382"
"chr4","41761777","41762052","chr6","42518806","42519082","12","757029"
"chr4","41767817","41768146","chrX","60214254","60214566","96","18446437"
"chr4","41772720","41773009","chr6","42535366","42535649","13","762646"
"chr4","41779747","41780030","chr6","42547699","42547982","7","767952"
"chr4","41783142","41783311","chr4","153955031","153955201","36","112171889"
"chr4","41783626","41783754","chr1","18409954","18410078","22","23373672"
"chr4","41784837","41785062","chr6","42447339","42447549","60","662502"
"chr4","41794284","41794576","chr6","42559117","42559412","8","764833"
"chr4","41803613","41803902","chr6","42568709","42569003","8","765096"
"chr4","41811640","41811724","chr6","42577448","42577532","1","765808"
"chr4","41833926","41834226","chr6","42602039","42602332","25","768113"
"chr4","41872499","41872689","chr9","88524250","88524424","39","46651751"
"chr4","41872725","41872843","chr3","131605399","131605517","22","89732674"
"chr4","41886784","41887094","chr6","42656774","42657086","7","769990"
"chr4","41905860","41906154","chr6","42675015","42675308","6","769155"
"chr4","41926457","41926740","chr6","42695846","42696149","27","769389"
"chr4","41927973","41928259","chr6","42697358","42697646","7","769385"
"chr4","41929296","41929587","chr6","42698665","42698956","6","769369"
"chr4","41934025","41934332","chr6","42703338","42703645","11","769313"
"chr4","41938471","41938774","chr10","30907821","30908124","55","11030650"
"chr4","41945599","41945857","chr6","42715230","42715488","2","769631"
"chr4","41952653","41952853","chr6","42720520","42720720","3","767867"
"chr4","41964391","41964683","chr6","42736449","42736740","9","772058"
"chr4","41984143","41984435","chr6","42757715","42758008","7","773572"
"chr4","41992841","41993137","chr6","42766269","42766565","7","773428"
"chr4","41993577","41993715","chr1","34737481","34737621","28","7256096"
"chr4","42015921","42016208","chrX","49643008","49643298","61","7627087"
"chr4","42022666","42022955","chr6","42798693","42798962","24","776027"
"chr4","42026449","42026762","chr6","42803368","42803681","8","776919"
"chr4","42030046","42030208","chr2","41160515","41160670","30","869531"
"chr4","42103165","42103469","chr6","42891076","42891370","14","787911"
"chr4","42136480","42136798","chr6","42924169","42924521","40","787689"
"chr4","42137688","42137936","chr20","13675962","13676190","68","28461726"
"chr4","42175633","42175838","chr6","42963137","42963357","17","787504"
"chr4","42176695","42176740","chr5","79602608","79602654","10","37425913"
"chr4","42178439","42178667","chr3","62373588","62373816","45","20195149"
"chr4","42189336","42189488","chr16","45439753","45439906","26","3250417"
"chr4","42195758","42196049","chr6","42983245","42983532","12","787487"
"chr4","42197937","42198236","chr6","42985425","42985724","5","787488"
"chr4","42231130","42231435","chr6","143406031","143406335","50","101174901"
"chr4","42236728","42237010","chr6","43021693","43021975","2","784965"
"chr4","42238781","42238940","chr6","43023740","43023893","8","784959"
"chr4","42238975","42239278","chr6","43023933","43024252","20","784958"
"chr4","42350843","42351157","chr6","43135924","43136240","10","785081"
"chr4","42352978","42353180","chr6","43138066","43138264","7","785088"
"chr4","42421140","42421409","chr6","43205299","43205569","7","784159"
"chr4","42436557","42436861","chr6","43221715","43222011","13","785158"
"chr4","42789625","42789897","chr6","43589342","43589614","16","799717"
"chr4","42891465","42891646","chr6","125315258","125315425","52","82423793"
"chr4","43097180","43097424","chr6","43876705","43876999","58","779525"
"chr4","43101974","43102241","chr6","43881591","43881858","2","779617"
"chr4","43104444","43104612","chr11","60191093","60191260","39","17086649"
"chr4","43154626","43154865","chr6","43933936","43934155","26","779310"
"chr4","43189546","43189677","chr6","43968571","43968702","1","779025"
"chr4","43200946","43201194","chr6","43980068","43980322","13","779122"
"chr4","43296079","43296359","chr6","44082747","44082981","52","786668"
"chr4","43300936","43300969","chr16","50138879","50138914","4","6837943"
"chr4","43300994","43301154","chr10","27501941","27502094","28","15799053"
"chr4","43445370","43445669","chr6","44254124","44254423","4","808754"
"chr4","43459770","43460064","chr6","44268671","44268965","10","808901"
"chr4","43489199","43489276","chr6","102750451","102750527","2","59261252"
"chr4","43692169","43692447","chr7","19968398","19968677","72","23723771"
"chr4","44058148","44058431","chr6","44878812","44879095","3","820664"
"chr4","44068959","44069254","chr6","44885493","44885786","8","816534"
"chr4","44106382","44106544","chr6","44922452","44922614","1","816070"
"chr4","44204624","44204925","chr6","45022145","45022446","5","817521"
"chr4","44356677","44356873","chr6","45183521","45183713","10","826844"
"chr4","44497400","44497669","chr6","45322628","45322924","33","825228"
"chr4","44497724","44497738","chr1","72742630","72742643","2","28244906"
"chr4","44499447","44499706","chr6","45324641","45324914","19","825194"
"chr4","46611602","46611898","chr19","50831642","50831941","61","4220040"
"chr4","46652022","46652097","chr16","66816782","66816860","18","20164760"
"chr4","46659372","46659447","chr16","66816782","66816860","18","20157410"
"chr4","46702567","46702879","chr13","41851851","41852159","66","4850716"
"chr4","46727280","46727354","chr6","46377755","46377820","10","349525"
"chr4","46786508","46786804","chr1","55288297","55288596","57","8501789"
"chr4","46835875","46836034","chr6","46491694","46491864","14","344181"
"chr4","46837051","46837279","chr6","46492876","46493104","7","344175"
"chr4","46872617","46872739","chr6","46527948","46528068","4","344669"
"chr4","46876658","46876939","chr6","46531977","46532259","7","344681"
"chr4","46908543","46908644","chr6","46562662","46562764","6","345881"
"chr4","46958226","46958508","chr6","46607293","46607574","5","350933"
"chr4","46984557","46984616","chr6","46633626","46633685","1","350931"
"chr4","46986857","46987086","chr6","46635933","46636158","6","350924"
"chr4","47001903","47002201","chr6","46650974","46651279","14","350929"
"chr4","47016709","47016992","chr6","46665846","46666127","8","350863"
"chr4","47047371","47047470","chr19","9707015","9707106","28","37340356"
"chr4","47086076","47086308","chr1","28421194","28421442","59","18664882"
"chr4","47100598","47100914","chr6","46752969","46753270","20","347629"
"chr4","47190312","47190591","chr1","54916700","54916978","53","7726388"
"chr4","47228538","47228789","chr6","46882510","46882759","8","346028"
"chr4","47247092","47247154","chr20","31886007","31886070","11","15361085"
"chr4","47305680","47305950","chr6","46960496","46960800","43","345184"
"chr4","47523664","47523949","chr6","47191735","47192032","22","331929"
"chr4","47543433","47543619","chr6","47210194","47210380","6","333239"
"chr4","47626350","47626647","chr6","47294959","47295256","4","331391"
"chr4","47646936","47647234","chr6","47315827","47316139","15","331109"
"chr4","47790343","47790493","chr6","47464119","47464268","8","326224"
"chr4","47911020","47911314","chr6","47595949","47596243","9","315071"
"chr4","47957602","47957887","chr6","47642496","47642781","7","315106"
"chr4","48000526","48000846","chr6","47688232","47688556","9","312294"
"chr4","48003810","48004094","chr6","47691515","47691799","6","312295"
"chr4","48121859","48122152","chr6","47822201","47822494","8","299658"
"chr4","48177197","48177467","chr6","47879740","47880010","4","297457"
"chr4","48232784","48233066","chr6","47948197","47948482","11","284587"
"chr4","48256168","48256449","chr6","47969241","47969522","6","286927"
"chr4","48266386","48266664","chr6","47979437","47979741","39","286949"
"chr4","48273641","48273914","chr6","47986721","47986995","19","286920"
"chr4","48292047","48292207","chr6","48005162","48005320","3","286885"
"chr4","48318364","48318587","chr6","48032349","48032572","8","286015"
"chr4","48323004","48323147","chr6","48036975","48037105","15","286029"
"chr4","48401628","48401681","chr6","48119145","48119189","10","282483"
"chr4","48454816","48455103","chr6","48174389","48174677","6","280427"
"chr4","48527060","48527285","chr6","48262636","48262861","21","264424"
"chr4","48614516","48614697","chr6","48351519","48351692","9","262997"
"chr4","48798133","48798435","chr6","48543745","48544029","25","254388"
"chr4","48907239","48907511","chr6","48657698","48657972","7","249541"
"chr4","48964320","48964399","chr8","122713960","122714043","19","73749640"
"chr4","48975647","48975930","chr6","48726791","48727077","7","248856"
"chr4","49003204","49003414","chr6","48753886","48754096","2","249318"
"chr4","49133640","49133939","chr6","48881994","48882283","17","251646"
"chr4","49156016","49156328","chr6","48904940","48905245","8","251076"
"chr4","49239986","49240100","chr6","48989909","48990023","2","250077"
"chr4","49442749","49443046","chr6","49198150","49198447","3","244599"
"chr4","49457683","49457983","chr6","49213349","49213619","39","244334"
"chr4","49498585","49498866","chr6","49253463","49253744","8","245122"
"chr4","49587385","49587676","chr6","49342254","49342545","4","245131"
"chr4","49675300","49675587","chr6","49429704","49429990","11","245596"
"chr4","49677756","49678042","chr6","49432164","49432446","11","245592"
"chr4","49708618","49708945","chr6","49463609","49463936","7","245009"
"chr4","49731495","49731790","chr6","49489161","49489488","39","242334"
"chr4","49761838","49762124","chr6","49520039","49520326","5","241799"
"chr4","49786989","49787193","chr6","49545146","49545351","5","241843"
"chr4","49787766","49787859","chr6","49545921","49546020","7","241845"
"chr4","49876971","49877250","chr6","49632327","49632595","19","244644"
"chr4","49885575","49885880","chr6","49640901","49641206","10","244674"
"chr4","49907068","49907363","chr6","49662718","49663009","8","244350"
"chr4","49913850","49914141","chr6","49669186","49669461","32","244664"
"chr4","49924451","49924745","chr2","48050554","48050859","77","1873897"
"chr4","49971194","49971510","chr8","114667413","114667711","76","64696219"
"chr4","50010566","50010835","chr6","164840820","164841075","52","114830254"
"chr4","50042198","50042348","chr4","151070766","151070923","34","101028568"
"chr4","50099317","50099609","chr6","49862775","49863066","4","236542"
"chr4","50169876","50170189","chr6","49933554","49933867","6","236322"
"chr4","50180879","50181152","chr6","49944712","49944985","8","236167"
"chr4","50197741","50198027","chr6","49961494","49961778","6","236247"
"chr4","50227509","50227797","chr6","49994145","49994429","12","233364"
"chr4","50241504","50241784","chr6","50011138","50011418","5","230366"
"chr4","50274391","50274705","chr12","100810682","100810996","61","50536291"
"chr4","50311983","50312282","chr6","50087677","50087976","13","224306"
"chr4","50334369","50334641","chr6","50111743","50112015","6","222626"
"chr4","50342412","50342686","chr6","50119789","50120063","3","222623"
"chr4","50355872","50356172","chr6","50133161","50133458","8","222711"
"chr4","50523045","50523317","chr6","50304088","50304360","4","218957"
"chr4","50536377","50536503","chr1","204353764","204353889","23","153817387"
"chr4","50540175","50540480","chr6","50321226","50321532","6","218949"
"chr4","50541028","50541316","chr6","50322080","50322368","2","218948"
"chr4","50545398","50545691","chr6","50326435","50326733","15","218963"
"chr4","50569456","50569786","chr6","50351589","50351881","44","217867"
"chr4","50584739","50585046","chr6","50367110","50367420","7","217629"
"chr4","50597976","50598239","chr6","50380846","50381109","5","217130"
"chr4","50627643","50627661","chr6","50411383","50411401","0","216260"
"chr4","50627698","50627949","chr6","50411447","50411697","2","216251"
"chr4","50659230","50659482","chr6","50442674","50442957","43","216556"
"chr4","50690079","50690193","chr11","27275028","27275139","19","23415051"
"chr4","50690295","50690458","chr12","23099834","23100001","32","27590461"
"chr4","50695377","50695691","chr6","50479672","50479984","5","215705"
"chr4","50708973","50709143","chr6","50493580","50493774","33","215393"
"chr4","50710452","50710515","chrX","63538907","63538972","12","12828455"
"chr4","50720003","50720280","chr6","50504940","50505215","8","215063"
"chr4","50737793","50738071","chr6","50522980","50523258","5","214813"
"chr4","50757473","50757771","chr6","50546773","50547073","11","210700"
"chr4","50763284","50763570","chr6","50550475","50550761","4","212809"
"chr4","50764631","50764917","chr16","3695771","3696066","63","47068860"
"chr4","50777754","50778053","chr6","50565230","50565533","31","212524"
"chr4","50801359","50801479","chr6","50589146","50589266","1","212213"
"chr4","50804558","50804878","chr1","55288297","55288596","80","4483739"
"chr4","50825733","50825904","chr6","50613480","50613651","4","212253"
"chr4","50825934","50826053","chr6","50613698","50613817","1","212236"
"chr4","50838378","50838671","chr6","50626150","50626448","16","212228"
"chr4","50873351","50873618","chr6","50661006","50661258","21","212345"
"chr4","50878906","50879211","chr6","50666377","50666682","7","212529"
"chr4","50899204","50899519","chr6","50686945","50687242","46","212259"
"chr4","50917951","50918051","chr19","12123499","12123598","19","38794452"
"chr4","50977686","50977979","chr6","50764861","50765151","9","212825"
"chr4","51047126","51047420","chr6","50837720","50838015","21","209406"
"chr4","51060638","51060889","chr6","50851235","50851486","5","209403"
"chr4","51071779","51072067","chr6","50862308","50862593","8","209471"
"chr4","51101092","51101365","chr6","50891377","50891650","4","209715"
"chr4","51123408","51123744","chr6","50913651","50913955","41","209757"
"chr4","51175130","51175417","chr6","50962549","50962837","16","212581"
"chr4","51191146","51191170","chr2","80838771","80838795","4","29647625"
"chr4","51191197","51191470","chr6","50979705","50979980","6","211492"
"chr4","51249492","51249775","chr6","51044705","51044988","4","204787"
"chr4","51278763","51279057","chr6","51072032","51072325","7","206731"
"chr4","51352940","51353162","chr6","51151632","51151853","5","201308"
"chr4","51358730","51358902","chr6","51157423","51157583","15","201307"
"chr4","51367391","51367681","chr6","51169500","51169777","15","197891"
"chr4","51383766","51384060","chr6","51186526","51186820","10","197240"
"chr4","51385984","51386293","chr6","51188746","51189057","10","197238"
"chr4","51387267","51387581","chr5","142565235","142565540","60","91177968"
"chr4","51400909","51401204","chr6","51202781","51203091","18","198128"
"chr4","51401211","51401321","chr6","51203095","51203207","2","198116"
"chr4","51426989","51427107","chr6","51230537","51230652","6","196452"
"chr4","51429880","51430172","chr6","51232058","51232350","6","197822"
"chr4","51434012","51434267","chr6","51236518","51236773","6","197494"
"chr4","51460073","51460394","chr6","51261660","51261981","3","198413"
"chr4","51472759","51473063","chr6","51274297","51274597","6","198462"
"chr4","51477039","51477367","chr6","51278910","51279215","36","198129"
"chr4","51485630","51485915","chr6","51287482","51287771","6","198148"
"chr4","51486576","51486863","chr6","51288210","51288498","3","198366"
"chr4","51515290","51515605","chr6","51317577","51317889","9","197713"
"chr4","51538918","51539121","chr6","51343591","51343788","9","195327"
"chr4","51549332","51549634","chr6","51354043","51354354","17","195289"
"chr4","51559971","51560261","chr6","51364735","51365034","11","195236"
"chr4","51565723","51565965","chr7","144572360","144572594","64","93006637"
"chr4","51579638","51579828","chr11","7030377","7030565","49","44549261"
"chr4","51580159","51580292","chr19","9170278","9170412","27","42409881"
"chr4","51584679","51584951","chr5","35718571","35718843","63","15866108"
"chr4","51591933","51592235","chr6","51397069","51397369","9","194864"
"chr4","51604438","51604750","chr6","51409886","51410191","15","194552"
"chr4","51608926","51609109","chr6","51414335","51414518","4","194591"
"chr4","51638013","51638318","chr6","51443697","51444002","6","194316"
"chr4","51643971","51644280","chr6","51449628","51449937","6","194343"
"chr4","51661408","51661669","chr6","51466317","51466578","8","195091"
"chr4","51690332","51690393","chr6","51490952","51491018","5","199380"
"chr4","51698176","51698475","chr6","51498686","51499000","20","199490"
"chr4","51703755","51704064","chr6","51504290","51504599","9","199465"
"chr4","51737101","51737414","chr6","51536805","51537107","19","200296"
"chr4","51745898","51746175","chr6","51547396","51547692","22","198502"
"chr4","51761432","51761745","chr3","178240315","178240614","68","126478883"
"chr4","51765202","51765343","chr6","51564391","51564532","4","200811"
"chr4","51765651","51765816","chr6","51564842","51565009","3","200809"
"chr4","51770012","51770129","chr6","31568190","31568307","19","20201822"
"chr4","51796367","51796664","chr6","51597030","51597327","7","199337"
"chr4","51803197","51803472","chr6","51603793","51604071","7","199404"
"chr4","51804485","51804780","chr6","51605074","51605375","8","199411"
"chr4","51810176","51810484","chr6","51610957","51611235","42","199219"
"chr4","51816972","51817300","chr6","51617480","51617812","16","199492"
"chr4","51844324","51844603","chr6","51644582","51644891","37","199742"
"chr4","51853553","51853845","chr6","51654229","51654513","18","199324"
"chr4","51854987","51855042","chr5","23147775","23147829","11","28707212"
"chr4","51856690","51856778","chr6","51657186","51657272","4","199504"
"chr4","51857074","51857211","chr6","51657566","51657723","22","199508"
"chr4","51860689","51860821","chr15","97072995","97073126","25","45212306"
"chr4","51868529","51868694","chr13","99761862","99762027","29","47893333"
"chr4","51873711","51873993","chr6","51682971","51683254","4","190740"
"chr4","51883559","51883866","chr6","51692379","51692674","17","191180"
"chr4","51898010","51898291","chr6","51706240","51706519","6","191770"
"chr4","51899698","51900023","chr6","51707932","51708241","18","191766"
"chr4","51913164","51913465","chr6","51721401","51721706","6","191763"
"chr4","51918468","51918715","chr6","51726671","51726918","5","191797"
"chr4","51920716","51921007","chr6","51728910","51729201","6","191806"
"chr4","51924769","51925052","chr6","51732805","51733088","6","191964"
"chr4","51951953","51952226","chr6","51762175","51762454","18","189778"
"chr4","51961304","51961400","chr6","51771545","51771640","2","189759"
"chr4","51974068","51974359","chr6","51783456","51783747","6","190612"
"chr4","51993162","51993458","chr6","51801580","51801880","10","191582"
"chr4","52018975","52019270","chr6","51827056","51827352","10","191919"
"chr4","52035207","52035383","chr6","51842942","51843118","3","192265"
"chr4","52042178","52042464","chr6","51850360","51850647","6","191818"
"chr4","52043491","52043796","chr6","51862409","51862715","4","181082"
"chr4","52045987","52046296","chr6","51864912","51865221","7","181075"
"chr4","52098509","52098816","chr6","51917367","51917661","22","181142"
"chr4","52120426","52120721","chr6","51939594","51939883","15","180832"
"chr4","52135650","52135813","chr6","51955005","51955168","1","180645"
"chr4","52154396","52154692","chr6","51974231","51974527","7","180165"
"chr4","52189164","52189449","chr6","52009038","52009317","11","180126"
"chr4","52197009","52197309","chr6","52016326","52016626","8","180683"
"chr4","52209965","52210125","chr6","52029309","52029469","5","180656"
"chr4","52221336","52221625","chr6","52040786","52041075","9","180550"
"chr4","52225518","52225764","chr6","52044690","52044953","18","180828"
"chr4","52271713","52271997","chr6","52091908","52092193","4","179805"
"chr4","52277099","52277256","chr7","53483520","53483679","25","1206421"
"chr4","52277284","52277409","chr14","110451581","110451702","23","58174297"
"chr4","52317566","52317871","chr6","52136352","52136658","10","181214"
"chr4","52318017","52318321","chr6","52136809","52137113","3","181208"
"chr4","52325351","52325658","chr6","52152347","52152657","16","173004"
"chr4","52331545","52331839","chr6","52146032","52146330","14","185513"
"chr4","52342679","52342976","chr6","52163869","52164164","11","178810"
"chr4","52344053","52344119","chr7","63597916","63597985","12","11253863"
"chr4","52345146","52345445","chr6","52166339","52166634","14","178807"
"chr4","52358526","52358815","chr6","52180375","52180664","7","178151"
"chr4","52373657","52373930","chr6","52195394","52195667","8","178263"
"chr4","52393143","52393328","chr1","162238155","162238336","40","109845012"
"chr4","52399208","52399506","chr6","52221199","52221497","7","178009"
"chr4","52415214","52415375","chr6","52236982","52237145","6","178232"
"chr4","52420013","52420075","chr6","52241754","52241816","4","178259"
"chr4","52424080","52424377","chr6","52245518","52245818","8","178562"
"chr4","52442836","52443150","chr6","52264166","52264478","12","178670"
"chr4","52471385","52471674","chr6","52292711","52293001","6","178674"
"chr4","52472538","52472848","chr6","52293870","52294181","12","178668"
"chr4","52483443","52483573","chr6","52309422","52309555","5","174021"
"chr4","52483863","52484004","chr6","52309845","52309986","3","174018"
"chr4","52509567","52509866","chr6","52335356","52335656","6","174211"
"chr4","52512791","52513057","chr13","92792576","92792858","57","40279785"
"chr4","52520361","52520664","chr6","52346545","52346840","16","173816"
"chr4","52573747","52574039","chr6","52405661","52405958","11","168086"
"chr4","52619581","52619867","chr6","52455840","52456124","6","163741"
"chr4","52651329","52651627","chr6","52490537","52490829","10","160792"
"chr4","52759075","52759362","chr6","52594992","52595275","8","164083"
"chr4","52822229","52822544","chr6","52658121","52658435","4","164108"
"chr4","52924271","52924567","chrX","40303897","40304177","67","12620374"
"chr4","53020984","53021279","chr6","52858835","52859130","7","162149"
"chr4","53056940","53057255","chr4","51463371","51463679","65","1593569"
"chr4","53076356","53076637","chr6","52915466","52915760","19","160890"
"chr4","53116973","53117242","chr6","52956057","52956344","24","160916"
"chr4","53140466","53140774","chr6","52979226","52979534","6","161240"
"chr4","53154267","53154560","chr6","52992783","52993081","8","161484"
"chr4","53229355","53229653","chr6","53068666","53068964","8","160689"
"chr4","53235038","53235341","chr6","53073932","53074242","20","161106"
"chr4","53277400","53277482","chr6","143182053","143182129","22","89904653"
"chr4","53277790","53277972","chr20","22152004","22152180","44","31125786"
"chr4","53287648","53287930","chr6","53126910","53127192","11","160738"
"chr4","53295792","53296088","chr6","53135443","53135747","15","160349"
"chr4","53345471","53345766","chr18","71609259","71609530","75","18263788"
"chr4","53345779","53346077","chr6","53196034","53196343","18","149745"
"chr4","53347830","53348107","chr6","53198075","53198351","4","149755"
"chr4","53355541","53355814","chrX","17348181","17348454","81","36007360"
"chr4","53358067","53358144","chr2","149704688","149704765","16","96346621"
"chr4","53358145","53358373","chr1","220165804","220166031","60","166807659"
"chr4","53360402","53360491","chr6","53204714","53204804","2","155688"
"chr4","53360530","53360654","chr6","53204842","53204962","5","155688"
"chr4","53370424","53370695","chr6","53215335","53215623","28","155089"
"chr4","53376955","53377262","chr6","53221883","53222182","12","155072"
"chr4","53391029","53391099","chr6","53236803","53236873","0","154226"
"chr4","53399452","53399533","chr6","53245174","53245256","6","154278"
"chr4","53399646","53399948","chr6","53245367","53245667","8","154279"
"chr4","53401191","53401314","chr6","53247005","53247118","14","154186"
"chr4","53401539","53401849","chr6","53247364","53247676","4","154175"
"chr4","53417833","53418144","chr6","53263808","53264113","12","154025"
"chr4","53418779","53419054","chr4","48671127","48671406","61","4747652"
"chr4","53421086","53421385","chr6","53266606","53266899","11","154480"
"chr4","53423687","53423972","chr6","53269216","53269503","16","154471"
"chr4","53425673","53425918","chr6","53271054","53271297","9","154619"
"chr4","53427108","53427311","chr6","53273320","53273519","14","153788"
"chr4","53427623","53427710","chr6","53273830","53273916","4","153793"
"chr4","53432220","53432523","chr6","53278692","53278966","46","153528"
"chr4","53434513","53434787","chr6","53280924","53281234","39","153589"
"chr4","53435963","53436258","chr6","53282410","53282719","19","153553"
"chr4","53438553","53438835","chr6","53284963","53285234","18","153590"
"chr4","53448088","53448213","chr6","53294543","53294668","5","153545"
"chr4","53474098","53474349","chr6","53319636","53319887","3","154462"
"chr4","53474985","53475283","chr6","53320515","53320820","11","154470"
"chr4","53478705","53478994","chr6","53324228","53324513","19","154477"
"chr4","53483594","53483889","chr6","53329407","53329698","6","154187"
"chr4","53525648","53525952","chr16","996804","997095","68","52528844"
"chr4","53527707","53527987","chr6","53373672","53373954","13","154035"
"chr4","53538764","53538996","chr6","53384756","53384988","1","154008"
"chr4","53549442","53549741","chr12","84818879","84819185","55","31269437"
"chr4","53560114","53560401","chr6","53406046","53406333","8","154068"
"chr4","53621632","53621917","chr8","10034943","10035230","53","43586689"
"chr4","53625172","53625478","chr6","53476130","53476438","10","149042"
"chr4","53655056","53655181","chr6","53505717","53505849","11","149339"
"chr4","53776425","53776688","chr6","53632368","53632669","43","144057"
"chr4","53818302","53818467","chr6","53684473","53684638","1","133829"
"chr4","53970711","53970833","chr6","53839419","53839536","8","131292"
"chr4","54051638","54051955","chr6","53920504","53920820","7","131134"
"chr4","54100930","54101250","chr6","53968512","53968834","16","132418"
"chr4","54185559","54185866","chr6","54059799","54060105","11","125760"
"chr4","54330490","54330799","chr6","54205274","54205580","9","125216"
"chr4","54370238","54370548","chr6","54244616","54244948","38","125622"
"chr4","54398449","54398769","chr6","54272652","54272967","18","125797"
"chr4","54438841","54439154","chr6","54312696","54313009","6","126145"
"chr4","54457883","54458161","chr6","54331735","54332022","18","126148"
"chr4","54485559","54485840","chr6","54359523","54359820","28","126036"
"chr4","54489962","54489972","chr19","28248347","28248357","1","26241615"
"chr4","54490007","54490260","chr6","54363981","54364253","25","126026"
"chr4","54587423","54587704","chr18","51648152","51648440","53","2939271"
"chr4","54611975","54612263","chr6","54483783","54484071","5","128192"
"chr4","54665558","54665857","chr6","54537601","54537897","10","127957"
"chr4","54717976","54718135","chr6","54589288","54589448","2","128688"
"chr4","54731389","54731561","chr6","54602620","54602791","1","128769"
"chr4","54739054","54739171","chr6","132323152","132323268","6","77584098"
"chr4","54818595","54818903","chr6","54690974","54691283","4","127621"
"chr4","54990117","54990418","chr6","54862594","54862906","25","127523"
"chr4","55196500","55196772","JH679691","21701","21980","12","55174799"
"chr4","55251880","55252180","JH679691","77347","77652","14","55174533"
"chr4","55271969","55272276","JH679691","97688","97996","10","55174281"
"chr4","55284676","55284961","JH679691","109535","109839","29","55175141"
"chr4","55334006","55334266","JH679691","159537","159797","3","55174469"
"chr4","55337402","55337716","JH679691","162940","163245","18","55174462"
"chr4","55344981","55345262","chr2","144685437","144685719","62","89340456"
"chr4","55346918","55347216","JH679691","172370","172668","13","55174548"
"chr4","55383147","55383457","JH679691","208525","208830","8","55174622"
"chr4","55395039","55395330","JH679691","220299","220589","2","55174740"
"chr4","55397678","55397940","JH679691","222956","223223","14","55174722"
"chr4","55426938","55427251","chr14","64863152","64863451","78","9436214"
"chr4","55429229","55429511","JH679691","256652","256938","19","55172577"
"chr4","55520729","55521020","JH679691","348502","348793","11","55172227"
"chr4","55542664","55542950","JH679691","370590","370895","25","55172074"
"chr4","55561689","55562011","JH679691","389528","389849","7","55172161"
"chr4","55613711","55614007","chr6","55086352","55086644","13","527359"
"chr4","55701814","55702123","chr6","55175973","55176282","7","525841"
"chr4","55740544","55740826","chr7","45303579","45303864","59","10436965"
"chr4","55843431","55843574","chr6","55316216","55316358","9","527215"
"chr4","55847431","55847738","chr6","55320221","55320513","24","527210"
"chr4","55851578","55851880","chr6","55324373","55324680","12","527205"
"chr4","55871685","55871998","chr6","55344533","55344842","13","527152"
"chr4","55878602","55878652","chr6","55351296","55351346","1","527306"
"chr4","55878688","55879004","chr6","55351382","55351703","8","527306"
"chr4","55961035","55961333","chr6","55434185","55434484","7","526850"
"chr4","56088343","56088639","chr6","55561686","55561981","8","526657"
"chr4","56164648","56164920","chr6","55637789","55638062","6","526859"
"chr4","56238069","56238310","chr6","55712658","55712898","10","525411"
"chr4","56372578","56372868","chr6","55853432","55853723","12","519146"
"chr4","56454965","56455227","chr6","55935020","55935282","13","519945"
"chr4","56463803","56464100","chr6","55943854","55944154","7","519949"
"chr4","56645860","56646160","chr6","56129874","56130176","7","515986"
"chr4","56660730","56660882","chr6","56147448","56147600","5","513282"
"chr4","56707691","56707953","chr6","56194024","56194286","4","513667"
"chr4","56723759","56724024","chr6","56210360","56210646","28","513399"
"chr4","56729772","56730118","chr6","56216395","56216742","5","513377"
"chr4","56737551","56737817","chr6","56224167","56224439","11","513384"
"chr4","56799814","56799932","chr7","14701810","14701931","37","42098004"
"chr4","56869409","56869719","chr6","56363141","56363450","9","506268"
"chr4","56876083","56876236","chr10","36576010","36576177","20","20300073"
"chr4","56876564","56876622","chr8","56996326","56996377","12","119762"
"chr4","56890513","56890822","chr6","56383346","56383651","12","507167"
"chr4","56969171","56969479","chr14","63431170","63431477","53","6461999"
"chr4","56979285","56979565","chr6","56479816","56480123","32","499469"
"chr4","57017383","57017694","chr6","56519061","56519381","16","498322"
"chr4","57022250","57022549","chr6","56523692","56523983","14","498558"
"chr4","57033376","57033673","chr6","56534712","56535009","8","498664"
"chr4","57056689","57056943","chr6","56558601","56558855","1","498088"
"chr4","57126250","57126541","chrX","96318063","96318367","59","39191813"
"chr4","57139470","57139751","chr6","56642194","56642458","25","497276"
"chr4","57235540","57235838","chr6","56738658","56738963","37","496882"
"chr4","57290855","57291132","chr6","56796332","56796640","41","494523"
"chr4","57321205","57321513","chr6","56828644","56828953","2","492561"
"chr4","57340435","57340749","chr6","56847541","56847849","12","492894"
"chr4","57409213","57409471","chr6","56915255","56915513","5","493958"
"chr4","57441823","57442120","chr6","56947885","56948198","25","493938"
"chr4","57443379","57443694","chr6","56949454","56949767","12","493925"
"chr4","57445968","57446279","chr6","56952044","56952354","8","493924"
"chr4","57465154","57465173","chr9","35108421","35108438","3","22356733"
"chr4","57465209","57465358","chr1","9312949","9313097","30","48152260"
"chr4","57537562","57537730","chr6","57043737","57043905","5","493825"
"chr4","57539443","57539723","chr6","57045619","57045900","8","493824"
"chr4","57540144","57540450","chr6","57046322","57046627","12","493822"
"chr4","57541347","57541640","chr5","55622599","55622883","58","1918748"
"chr4","57557778","57557969","chr6","57064661","57064852","4","493117"
"chr4","57606753","57607060","chr6","57113531","57113831","10","493222"
"chr4","57622211","57622504","chr6","57129194","57129497","18","493017"
"chr4","57623060","57623362","chr6","57130056","57130352","14","493004"
"chr4","57708871","57709049","chr6","57215091","57215269","6","493780"
"chr4","57740068","57740361","chr6","57246652","57246961","20","493416"
"chr4","57745934","57746060","chr6","57252621","57252749","4","493313"
"chr4","57746380","57746538","chr6","57253069","57253227","4","493311"
"chr4","57757108","57757387","chr6","57264108","57264386","6","493000"
"chr4","57785864","57786172","chr6","57292740","57293050","12","493124"
"chr4","57854847","57855142","chr6","57363421","57363711","9","491426"
"chr4","57874198","57874459","chr6","57382356","57382607","13","491842"
"chr4","57881169","57881433","chr6","57389344","57389608","5","491825"
"chr4","58127112","58127394","chr6","57635457","57635747","12","491655"
"chr4","58161767","58162074","chr6","57668885","57669192","10","492882"
"chr4","58214848","58215153","chr6","57722502","57722807","2","492346"
"chr4","58271302","58271482","chr6","57780594","57780764","14","490708"
"chr4","58273718","58274011","chr6","57783130","57783424","5","490588"
"chr4","58284087","58284389","chr6","57793551","57793867","26","490536"
"chr4","58322495","58322801","chr6","57832879","57833181","14","489616"
"chr4","58323590","58323874","chr6","57833980","57834271","13","489610"
"chr4","58353255","58353548","chr6","57869796","57870089","6","483459"
"chr4","58364194","58364504","chr6","57880442","57880752","6","483752"
"chr4","58370786","58371088","chr6","57888273","57888571","9","482513"
"chr4","58386290","58386584","chr6","57902517","57902812","7","483773"
"chr4","58427926","58428206","chr6","57943619","57943926","37","484307"
"chr4","58435366","58435671","chr6","57951108","57951409","15","484258"
"chr4","58467875","58468026","chr6","57984997","57985132","28","482878"
"chr4","58481019","58481315","chr6","57998403","57998695","7","482616"
"chr4","58502590","58502894","chr6","58020240","58020546","11","482350"
"chr4","58502959","58503264","chr6","58020611","58020916","11","482348"
"chr4","58504579","58504875","chr6","58022202","58022502","11","482377"
"chr4","58507763","58508010","chr6","58024341","58024588","6","483422"
"chr4","58511089","58511390","chr6","58027667","58027965","20","483422"
"chr4","58526460","58526614","chr1","30091151","30091287","38","28435309"
"chr4","58528577","58528877","chr6","58044367","58044666","7","484210"
"chr4","58530218","58530522","chr6","58047281","58047585","5","482937"
"chr4","58538608","58538898","chr6","58056034","58056324","5","482574"
"chr4","58548080","58548374","chr6","58065635","58065929","7","482445"
"chr4","58550523","58550800","chr14","115089058","115089328","63","56538535"
"chr4","58558362","58558649","chr6","58075838","58076110","22","482524"
"chr4","58573698","58573993","chr6","58092276","58092572","9","481422"
"chr4","58575257","58575532","chr6","58094252","58094525","10","481005"
"chr4","58575741","58576034","chr6","58094743","58095036","10","480998"
"chr4","58579921","58580200","chr6","58098725","58099007","8","481196"
"chr4","58593089","58593394","chr6","58115229","58115533","13","477860"
"chr4","58597290","58597589","chr6","58106143","58106442","12","491147"
"chr4","58605737","58606042","chr6","58115229","58115533","13","490508"
"chr4","58609425","58609707","chr6","58118898","58119179","6","490527"
"chr4","58612881","58612993","chr6","58122345","58122457","1","490536"
"chr4","58621752","58622068","chr2","44247952","44248260","55","14373800"
"chr4","58626090","58626391","chr6","58135486","58135787","5","490604"
"chr4","58626946","58627202","chr6","58136372","58136627","8","490574"
"chr4","58637299","58637609","chr6","58146808","58147116","15","490491"
"chr4","58639084","58639230","chr6","58148577","58148723","0","490507"
"chr4","58643003","58643193","chr6","58151759","58151949","6","491244"
"chr4","58655093","58655394","chr6","58163228","58163527","13","491865"
"chr4","58665884","58666168","chr6","58173964","58174249","5","491920"
"chr4","58668810","58669095","chr6","58176901","58177186","7","491909"
"chr4","58678700","58678994","chr6","58186792","58187084","10","491908"
"chr4","58682229","58682518","chr6","58190305","58190594","6","491924"
"chr4","58685180","58685484","chr6","58193565","58193881","15","491615"
"chr4","58686687","58686978","chr6","58195550","58195826","27","491137"
"chr4","58689146","58689381","chr6","58198059","58198294","3","491087"
"chr4","58729680","58729979","chr6","58242120","58242419","9","487560"
"chr4","58730200","58730329","chr4","118775455","118775575","43","60045255"
"chr4","58752710","58752989","chr6","58267335","58267614","11","485375"
"chr4","58759317","58759632","chr6","58272577","58272892","11","486740"
"chr4","58763307","58763593","chr6","58276644","58276930","5","486663"
"chr4","58772921","58773212","chr6","58286244","58286546","19","486677"
"chr4","58796265","58796557","chr10","29529672","29529972","71","29266593"
"chr4","58827678","58827958","chr6","58339893","58340173","2","487785"
"chr4","58847500","58847711","chr6","58359350","58359561","6","488150"
"chr4","58849759","58849822","chr6","58361620","58361683","1","488139"
"chr4","58849918","58850153","chr6","58361779","58362012","8","488139"
"chr4","58853007","58853299","chr6","58365156","58365444","6","487851"
"chr4","58858196","58858494","chr6","58370342","58370640","5","487854"
"chr4","58883562","58883821","chr7","132651732","132652000","64","73768170"
"chr4","58906423","58906701","chr6","58423163","58423408","38","483260"
"chr4","58925358","58925642","chr6","58441779","58442070","35","483579"
"chr4","58934117","58934390","chr6","172279903","172280171","51","113345786"
"chr4","59001306","59001607","chr6","58525588","58525884","10","475718"
"chr4","59051836","59052127","chr6","58597719","58598007","11","454117"
"chr4","59095250","59095581","chr6","58645896","58646196","45","449354"
"chr4","59107291","59107378","chr6","58657880","58657967","2","449411"
"chr4","59111979","59112107","chrX","61671031","61671155","27","2559052"
"chr4","59115529","59115661","chr6","58666107","58666239","3","449422"
"chr4","59818970","59819214","chr6","59396293","59396516","32","422677"
"chr4","59887216","59887495","chr1","178768175","178768453","54","118880959"
"chr4","59946728","59947017","chr6","59526293","59526595","36","420435"
"chr4","60008895","60009203","chr6","59587271","59587579","10","421624"
"chr4","60030592","60030880","chr6","59610010","59610300","9","420582"
"chr4","60054359","60054650","chr6","59635018","59635312","10","419341"
"chr4","60132217","60132436","chr6","59711435","59711655","8","420782"
"chr4","60169611","60169790","chr6","59748719","59748898","3","420892"
"chr4","60274301","60274586","chr6","59865641","59865930","10","408660"
"chr4","60610390","60610694","chr6","60219206","60219504","22","391184"
"chr4","60638201","60638490","chr6","60248809","60249098","7","389392"
"chr4","60680774","60681062","chr6","60291769","60292062","13","389005"
"chr4","60685076","60685365","chr7","106856652","106856944","52","46171576"
"chr4","60690389","60690670","chr15","18184869","18185148","57","42505520"
"chr4","60766145","60766446","chr6","60377095","60377396","9","389050"
"chr4","60809617","60809917","chr6","60420859","60421166","23","388758"
"chr4","60827740","60828024","chr6","60443429","60443714","6","384311"
"chr4","60840033","60840138","chr6","60455713","60455816","2","384320"
"chr4","60840509","60840699","chr6","60456193","60456383","11","384316"
"chr4","60894912","60895185","chr8","10034943","10035230","54","50859969"
"chr4","60934446","60934758","chr6","60550758","60551062","12","383688"
"chr4","61225054","61225347","chr6","60842165","60842458","6","382889"
"chr4","61313112","61313265","chr6","60929793","60929944","7","383319"
"chr4","61313312","61313422","chr6","60929971","60930084","5","383341"
"chr4","61319563","61319876","chr6","60936546","60936866","15","383017"
"chr4","61353630","61353919","chr6","60973325","60973614","7","380305"
"chr4","61424007","61424314","chr6","61041618","61041916","12","382389"
"chr4","61424561","61424846","chr6","61042163","61042446","6","382398"
"chr4","61434822","61435111","chr6","61052075","61052363","3","382747"
"chr4","61440581","61440868","chr6","61057751","61058038","3","382830"
"chr4","61442585","61442725","chr2","94162758","94162902","32","32720173"
"chr4","61443680","61443800","chr14","18970034","18970159","21","42473646"
"chr4","61459321","61459618","chr1","190421310","190421602","49","128961989"
"chr4","61462014","61462333","chr19","34580230","34580548","8","26881784"
"chr4","61466567","61466856","chr6","61082949","61083244","10","383618"
"chr4","61491758","61492034","chr6","61107871","61108145","7","383887"
"chr4","61497081","61497176","chr6","61113512","61113607","0","383569"
"chr4","61497572","61497767","chr6","61114020","61114215","4","383552"
"chr4","61506380","61506499","chr6","87584999","87585119","19","26078619"
"chr4","61506526","61506666","chr15","76539494","76539620","42","15032968"
"chr4","61510386","61510699","chr2","153104813","153105122","60","91594427"
"chr4","61552657","61552954","chr6","61167962","61168260","2","384695"
"chr4","61559320","61559620","chr6","61175276","61175577","6","384044"
"chr4","61619268","61619335","chr1","30644596","30644660","13","30974672"
"chr4","61632406","61632704","chr6","61251181","61251477","10","381225"
"chr4","61685542","61685804","chr6","61302505","61302767","7","383037"
"chr4","61695033","61695169","chr6","61312283","61312419","5","382750"
"chr4","61722447","61722655","chr6","61340297","61340505","4","382150"
"chr4","61726781","61727056","chr6","61344609","61344880","7","382172"
"chr4","61732691","61732870","chr2","186798231","186798402","35","125065540"
"chr4","61732907","61733023","chr11","64136333","64136444","20","2403426"
"chr4","61798399","61798652","chr6","61420169","61420420","8","378230"
"chr4","61801785","61801981","chr6","61423524","61423720","7","378261"
"chr4","61814059","61814388","chr6","61436079","61436407","7","377980"
"chr4","61824399","61824623","chr6","61446425","61446649","5","377974"
"chr4","61840948","61841244","chr6","61462940","61463243","12","378008"
"chr4","61877352","61877607","chr5","101314123","101314375","50","39436771"
"chr4","61883503","61883782","chr6","61506354","61506633","6","377149"
"chr4","61884851","61884891","chr4","100863373","100863411","9","38978522"
"chr4","61898567","61898867","chr6","61521315","61521611","16","377252"
"chr4","61899435","61899551","chr16","53373122","53373239","20","8526313"
"chr4","61899588","61899754","chr19","35698409","35698577","28","26201179"
"chr4","61902363","61902661","chr6","61525292","61525590","8","377071"
"chr4","61915227","61915539","chr6","61538039","61538350","9","377188"
"chr4","61923445","61923739","chr6","61546278","61546572","6","377167"
"chr4","61926323","61926622","chr6","61549140","61549439","6","377183"
"chr4","61929149","61929424","chr6","61551953","61552226","16","377196"
"chr4","61930473","61930780","chr9","102340368","102340668","52","40409895"
"chr4","61930922","61931091","chr3","160740675","160740837","32","98809753"
"chr4","61931092","61931141","chr1","46968655","46968705","9","14962437"
"chr4","61938453","61938683","chr12","21656036","21656258","61","40282417"
"chr4","61946415","61946710","chr6","61567341","61567642","16","379074"
"chr4","61956578","61956910","chr6","61578634","61578954","24","377944"
"chr4","61958748","61958910","chr6","61580779","61580958","19","377969"
"chr4","61966079","61966368","chr6","61588130","61588426","11","377949"
"chr4","61966597","61966883","chr6","61588654","61588940","3","377943"
"chr4","61981983","61982271","chr6","61604736","61605023","4","377247"
"chr4","61986704","61986995","chr6","61609451","61609746","14","377253"
"chr4","61987668","61987955","chr6","61610419","61610705","6","377249"
"chr4","61988421","61988770","chr6","61611168","61611524","16","377253"
"chr4","61992209","61992515","chr6","61614967","61615273","9","377242"
"chr4","61994066","61994367","chr6","61616815","61617131","23","377251"
"chr4","62003989","62004282","chr6","61627082","61627375","3","376907"
"chr4","62004688","62004768","chr6","61627781","61627859","5","376907"
"chr4","62006936","62007230","chr6","61630031","61630324","6","376905"
"chr4","62027245","62027549","chr6","61650348","61650652","9","376897"
"chr4","62027780","62028060","chr6","61650883","61651163","7","376897"
"chr4","62041414","62041718","chr6","61664096","61664396","12","377318"
"chr4","62043291","62043588","chr6","61666011","61666312","11","377280"
"chr4","62056033","62056250","chr6","61679011","61679231","3","377022"
"chr4","62065809","62065905","chr6","61690657","61690760","8","375152"
"chr4","62066413","62066577","chr6","61691270","61691432","5","375143"
"chr4","62072373","62072668","chr6","61697278","61697575","5","375095"
"chr4","62074180","62074465","chr6","61699087","61699374","10","375093"
"chr4","62086188","62086288","chr6","61711079","61711179","1","375109"
"chr4","62089186","62089482","chr6","61714055","61714348","15","375131"
"chr4","62090948","62091247","chr6","61715814","61716113","9","375134"
"chr4","62094198","62094504","chr6","61719059","61719365","8","375139"
"chr4","62105254","62105564","chr6","61730076","61730386","8","375178"
"chr4","62107480","62107571","chr6","61732304","61732378","18","375176"
"chr4","62139556","62139841","chr6","61761759","61762039","10","377797"
"chr4","62141610","62141903","chr6","61763803","61764097","9","377807"
"chr4","62182793","62183068","chr6","61804380","61804657","7","378413"
"chr4","62192910","62193206","chr6","61814752","61815046","11","378158"
"chr4","62245236","62245529","chr6","61871965","61872257","10","373271"
"chr4","62245561","62245839","chr6","61872270","61872557","31","373291"
"chr4","62258615","62258697","chr6","61885379","61885447","14","373236"
"chr4","62271124","62271429","chr6","61898042","61898346","8","373082"
"chr4","62281027","62281312","chr6","61907956","61908252","13","373071"
"chr4","62319759","62320046","chr6","61945525","61945813","8","374234"
"chr4","62332499","62332661","chrX","44896932","44897093","28","17435567"
"chr4","62342823","62342960","chr6","61974650","61974787","4","368173"
"chr4","62360324","62360603","chr6","61992167","61992446","8","368157"
"chr4","62385182","62385257","chr1","53569749","53569824","17","8815433"
"chr4","62447922","62448221","chr6","62080514","62080809","10","367408"
"chr4","62461324","62461614","chr6","62092030","62092324","13","369294"
"chr4","62471132","62471436","chr6","62102156","62102461","9","368976"
"chr4","62477364","62477655","chr6","62108404","62108680","18","368960"
"chr4","62481091","62481374","chr6","62112093","62112371","9","368998"
"chr4","62515584","62515787","chr6","62146684","62146884","7","368900"
"chr4","62621626","62621939","chr6","71945525","71945829","72","9323899"
"chr4","62623614","62623874","chr6","62256084","62256345","5","367530"
"chr4","62663309","62663610","chr6","62296748","62297049","8","366561"
"chr4","62787243","62787529","chr6","62424958","62425256","19","362285"
"chr4","62816200","62816497","chr6","62453234","62453531","10","362966"
"chr4","62863862","62864209","chr6","62500479","62500791","40","363383"
"chr4","62935131","62935300","chr6","62570570","62570739","4","364561"
"chr4","62961879","62962170","chrX","91056145","91056435","56","28094266"
"chr4","62995850","62996185","chr6","62632371","62632708","12","363479"
"chr4","63011951","63012252","chr6","62648478","62648777","7","363473"
"chr4","63028672","63028976","chr6","62665251","62665555","8","363421"
"chr4","63055809","63056108","chr6","62692370","62692669","3","363439"
"chr4","63131180","63131497","chr6","62771003","62771321","21","360177"
"chr4","63195083","63195202","chr6","62834702","62834821","4","360381"
"chr4","63195513","63195664","chr6","62835142","62835291","9","360371"
"chr4","63206501","63206810","chr6","62846450","62846754","9","360051"
"chr4","63253285","63253573","chr6","62892747","62893035","5","360538"
"chr4","63330256","63330566","chr6","62969484","62969797","10","360772"
"chr4","63384437","63384736","chr6","63023597","63023895","6","360840"
"chr4","63449207","63449483","chr6","63088227","63088504","6","360980"
"chr4","63524402","63524710","chr6","63164049","63164357","2","360353"
"chr4","63577481","63577780","chr6","63220704","63220999","17","356777"
"chr4","63583356","63583638","chr2","12052111","12052399","59","51531245"
"chr4","63585734","63586013","chr6","63228825","63229099","13","356909"
"chr4","63592056","63592339","chr6","63239514","63239799","7","352542"
"chr4","63593246","63593483","chr1","160893032","160893268","55","97299786"
"chr4","63605703","63606007","chr6","63253203","63253512","15","352500"
"chr4","63619750","63620024","chr6","63266597","63266869","10","353153"
"chr4","63739968","63740245","chr6","63389511","63389788","4","350457"
"chr4","63805700","63805868","chr6","63454847","63455015","2","350853"
"chr4","63806225","63806345","chr6","63455372","63455492","0","350853"
"chr4","64098492","64098744","chr6","63763112","63763364","10","335380"
"chr4","64107279","64107359","chr3","41728810","41728887","15","22378469"
"chr4","64143029","64143157","chr11","3083251","3083379","27","61059778"
"chr4","64143265","64143383","chr5","72211322","72211444","21","8068057"
"chr4","64161507","64161762","chr6","63819807","63820063","19","341700"
"chr4","64248971","64249280","chr6","63908593","63908904","11","340378"
"chr4","64351860","64352076","chr6","64011986","64012202","11","339874"
"chr4","64352077","64352215","chr6","64012204","64012341","3","339873"
"chr4","64361198","64361494","chr6","64021520","64021820","10","339678"
"chr4","64427750","64427849","chr6","64088247","64088347","1","339503"
"chr4","64438115","64438429","chr6","64098614","64098928","9","339501"
"chr4","64510798","64511066","chr6","64170888","64171184","31","339910"
"chr4","64532285","64532549","chr6","64193221","64193485","6","339064"
"chr4","64564201","64564357","chr20","3720307","3720459","30","60843894"
"chr4","64575643","64575925","chr6","64236602","64236885","10","339041"
"chr4","64690787","64691089","chr4","55862516","55862820","61","8828271"
"chr4","64774691","64774997","chr6","64440294","64440597","13","334397"
"chr4","64823050","64823356","chr6","64488975","64489281","4","334075"
"chr4","64880237","64880542","chr6","64544935","64545241","11","335302"
"chr4","64908752","64909042","chr6","64573113","64573402","10","335639"
"chr4","64981694","64981977","chr6","64648202","64648504","31","333492"
"chr4","64995112","64995393","chr1","192268809","192269094","64","127273697"
"chr4","65017917","65018206","chr6","64684606","64684895","8","333311"
"chr4","65059568","65059876","chr6","64726261","64726568","9","333307"
"chr4","65060583","65060863","chr6","64727276","64727556","10","333307"
"chr4","65095524","65095825","chr4","132023114","132023423","59","66927590"
"chr4","65104431","65104499","chr7","158716377","158716438","18","93611946"
"chr4","65119760","65120035","chr6","64785389","64785666","16","334371"
"chr4","65134719","65134985","chr6","64800523","64800787","19","334196"
"chr4","65149550","65149837","chr6","64815443","64815729","10","334107"
"chr4","65151548","65151580","chr6","64817448","64817480","0","334100"
"chr4","65159477","65159778","chr6","64833597","64833903","16","325880"
"chr4","65182007","65182312","chr6","64849889","64850194","11","332118"
"chr4","65189324","65189509","chr6","64857068","64857245","12","332256"
"chr4","65193180","65193417","chr10","27800696","27800935","60","37392484"
"chr4","65196708","65196922","chr6","64865093","64865307","6","331615"
"chr4","65203539","65203729","chr6","64871898","64872098","14","331641"
"chr4","65203849","65204157","chr6","64872218","64872526","11","331631"
"chr4","65223570","65223688","chr9","26937961","26938081","19","38285609"
"chr4","65243084","65243224","chr16","3519601","3519735","27","61723483"
"chr4","65251474","65251763","JH682036","357821","358117","56","64893653"
"chr4","65252111","65252385","chr9","92718527","92718801","57","27466416"
"chr4","65253900","65254128","chr1","161877205","161877427","47","96623305"
"chr4","65254921","65255234","chr2","92053578","92053889","58","26798657"
"chr4","65258734","65258961","chr6","64919419","64919649","9","339315"
"chr4","65260757","65260890","chr6","64921195","64921311","25","339562"
"chr4","65262344","65262634","chr6","64922788","64923071","18","339556"
"chr4","65263635","65263927","chr20","55867580","55867882","24","9396055"
"chr4","65280035","65280319","chr6","64938910","64939193","12","341125"
"chr4","65287145","65287355","chr6","64946424","64946634","7","340721"
"chr4","65288533","65288810","chr11","92242519","92242805","66","26953986"
"chr4","65290277","65290460","chr6","64949851","64950034","6","340426"
"chr4","65290832","65290956","chr6","64950330","64950451","5","340502"
"chr4","65291535","65291799","chr14","11758420","11758684","59","53533115"
"chr4","65294093","65294393","chr6","64954123","64954425","10","339970"
"chr4","65303075","65303145","chr4","30581466","30581535","19","34721609"
"chr4","65309827","65310072","chr6","64961007","64961245","22","348820"
"chr4","65315269","65315518","chr6","64976899","64977181","38","338370"
"chr4","65316971","65317270","chr6","64978624","64978922","13","338347"
"chr4","65317429","65317720","chr6","64979388","64979679","10","338041"
"chr4","65319269","65319422","chr19","8728781","8728915","35","56590488"
"chr4","65332436","65332523","chr8","24110377","24110470","24","41222059"
"chr4","65344269","65344575","chr6","65005837","65006143","10","338432"
"chr4","65354252","65354538","chr10","28912190","28912483","66","36442062"
"chr4","65356249","65356549","chr6","65018820","65019120","6","337429"
"chr4","65362261","65362395","chr6","65025175","65025309","5","337086"
"chr4","65367577","65367716","chr6","65030346","65030485","5","337231"
"chr4","65369346","65369653","chr6","65032387","65032695","9","336959"
"chr4","65378183","65378403","chr6","65041124","65041348","16","337059"
"chr4","65389814","65389825","chr3","35836614","35836624","3","29553200"
"chr4","65390121","65390267","chr1","13335847","13335992","31","52054274"
"chr4","65395941","65396236","chr6","65067017","65067326","18","328924"
"chr4","65410779","65410944","chr11","110402020","110402179","33","44991241"
"chr4","65411729","65411892","chr6","65063438","65063614","17","348291"
"chr4","65416990","65417114","chr6","65084419","65084548","14","332571"
"chr4","65417419","65417573","chr6","65084848","65085002","8","332571"
"chr4","65440091","65440404","chr6","65119498","65119802","16","320593"
"chr4","65443678","65443976","chr6","65123455","65123753","8","320223"
"chr4","65448809","65449068","chr6","65128615","65128875","5","320194"
"chr4","65465607","65465916","chr6","65146844","65147153","10","318763"
"chr4","65469443","65469713","chr6","65150902","65151171","10","318541"
"chr4","65471066","65471268","chr6","65152455","65152657","7","318611"
"chr4","65480585","65480901","chr6","65159929","65160241","16","320656"
"chr4","65481315","65481592","chr6","65160967","65161244","7","320348"
"chr4","65490930","65491240","chrX","143014475","143014784","61","77523545"
"chr4","65491722","65491774","chr6","65172272","65172324","3","319450"
"chr4","65492082","65492232","chr1","146862849","146862999","29","81370767"
"chr4","65493794","65494091","chr6","65174850","65175114","48","318944"
"chr4","65509394","65509682","chr6","65189891","65190179","14","319503"
"chr4","65517740","65517929","chr16","45301217","45301409","38","20216523"
"chr4","65524670","65524970","chr6","65205652","65205956","8","319018"
"chr4","65531402","65531687","chr6","65212357","65212654","21","319045"
"chr4","65540847","65541195","chr7","157597597","157597931","98","92056750"
"chr4","65541989","65542157","chr6","65225999","65226167","3","315990"
"chr4","65542532","65542837","chr6","65226548","65226850","9","315984"
"chr4","65544390","65544660","chr6","65223783","65224053","5","320607"
"chr4","65559364","65559658","chr6","65249169","65249470","20","310195"
"chr4","65592716","65592880","chr6","65276252","65276415","3","316464"
"chr4","65603550","65603861","chr6","65287407","65287714","10","316143"
"chr4","65605650","65605932","chr6","65289845","65290127","18","315805"
"chr4","65619691","65619841","chr6","148154766","148154916","31","82535075"
"chr4","65624832","65624909","chr6","65309620","65309700","7","315212"
"chr4","65630107","65630233","chr14","120413917","120414031","43","54783810"
"chr4","65632762","65632938","chr3","46007627","46007792","41","19625135"
"chr4","65659664","65659957","chr6","65344359","65344652","6","315305"
"chr4","65686402","65686704","chr11","49468649","49468943","63","16217753"
"chr4","65692297","65692578","chr3","12644640","12644921","52","53047657"
"chr4","65694326","65694629","chr6","65378653","65378956","3","315673"
"chr4","65697047","65697343","chr6","65381214","65381519","17","315833"
"chr4","65708234","65708464","chr6","65393067","65393297","6","315167"
"chr4","65712914","65713075","chr6","65396254","65396415","5","316660"
"chr4","65726354","65726634","chr6","65411293","65411568","10","315061"
"chr4","65756198","65756268","chr17","4930115","4930187","17","60826083"
"chr4","65761284","65761390","chr20","17667801","17667909","26","48093483"
"chr4","65773507","65773638","chr6","65458828","65458959","1","314679"
"chr4","65773940","65774085","chr6","65459263","65459409","9","314677"
"chr4","65780725","65780818","chr6","65466775","65466869","3","313950"
"chr4","65781814","65781990","chr7","38789439","38789604","37","26992375"
"chr4","65782795","65783117","chr11","130982502","130982828","65","65199707"
"chr4","65784497","65784698","chr6","65470874","65471075","6","313623"
"chr4","65785605","65785841","chr6","65471978","65472212","12","313627"
"chr4","65786576","65786869","chr1","21109084","21109381","61","44677492"
"chr4","65789489","65789788","chr6","65474524","65474820","11","314965"
"chr4","65798475","65798757","chr6","65483851","65484133","6","314624"
"chr4","65799518","65799810","chr6","65485205","65485493","10","314313"
"chr4","65805533","65805840","chr6","65491213","65491517","9","314320"
"chr4","65814364","65814684","chr6","65501044","65501361","6","313320"
"chr4","65819762","65820062","chr6","65506137","65506436","5","313625"
"chr4","65822343","65822650","chr6","65509010","65509316","9","313333"
"chr4","65823364","65823517","chr6","65510029","65510182","2","313335"
"chr4","65831212","65831515","chr6","65517328","65517640","20","313884"
"chr4","65832397","65832636","chr6","65518524","65518758","22","313873"
"chr4","65832948","65833026","chr6","65519066","65519144","0","313882"
"chr4","65833141","65833444","chr6","65519258","65519561","8","313883"
"chr4","65835637","65835952","chr6","65521757","65522048","33","313880"
"chr4","65841159","65841456","chr6","65527378","65527674","7","313781"
"chr4","65851329","65851638","chr6","65537850","65538173","17","313479"
"chr4","65856479","65856617","chr6","65543846","65543984","4","312633"
"chr4","65867084","65867374","chr6","65554530","65554821","6","312554"
"chr4","65868557","65868850","chr3","123559948","123560236","77","57691391"
"chr4","65871635","65871934","chr6","65559077","65559368","11","312558"
"chr4","65873041","65873335","chr6","65560476","65560785","23","312565"
"chr4","65878976","65879283","chr6","65566415","65566722","6","312561"
"chr4","65882694","65882991","chr6","65570052","65570344","13","312642"
"chr4","65892572","65892941","chr15","21541454","21541785","91","44351118"
"chr4","65893195","65893483","chr6","65579864","65580149","11","313331"
"chr4","65893594","65893667","chr6","65580253","65580336","10","313341"
"chr4","65907002","65907292","chr6","65593902","65594192","6","313100"
"chr4","65907308","65907590","chr6","65594193","65594486","14","313115"
"chr4","65909551","65909702","chr6","65596425","65596592","17","313126"
"chr4","65911630","65911861","chr6","65598587","65598818","5","313043"
"chr4","65917391","65917557","chr6","65604236","65604384","21","313155"
"chr4","65917812","65917998","chr3","41983040","41983225","53","23934772"
"chr4","65928390","65928673","chr6","65615511","65615794","5","312879"
"chr4","65929989","65930282","chr6","65617110","65617392","26","312879"
"chr4","65931661","65931952","chr6","65618784","65619075","4","312877"
"chr4","65934744","65935032","chr6","65621896","65622184","8","312848"
"chr4","65935341","65935605","chr11","121382141","121382385","65","55446800"
"chr4","65943494","65943734","chr6","65632441","65632683","10","311053"
"chr4","65957023","65957182","chr11","124217507","124217665","28","58260484"
"chr4","65965951","65966180","chr15","27404184","27404415","55","38561767"
"chr4","65972106","65972401","chr6","65661381","65661668","11","310725"
"chr4","65974279","65974447","chr6","65663854","65664024","9","310425"
"chr4","66001740","66001921","chr6","65691077","65691258","3","310663"
"chr4","66008542","66008855","chr6","65701942","65702248","12","306600"
"chr4","66008985","66009271","chr6","65702377","65702663","7","306608"
"chr4","66017215","66017516","chr6","65711238","65711546","16","305977"
"chr4","66018682","66018824","chr11","121092295","121092441","33","55073613"
"chr4","66019079","66019177","chr7","87943721","87943819","15","21924642"
"chr4","66036192","66036517","chr6","65732311","65732628","24","303881"
"chr4","66054972","66055186","chr3","45613516","45613724","48","20441456"
"chr4","66055492","66055578","chr6","65759224","65759314","5","296268"
"chr4","66066681","66066988","chr6","65770354","65770629","42","296327"
"chr4","66069012","66069283","chr6","65772660","65772931","4","296352"
"chr4","66072122","66072411","chr6","65775758","65776049","6","296364"
"chr4","66076191","66076475","chr6","65779700","65779983","9","296491"
"chr4","66085044","66085285","chr6","65788612","65788853","6","296432"
"chr4","66117436","66117741","chr6","65821180","65821491","22","296256"
"chr4","66133944","66134244","chr6","65837972","65838275","7","295972"
"chr4","66146784","66147053","chr6","65852366","65852636","8","294418"
"chr4","66196908","66197185","chr6","65902261","65902538","3","294647"
"chr4","66301747","66302038","chr6","66008518","66008809","7","293229"
"chr4","66478783","66479116","chr6","66186762","66187102","16","292021"
"chr4","66502657","66502958","chr1","138961578","138961868","61","72458921"
"chr4","66510091","66510371","chr6","66217538","66217825","12","292553"
"chr4","66512618","66512904","chr6","66220082","66220380","19","292536"
"chr4","66513811","66514016","chr6","66221274","66221478","37","292537"
"chr4","66575903","66576142","chr6","66283368","66283597","19","292535"
"chr4","66628009","66628301","chr14","57071409","57071701","57","9556600"
"chr4","66660682","66660969","chr6","66368105","66368396","11","292577"
"chr4","66694157","66694401","chr6","66401490","66401733","7","292667"
"chr4","66733891","66734208","chr6","66441510","66441827","6","292381"
"chr4","66742189","66742240","chr8","56996326","56996377","9","9745863"
"chr4","66808016","66808101","chr1","146054287","146054366","16","79246271"
"chr4","66862368","66862658","chr6","66567123","66567413","6","295245"
"chr4","66951499","66951801","chr6","66664997","66665304","8","286502"
"chr4","67044673","67044981","chr6","66764877","66765180","18","279796"
"chr4","67071464","67071772","chr6","66790510","66790812","15","280954"
"chr4","67075828","67076114","chr6","66794789","66795085","14","281039"
"chr4","67091284","67091504","chr11","68797484","68797712","59","1706200"
"chr4","67107157","67107457","chr6","145262867","145263160","60","78155710"
"chr4","67134175","67134478","chr3","151266637","151266939","55","84132462"
"chr4","67138947","67139229","chr6","66858143","66858425","11","280804"
"chr4","67169490","67169709","chr6","66888351","66888561","13","281139"
"chr4","67194559","67194809","chr6","66914393","66914643","5","280166"
"chr4","67203019","67203307","chr6","66923778","66924066","5","279241"
"chr4","67225813","67226136","chr4","25924031","25924343","72","41301782"
"chr4","67233302","67233617","chr6","66953754","66954022","49","279548"
"chr4","67249218","67249520","chr6","66969122","66969424","11","280096"
"chr4","67259770","67259916","chr6","66979885","66980015","21","279885"
"chr4","67278644","67278936","chr6","66999455","66999754","17","279189"
"chr4","67292995","67293268","chr6","67015572","67015868","48","277423"
"chr4","67312337","67312649","chr6","67034924","67035237","13","277413"
"chr4","67313964","67314225","chr6","67036228","67036488","4","277736"
"chr4","67328063","67328331","chr1","127729906","127730171","82","60401843"
"chr4","67338601","67338908","chr6","67060748","67061042","32","277853"
"chr4","67373290","67373585","chr6","67089308","67089604","5","283982"
"chr4","67373652","67373952","chr6","67089671","67089971","5","283981"
"chr4","67374532","67374841","chr6","67090546","67090862","16","283986"
"chr4","67385839","67386153","chr6","67102080","67102396","14","283759"
"chr4","67397103","67397355","chr9","124548816","124549088","68","57151713"
"chr4","67417686","67418000","chr6","67137582","67137897","12","280104"
"chr4","67444123","67444418","chr6","67163659","67163963","14","280464"
"chr4","67447020","67447304","chr6","67166568","67166852","5","280452"
"chr4","67447875","67448160","chr6","67167423","67167727","31","280452"
"chr4","67559125","67559395","chr6","67279328","67279597","6","279797"
"chr4","67579206","67579479","chr6","67299390","67299663","7","279816"
"chr4","67582206","67582513","chr6","67302389","67302696","10","279817"
"chr4","67598846","67599086","chrX","44102397","44102629","58","23496449"
"chr4","67602508","67602733","chr6","67323112","67323338","12","279396"
"chr4","67691166","67691300","chr5","78587456","78587592","21","10896290"
"chr4","67700791","67700903","chr20","62747404","62747517","18","4953387"
"chr4","67752218","67752378","chr6","67472557","67472718","4","279661"
"chr4","67809608","67809899","chr6","67529768","67530058","20","279840"
"chr4","67821999","67822312","chr6","67542760","67543072","9","279239"
"chr4","67824240","67824540","chr6","67545162","67545462","5","279078"
"chr4","67829686","67829995","chr6","67551899","67552202","16","277787"
"chr4","67836697","67836866","chr6","67556104","67556268","6","280593"
"chr4","67836928","67836942","chr9","20973335","20973349","4","46863593"
"chr4","67836998","67837129","chr6","67556467","67556572","28","280531"
"chr4","67837144","67837291","chr6","67556589","67556738","5","280555"
"chr4","67845430","67845705","chr6","67563168","67563439","15","282262"
"chr4","67848133","67848431","chr8","36041346","36041638","49","31806787"
"chr4","67850260","67850452","chr20","21014772","21014943","46","46835488"
"chr4","67879687","67880012","chr6","67597570","67597913","23","282117"
"chr4","67893394","67893663","chr6","67611150","67611422","8","282244"
"chr4","67902661","67902965","chr6","67620408","67620712","9","282253"
"chr4","67907049","67907229","chr6","67625093","67625273","4","281956"
"chr4","67907552","67907679","chr6","67625593","67625721","2","281959"
"chr4","67921260","67921477","chr6","67639691","67639944","46","281569"
"chr4","67932473","67932772","chr6","67650478","67650773","9","281995"
"chr4","67936723","67937013","chr6","67654714","67655003","8","282009"
"chr4","67937854","67937988","chr6","67655793","67655918","11","282061"
"chr4","67949323","67949619","chr6","67667229","67667525","8","282094"
"chr4","67956405","67956717","chr6","67674767","67675078","8","281638"
"chr4","67975640","67975923","chr6","67694347","67694661","36","281293"
"chr4","67990325","67990619","chr6","67710094","67710388","13","280231"
"chr4","68005659","68005970","chr6","67725152","67725463","10","280507"
"chr4","68035325","68035613","chr6","67756058","67756345","7","279267"
"chr4","68092673","68092892","chr6","67814004","67814223","10","278669"
"chr4","68102349","68102651","chr6","67823220","67823522","9","279129"
"chr4","68134431","68134721","chr6","67855656","67855945","7","278775"
"chr4","68189589","68189895","chr4","110799624","110799919","54","42610035"
"chr4","68206933","68207233","chr6","67927940","67928240","9","278993"
"chr4","68235624","68235918","chr6","67956595","67956891","9","279029"
"chr4","68240420","68240624","chr6","67961400","67961602","5","279020"
"chr4","68262381","68262685","chr6","67983538","67983842","14","278843"
"chr4","68270889","68271197","chr6","67992058","67992363","13","278831"
"chr4","68293149","68293216","chr6","68014336","68014403","1","278813"
"chr4","68363930","68364253","chr6","68085166","68085499","32","278764"
"chr4","68443216","68443386","chrX","38836775","38836941","38","29606441"
"chr4","68456882","68457145","chr6","68177894","68178160","12","278988"
"chr4","68619064","68619207","chr11","95527470","95527604","32","26908406"
"chr4","68620962","68621252","chr3","86778500","86778786","64","18157538"
"chr4","68695177","68695486","chr6","68418247","68418556","8","276930"
"chr4","68700856","68701172","chr6","68423758","68424075","15","277098"
"chr4","68728761","68729080","chr13","84452913","84453227","53","15724152"
"chr4","68800063","68800201","chr6","68525861","68525996","9","274202"
"chr4","68800509","68800680","chr6","68526300","68526488","21","274209"
"chr4","68802626","68802908","chr6","68528393","68528714","52","274233"
"chr4","68813571","68813697","chr6","68539474","68539606","11","274097"
"chr4","68841839","68841902","chr18","8036947","8037011","12","60804892"
"chr4","68841924","68842049","chr4","123325021","123325144","16","54483097"
"chr4","68868356","68868648","chr6","68595391","68595655","35","272965"
"chr4","68888197","68888492","chr6","68615222","68615528","15","272975"
"chr4","68936161","68936466","chr6","68668251","68668557","15","267910"
"chr4","68953453","68953612","chr6","68685555","68685715","7","267898"
"chr4","68971291","68971604","chr6","68703938","68704251","12","267353"
"chr4","69044306","69044553","chr6","68776576","68776823","6","267730"
"chr4","69045915","69046200","chr6","68778185","68778470","2","267730"
"chr4","69051929","69052049","chr6","68784153","68784276","9","267776"
"chr4","69054789","69055065","chr6","68787013","68787291","6","267776"
"chr4","69055916","69056167","chr6","68788132","68788391","25","267784"
"chr4","69094589","69094890","chr6","68827584","68827888","15","267005"
"chr4","69113383","69113683","chr6","68845854","68846154","9","267529"
"chr4","69120605","69120890","chr6","68853545","68853833","7","267060"
"chr4","69158874","69159189","chr6","68899047","68899362","3","259827"
"chr4","69182730","69183037","chr6","68922635","68922929","21","260095"
"chr4","69203212","69203513","chr6","68943144","68943442","5","260068"
"chr4","69205415","69205726","chr6","68945355","68945668","4","260060"
"chr4","69232414","69232634","chr15","6130205","6130419","37","63102209"
"chr4","69237549","69237864","chr1","28104773","28105052","80","41132776"
"chr4","69239323","69239432","chr6","68979815","68979924","2","259508"
"chr4","69261054","69261347","chr6","69001021","69001324","15","260033"
"chr4","69268740","69269043","chr6","69008445","69008725","33","260295"
"chr4","69277328","69277343","chr9","95345310","95345325","1","26067982"
"chr4","69277429","69277602","chr6","69024868","69025040","4","252561"
"chr4","69282479","69282773","chr6","69030413","69030704","15","252066"
"chr4","69340809","69341099","chr6","69092476","69092769","16","248333"
"chr4","69348534","69348825","chr6","69099858","69100149","5","248676"
"chr4","69472425","69472700","chr6","69222954","69223229","6","249471"
"chr4","69546280","69546592","chr6","69294215","69294527","7","252065"
"chr4","69571394","69571683","chr3","41279770","41280061","61","28291624"
"chr4","69591482","69591771","chr1","109564013","109564305","50","39972531"
"chr4","69606485","69606791","chr6","69361545","69361852","8","244940"
"chr4","69618902","69619197","chr6","69372902","69373197","13","246000"
"chr4","69634787","69635043","chr6","69421321","69421575","9","213466"
"chr4","69639449","69639728","chr6","69425659","69425938","5","213790"
"chr4","69646793","69646949","chr6","69432706","69432874","12","214087"
"chr4","69650591","69650858","chr6","69436210","69436466","22","214381"
"chr4","69652477","69652599","chr6","69438085","69438208","6","214392"
"chr4","69652901","69653102","chr6","69438515","69438707","16","214386"
"chr4","69671295","69671433","chr6","69459200","69459338","2","212095"
"chr4","69671740","69671901","chr6","69459652","69459817","6","212088"
"chr4","69703997","69704297","chr6","69491816","69492109","15","212181"
"chr4","69717066","69717352","chr6","69505219","69505505","3","211847"
"chr4","69723349","69723571","chr6","69511357","69511579","2","211992"
"chr4","69752522","69752754","chr6","69540821","69541054","3","211701"
"chr4","69763135","69763428","chr6","69551424","69551716","6","211711"
"chr4","69766141","69766446","chr6","69554389","69554694","5","211752"
"chr4","69771506","69771773","chr18","46681912","46682179","45","23089594"
"chr4","69785517","69785803","chr6","69574058","69574357","24","211459"
"chr4","69823419","69823688","chr8","114619965","114620250","70","44796546"
"chr4","69826591","69826898","chr6","69618042","69618353","16","208549"
"chr4","69832205","69832409","chr6","69623645","69623848","3","208560"
"chr4","69838247","69838532","chr6","69629678","69629962","8","208569"
"chr4","69847681","69847858","chr11","6988011","6988177","40","62859670"
"chr4","69869695","69870014","chr6","69661712","69662031","8","207983"
"chr4","69908402","69908595","chr6","69702036","69702229","3","206366"
"chr4","69920286","69920585","chr6","69715343","69715641","9","204943"
"chr4","69934902","69935201","chr6","69715343","69715641","9","219559"
"chr4","69941538","69941750","chr6","69730413","69730623","5","211125"
"chr4","69962486","69962767","chr6","69752928","69753209","7","209558"
"chr4","69971531","69971840","chr13","124875372","124875677","50","54903841"
"chr4","69977724","69978021","chr6","69768137","69768434","1","209587"
"chr4","70024159","70024463","chr6","69816314","69816618","7","207845"
"chr4","70051906","70052225","chr6","69847792","69848115","11","204114"
"chr4","70139003","70139301","chr6","69943084","69943382","5","195919"
"chr4","70200239","70200365","chr3","43539155","43539288","26","26661084"
"chr4","70202420","70202597","chr6","70006856","70007033","7","195564"
"chr4","70231170","70231391","chr6","70037328","70037553","6","193842"
"chr4","70236345","70236666","chr6","70042515","70042806","52","193830"
"chr4","70424811","70425118","chr6","70234635","70234943","12","190176"
"chr4","70427149","70427433","chr6","70236836","70237130","16","190313"
"chr4","70438127","70438294","chr6","70248168","70248340","6","189959"
"chr4","70551985","70552189","chr6","70361362","70361567","8","190623"
"chr4","70563334","70563595","chrX","16245529","16245781","51","54317805"
"chr4","70574526","70574607","chr5","50038017","50038098","13","20536509"
"chr4","70577865","70577973","chr6","70388086","70388194","0","189779"
"chr4","70594864","70595166","chr6","70404277","70404568","15","190587"
"chr4","70597198","70597476","chr6","70406619","70406898","7","190579"
"chr4","70621326","70621551","chr6","70427687","70427917","26","193639"
"chr4","70638928","70639234","chr6","70449798","70450104","13","189130"
"chr4","70642148","70642400","chr1","4156865","4157121","61","66485283"
"chr4","70653048","70653351","chr6","70464728","70465022","15","188320"
"chr4","70664244","70664387","chr8","94138574","94138715","24","23474330"
"chr4","70664836","70664988","chr4","41295054","41295204","37","29369782"
"chr4","70686536","70686761","chr19","34966965","34967180","50","35719571"
"chr4","70691311","70691596","chr6","70501055","70501362","36","190256"
"chr4","70728056","70728313","chr6","70539168","70539447","32","188888"
"chr4","70732249","70732444","chr6","70543386","70543578","10","188863"
"chr4","70734056","70734196","chr10","12286075","12286221","30","58447981"
"chr4","70738039","70738341","chr6","70549139","70549434","17","188900"
"chr4","70748078","70748367","chr6","70559633","70559936","30","188445"
"chr4","70762759","70762893","chr14","72844030","72844163","20","2081271"
"chr4","70771128","70771413","chr6","70583082","70583367","8","188046"
"chr4","70787036","70787345","chr6","70599631","70599920","29","187405"
"chr4","70813343","70813605","chr6","70625771","70626030","10","187572"
"chr4","70861743","70862036","chr6","70674857","70675128","29","186886"
"chr4","70907489","70907778","chr6","70720620","70720899","15","186869"
"chr4","70923365","70923651","chr6","70736470","70736765","14","186895"
"chr4","70938409","70938704","chr6","70751465","70751761","13","186944"
"chr4","70947015","70947212","chr6","70760693","70760890","5","186322"
"chr4","70974872","70975155","chr6","70788472","70788755","7","186400"
"chr4","70991299","70991546","chr6","70805446","70805693","5","185853"
"chr4","70997170","70997456","chr6","70810731","70811017","14","186439"
"chr4","71014190","71014485","chr6","70828108","70828405","11","186082"
"chr4","71022530","71022670","chr1","38490561","38490701","31","32531969"
"chr4","71030827","71031114","chr6","70847246","70847532","11","183581"
"chr4","71034998","71035303","chr6","70852401","70852703","11","182597"
"chr4","71036619","71036906","chr6","70854019","70854315","21","182600"
"chr4","71046488","71046761","chr14","115021905","115022175","59","43975417"
"chr4","71053703","71053790","chr7","33765401","33765487","10","37288302"
"chr4","71054032","71054322","chr6","70870006","70870297","10","184026"
"chr4","71061572","71061854","chr6","70877200","70877485","6","184372"
"chr4","71117667","71117982","chr13","45932391","45932692","56","25185276"
"chr4","71122568","71122880","chr6","70933236","70933531","28","189332"
"chr4","71147668","71147990","chr6","70958218","70958522","28","189450"
"chr4","71153925","71154050","chr16","40688274","40688396","24","30465651"
"chr4","71167171","71167368","chr6","70985480","70985704","30","181691"
"chr4","71167402","71167416","chr11","45105778","45105792","0","26061624"
"chr4","71225751","71225925","chr6","71045457","71045636","8","180294"
"chr4","71226233","71226353","chr6","71045934","71046054","3","180299"
"chr4","71232135","71232331","chr6","71051846","71052043","6","180289"
"chr4","71235119","71235407","chr6","71054839","71055127","11","180280"
"chr4","71243767","71244079","chr6","71063971","71064276","10","179796"
"chr4","71252622","71252923","chr6","71072804","71073114","31","179818"
"chr4","71265471","71265688","chr6","71085633","71085850","3","179838"
"chr4","71287772","71287920","chr6","71108597","71108745","3","179175"
"chr4","71294252","71294546","chr6","71114747","71115056","28","179505"
"chr4","71294963","71295133","chr6","71115473","71115642","4","179490"
"chr4","71296668","71296969","chr6","71117228","71117522","12","179440"
"chr4","71325548","71325815","chr6","71145858","71146125","1","179690"
"chr4","71336688","71336987","chr6","71156906","71157206","5","179782"
"chr4","71338186","71338471","chr6","71158410","71158691","8","179776"
"chr4","71368360","71368658","chr6","71183946","71184250","11","184414"
"chr4","71369020","71369112","chr6","71184612","71184704","0","184408"
"chr4","71369122","71369151","chr6","71184714","71184743","0","184408"
"chr4","71369166","71369444","chr6","71184758","71185035","11","184408"
"chr4","71429398","71429695","chr6","71244863","71245155","21","184535"
"chr4","71462571","71462867","chr6","71276063","71276358","6","186508"
"chr4","71535964","71536207","chr6","71349629","71349878","9","186335"
"chr4","71564437","71564734","chr6","71378332","71378629","9","186105"
"chr4","71588166","71588482","chr6","71401844","71402158","11","186322"
"chr4","71697077","71697424","chr6","71510876","71511203","48","186201"
"chr4","71711723","71712022","chr6","71526314","71526613","11","185409"
"chr4","71735207","71735511","chr6","71550980","71551279","10","184227"
"chr4","71775192","71775440","chr6","71592043","71592297","15","183149"
"chr4","71822134","71822418","chr10","79049984","79050252","60","7227850"
"chr4","71825457","71825767","chr6","71642863","71643160","38","182594"
"chr4","71907619","71907924","chr6","71726702","71727011","12","180917"
"chr4","71927759","71928039","chr6","71747689","71747969","6","180070"
"chr4","71933459","71933645","chr1","26004811","26004989","35","45928648"
"chr4","71937653","71937797","chr6","71757616","71757780","21","180037"
"chr4","72013067","72013339","chr6","71834262","71834534","9","178805"
"chr4","72015747","72016054","chr6","71836947","71837249","13","178800"
"chr4","72033075","72033351","chr6","71854703","71854979","8","178372"
"chr4","72083012","72083189","chr6","71905227","71905404","4","177785"
"chr4","72103310","72103484","chr3","36392620","36392792","27","35710690"
"chr4","72121320","72121619","chr6","71942832","71943118","22","178488"
"chr4","72124733","72125032","chr6","71945525","71945829","15","179208"
"chr4","72128553","72128845","chr6","71949333","71949625","7","179220"
"chr4","72129424","72129732","chr6","71950206","71950514","8","179218"
"chr4","72152561","72152706","chr12","84994725","84994863","30","12842164"
"chr4","72179434","72179716","chr6","72004076","72004355","14","175358"
"chr4","72179952","72180260","chr6","72004591","72004891","20","175361"
"chr4","72203443","72203742","chr6","72029762","72030069","14","173681"
"chr4","72209090","72209388","chr6","72035426","72035726","17","173664"
"chr4","72248648","72248797","chr6","72075000","72075148","6","173648"
"chr4","72249094","72249237","chr1","26953782","26953919","26","45295312"
"chr4","72305224","72305502","chr6","72133044","72133322","6","172180"
"chr4","72308961","72309252","chr6","72136865","72137154","9","172096"
"chr4","72317868","72318028","chr6","72145825","72145985","6","172043"
"chr4","72328844","72329150","chr6","72156792","72157091","27","172052"
"chr4","72333456","72333733","chr6","72161419","72161695","10","172037"
"chr4","72380063","72380327","chr6","72207483","72207764","23","172580"
"chr4","72423572","72423846","chr6","72253692","72253964","9","169880"
"chr4","72433017","72433149","chr6","72262753","72262885","1","170264"
"chr4","72433457","72433627","chr6","72263193","72263362","2","170264"
"chr4","72446903","72447212","chr6","72276516","72276825","7","170387"
"chr4","72449205","72449337","chr1","28999769","28999900","19","43449436"
"chr4","72455091","72455400","chr6","72284980","72285289","5","170111"
"chr4","72455610","72455911","chr6","72285499","72285821","35","170111"
"chr4","72463501","72463751","chr6","72293369","72293619","6","170132"
"chr4","72465466","72465764","chr6","72295342","72295652","25","170124"
"chr4","72465765","72466072","chr6","72295653","72295960","7","170112"
"chr4","72499410","72499694","chr6","72329170","72329441","18","170240"
"chr4","72505965","72506125","chr16","31737053","31737209","28","40768912"
"chr4","72520343","72520637","chr6","72350535","72350829","8","169808"
"chr4","72536027","72536326","chr6","72366207","72366507","6","169820"
"chr4","72538379","72538578","chr6","72368241","72368440","15","170138"
"chr4","72559113","72559409","chr6","72388291","72388585","15","170822"
"chr4","72585703","72586017","chr7","64482622","64482942","70","8103081"
"chr4","72589568","72589847","chr6","72420417","72420696","9","169151"
"chr4","72598734","72598950","chr6","72429255","72429474","14","169479"
"chr4","72701318","72701623","chr6","72540139","72540442","10","161179"
"chr4","72832220","72832298","chr6","72674106","72674172","12","158114"
"chr4","72869224","72869539","chr6","72711128","72711440","14","158096"
"chr4","72913454","72913726","chr6","72754653","72754925","6","158801"
"chr4","72917898","72918203","chr6","72759080","72759385","5","158818"
"chr4","72918792","72919089","chr6","72759973","72760264","10","158819"
"chr4","72951468","72951767","chr6","72791803","72792098","7","159665"
"chr4","72974813","72975040","chr6","72819075","72819302","10","155738"
"chr4","72975499","72975794","chr6","72819775","72820069","4","155724"
"chr4","72980421","72980724","chr6","72824404","72824707","4","156017"
"chr4","72981919","72982152","chr6","72825897","72826130","7","156022"
"chr4","73014236","73014533","chr6","72858677","72858976","11","155559"
"chr4","73085030","73085335","chr4","103468600","103468909","59","30383570"
"chr4","73146999","73147266","chr6","72994192","72994464","10","152807"
"chr4","73166999","73167305","chr6","73013258","73013566","7","153741"
"chr4","73188385","73188701","chr6","73036424","73036740","6","151961"
"chr4","73207454","73207763","chr6","73055434","73055729","18","152020"
"chr4","73239713","73239976","chr6","73085493","73085765","11","154220"
"chr4","73267089","73267349","chr6","73114604","73114878","19","152485"
"chr4","73285001","73285299","chr15","92728954","92729252","49","19443953"
"chr4","73308162","73308453","chr6","73154579","73154870","6","153583"
"chr4","73311717","73311923","chr6","73158147","73158368","22","153570"
"chr4","73315695","73316003","chr6","73162240","73162542","31","153455"
"chr4","73336336","73336540","chr6","73182823","73183027","4","153513"
"chr4","73345272","73345570","chr6","73192894","73193186","13","152378"
"chr4","73357059","73357313","chr6","73204751","73205005","4","152308"
"chr4","73362122","73362421","chr6","73209822","73210118","7","152300"
"chr4","73372520","73372808","chr2","172957809","172958091","57","99585289"
"chr4","73376014","73376187","chr6","73223735","73223908","4","152279"
"chr4","73379573","73379866","chr3","109505522","109505799","56","36125949"
"chr4","73397033","73397138","chr6","73244393","73244498","1","152640"
"chr4","73414395","73414686","chr6","73262377","73262668","11","152018"
"chr4","73418928","73419231","chr6","73273035","73273347","16","145893"
"chr4","73420160","73420465","chr6","73274264","73274551","29","145896"
"chr4","73425340","73425636","chr6","73267071","73267367","5","158269"
"chr4","73428915","73429209","chr6","73270682","73270976","6","158233"
"chr4","73431932","73432144","chr6","73280441","73280645","12","151491"
"chr4","73433090","73433221","chr3","20721478","20721612","26","52711612"
"chr4","73438852","73439060","chr6","73285523","73285731","4","153329"
"chr4","73439067","73439198","chr6","73285738","73285873","5","153329"
"chr4","73440593","73440891","chr6","73289180","73289473","21","151413"
"chr4","73442533","73442756","chr6","73291253","73291476","5","151280"
"chr4","73442816","73443107","chr6","73291536","73291823","15","151280"
"chr4","73463365","73463521","chr8","121924008","121924161","29","48460643"
"chr4","73464676","73464968","chr6","73314191","73314483","3","150485"
"chr4","73468350","73468570","chr6","73317763","73318007","29","150587"
"chr4","73471967","73472232","chr6","73321381","73321650","9","150586"
"chr4","73474556","73474802","chr6","73324734","73324981","9","149822"
"chr4","73475483","73475690","chr9","94690653","94690862","45","21215170"
"chr4","73477535","73477817","chr6","73327703","73327989","5","149832"
"chr4","73478256","73478555","chr6","73328271","73328570","3","149985"
"chr4","73484840","73485071","chr16","74040716","74040945","59","555876"
"chr4","73489741","73489932","chr6","73339359","73339555","8","150382"
"chr4","73490212","73490338","chr6","73339827","73339953","3","150385"
"chr4","73490646","73490965","chr6","73340262","73340578","9","150384"
"chr4","73491782","73492041","chr11","12026451","12026694","60","61465331"
"chr4","73505132","73505317","chr6","73354860","73355026","23","150272"
"chr4","73524023","73524305","chr6","73373325","73373608","6","150698"
"chr4","73563657","73563937","chr6","73411009","73411296","15","152648"
"chr4","73569538","73569752","chr6","73417155","73417368","4","152383"
"chr4","73578528","73578830","chr6","73427546","73427851","8","150982"
"chr4","73607316","73607628","chr6","73457548","73457855","11","149768"
"chr4","73617410","73617682","chr6","73467628","73467899","6","149782"
"chr4","73628342","73628643","chr6","73478289","73478590","11","150053"
"chr4","73629846","73630104","chr6","73479791","73480048","4","150055"
"chr4","73681262","73681529","chr6","73531770","73532035","10","149492"
"chr4","73682828","73683130","chr6","73533330","73533628","7","149498"
"chr4","73697043","73697354","chr6","73547736","73548035","19","149307"
"chr4","73706600","73706909","chr6","73557009","73557320","8","149591"
"chr4","73716864","73717143","chr9","17977557","17977838","47","55739307"
"chr4","73722213","73722451","chr6","73572880","73573140","28","149333"
"chr4","73738133","73738427","chr6","73588763","73589049","19","149370"
"chr4","73745848","73746133","chr6","73596450","73596737","17","149398"
"chr4","73754210","73754508","chr2","186062025","186062324","52","112307815"
"chr4","73757304","73757585","chr7","14286956","14287238","54","59470348"
"chr4","73763809","73764108","chr6","73614100","73614402","19","149709"
"chr4","73768091","73768372","chr6","73618375","73618662","11","149716"
"chr4","73805095","73805395","chr6","73655224","73655528","13","149871"
"chr4","73821124","73821373","chr16","28836784","28837030","63","44984340"
"chr4","73822177","73822452","chr5","33703173","33703447","58","40119004"
"chr4","73828710","73828912","chr6","73675956","73676159","4","152754"
"chr4","73829513","73829646","chr6","73676756","73676889","4","152757"
"chr4","73831265","73831565","chr6","73678519","73678819","4","152746"
"chr4","73849798","73850086","chr6","73696724","73697011","8","153074"
"chr4","73879503","73879728","chr6","73158147","73158368","68","721356"
"chr4","73879917","73879978","chr1","6641003","6641065","7","67238914"
"chr4","73890318","73890416","chr6","73737152","73737250","0","153166"
"chr4","73891338","73891530","chr6","73738217","73738409","3","153121"
"chr4","73897496","73897758","chr6","73744358","73744618","4","153138"
"chr4","73898049","73898277","chr6","73744908","73745125","16","153141"
"chr4","73906553","73906855","chr6","73753256","73753561","10","153297"
"chr4","73935558","73935735","chrX","43657953","43658129","41","30277605"
"chr4","73936748","73936897","chr9","54973222","54973366","31","18963526"
"chr4","73952923","73953220","chr20","21109972","21110264","52","52842951"
"chr4","74010220","74010387","chrX","45599837","45600005","35","28410383"
"chr4","74010388","74010449","chr1","31252960","31253021","12","42757428"
"chr4","74029188","74029470","chr6","73874989","73875272","15","154199"
"chr4","74044001","74044288","chr6","73889554","73889840","17","154447"
"chr4","74106457","74106779","chr6","73953904","73954226","16","152553"
"chr4","74191584","74191792","chr6","74039623","74039835","9","151961"
"chr4","74223677","74223988","chr6","74070978","74071283","11","152699"
"chr4","74248995","74249288","chr6","74099689","74099983","9","149306"
"chr4","74254383","74254674","chr2","78493440","78493742","54","4239057"
"chr4","74257381","74257596","chr6","74109053","74109264","15","148328"
"chr4","74288651","74288945","chr6","74140590","74140893","15","148061"
"chr4","74292366","74292664","chr6","74144314","74144607","21","148052"
"chr4","74322864","74323033","chr6","74178112","74178280","6","144752"
"chr4","74331736","74332019","chr3","178010044","178010346","67","103678308"
"chr4","74345059","74345348","chr6","74196654","74196942","13","148405"
"chr4","74355298","74355595","chr6","74209408","74209693","18","145890"
"chr4","74363439","74363709","chr6","74215816","74216086","7","147623"
"chr4","74366376","74366667","chr6","74218822","74219123","21","147554"
"chr4","74369268","74369549","chr6","74221640","74221922","7","147628"
"chr4","74373314","74373609","chr6","74225627","74225918","16","147687"
"chr4","74376202","74376510","chr6","74229117","74229416","35","147085"
"chr4","74385336","74385622","chr6","74238421","74238705","21","146915"
"chr4","74395317","74395468","chr6","74248336","74248487","5","146981"
"chr4","74404765","74405074","chr6","74257596","74257911","16","147169"
"chr4","74411872","74412176","chr7","129864425","129864727","58","55452553"
"chr4","74420753","74421039","chr6","74274196","74274479","5","146557"
"chr4","74430097","74430358","chr6","74284066","74284353","45","146031"
"chr4","74434656","74434971","chr6","74288855","74289190","32","145801"
"chr4","74437298","74437324","chr11","121677247","121677272","4","47239949"
"chr4","74437635","74437746","chr4","151423873","151423990","32","76986238"
"chr4","74440656","74440943","chr6","74294843","74295131","4","145813"
"chr4","74455342","74455665","chr6","74309339","74309660","17","146003"
"chr4","74458104","74458369","chr6","74312270","74312535","3","145834"
"chr4","74471412","74471601","chr3","37052426","37052597","71","37418986"
"chr4","74473371","74473661","chr6","74326823","74327109","9","146548"
"chr4","74479508","74479821","chr6","74332918","74333222","18","146590"
"chr4","74482670","74482959","chr6","74335846","74336136","8","146824"
"chr4","74488448","74488605","chr6","74341618","74341775","4","146830"
"chr4","74498065","74498374","chr6","74356724","74357033","5","141341"
"chr4","74498842","74499154","chr6","74357506","74357815","11","141336"
"chr4","74501051","74501218","chr6","74359873","74360031","9","141178"
"chr4","74506200","74506386","chr11","123458013","123458215","43","48951813"
"chr4","74516823","74517104","chr6","74376455","74376736","2","140368"
"chr4","74517599","74517799","chr1","150593735","150593929","54","76076136"
"chr4","74517907","74518016","chr7","39858779","39858887","26","34659128"
"chr4","74518308","74518606","chr6","74377957","74378250","11","140351"
"chr4","74519874","74520151","chr6","74379515","74379793","13","140359"
"chr4","74521896","74522195","chr6","74381562","74381852","18","140334"
"chr4","74524425","74524717","chr6","74384287","74384581","5","140138"
"chr4","74528016","74528318","chr6","74387905","74388192","29","140111"
"chr4","74533197","74533500","chr6","74393014","74393307","22","140183"
"chr4","74566204","74566487","chr6","74427452","74427735","4","138752"
"chr4","74567746","74568024","chr6","74429003","74429281","8","138743"
"chr4","74572349","74572584","chr6","74433567","74433802","3","138782"
"chr4","74574820","74575125","chr14","61825888","61826189","65","12748932"
"chr4","74576743","74577067","chr6","74437467","74437799","16","139276"
"chr4","74591275","74591571","chr6","74451874","74452169","5","139401"
"chr4","74593137","74593436","chr6","74453709","74454010","12","139428"
"chr4","74608070","74608368","chr16","39683567","39683858","59","34924503"
"chr4","74634901","74635257","chr1","13426088","13426430","83","61208813"
"chr4","74658572","74658840","chr6","74519853","74520133","20","138719"
"chr4","74668208","74668494","chr6","74528656","74528938","9","139552"
"chr4","74673860","74674223","chr13","61336963","61337313","92","13336897"
"chr4","74688035","74688319","chr6","74547093","74547378","4","140942"
"chr4","74736301","74736587","chr6","74597133","74597409","38","139168"
"chr4","74746212","74746496","chr6","74606703","74606987","9","139509"
"chr4","74783966","74784170","chr6","74645031","74645236","3","138935"
"chr4","74795680","74795950","chr6","74656091","74656374","18","139589"
"chr4","74805973","74806232","chr6","74666451","74666700","16","139522"
"chr4","74829341","74829640","chr6","74689828","74690128","8","139513"
"chr4","74862260","74862560","chr14","10166163","10166465","60","64696097"
"chr4","74877854","74878143","chr6","74738662","74738982","41","139192"
"chr4","74878838","74879114","chr6","74739618","74739894","7","139220"
"chr4","74881477","74881774","chr6","74741954","74742249","13","139523"
"chr4","74926824","74927108","chr6","74787410","74787697","8","139414"
"chr4","74939848","74940139","chr6","74797248","74797533","15","142600"
"chr4","74961455","74961717","chr6","74820820","74821076","14","140635"
"chr4","74968750","74969018","chr6","74828136","74828403","9","140614"
"chr4","74992548","74992858","chr6","74852855","74853164","9","139693"
"chr4","75003083","75003381","chr6","74864345","74864647","11","138738"
"chr4","75007488","75007781","chr6","74868758","74869054","17","138730"
"chr4","75011618","75011908","chr6","74878389","74878690","21","133229"
"chr4","75013429","75013744","chr6","74880197","74880512","15","133232"
"chr4","75022271","75022562","chr6","74889376","74889667","4","132895"
"chr4","75028359","75028671","chr6","74895482","74895788","15","132877"
"chr4","75042753","75043047","chr14","32324593","32324886","64","42718160"
"chr4","75044420","75044677","chr6","74912287","74912557","22","132133"
"chr4","75045531","75045834","chr6","74913388","74913693","8","132143"
"chr4","75046051","75046337","chr6","74913904","74914191","14","132147"
"chr4","75057734","75058011","chr6","74925591","74925868","14","132143"
"chr4","75059227","75059347","chr6","74927082","74927205","7","132145"
"chr4","75060657","75060957","chr6","74928522","74928822","7","132135"
"chr4","75084678","75084921","chr6","74952390","74952647","19","132288"
"chr4","75104737","75105021","chr6","74973362","74973650","13","131375"
"chr4","75139132","75139426","chr6","75007112","75007388","24","132020"
"chr4","75142255","75142542","chr6","75010231","75010521","11","132024"
"chr4","75145661","75145801","chr11","95299939","95300061","31","20154278"
"chr4","75145834","75145961","chr1","121494900","121495026","30","46349066"
"chr4","75168791","75168945","chr6","75037939","75038094","4","130852"
"chr4","75190997","75191309","chr3","84696539","84696849","64","9505542"
"chr4","75204760","75205069","chr6","75075774","75076065","28","128986"
"chr4","75208849","75209107","chr6","75079903","75080170","11","128946"
"chr4","75284094","75284396","chr6","75155209","75155504","15","128885"
"chr4","75358953","75359239","chr7","25185886","25186189","65","50173067"
"chr4","75431940","75432223","chr6","75311191","75311470","10","120749"
"chr4","75445924","75446188","chr6","75325244","75325537","38","120680"
"chr4","75461021","75461336","chr6","75340346","75340651","15","120675"
"chr4","75473184","75473488","chr6","75355795","75356108","20","117389"
"chr4","75475804","75476061","chr6","75358388","75358652","14","117416"
"chr4","75526185","75526456","chr6","75409655","75409931","14","116530"
"chr4","75536947","75537179","chr6","75420739","75420972","10","116208"
"chr4","75563316","75563602","chr6","75447221","75447507","5","116095"
"chr4","75591396","75591690","chr6","75476126","75476414","13","115270"
"chr4","75594386","75594721","chr6","75479109","75479448","6","115277"
"chr4","75621339","75621464","chr2","87140260","87140382","17","11518921"
"chr4","75633133","75633279","chr6","75518189","75518335","2","114944"
"chr4","75633659","75633777","chr6","75518714","75518832","0","114945"
"chr4","75725471","75725774","chr6","75612259","75612556","10","113212"
"chr4","75830428","75830439","chr3","39984846","39984857","0","35845582"
"chr4","75830483","75830751","chr6","75721603","75721901","32","108880"
"chr4","75842914","75843228","chr6","75734586","75734901","4","108328"
"chr4","75890045","75890346","chr6","75781736","75782040","14","108309"
"chr4","75954391","75954660","chr6","75846636","75846905","7","107755"
"chr4","76003971","76004285","chr6","75894242","75894540","21","109729"
"chr4","76008734","76009048","chr6","75898990","75899301","11","109744"
"chr4","76074053","76074363","chr6","75965294","75965604","12","108759"
"chr4","76105606","76105908","chr6","75995670","75995966","10","109936"
"chr4","76119417","76119570","chr6","76009871","76010027","6","109546"
"chr4","76351402","76351702","chr6","76250886","76251186","3","100516"
"chr4","76378251","76378559","chr6","76277218","76277524","6","101033"
"chr4","76382479","76382802","chr6","76281453","76281756","27","101026"
"chr4","76436079","76436365","chr6","76335270","76335555","7","100809"
"chr4","76459976","76460276","chr6","76359240","76359540","7","100736"
"chr4","76469547","76469853","chr6","76368792","76369097","9","100755"
"chr4","76488461","76488595","chr6","76387718","76387852","1","100743"
"chr4","76488883","76489078","chr3","36884589","36884771","51","39604294"
"chr4","76489126","76489161","chr10","13398535","13398571","7","63090591"
"chr4","76527239","76527522","chr6","76426604","76426887","10","100635"
"chr4","76609803","76609866","chr1","44746983","44747047","13","31862820"
"chr4","76744504","76744636","chr6","76644246","76644381","5","100258"
"chr4","76745993","76746298","chr6","76645709","76646018","15","100284"
"chr4","76837087","76837251","chr19","32427931","32428091","41","44409156"
"chr4","76837505","76837675","chr8","9619898","9620051","42","67217607"
"chr4","77057171","77057314","chr6","76968528","76968673","7","88643"
"chr4","77059066","77059375","chr6","76970421","76970730","7","88645"
"chr4","77062525","77062798","chr6","76973864","76974148","17","88661"
"chr4","77184769","77185064","chr6","77094820","77095115","10","89949"
"chr4","77284141","77284442","chr6","77194760","77195065","16","89381"
"chr4","77322872","77323170","chr6","77231635","77231929","9","91237"
"chr4","77331632","77331942","chr6","77240372","77240682","8","91260"
"chr4","77343247","77343396","chr1","45770713","45770857","47","31572534"
"chr4","77343910","77344210","chr6","77252606","77252910","10","91304"
"chr4","77494771","77494923","chr19","14673246","14673394","31","62821525"
"chr4","77547485","77547775","chr6","77461938","77462246","35","85547"
"chr4","77604523","77604836","chr6","77519125","77519438","3","85398"
"chr4","77656195","77656473","chr6","77570616","77570878","18","85579"
"chr4","77716839","77717067","chr6","77631235","77631492","31","85604"
"chr4","77903496","77903784","chr6","77824709","77825039","54","78787"
"chr4","77916546","77916843","chr6","77836835","77837127","15","79711"
"chr4","77944570","77944878","chr6","77864532","77864840","17","80038"
"chr4","78074343","78074651","chr1","190113104","190113416","52","112038761"
"chr4","78101232","78101401","chr6","78021329","78021498","3","79903"
"chr4","78136784","78137068","chr6","78056668","78056949","11","80116"
"chr4","78143809","78144115","chr6","78063615","78063912","17","80194"
"chr4","78151627","78151932","chr6","78071019","78071324","15","80608"
"chr4","78274667","78274970","chr6","78198319","78198622","10","76348"
"chr4","78285212","78285527","chr6","78208860","78209176","10","76352"
"chr4","78309834","78310144","chr6","78231875","78232192","28","77959"
"chr4","78342010","78342293","chr6","78264083","78264366","4","77927"
"chr4","78432694","78432796","chr6","61711079","61711179","16","16721615"
"chr4","78438281","78438477","chr17","23730068","23730253","50","54708213"
"chr4","78474086","78474176","chr6","78398645","78398731","6","75441"
"chr4","78506333","78506613","chr6","78430916","78431197","8","75417"
"chr4","78518530","78518803","chr6","78442845","78443139","23","75685"
"chr4","78523864","78524162","chr6","78448208","78448505","7","75656"
"chr4","78607605","78607860","chr18","4868742","4869002","51","73738863"
"chr4","78678216","78678499","chr6","78605668","78605952","6","72548"
"chr4","78916436","78916724","chr6","78839636","78839925","6","76800"
"chr4","78996816","78997124","chr6","78922722","78923027","8","74094"
"chr4","79059295","79059348","chr11","85166302","85166360","13","6107007"
"chr4","79059680","79059822","chr16","30987162","30987307","33","48072518"
"chr4","79258547","79258824","chr6","79194019","79194297","9","64528"
"chr4","79290335","79290406","chr6","79231119","79231190","1","59216"
"chr4","79396880","79397050","chr6","79343046","79343197","24","53834"
"chr4","79490974","79491254","chr10","69206994","69207281","52","10283980"
"chr4","79712390","79712677","chr6","79677522","79677809","13","34868"
"chr4","79770138","79770450","chr6","79742696","79743012","17","27442"
"chr4","79869971","79870308","chr6","79834709","79835016","36","35262"
"chr4","79883243","79883286","chr15","35908640","35908683","8","43974603"
"chr4","79883931","79883987","chr19","42708640","42708692","16","37175291"
"chr4","79890584","79890790","chr6","79855859","79856066","6","34725"
"chr4","80086151","80086445","chr6","80089131","80089426","19","2980"
"chr4","80094365","80094647","chr6","80097024","80097312","18","2659"
"chr4","80219870","80220075","chr6","80232955","80233161","10","13085"
"chr4","80233028","80233322","chr6","80246198","80246491","13","13170"
"chr4","80312249","80312521","chr6","80570108","80570381","11","257859"
"chr4","80317494","80317784","chr6","80564919","80565209","11","247425"
"chr4","80335230","80335522","chr6","80545897","80546181","50","210667"
"chr4","80369687","80369972","chr6","80511354","80511641","14","141667"
"chr4","80437999","80438204","chr17","51643","51852","42","80386356"
"chr4","80445563","80445891","chr4","36126419","36126732","72","44319144"
"chr4","80472827","80473136","chr6","80406549","80406854","25","66278"
"chr4","80473449","80473550","chr11","119157167","119157269","27","38683718"
"chr4","80486935","80487095","chr6","80393424","80393584","1","93511"
"chr4","80542041","80542350","chr2","81857961","81858267","69","1315920"
"chr4","80568020","80568249","chr6","80310067","80310327","36","257953"
"chr4","80615686","80615916","chr6","80263994","80264225","14","351692"
"chr4","80624443","80624606","chrX","49524523","49524692","34","31099920"
"chr4","80668344","80668508","chrX","17163667","17163825","42","63504677"
"chr4","80668537","80668656","chr3","55268266","55268384","15","25400271"
"chr4","80710694","80711004","chr6","80734913","80735178","55","24219"
"chr4","80745861","80746122","chr6","80769415","80769676","5","23554"
"chr4","80791648","80791848","chr6","80820550","80820750","7","28902"
"chr4","80858077","80858372","chr6","80888109","80888406","9","30032"
"chr4","80900250","80900420","chr2","78396898","78397056","36","2503352"
"chr4","80952831","80953001","chr6","80984293","80984454","12","31462"
"chr4","81053817","81054124","chr6","81093115","81093417","12","39298"
"chr4","81074672","81074828","chr6","81111801","81111957","2","37129"
"chr4","81091574","81091726","chr6","81128358","81128519","9","36784"
"chr4","81126196","81126466","chr5","46451590","46451863","52","34674606"
"chr4","81127982","81128296","chr6","81171876","81172144","50","43894"
"chr4","81136955","81137255","chr6","81181146","81181447","13","44191"
"chr4","81198689","81198813","chr6","81241689","81241813","1","43000"
"chr4","81205597","81205890","chr6","81248857","81249150","9","43260"
"chr4","81244719","81245029","chr6","81288658","81288944","30","43939"
"chr4","81269893","81270179","chr6","81313738","81314015","11","43845"
"chr4","81275759","81276062","chr6","81320202","81320506","11","44443"
"chr4","81307314","81307608","chr6","81351275","81351556","19","43961"
"chr4","81310112","81310415","chr6","81354080","81354382","19","43968"
"chr4","81383004","81383294","chr6","81427277","81427569","5","44273"
"chr4","81410308","81410413","chr2","44255996","44256087","38","37154312"
"chr4","81435612","81435916","chr6","81485623","81485926","12","50011"
"chr4","81496344","81496528","chr14","67129250","67129427","40","14367094"
"chr4","81496572","81496631","chr12","89479330","89479366","30","7982758"
"chr4","81496673","81496791","chr13","69294480","69294599","16","12202193"
"chr4","81519773","81520034","chr6","81584170","81584458","36","64397"
"chr4","81642589","81642853","chr6","81706760","81706976","53","64171"
"chr4","81785352","81785494","chr6","81849253","81849400","6","63901"
"chr4","81785788","81785941","chr3","82362989","82363140","36","577201"
"chr4","81881026","81881180","chr2","77734436","77734584","39","4146590"
"chr4","81881181","81881244","chr20","10976550","10976613","14","70904631"
"chr4","81961954","81962256","chr6","82026616","82026922","7","64662"
"chr4","82085841","82086118","chr6","82160972","82161249","20","75131"
"chr4","82159904","82160186","chr6","82238375","82238657","11","78471"
"chr4","82201955","82202077","chr6","82279388","82279510","1","77433"
"chr4","82202079","82202156","chr6","82279521","82279590","8","77442"
"chr4","82209620","82209717","chr7","87943721","87943819","27","5734101"
"chr4","82212968","82213260","chr6","82290402","82290694","9","77434"
"chr4","82266678","82266973","chr6","82343905","82344200","1","77227"
"chr4","82300071","82300099","chr17","70693978","70694006","3","11606093"
"chr4","82300220","82300493","chr6","82377612","82377915","35","77392"
"chr4","82358478","82358757","chr6","82440367","82440646","13","81889"
"chr4","82367968","82368278","chr6","82449832","82450139","10","81864"
"chr4","82410706","82410957","chr6","82492215","82492468","10","81509"
"chr4","82438286","82438571","chr6","82520326","82520610","2","82040"
"chr4","82480823","82481099","chr6","82563400","82563676","6","82577"
"chr4","82615101","82615396","chr6","82720291","82720586","4","105190"
"chr4","82772456","82772754","chr6","82875022","82875306","20","102566"
"chr4","82785899","82786193","chr6","82888439","82888735","11","102540"
"chr4","82790465","82790776","chr6","82893310","82893621","6","102845"
"chr4","82804900","82805187","chr6","82907486","82907793","30","102586"
"chr4","82825086","82825394","chr6","82927360","82927679","17","102274"
"chr4","82961336","82961560","chr6","83064809","83065024","13","103473"
"chr4","82968858","82969167","chr6","83072335","83072647","13","103477"
"chr4","82984882","82985194","chr6","83088167","83088479","9","103285"
"chr4","83001958","83002264","chr6","83105291","83105597","2","103333"
"chr4","83145844","83146059","chr6","83251325","83251539","6","105481"
"chr4","83162938","83163245","chr6","83267932","83268240","9","104994"
"chr4","83463663","83463949","chr8","121703606","121703883","71","38239943"
"chr4","83530518","83530611","chrX","50273487","50273576","15","33257031"
"chr4","83551029","83551343","chr6","83667747","83668062","11","116718"
"chr4","83801352","83801574","chr11","82387520","82387742","54","1413832"
"chr4","83830354","83830665","chr6","83942381","83942695","17","112027"
"chr4","84083296","84083639","chr16","69245717","69246070","90","14837579"
"chr4","84112020","84112292","chr6","84228053","84228325","6","116033"
"chr4","84161236","84161460","chr6","84282248","84282472","4","121012"
"chr4","84225066","84225326","chr6","84344392","84344654","8","119326"
"chr4","84240076","84240182","chr6","84359432","84359538","4","119356"
"chr4","84250770","84251057","chr6","84370152","84370439","9","119382"
"chr4","84304922","84305229","chr6","84424721","84425019","20","119799"
"chr4","84323055","84323360","chr6","84442906","84443189","31","119851"
"chr4","84336276","84336416","chr6","84456121","84456261","5","119845"
"chr4","84379065","84379374","chr6","84499300","84499592","20","120235"
"chr4","84393532","84393807","chr6","84515255","84515531","5","121723"
"chr4","84397258","84397534","chr6","84518966","84519245","8","121708"
"chr4","84438413","84438714","chr6","84555603","84555904","4","117190"
"chr4","84443050","84443321","chr6","84560244","84560524","21","117194"
"chr4","84460114","84460206","chr6","84577674","84577766","2","117560"
"chr4","84460211","84460278","chr6","84577771","84577838","2","117560"
"chr4","84482340","84482640","chr6","84599997","84600297","8","117657"
"chr4","84490157","84490474","chr6","84607787","84608103","7","117630"
"chr4","84559751","84560059","chr6","84671639","84671946","13","111888"
"chr4","84604415","84604563","chr9","29301195","29301347","30","55303220"
"chr4","84655935","84656170","chr6","84767865","84768097","12","111930"
"chr4","84693967","84694150","chr3","34029333","34029518","38","50664634"
"chr4","84755757","84756051","chr6","84867397","84867689","13","111640"
"chr4","84770315","84770599","chr6","84882204","84882488","2","111889"
"chr4","84819230","84819516","chr6","84931649","84931952","36","112419"
"chr4","84862071","84862181","chr6","84976122","84976226","9","114051"
"chr4","84874832","84875127","chr6","84988969","84989265","18","114137"
"chr4","84890093","84890398","chr6","85003139","85003444","7","113046"
"chr4","84977451","84977632","chr6","85090691","85090843","33","113240"
"chr4","84977666","84977795","chr6","85090889","85091024","11","113223"
"chr4","84980273","84980579","chr6","85093499","85093798","17","113226"
"chr4","85010770","85010988","chrX","13060439","13060663","44","71950331"
"chr4","85015739","85016056","chr16","8260110","8260413","68","76755629"
"chr4","85020676","85020854","chr6","85139536","85139711","7","118860"
"chr4","85020890","85021008","chr6","85139739","85139857","5","118849"
"chr4","85052763","85053074","chr6","85171715","85172024","13","118952"
"chr4","85096599","85096856","chr6","85215417","85215674","9","118818"
"chr4","85098982","85099155","chr11","95299741","95299912","35","10200759"
"chr4","85112211","85112501","chr6","85231784","85232074","10","119573"
"chr4","85119468","85119587","chr6","85239109","85239228","3","119641"
"chr4","85144521","85144848","chr6","85263936","85264262","9","119415"
"chr4","85168652","85168951","chr6","85288879","85289181","11","120227"
"chr4","85172743","85173042","chr6","85292967","85293272","21","120224"
"chr4","85173580","85173893","chr12","51341692","51341995","63","33831888"
"chr4","85178245","85178518","chr6","85298500","85298769","10","120255"
"chr4","85192429","85192725","chr6","85312929","85313225","8","120500"
"chr4","85193040","85193175","chr6","85313542","85313677","2","120502"
"chr4","85193465","85193642","chr6","85313979","85314142","16","120514"
"chr4","85198099","85198384","chr6","85318579","85318876","38","120480"
"chr4","85198609","85198938","chr6","85319075","85319386","29","120466"
"chr4","85203434","85203517","chr9","13509590","13509671","18","71693844"
"chr4","85206835","85207149","chr6","85327604","85327921","12","120769"
"chr4","85214842","85215059","chr6","85335558","85335809","39","120716"
"chr4","85235379","85235680","chr6","85356923","85357242","19","121544"
"chr4","85237185","85237503","chr6","85359056","85359371","17","121871"
"chr4","85252856","85253160","chr6","85375025","85375329","4","122169"
"chr4","85259704","85259796","chr6","85376369","85376461","0","116665"
"chr4","85267831","85268025","chrX","99881690","99881893","49","14613859"
"chr4","85269602","85269726","chr11","94362131","94362241","37","9092529"
"chr4","85281582","85281877","chr6","85405228","85405523","5","123646"
"chr4","85283319","85283616","chr6","85406973","85407273","12","123654"
"chr4","85285461","85285754","chr6","85409485","85409777","9","124024"
"chr4","85292229","85292529","chr6","85416167","85416466","8","123938"
"chr4","85330742","85331038","chr6","85451222","85451518","5","120480"
"chr4","85334957","85335085","chr7","34286297","34286425","25","51048660"
"chr4","85345007","85345331","chr6","85465464","85465790","10","120457"
"chr4","85362632","85362949","chr6","85483075","85483397","11","120443"
"chr4","85470332","85470644","chr6","85593731","85594042","7","123399"
"chr4","85505236","85505523","chr6","85628608","85628905","15","123372"
"chr4","85506414","85506716","chr19","7046387","7046691","56","78460027"
"chr4","85683449","85683718","chr6","85804125","85804395","11","120676"
"chr4","85781573","85781883","chr6","85905820","85906112","25","124247"
"chr4","85829077","85829373","chr6","85959569","85959866","7","130492"
"chr4","85837253","85837417","chr6","85967477","85967642","5","130224"
"chr4","85862526","85862840","chr6","85993374","85993677","19","130848"
"chr4","85864442","85864591","chr6","85995278","85995428","3","130836"
"chr4","86070158","86070286","chr6","86200408","86200527","14","130250"
"chr4","86070441","86070604","chr6","86200696","86200862","13","130255"
"chr4","86239861","86240144","chr6","86371735","86372022","16","131874"
"chr4","86271805","86272130","chr13","25007413","25007743","74","61264392"
"chr4","86333062","86333353","chr6","86456784","86457075","7","123722"
"chr4","86361536","86361836","chr6","86484917","86485217","5","123381"
"chr4","86413652","86413949","chr6","86536683","86536981","6","123031"
"chr4","86423937","86424163","chr6","86548214","86548404","38","124277"
"chr4","86499167","86499345","chr6","86628588","86628766","4","129421"
"chr4","86499385","86499500","chr6","86628806","86628921","11","129421"
"chr4","86764099","86764260","chr6","86902525","86902684","8","138426"
"chr4","86774365","86774583","chr6","86912719","86912938","5","138354"
"chr4","86972526","86972810","chr6","87111128","87111412","4","138602"
"chr4","87097546","87097852","chr6","87232277","87232583","6","134731"
"chr4","87123975","87124255","chrX","48614135","48614413","56","38509840"
"chr4","87172786","87173088","chr6","87307466","87307768","4","134680"
"chr4","87270147","87270443","chr6","87405366","87405651","15","135219"
"chr4","87419341","87419637","chr6","87559893","87560189","6","140552"
"chr4","87443057","87443358","chr6","87583927","87584235","12","140870"
"chr4","87443693","87443824","chr13","19492404","19492536","21","67951289"
"chr4","87443949","87444235","chr1","181762540","181762820","59","94318591"
"chr4","87512616","87512910","chr6","87653137","87653431","1","140521"
"chr4","87515606","87515845","chr6","87656103","87656345","9","140497"
"chr4","87528963","87529264","chr6","87670402","87670700","6","141439"
"chr4","87550792","87551089","chr6","87694063","87694360","7","143271"
"chr4","87690679","87690981","chr6","87831577","87831883","14","140898"
"chr4","87721621","87721676","chrX","939789","939841","9","86781832"
"chr4","87721677","87721766","chr6","113979518","113979602","22","26257841"
"chr4","87726956","87727235","chr6","87867387","87867679","15","140431"
"chr4","87836290","87836523","chr6","87978808","87979041","5","142518"
"chr4","87855685","87855999","chr6","87998140","87998454","10","142455"
"chr4","87927721","87928033","chr6","88070341","88070653","10","142620"
"chr4","88118916","88119216","chr6","88271289","88271591","5","152373"
"chr4","88141625","88141926","chr6","88294613","88294920","14","152988"
"chr4","88250697","88250956","chr6","88393839","88394098","2","143142"
"chr4","88251368","88251633","chr6","88394510","88394775","3","143142"
"chr4","88376712","88376899","chr16","41211187","41211366","39","47165525"
"chr4","88417530","88417826","chr6","88564143","88564439","9","146613"
"chr4","88441948","88442220","chr6","88588257","88588527","9","146309"
"chr4","88450120","88450165","chr3","139974736","139974777","8","51524616"
"chr4","88615029","88615339","chr6","88763473","88763785","15","148444"
"chr4","88615825","88616035","chr6","88764310","88764470","53","148485"
"chr4","88621284","88621417","chr6","88769758","88769891","1","148474"
"chr4","88622724","88623011","chr6","88771196","88771491","13","148472"
"chr4","88639062","88639351","chr6","88787533","88787831","16","148471"
"chr4","88683745","88684065","chr6","88830927","88831246","8","147182"
"chr4","88724041","88724341","chr6","88869144","88869441","11","145103"
"chr4","88775762","88776077","chr6","88920979","88921280","22","145217"
"chr4","88785018","88785329","chr6","88930206","88930504","20","145188"
"chr4","88949363","88949570","chr6","89094131","89094338","6","144768"
"chr4","89052718","89053024","chr6","89196766","89197072","12","144048"
"chr4","89118358","89118660","chr6","89262917","89263219","7","144559"
"chr4","89119581","89119825","chr6","89264146","89264390","6","144565"
"chr4","89219435","89219725","chr6","89367836","89368121","12","148401"
"chr4","89305549","89305779","chr6","89451683","89451933","28","146134"
"chr4","89356351","89356659","chr6","89503440","89503719","34","147089"
"chr4","89494011","89494224","chr6","89638717","89638947","26","144706"
"chr4","89513545","89513661","chr14","106959375","106959495","19","17445830"
"chr4","89582890","89583214","chr6","89727589","89727901","21","144699"
"chr4","89619003","89619285","chr6","89763788","89764060","14","144785"
"chr4","89637646","89637907","chr6","89782529","89782808","22","144883"
"chr4","89690734","89691009","chr6","89832028","89832301","5","141294"
"chr4","89776163","89776472","chr6","89918372","89918686","12","142209"
"chr4","89899284","89899569","chr6","90042670","90042955","3","143386"
"chr4","89963216","89963519","chr6","90110075","90110373","15","146859"
"chr4","90079334","90079503","chr6","90226282","90226451","2","146948"
"chr4","90085279","90085576","chr6","90232125","90232433","17","146846"
"chr4","90245705","90245994","chr6","90393940","90394229","5","148235"
"chr4","90386200","90386506","chr6","90537013","90537314","16","150813"
"chr4","90393223","90393499","chr6","90561696","90561950","28","168473"
"chr4","90403972","90404254","chr6","90572432","90572713","11","168460"
"chr4","90513722","90513888","chr6","90681388","90681554","9","167666"
"chr4","90531001","90531131","chr4","107582407","107582525","25","17051406"
"chr4","90531177","90531348","chr10","53993129","53993294","34","36538048"
"chr4","90544904","90545176","chr6","90713181","90713455","8","168277"
"chr4","90582582","90582897","chr6","90751098","90751414","10","168516"
"chr4","90586280","90586594","chr11","115869443","115869748","66","25283163"
"chr4","90601429","90601708","chr5","35471371","35471651","49","55130058"
"chr4","90627951","90628239","chr6","90796361","90796650","11","168410"
"chr4","90631189","90631452","chr6","90799933","90800190","13","168744"
"chr4","90634757","90635069","chr6","90803526","90803815","30","168769"
"chr4","90651494","90651770","chr6","90828982","90829291","43","177488"
"chr4","90692678","90692938","chr6","90875483","90875746","14","182805"
"chr4","90746651","90746943","chr6","90917774","90918064","7","171123"
"chr4","90754741","90755044","chr6","90926078","90926377","9","171337"
"chr4","90761324","90761529","chr8","69577131","69577335","39","21184193"
"chr4","90777872","90778108","chr6","90948909","90949172","33","171037"
"chr4","90906672","90906951","chr6","91080896","91081181","20","174224"
"chr4","90914645","90914925","chr6","91088938","91089218","15","174293"
"chr4","90921861","90922010","chr8","138639847","138639985","33","47717986"
"chr4","90971773","90972056","chr6","91153422","91153705","13","181649"
"chr4","90972669","90972962","chr6","91154329","91154623","11","181660"
"chr4","90981305","90981616","chr6","91162765","91163087","25","181460"
"chr5","72351698","72351991","chr20","68691790","68692085","8","3659908"
"chr5","18087761","18088077","chr20","17992096","17992380","42","95665"
"chr5","21495791","21496086","chr20","21452211","21452505","6","43580"
"chr5","35782582","35782844","chr20","32444888","32445162","18","3337694"
"chr5","38141670","38141958","chr20","34819380","34819697","48","3322290"
"chr5","54394735","54395024","chr20","55282703","55282992","8","887968"
"chr5","58851271","58851596","chr16","24447104","24447420","78","34404167"
"chr5","60423961","60424206","chr20","49246862","49247107","2","11177099"
"chr5","74055433","74055733","chr20","70387719","70388016","15","3667714"
"chr5","4881","5190","chrX","137897233","137897536","71","137892352"
"chr5","50775","51018","chr1","29985409","29985644","54","29934634"
"chr5","52757","53015","chr15","36754886","36755152","68","36702129"
"chr5","53477","53782","chr1","190510734","190511037","66","190457257"
"chr5","59504","59783","chr9","90215905","90216184","59","90156401"
"chr5","62361","62662","chr1","53885823","53886111","57","53823462"
"chr5","70993","71280","chr6","135022778","135023064","45","134951785"
"chr5","72378","72514","chr16","32496655","32496791","23","32424277"
"chr5","86410","86722","chr13","84452913","84453227","54","84366503"
"chr5","97790","98115","chr20","10817","11152","31","86973"
"chr5","99502","99796","chr20","14857","15151","4","84645"
"chr5","131470","131633","chr20","56232","56393","12","75238"
"chr5","148526","148829","chr5","142637298","142637591","75","142488772"
"chr5","149623","149805","chr20","70593","70778","7","79030"
"chr5","163633","163916","chr20","86567","86851","8","77066"
"chr5","170404","170664","chr8","68882795","68883049","60","68712391"
"chr5","176436","176625","chr20","102735","102917","19","73701"
"chr5","177461","177613","chr20","103743","103911","21","73718"
"chr5","179302","179503","chr11","106321781","106321987","47","106142479"
"chr5","187469","187773","chr20","117204","117513","14","70265"
"chr5","193787","193975","chr8","67378736","67378912","39","67184949"
"chr5","196299","196586","chr12","33772537","33772827","54","33576238"
"chr5","202247","202550","chr6","33100388","33100695","52","32898141"
"chr5","215967","216184","chr20","149709","149926","1","66258"
"chr5","241206","241320","chr20","177943","178037","20","63263"
"chr5","244449","244705","chr20","181175","181432","7","63274"
"chr5","246255","246516","chr20","182330","182585","14","63925"
"chr5","249077","249366","chr20","185487","185766","19","63590"
"chr5","251422","251719","chr20","187803","188102","23","63619"
"chr5","274404","274549","chr5","101392148","101392288","35","101117744"
"chr5","279298","279366","chr20","218326","218394","3","60972"
"chr5","292890","293192","chr20","233206","233512","12","59684"
"chr5","320666","320793","chr14","99325694","99325827","34","99005028"
"chr5","326813","327024","chr20","268218","268419","19","58595"
"chr5","329113","329290","chr1","24160077","24160252","40","23830964"
"chr5","330369","330430","chr20","10999316","10999379","8","10668947"
"chr5","333180","333305","chr20","283572","283697","5","49608"
"chr5","333908","334210","chr20","282991","283293","11","50917"
"chr5","337150","337273","chr20","929087","929213","19","591937"
"chr5","344037","344247","chr20","271416","271626","9","72621"
"chr5","365096","365389","chr20","311565","311863","17","53531"
"chr5","367639","367808","chr13","25896615","25896780","29","25528976"
"chr5","375334","375629","chr20","324360","324656","9","50974"
"chr5","382456","382687","chr20","332749","333004","30","49707"
"chr5","388622","388924","chr20","358197","358499","6","30425"
"chr5","389151","389439","chr20","358728","359016","9","30423"
"chr5","390707","390853","chr20","348276","348430","10","42431"
"chr5","391157","391292","chr20","348745","348880","5","42412"
"chr5","401120","401432","chr20","352208","352520","14","48912"
"chr5","407580","407694","chr20","360448","360562","3","47132"
"chr5","408008","408205","chr20","360868","361065","5","47140"
"chr5","413958","414263","chr20","367796","368101","4","46162"
"chr5","416205","416481","chr20","370040","370316","8","46165"
"chr5","420532","420712","chr20","373980","374160","7","46552"
"chr5","423613","423698","chr1","58740674","58740760","15","58317061"
"chr5","423712","424019","chr20","377170","377477","5","46542"
"chr5","424051","424355","chr20","377509","377813","5","46542"
"chr5","432593","432744","chr20","386130","386278","8","46463"
"chr5","433047","433182","chr20","386584","386719","6","46463"
"chr5","447236","447437","chr20","401296","401500","11","45940"
"chr5","465244","465410","chr7","53483520","53483679","27","53018276"
"chr5","465739","465851","chr16","35887409","35887513","27","35421670"
"chr5","467620","467712","chr20","423032","423123","2","44588"
"chr5","507200","507483","chr20","462478","462754","26","44722"
"chr5","509481","509684","chr20","464761","464948","23","44720"
"chr5","565226","565518","chr20","525247","525544","7","39979"
"chr5","632689","632987","chr20","593092","593388","15","39597"
"chr5","662449","662785","chr20","622680","623014","28","39769"
"chr5","663677","663832","chr20","623864","624039","24","39813"
"chr5","668441","668545","chr20","625322","625434","11","43119"
"chr5","670202","670496","chr20","627352","627640","13","42850"
"chr5","672442","672571","chr20","629915","630029","16","42527"
"chr5","697039","697181","chr1","38100145","38100281","32","37403106"
"chr5","724330","724476","chr20","684343","684499","25","39987"
"chr5","725680","725965","chr20","685698","685986","12","39982"
"chr5","750239","750379","chr20","55907955","55908106","44","55157716"
"chr5","832183","832387","chr19","10261191","10261401","50","9429008"
"chr5","837062","837343","chr10","13389158","13389451","63","12552096"
"chr5","846283","846516","chr20","811934","812176","16","34349"
"chr5","970230","970356","chr20","929087","929213","3","41143"
"chr5","972357","972638","chr20","931536","931827","20","40821"
"chr5","982415","982710","chr20","941653","941952","16","40762"
"chr5","1023757","1024034","chr20","983509","983786","19","40248"
"chr5","1033424","1033711","chr20","994189","994483","16","39235"
"chr5","1050249","1050410","chr20","1012637","1012820","32","37612"
"chr5","1074788","1075080","chr20","1037633","1037925","15","37155"
"chr5","1112056","1112350","chr20","1076807","1077113","22","35249"
"chr5","1122410","1122505","chr9","33792304","33792389","28","32669894"
"chr5","1122509","1122605","chr20","1087728","1087824","4","34781"
"chr5","1155440","1155576","chr20","1119193","1119329","7","36247"
"chr5","1157141","1157264","chr4","137757698","137757825","29","136600557"
"chr5","1181239","1181565","chr20","1145844","1146170","16","35395"
"chr5","1186527","1186684","chr20","1151152","1151313","11","35375"
"chr5","1186988","1187121","chr2","149546616","149546752","31","148359628"
"chr5","1190944","1191082","chr20","1156603","1156732","10","34341"
"chr5","1195280","1195574","chr20","1160961","1161252","25","34319"
"chr5","1258576","1258678","chr20","1227825","1227926","11","30751"
"chr5","1267067","1267336","chr20","1239714","1239984","12","27353"
"chr5","1290591","1290751","chr20","1255862","1256027","10","34729"
"chr5","1296396","1296679","chr20","1262979","1263256","18","33417"
"chr5","1299411","1299578","chr8","20115756","20115916","28","18816345"
"chr5","1300336","1300626","chr1","67481172","67481455","58","66180836"
"chr5","1309835","1309940","chr20","1277139","1277241","8","32696"
"chr5","1313216","1313397","chr11","95299741","95299912","37","93986525"
"chr5","1315974","1316094","chr1","38371894","38372018","36","37055920"
"chr5","1329359","1329465","chr20","1297933","1298039","4","31426"
"chr5","1329767","1329823","chr4","85237427","85237484","13","83907660"
"chr5","1330134","1330241","chr12","41865094","41865202","19","40534960"
"chr5","1334417","1334572","chr20","1303031","1303175","14","31386"
"chr5","1348335","1348455","chr20","1317173","1317293","3","31162"
"chr5","1384479","1384722","chr20","1355737","1355978","12","28742"
"chr5","1393864","1394169","chr20","1364821","1365135","18","29043"
"chr5","1394504","1394681","chr14","6757447","6757620","36","5362943"
"chr5","1401865","1402170","chr20","1373185","1373487","18","28680"
"chr5","1421819","1422010","chr18","37163679","37163850","56","35741860"
"chr5","1430401","1430573","chr20","1400338","1400510","1","30063"
"chr5","1430872","1431014","chr20","1400810","1400952","10","30062"
"chr5","1434009","1434239","chr20","1403943","1404179","17","30066"
"chr5","1440427","1440717","chr20","1410741","1411037","14","29686"
"chr5","1484639","1484817","chr7","19543158","19543338","38","18058519"
"chr5","1485132","1485217","chr6","133011443","133011533","23","131526311"
"chr5","1486117","1486407","chr20","1454817","1455106","6","31300"
"chr5","1488553","1488844","chr20","1458613","1458904","6","29940"
"chr5","1501896","1502159","chr20","1473058","1473320","3","28838"
"chr5","1508885","1509194","chr20","1480044","1480354","8","28841"
"chr5","1519103","1519392","chr20","1490843","1491131","6","28260"
"chr5","1522759","1523063","chr15","99243147","99243458","60","97720388"
"chr5","1557232","1557326","chr20","1527458","1527552","2","29774"
"chr5","1595198","1595372","chr20","1565032","1565206","7","30166"
"chr5","1598849","1599165","chr20","1568684","1568999","10","30165"
"chr5","1607460","1607748","chr20","1576992","1577293","21","30468"
"chr5","1613127","1613385","chr20","1582910","1583171","11","30217"
"chr5","1630127","1630265","chr20","1604219","1604345","16","25908"
"chr5","1636719","1637013","chr20","1612418","1612713","6","24301"
"chr5","1659931","1660210","chr20","1634661","1634928","18","25270"
"chr5","1663541","1663903","chr20","1637830","1638192","19","25711"
"chr5","1689679","1689983","chr20","1663623","1663927","10","26056"
"chr5","1698456","1698745","chr20","1671334","1671625","13","27122"
"chr5","1710480","1710683","chr20","1681566","1681742","32","28914"
"chr5","1711991","1712144","chr20","1689318","1689472","5","22673"
"chr5","1714149","1714432","chr4","119713035","119713321","57","117998886"
"chr5","1719384","1719454","chr18","51499572","51499640","23","49780188"
"chr5","1729578","1729867","chr20","1707995","1708301","35","21583"
"chr5","1739230","1739533","chr20","1716911","1717218","16","22319"
"chr5","1750737","1750868","chr20","1729880","1730011","3","20857"
"chr5","1751492","1751651","chr4","155593864","155594024","40","153842372"
"chr5","1761461","1761756","chr20","1741884","1742183","16","19577"
"chr5","1766238","1766533","chr20","1746667","1746969","16","19571"
"chr5","1784575","1784921","chr20","1766511","1766824","37","18064"
"chr5","1787351","1787643","chr20","1771293","1771587","13","16058"
"chr5","1788303","1788605","chr20","1769201","1769497","17","19102"
"chr5","1792368","1792684","chr20","1775771","1776068","34","16597"
"chr5","1799395","1799706","chr20","1783022","1783320","18","16373"
"chr5","1800572","1800718","chr20","1784589","1784735","8","15983"
"chr5","1801011","1801182","chr20","1785031","1785197","18","15980"
"chr5","1835740","1836049","chrX","44566163","44566473","66","42730423"
"chr5","1846216","1846399","chr20","1833342","1833543","25","12874"
"chr5","1846735","1846882","chr20","1833851","1833999","8","12884"
"chr5","1846883","1846988","chr19","13023168","13023279","30","11176285"
"chr5","1852018","1852257","chr2","156055722","156055963","44","154203704"
"chr5","1853867","1854031","chr20","1839746","1839905","9","14121"
"chr5","1854615","1854883","chr20","1840412","1840659","29","14203"
"chr5","1892157","1892430","chr20","1877840","1878113","7","14317"
"chr5","1907135","1907239","chr20","1892992","1893096","3","14143"
"chr5","1913042","1913245","chr20","1900825","1901088","68","12217"
"chr5","1945547","1945843","chr20","1939071","1939368","10","6476"
"chr5","2025025","2025286","chr19","27639596","27639887","70","25614571"
"chr5","2032300","2032606","chr20","2022829","2023135","6","9471"
"chr5","2036297","2036605","chr20","2026206","2026514","10","10091"
"chr5","2060325","2060607","chr20","2051480","2051721","47","8845"
"chr5","2080708","2080999","chr20","2071343","2071634","4","9365"
"chr5","2082995","2083139","chr20","2073638","2073782","3","9357"
"chr5","2083161","2083414","chr20","2073804","2074057","8","9357"
"chr5","2093005","2093278","chr14","7199598","7199865","60","5106593"
"chr5","2111798","2111944","chr20","2103497","2103660","20","8301"
"chr5","2112249","2112265","chr1","134295927","134295943","2","132183678"
"chr5","2115928","2116025","chr20","49228494","49228595","18","47112566"
"chr5","2159565","2159715","chr20","2155942","2156092","1","3623"
"chr5","2177346","2177633","chr19","3083664","3083949","65","906318"
"chr5","2195453","2195748","chr20","2193205","2193501","9","2248"
"chr5","2201523","2201608","chr20","2197020","2197105","0","4503"
"chr5","2203534","2203761","chr4","103336883","103337103","43","101133349"
"chr5","2205784","2205953","chr20","2202011","2202170","13","3773"
"chr5","2206262","2206401","chr20","2202490","2202630","2","3772"
"chr5","2256929","2257024","chr5","97094637","97094736","20","94837708"
"chr5","2259065","2259368","chr20","2262571","2262889","19","3506"
"chr5","2265643","2265882","chr20","2270370","2270609","7","4727"
"chr5","2268071","2268389","chr20","2272312","2272618","25","4241"
"chr5","2308206","2308477","chr20","2329885","2330162","18","21679"
"chr5","2320426","2320736","chr20","2322759","2323051","27","2333"
"chr5","2324097","2324241","chr20","2326720","2326863","5","2623"
"chr5","2324551","2324709","chr20","2327176","2327334","2","2625"
"chr5","2329953","2330111","chr20","2340545","2340703","2","10592"
"chr5","2358635","2358977","chr20","2369371","2369690","34","10736"
"chr5","2373496","2373676","chr20","2381209","2381405","18","7713"
"chr5","2373982","2374132","chr20","2381707","2381856","6","7725"
"chr5","2377055","2377179","chr20","2384758","2384882","1","7703"
"chr5","2389999","2390295","chr20","2407987","2408289","14","17988"
"chr5","2423127","2423439","chr8","24278067","24278367","69","21854940"
"chr5","2425061","2425345","chr20","2448457","2448740","11","23396"
"chr5","2425863","2426144","chr20","2449258","2449539","10","23395"
"chr5","2427759","2427833","chr1","25250540","25250614","14","22822781"
"chr5","2428821","2429122","chr3","2797380","2797675","51","368559"
"chr5","2429123","2429296","chr20","2455530","2455704","9","26407"
"chr5","2429594","2429737","chr20","2456002","2456145","7","26408"
"chr5","2433299","2433603","chr2","87650402","87650680","86","85217103"
"chr5","2483390","2483703","chr9","96267544","96267859","55","93784154"
"chr5","2496872","2497183","chr20","2543172","2543484","10","46300"
"chr5","2500609","2500906","chr6","61041618","61041916","52","58541009"
"chr5","2509350","2509646","chr20","2555404","2555700","12","46054"
"chr5","2512049","2512340","chr20","9974295","9974603","69","7462246"
"chr5","2539153","2539288","chr20","2586565","2586700","2","47412"
"chr5","2539597","2539728","chr20","2587306","2587430","9","47709"
"chr5","2560744","2561039","chr20","2604556","2604857","16","43812"
"chr5","2565846","2566049","chr1","17368858","17369057","64","14803012"
"chr5","2608654","2608952","chr20","2663980","2664283","8","55326"
"chr5","2614419","2614445","chr14","7460741","7460765","8","4846322"
"chr5","2614762","2614818","chr1","12171232","12171281","14","9556470"
"chr5","2619305","2619585","chr9","27680847","27681122","51","25061542"
"chr5","2620467","2620675","chr20","2674756","2674964","4","54289"
"chr5","2622202","2622488","chr2","147425285","147425576","55","144803083"
"chr5","2648211","2648470","chr9","89071379","89071608","79","86423168"
"chr5","2662145","2662353","chr20","2720315","2720524","4","58170"
"chr5","2672078","2672358","chr15","18184869","18185148","53","15512791"
"chr5","2680377","2680569","chr20","2738175","2738364","11","57798"
"chr5","2719689","2719981","chr7","18328545","18328829","50","15608856"
"chr5","2724102","2724213","chr20","2788676","2788787","3","64574"
"chr5","2724511","2724594","chr20","2789075","2789170","15","64564"
"chr5","2724708","2725013","chr11","50004656","50004962","56","47279948"
"chr5","2734172","2734503","chr20","2799423","2799747","27","65251"
"chr5","2746297","2746466","chr20","2812210","2812390","23","65913"
"chr5","2746763","2746891","chr20","2812684","2812817","8","65921"
"chr5","2747190","2747405","chr20","2813107","2813295","29","65917"
"chr5","2761920","2762207","chr20","2829436","2829722","4","67516"
"chr5","2762840","2763041","chr20","2830333","2830532","4","67493"
"chr5","2776760","2777053","chr7","122518704","122518988","54","119741944"
"chr5","2782497","2782784","chr20","2848599","2848887","6","66102"
"chr5","2786994","2787105","chr20","2858506","2858617","3","71512"
"chr5","2787416","2787612","chr20","2858889","2859085","9","71473"
"chr5","2788129","2788294","chr20","2859599","2859764","1","71470"
"chr5","2789881","2790012","chr14","10256467","10256598","29","7466586"
"chr5","2796889","2797195","chr3","153060925","153061233","64","150264036"
"chr5","2799282","2799438","chr20","2870691","2870847","4","71409"
"chr5","2807071","2807363","chr20","2878183","2878476","14","71112"
"chr5","2818149","2818447","chr20","2890060","2890357","9","71911"
"chr5","2819276","2819398","chr20","2891186","2891296","16","71910"
"chr5","2819705","2819882","chr20","2892226","2892400","6","72521"
"chr5","2821706","2821881","chr20","2894250","2894425","9","72544"
"chr5","2841533","2841835","chr20","2913431","2913740","13","71898"
"chr5","2851312","2851585","chr20","2923198","2923469","10","71886"
"chr5","2894424","2894640","chr15","24479301","24479505","59","21584877"
"chr5","2905842","2905916","chr20","2983692","2983767","1","77850"
"chr5","2906223","2906367","chr20","2984077","2984220","7","77854"
"chr5","2925418","2925455","chr12","32726896","32726932","5","29801478"
"chr5","2925748","2926020","chr5","158962682","158962956","52","156036934"
"chr5","2939339","2939621","chr20","3020348","3020632","10","81009"
"chr5","2968669","2968966","chr20","3052255","3052559","11","83586"
"chr5","2969619","2969876","chr20","3053218","3053475","1","83599"
"chr5","2973375","2973664","chr20","3057215","3057515","14","83840"
"chr5","2981017","2981159","chr3","75119322","75119465","27","72138305"
"chr5","2994757","2994928","chr16","22807665","22807835","31","19812908"
"chr5","3001860","3002091","chr1","220165804","220166031","57","217163944"
"chr5","3033139","3033423","chr20","3119953","3120233","15","86814"
"chr5","3034084","3034293","chr2","186851868","186852075","37","183817784"
"chr5","3057133","3057284","chr20","3143622","3143770","8","86489"
"chr5","3057566","3057684","chr20","3144053","3144172","20","86487"
"chr5","3069458","3069748","chr20","3161268","3161560","8","91810"
"chr5","3075405","3075689","chr3","67771493","67771765","60","64696088"
"chr5","3101357","3101646","chr20","3194479","3194770","5","93122"
"chr5","3108838","3109125","chr20","3203891","3204174","10","95053"
"chr5","3111066","3111347","chr20","3206117","3206426","32","95051"
"chr5","3126567","3126864","chr20","3221556","3221853","5","94989"
"chr5","3140041","3140352","chr20","3234753","3235047","22","94712"
"chr5","3144676","3144965","chr20","3247968","3248261","24","103292"
"chr5","3153097","3153373","chr5","158962682","158962956","55","155809585"
"chr5","3161679","3161962","chr20","3257823","3258098","16","96144"
"chr5","3180918","3181021","chr20","3278036","3278139","2","97118"
"chr5","3198588","3198908","chr20","3291596","3291916","18","93008"
"chr5","3206094","3206395","chr20","3303192","3303492","12","97098"
"chr5","3228074","3228372","chr6","168926020","168926313","59","165697946"
"chr5","3237473","3237770","chr20","3335263","3335550","15","97790"
"chr5","3245082","3245409","chr20","3342785","3343111","11","97703"
"chr5","3269232","3269353","chr7","27522130","27522249","23","24252898"
"chr5","3273951","3274096","chr11","121092295","121092441","26","117818344"
"chr5","3278432","3278585","chr20","3374565","3374718","4","96133"
"chr5","3279951","3280091","chr20","3376080","3376220","1","96129"
"chr5","3285738","3285978","chr20","3381850","3382092","11","96112"
"chr5","3299815","3300115","chr20","3396448","3396748","10","96633"
"chr5","3306619","3306796","chr20","3403268","3403427","23","96649"
"chr5","3322693","3322982","chr20","3419578","3419871","12","96885"
"chr5","3323160","3323468","chr7","59039384","59039668","71","55716224"
"chr5","3327484","3327784","chr20","3424379","3424634","54","96895"
"chr5","3342092","3342238","chr17","77370914","77371058","44","74028822"
"chr5","3342585","3342733","chr20","3451155","3451327","24","108570"
"chr5","3369939","3370220","chr20","3481330","3481614","8","111391"
"chr5","3371156","3371460","chr20","3482544","3482849","9","111388"
"chr5","3373093","3373394","chr20","3484492","3484793","10","111399"
"chr5","3374822","3375093","chr20","3486232","3486503","11","111410"
"chr5","3378393","3378562","chr20","3489354","3489532","13","110961"
"chr5","3381076","3381219","chr20","3492051","3492194","6","110975"
"chr5","3381237","3381529","chr20","3492212","3492504","7","110975"
"chr5","3389668","3389967","chr20","3502362","3502661","15","112694"
"chr5","3409535","3409840","chr20","3523963","3524271","10","114428"
"chr5","3430010","3430291","chr20","3548388","3548670","5","118378"
"chr5","3436005","3436228","chr6","73158147","73158368","53","69722142"
"chr5","3436236","3436352","chrX","19112370","19112485","35","15676134"
"chr5","3453379","3453673","chr20","3571731","3572032","11","118352"
"chr5","3453979","3454083","chr8","28333149","28333249","25","24879170"
"chr5","3454086","3454191","chr18","28177084","28177194","30","24722998"
"chr5","3456446","3456710","chr20","3574612","3574883","15","118166"
"chr5","3457805","3458139","chr20","3577038","3577372","10","119233"
"chr5","3462635","3462918","chr20","3581553","3581836","8","118918"
"chr5","3481253","3481543","chr20","3601349","3601639","8","120096"
"chr5","3492876","3493172","chr20","3612906","3613202","9","120030"
"chr5","3496829","3497117","chr20","3617393","3617682","9","120564"
"chr5","3516562","3516842","chr20","3637180","3637458","17","120618"
"chr5","3535301","3535595","chr20","3655672","3655964","7","120371"
"chr5","3582510","3582874","chr20","3708907","3709272","6","126397"
"chr5","3589263","3589596","chr16","59577725","59578048","77","55988462"
"chr5","3591317","3591620","chr8","27494134","27494437","69","23902817"
"chr5","3593695","3593986","chr20","3710011","3710305","8","116316"
"chr5","3601758","3602003","chr20","3724740","3724988","8","122982"
"chr5","3607913","3608053","chr16","21126160","21126297","22","17518247"
"chr5","3608656","3608790","chr1","129251224","129251360","24","125642568"
"chr5","3609090","3609269","chr20","3732674","3732861","17","123584"
"chr5","3616960","3617260","chr20","3740542","3740842","13","123582"
"chr5","3623509","3623820","chr20","3747671","3747969","23","124162"
"chr5","3627299","3627592","chr20","3752511","3752811","11","125212"
"chr5","3637800","3638097","chr20","3766932","3767227","14","129132"
"chr5","3639886","3640188","chr20","3769013","3769315","9","129127"
"chr5","3645837","3645969","chr20","3774160","3774292","5","128323"
"chr5","3677990","3678286","chr20","3802651","3802951","16","124661"
"chr5","3681761","3681944","chr20","3809622","3809805","12","127861"
"chr5","3689821","3690113","chr20","3817623","3817914","14","127802"
"chr5","3697675","3697846","chr8","137943501","137943673","31","134245826"
"chr5","3709744","3710032","chr20","3841199","3841488","13","131455"
"chr5","3725033","3725301","chr20","3854739","3855018","17","129706"
"chr5","3743812","3743931","chr20","3873944","3874061","5","130132"
"chr5","3747008","3747282","chr20","3877158","3877432","6","130150"
"chr5","3751137","3751432","chr20","3881107","3881417","21","129970"
"chr5","3755297","3755565","chr8","97975528","97975804","47","94220231"
"chr5","3758434","3758581","chr7","130068207","130068351","33","126309773"
"chr5","3758847","3758960","chr3","17112514","17112638","26","13353667"
"chr5","3759049","3759070","chr1","85264343","85264360","6","81505294"
"chr5","3768642","3768917","chr20","3896978","3897253","8","128336"
"chr5","3770061","3770315","chr20","3898382","3898646","22","128321"
"chr5","3774657","3774831","chr20","3903209","3903386","9","128552"
"chr5","3776758","3777071","chr9","116170959","116171266","60","112394201"
"chr5","3780719","3780960","chr20","3909901","3910143","6","129182"
"chr5","3781650","3781748","chr12","18403513","18403610","21","14621863"
"chr5","3786047","3786210","chr9","11885043","11885208","31","8098996"
"chr5","3789668","3789774","chr20","3918667","3918773","1","128999"
"chr5","3804342","3804624","chr20","3939932","3940215","19","135590"
"chr5","3809706","3810018","chr20","3933900","3934212","14","124194"
"chr5","3819184","3819483","chr20","3951877","3952178","16","132693"
"chr5","3825720","3825847","chr20","3958428","3958554","7","132708"
"chr5","3825887","3825913","chr20","3958596","3958621","4","132709"
"chr5","3826205","3826358","chr20","3958917","3959090","23","132712"
"chr5","3829193","3829450","chr20","3961960","3962219","8","132767"
"chr5","3831920","3832055","chr20","3964273","3964408","8","132353"
"chr5","3832353","3832534","chr20","3964706","3964901","22","132353"
"chr5","3839458","3839768","chr20","3976107","3976416","11","136649"
"chr5","3842565","3842850","chr20","3979787","3980075","10","137222"
"chr5","3845661","3845978","chr20","3982684","3983002","13","137023"
"chr5","3865718","3865902","chr20","4008932","4009116","6","143214"
"chr5","3867441","3867465","chr4","6040937","6040958","4","2173496"
"chr5","3867493","3867768","chr20","4010671","4010982","44","143178"
"chr5","3867780","3868072","chr16","996804","997095","53","2870976"
"chr5","3896519","3896669","chr20","4040570","4040719","6","144051"
"chr5","3896976","3897149","chr20","4041028","4041203","8","144052"
"chr5","3897702","3897985","chr20","4041754","4042061","33","144052"
"chr5","3904986","3905284","chr20","4049204","4049502","11","144218"
"chr5","3908633","3908927","chr20","4050755","4051065","27","142122"
"chr5","3910111","3910412","chr20","4052776","4053085","24","142665"
"chr5","3912451","3912710","chr20","4055203","4055476","38","142752"
"chr5","3913272","3913571","chr20","4058021","4058329","26","144749"
"chr5","3917410","3917598","chr9","10804689","10804873","47","6887279"
"chr5","3929863","3929928","chr20","4074804","4074868","8","144941"
"chr5","3930227","3930370","chr20","4075166","4075309","1","144939"
"chr5","3930403","3930417","chr5","34834358","34834371","3","30903955"
"chr5","3935097","3935265","chr12","83005289","83005458","29","79070192"
"chr5","3935272","3935570","chr3","42883597","42883894","45","38948325"
"chr5","3943005","3943319","chr20","4088340","4088648","13","145335"
"chr5","3957509","3957668","chr20","4103896","4104057","9","146387"
"chr5","3959971","3960114","chr2","172227852","172227991","28","168267881"
"chr5","3974328","3974496","chrX","107282587","107282754","33","103308259"
"chr5","3975190","3975490","chr20","4123472","4123768","9","148282"
"chr5","3978447","3978753","chr7","87919974","87920279","61","83941527"
"chr5","3989509","3989775","chr20","4136722","4137015","33","147213"
"chr5","4006931","4007063","chr20","4155375","4155507","3","148444"
"chr5","4025975","4025985","chr16","68350242","68350252","0","64324267"
"chr5","4026299","4026433","chr20","4173590","4173726","6","147291"
"chr5","4026566","4026726","chr20","4173859","4174019","4","147293"
"chr5","4028871","4029149","chr20","4176174","4176500","61","147303"
"chr5","4031902","4032212","chr1","158821141","158821452","64","154789239"
"chr5","4035927","4036086","chr20","4183216","4183376","10","147289"
"chr5","4036388","4036530","chr20","4183679","4183820","4","147291"
"chr5","4048061","4048210","chr20","4195469","4195618","3","147408"
"chr5","4048502","4048620","chr20","4195910","4196028","1","147408"
"chr5","4049117","4049182","chr20","4196337","4196403","1","147220"
"chr5","4071830","4071961","chr20","4218994","4219123","3","147164"
"chr5","4072263","4072411","chr20","4219731","4219879","2","147468"
"chr5","4080169","4080278","chr1","163954934","163955041","21","159874765"
"chr5","4082588","4082879","chr7","25185886","25186189","55","21103298"
"chr5","4096663","4096966","chr20","4242727","4243029","12","146064"
"chr5","4098918","4099084","chr20","4244977","4245143","5","146059"
"chr5","4105777","4106100","chr20","4251492","4251816","9","145715"
"chr5","4106426","4106685","chr20","4252141","4252403","10","145715"
"chr5","4106711","4106866","chr20","4252429","4252584","3","145718"
"chr5","4112694","4112966","chr20","4257148","4257405","24","144454"
"chr5","4117723","4117733","chr10","17677672","17677682","1","13559949"
"chr5","4118038","4118068","chr3","51721696","51721728","7","47603658"
"chr5","4118392","4118542","chr20","4269524","4269669","7","151132"
"chr5","4118958","4119259","chr20","4270083","4270393","16","151125"
"chr5","4124191","4124500","chr20","4275668","4275977","7","151477"
"chr5","4141868","4142051","chr9","88967166","88967333","44","84825298"
"chr5","4149022","4149190","chr20","4290215","4290389","8","141193"
"chr5","4154062","4154146","chr8","74369844","74369927","12","70215782"
"chr5","4156505","4156685","chr3","42298682","42298860","40","38142177"
"chr5","4160588","4160910","chr20","4303573","4303895","8","142985"
"chr5","4162244","4162534","chr20","4305520","4305812","8","143276"
"chr5","4165626","4165794","chr20","4309267","4309431","5","143641"
"chr5","4166655","4166855","chr20","4310293","4310455","44","143638"
"chr5","4167322","4167419","chr20","4311266","4311363","1","143944"
"chr5","4177866","4178084","chr20","4328396","4328614","6","150530"
"chr5","4180719","4181005","chr20","4331224","4331510","7","150505"
"chr5","4184146","4184440","chr20","4334326","4334620","7","150180"
"chr5","4219984","4220152","chr9","13119395","13119567","37","8899411"
"chr5","4222440","4222584","chr9","19767173","19767318","36","15544733"
"chr5","4223034","4223158","chr5","158569038","158569168","20","154346004"
"chr5","4232883","4233041","chr1","202426861","202427019","30","198193978"
"chr5","4235783","4236072","chr20","4387488","4387791","33","151705"
"chr5","4237585","4237894","chr20","4389298","4389608","9","151713"
"chr5","4247540","4247830","chr20","4399717","4400007","14","152177"
"chr5","4252103","4252404","chr20","4404756","4405057","11","152653"
"chr5","4257379","4257685","chr20","4410784","4411092","13","153405"
"chr5","4265627","4265753","chr20","4421791","4421929","14","156164"
"chr5","4267716","4268006","chr20","4420330","4420618","11","152614"
"chr5","4270873","4271050","chr20","4425802","4425985","10","154929"
"chr5","4271078","4271371","chr20","4425996","4426304","49","154918"
"chr5","4275501","4275764","chr8","99732515","99732777","49","95457014"
"chr5","4284183","4284492","chr20","4439637","4439942","7","155454"
"chr5","4303901","4304039","chr20","4458850","4458982","10","154949"
"chr5","4304344","4304464","chr20","4459602","4459722","2","155258"
"chr5","4306435","4306747","chr20","4462005","4462318","12","155570"
"chr5","4309078","4309385","chr20","4465097","4465410","12","156019"
"chr5","4315983","4316297","chr19","28718617","28718918","63","24402634"
"chr5","4324337","4324505","chr20","4485123","4485291","7","160786"
"chr5","4324806","4324940","chr20","4485592","4485726","4","160786"
"chr5","4340049","4340323","chr20","4502791","4503065","8","162742"
"chr5","4357541","4357811","chr20","4520823","4521092","8","163282"
"chr5","4359899","4360197","chr20","4523815","4524112","7","163916"
"chr5","4369260","4369507","chr20","4533098","4533343","13","163838"
"chr5","4399740","4399910","chr20","5000355","5000521","35","600615"
"chr5","4402433","4402732","chr1","139022172","139022488","68","134619739"
"chr5","4419407","4419593","chr20","4587355","4587538","6","167948"
"chr5","4441610","4441906","chr20","4609550","4609852","21","167940"
"chr5","4450132","4450262","chr20","4622831","4622961","5","172699"
"chr5","4452830","4453157","chr11","59899765","59900078","84","55446935"
"chr5","4453524","4453641","chr20","4631655","4631772","5","178131"
"chr5","4461583","4461859","chr20","4626751","4627032","12","165168"
"chr5","4463801","4464101","chr20","4629173","4629473","9","165372"
"chr5","4485601","4485818","chr20","4661786","4662024","24","176185"
"chr5","4486355","4486640","chr5","35786577","35786873","65","31300222"
"chr5","4491433","4491716","chr20","4667585","4667868","4","176152"
"chr5","4499845","4499999","chr15","7442796","7442954","40","2942951"
"chr5","4505320","4505482","chr20","4681889","4682051","1","176569"
"chr5","4512920","4513223","chr20","4689857","4690163","24","176937"
"chr5","4515231","4515511","chr20","4692186","4692466","4","176955"
"chr5","4520286","4520452","chr20","4697565","4697744","21","177279"
"chr5","4520757","4520901","chr20","4698046","4698185","15","177289"
"chr5","4521558","4521659","chr4","136926724","136926825","28","132405166"
"chr5","4521969","4522151","chr5","148194407","148194588","36","143672438"
"chr5","4523401","4523676","chr20","4700360","4700633","6","176959"
"chr5","4527563","4527854","chr20","4704503","4704814","25","176940"
"chr5","4529746","4530049","chr20","4706701","4707001","8","176955"
"chr5","4538032","4538302","chr20","4714916","4715190","6","176884"
"chr5","4539121","4539434","chr20","4716006","4716312","24","176885"
"chr5","4573273","4573561","chr20","4749877","4750179","23","176604"
"chr5","4574235","4574545","chr20","4750853","4751163","9","176618"
"chr5","4574553","4574767","chrX","38144107","38144315","42","33569554"
"chr5","4574810","4574829","chrX","48625565","48625583","1","44050755"
"chr5","4579527","4579711","chr20","4756426","4756604","10","176899"
"chr5","4580958","4581242","chr20","4757845","4758126","7","176887"
"chr5","4583885","4584195","chr20","4760769","4761048","51","176884"
"chr5","4588880","4589181","chr20","4765736","4766035","15","176856"
"chr5","4589971","4590273","chr20","4766824","4767124","15","176853"
"chr5","4611957","4611968","chr5","58058740","58058751","2","53446783"
"chr5","4612007","4612289","chr20","4788309","4788615","40","176302"
"chr5","4641955","4642259","chr20","4819299","4819585","27","177344"
"chr5","4662459","4662727","chr20","4841307","4841569","16","178848"
"chr5","4670326","4670637","chr20","4848930","4849245","24","178604"
"chr5","4672480","4672664","chr6","68526300","68526488","30","63853820"
"chr5","4691803","4692000","chr20","4870540","4870735","7","178737"
"chr5","4711210","4711506","chr20","4892373","4892669","12","181163"
"chr5","4721469","4721779","chr12","99689911","99690212","51","94968442"
"chr5","4722668","4722970","chr3","1520164","1520462","54","3202504"
"chr5","4735244","4735544","chr20","4916435","4916740","16","181191"
"chr5","4738246","4738543","chr20","4919738","4920033","12","181492"
"chr5","4754835","4754943","chr7","148664648","148664755","16","143909813"
"chr5","4756331","4756635","chr20","4936559","4936860","29","180228"
"chr5","4774534","4774709","chr20","4970802","4970975","11","196268"
"chr5","4774993","4775127","chr10","27050328","27050458","23","22275335"
"chr5","4775209","4775508","chr20","4971463","4971770","22","196254"
"chr5","4776113","4776172","chr20","4972377","4972436","6","196264"
"chr5","4776642","4776884","chr20","4972905","4973157","18","196263"
"chr5","4778976","4779094","chr20","4975317","4975429","8","196341"
"chr5","4779406","4779552","chr20","4976033","4976178","6","196627"
"chr5","4803273","4803347","chr4","37211680","37211750","20","32408407"
"chr5","4808685","4808966","chr11","113023863","113024155","54","108215178"
"chr5","4813667","4813979","chr20","5010965","5011264","15","197298"
"chr5","4851213","4851272","chr20","5048738","5048794","4","197525"
"chr5","4851614","4851728","chr20","5049136","5049236","17","197522"
"chr5","4855081","4855355","chr10","69021821","69022111","64","64166740"
"chr5","4869074","4869290","chr14","331143","331344","49","4537931"
"chr5","4886258","4886569","chr20","5083562","5083869","18","197304"
"chr5","4893494","4893798","chr20","5090843","5091140","24","197349"
"chr5","4898536","4898663","chr15","34683273","34683394","26","29784737"
"chr5","4898710","4898870","chrX","14387257","14387417","29","9488547"
"chr5","4914406","4914713","chr20","5111929","5112219","25","197523"
"chr5","4963491","4963783","chr20","5161663","5161954","18","198172"
"chr5","4994421","4994656","chr15","99486679","99486907","45","94492258"
"chr5","5008607","5008898","chr20","5208639","5208940","20","200032"
"chr5","5049505","5049610","chr20","5251300","5251410","11","201795"
"chr5","5059452","5059649","chr2","181564775","181564973","51","176505323"
"chr5","5070158","5070457","chr20","5275942","5276240","8","205784"
"chr5","5080861","5081194","chr20","5286648","5286979","14","205787"
"chr5","5177465","5177738","chr20","5382454","5382727","4","204989"
"chr5","5188701","5189015","chr20","5393091","5393407","15","204390"
"chr5","5285975","5286151","chr20","5491938","5492136","33","205963"
"chr5","5286460","5286595","chr20","5492446","5492581","6","205986"
"chr5","5417321","5417593","chr20","5622069","5622342","9","204748"
"chr5","5475494","5475763","chr20","5680219","5680499","19","204725"
"chr5","5517364","5517645","chr20","5721859","5722126","20","204495"
"chr5","5533028","5533336","chr20","5737989","5738307","23","204961"
"chr5","5559406","5559628","chr20","5764508","5764741","15","205102"
"chr5","5559712","5559788","chr20","5764825","5764899","7","205113"
"chr5","5560416","5560716","chr2","186502325","186502623","55","180941909"
"chr5","5565708","5565946","chr20","5770727","5770981","26","205019"
"chr5","5588522","5588829","chr4","11915397","11915699","68","6326875"
"chr5","5617901","5618197","chr20","5820783","5821079","10","202882"
"chr5","5693108","5693395","chr20","5894249","5894536","8","201141"
"chr5","5733153","5733437","chr20","5935526","5935803","16","202373"
"chr5","5741434","5741686","chr20","5943786","5944038","13","202352"
"chr5","5746373","5746703","chr1","216385363","216385697","78","210638990"
"chr5","5867163","5867438","chr13","19787422","19787699","59","13920259"
"chr5","5874745","5875053","chr20","6077053","6077360","11","202308"
"chr5","5883552","5883618","chr6","46377755","46377820","21","40494203"
"chr5","5904440","5904577","chr1","14816698","14816833","25","8912258"
"chr5","5939967","5940266","chr20","6142622","6142923","13","202655"
"chr5","5945785","5946092","chr20","6148739","6149053","13","202954"
"chr5","5954552","5954726","chr20","6157951","6158125","10","203399"
"chr5","6039554","6039861","chr20","6243551","6243863","22","203997"
"chr5","6066045","6066349","chr20","6271014","6271323","10","204969"
"chr5","6089903","6090065","chr1","179541903","179542057","31","173452000"
"chr5","6091425","6091744","chr20","6295831","6296145","23","204406"
"chr5","6117955","6118259","chr20","6322185","6322489","11","204230"
"chr5","6175267","6175591","chr9","24068882","24069202","62","17893615"
"chr5","6202829","6203144","chr20","6407362","6407678","9","204533"
"chr5","6226823","6227106","chr20","6431568","6431862","31","204745"
"chr5","6237402","6237436","chr20","6442660","6442694","1","205258"
"chr5","6269287","6269417","chr20","6474985","6475122","9","205698"
"chr5","6270365","6270522","chr20","6476003","6476160","2","205638"
"chr5","6275783","6276062","chr20","6481446","6481725","7","205663"
"chr5","6368837","6369143","chr20","6575400","6575706","23","206563"
"chr5","6371167","6371452","chr20","6577725","6578010","11","206558"
"chr5","6384182","6384485","chr20","6590760","6591063","9","206578"
"chr5","6398927","6399092","chr7","46204257","46204412","33","39805330"
"chr5","6400244","6400470","chr20","6606633","6606868","18","206389"
"chr5","6408787","6409075","chr20","6615147","6615461","36","206360"
"chr5","6409119","6409145","chr2","21604054","21604082","5","15194935"
"chr5","6411070","6411369","chr20","6617413","6617713","20","206343"
"chr5","6453733","6454042","chr20","6660639","6660946","11","206906"
"chr5","6536785","6537065","chr20","6745669","6745956","27","208884"
"chr5","6537095","6537265","chr20","6745976","6746172","32","208881"
"chr5","6576205","6576381","chr13","60629700","60629873","32","54053495"
"chr5","6579117","6579431","chr20","6786419","6786717","32","207302"
"chr5","6579801","6579968","chr20","6787084","6787251","6","207283"
"chr5","6602519","6602624","chr17","1352997","1353107","29","5249522"
"chr5","6602971","6603145","chr11","44496859","44497034","35","37893888"
"chr5","6622526","6622818","chr20","6832742","6833047","28","210216"
"chr5","6628979","6629272","chr20","6839190","6839491","23","210211"
"chr5","6643605","6643697","chr20","6854283","6854375","0","210678"
"chr5","6648104","6648391","chr20","6858785","6859074","18","210681"
"chr5","6668920","6669151","chr5","71934527","71934759","64","65265607"
"chr5","6724436","6724735","chr20","6939685","6939980","16","215249"
"chr5","6733064","6733360","chr20","6948635","6948920","23","215571"
"chr5","6793852","6794159","chr20","7010093","7010397","17","216241"
"chr5","6797136","6797320","chr20","7013405","7013575","21","216269"
"chr5","6799388","6799686","chr20","7015652","7015954","13","216264"
"chr5","6802309","6802636","chr9","105795744","105796061","76","98993435"
"chr5","6809079","6809353","chr20","7026075","7026367","42","216996"
"chr5","6809788","6809906","chr11","60190950","60191069","19","53381162"
"chr5","6824458","6824757","chr20","7041582","7041881","5","217124"
"chr5","6841876","6842174","chr20","7058846","7059153","25","216970"
"chr5","6848958","6849234","chr20","7066281","7066559","11","217323"
"chr5","6894264","6894450","chr20","51034793","51034975","33","44140529"
"chr5","6894477","6894592","chr7","46204039","46204155","16","39309562"
"chr5","7006131","7006409","chr20","7222595","7222873","13","216464"
"chr5","7041721","7042028","chr20","7257732","7258039","4","216011"
"chr5","7071438","7071750","chr20","7287255","7287567","10","215817"
"chr5","7092394","7092633","chr20","7308907","7309146","2","216513"
"chr5","7128326","7128626","chr20","7347433","7347709","30","219107"
"chr5","7131477","7131786","chr20","7350572","7350890","17","219095"
"chr5","7206649","7206816","chrX","90601178","90601349","37","83394529"
"chr5","7210750","7211032","chr2","81149346","81149628","50","73938596"
"chr5","7221424","7221585","chr2","62288928","62289088","43","55067504"
"chr5","7244943","7245091","chr10","29318941","29319087","36","22073998"
"chr5","7245092","7245374","chr20","7464495","7464793","24","219403"
"chr5","7251811","7252108","chr20","7471261","7471544","29","219450"
"chr5","7304298","7304570","chr20","7523484","7523754","17","219186"
"chr5","7372343","7372643","chr20","7591875","7592183","23","219532"
"chr5","7375935","7376216","chr1","202638456","202638752","85","195262521"
"chr5","7466219","7466527","chr20","7686430","7686726","22","220211"
"chr5","7623560","7623720","chr4","66251373","66251530","32","58627813"
"chr5","7682207","7682327","chr20","7900248","7900368","1","218041"
"chr5","7745294","7745570","chr20","7963673","7963953","25","218379"
"chr5","7748315","7748626","chr20","7966694","7966996","15","218379"
"chr5","7876415","7876718","chr20","8094255","8094558","8","217840"
"chr5","7916993","7917318","chr20","8135078","8135382","35","218085"
"chr5","7930796","7931063","chr20","8148778","8149043","13","217982"
"chr5","7955439","7955574","chr20","8172649","8172784","6","217210"
"chr5","7955872","7956032","chr20","8173079","8173239","9","217207"
"chr5","7966699","7966904","chr20","8183834","8184034","10","217135"
"chr5","8005171","8005479","chr1","20770331","20770635","62","12765160"
"chr5","8033429","8033586","chr4","42373854","42373990","41","34340425"
"chr5","8068393","8068692","chr20","8289513","8289801","18","221120"
"chr5","8076633","8076715","chr20","8298660","8298739","6","222027"
"chr5","8081692","8081973","chr20","8303717","8303998","10","222025"
"chr5","8085135","8085267","chr20","8312972","8313104","5","227837"
"chr5","8086258","8086558","chr20","8314107","8314403","20","227849"
"chr5","8102815","8103125","chr20","8330568","8330849","33","227753"
"chr5","8113137","8113423","chr9","5765156","5765435","51","2347981"
"chr5","8122800","8123073","chr20","8351339","8351603","18","228539"
"chr5","8124814","8125119","chr20","8353333","8353597","46","228519"
"chr5","8139508","8139793","chr20","8367485","8367768","20","227977"
"chr5","8148157","8148449","chr20","8376114","8376406","4","227957"
"chr5","8149310","8149610","chr20","8377269","8377566","12","227959"
"chr5","8188626","8188928","chr20","8417372","8417670","16","228746"
"chr5","8204496","8204812","chr20","8433499","8433803","26","229003"
"chr5","8225590","8225786","chr20","8455506","8455696","11","229916"
"chr5","8234224","8234505","chr20","8465051","8465329","16","230827"
"chr5","8239773","8240064","chr20","8469148","8469439","18","229375"
"chr5","8264744","8265026","chr20","8491820","8492127","35","227076"
"chr5","8265359","8265603","chr20","8492433","8492676","8","227074"
"chr5","8271054","8271356","chr20","8498443","8498741","9","227389"
"chr5","8277948","8278221","chr20","8505626","8505887","14","227678"
"chr5","8278357","8278467","chr6","173207520","173207631","29","164929163"
"chr5","8290076","8290264","chr20","8525621","8525809","2","235545"
"chr5","8290410","8290725","chr20","8525878","8526185","35","235468"
"chr5","8301224","8301329","chr20","8530555","8530657","6","229331"
"chr5","8301568","8301740","chr20","8530896","8531065","7","229328"
"chr5","8302491","8302793","chr20","8531818","8532119","11","229327"
"chr5","8305138","8305433","chr20","8534469","8534765","10","229331"
"chr5","8320190","8320487","chr20","8549893","8550189","8","229703"
"chr5","8339619","8339930","chr20","8570389","8570692","19","230770"
"chr5","8340069","8340369","chr20","8570831","8571131","11","230762"
"chr5","8347973","8348286","chr11","71691492","71691799","48","63343519"
"chr5","8353554","8353865","chr20","8591416","8591726","20","237862"
"chr5","8355843","8356159","chr20","8582640","8582954","15","226797"
"chr5","8359127","8359443","chr20","8585923","8586216","32","226796"
"chr5","8361352","8361664","chr14","46436986","46437302","51","38075634"
"chr5","8383460","8383760","chrX","27894759","27895057","55","19511299"
"chr5","8393647","8393915","chr20","8622156","8622424","10","228509"
"chr5","8402288","8402608","chr20","8631102","8631422","10","228814"
"chr5","8403049","8403260","chr20","8631864","8632074","3","228815"
"chr5","8403708","8404016","chr20","8632524","8632827","15","228816"
"chr5","8419365","8419516","chr14","63560003","63560159","27","55140638"
"chr5","8436920","8437004","chrX","13936177","13936268","22","5499257"
"chr5","8438973","8439274","chr20","8669188","8669489","13","230215"
"chr5","8449770","8450086","chr20","8681328","8681624","23","231558"
"chr5","8452899","8453103","chr20","8679019","8679183","44","226120"
"chr5","8455490","8455790","chr2","99765590","99765888","56","91310100"
"chr5","8465953","8466263","chr16","71534355","71534671","61","63068402"
"chr5","8484790","8485058","chr20","8715532","8715793","25","230742"
"chr5","8525988","8526249","chr20","8759614","8759874","11","233626"
"chr5","8542423","8542537","chr13","124948902","124949015","17","116406479"
"chr5","8549320","8549617","chr20","8785521","8785821","11","236201"
"chr5","8550444","8550687","chr20","8786636","8786879","4","236192"
"chr5","8552741","8553060","chr9","49141883","49142184","72","40589142"
"chr5","8556173","8556301","chrX","61671031","61671155","27","53114858"
"chr5","8557084","8557379","chr20","8795060","8795360","9","237976"
"chr5","8559140","8559310","chr20","8797458","8797614","18","238318"
"chr5","8562508","8562818","chr20","8800846","8801156","13","238338"
"chr5","8563392","8563546","chr9","84374724","84374880","33","75811332"
"chr5","8565487","8565569","chr20","66804889","66804973","9","58239402"
"chr5","8565867","8566095","chr20","8804401","8804641","23","238534"
"chr5","8566282","8566542","chr2","113243890","113244140","66","104677608"
"chr5","8572743","8572826","chr1","44783610","44783690","22","36210867"
"chr5","8573679","8573817","chr6","132308916","132309054","26","123735237"
"chr5","8575915","8576094","chr20","2214409","2214584","51","6361506"
"chr5","8596375","8596676","chr20","8857113","8857418","16","260738"
"chr5","8597826","8598110","chr20","8858553","8858843","18","260727"
"chr5","8606202","8606505","chr20","8868499","8868781","29","262297"
"chr5","8609391","8609550","chr20","8873037","8873219","26","263646"
"chr5","8611133","8611251","chr20","8874765","8874883","3","263632"
"chr5","8611289","8611442","chr20","8874921","8875074","4","263632"
"chr5","8630359","8630666","chr20","8895386","8895693","9","265027"
"chr5","8636273","8636541","chr20","8908796","8909063","15","272523"
"chr5","8648593","8648893","chr20","8921368","8921669","13","272775"
"chr5","8649370","8649653","chr20","8922146","8922429","15","272776"
"chr5","8659942","8660238","chr11","8053974","8054276","58","605968"
"chr5","8669848","8669978","chr20","8942915","8943045","2","273067"
"chr5","8683832","8683911","chr11","51804837","51804914","14","43121005"
"chr5","8692326","8692618","chr3","39123558","39123843","56","30431232"
"chr5","8692630","8692926","chr3","10288042","10288326","66","1595412"
"chr5","8695560","8695746","chr20","8969404","8969579","16","273844"
"chr5","8696044","8696107","chr20","8969882","8969945","3","273838"
"chr5","8696388","8696478","chr20","8970212","8970292","11","273824"
"chr5","8703143","8703421","chr20","8976936","8977214","4","273793"
"chr5","8711831","8712081","chr20","8988986","8989254","45","277155"
"chr5","8718503","8718786","chr20","8993626","8993910","13","275123"
"chr5","8732664","8732911","chr6","34230406","34230659","65","25497742"
"chr5","8733041","8733369","chr20","9009298","9009623","20","276257"
"chr5","8736549","8736860","chr20","9013127","9013436","11","276578"
"chr5","8756248","8756579","chrX","118224558","118224863","74","109468310"
"chr5","8757336","8757640","chr20","9034951","9035259","16","277615"
"chr5","8770197","8770548","chr20","9042206","9042554","12","272009"
"chr5","8776363","8776654","chr20","9054867","9055163","19","278504"
"chr5","8787726","8787992","chr20","9066762","9067027","11","279036"
"chr5","8800861","8801172","chr20","9079908","9080222","13","279047"
"chr5","8804083","8804173","chr6","170788759","170788849","17","161984676"
"chr5","8838881","8839182","chr20","9117840","9118143","13","278959"
"chr5","8888490","8888751","chr20","9167564","9167838","18","279074"
"chr5","8907830","8907985","chr6","132998703","132998868","39","124090873"
"chr5","8917910","8918089","chr20","9206502","9206685","8","288592"
"chr5","8926772","8927077","chr20","9202041","9202343","8","275269"
"chr5","8932724","8933028","chr20","9222293","9222597","12","289569"
"chr5","8962017","8962237","chr18","16392466","16392684","38","7430449"
"chr5","8970535","8970650","chr16","25294402","25294519","20","16323867"
"chr5","8970680","8970826","chr1","114051398","114051543","30","105080718"
"chr5","8999553","8999839","chr1","161416733","161417012","55","152417180"
"chr5","9004695","9005059","chr20","9294325","9294687","19","289630"
"chr5","9022969","9023262","chr20","9312584","9312881","16","289615"
"chr5","9072460","9072765","chr20","9362572","9362878","11","290112"
"chr5","9098256","9098535","chr20","9388130","9388410","7","289874"
"chr5","9102816","9103124","chr20","9392997","9393294","19","290181"
"chr5","9108345","9108629","chr20","9398506","9398794","11","290161"
"chr5","9122273","9122360","chr2","76595940","76596024","14","67473667"
"chr5","9130843","9131075","chr20","9420850","9421074","15","290007"
"chr5","9139351","9139636","chr20","9429375","9429661","10","290024"
"chr5","9148156","9148467","chr20","9438216","9438527","10","290060"
"chr5","9155488","9155784","chr20","9445131","9445426","15","289643"
"chr5","9194660","9194800","chr20","9484183","9484323","4","289523"
"chr5","9262347","9262630","chr15","10312358","10312633","55","1050011"
"chr5","9298748","9299046","chr2","164269237","164269534","50","154970489"
"chr5","9307648","9307939","chr20","9596201","9596492","6","288553"
"chr5","9367949","9368100","chr19","3073349","3073500","33","6294600"
"chr5","9396448","9396740","chr1","28104773","28105052","67","18708325"
"chr5","9398509","9398743","chr20","9687371","9687605","7","288862"
"chr5","9398751","9398849","chr20","9687609","9687711","9","288858"
"chr5","9430769","9431046","chr20","9719725","9720003","11","288956"
"chr5","9485070","9485374","chr3","151882322","151882618","61","142397252"
"chr5","9607120","9607399","chr3","125870477","125870760","54","116263357"
"chr5","9610931","9611239","chr4","152226280","152226592","57","142615349"
"chr5","9614548","9614658","chr13","62005594","62005716","28","52391046"
"chr5","9614787","9614939","chr19","42267502","42267658","39","32652715"
"chr5","9658687","9658995","chr13","41851851","41852159","70","32193164"
"chr5","9668511","9668820","chr7","106842256","106842567","53","97173745"
"chr5","9672265","9672573","chrX","13102883","13103175","66","3430618"
"chr5","9683065","9683366","chr19","28718617","28718918","49","19035552"
"chr5","9710257","9710367","chr14","1336389","1336496","16","8373868"
"chr5","9722695","9722996","chr3","83386578","83386861","66","73663883"
"chr5","9724059","9724215","chr3","174269011","174269175","31","164544952"
"chr5","9765033","9765314","chr1","124051404","124051694","69","114286371"
"chr5","9768362","9768603","chr5","145437734","145437976","47","135669372"
"chr5","9772150","9772234","chr8","96027204","96027287","22","86255054"
"chr5","9773475","9773603","chr3","43398932","43399067","26","33625457"
"chr5","9787988","9788290","chr19","35150394","35150696","56","25362406"
"chr5","9790764","9791063","chr2","78493440","78493742","47","68702676"
"chr5","9792152","9792422","chr16","21317898","21318176","59","11525746"
"chr5","9797942","9798008","chr1","6641003","6641065","11","3156939"
"chr5","9798412","9798481","chr20","14309840","14309907","12","4511428"
"chr5","9811127","9811408","chr10","53952009","53952289","49","44140882"
"chr5","9814018","9814337","chr14","109535565","109535877","65","99721547"
"chr5","9820626","9820803","chr7","17693612","17693794","48","7872986"
"chr5","9824630","9824879","chr15","74717077","74717322","49","64892447"
"chr5","9826421","9826719","chr4","151799738","151800017","72","141973317"
"chr5","9828984","9829268","chr11","3138562","3138847","53","6690422"
"chr5","9844059","9844349","chrX","43954303","43954603","57","34110244"
"chr5","9845407","9845562","chr10","27501941","27502094","31","17656534"
"chr5","9849798","9849967","chrX","44239463","44239639","42","34389665"
"chr5","9863086","9863394","chrX","123017391","123017696","51","113154305"
"chr5","9865777","9866081","chr20","9727422","9727726","9","138355"
"chr5","9867653","9867909","chr20","9729292","9729548","4","138361"
"chr5","9892208","9892570","chr20","54335350","54335662","111","44443142"
"chr5","9893196","9893476","chr20","9753981","9754261","2","139215"
"chr5","9897305","9897603","chr20","9758886","9759188","7","138419"
"chr5","9900965","9901254","chr15","13747044","13747334","52","3846079"
"chr5","9921978","9922249","chr20","9783642","9783923","16","138336"
"chr5","9932857","9933119","chr20","9793520","9793782","18","139337"
"chr5","9949569","9949860","chr20","9807395","9807689","15","142174"
"chr5","9982640","9982915","chr20","9840408","9840684","8","142232"
"chr5","10007075","10007378","chr20","9873348","9873645","19","133727"
"chr5","10016631","10016881","chr20","9883334","9883584","12","133297"
"chr5","10017424","10017490","chr13","60540775","60540837","13","50523351"
"chr5","10017841","10018051","chr20","9884543","9884760","13","133298"
"chr5","10022101","10022362","chr20","9888667","9888928","10","133434"
"chr5","10023428","10023693","chr20","9889995","9890260","15","133433"
"chr5","10025113","10025420","chr20","9891677","9891982","20","133436"
"chr5","10025879","10026163","chr17","27854216","27854497","53","17828337"
"chr5","10029677","10029986","chr20","9899152","9899462","6","130525"
"chr5","10080421","10080718","chr20","9953212","9953521","22","127209"
"chr5","10090038","10090339","chr20","9963198","9963499","5","126840"
"chr5","10094394","10094690","chr20","9967664","9967947","26","126730"
"chr5","10108968","10109265","chr20","9982552","9982849","16","126416"
"chr5","10120364","10120663","chr20","9994960","9995254","20","125404"
"chr5","10124358","10124654","chr20","9998925","9999223","18","125433"
"chr5","10126324","10126493","chr20","10000891","10001064","14","125433"
"chr5","10128455","10128771","chr9","22454562","22454871","60","12326107"
"chr5","10132678","10132969","chr3","52241377","52241669","53","42108699"
"chr5","10134862","10135144","chr10","27004201","27004490","65","16869339"
"chr5","10151606","10151741","chr20","10025046","10025182","6","126560"
"chr5","10155584","10155860","chr20","10029122","10029394","7","126462"
"chr5","10205690","10205987","chr20","10070565","10070863","21","135125"
"chr5","10212029","10212111","chr20","10076891","10076981","9","135138"
"chr5","10228006","10228304","chr20","10089771","10090069","9","138235"
"chr5","10229967","10230118","chr20","10091730","10091876","13","138237"
"chr5","10238087","10238390","chr20","10099857","10100161","9","138230"
"chr5","10240342","10240626","chr14","7153919","7154206","61","3086423"
"chr5","10244357","10244544","chr8","78777591","78777773","38","68533234"
"chr5","10250231","10250558","chr20","10112162","10112481","22","138069"
"chr5","10251915","10252176","chr20","10113847","10114108","9","138068"
"chr5","10257095","10257180","chr19","3643688","3643758","26","6613407"
"chr5","10262916","10263228","chr20","10123403","10123711","12","139513"
"chr5","10264779","10264987","chr1","40122427","40122609","53","29857648"
"chr5","10274527","10274812","chr20","10137029","10137319","12","137498"
"chr5","10278832","10279116","chr20","10141016","10141300","5","137816"
"chr5","10288395","10288698","chr20","10150898","10151192","21","137497"
"chr5","10289383","10289673","chr20","10151872","10152163","12","137511"
"chr5","10301510","10301800","chr20","10165053","10165343","6","136457"
"chr5","10310346","10310458","chr6","70388086","70388194","19","60077740"
"chr5","10319655","10319948","chr20","10184355","10184648","4","135300"
"chr5","10323890","10324164","chr20","10188545","10188820","11","135345"
"chr5","10325920","10326125","chr20","10190626","10190830","15","135294"
"chr5","10331211","10331511","chr20","10195864","10196165","11","135347"
"chr5","10340228","10340531","chr20","10204878","10205186","14","135350"
"chr5","10343554","10343855","chr20","10208218","10208518","12","135336"
"chr5","10367396","10367621","chr20","10233065","10233304","19","134331"
"chr5","10382932","10383236","chr20","10248874","10249178","13","134058"
"chr5","10388461","10388490","chr4","28411478","28411506","7","18023017"
"chr5","10388567","10388852","chr20","10254510","10254822","37","134057"
"chr5","10396631","10396727","chr19","12123499","12123598","24","1726868"
"chr5","10438641","10438931","chr20","10305686","10305976","13","132955"
"chr5","10452613","10452923","chr20","10319611","10319920","14","133002"
"chr5","10464962","10465264","chr20","10331683","10331991","20","133279"
"chr5","10473342","10473646","chr20","10339702","10340006","3","133640"
"chr5","10477496","10477787","chr6","125948838","125949124","54","115471342"
"chr5","10478066","10478219","chr20","10344417","10344556","21","133649"
"chr5","10486207","10486501","chr20","10352868","10353162","15","133339"
"chr5","10495167","10495424","chr20","10361527","10361783","10","133640"
"chr5","10498762","10499048","chr20","10365013","10365299","7","133749"
"chr5","10539495","10539806","chr20","10405465","10405775","12","134030"
"chr5","10544151","10544279","chrX","131969934","131970064","27","121425783"
"chr5","10549968","10550037","chr4","21192049","21192120","12","10642081"
"chr5","10552247","10552414","chr20","10418412","10418582","9","133835"
"chr5","10561157","10561331","chr20","10428154","10428328","2","133003"
"chr5","10567657","10567952","chr20","55616261","55616560","58","45048604"
"chr5","10579622","10579940","chr20","10446390","10446707","5","133232"
"chr5","10588883","10589171","chr20","10455654","10455943","10","133229"
"chr5","10590835","10591134","chr20","10457616","10457907","22","133219"
"chr5","10600594","10600885","chr20","10467349","10467640","12","133245"
"chr5","10603392","10603700","chr20","10470152","10470455","13","133240"
"chr5","10631082","10631275","chr20","10497748","10497941","3","133334"
"chr5","10641290","10641590","chr20","10508039","10508338","16","133251"
"chr5","10659916","10660083","chr20","10526597","10526762","6","133319"
"chr5","10693775","10694094","chr20","10560683","10561000","16","133092"
"chr5","10701928","10702011","chr20","10568870","10568953","1","133058"
"chr5","10702642","10702934","chr20","10569574","10569887","28","133068"
"chr5","10718530","10718835","chr1","13689301","13689610","58","2970771"
"chr5","10719245","10719514","chr20","10587286","10587558","7","131959"
"chr5","10724104","10724404","chr11","108257243","108257525","66","97533139"
"chr5","10738838","10739092","chr20","10607305","10607549","22","131533"
"chr5","10743939","10744092","chr20","10612416","10612552","17","131523"
"chr5","10753850","10754175","chr20","10622419","10622726","31","131431"
"chr5","10755422","10755721","chr20","10623982","10624294","25","131440"
"chr5","10763596","10763872","chr20","10633419","10633691","6","130177"
"chr5","10764084","10764261","chr7","46908281","46908458","44","36144197"
"chr5","10767432","10767742","chr20","10636745","10637063","22","130687"
"chr5","10773587","10773870","chr20","10642627","10642910","11","130960"
"chr5","10784806","10785079","chr11","121352926","121353191","64","110568120"
"chr5","10791188","10791500","chr13","92870661","92870964","67","82079473"
"chr5","10796044","10796344","chr20","10664561","10664860","15","131483"
"chr5","10800405","10800701","chr20","10668451","10668746","8","131954"
"chr5","10801457","10801707","chr20","10669511","10669750","17","131946"
"chr5","10808220","10808526","chr20","10676950","10677256","3","131270"
"chr5","10817250","10817567","chr2","101508511","101508813","65","90691261"
"chr5","10825312","10825595","chr20","10695259","10695544","10","130053"
"chr5","10833336","10833494","chr1","4696099","4696256","34","6137237"
"chr5","10886991","10887295","chrX","96318063","96318367","67","85431072"
"chr5","10890539","10890731","chr20","10759366","10759562","11","131173"
"chr5","10891029","10891154","chr20","10760167","10760292","6","130862"
"chr5","10895722","10895901","chr15","43698564","43698741","33","32802842"
"chr5","10912658","10912963","chr20","10782829","10783133","14","129829"
"chr5","10931162","10931261","chr20","10801542","10801641","6","129620"
"chr5","10934744","10934987","chr20","10805436","10805681","14","129308"
"chr5","10948891","10949195","chr20","10819895","10820207","15","128996"
"chr5","10958658","10958960","chr9","123818237","123818533","68","112859579"
"chr5","10961554","10961700","chr17","32000688","32000836","27","21039134"
"chr5","10973251","10973551","chr20","10844739","10845028","19","128512"
"chr5","10977464","10977756","chr20","10848991","10849283","11","128473"
"chr5","10984823","10985114","chr20","10853699","10853987","11","131124"
"chr5","10985233","10985455","chr6","151329651","151329875","51","140344418"
"chr5","10987287","10987598","chr20","10859607","10859912","21","127680"
"chr5","10999710","11000000","chr20","10871835","10872146","30","127875"
"chr5","11000996","11001098","chr20","10873126","10873230","5","127870"
"chr5","11001416","11001517","chr20","10873553","10873651","8","127863"
"chr5","11002605","11002882","chr20","10874735","10875007","36","127870"
"chr5","11015931","11016246","chr20","10886749","10887063","10","129182"
"chr5","11030551","11030863","chr20","10901211","10901520","15","129340"
"chr5","11033228","11033532","chr20","10903608","10903902","22","129620"
"chr5","11034242","11034541","chr20","10904600","10904899","14","129642"
"chr5","11034784","11035088","chr20","10905142","10905446","7","129642"
"chr5","11041368","11041666","chr20","10924429","10924727","8","116939"
"chr5","11041985","11042257","chr20","10925045","10925319","24","116940"
"chr5","11046208","11046490","chr20","10914539","10914838","26","131669"
"chr5","11067239","11067536","chrX","27894759","27895057","61","16827520"
"chr5","11070273","11070567","chr6","125546900","125547188","58","114476627"
"chr5","11074123","11074250","chr18","68543916","68544034","25","57469793"
"chr5","11074625","11074935","chr20","10948836","10949141","20","125789"
"chr5","11079483","11079628","chr3","75948694","75948847","37","64869211"
"chr5","11079629","11079681","chr11","107124621","107124670","11","96044992"
"chr5","11086490","11086779","chr20","10961411","10961702","10","125079"
"chr5","11094621","11094928","chr20","10969841","10970151","14","124780"
"chr5","11096007","11096220","chr6","120289738","120289971","58","109193731"
"chr5","11096848","11097010","chr20","10971979","10972142","6","124869"
"chr5","11101699","11101998","chr13","92870661","92870964","61","81768962"
"chr5","11109228","11109447","chr20","10986408","10986628","7","122820"
"chr5","11112563","11112874","chr20","10989787","10990094","20","122776"
"chr5","11117295","11117358","chr20","10999316","10999379","1","117979"
"chr5","11125016","11125305","chr20","11007316","11007605","9","117700"
"chr5","11129109","11129275","chr20","11011414","11011581","7","117695"
"chr5","11130316","11130586","chrX","68221111","68221374","56","57090795"
"chr5","11149604","11149889","chr9","26171818","26172114","58","15022214"
"chr5","11174273","11174517","chr20","11058263","11058522","18","116010"
"chr5","11176393","11176525","chr20","11060384","11060516","2","116009"
"chr5","11176819","11177003","chr20","11060802","11060985","7","116017"
"chr5","11177874","11178151","chr20","11061736","11062013","12","116138"
"chr5","11218059","11218370","chr20","11104145","11104450","11","113914"
"chr5","11232834","11233161","chr20","11120207","11120534","7","112627"
"chr5","11240407","11240708","chr20","11126317","11126614","11","114090"
"chr5","11246977","11247102","chr20","11134892","11135017","3","112085"
"chr5","11247718","11247903","chr20","11135633","11135818","2","112085"
"chr5","11262935","11263247","chr20","11151071","11151382","12","111864"
"chr5","11268655","11268911","chr20","11157093","11157349","14","111562"
"chr5","11270476","11270607","chr20","11167218","11167363","14","103258"
"chr5","11270899","11271033","chr20","11167655","11167789","5","103244"
"chr5","11280702","11280823","chr20","11165420","11165562","27","115282"
"chr5","11281143","11281275","chr11","30643500","30643625","31","19362357"
"chr5","11282067","11282219","chr3","118178454","118178590","52","106896387"
"chr5","11282220","11282289","chr1","30644596","30644660","17","19362376"
"chr5","11284775","11285080","chr20","11176856","11177156","10","107919"
"chr5","11285629","11285889","chr20","11177706","11177981","25","107923"
"chr5","11293933","11294166","chr20","11183599","11183832","5","110334"
"chr5","11294737","11294766","chr20","11184405","11184434","1","110332"
"chr5","11295351","11295597","chr20","11185013","11185256","15","110338"
"chr5","11300506","11300721","chr20","11190858","11191043","34","109648"
"chr5","11300761","11300870","chr3","69203217","69203340","40","57902456"
"chr5","11301181","11301366","chr7","38599193","38599366","47","27298012"
"chr5","11310013","11310228","chr20","11190858","11191043","34","119155"
"chr5","11316320","11316631","chr20","11196929","11197252","24","119391"
"chr5","11323508","11323816","chr20","11204144","11204452","8","119364"
"chr5","11328347","11328615","chr20","11208670","11208937","10","119677"
"chr5","11352344","11352657","chr20","11232840","11233152","12","119504"
"chr5","11360024","11360320","chr20","11240552","11240849","3","119472"
"chr5","11367459","11367732","chr20","11247553","11247822","23","119906"
"chr5","11368127","11368342","chr20","11248217","11248432","2","119910"
"chr5","11369762","11369934","chr4","119074513","119074677","37","107704751"
"chr5","11371023","11371303","chr20","11251460","11251748","18","119563"
"chr5","11385773","11386058","chr20","11267047","11267329","18","118726"
"chr5","11419263","11419551","chr20","11311452","11311688","60","107811"
"chr5","11423090","11423309","chr4","152814446","152814659","47","141391356"
"chr5","11432809","11433131","chr20","11326226","11326543","11","106583"
"chr5","11434280","11434544","chr20","11327963","11328260","41","106317"
"chr5","11435237","11435384","chr20","11328921","11329062","14","106316"
"chr5","11440335","11440491","chr20","11334333","11334491","4","106002"
"chr5","11441848","11442159","chr9","96267544","96267859","55","84825696"
"chr5","11455217","11455334","chr20","11349738","11349855","1","105479"
"chr5","11455372","11455550","chr20","11349887","11350073","10","105485"
"chr5","11459686","11459864","chr20","11354001","11354179","3","105685"
"chr5","11460157","11460293","chr20","11354470","11354606","3","105687"
"chr5","11478135","11478427","chr20","11373791","11374095","18","104344"
"chr5","11481814","11482119","chr20","11377747","11378047","7","104067"
"chr5","11484638","11484835","chr20","11383755","11383986","36","100883"
"chr5","11491150","11491463","chr9","95600829","95601141","62","84109679"
"chr5","11494806","11494996","chr19","44394983","44395172","44","32900177"
"chr5","11508969","11509144","chr20","25745834","25746011","34","14236865"
"chr5","11516764","11517064","chr20","11408887","11409187","12","107877"
"chr5","11532346","11532625","chr20","11424436","11424722","11","107910"
"chr5","11539290","11539604","chr20","11431388","11431700","10","107902"
"chr5","11545570","11545699","chr7","15394911","15395040","18","3849341"
"chr5","11590768","11591050","chr7","137341651","137341933","58","125750883"
"chr5","11596310","11596620","chr20","11488450","11488750","25","107860"
"chr5","11602732","11603045","chrX","7054108","7054419","67","4548624"
"chr5","11615093","11615343","chr20","11507204","11507455","8","107889"
"chr5","11621114","11621209","chr20","11513287","11513381","4","107827"
"chr5","11658291","11658565","chr20","11550269","11550545","6","108022"
"chr5","11672028","11672391","chr20","11562790","11563143","18","109238"
"chr5","11680597","11680888","chr8","10112421","10112720","56","1568176"
"chr5","11705866","11706172","chr20","11596190","11596501","14","109676"
"chr5","11727951","11728265","chr20","11619606","11619916","27","108345"
"chr5","11736988","11737199","chr20","11628660","11628856","22","108328"
"chr5","11796733","11797034","chr20","11688697","11688998","12","108036"
"chr5","11797408","11797709","chr20","11689372","11689673","10","108036"
"chr5","11852556","11852853","chr20","11742870","11743146","36","109686"
"chr5","11960677","11960987","chr20","11842880","11843197","22","117797"
"chr5","11962146","11962265","chr3","72600923","72601041","32","60638777"
"chr5","11962263","11962355","chr20","11844482","11844574","3","117781"
"chr5","11962358","11962506","chr4","148396918","148397075","34","136434560"
"chr5","11973212","11973321","chr2","160576044","160576152","19","148602832"
"chr5","12018215","12018496","chr4","35139132","35139421","59","23120917"
"chr5","12047081","12047384","chr20","11924609","11924916","48","122472"
"chr5","12057692","12057996","chr13","127123568","127123870","57","115065876"
"chr5","12064269","12064559","chr20","11941236","11941535","18","123033"
"chr5","12072342","12072576","chr2","91470121","91470359","73","79397779"
"chr5","12077333","12077621","chr20","11954219","11954509","32","123114"
"chr5","12081248","12081524","chr9","90215905","90216184","83","78134657"
"chr5","12082078","12082305","chr20","11958734","11958971","33","123344"
"chr5","12086059","12086352","chr4","35119120","35119410","65","23033061"
"chr5","12092954","12093266","chr7","107098860","107099173","59","95005906"
"chr5","12107188","12107480","chr20","11986965","11987257","10","120223"
"chr5","12136657","12136810","chr20","12017014","12017184","25","119643"
"chr5","12141714","12142019","chr20","12022008","12022314","20","119706"
"chr5","12153923","12153972","chr5","75142717","75142755","19","62988794"
"chr5","12154383","12154428","chr1","161919454","161919500","6","149765071"
"chr5","12169521","12169829","chr20","12049233","12049498","51","120288"
"chr5","12174074","12174373","chr20","12053800","12054099","15","120274"
"chr5","12175536","12175620","chr14","67403380","67403464","23","55227844"
"chr5","12189380","12189691","chr20","12068813","12069125","12","120567"
"chr5","12190058","12190358","chr20","12069492","12069792","9","120566"
"chr5","12192496","12192802","chr20","12071919","12072232","20","120577"
"chr5","12200874","12201186","chr4","151028880","151029183","56","138828006"
"chr5","12209616","12209750","chr20","12089068","12089202","6","120548"
"chr5","12219819","12220115","chr20","12099751","12100048","17","120068"
"chr5","12230216","12230380","chr20","12110124","12110279","14","120092"
"chr5","12234515","12234804","chr20","12114402","12114691","6","120113"
"chr5","12242285","12242578","chr20","12122146","12122439","13","120139"
"chr5","12259174","12259274","chr20","12139641","12139741","2","119533"
"chr5","12264806","12265103","chr20","12145142","12145455","35","119664"
"chr5","12266358","12266544","chr20","12146697","12146857","29","119661"
"chr5","12277442","12277736","chr20","12158537","12158840","13","118905"
"chr5","12283815","12284122","chr20","12164931","12165238","5","118884"
"chr5","12290063","12290443","chr20","12171220","12171537","71","118843"
"chr5","12293524","12293813","chr20","12174600","12174883","13","118924"
"chr5","12301834","12302097","chr20","12183193","12183473","24","118641"
"chr5","12311599","12311881","chr20","12193436","12193718","8","118163"
"chr5","12322107","12322416","chr20","12204019","12204329","14","118088"
"chr5","12334317","12334629","chr20","12216718","12217031","13","117599"
"chr5","12382307","12382614","chr20","12265586","12265894","8","116721"
"chr5","12446947","12447166","chr20","12331600","12331816","8","115347"
"chr5","12477624","12477916","chr20","12362235","12362553","38","115389"
"chr5","12515810","12515901","chr20","12401031","12401122","3","114779"
"chr5","12684969","12685259","chr1","130506906","130507192","63","117821937"
"chr5","12693308","12693607","chr20","12577115","12577414","11","116193"
"chr5","12698255","12698546","chr20","12582028","12582319","11","116227"
"chr5","12747713","12748008","chr20","12631446","12631741","10","116267"
"chr5","12817142","12817430","chr1","1125005","1125288","57","11692137"
"chr5","12824388","12824590","chr8","69577131","69577335","46","56752743"
"chr5","12879282","12879571","chr20","12764462","12764751","5","114820"
"chr5","12918700","12919011","chr20","12804873","12805171","20","113827"
"chr5","12981916","12982194","chr10","20003309","20003597","51","7021393"
"chr5","12986615","12986716","chr2","84057779","84057879","28","71071164"
"chr5","13024989","13025276","chr20","12912846","12913146","37","112143"
"chr5","13070525","13070796","chr20","12960679","12960951","9","109846"
"chr5","13094030","13094342","chr20","12984732","12985039","21","109298"
"chr5","13098034","13098330","chr20","12988814","12989112","11","109220"
"chr5","13176753","13177057","chr20","13077138","13077442","7","99615"
"chr5","13185808","13186118","chr20","13086177","13086487","15","99631"
"chr5","13192944","13193239","chr1","67334142","67334435","62","54141198"
"chr5","13220937","13221206","chr20","13121152","13121444","31","99785"
"chr5","13273218","13273519","chr20","13168600","13168901","9","104618"
"chr5","13336098","13336376","chr4","163605188","163605455","62","150269090"
"chr5","13341048","13341311","chr1","28499187","28499455","81","15158139"
"chr5","13370346","13370651","chr20","13264725","13265012","27","105621"
"chr5","13377718","13377785","chr20","14309840","14309907","9","932122"
"chr5","13394809","13395125","chr20","13288899","13289219","19","105910"
"chr5","13399928","13400042","chr20","13293930","13294044","4","105998"
"chr5","13444366","13444563","chr20","13338616","13338816","6","105750"
"chr5","13446722","13447036","chr20","13341038","13341367","30","105684"
"chr5","13457090","13457169","chr11","9981435","9981516","13","3475655"
"chr5","13485714","13485918","chr18","3826442","3826644","39","9659272"
"chr5","13493805","13493936","chr4","65813127","65813256","23","52319322"
"chr5","13506802","13506952","chr20","13400200","13400348","2","106602"
"chr5","13511340","13511455","chr14","11344995","11345109","27","2166345"
"chr5","13541546","13541805","chr20","13434727","13434978","13","106819"
"chr5","13544175","13544486","chr20","13437406","13437702","19","106769"
"chr5","13579149","13579444","chr20","13472794","13473097","15","106355"
"chr5","13622341","13622640","chr20","13515348","13515653","10","106993"
"chr5","13638883","13639160","chr20","13531827","13532116","23","107056"
"chr5","13682308","13682413","chr10","46313222","46313327","20","32630914"
"chr5","13682740","13683027","chr20","13574900","13575187","7","107840"
"chr5","13714438","13714746","chr20","13607483","13607789","6","106955"
"chr5","13737028","13737332","chr20","13629835","13630138","12","107193"
"chr5","13754193","13754498","chr20","13646571","13646876","6","107622"
"chr5","13757448","13757557","chr5","140149637","140149748","32","126392189"
"chr5","13772090","13772395","chr20","13664031","13664316","31","108059"
"chr5","13783297","13783596","chr7","63259439","63259745","55","49476142"
"chr5","13783686","13783965","chr1","159614491","159614771","46","145830805"
"chr5","13789755","13790057","chr20","13682230","13682532","11","107525"
"chr5","13809752","13810055","chr7","45269231","45269537","59","31459479"
"chr5","13831110","13831425","chr20","13723813","13724127","10","107297"
"chr5","13839447","13839752","chr8","68808553","68808854","59","54969106"
"chr5","13841009","13841324","chr20","13734963","13735269","15","106046"
"chr5","13846875","13847175","chr20","13739695","13739991","13","107180"
"chr5","13859748","13860041","chr20","13755871","13756163","9","103877"
"chr5","13865441","13865724","chr20","13761988","13762271","4","103453"
"chr5","13878791","13879093","chr20","13775356","13775657","7","103435"
"chr5","13886272","13886557","chr20","13782978","13783280","21","103294"
"chr5","13889823","13890085","chr20","13786548","13786824","30","103275"
"chr5","13890353","13890634","chr20","13787085","13787366","2","103268"
"chr5","13912334","13912642","chr20","13809222","13809529","7","103112"
"chr5","13920931","13921233","chr20","13818233","13818539","18","102698"
"chr5","13921892","13921967","chr20","13819206","13819282","1","102686"
"chr5","13922212","13922505","chr20","13819476","13819795","46","102736"
"chr5","13927897","13928188","chr20","13824901","13825190","9","102996"
"chr5","13939989","13940294","chr20","13836799","13837089","26","103190"
"chr5","13944600","13944897","chr20","13841096","13841392","14","103504"
"chr5","13948307","13948608","chr20","13844798","13845121","26","103509"
"chr5","13949908","13950206","chr20","13846401","13846736","42","103507"
"chr5","13951641","13951942","chr20","13848115","13848416","8","103526"
"chr5","13958516","13958819","chr20","13854974","13855277","8","103542"
"chr5","13981494","13981584","chr20","13877989","13878087","11","103505"
"chr5","13983639","13983931","chr20","13880137","13880424","12","103502"
"chr5","13996002","13996301","chr20","13892580","13892878","6","103422"
"chr5","14002770","14003091","chr20","13899258","13899579","6","103512"
"chr5","14006964","14007266","chr20","13903468","13903770","2","103496"
"chr5","14025009","14025317","chr10","19396155","19396461","53","5371146"
"chr5","14033174","14033480","chr20","13929598","13929901","24","103576"
"chr5","14039965","14040177","chr20","13936686","13936899","10","103279"
"chr5","14041664","14041778","chr1","71722228","71722339","20","57680564"
"chr5","14049298","14049593","chr20","13945087","13945374","15","104211"
"chr5","14052586","14052888","chr20","13948985","13949284","14","103601"
"chr5","14059830","14060122","chr20","13956819","13957111","9","103011"
"chr5","14062347","14062654","chr20","13959643","13959947","17","102704"
"chr5","14066245","14066550","chr11","120115862","120116155","56","106049617"
"chr5","14069500","14069756","chr20","13967116","13967413","50","102384"
"chr5","14072959","14073248","chr20","13970296","13970582","19","102663"
"chr5","14077622","14077816","chr10","88408679","88408875","54","74331057"
"chr5","14077904","14077999","chr15","55907244","55907342","16","41829340"
"chr5","14077993","14078107","chr8","90064854","90064963","25","75986861"
"chr5","14084818","14085049","chr1","14179494","14179714","47","94676"
"chr5","14095592","14095692","chr20","13997740","13997840","4","97852"
"chr5","14096295","14096592","chr20","13998762","13999059","5","97533"
"chr5","14098437","14098713","chr20","14001574","14001851","10","96863"
"chr5","14105635","14105807","chr20","14008243","14008415","5","97392"
"chr5","14120299","14120583","chr20","14027033","14027327","25","93266"
"chr5","14133793","14134069","chr20","14034247","14034525","15","99546"
"chr5","14149099","14149393","chr20","14050904","14051202","14","98195"
"chr5","14227016","14227309","chr20","14132061","14132345","20","94955"
"chr5","14233554","14233700","chr7","8262779","8262919","26","5970775"
"chr5","14234083","14234283","chr20","14140471","14140671","10","93612"
"chr5","14256351","14256654","chr20","14163854","14164153","12","92497"
"chr5","14258642","14258929","chr6","135910504","135910796","70","121651862"
"chr5","14273795","14274068","chr20","14180974","14181262","40","92821"
"chr5","14281311","14281630","chr20","14189144","14189446","25","92167"
"chr5","14282761","14283053","chr20","14190579","14190873","8","92182"
"chr5","14284738","14285001","chr20","14192569","14192834","16","92169"
"chr5","14288163","14288304","chr20","14196291","14196432","1","91872"
"chr5","14288519","14288566","chr20","14196650","14196697","2","91869"
"chr5","14301331","14301539","chr20","14209405","14209622","21","91926"
"chr5","14310642","14310942","chr20","14218592","14218892","8","92050"
"chr5","14334738","14335022","chr14","18211787","18212071","54","3877049"
"chr5","14336914","14337224","chr20","14246471","14246786","16","90443"
"chr5","14337227","14337431","chr20","14246790","14246995","3","90437"
"chr5","14342106","14342389","chr20","14251977","14252264","15","90129"
"chr5","14347448","14347737","chrX","122336794","122337087","63","107989346"
"chr5","14356637","14356859","chr2","11818821","11819051","64","2537816"
"chr5","14358429","14358733","chr20","14266966","14267248","31","91463"
"chr5","14359815","14360110","chr6","174063586","174063879","52","159703771"
"chr5","14362834","14363123","chr1","2720124","2720420","60","11642710"
"chr5","14364842","14365149","chr20","14274165","14274471","6","90677"
"chr5","14367066","14367107","chrX","21161758","21161797","8","6794692"
"chr5","14367224","14367478","chr2","81745556","81745809","47","67378332"
"chr5","14372565","14372871","chr20","14287696","14288003","16","84869"
"chr5","14385405","14385637","chr20","14308697","14308929","8","76708"
"chr5","14389915","14390203","chr1","25345280","25345597","68","10955365"
"chr5","14401169","14401473","chr20","14287696","14288003","18","113473"
"chr5","14402235","14402484","chr7","38796975","38797230","55","24394740"
"chr5","14404061","14404291","chr20","14323661","14323893","6","80400"
"chr5","14405006","14405310","chr16","41812244","41812543","53","27407238"
"chr5","14414930","14415219","chr20","14336277","14336563","15","78653"
"chr5","14422266","14422512","chr20","14341986","14342232","12","80280"
"chr5","14428905","14428970","chr20","14348631","14348696","3","80274"
"chr5","14429489","14429807","chr20","14349215","14349539","12","80274"
"chr5","14430363","14430646","chr20","14350097","14350378","9","80266"
"chr5","14431620","14431878","chr20","14351349","14351588","28","80271"
"chr5","14432676","14432793","chr19","15059253","15059370","19","626577"
"chr5","14441189","14441359","chr20","14360824","14360991","8","80365"
"chr5","14441636","14441774","chr20","14361269","14361413","11","80367"
"chr5","14443404","14443710","chr20","14363062","14363367","11","80342"
"chr5","14459622","14459935","chr20","14378229","14378535","30","81393"
"chr5","14460726","14460845","chr9","42559409","42559528","16","28098683"
"chr5","14469659","14469961","chr20","14388773","14389058","22","80886"
"chr5","14471883","14472206","chr20","14392001","14392293","38","79882"
"chr5","14480530","14480836","chr7","26122036","26122348","54","11641506"
"chr5","14489488","14489542","chr9","57093716","57093762","16","42604228"
"chr5","14489906","14490117","chr20","14408611","14408821","9","81295"
"chr5","14492522","14492839","chr20","14411733","14412056","12","80789"
"chr5","14523635","14523923","chr20","14444142","14444436","20","79493"
"chr5","14553002","14553270","chr20","14476004","14476271","16","76998"
"chr5","14556294","14556595","chr6","34271219","34271517","60","19714925"
"chr5","14558904","14559220","chr20","14481754","14482037","41","77150"
"chr5","14576222","14576339","chr20","14497841","14497958","4","78381"
"chr5","14601443","14601737","chr20","14522670","14522964","13","78773"
"chr5","14604713","14605009","chr20","14525981","14526277","5","78732"
"chr5","14613535","14613821","chr3","35689790","35690077","49","21076255"
"chr5","14664962","14665096","chr1","1658615","1658747","34","13006347"
"chr5","14673070","14673370","chr20","14596406","14596706","13","76664"
"chr5","14681868","14682138","chr20","14604667","14604934","6","77201"
"chr5","14682675","14682975","chr20","14605474","14605774","7","77201"
"chr5","14686178","14686466","chr20","14608962","14609242","16","77216"
"chr5","14687808","14687919","chr20","14610585","14610701","8","77223"
"chr5","14688208","14688402","chr20","14611012","14611199","13","77196"
"chr5","14693001","14693041","chr20","14615793","14615833","1","77208"
"chr5","14694213","14694425","chr20","14617003","14617217","6","77210"
"chr5","14696114","14696320","chr20","14618957","14619176","25","77157"
"chr5","14700248","14700547","chr20","14623147","14623442","22","77101"
"chr5","14703185","14703351","chr20","14626116","14626274","15","77069"
"chr5","14715006","14715298","chr20","14637795","14638087","14","77211"
"chr5","14716190","14716266","chr16","29169000","29169077","14","14452810"
"chr5","14716344","14716516","chr20","14639135","14639315","17","77209"
"chr5","14717175","14717456","chr20","14639976","14640260","20","77199"
"chr5","14718345","14718512","chr20","14641203","14641378","16","77142"
"chr5","14719376","14719584","chr20","14642247","14642456","10","77129"
"chr5","14753308","14753468","chr20","14676476","14676636","6","76832"
"chr5","14753775","14753913","chr20","14676946","14677094","19","76829"
"chr5","14764011","14764289","chr20","14687144","14687433","15","76867"
"chr5","14777678","14777833","chr7","53483520","53483679","27","38705842"
"chr5","14777842","14778033","chr20","14701099","14701287","14","76743"
"chr5","14790492","14790659","chr9","102217878","102218037","44","87427386"
"chr5","14790967","14791114","chr20","14714173","14714316","7","76794"
"chr5","14791115","14791354","chr20","14714317","14714556","10","76798"
"chr5","14803410","14803533","chr20","14726753","14726873","8","76657"
"chr5","14814759","14815049","chr20","14738132","14738427","16","76627"
"chr5","14827201","14827488","chr10","38352340","38352624","59","23525139"
"chr5","14831068","14831367","chr20","14754450","14754759","22","76618"
"chr5","14833535","14833820","chr20","14756904","14757190","8","76631"
"chr5","14841773","14842075","chr20","14762358","14762658","14","79415"
"chr5","14844978","14845275","chr15","40137625","40137920","58","25292647"
"chr5","14845639","14845939","chr20","14766087","14766396","24","79552"
"chr5","14861011","14861255","chr20","14781274","14781526","19","79737"
"chr5","14868857","14869102","chr20","14789366","14789594","20","79491"
"chr5","14869383","14869711","chr20","14789890","14790192","40","79493"
"chr5","14872760","14873060","chr20","14793278","14793578","9","79482"
"chr5","14882214","14882504","chr20","14802646","14802936","2","79568"
"chr5","14882533","14882742","chr20","14802970","14803179","4","79563"
"chr5","14885820","14886088","chr12","80823770","80824037","53","65937950"
"chr5","14891190","14891339","chr20","14811688","14811838","4","79502"
"chr5","14895802","14895919","chr20","14815794","14815910","6","80008"
"chr5","14899181","14899298","chr20","14819151","14819268","0","80030"
"chr5","14900141","14900451","chr20","14820115","14820426","14","80026"
"chr5","14901443","14901560","chr20","10996221","10996338","16","3905222"
"chr5","14905759","14906052","chr20","14825585","14825878","11","80174"
"chr5","14918506","14918816","chr20","14838767","14839047","38","79739"
"chr5","14919179","14919507","chr20","14839274","14839595","16","79905"
"chr5","14925080","14925374","chr20","14845704","14846000","14","79376"
"chr5","14927755","14927841","chr7","33765401","33765487","11","18837646"
"chr5","14933661","14933898","chr6","135792938","135793177","42","120859277"
"chr5","14936184","14936230","chr8","54730844","54730893","11","39794660"
"chr5","14936461","14936708","chr15","56016075","56016314","54","41079614"
"chr5","14945889","14946171","chr5","157729527","157729817","62","142783638"
"chr5","14949555","14949866","chr20","14863246","14863557","15","86309"
"chr5","14957340","14957615","chr20","14871399","14871675","14","85941"
"chr5","14959096","14959402","chr20","14872994","14873300","5","86102"
"chr5","14962896","14963011","chr10","70785006","70785125","22","55822110"
"chr5","14965512","14965752","chr20","14877087","14877325","9","88425"
"chr5","14974668","14974959","chr20","14886969","14887260","8","87699"
"chr5","14982988","14983261","chr20","14895345","14895618","9","87643"
"chr5","14990412","14990688","chr20","14902737","14903038","43","87675"
"chr5","14991953","14992117","chr20","14904588","14904753","8","87365"
"chr5","14996005","14996307","chr20","14908643","14908939","9","87362"
"chr5","14996908","14997210","chr19","26903026","26903324","59","11906118"
"chr5","15004821","15005128","chrX","28158227","28158530","51","13153406"
"chr5","15006096","15006378","chr20","14919351","14919636","11","86745"
"chr5","15008189","15008491","chr20","14921424","14921726","5","86765"
"chr5","15018548","15018849","chr20","14937308","14937610","16","81240"
"chr5","15019046","15019162","chr20","14937807","14937923","8","81239"
"chr5","15020945","15021237","chr20","14939394","14939684","10","81551"
"chr5","15033285","15033444","chr19","14673246","14673394","40","360039"
"chr5","15038096","15038268","chr20","39941336","39941509","31","24903240"
"chr5","15045616","15045913","chr20","14963643","14963940","12","81973"
"chr5","15048797","15049089","chr20","14966789","14967082","8","82008"
"chr5","15055349","15055653","chr20","14973547","14973848","15","81802"
"chr5","15056831","15057110","chr20","14974980","14975291","35","81851"
"chr5","15068108","15068299","chr13","102715671","102715855","40","87647563"
"chr5","15074256","15074545","chr20","14992360","14992647","19","81896"
"chr5","15076623","15076690","chr7","39038812","39038876","16","23962189"
"chr5","15082716","15083014","chr20","15000870","15001168","11","81846"
"chr5","15083401","15083565","chr18","55869658","55869818","40","40786257"
"chr5","15090235","15090368","chr20","15008541","15008669","10","81694"
"chr5","15090532","15090724","chr20","15008820","15008977","38","81712"
"chr5","15093512","15093809","chr20","15011812","15012123","23","81700"
"chr5","15111636","15111927","chr20","15028784","15029078","19","82852"
"chr5","15129406","15129718","chr20","15047390","15047688","20","82016"
"chr5","15134232","15134530","chr20","15052201","15052499","11","82031"
"chr5","15139791","15140076","chr20","15057830","15058115","6","81961"
"chr5","15148215","15148485","chr20","15066060","15066320","20","82155"
"chr5","15153577","15153865","chr20","15072098","15072386","12","81479"
"chr5","15156263","15156575","chr20","15074461","15074773","8","81802"
"chr5","15161874","15162032","chr1","28468412","28468583","36","13306538"
"chr5","15173425","15173701","chr20","15091822","15092102","16","81603"
"chr5","15173761","15174004","chr10","66914544","66914791","62","51740783"
"chr5","15180181","15180489","chr20","15101269","15101570","21","78912"
"chr5","15187978","15188263","chr20","15109049","15109334","14","78929"
"chr5","15258784","15258904","chrX","100116560","100116681","17","84857776"
"chr5","15272428","15272765","chr20","15193810","15194142","17","78618"
"chr5","15279916","15280214","chr20","15201265","15201553","23","78651"
"chr5","15304825","15305133","chr3","51622492","51622797","55","36317667"
"chr5","15315670","15315969","chr20","15236898","15237190","17","78772"
"chr5","15331628","15331928","chr20","15252877","15253186","17","78751"
"chr5","15331929","15332092","chr20","15253187","15253347","9","78742"
"chr5","15338794","15339090","chr20","15260072","15260367","21","78722"
"chr5","15413234","15413529","chr20","15334862","15335157","13","78372"
"chr5","15422882","15423099","chr20","15344970","15345194","14","77912"
"chr5","15435845","15436116","chrX","90717934","90718213","47","75282089"
"chr5","15451398","15451565","chr20","15374506","15374669","20","76892"
"chr5","15474126","15474426","chr20","15397839","15398140","7","76287"
"chr5","15474839","15475162","chr20","15398553","15398872","15","76286"
"chr5","15481569","15481850","chr7","143770144","143770424","5","128288575"
"chr5","15521424","15521675","chr20","15425465","15425743","32","95959"
"chr5","15539488","15539750","chr20","15444571","15444833","7","94917"
"chr5","15584184","15584477","chr12","64095954","64096238","56","48511770"
"chr5","15630108","15630398","chr20","15535328","15535617","13","94780"
"chr5","15681414","15681725","chr20","15588787","15589097","6","92627"
"chr5","15725053","15725172","chr20","15633937","15634059","5","91116"
"chr5","15727579","15727860","chr20","15636418","15636699","5","91161"
"chr5","15784376","15784546","chr20","15691418","15691588","9","92958"
"chr5","15788940","15789198","chr6","75846636","75846905","63","60057696"
"chr5","15791750","15792058","chr20","15698248","15698557","16","93502"
"chr5","15898305","15898594","chr20","15807222","15807511","8","91083"
"chr5","15912979","15913210","chr20","15821074","15821305","10","91905"
"chr5","15914302","15914610","chr20","15822395","15822706","10","91907"
"chr5","15938107","15938360","chr20","15846224","15846519","53","91883"
"chr5","16005876","16006015","chr20","15912729","15912871","6","93147"
"chr5","16006317","16006490","chr20","15913168","15913335","9","93149"
"chr5","16021270","16021571","chr20","15928508","15928811","17","92762"
"chr5","16031381","16031669","chr3","151851449","151851741","67","135820068"
"chr5","16085702","16086010","chr20","15994132","15994432","12","91570"
"chr5","16100008","16100323","chr20","16007326","16007649","20","92682"
"chr5","16120457","16120738","chr20","16027945","16028226","9","92512"
"chr5","16150571","16150727","chr20","16058743","16058912","21","91828"
"chr5","16163794","16164077","chr20","16072331","16072591","31","91463"
"chr5","16166239","16166538","chr20","16074753","16075060","20","91486"
"chr5","16183225","16183371","chr20","16085302","16085465","19","97923"
"chr5","16183723","16183835","chr20","16085815","16085941","19","97908"
"chr5","16186206","16186374","chr20","16088284","16088450","4","97922"
"chr5","16186677","16186813","chr20","16088742","16088882","7","97935"
"chr5","16189088","16189387","chr20","16091162","16091463","14","97926"
"chr5","16208818","16209104","chr20","16111695","16111981","6","97123"
"chr5","16211549","16211836","chr20","16114441","16114722","23","97108"
"chr5","16223171","16223447","chr20","16129310","16129587","8","93861"
"chr5","16247331","16247613","chr20","16153563","16153845","12","93768"
"chr5","16256379","16256643","chr20","16162255","16162512","40","94124"
"chr5","16267742","16268048","chr20","16173592","16173898","11","94150"
"chr5","16334651","16334928","chr20","16240649","16240926","6","94002"
"chr5","16354846","16355157","chr20","16261439","16261748","11","93407"
"chr5","16379447","16379541","chr20","16285640","16285736","6","93807"
"chr5","16443006","16443197","chr11","106913246","106913433","36","90470240"
"chr5","16450367","16450532","chr20","16356245","16356410","2","94122"
"chr5","16491549","16491838","chr20","16391537","16391824","9","100012"
"chr5","16608883","16609209","chr20","16506604","16506901","33","102279"
"chr5","16641741","16642032","chr20","16539249","16539539","9","102492"
"chr5","16650485","16650692","chr20","16547934","16548116","30","102551"
"chr5","16692554","16692840","chr20","16588554","16588850","19","104000"
"chr5","16693963","16694256","chr20","16589971","16590264","4","103992"
"chr5","16741823","16742133","chr3","9039630","9039934","63","7702193"
"chr5","16793117","16793423","chr20","16688399","16688685","28","104718"
"chr5","16907417","16907684","chr20","16798100","16798368","9","109317"
"chr5","16922408","16922596","chr3","173923294","173923479","33","157000886"
"chr5","16922868","16923018","chr9","87445157","87445307","38","70522289"
"chr5","16931719","16931842","chr5","101358447","101358572","31","84426728"
"chr5","16940867","16941155","chr20","16836425","16836719","14","104442"
"chr5","16944276","16944395","chr11","107496470","107496572","30","90552194"
"chr5","16944671","16944852","chr20","16830543","16830722","8","114128"
"chr5","16953673","16954033","chr19","33050931","33051257","90","16097258"
"chr5","16955089","16955213","chr7","110909587","110909712","26","93954498"
"chr5","16981858","16982132","chr20","16873754","16874028","27","108104"
"chr5","16983176","16983510","chr20","16875093","16875393","44","108083"
"chr5","16986706","16987012","chr20","16878600","16878906","9","108106"
"chr5","16991474","16991761","chr20","16883379","16883660","19","108095"
"chr5","16993165","16993448","chr20","16885038","16885341","37","108127"
"chr5","16994369","16994663","chr20","16886267","16886588","42","108102"
"chr5","16999053","16999335","chr20","16890948","16891221","17","108105"
"chr5","17011249","17011358","chr20","16903257","16903377","14","107992"
"chr5","17021757","17022066","chr5","4100535","4100837","69","12921222"
"chr5","17029993","17030308","chr10","17081355","17081663","60","51362"
"chr5","17056724","17056962","chr20","16945975","16946212","6","110749"
"chr5","17057724","17058006","chr20","16946965","16947246","7","110759"
"chr5","17061235","17061543","chrX","1973496","1973797","59","15087739"
"chr5","17077872","17078161","chr20","16970407","16970696","4","107465"
"chr5","17094132","17094304","chr20","16986951","16987122","10","107181"
"chr5","17127080","17127306","chr20","17020339","17020565","3","106741"
"chr5","17134387","17134688","chr20","17027658","17027959","4","106729"
"chr5","17145820","17146110","chr20","17039104","17039395","8","106716"
"chr5","17156481","17156747","chr20","17050065","17050331","5","106416"
"chr5","17170551","17170850","chr20","17062743","17063048","19","107808"
"chr5","17179492","17179750","chr20","17072089","17072353","14","107403"
"chr5","17184513","17184789","chr20","17077102","17077379","8","107411"
"chr5","17185402","17185699","chr20","17077992","17078288","8","107410"
"chr5","17195115","17195399","chr20","17087902","17088186","10","107213"
"chr5","17201513","17201621","chr3","142847065","142847173","27","125645552"
"chr5","17201915","17202022","chr15","4765942","4766043","18","12435973"
"chr5","17211467","17211527","chr1","15409364","15409425","11","1802103"
"chr5","17211541","17211865","chr20","17104015","17104339","4","107526"
"chr5","17212185","17212375","chr20","17104657","17104842","7","107528"
"chr5","17213872","17214149","chr20","17106333","17106612","8","107539"
"chr5","17236183","17236419","chr20","17129981","17130207","18","106202"
"chr5","17241649","17241826","chr13","7960128","7960302","28","9281521"
"chr5","17242170","17242315","chr20","17133957","17134102","1","108213"
"chr5","17244494","17244639","chr5","114190086","114190231","31","96945592"
"chr5","17250286","17250578","chr20","17142916","17143207","8","107370"
"chr5","17253138","17253254","chr20","17145915","17146034","6","107223"
"chr5","17253896","17254032","chr20","17146672","17146811","11","107224"
"chr5","17257275","17257567","chr20","17151485","17151775","6","105790"
"chr5","17260020","17260341","chr20","17154221","17154535","20","105799"
"chr5","17287420","17287677","chr20","17182053","17182320","22","105367"
"chr5","17289079","17289370","chr20","17183712","17183999","11","105367"
"chr5","17299825","17300124","chr20","17195358","17195656","10","104467"
"chr5","17306250","17306402","chr3","43694728","43694868","38","26388478"
"chr5","17317538","17317797","chr20","17212118","17212372","20","105420"
"chr5","17321505","17321807","chr20","17216070","17216373","10","105435"
"chr5","17331818","17332125","chr20","17226971","17227247","45","104847"
"chr5","17334445","17334747","chr9","113740769","113741081","65","96406324"
"chr5","17336769","17336993","chr20","17231933","17232157","4","104836"
"chr5","17349445","17349745","chr20","17244908","17245208","12","104537"
"chr5","17354307","17354615","chr14","107679725","107680016","65","90325418"
"chr5","17362473","17362767","chr20","17258135","17258414","19","104338"
"chr5","17367988","17368264","chr20","17263662","17263935","7","104326"
"chr5","17381497","17381791","chr20","17276609","17276914","19","104888"
"chr5","17385998","17386258","chr20","17281086","17281319","32","104912"
"chr5","17387634","17387914","chr20","17282671","17282951","1","104963"
"chr5","17388930","17389061","chr17","77658355","77658487","30","60269425"
"chr5","17391423","17391714","chr20","17286576","17286867","9","104847"
"chr5","17393830","17394036","chr20","17289050","17289252","10","104780"
"chr5","17395963","17396281","chr20","17291518","17291871","43","104445"
"chr5","17418384","17418686","chr20","17314712","17315014","6","103672"
"chr5","17439987","17440296","chr20","17337169","17337486","20","102818"
"chr5","17440893","17441179","chr20","17338084","17338370","6","102809"
"chr5","17448352","17448618","chr20","17346131","17346426","34","102221"
"chr5","17454124","17454433","chr20","17351999","17352306","6","102125"
"chr5","17463129","17463399","chr11","108915754","108916017","60","91452625"
"chr5","17485668","17485946","chr20","17384784","17385064","29","100884"
"chr5","17513244","17513524","chr5","51804850","51805130","47","34291606"
"chr5","17523162","17523468","chr20","17422462","17422762","21","100700"
"chr5","17531659","17531719","chr20","17430758","17430819","5","100901"
"chr5","17531912","17532126","chr20","17430994","17431207","7","100918"
"chr5","17536479","17536762","chr20","17437544","17437827","6","98935"
"chr5","17546390","17546697","chr20","17445863","17446169","10","100527"
"chr5","17552116","17552395","chr4","107227417","107227688","64","89675301"
"chr5","17577768","17578050","chr20","17476302","17476599","24","101466"
"chr5","17591531","17591841","chr20","17490012","17490327","9","101519"
"chr5","17592855","17593156","chr20","17491343","17491648","22","101512"
"chr5","17593937","17594197","chr20","17492454","17492732","28","101483"
"chr5","17599352","17599576","chr20","17497940","17498162","18","101412"
"chr5","17601259","17601559","chr13","26517121","26517403","78","8915862"
"chr5","17622263","17622554","chr1","13344673","13344967","56","4277590"
"chr5","17628535","17628812","chr20","17520020","17520294","10","108515"
"chr5","17637133","17637432","chr20","17527757","17528055","5","109376"
"chr5","17642886","17642930","chr7","34110147","34110189","7","16467261"
"chr5","17650974","17651110","chr11","111931690","111931822","24","94280716"
"chr5","17651390","17651676","chr20","17547432","17547718","6","103958"
"chr5","17656564","17656850","chr20","17555150","17555436","11","101414"
"chr5","17657798","17658095","chr20","17556384","17556684","9","101414"
"chr5","17658942","17659246","chr4","36593951","36594258","62","18935009"
"chr5","17661947","17662245","chr20","17552606","17552927","43","109341"
"chr5","17669808","17670026","chr6","11108899","11109117","44","6560909"
"chr5","17691674","17691979","chr20","17587560","17587853","18","104114"
"chr5","17697016","17697314","chr20","17595624","17595924","19","101392"
"chr5","17701467","17701628","chr20","17599999","17600154","9","101468"
"chr5","17714555","17714862","chr20","17617846","17618152","12","96709"
"chr5","17724388","17724551","chr20","17626783","17626946","7","97605"
"chr5","17726514","17726777","chr20","17629005","17629267","9","97509"
"chr5","17727264","17727546","chr20","17629759","17630041","6","97505"
"chr5","17729643","17729794","chr20","17632141","17632288","13","97502"
"chr5","17732022","17732166","chr20","17634506","17634640","13","97516"
"chr5","17732467","17732654","chr20","17634952","17635131","12","97515"
"chr5","17745547","17745860","chr20","17648272","17648577","17","97275"
"chr5","17748474","17748781","chr20","17651645","17651938","26","96829"
"chr5","17750463","17750645","chr20","17653659","17653835","9","96804"
"chr5","17758258","17758544","chr20","17661950","17662260","31","96308"
"chr5","17763788","17763900","chr20","17667801","17667909","6","95987"
"chr5","17798242","17798539","chr20","17702675","17702964","14","95567"
"chr5","17810755","17811051","chr20","17715016","17715311","8","95739"
"chr5","17819070","17819361","chr20","17723428","17723719","11","95642"
"chr5","17850096","17850392","chr20","17754512","17754798","18","95584"
"chr5","17851094","17851349","chr20","17755494","17755749","4","95600"
"chr5","17866627","17866811","chr20","17771175","17771356","10","95452"
"chr5","17867827","17868104","chr3","173597806","173598081","63","155729979"
"chr5","17871083","17871386","chr20","17773683","17773988","12","97400"
"chr5","17881740","17882023","chr20","17784311","17784593","9","97429"
"chr5","17885170","17885320","chr1","1658615","1658747","35","16226555"
"chr5","17906672","17907009","chr20","17809334","17809643","33","97338"
"chr5","17916570","17916835","chr20","17819561","17819825","8","97009"
"chr5","17918621","17918926","chr20","17821317","17821626","9","97304"
"chr5","17923340","17923644","chr5","142565235","142565540","53","124641895"
"chr5","17933945","17934016","chr4","57063686","57063754","12","39129741"
"chr5","17934018","17934169","chr4","17814413","17814562","25","119605"
"chr5","17950716","17951017","chr20","17853426","17853732","16","97290"
"chr5","17957902","17958215","chr20","17860276","17860588","14","97626"
"chr5","17962447","17962498","chr14","46545664","46545707","14","28583217"
"chr5","17966133","17966416","chr20","17867782","17868065","8","98351"
"chr5","17977217","17977357","chr20","17879896","17880035","4","97321"
"chr5","17977653","17977814","chr20","17880331","17880497","8","97322"
"chr5","17978608","17978840","chr20","17881292","17881523","11","97316"
"chr5","17979152","17979230","chr20","17881831","17881913","7","97321"
"chr5","17987393","17987474","chr20","17889421","17889500","6","97972"
"chr5","17989764","17990045","chr15","106630239","106630525","60","88640475"
"chr5","18016038","18016315","chr7","106707957","106708225","63","88691919"
"chr5","18017661","18017740","chr7","43566719","43566796","18","25549058"
"chr5","18019825","18019991","chr20","17923604","17923785","23","96221"
"chr5","18023052","18023363","chr20","17926818","17927115","21","96234"
"chr5","18033108","18033422","chr20","17936744","17937059","13","96364"
"chr5","18045974","18046267","chr20","17950468","17950764","16","95506"
"chr5","18054082","18054361","chr20","17959515","17959794","12","94567"
"chr5","18057366","18057687","chr20","17962792","17963108","26","94574"
"chr5","18072121","18072433","chr20","17978117","17978438","35","94004"
"chr5","18083220","18083383","chr18","33231384","33231545","32","15148164"
"chr5","18085002","18085304","chr20","17988610","17988912","11","96392"
"chr5","18089760","18090045","chr20","17994055","17994340","3","95705"
"chr5","18093959","18094231","chr20","17998279","17998549","8","95680"
"chr5","18097768","18098071","chr20","18002053","18002349","24","95715"
"chr5","18103668","18103964","chr20","18008276","18008573","24","95392"
"chr5","18118435","18118720","chr20","18024934","18025235","24","93501"
"chr5","18126118","18126414","chr20","18032619","18032916","5","93499"
"chr5","18127103","18127393","chr7","125147857","125148143","48","107020754"
"chr5","18130748","18131057","chr20","18037580","18037887","8","93168"
"chr5","18145831","18146119","chr20","18052947","18053234","11","92884"
"chr5","18149791","18150081","chr20","18058094","18058400","20","91697"
"chr5","18159719","18160022","chr20","18068158","18068422","41","91561"
"chr5","18170095","18170402","chr20","18077716","18078022","11","92379"
"chr5","18186175","18186449","chr20","18094092","18094377","24","92083"
"chr5","18188129","18188342","chr20","18096051","18096270","12","92078"
"chr5","18189785","18190098","chr20","18097687","18097999","11","92098"
"chr5","18192022","18192325","chr20","18099925","18100231","9","92097"
"chr5","18196727","18196864","chr20","18104632","18104766","7","92095"
"chr5","18197700","18198001","chr20","18105598","18105898","11","92102"
"chr5","18222465","18222787","chr9","106530616","106530926","70","88308151"
"chr5","18253824","18253881","chr20","18166394","18166451","0","87430"
"chr5","18259172","18259293","chr20","18172133","18172254","5","87039"
"chr5","18279881","18280185","chr20","18193117","18193421","9","86764"
"chr5","18344338","18344648","chr20","18257183","18257488","13","87155"
"chr5","18405191","18405488","chr20","18318613","18318905","13","86578"
"chr5","18421977","18422241","chr20","18335361","18335625","3","86616"
"chr5","18452305","18452603","chr20","18364960","18365237","29","87345"
"chr5","18462597","18462632","chr20","18376499","18376534","2","86098"
"chr5","18463185","18463368","chr20","18377087","18377270","4","86098"
"chr5","18548258","18548544","chr20","18463609","18463895","6","84649"
"chr5","18560021","18560304","chr20","18475629","18475948","45","84392"
"chr5","18637291","18637495","chr10","7732797","7732975","60","10904494"
"chr5","18645861","18646082","chr20","18562543","18562764","3","83318"
"chr5","18661288","18661532","chr20","18577956","18578198","8","83332"
"chr5","18665348","18665502","chr2","43194047","43194197","32","24528699"
"chr5","18666216","18666381","chr20","18583116","18583277","16","83100"
"chr5","18683965","18684252","chr11","8822956","8823241","53","9861009"
"chr5","18720586","18720879","chr20","18637594","18637876","16","82992"
"chr5","18731119","18731407","chr20","18655915","18656203","8","75204"
"chr5","18874611","18874908","chr20","18806620","18806916","17","67991"
"chr5","18911649","18911948","chr20","18858661","18858962","24","52988"
"chr5","18937150","18937466","chr20","18885003","18885314","25","52147"
"chr5","18941733","18941852","chr20","18889224","18889344","8","52509"
"chr5","18948968","18949268","chr20","18896498","18896796","11","52470"
"chr5","18968537","18968824","chr20","18915668","18915902","60","52869"
"chr5","19024276","19024573","chr20","18969717","18970014","4","54559"
"chr5","19029095","19029399","chr20","18974535","18974839","2","54560"
"chr5","19029908","19030199","chr20","18975348","18975639","10","54560"
"chr5","19046665","19046836","chr20","18992050","18992226","8","54615"
"chr5","19047930","19048238","chr20","18993327","18993635","5","54603"
"chr5","19072934","19073233","chr2","44882107","44882408","54","25809173"
"chr5","19078759","19079045","chr20","19023834","19024119","11","54925"
"chr5","19079369","19079681","chr20","19024444","19024759","11","54925"
"chr5","19086468","19086737","chr1","121994182","121994464","60","102907714"
"chr5","19093510","19093812","chr20","19038157","19038457","16","55353"
"chr5","19101457","19101511","chr20","19046125","19046180","2","55332"
"chr5","19103088","19103374","chr20","19047753","19048042","10","55335"
"chr5","19109082","19109397","chr5","158593440","158593741","64","139484358"
"chr5","19115625","19115918","chr20","19060634","19060927","3","54991"
"chr5","19118942","19119255","chr20","19063949","19064266","16","54993"
"chr5","19127200","19127369","chr20","39941336","39941509","35","20814136"
"chr5","19129537","19129843","chr17","89294462","89294768","47","70164925"
"chr5","19138973","19139245","chr20","19082168","19082436","13","56805"
"chr5","19141349","19141667","chr20","19084547","19084865","11","56802"
"chr5","19152097","19152379","chr20","19095504","19095784","14","56593"
"chr5","19160492","19160772","chr20","19105579","19105883","35","54913"
"chr5","19162108","19162263","chr8","95565736","95565891","29","76403628"
"chr5","19163163","19163412","chr20","19108241","19108490","5","54922"
"chr5","19166969","19167118","chr8","93414180","93414317","40","74247211"
"chr5","19167269","19167345","chr5","74611056","74611132","15","55443787"
"chr5","19175151","19175451","chr20","19121233","19121532","12","53918"
"chr5","19189780","19190081","chr20","19136229","19136537","15","53551"
"chr5","19207922","19208220","chr20","19154279","19154589","22","53643"
"chr5","19209416","19209677","chr20","19155795","19156043","20","53621"
"chr5","19219609","19219905","chr20","19166000","19166301","11","53609"
"chr5","19254881","19255190","chr20","19201007","19201317","13","53874"
"chr5","19256330","19256470","chr9","95507139","95507272","24","76250809"
"chr5","19260463","19260531","chr1","41706824","41706888","15","22446361"
"chr5","19260594","19260845","chr20","19206698","19206949","2","53896"
"chr5","19263726","19263977","chr20","19209855","19210101","12","53871"
"chr5","19276096","19276389","chr20","19222195","19222493","18","53901"
"chr5","19307371","19307665","chr20","19253583","19253886","16","53788"
"chr5","19307952","19308248","chr20","19254176","19254478","22","53776"
"chr5","19329314","19329622","chr20","19275479","19275792","15","53835"
"chr5","19329693","19329963","chr3","45544140","45544411","62","26214447"
"chr5","19378374","19378674","chr20","19327811","19328111","7","50563"
"chr5","19387538","19387677","chr20","19336586","19336725","5","50952"
"chr5","19387971","19388118","chr20","19337018","19337172","19","50953"
"chr5","19471037","19471354","chr20","19420451","19420788","34","50586"
"chr5","19527402","19527689","chr20","19470231","19470520","12","57171"
"chr5","19619182","19619427","chr20","19556856","19557104","14","62326"
"chr5","19633734","19634037","chr20","19571404","19571727","28","62330"
"chr5","19646083","19646249","chr20","19583744","19583909","4","62339"
"chr5","19651801","19652093","chr20","19589437","19589729","8","62364"
"chr5","19657133","19657200","chr20","19594470","19594537","1","62663"
"chr5","19661802","19662093","chr20","19599147","19599440","6","62655"
"chr5","19692474","19692772","chr20","19629006","19629299","19","63468"
"chr5","19700612","19700909","chr20","19637099","19637405","13","63513"
"chr5","19704778","19705079","chr16","30593804","30594103","51","10889026"
"chr5","19706362","19706632","chr11","116386157","116386433","54","96679795"
"chr5","19769991","19770272","chr20","19699272","19699552","6","70719"
"chr5","19771987","19772319","chr20","19701277","19701607","11","70710"
"chr5","19775267","19775577","chr20","19704552","19704862","16","70715"
"chr5","19789527","19789803","chr20","19721384","19721661","13","68143"
"chr5","19795254","19795540","chr20","19727152","19727441","16","68102"
"chr5","19805141","19805264","chr20","19737138","19737261","2","68003"
"chr5","19815008","19815320","chr20","19747036","19747348","8","67972"
"chr5","19822031","19822114","chr20","19753866","19753949","2","68165"
"chr5","19823061","19823359","chr20","19754895","19755202","17","68166"
"chr5","19827674","19827967","chr20","19759718","19760009","4","67956"
"chr5","19829871","19830166","chr20","19761912","19762208","8","67959"
"chr5","19833317","19833585","chr20","19764689","19764956","12","68628"
"chr5","19840810","19841100","chr20","19770838","19771132","11","69972"
"chr5","19844441","19844677","chr20","19774458","19774688","12","69983"
"chr5","19868918","19869221","chr20","19803701","19804016","18","65217"
"chr5","19878215","19878341","chr20","19808709","19808842","11","69506"
"chr5","19884568","19884689","chr20","19814709","19814828","5","69859"
"chr5","19887456","19887761","chr20","19817597","19817899","11","69859"
"chr5","19891369","19891658","chr20","19821501","19821800","24","69868"
"chr5","19898680","19898796","chr20","19829730","19829851","8","68950"
"chr5","19909902","19910031","chr20","19839889","19840018","4","70013"
"chr5","19910925","19911214","chr20","19841396","19841684","10","69529"
"chr5","19921741","19922035","chr15","7749125","7749420","52","12172616"
"chr5","19933645","19933944","chr20","19864834","19865132","9","68811"
"chr5","19949923","19950230","chr20","19882206","19882511","5","67717"
"chr5","19955431","19955665","chr17","23842476","23842712","49","3887045"
"chr5","19966758","19967044","chr20","19900413","19900699","7","66345"
"chr5","20018582","20018889","chr14","9059297","9059591","71","10959285"
"chr5","20038199","20038485","chr20","19971747","19972035","16","66452"
"chr5","20042398","20042523","chr20","19975719","19975845","2","66679"
"chr5","20056111","20056416","chr20","19989012","19989319","10","67099"
"chr5","20060534","20060719","chr20","19993471","19993632","43","67063"
"chr5","20061357","20061471","chr3","33449589","33449704","19","13388232"
"chr5","20064220","20064536","chr20","19996787","19997103","8","67433"
"chr5","20068494","20068782","chr20","20001118","20001398","13","67376"
"chr5","20070287","20070585","chr20","20002885","20003175","9","67402"
"chr5","20071228","20071530","chr20","20003816","20004117","10","67412"
"chr5","20084508","20084814","chr20","20019655","20019961","4","64853"
"chr5","20087512","20087753","chr20","20022724","20022965","7","64788"
"chr5","20093109","20093402","chr20","20028485","20028783","14","64624"
"chr5","20103195","20103331","chr20","20039452","20039588","3","63743"
"chr5","20103639","20103810","chr20","20039902","20040075","7","63737"
"chr5","20107304","20107578","chr20","20043277","20043570","47","64027"
"chr5","20112141","20112387","chr20","20048125","20048372","8","64016"
"chr5","20114768","20115066","chr20","12631446","12631741","54","7483322"
"chr5","20115886","20116022","chr16","22932775","22932908","20","2816889"
"chr5","20122242","20122544","chr20","20060776","20061077","5","61466"
"chr5","20125083","20125346","chr1","64867733","64867995","42","44742650"
"chr5","20144141","20144446","chr20","20082455","20082759","6","61686"
"chr5","20186186","20186486","chr20","20126245","20126552","24","59941"
"chr5","20188286","20188589","chr20","20128346","20128649","10","59940"
"chr5","20218507","20218787","chr20","20159744","20160024","6","58763"
"chr5","20230813","20231073","chr20","20172577","20172836","14","58236"
"chr5","20233287","20233515","chr11","506621","506855","53","19726666"
"chr5","20233755","20234048","chr20","20175531","20175828","12","58224"
"chr5","20246889","20247177","chr20","20189049","20189336","7","57840"
"chr5","20255349","20255621","chr20","20197688","20197975","16","57661"
"chr5","20257669","20257968","chr20","20200020","20200318","6","57649"
"chr5","20288059","20288376","chr20","20230023","20230338","14","58036"
"chr5","20306911","20307222","chr20","20249123","20249428","23","57788"
"chr5","20320368","20320662","chr9","26171818","26172114","60","5851450"
"chr5","20347479","20347770","chr20","20292282","20292577","16","55197"
"chr5","20355690","20356041","chr1","162536475","162536801","90","142180785"
"chr5","20357758","20358054","chr20","20302684","20302980","4","55074"
"chr5","20388813","20389139","chr20","20334618","20334945","20","54195"
"chr5","20392765","20393052","chrX","56627108","56627396","60","36234343"
"chr5","20394513","20394789","chr20","20340324","20340598","10","54189"
"chr5","20427893","20428178","chr20","20371357","20371643","5","56536"
"chr5","20431971","20432102","chr16","9009276","9009407","27","11422695"
"chr5","20508561","20508840","chr20","20456065","20456343","5","52496"
"chr5","20523220","20523514","chr20","20470836","20471142","19","52384"
"chr5","20561664","20561993","chr20","20509434","20509769","29","52230"
"chr5","20575149","20575439","chr20","20522949","20523239","4","52200"
"chr5","20577111","20577412","chr20","20524911","20525208","7","52200"
"chr5","20589671","20589992","chr2","91822603","91822914","70","71232932"
"chr5","20590620","20590716","chr11","110032530","110032623","17","89441910"
"chr5","20592860","20593171","chr20","20540576","20540888","11","52284"
"chr5","20603476","20603799","chr20","20551213","20551506","38","52263"
"chr5","20607497","20607778","chr20","20555203","20555483","9","52294"
"chr5","20614547","20614809","chr20","20562422","20562716","50","52125"
"chr5","20698594","20698899","chr20","20646607","20646937","35","51987"
"chr5","20713236","20713395","chr10","27501941","27502094","25","6788705"
"chr5","20729857","20730157","chr20","20677837","20678140","7","52020"
"chr5","20737905","20738224","chr20","20685870","20686182","11","52035"
"chr5","20844399","20844702","chr20","20793226","20793508","26","51173"
"chr5","20847555","20847850","chr20","20796363","20796660","6","51192"
"chr5","20852888","20853191","chr20","20801931","20802238","8","50957"
"chr5","20865492","20865790","chr20","20814455","20814741","24","51037"
"chr5","20877261","20877567","chr20","20826859","20827169","14","50402"
"chr5","20878419","20878531","chr20","20827684","20827796","4","50735"
"chr5","20886675","20886779","chr20","20835624","20835714","15","51051"
"chr5","20888977","20889277","chr20","20839338","20839651","21","49639"
"chr5","20902141","20902424","chr20","20852716","20853040","43","49425"
"chr5","20911586","20911881","chr20","20862142","20862442","13","49444"
"chr5","20915851","20916021","chr20","20866363","20866533","7","49488"
"chr5","20916888","20917053","chr12","23205660","23205817","29","2288772"
"chr5","20924569","20924720","chr16","25283322","25283460","34","4358753"
"chr5","20928364","20928663","chr14","3387026","3387321","62","17541338"
"chr5","20929623","20929910","chr20","20886257","20886514","36","43366"
"chr5","20934184","20934250","chr20","20890703","20890769","0","43481"
"chr5","20940945","20941227","chr20","20897641","20897893","32","43304"
"chr5","20947329","20947606","chr20","20905144","20905421","8","42185"
"chr5","20949507","20949798","chr20","20907224","20907518","15","42283"
"chr5","20958104","20958391","chr20","20916941","20917231","13","41163"
"chr5","20959369","20959677","chr20","20918109","20918417","8","41260"
"chr5","20962027","20962213","chr20","20921084","20921270","14","40943"
"chr5","20964251","20964555","chr20","20923120","20923423","9","41131"
"chr5","20967832","20968114","chr7","14286956","14287238","53","6680876"
"chr5","20968718","20969063","chr11","82343675","82344006","76","61374957"
"chr5","20986745","20986818","chrX","62430009","62430085","15","41443264"
"chr5","20987344","20987500","chr6","147954262","147954413","29","126966918"
"chr5","20999836","20999993","chr14","120450685","120450839","25","99450849"
"chr5","21000009","21000142","chr11","122488218","122488356","21","101488209"
"chr5","21001534","21001678","chr20","20955829","20955973","3","45705"
"chr5","21005128","21005267","chr1","37288779","37288903","39","16283651"
"chr5","21007384","21007686","chr20","20961670","20961974","8","45714"
"chr5","21007806","21008102","chr14","103408162","103408451","62","82400356"
"chr5","21008443","21008718","chr20","20962730","20963004","9","45713"
"chr5","21011437","21011774","chr20","20965712","20966041","18","45725"
"chr5","21012396","21012696","chr20","20966657","20966957","11","45739"
"chr5","21013532","21013841","chr20","20968070","20968378","9","45462"
"chr5","21025075","21025192","chr20","20979641","20979759","4","45434"
"chr5","21025261","21025463","chr20","20979868","20980043","28","45393"
"chr5","21033825","21034112","chr20","20986986","20987269","11","46839"
"chr5","21034590","21034885","chr1","141444766","141445056","55","120410176"
"chr5","21039297","21039596","chr20","20992477","20992776","11","46820"
"chr5","21052807","21053089","chr20","21006549","21006831","9","46258"
"chr5","21056091","21056262","chr7","148417047","148417212","34","127360956"
"chr5","21056567","21056699","chr3","43539155","43539288","22","22482588"
"chr5","21061766","21062086","chr5","34754577","34754905","64","13692811"
"chr5","21070804","21071081","chr20","21023417","21023694","14","47387"
"chr5","21073102","21073237","chr20","21025713","21025848","4","47389"
"chr5","21073526","21073690","chr20","21026145","21026324","19","47381"
"chr5","21087292","21087369","chr1","48438956","48439030","16","27351664"
"chr5","21093815","21094068","chr20","21047706","21047959","5","46109"
"chr5","21094666","21094946","chr20","21048557","21048837","9","46109"
"chr5","21109941","21110241","chr20","21064164","21064464","9","45777"
"chr5","21141495","21141785","chr20","21095433","21095723","8","46062"
"chr5","21144436","21144687","chr4","35102585","35102835","47","13958149"
"chr5","21145207","21145474","chr20","21099131","21099398","7","46076"
"chr5","21147698","21148010","chr20","21101936","21102246","12","45762"
"chr5","21149531","21149823","chr20","21109972","21110264","3","39559"
"chr5","21150653","21150958","chr20","21111032","21111337","9","39621"
"chr5","21153640","21153921","chr20","21113996","21114294","24","39644"
"chr5","21157837","21158129","chr20","21129460","21129749","10","28377"
"chr5","21172405","21172704","chr20","21132965","21133272","16","39440"
"chr5","21176129","21176437","chr20","21124831","21125137","6","51298"
"chr5","21183590","21183713","chr20","21140131","21140256","11","43459"
"chr5","21187244","21187528","chr20","21143625","21143910","12","43619"
"chr5","21203438","21203710","chr20","21158390","21158662","5","45048"
"chr5","21216898","21217014","chr19","40105654","40105767","23","18888756"
"chr5","21217137","21217324","chr20","21172200","21172402","29","44937"
"chr5","21222483","21222610","chr20","21177584","21177711","5","44899"
"chr5","21222933","21223087","chr20","21179351","21179502","13","43582"
"chr5","21224128","21224311","chr20","21178012","21178184","21","46116"
"chr5","21237414","21237682","chr20","21191688","21191958","7","45726"
"chr5","21240340","21240622","chr20","21194634","21194935","23","45706"
"chr5","21241243","21241523","chr20","21195882","21196162","6","45361"
"chr5","21241944","21242095","chr1","139075827","139075967","33","117833883"
"chr5","21244039","21244211","chr20","21198984","21199155","3","45055"
"chr5","21244459","21244660","chr20","21199403","21199604","4","45056"
"chr5","21245201","21245508","chr20","21200162","21200469","4","45039"
"chr5","21263906","21264036","chr20","21217720","21217837","16","46186"
"chr5","21264253","21264431","chr20","21218366","21218544","4","45887"
"chr5","21264444","21264755","chr20","21218552","21218863","9","45892"
"chr5","21272612","21272909","chr20","21227283","21227580","7","45329"
"chr5","21274218","21274340","chr20","21228863","21228984","4","45355"
"chr5","21275591","21275656","chr20","21229600","21229671","9","45991"
"chr5","21276619","21276858","chr20","21230630","21230871","15","45989"
"chr5","21279004","21279080","chr20","21233640","21233716","4","45364"
"chr5","21279546","21279788","chr20","21234182","21234434","16","45364"
"chr5","21280673","21280972","chr20","21235311","21235605","15","45362"
"chr5","21303795","21304064","chr20","21258502","21258762","16","45293"
"chr5","21310060","21310196","chr20","21270882","21271018","3","39178"
"chr5","21321255","21321561","chr20","21276455","21276753","12","44800"
"chr5","21327715","21327803","chrX","99205169","99205254","14","77877454"
"chr5","21332269","21332312","chr20","21287612","21287655","1","44657"
"chr5","21334562","21334855","chr20","21289920","21290213","7","44642"
"chr5","21343474","21343603","chr20","21299538","21299667","9","43936"
"chr5","21343919","21344095","chr20","21299979","21300154","12","43940"
"chr5","21349421","21349552","chr7","147655285","147655413","23","126305864"
"chr5","21351280","21351585","chr20","21307323","21307627","23","43957"
"chr5","21367703","21368036","chr8","138746624","138746946","68","117378921"
"chr5","21372916","21373213","chr20","21328247","21328535","15","44669"
"chr5","21390327","21390453","chr9","26937961","26938081","26","5547634"
"chr5","21392263","21392571","chr20","21347233","21347543","7","45030"
"chr5","21401754","21402046","chr20","21357011","21357301","5","44743"
"chr5","21402097","21402383","chr20","21357341","21357634","14","44756"
"chr5","21415102","21415362","chr20","21370349","21370610","4","44753"
"chr5","21443918","21444225","chr20","21398934","21399241","8","44984"
"chr5","21466471","21466484","chr1","156086492","156086506","2","134620021"
"chr5","21466641","21466942","chr20","21421702","21422011","20","44939"
"chr5","21467701","21468026","chr9","79453076","79453394","73","57985375"
"chr5","21477754","21477834","chr20","21434150","21434230","3","43604"
"chr5","21483195","21483446","chr11","93604681","93604934","57","72121486"
"chr5","21498380","21498661","chr13","92792576","92792858","51","71294196"
"chr5","21499650","21499946","chr20","21456082","21456378","8","43568"
"chr5","21501127","21501417","chr20","21457563","21457846","17","43564"
"chr5","21504746","21504909","chr20","21461236","21461400","7","43510"
"chr5","21507495","21507797","chr20","21464337","21464643","12","43158"
"chr5","21510254","21510414","chrX","51314960","51315116","34","29804706"
"chr5","21510451","21510569","chr1","48746228","48746346","16","27235777"
"chr5","21514491","21514629","chr1","160006226","160006358","20","138491735"
"chr5","21520991","21521331","chr20","21477914","21478226","33","43077"
"chr5","21522628","21522960","chr20","21479536","21479866","17","43092"
"chr5","21532938","21533241","chr20","21477914","21478226","17","55024"
"chr5","21540554","21540831","chr20","21491592","21491868","10","48962"
"chr5","21554007","21554160","chr20","21504811","21504964","0","49196"
"chr5","21582204","21582415","chr20","21532701","21532912","6","49503"
"chr5","21584483","21584813","chr20","21534958","21535267","35","49525"
"chr5","21588582","21588728","chr20","21539006","21539152","1","49576"
"chr5","21588799","21588837","chr20","21539223","21539261","0","49576"
"chr5","21597755","21598056","chr20","21548470","21548784","26","49285"
"chr5","21637686","21637994","chr20","21588300","21588608","10","49386"
"chr5","21651229","21651513","chr20","21601772","21602059","8","49457"
"chr5","21657097","21657372","chr20","21607630","21607905","5","49467"
"chr5","21677033","21677240","chr20","21627781","21627989","11","49252"
"chr5","21703119","21703427","chr20","21653731","21654046","21","49388"
"chr5","21706948","21707229","chr20","21657533","21657840","28","49415"
"chr5","21710876","21711176","chr20","21661801","21662104","11","49075"
"chr5","21724790","21725068","chr20","21676244","21676522","5","48546"
"chr5","21731437","21731723","chr20","21682862","21683149","21","48575"
"chr5","21740214","21740526","chr20","21691620","21691927","18","48594"
"chr5","21746666","21746979","chr20","21698835","21699151","14","47831"
"chr5","21763273","21763572","chr20","21715640","21715939","10","47633"
"chr5","21812068","21812357","chr20","21763517","21763804","7","48551"
"chr5","21817050","21817331","chr20","21768534","21768815","5","48516"
"chr5","21846387","21846545","chr20","21798494","21798662","17","47893"
"chr5","21847133","21847269","chr20","21798944","21799078","7","48189"
"chr5","21853389","21853455","chr7","74966755","74966820","7","53113366"
"chr5","21854185","21854486","chr20","21806093","21806406","20","48092"
"chr5","21876134","21876435","chr20","21828015","21828317","25","48119"
"chr5","21879181","21879437","chr20","21831053","21831306","8","48128"
"chr5","21881851","21882146","chr20","21833814","21834120","18","48037"
"chr5","21884426","21884728","chr20","21836421","21836711","22","48005"
"chr5","21886778","21887001","chr20","21838756","21838983","11","48022"
"chr5","21900935","21901244","chr20","21852901","21853216","15","48034"
"chr5","21906866","21907017","chr20","21859133","21859293","13","47733"
"chr5","21913081","21913290","chr20","21865494","21865691","21","47587"
"chr5","21913614","21913727","chr20","21866020","21866133","3","47594"
"chr5","21914971","21915263","chr20","21867398","21867692","9","47573"
"chr5","21922898","21923218","chr20","21875309","21875633","7","47589"
"chr5","21957998","21958114","chr20","21910400","21910516","2","47598"
"chr5","22006260","22006387","chr20","21960111","21960238","2","46149"
"chr5","22023710","22023992","chr20","21976631","21976908","16","47079"
"chr5","22032227","22032445","chr2","147695112","147695327","64","125662885"
"chr5","22038035","22038129","chr7","106670395","106670490","22","84632360"
"chr5","22039285","22039596","chrX","142116490","142116801","58","120077205"
"chr5","22041533","22041835","chr20","21995934","21996243","15","45599"
"chr5","22045590","22045730","chr3","172677382","172677504","39","150631792"
"chr5","22045851","22046024","chr20","22000182","22000369","18","45669"
"chr5","22058878","22059173","chr20","22013221","22013525","13","45657"
"chr5","22071582","22071873","chr20","22026222","22026532","27","45360"
"chr5","22072938","22073254","chr14","110155097","110155415","60","88082159"
"chr5","22075424","22075706","chr20","22030083","22030367","6","45341"
"chr5","22082583","22082888","chr20","22037234","22037539","6","45349"
"chr5","22091181","22091469","chr20","22045582","22045866","12","45599"
"chr5","22115818","22115939","chrX","112241983","112242097","28","90126165"
"chr5","22138565","22138754","chr20","22093900","22094089","6","44665"
"chr5","22147560","22147881","chr20","22103211","22103534","15","44349"
"chr5","22154783","22154906","chr11","4764033","4764157","20","17390750"
"chr5","22158849","22159152","chr20","22114098","22114401","3","44751"
"chr5","22161278","22161554","chr20","22117477","22117756","17","43801"
"chr5","22167147","22167324","chr20","22121806","22121954","33","45341"
"chr5","22167630","22167748","chr20","22122274","22122392","3","45356"
"chr5","22177156","22177355","chr20","22131735","22131922","18","45421"
"chr5","22188892","22189098","chr10","31424063","31424261","49","9235171"
"chr5","22189426","22189476","chr1","48611164","48611212","10","26421738"
"chr5","22190858","22190904","chr12","62226475","62226513","11","40035617"
"chr5","22206465","22206576","chr20","22160945","22161056","2","45520"
"chr5","22216723","22216861","chr10","47446471","47446607","30","25229748"
"chr5","22220331","22220622","chr20","22173881","22174151","29","46450"
"chr5","22221895","22222052","chr20","22175426","22175583","5","46469"
"chr5","22222431","22222457","chr20","22175963","22175989","2","46468"
"chr5","22227022","22227316","chr20","22180787","22181068","21","46235"
"chr5","22228449","22228779","chr20","22182209","22182533","22","46240"
"chr5","22236496","22236794","chr20","22188687","22188985","2","47809"
"chr5","22252595","22252774","chr20","22205972","22206146","9","46623"
"chr5","22253083","22253211","chr20","22206450","22206577","3","46633"
"chr5","22255445","22255737","chr20","22208739","22209002","33","46706"
"chr5","22255758","22255892","chr3","151370968","151371098","31","129115210"
"chr5","22259969","22260248","chr20","22213266","22213547","5","46703"
"chr5","22266756","22267049","chr20","22220096","22220361","37","46660"
"chr5","22274862","22275162","chr20","22228159","22228458","15","46703"
"chr5","22320918","22321068","chr20","22274833","22274980","6","46085"
"chr5","22321097","22321243","chr15","96562176","96562321","26","74241079"
"chr5","22324838","22325012","chr20","22278419","22278593","2","46419"
"chr5","22330416","22330563","chr20","22283921","22284068","6","46495"
"chr5","22332511","22332831","chr20","22286036","22286353","15","46475"
"chr5","22353259","22353568","chr20","22306758","22307061","22","46501"
"chr5","22362527","22362809","chr20","22316028","22316319","16","46499"
"chr5","22365546","22365856","chr20","22318879","22319189","8","46667"
"chr5","22366707","22367015","chr20","22320013","22320319","8","46694"
"chr5","22368388","22368698","chr20","22321681","22321992","14","46707"
"chr5","22368733","22368994","chr20","22322039","22322303","18","46694"
"chr5","22372621","22372903","chr20","22325922","22326204","1","46699"
"chr5","22374040","22374141","chr13","103810057","103810157","13","81436017"
"chr5","22378460","22378735","chr20","22328561","22328836","12","49899"
"chr5","22383458","22383767","chr20","22337296","22337607","10","46162"
"chr5","22386170","22386505","chr20","22343063","22343401","12","43107"
"chr5","22394516","22394859","chr20","22343063","22343401","17","51453"
"chr5","22399258","22399571","chr20","22352283","22352595","7","46975"
"chr5","22399744","22399964","chr9","6030499","6030716","40","16369245"
"chr5","22400368","22400670","chr4","152226280","152226592","53","129825912"
"chr5","22401129","22401223","chr3","44020347","44020441","23","21619218"
"chr5","22403270","22403554","chr20","22356754","22357037","11","46516"
"chr5","22405352","22405504","chr3","127653755","127653909","25","105248403"
"chr5","22408731","22408893","chr20","22362245","22362419","26","46486"
"chr5","22408934","22409108","chr20","22362451","22362599","35","46483"
"chr5","22412029","22412411","chr5","52798229","52798554","129","30386200"
"chr5","22416217","22416393","chr3","46941865","46942032","46","24525648"
"chr5","22416592","22416687","chr19","182922","183017","14","22233670"
"chr5","22417730","22417798","chrX","37713785","37713855","12","15296055"
"chr5","22418720","22419004","chr20","22372786","22373068","7","45934"
"chr5","22428572","22428864","chr20","22382975","22383266","11","45597"
"chr5","22441213","22441387","chr20","22395566","22395725","17","45647"
"chr5","22443661","22443801","chr20","22398008","22398149","7","45653"
"chr5","22444107","22444277","chr20","22398454","22398620","6","45653"
"chr5","22444680","22444850","chr20","22399037","22399203","8","45643"
"chr5","22445495","22445778","chr20","22399867","22400151","9","45628"
"chr5","22448507","22448783","chr20","22402881","22403157","12","45626"
"chr5","22467494","22467778","chr20","22421862","22422146","4","45632"
"chr5","22529337","22529633","chr20","22483955","22484260","19","45382"
"chr5","22539984","22540290","chr20","22494958","22495256","17","45026"
"chr5","22555350","22555496","chr20","22509368","22509524","14","45982"
"chr5","22555522","22555634","chr20","22509547","22509661","4","45975"
"chr5","22555657","22555936","chr11","121352926","121353191","67","98797269"
"chr5","22560144","22560308","chr20","22514170","22514340","14","45974"
"chr5","22566507","22566732","chr6","101193819","101194038","45","78627312"
"chr5","22581298","22581371","chr4","17031387","17031455","17","5549911"
"chr5","22593059","22593371","chr20","22549162","22549465","16","43897"
"chr5","22594351","22594478","chr7","38210749","38210872","30","15616398"
"chr5","22594506","22594650","chr1","41160156","41160285","34","18565650"
"chr5","22595635","22595925","chr20","22552333","22552623","4","43302"
"chr5","22599778","22600039","chr10","71476014","71476273","64","48876236"
"chr5","22609780","22610083","chr20","22567367","22567682","26","42413"
"chr5","22610418","22610728","chr20","22568333","22568641","5","42085"
"chr5","22618486","22618519","chr10","18349163","18349196","2","4269323"
"chr5","22618512","22618566","chr4","154580698","154580747","10","131962186"
"chr5","22625207","22625491","chr20","22582918","22583172","41","42289"
"chr5","22625677","22625805","chr19","1853493","1853623","19","20772184"
"chr5","22625839","22625982","chr4","125675795","125675937","24","103049956"
"chr5","22629355","22629510","chr5","170700200","170700344","37","148070845"
"chr5","22637431","22637732","chr1","127839360","127839659","60","105201929"
"chr5","22645448","22645737","chr20","22603349","22603639","9","42099"
"chr5","22654802","22655093","chr20","22612717","22613009","11","42085"
"chr5","22698955","22699270","chr20","22657698","22658028","25","41257"
"chr5","22714009","22714028","chr11","109627400","109627417","6","86913391"
"chr5","22714340","22714487","chr20","22673126","22673276","7","41214"
"chr5","22723404","22723705","chr1","101026699","101026993","74","78303295"
"chr5","22731558","22731844","chr16","30945909","30946199","62","8214351"
"chr5","22734599","22734897","chr20","22693571","22693866","15","41028"
"chr5","22737817","22738115","chr20","22696780","22697076","10","41037"
"chr5","22741357","22741448","chr20","22700365","22700456","3","40992"
"chr5","22748754","22748947","chr1","136301302","136301473","55","113552548"
"chr5","22751101","22751390","chr16","21954896","21955178","57","796205"
"chr5","22756936","22757110","chr1","66887413","66887590","34","44130477"
"chr5","22759707","22759987","chr20","22720096","22720376","12","39611"
"chr5","22763058","22763342","chr20","22723954","22724249","23","39104"
"chr5","22764964","22765063","chr20","22725852","22725967","19","39112"
"chr5","22765813","22766116","chr20","22726703","22727015","21","39110"
"chr5","22767102","22767405","chr20","22727995","22728298","1","39107"
"chr5","22772085","22772366","chr20","22731811","22732090","12","40274"
"chr5","22779546","22779806","chr20","22741521","22741788","19","38025"
"chr5","22782503","22782798","chr20","22744763","22745062","14","37740"
"chr5","22785948","22786084","chr1","110258390","110258520","26","87472442"
"chr5","22791054","22791343","chr1","63505271","63505559","59","40714217"
"chr5","22817189","22817487","chr20","22780445","22780743","14","36744"
"chr5","22835570","22835850","chr20","22795040","22795315","17","40530"
"chr5","22839463","22839775","chr20","22798925","22799244","26","40538"
"chr5","22841062","22841360","chr20","22800533","22800837","37","40529"
"chr5","22849822","22850112","chr20","22809314","22809603","15","40508"
"chr5","22855044","22855344","chr20","22814734","22815038","16","40310"
"chr5","22859056","22859363","chr20","22820731","22821038","7","38325"
"chr5","22865379","22865607","chr20","22826724","22826958","15","38655"
"chr5","22867322","22867617","chr20","22828671","22828961","15","38651"
"chr5","22876343","22876632","chr20","22838271","22838560","11","38072"
"chr5","22884920","22885140","chr20","22847347","22847567","3","37573"
"chr5","22906447","22906727","chr20","22868902","22869197","42","37545"
"chr5","22915031","22915336","chr20","22882167","22882474","10","32864"
"chr5","22916195","22916412","chr4","125919367","125919579","52","103003172"
"chr5","22953511","22953642","chr15","22824677","22824809","25","128834"
"chr5","22966030","22966078","chr16","4318625","4318672","12","18647405"
"chr5","22997523","22997613","chr20","22964012","22964088","15","33511"
"chr5","23004859","23005159","chr20","22969980","22970279","6","34879"
"chr5","23009522","23009820","chr3","42883597","42883894","47","19874075"
"chr5","23040449","23040550","chr20","23004775","23004876","2","35674"
"chr5","23040905","23041078","chr20","23005231","23005404","5","35674"
"chr5","23112894","23113156","chr20","23078232","23078520","35","34662"
"chr5","23141010","23141310","chr20","23107269","23107555","15","33741"
"chr5","23210198","23210353","chr20","23176974","23177129","4","33224"
"chr5","23211769","23212097","chr20","23178539","23178855","22","33230"
"chr5","23212677","23212932","chr20","23179434","23179682","10","33243"
"chr5","23220378","23220472","chr20","23186974","23187061","10","33404"
"chr5","23220819","23221023","chr20","23187348","23187552","12","33471"
"chr5","23221032","23221342","chr20","23187575","23187859","33","33457"
"chr5","23222965","23223134","chr20","23189445","23189615","4","33520"
"chr5","23262584","23262884","chr20","23227826","23228126","20","34758"
"chr5","23276892","23277070","chr20","23244136","23244308","12","32756"
"chr5","23286869","23286974","chr20","23254015","23254126","10","32854"
"chr5","23287500","23287686","chr20","23254642","23254804","33","32858"
"chr5","23300256","23300513","chr20","23267735","23268000","25","32521"
"chr5","23318733","23318905","chrX","1974259","1974432","30","21344474"
"chr5","23318945","23319060","chr7","132107772","132107886","18","108788827"
"chr5","23386644","23386941","chr20","23351136","23351433","11","35508"
"chr5","23388466","23388610","chr2","78119437","78119571","26","54730971"
"chr5","23395985","23396113","chr20","23360668","23360796","2","35317"
"chr5","23422324","23422602","chr20","23387245","23387549","35","35079"
"chr5","23457925","23458234","chr20","23423237","23423557","23","34688"
"chr5","23471195","23471477","chr11","11579186","11579467","64","11892009"
"chr5","23549607","23549884","chr20","23512113","23512390","9","37494"
"chr5","23557831","23558135","chr20","23520653","23520964","18","37178"
"chr5","23607884","23608173","chr20","23570469","23570759","9","37415"
"chr5","23619858","23620123","chr20","23582521","23582809","29","37337"
"chr5","23631142","23631455","chr20","23593701","23594015","16","37441"
"chr5","23632296","23632584","chr20","23594856","23595161","25","37440"
"chr5","23703324","23703657","chr13","88598834","88599147","74","64895510"
"chr5","23774237","23774527","chr20","23738145","23738435","10","36092"
"chr5","23777812","23778117","chr20","23741718","23742025","5","36094"
"chr5","23834575","23834657","chr20","23793579","23793661","5","40996"
"chr5","23869521","23869814","chr20","23827553","23827835","29","41968"
"chr5","23880585","23880906","chr20","23838517","23838812","32","42068"
"chr5","23882598","23882895","chr20","23840630","23840930","22","41968"
"chr5","23995833","23996111","chr20","23948619","23948897","5","47214"
"chr5","24163802","24163974","chr20","24116910","24117082","7","46892"
"chr5","24170470","24170783","chr20","24123574","24123883","20","46896"
"chr5","24223732","24223872","chrX","123744675","123744818","26","99520943"
"chr5","24224328","24224414","chr1","25234832","25234924","21","1010504"
"chr5","24239805","24240092","chr20","24194239","24194529","15","45566"
"chr5","24243911","24244237","chr20","24198675","24199001","11","45236"
"chr5","24283475","24283793","chr20","24238716","24239036","11","44759"
"chr5","24327074","24327362","chr2","21697149","21697445","47","2629925"
"chr5","24336522","24336657","chr7","40816087","40816225","25","16479565"
"chr5","24336945","24337107","chr18","55869658","55869818","36","31532713"
"chr5","24338720","24338763","chr7","12956510","12956553","9","11382210"
"chr5","24338764","24338960","chr3","171896167","171896368","55","147557403"
"chr5","24355279","24355335","chr16","1008931","1008973","18","23346348"
"chr5","24355373","24355598","chrX","62992383","62992597","54","38637010"
"chr5","24407995","24408294","chr20","24365747","24366046","11","42248"
"chr5","24418860","24419141","chr20","24376739","24377039","25","42121"
"chr5","24526140","24526443","chr20","24483917","24484213","25","42223"
"chr5","24528970","24529060","chr3","6704911","6705006","28","17824059"
"chr5","24531573","24531891","chr20","24489321","24489635","10","42252"
"chr5","24532600","24532700","chr20","24490374","24490475","5","42226"
"chr5","24532875","24533092","chr20","55066082","55066300","48","30533207"
"chr5","24534319","24534614","chr20","24491292","24491586","6","43027"
"chr5","24585073","24585143","chr2","98666597","98666670","24","74081524"
"chr5","24603070","24603357","chr7","51365657","51365940","55","26762587"
"chr5","24622438","24622523","chr7","33765401","33765487","13","9142963"
"chr5","24683890","24684182","chr20","24641545","24641837","10","42345"
"chr5","24708767","24709040","chr20","24666094","24666377","20","42673"
"chr5","24747690","24747967","chr20","24701760","24702036","13","45930"
"chr5","24784487","24784783","chr1","82230677","82230953","64","57446190"
"chr5","24812774","24812895","chr20","24768103","24768223","3","44671"
"chr5","24836484","24836567","chr1","190655363","190655447","13","165818879"
"chr5","24861613","24861772","chr9","801634","801780","34","24059979"
"chr5","24863479","24863585","chr7","148664648","148664755","28","123801169"
"chr5","24884478","24884756","chr20","24839005","24839281","9","45473"
"chr5","24888544","24888849","chrX","11030031","11030337","59","13858513"
"chr5","24920115","24920346","chr1","125322515","125322745","40","100402400"
"chr5","24922941","24923215","chr3","44253015","44253291","66","19330074"
"chr5","24923464","24923754","chr20","24878799","24879080","24","44665"
"chr5","24924790","24925096","chr20","24880176","24880482","7","44614"
"chr5","24951616","24951903","chr20","24907603","24907890","11","44013"
"chr5","24953911","24954218","chr20","24910614","24910924","8","43297"
"chr5","24965524","24965752","chr20","24922405","24922631","11","43119"
"chr5","24969282","24969594","chr20","24926158","24926470","16","43124"
"chr5","24976915","24977040","chr20","24933763","24933896","12","43152"
"chr5","24984781","24985083","chr20","24941880","24942193","15","42901"
"chr5","24988412","24988725","chr20","24945563","24945875","12","42849"
"chr5","24990117","24990415","chr20","24947130","24947435","13","42987"
"chr5","24996782","24997074","chr20","24955945","24956237","13","40837"
"chr5","24999758","24999998","chr10","51470946","51471181","45","26471188"
"chr5","25001558","25001837","chr20","24961262","24961541","7","40296"
"chr5","25028096","25028393","chr20","24985529","24985819","22","42567"
"chr5","25031312","25031612","chr20","24988746","24989046","11","42566"
"chr5","25039159","25039312","chr20","24996993","24997145","6","42166"
"chr5","25044774","25045064","chr20","25002501","25002791","12","42273"
"chr5","25053260","25053417","chr20","25010775","25010932","2","42485"
"chr5","25081137","25081444","chr18","15946898","15947197","57","9134239"
"chr5","25097567","25097849","chr20","25056846","25057128","2","40721"
"chr5","25134762","25134876","chr16","67617314","67617428","19","42482552"
"chr5","25134903","25135059","chr3","127653755","127653909","31","102518852"
"chr5","25137474","25137763","chr20","25099462","25099751","13","38012"
"chr5","25140933","25141221","chr20","25102934","25103223","15","37999"
"chr5","25141875","25142080","chr20","25103878","25104082","12","37997"
"chr5","25178504","25178788","chr13","101505475","101505752","55","76326971"
"chr5","25209582","25209888","chr20","25171647","25171953","8","37935"
"chr5","25217501","25217807","chr20","25179650","25179956","7","37851"
"chr5","25224101","25224386","chr1","82230677","82230953","64","57006576"
"chr5","25230279","25230550","chr20","25192493","25192759","7","37786"
"chr5","25248895","25249015","chr20","25211119","25211222","19","37776"
"chr5","25256221","25256461","chr20","25218578","25218815","30","37643"
"chr5","25261556","25261849","chr20","25224233","25224530","10","37323"
"chr5","25279118","25279245","chr20","25241774","25241901","4","37344"
"chr5","25282700","25282986","chr20","25245370","25245657","12","37330"
"chr5","25290206","25290501","chr20","25253165","25253473","22","37041"
"chr5","25291575","25291865","chr20","25254549","25254838","11","37026"
"chr5","25296092","25296281","chr20","25259224","25259413","2","36868"
"chr5","25297263","25297539","chr1","41753520","41753796","63","16456257"
"chr5","25298867","25299151","chr20","25261929","25262213","7","36938"
"chr5","25316732","25317020","chr20","25279556","25279853","17","37176"
"chr5","25328355","25328651","chr15","70204095","70204396","55","44875740"
"chr5","25357655","25357958","chr20","25322046","25322361","18","35609"
"chr5","25365398","25365560","chr20","25329697","25329865","13","35701"
"chr5","25365689","25365814","chr20","25329930","25330046","12","35759"
"chr5","25377851","25377977","chr20","3986642","3986770","28","21391209"
"chr5","25393927","25394217","chr20","25357859","25358136","25","36068"
"chr5","25394262","25394285","chr9","13477959","13477979","4","11916303"
"chr5","25398390","25398680","chr20","25362449","25362730","22","35941"
"chr5","25413251","25413555","chr20","25377062","25377367","11","36189"
"chr5","25444844","25444993","chr6","131494129","131494271","30","106049285"
"chr5","25451915","25452224","chr20","25415941","25416254","9","35974"
"chr5","25454460","25454750","chr20","25418196","25418479","18","36264"
"chr5","25512875","25513159","chr20","25477881","25478165","10","34994"
"chr5","25527914","25527929","chr20","25492929","25492944","1","34985"
"chr5","25528066","25528182","chr20","25493080","25493197","4","34986"
"chr5","25528553","25528589","chr20","25493566","25493602","0","34987"
"chr5","25552228","25552523","chr16","67819115","67819407","56","42266887"
"chr5","25558558","25558688","chr20","25522622","25522752","4","35936"
"chr5","25566612","25566916","chr20","25530684","25530988","12","35928"
"chr5","25572025","25572326","chr20","25536099","25536400","9","35926"
"chr5","25575091","25575255","chr20","25539175","25539339","8","35916"
"chr5","25578718","25578843","chr20","25542807","25542927","7","35911"
"chr5","25579214","25579393","chr20","25543298","25543476","3","35916"
"chr5","25587555","25587864","chr20","25551789","25552099","17","35766"
"chr5","25593852","25593971","chr20","25558076","25558195","1","35776"
"chr5","25594277","25594338","chr20","25558491","25558562","11","35786"
"chr5","25611107","25611417","chr20","25577383","25577694","20","33724"
"chr5","25614877","25614904","chr7","41635140","41635166","4","16020263"
"chr5","25614970","25615118","chr20","25581453","25581600","6","33517"
"chr5","25627890","25628090","chr10","75919977","75920176","48","50292087"
"chr5","25646549","25646715","chr20","25614868","25615042","15","31681"
"chr5","25705229","25705537","chr20","25673653","25673947","21","31576"
"chr5","25720035","25720185","chr20","25688546","25688695","9","31489"
"chr5","25725466","25725703","chr20","25693963","25694200","4","31503"
"chr5","25738745","25739042","chr20","25707420","25707716","9","31325"
"chr5","25741318","25741628","chr20","25709993","25710303","10","31325"
"chr5","25745858","25746150","chr20","25716501","25716803","20","29357"
"chr5","25754570","25754886","chr20","25725805","25726104","25","28765"
"chr5","25769176","25769483","chr20","25740300","25740606","16","28876"
"chr5","25773116","25773416","chr20","25744241","25744541","7","28875"
"chr5","25777282","25777585","chr10","13389158","13389451","60","12388124"
"chr5","25791741","25791816","chr20","25761665","25761740","2","30076"
"chr5","25820444","25820744","chr20","25790164","25790458","13","30280"
"chr5","25849386","25849533","chr14","21241881","21242020","39","4607505"
"chr5","25860112","25860285","chr6","127630083","127630251","28","101769971"
"chr5","25860311","25860482","chr12","93466662","93466820","45","67606351"
"chr5","25862546","25862838","chr20","25832833","25833125","4","29713"
"chr5","25871278","25871416","chr10","82442785","82442922","25","56571507"
"chr5","25876039","25876233","chr1","150593735","150593929","41","124717696"
"chr5","25876412","25876524","chr4","129969820","129969934","29","104093408"
"chr5","25887342","25887628","chr20","25857833","25858119","8","29509"
"chr5","25902307","25902603","chr20","25872872","25873167","10","29435"
"chr5","25909772","25910066","chr20","25880316","25880597","17","29456"
"chr5","25912813","25912859","chr8","85459627","85459674","12","59546814"
"chr5","25913729","25913764","chr2","81811835","81811870","9","55898106"
"chr5","25915106","25915420","chr20","25885848","25886162","7","29258"
"chr5","25919322","25919622","chr20","25889850","25890155","13","29472"
"chr5","25920952","25921224","chr20","25891496","25891768","6","29456"
"chr5","25923696","25923997","chr20","25894391","25894693","12","29305"
"chr5","25932422","25932641","chr20","25907189","25907404","13","25233"
"chr5","25934787","25935082","chr20","25909541","25909836","6","25246"
"chr5","25942522","25942656","chr20","25917849","25917983","2","24673"
"chr5","25944832","25945123","chr20","25920194","25920485","2","24638"
"chr5","25948458","25948715","chr19","15856154","15856393","57","10092304"
"chr5","25962209","25962501","chr3","2443494","2443769","70","23518715"
"chr5","25963844","25964032","chr14","67878831","67878995","58","41914987"
"chr5","25964335","25964480","chr3","44977261","44977396","37","19012926"
"chr5","25965370","25965594","chr20","25942010","25942234","1","23360"
"chr5","25967560","25967867","chr20","25944193","25944501","5","23367"
"chr5","25975515","25975688","chr20","25952001","25952174","2","23514"
"chr5","25981947","25982229","chr20","25958324","25958607","4","23623"
"chr5","25986669","25986978","chr20","25963163","25963474","5","23506"
"chr5","26010801","26011081","chr20","25988052","25988334","11","22749"
"chr5","26013974","26014118","chr20","25991261","25991409","5","22713"
"chr5","26014216","26014402","chr20","25991507","25991693","4","22709"
"chr5","26030769","26030899","chr15","29077601","29077731","26","3046832"
"chr5","26032324","26032487","chr13","37888752","37888912","30","11856428"
"chr5","26041093","26041394","chr20","26017964","26018265","21","23129"
"chr5","26060395","26060572","chr20","26038376","26038553","5","22019"
"chr5","26074712","26074993","chr20","26053379","26053677","31","21333"
"chr5","26076934","26077219","chr20","26056936","26057224","8","19998"
"chr5","26081178","26081454","chr20","26060929","26061205","11","20249"
"chr5","26082086","26082392","chr20","26062189","26062470","32","19897"
"chr5","26086539","26086706","chr20","26066608","26066775","2","19931"
"chr5","26101926","26102220","chr20","26081563","26081867","13","20363"
"chr5","26109732","26109819","chr17","15917356","15917444","21","10192376"
"chr5","26115169","26115267","chr20","26094778","26094876","4","20391"
"chr5","26116621","26116951","chr20","26096230","26096534","39","20391"
"chr5","26122443","26122569","chr20","26102213","26102339","1","20230"
"chr5","26128834","26128995","chr18","13763591","13763753","29","12365243"
"chr5","26129278","26129411","chr19","41670458","41670593","15","15541180"
"chr5","26133220","26133537","chr20","26127397","26127710","11","5823"
"chr5","26148278","26148574","chr20","26129681","26129976","9","18597"
"chr5","26156429","26156740","chr20","26138286","26138594","18","18143"
"chr5","26162169","26162474","chr20","26142827","26143132","5","19342"
"chr5","26171412","26171593","chr2","152175373","152175556","36","126003961"
"chr5","26174483","26174658","chr20","26155722","26155886","21","18761"
"chr5","26174969","26175102","chr20","26156195","26156327","7","18774"
"chr5","26177235","26177534","chr20","26158448","26158758","16","18787"
"chr5","26180468","26180794","chr20","26161668","26162003","14","18800"
"chr5","26200701","26201026","chr20","26181983","26182311","10","18718"
"chr5","26211343","26211639","chr20","17950468","17950764","54","8260875"
"chr5","26227869","26228149","chr3","160779854","160780124","60","134551985"
"chr5","26235858","26236110","chr20","26220572","26220824","4","15286"
"chr5","26241997","26242282","chr20","26226251","26226528","14","15746"
"chr5","26244162","26244493","chr20","26228409","26228725","21","15753"
"chr5","26250951","26251057","chr20","26234468","26234574","2","16483"
"chr5","26267504","26267777","chr20","26253380","26253653","4","14124"
"chr5","26269422","26269706","chr20","26255275","26255562","15","14147"
"chr5","26271302","26271476","chr20","26257389","26257560","8","13913"
"chr5","26272287","26272434","chr20","26258376","26258523","7","13911"
"chr5","26272725","26272888","chr20","26258811","26258974","8","13914"
"chr5","26287135","26287340","chr18","71888328","71888531","37","45601193"
"chr5","26295489","26295621","chr20","26279634","26279766","3","15855"
"chr5","26301208","26301489","chr20","26285537","26285818","8","15671"
"chr5","26315978","26316267","chr20","26317204","26317514","26","1226"
"chr5","26317834","26318112","chr20","26319067","26319376","37","1233"
"chr5","26324272","26324561","chr20","26328511","26328804","14","4239"
"chr5","26337909","26338024","chrX","44142645","44142756","29","17804736"
"chr5","26338508","26338526","chr3","20396144","20396158","8","5942364"
"chr5","26342066","26342150","chr2","76595940","76596024","16","50253874"
"chr5","26342329","26342632","chr20","26340980","26341279","6","1349"
"chr5","26370630","26370934","chr20","26639599","26639902","14","268969"
"chr5","26374468","26374600","chr20","26635900","26636041","12","261432"
"chr5","26376222","26376338","chr20","26634154","26634272","6","257932"
"chr5","26376378","26376573","chr20","26633921","26634090","29","257543"
"chr5","26391138","26391420","chr20","26615296","26615577","12","224158"
"chr5","26391850","26391979","chr20","26614749","26614875","19","222899"
"chr5","26392294","26392481","chr20","26614241","26614443","24","221947"
"chr5","26392521","26392675","chr15","57226583","57226735","33","30834062"
"chr5","26395515","26395696","chr20","26612038","26612199","30","216523"
"chr5","26395955","26396089","chr20","26611624","26611758","3","215669"
"chr5","26406988","26407129","chr20","26600518","26600659","4","193530"
"chr5","26407440","26407603","chr20","26600038","26600207","14","192598"
"chr5","26409573","26409873","chr20","26598087","26598396","17","188514"
"chr5","26415492","26415786","chr20","26591783","26592085","18","176291"
"chr5","26447957","26448250","chr20","26553476","26553768","11","105519"
"chr5","26454057","26454347","chr20","26553476","26553768","35","99419"
"chr5","26480906","26481252","chr7","129403533","129403873","61","102922627"
"chr5","26481548","26481843","chr20","26508304","26508599","4","26756"
"chr5","26490081","26490253","chr20","26494311","26494459","32","4230"
"chr5","26490543","26490571","chr4","128266989","128267011","12","101776446"
"chr5","26494699","26494943","chr20","26492782","26493027","7","1917"
"chr5","26506521","26506820","chr20","26482691","26482990","9","23830"
"chr5","26518301","26518436","chr20","26465974","26466110","5","52327"
"chr5","26518700","26518863","chr20","26465557","26465720","2","53143"
"chr5","26520086","26520342","chr3","150123326","150123578","71","123603240"
"chr5","26521020","26521097","chr9","95214091","95214171","9","68693071"
"chr5","26528125","26528273","chr20","26456125","26456270","5","72000"
"chr5","26528303","26528484","chr20","26455919","26456083","21","72384"
"chr5","26530396","26530685","chr20","26454084","26454365","15","76312"
"chr5","26552538","26552548","chr20","26431978","26431988","0","120560"
"chr5","26552853","26553003","chr20","26431523","26431673","3","121330"
"chr5","26569233","26569528","chr20","26411858","26412153","3","157375"
"chr5","26590756","26590854","chr20","26390043","26390141","3","200713"
"chr5","26602711","26603000","chr20","26377188","26377477","3","225523"
"chr5","26615228","26615456","chr7","16197144","16197369","42","10418084"
"chr5","26624869","26625059","chr5","35383631","35383814","45","8758762"
"chr5","26629161","26629445","chr1","188892932","188893211","59","162263771"
"chr5","26630753","26631063","chr7","111535507","111535810","56","84904754"
"chr5","26643416","26643595","chrX","121706745","121706913","55","95063329"
"chr5","26643908","26644031","chr7","158268065","158268192","28","131624157"
"chr5","26646486","26646749","chr7","35476945","35477208","62","8830459"
"chr5","26647457","26647686","chr9","59289779","59290004","44","32642322"
"chr5","26663884","26664088","chrX","57131789","57132001","51","30467905"
"chr5","26690971","26691179","chr9","51781414","51781619","30","25090443"
"chr5","26692705","26693013","chr4","152226280","152226592","62","125533575"
"chr5","26696016","26696356","chr7","158457783","158458119","64","131761767"
"chr5","26700223","26700497","chr9","56456050","56456320","68","29755827"
"chr5","26704461","26704779","chr3","90024446","90024766","62","63319985"
"chr5","26705573","26705676","chr1","18679165","18679266","20","8026408"
"chr5","26706457","26706627","chr20","3120863","3121026","38","23585594"
"chr5","26714854","26715162","chr16","45630263","45630556","67","18915409"
"chr5","26718063","26718372","chr13","41448795","41449103","54","14730732"
"chr5","26723152","26723459","chr13","45789004","45789300","63","19065852"
"chr5","26725245","26725389","chr2","69717880","69718018","21","42992635"
"chr5","26753600","26753719","chr1","135394832","135394955","22","108641232"
"chr5","26762593","26762889","chr1","23009025","23009318","59","3753568"
"chr5","26773047","26773345","chrX","46046489","46046783","60","19273442"
"chr5","26774380","26774692","chr7","123760682","123760996","61","96986302"
"chr5","26798469","26798771","chr7","3904429","3904730","60","22894040"
"chr5","26798789","26799074","chr13","43004999","43005302","61","16206210"
"chr5","26813304","26813612","chr5","166638879","166639188","55","139825575"
"chr5","26816791","26817082","chr4","35119120","35119410","54","8302329"
"chr5","26820205","26820365","chr15","34671369","34671534","34","7851164"
"chr5","26820668","26820680","chr1","8928246","8928258","4","17892422"
"chr5","26851834","26852137","chr13","86694872","86695169","51","59843038"
"chr5","26867176","26867363","chr15","36190565","36190758","36","9323389"
"chr5","26869814","26869968","chr4","36434228","36434382","38","9564414"
"chr5","26882899","26883181","chr4","17887711","17887996","62","8995188"
"chr5","26886219","26886516","chr16","18768739","18769026","50","8117480"
"chr5","26906906","26907212","chr2","101764441","101764747","50","74857535"
"chr5","26911628","26911900","chr6","133751210","133751481","66","106839582"
"chr5","26913887","26914176","chr20","10150898","10151192","59","16762989"
"chr5","26915799","26916111","chr13","73475897","73476202","62","46560098"
"chr5","26920426","26920627","chr2","48085697","48085895","32","21165271"
"chr5","26920815","26920985","chr15","36889646","36889809","34","9968831"
"chr5","26922684","26922991","chrX","41341410","41341721","53","14418726"
"chr5","26959619","26959789","chr3","44961085","44961258","38","18001466"
"chr5","26962159","26962447","chr7","125147857","125148143","48","98185698"
"chr5","26963731","26963985","chr13","24581020","24581268","55","2382711"
"chr5","26967415","26967583","chr1","17629970","17630130","30","9337445"
"chr5","26980249","26980434","chr19","30150601","30150791","37","3170352"
"chr5","26983081","26983377","chr7","26648001","26648299","60","335080"
"chr5","26997199","26997490","chr9","30335894","30336181","73","3338695"
"chr5","27001953","27002095","chr1","159683620","159683764","22","132681667"
"chr5","27002560","27002744","chr13","8850619","8850781","52","18151941"
"chr5","27015392","27015698","chr14","6799945","6800241","58","20215447"
"chr5","27024482","27024794","chrX","17125928","17126236","69","9898554"
"chr5","27039716","27039850","chr11","1808170","1808304","21","25231546"
"chr5","27057484","27057771","chr17","23603080","23603370","53","3454404"
"chr5","27064855","27064915","chr9","57301970","57302028","9","30237115"
"chr5","27068196","27068493","chr8","136921807","136922110","64","109853611"
"chr5","27071277","27071565","chr11","4477603","4477893","49","22593674"
"chr5","27074037","27074119","chr1","62136872","62136956","17","35062835"
"chr5","27076669","27076942","chr11","60739485","60739780","62","33662816"
"chr5","27076965","27077118","chr1","185923305","185923457","20","158846340"
"chr5","27082647","27082814","chr1","41621732","41621898","36","14539085"
"chr5","27086285","27086602","chr8","128593269","128593566","63","101506984"
"chr5","27094021","27094162","chr10","72116415","72116555","23","45022394"
"chr5","27103962","27104107","chr16","22932775","22932908","33","4171187"
"chr5","27105029","27105108","chr14","55622376","55622453","16","28517347"
"chr5","27108576","27108656","chr1","93795970","93796048","11","66687394"
"chr5","27109122","27109309","chr8","136041581","136041762","46","108932459"
"chr5","27114053","27114341","chr14","55839880","55840167","52","28725827"
"chr5","27120433","27120725","chr9","94574568","94574863","52","67454135"
"chr5","27132814","27132933","chr3","10751739","10751848","31","16381075"
"chr5","27145031","27145244","chr6","35266842","35267046","45","8121811"
"chr5","27148912","27149048","chr16","1698484","1698613","21","25450428"
"chr5","27154456","27154733","chr12","102613936","102614198","51","75459480"
"chr5","27155939","27156202","chr9","59668702","59668973","64","32512763"
"chr5","27160885","27161177","chr15","23211398","23211693","61","3949487"
"chr5","27162499","27162763","chr20","29257694","29257942","56","2095195"
"chr5","27166757","27166830","chr4","150609236","150609309","18","123442479"
"chr5","27167114","27167282","chr15","598374","598523","46","26568740"
"chr5","27178131","27178265","chr16","4095055","4095189","16","23083076"
"chr5","27178588","27178756","chr9","20868136","20868298","32","6310452"
"chr5","27180860","27180955","chr19","47941069","47941164","19","20760209"
"chr5","27181505","27181686","chr2","45653846","45654022","43","18472341"
"chr5","27182358","27182527","chr7","38789439","38789604","32","11607081"
"chr5","27182745","27182756","chr1","22794806","22794817","2","4387939"
"chr5","27205215","27205492","chr13","92792576","92792858","52","65587361"
"chr5","27216536","27216830","chr17","12592056","12592353","67","14624480"
"chr5","27243365","27243515","chr1","161109582","161109735","27","133866217"
"chr5","27243704","27243751","chr1","46432746","46432787","16","19189042"
"chr5","27244056","27244182","chr2","87140260","87140382","25","59896204"
"chr5","27253835","27254119","chr20","26689379","26689663","9","564456"
"chr5","27264339","27264622","chr20","26701059","26701341","9","563280"
"chr5","27266478","27266760","chr20","26703191","26703493","27","563287"
"chr5","27266781","27266943","chr7","117936452","117936611","31","90669671"
"chr5","27267254","27267271","chr13","99878230","99878245","3","72610976"
"chr5","27276505","27276524","chr20","26714216","26714235","0","562289"
"chr5","27276572","27276851","chr20","26714268","26714547","8","562304"
"chr5","27277848","27278155","chr20","26715543","26715843","23","562305"
"chr5","27281149","27281430","chr20","26719159","26719440","12","561990"
"chr5","27281466","27281614","chr20","26719484","26719631","4","561982"
"chr5","27285015","27285298","chr20","26722874","26723157","3","562141"
"chr5","27300393","27300548","chr12","93466662","93466820","29","66166269"
"chr5","27302327","27302613","chr20","26740492","26740803","33","561835"
"chr5","27317247","27317527","chr20","26758629","26758899","19","558618"
"chr5","27322432","27322750","chr20","26762703","26763029","19","559729"
"chr5","27329493","27329620","chr20","26773931","26774058","1","555562"
"chr5","27329926","27330145","chr20","26774363","26774587","5","555563"
"chr5","27330693","27330860","chr20","26775145","26775312","1","555548"
"chr5","27337539","27337831","chr2","147298646","147298934","55","119961107"
"chr5","27361663","27361954","chrX","36812579","36812875","50","9450916"
"chr5","27363865","27364103","chr20","26809017","26809255","7","554848"
"chr5","27393423","27393733","chr20","26839843","26840153","7","553580"
"chr5","27397338","27397510","chr20","26843765","26843947","15","553573"
"chr5","27397550","27397687","chr19","39407794","39407943","32","12010244"
"chr5","27415193","27415347","chr20","26863368","26863519","7","551825"
"chr5","27415648","27415776","chr20","26863815","26863945","6","551833"
"chr5","27419662","27419942","chr20","26867841","26868114","12","551821"
"chr5","27419943","27420242","chr20","26868115","26868413","7","551828"
"chr5","27476359","27476491","chr13","24013166","24013306","35","3463193"
"chr5","27476791","27476982","chr7","49055521","49055705","43","21578730"
"chr5","27485164","27485341","chr20","26935366","26935547","6","549798"
"chr5","27486428","27486675","chr20","26936633","26936880","4","549795"
"chr5","27499370","27499442","chr20","16689970","16690035","18","10809400"
"chr5","27534390","27534495","chr7","129593815","129593910","27","102059425"
"chr5","27534795","27534843","chr1","8856121","8856171","8","18678674"
"chr5","27553569","27553858","chr20","27013922","27014214","7","539647"
"chr5","27564285","27564438","chr19","4471077","4471218","31","23093208"
"chr5","27564442","27564509","chrX","39114961","39115027","17","11550519"
"chr5","27580999","27581193","chr20","27042934","27043128","5","538065"
"chr5","27581915","27582229","chr20","27044204","27044513","13","537711"
"chr5","27585912","27586194","chr20","27048193","27048471","4","537719"
"chr5","27606620","27606818","chr20","27063970","27064148","24","542650"
"chr5","27607470","27607748","chr5","34581916","34582195","58","6974446"
"chr5","27633972","27634137","chr20","27091802","27091965","4","542170"
"chr5","27643864","27644137","chr20","27101681","27101962","15","542183"
"chr5","27645147","27645176","chr20","27102992","27103021","0","542155"
"chr5","27645482","27645741","chr20","27103340","27103596","13","542142"
"chr5","27662370","27662583","chr20","27120216","27120422","13","542154"
"chr5","27666737","27666993","chr20","27123688","27123941","15","543049"
"chr5","27685577","27685866","chr9","69412550","69412830","63","41726973"
"chr5","27691679","27691836","chr20","27148039","27148194","3","543640"
"chr5","27692096","27692204","chr10","30484458","30484572","24","2792362"
"chr5","27698404","27698687","chr17","11480634","11480920","55","16217770"
"chr5","27709594","27709901","chr20","27160084","27160391","16","549510"
"chr5","27712496","27712801","chr15","55843644","55843940","52","28131148"
"chr5","27714489","27714663","chr20","27171841","27172026","16","542648"
"chr5","27722409","27722700","chr20","27179349","27179640","8","543060"
"chr5","27729878","27729960","chr20","27187945","27188027","3","541933"
"chr5","27732348","27732636","chr20","27190424","27190717","12","541924"
"chr5","27739830","27740134","chr4","112947774","112948074","56","85207944"
"chr5","27756511","27756813","chr20","27219840","27220142","3","536671"
"chr5","27774590","27774882","chr20","27237939","27238231","6","536651"
"chr5","27777780","27778078","chr11","1016585","1016893","59","26761195"
"chr5","27780477","27780784","chr2","47470757","47471039","77","19690280"
"chr5","27807313","27807459","chr3","15494854","15494998","37","12312459"
"chr5","27824007","27824331","chr20","27295109","27295440","10","528898"
"chr5","27851378","27851515","chr19","13173005","13173138","22","14678373"
"chr5","27857321","27857394","chr3","47617372","47617450","12","19760051"
"chr5","27857395","27857499","chr12","80509677","80509785","27","52652282"
"chr5","27862090","27862374","chr20","27337790","27338074","13","524300"
"chr5","27863034","27863320","chr20","27338634","27338922","6","524400"
"chr5","27884851","27885155","chr20","27357986","27358285","16","526865"
"chr5","27888516","27888648","chr20","27363240","27363372","4","525276"
"chr5","27888916","27889018","chr20","27363653","27363755","3","525263"
"chr5","27899354","27899655","chrX","27894759","27895057","55","4595"
"chr5","27902004","27902145","chr20","27377301","27377442","2","524703"
"chr5","27903072","27903264","chr20","27386299","27386486","9","516773"
"chr5","27916930","27917096","chr1","34737481","34737621","46","6820551"
"chr5","27922320","27922602","chr20","27399723","27400016","20","522597"
"chr5","27935174","27935318","chr7","43497058","43497204","35","15561884"
"chr5","27949333","27949640","chrX","60143324","60143625","59","32193991"
"chr5","27958473","27958770","chr20","27429621","27429913","10","528852"
"chr5","27958838","27958993","chr20","27429969","27430124","2","528869"
"chr5","27960885","27961171","chr20","27418581","27418867","5","542304"
"chr5","27973842","27974143","chr20","27436053","27436353","11","537789"
"chr5","28011184","28011465","chr20","27476885","27477159","19","534299"
"chr5","28012808","28013066","chr13","57971791","57972040","64","29958983"
"chr5","28020032","28020323","chr20","27486653","27486937","26","533379"
"chr5","28036723","28037032","chr20","27504126","27504434","5","532597"
"chr5","28075340","28075668","chr9","24068882","24069202","71","4006458"
"chr5","28088079","28088382","chr20","27556774","27557074","16","531305"
"chr5","28103252","28103435","chr11","113835613","113835796","36","85732361"
"chr5","28119410","28119739","chr20","27586715","27587057","25","532695"
"chr5","28133315","28133503","chr20","27605139","27605312","27","528176"
"chr5","28133718","28133792","chr20","27598270","27598344","2","535448"
"chr5","28154449","28154755","chr20","27624246","27624552","9","530203"
"chr5","28154756","28154882","chr20","27624553","27624679","1","530203"
"chr5","28161342","28161529","chr20","27631045","27631232","10","530297"
"chr5","28175811","28176105","chr20","27646196","27646506","24","529615"
"chr5","28181789","28182071","chr20","27652195","27652479","7","529594"
"chr5","28192224","28192470","chr20","27662955","27663231","35","529269"
"chr5","28194709","28194836","chr3","173613198","173613322","23","145418489"
"chr5","28195131","28195189","chr20","5048738","5048794","13","23146393"
"chr5","28212323","28212620","chr20","27683119","27683404","23","529204"
"chr5","28215474","28215648","chr6","69024868","69025040","36","40809394"
"chr5","28291240","28291506","chr20","27933999","27934259","11","357241"
"chr5","28303046","28303318","chr20","27922540","27922809","9","380506"
"chr5","28309111","28309391","chr20","27916197","27916447","53","392914"
"chr5","28374478","28374774","chr20","27866122","27866417","6","508356"
"chr5","28422195","28422445","chr20","27916197","27916447","5","505998"
"chr5","28428209","28428481","chr20","27922540","27922809","9","505669"
"chr5","28439276","28439530","chr16","66353696","66353968","69","37914420"
"chr5","28516673","28516941","chr20","28012576","28012844","3","504097"
"chr5","28646694","28646999","chr20","28112059","28112362","13","534635"
"chr5","28653699","28653997","chr1","137944096","137944395","66","109290397"
"chr5","28688704","28688784","chr20","28151296","28151389","17","537408"
"chr5","28694907","28695199","chr20","28157464","28157773","29","537443"
"chr5","28735992","28736289","chr20","28206502","28206799","13","529490"
"chr5","28758131","28758386","chr20","28226495","28226750","6","531636"
"chr5","28760864","28760961","chr20","28230641","28230738","1","530223"
"chr5","28765219","28765482","chr20","28235051","28235315","7","530168"
"chr5","28769642","28769936","chr20","28239502","28239796","11","530140"
"chr5","28771296","28771585","chr20","28241167","28241456","8","530129"
"chr5","28774033","28774326","chr20","28243900","28244200","18","530133"
"chr5","28774551","28774849","chr20","28244425","28244714","21","530126"
"chr5","28776656","28776967","chr20","28246476","28246789","13","530180"
"chr5","28777329","28777584","chr20","28247137","28247389","13","530192"
"chr5","28794476","28794798","chr20","28264994","28265306","20","529482"
"chr5","28797272","28797435","chr7","51858484","51858651","35","23061212"
"chr5","28836265","28836555","chr20","28304960","28305238","19","531305"
"chr5","28837092","28837232","chr7","65157340","65157477","36","36320248"
"chr5","28872298","28872362","chr1","86128485","86128542","15","57256187"
"chr5","28885325","28885578","JH681259","25555","25838","52","28859770"
"chr5","28905844","28906127","chr3","124901104","124901390","76","95995260"
"chr5","28963650","28963936","chr5","55622599","55622883","74","26658949"
"chr5","28990571","28990858","JH681259","25555","25838","29","28965016"
"chr5","29005588","29005787","chrX","108570575","108570790","59","79564987"
"chr5","29016131","29016409","chr20","15636418","15636699","70","13379713"
"chr5","29039111","29039400","chr1","28104773","28105052","76","934338"
"chr5","29129588","29129760","chr14","15335040","15335211","37","13794548"
"chr5","31459793","31460091","chr9","31815451","31815746","66","355658"
"chr5","31469924","31470214","chrX","44083154","44083444","55","12613230"
"chr5","31580540","31580805","chr16","6879134","6879396","53","24701406"
"chr5","31587068","31587232","chr1","125076167","125076330","37","93489099"
"chr5","31587274","31587391","chr7","11869238","11869356","30","19718036"
"chr5","31695499","31695708","chr18","1681872","1682084","33","30013627"
"chr5","31732392","31732695","chr20","29058691","29059002","30","2673701"
"chr5","31750300","31750598","chr20","28920667","28920978","46","2829633"
"chr5","31761319","31761409","chr20","28891862","28891948","5","2869457"
"chr5","31800944","31801240","chr5","46461086","46461387","66","14660142"
"chr5","31808064","31808371","chr20","28112059","28112362","41","3696005"
"chr5","31826695","31826986","chr20","28812145","28812436","4","3014550"
"chr5","31835666","31835939","chr20","29118821","29119076","33","2716845"
"chr5","31846967","31847259","chr20","28206502","28206799","39","3640465"
"chr5","31866047","31866320","chr20","28226495","28226750","37","3639552"
"chr5","31869756","31870020","chr9","17956914","17957182","61","13912842"
"chr5","31875962","31876251","chr20","28239502","28239796","30","3636460"
"chr5","31880294","31880489","chr20","62793124","62793314","34","30912830"
"chr5","31896996","31897319","chr20","28264994","28265306","37","3632002"
"chr5","31929194","31929489","chr20","28304960","28305238","49","3624234"
"chr5","31996369","31996655","chr20","28786928","28787223","40","3209441"
"chr5","31999501","31999782","chr1","109215125","109215406","58","77215624"
"chr5","32127513","32127722","chr18","1681872","1682084","34","30445641"
"chr5","32198762","32199085","chr20","28112059","28112362","44","4086703"
"chr5","32215720","32216016","chr20","28786928","28787223","22","3428792"
"chr5","32219652","32219891","chr20","28783073","28783299","17","3436579"
"chr5","32251766","32252048","chr20","29115933","29116220","44","3135833"
"chr5","32285267","32285573","chr20","28112059","28112362","39","4173208"
"chr5","32357523","32357803","chr20","28915583","28915855","20","3441940"
"chr5","32401546","32401848","chr20","28964877","28965179","5","3436669"
"chr5","32430903","32431026","chr19","3829476","3829595","31","28601427"
"chr5","32431414","32431594","chr13","7960128","7960302","49","24471286"
"chr5","32439114","32439407","chr20","29034428","29034722","8","3404686"
"chr5","32465046","32465361","chr20","29058691","29059002","12","3406355"
"chr5","32481660","32481953","chr20","29075106","29075399","4","3406554"
"chr5","32503692","32503991","chr20","29095509","29095764","49","3408183"
"chr5","32527334","32527588","chr20","29118821","29119076","5","3408513"
"chr5","32546625","32546927","chr20","29138561","29138870","14","3408064"
"chr5","32557676","32557971","chr20","29155753","29156048","7","3401923"
"chr5","32563284","32563514","chr20","29148032","29148227","38","3415252"
"chr5","32567301","32567416","chr20","29162228","29162343","4","3405073"
"chr5","32572006","32572287","chr20","29166913","29167193","4","3405093"
"chr5","32580100","32580391","chr20","29174738","29175025","14","3405362"
"chr5","32583584","32583793","chr20","29178515","29178724","2","3405069"
"chr5","32586946","32587173","chr20","29181966","29182198","10","3404980"
"chr5","32600474","32600777","chr20","29195303","29195604","7","3405171"
"chr5","32605653","32605949","chr20","29208441","29208761","28","3397212"
"chr5","32606071","32606081","chr10","27946500","27946510","0","4659571"
"chr5","32606114","32606405","JH680271","4074","4364","58","32602040"
"chr5","32614782","32614938","chr20","29211540","29211695","4","3403242"
"chr5","32621006","32621315","chr20","29218120","29218429","6","3402886"
"chr5","32624636","32624942","chr20","29221734","29222040","2","3402902"
"chr5","32637123","32637430","chr20","29235075","29235388","13","3402048"
"chr5","32646444","32646744","chr20","29247773","29248037","48","3398671"
"chr5","32659885","32660142","chr20","29257694","29257942","10","3402191"
"chr5","32670664","32670818","chr20","29269515","29269669","5","3401149"
"chr5","32671201","32671356","chr15","11286512","11286654","32","21384689"
"chr5","32674433","32674592","chr20","29273277","29273446","10","3401156"
"chr5","32685843","32686049","chr20","29285139","29285348","5","3400704"
"chr5","32686229","32686487","chr20","29285528","29285792","10","3400701"
"chr5","32690030","32690318","chr16","8997476","8997752","58","23692554"
"chr5","32690718","32690802","chr9","95693762","95693842","18","63003044"
"chr5","32695126","32695227","chr20","29290541","29290642","1","3404585"
"chr5","32697868","32697958","chr20","29292992","29293079","5","3404876"
"chr5","32700150","32700396","chr2","38966184","38966423","72","6266034"
"chr5","32700872","32701185","chrX","44306757","44307052","87","11605885"
"chr5","32715811","32716111","chr20","29314936","29315236","10","3400875"
"chr5","32720159","32720445","chr20","29319252","29319538","5","3400907"
"chr5","32720903","32721063","chr20","29319994","29320152","4","3400909"
"chr5","32724892","32724959","chr20","29323968","29324037","4","3400924"
"chr5","32726959","32727265","chr20","29329408","29329711","17","3397551"
"chr5","32731782","32731932","chr6","144630022","144630156","36","111898240"
"chr5","32732848","32733118","chr20","29335817","29336088","11","3397031"
"chr5","32748521","32748704","chr20","29359115","29359298","4","3389406"
"chr5","32756835","32757005","chr20","29367598","29367768","1","3389237"
"chr5","32765810","32766109","chr20","29376849","29377150","13","3388961"
"chr5","32785525","32785790","chr20","29396682","29396947","4","3388843"
"chr5","32792274","32792516","chr20","29403742","29403983","4","3388532"
"chr5","32799916","32800093","chr9","94748227","94748404","42","61948311"
"chr5","32801467","32801719","chr20","29423044","29423296","4","3378423"
"chr5","32808025","32808275","chr8","69659063","69659312","66","36851038"
"chr5","32809453","32809771","chr20","29408011","29408329","3","3401442"
"chr5","32811051","32811332","chr7","60158670","60158946","63","27347619"
"chr5","32813006","32813273","chr20","29411274","29411540","6","3401732"
"chr5","32818293","32818438","chr6","42595918","42596055","50","9777625"
"chr5","32818439","32818505","chr3","127658426","127658498","18","94839987"
"chr5","32826103","32826410","chr20","29439078","29439339","54","3387025"
"chr5","32840250","32840552","chr20","29453515","29453816","6","3386735"
"chr5","32843947","32844251","chr20","29456383","29456683","6","3387564"
"chr5","32849419","32849708","chr20","29466262","29466551","3","3383157"
"chr5","32850571","32850663","chr20","29468215","29468307","1","3382356"
"chr5","32855588","32855896","chr20","29473860","29474167","5","3381728"
"chr5","32861215","32861520","chr20","29479044","29479348","15","3382171"
"chr5","32879374","32879679","chr20","29497099","29497403","4","3382275"
"chr5","32883194","32883506","chr11","119286245","119286555","56","86403051"
"chr5","32884178","32884463","chr20","29501908","29502193","9","3382270"
"chr5","32893129","32893435","chr20","29510883","29511190","8","3382246"
"chr5","32894688","32894976","chr20","29512422","29512725","17","3382266"
"chr5","32906579","32906891","chr20","29524340","29524643","17","3382239"
"chr5","32919537","32919836","chr20","29537331","29537634","27","3382206"
"chr5","32925401","32925692","chr20","29543307","29543600","10","3382094"
"chr5","32962794","32963106","chr20","29581010","29581317","23","3381784"
"chr5","32965060","32965184","chr20","29583273","29583397","2","3381787"
"chr5","32970672","32970836","chr20","29588843","29589003","5","3381829"
"chr5","33011024","33011303","chr20","29629754","29630033","9","3381270"
"chr5","33013808","33014094","chr20","29632475","29632764","7","3381333"
"chr5","33027608","33027896","chr20","29645478","29645779","17","3382130"
"chr5","33029242","33029496","chr20","29647123","29647378","5","3382119"
"chr5","33047558","33047841","chr20","29666182","29666465","4","3381376"
"chr5","33057099","33057305","chr20","29676980","29677186","2","3380119"
"chr5","33066606","33066880","chr20","29686299","29686605","35","3380307"
"chr5","33075946","33076260","chr20","29695037","29695339","19","3380909"
"chr5","33098009","33098176","chr11","112541490","112541655","32","79443481"
"chr5","33098484","33098602","chr20","29717366","29717484","3","3381118"
"chr5","33128499","33128800","chr13","41312881","41313177","74","8184382"
"chr5","33161412","33161697","chr20","29784777","29785066","11","3376635"
"chr5","33189980","33190241","chr20","29812843","29813104","6","3377137"
"chr5","33190424","33190571","chr20","29813285","29813434","4","3377139"
"chr5","33192198","33192299","chr20","29814736","29814837","3","3377462"
"chr5","33241450","33241741","chr20","29863693","29863985","11","3377757"
"chr5","33247968","33248097","chr19","11693182","11693309","37","21554786"
"chr5","33258264","33258554","chr20","29884402","29884692","5","3373862"
"chr5","33274001","33274321","chr20","29900128","29900449","13","3373873"
"chr5","33299061","33299338","chr20","29931375","29931652","2","3367686"
"chr5","33308930","33309231","chr3","28898267","28898572","56","4410663"
"chr5","33311836","33312117","chr20","29944521","29944800","4","3367315"
"chr5","33333874","33334162","chr20","29966784","29967072","4","3367090"
"chr5","33344219","33344522","chr20","29977441","29977746","6","3366778"
"chr5","33425047","33425198","chr20","13400200","13400348","25","20024847"
"chr5","33461389","33461693","chr20","30098170","30098479","9","3363219"
"chr5","33470951","33471046","chr20","30107772","30107867","0","3363179"
"chr5","33473457","33473761","chr20","30110270","30110575","5","3363187"
"chr5","33502940","33503237","chr20","30142042","30142331","14","3360898"
"chr5","33518393","33518707","chr20","30158840","30159139","21","3359553"
"chr5","33528877","33529005","chr20","30169319","30169446","5","3359558"
"chr5","33566784","33567047","chr20","30205531","30205816","30","3361253"
"chr5","33639556","33639835","chr20","30287222","30287509","14","3352334"
"chr5","33655936","33656253","chr20","30303617","30303935","16","3352319"
"chr5","33707711","33707858","chr20","30354785","30354934","7","3352926"
"chr5","33752976","33753142","chr20","30400156","30400320","3","3352820"
"chr5","33759606","33759791","chr13","102715671","102715855","35","68956065"
"chr5","33764498","33764775","chr20","30411972","30412250","12","3352526"
"chr5","33767632","33767940","chr20","30415109","30415420","7","3352523"
"chr5","33820904","33821197","chr5","118649129","118649420","54","84828225"
"chr5","33847296","33847599","chr20","30494611","30494915","6","3352685"
"chr5","33861088","33861420","chr20","30508374","30508672","46","3352714"
"chr5","33948895","33949202","chr20","30604502","30604816","23","3344393"
"chr5","33972378","33972553","chr20","30619190","30619366","22","3353188"
"chr5","33988494","33988781","chr20","30635265","30635565","18","3353229"
"chr5","33989377","33989649","chr20","30636157","30636429","3","3353220"
"chr5","33989882","33990162","chr20","30636662","30636942","7","3353220"
"chr5","33999102","33999387","chr20","30645881","30646182","19","3353221"
"chr5","34015003","34015268","chr20","30662124","30662389","2","3352879"
"chr5","34033175","34033482","chr20","30678432","30678739","9","3354743"
"chr5","34054697","34054998","chr20","30693444","30693743","8","3361253"
"chr5","34060621","34060923","chr20","30699430","30699732","5","3361191"
"chr5","34078056","34078391","chr20","30716817","30717152","2","3361239"
"chr5","34106701","34106844","chr20","30745838","30745981","5","3360863"
"chr5","34147184","34147482","chr4","35454882","35455179","42","1307698"
"chr5","34152888","34153174","chr20","30791868","30792154","3","3361020"
"chr5","34154868","34154986","chr5","96360141","96360256","19","62205273"
"chr5","34161578","34161876","chr20","30800484","30800768","18","3361094"
"chr5","34176970","34177235","chr20","30817069","30817335","3","3359901"
"chr5","34202380","34202631","chr12","94458994","94459250","58","60256614"
"chr5","34211062","34211218","chr20","30845737","30845895","4","3365325"
"chr5","34214136","34214294","chr14","6127478","6127641","27","28086658"
"chr5","34222889","34223178","chr20","30858745","30859040","10","3364144"
"chr5","34228854","34228967","chr3","34515363","34515472","23","286509"
"chr5","34233716","34234010","chr20","30870385","30870679","4","3363331"
"chr5","34237048","34237346","chr20","30873720","30874025","9","3363328"
"chr5","34249721","34249929","chrX","44838785","44839000","39","10589064"
"chr5","34255127","34255220","chr20","30892111","30892205","3","3363016"
"chr5","34256397","34256698","chr20","30893414","30893721","10","3362983"
"chr5","34261699","34261989","chr20","30898719","30899009","6","3362980"
"chr5","34267919","34268058","chr1","41557639","41557785","32","7289720"
"chr5","34268110","34268231","chr12","81113596","81113717","32","46845486"
"chr5","34269806","34269962","chr19","34130811","34130947","41","138995"
"chr5","34273599","34273755","chr20","30910634","30910790","6","3362965"
"chr5","34281193","34281502","chr20","30918235","30918540","22","3362958"
"chr5","34283589","34283899","chr14","108304405","108304714","40","74020816"
"chr5","34297845","34298023","chr20","30935460","30935643","8","3362385"
"chr5","34298064","34298181","chr20","30935684","30935801","1","3362380"
"chr5","34300470","34300758","chr20","30938079","30938369","10","3362391"
"chr5","34304596","34304906","chr20","30942211","30942503","28","3362385"
"chr5","34311448","34311760","chr20","30949390","30949693","23","3362058"
"chr5","34315631","34315923","chr4","7327839","7328133","53","26987792"
"chr5","34327653","34327965","chr10","12189247","12189557","51","22138406"
"chr5","34358079","34358370","chr20","30997929","30998226","19","3360150"
"chr5","34373263","34373549","chr20","31013142","31013428","5","3360121"
"chr5","34383753","34384037","chr20","31023629","31023912","6","3360124"
"chr5","34384678","34384872","chr20","31024555","31024753","5","3360123"
"chr5","34392055","34392089","chr20","31031693","31031727","0","3360362"
"chr5","34415813","34416027","chr20","31054685","31054900","10","3361128"
"chr5","34417288","34417560","chr20","31056144","31056416","2","3361144"
"chr5","34421843","34422160","chr20","31060683","31061000","6","3361160"
"chr5","34437237","34437445","chr20","31075994","31076205","10","3361243"
"chr5","34445642","34445936","chr20","31086858","31087138","22","3358784"
"chr5","34447297","34447592","chr20","31088493","31088787","9","3358804"
"chr5","34451051","34451327","chr20","31086858","31087138","17","3364193"
"chr5","34463441","34463497","chr20","31101370","31101423","4","3362071"
"chr5","34480908","34481227","chr20","31123434","31123754","5","3357474"
"chr5","34483869","34484015","chr13","110973793","110973925","31","76489924"
"chr5","34540251","34540411","chr20","31192354","31192514","1","3347897"
"chr5","34557679","34557809","chr20","31208082","31208212","2","3349597"
"chr5","34580102","34580396","chr20","31227508","31227801","6","3352594"
"chr5","34717836","34718121","chr20","31372173","31372459","5","3345663"
"chr5","34805479","34805689","chr20","48981396","48981605","35","14175917"
"chr5","34810496","34810802","chr20","31473859","31474161","12","3336637"
"chr5","34816742","34817026","chr20","31480092","31480376","4","3336650"
"chr5","34826999","34827291","chr4","34669088","34669380","56","157911"
"chr5","34872882","34873176","chr20","31535928","31536217","14","3336954"
"chr5","34920833","34921079","chr20","31585220","31585466","6","3335613"
"chr5","35093050","35093340","chr15","35834922","35835211","60","741872"
"chr5","35122878","35123169","chr20","31786229","31786520","5","3336649"
"chr5","35127469","35127747","chr20","31790814","31791092","9","3336655"
"chr5","35147015","35147311","chr20","31810383","31810689","14","3336632"
"chr5","35178284","35178559","chr20","31841865","31842156","24","3336419"
"chr5","35186064","35186352","chr20","31849654","31849947","10","3336410"
"chr5","35220099","35220281","chr20","31885242","31885424","3","3334857"
"chr5","35220882","35220945","chr20","31886007","31886070","3","3334875"
"chr5","35264975","35265265","chr20","31931519","31931810","9","3333456"
"chr5","35309931","35310253","chr20","31975996","31976318","5","3333935"
"chr5","35433567","35433702","chr20","32092121","32092256","0","3341446"
"chr5","35476602","35476873","chr20","32135653","32135925","11","3340949"
"chr5","35481021","35481176","chr20","32139861","32140025","10","3341160"
"chr5","35483405","35483693","chr1","34356554","34356838","54","1126851"
"chr5","35491166","35491482","chr20","32150035","32150343","15","3341131"
"chr5","35562698","35562958","chr20","32220718","32220934","47","3341980"
"chr5","35564981","35565295","chr20","32222955","32223267","11","3342026"
"chr5","35593540","35593839","chr9","33469327","33469615","65","2124213"
"chr5","35611900","35612171","chr20","32269811","32270082","0","3342089"
"chr5","35622881","35623156","chr20","32281006","32281280","11","3341875"
"chr5","35624996","35625295","chr20","32283126","32283425","5","3341870"
"chr5","35644462","35644770","chr20","32303175","32303470","21","3341287"
"chr5","35662307","35662617","chr20","32321440","32321751","5","3340867"
"chr5","35669697","35669959","chr20","32328805","32329085","34","3340892"
"chr5","35702508","35702582","chr18","38839209","38839283","15","3136701"
"chr5","35737119","35737417","chr20","32396062","32396363","12","3341057"
"chr5","35743834","35744123","chr20","32403115","32403408","11","3340719"
"chr5","35751017","35751330","chr20","32412622","32412940","12","3338395"
"chr5","35753761","35753916","chr16","18819593","18819742","34","16934168"
"chr5","35761606","35761893","chr20","32423188","32423494","37","3338418"
"chr5","35780761","35781054","chr20","32443200","32443486","25","3337561"
"chr5","35782952","35783089","chr20","19839889","19840018","43","15943063"
"chr5","35796096","35796381","chr20","32457709","32457967","33","3338387"
"chr5","35801996","35802267","chr20","32463782","32464054","10","3338214"
"chr5","35802995","35803239","chr2","75550330","75550579","46","39747335"
"chr5","35809726","35809893","chr20","32471962","32472131","8","3337764"
"chr5","35812416","35812716","chr20","32474639","32474939","9","3337777"
"chr5","35812880","35813009","chr3","170865908","170866033","28","135053028"
"chr5","35813669","35813807","chr14","115035774","115035918","28","79222105"
"chr5","35819535","35819812","chr20","32481763","32482039","5","3337772"
"chr5","35822765","35822964","chr14","265781","265976","55","35556984"
"chr5","35824285","35824524","chr14","55438360","55438588","47","19614075"
"chr5","35851786","35852103","chr20","32518909","32519226","9","3332877"
"chr5","35858199","35858340","chr3","10103537","10103656","37","25754662"
"chr5","35862719","35863016","chr20","32530171","32530468","5","3332548"
"chr5","35876310","35876451","chr20","32546424","32546564","3","3329886"
"chr5","35894567","35894855","chr20","32565125","32565413","6","3329442"
"chr5","35909245","35909516","chr20","32582102","32582368","8","3327143"
"chr5","35918106","35918394","chr20","32590656","32590944","10","3327450"
"chr5","35924227","35924382","chr8","75867115","75867266","35","39942888"
"chr5","35928060","35928382","chr20","32601704","32602031","16","3326356"
"chr5","35934505","35934516","chr19","10181868","10181879","0","25752637"
"chr5","35935827","35935978","chr20","32609171","32609329","9","3326656"
"chr5","35938875","35939167","chr20","32612213","32612539","42","3326662"
"chr5","35942418","35942710","chr20","32616077","32616369","2","3326341"
"chr5","35943511","35943782","chr20","32617170","32617440","5","3326341"
"chr5","35948015","35948163","chr1","48047025","48047171","33","12099010"
"chr5","35948618","35948758","chr20","6449244","6449388","28","29499374"
"chr5","35953563","35953864","chr13","92870661","92870964","55","56917098"
"chr5","35955070","35955289","chr10","89915538","89915755","36","53960468"
"chr5","35955563","35955854","chr2","90206774","90207060","61","54251211"
"chr5","35971733","35972039","chr20","32646618","32646924","5","3325115"
"chr5","35972054","35972342","chr20","32646939","32647227","5","3325115"
"chr5","35977256","35977521","chr20","32652146","32652426","18","3325110"
"chr5","35977906","35978199","chr20","32652812","32653105","8","3325094"
"chr5","35990452","35990712","chr20","32664746","32665007","7","3325706"
"chr5","35995488","35995791","chr20","32669646","32669976","33","3325842"
"chr5","36033733","36033899","chr7","53483520","53483679","32","17449787"
"chr5","36034970","36035079","chr4","24203833","24203951","23","11831137"
"chr5","36037600","36037733","chr20","32712421","32712554","6","3325179"
"chr5","36041963","36042091","chr20","32716912","32717041","3","3325051"
"chr5","36045637","36045940","chr20","32720580","32720884","5","3325057"
"chr5","36054158","36054461","chr7","46240539","46240847","61","10186381"
"chr5","36056428","36056731","chr20","32731123","32731424","10","3325305"
"chr5","36068683","36068964","chrX","48614135","48614413","53","12545452"
"chr5","36084689","36085000","chr20","55616261","55616560","69","19531572"
"chr5","36094573","36094868","chr20","32771545","32771849","14","3323028"
"chr5","36158022","36158317","chr20","32836118","32836413","4","3321904"
"chr5","36172076","36172221","chr11","111931690","111931822","28","75759614"
"chr5","36206826","36207065","chr19","1491402","1491643","63","34715424"
"chr5","36207106","36207153","chr3","39246422","39246462","11","3039316"
"chr5","36211259","36211471","chr20","32888196","32888408","12","3323063"
"chr5","36231693","36231992","chr20","32908522","32908821","10","3323171"
"chr5","36240208","36240356","chr6","65604236","65604384","25","29364028"
"chr5","36265156","36265453","chr20","32942417","32942714","7","3322739"
"chr5","36284019","36284284","chr20","32961263","32961530","15","3322756"
"chr5","36315535","36315821","chr19","37113323","37113611","59","797788"
"chr5","36428215","36428484","chr1","166123895","166124171","55","129695680"
"chr5","36453279","36453412","chr1","93048486","93048623","27","56595207"
"chr5","36455868","36456224","chr13","27285479","27285815","91","9170389"
"chr5","36545106","36545384","chr20","33217247","33217525","9","3327859"
"chr5","36547968","36548275","chr20","33220112","33220420","12","3327856"
"chr5","36579205","36579517","chr20","33251993","33252282","33","3327212"
"chr5","36638339","36638650","chr4","127145417","127145738","63","90507078"
"chr5","36698618","36698958","chr6","165957835","165958144","78","129259217"
"chr5","36708673","36708973","chr20","33382266","33382575","19","3326407"
"chr5","36858720","36858734","chr1","12914116","12914128","4","23944604"
"chr5","36859097","36859261","chr20","33533522","33533683","25","3325575"
"chr5","36868646","36868954","chr20","33543094","33543401","4","3325552"
"chr5","36879087","36879384","chr20","33553806","33554103","7","3325281"
"chr5","36894026","36894320","chr20","33568705","33569029","37","3325321"
"chr5","36898168","36898372","chr20","33572842","33573046","1","3325326"
"chr5","36900637","36900916","chr20","33575311","33575590","9","3325326"
"chr5","36913863","36914143","chr20","33588664","33588944","7","3325199"
"chr5","36921866","36922192","chr20","33596707","33597034","10","3325159"
"chr5","36975930","36976221","chr20","33650736","33651027","9","3325194"
"chr5","36997101","36997273","chr20","33671891","33672063","6","3325210"
"chr5","36997996","36998160","chr20","33672783","33672947","9","3325213"
"chr5","37007461","37007620","chr20","33682927","33683086","5","3324534"
"chr5","37060691","37060907","chr20","33735150","33735366","6","3325541"
"chr5","37125054","37125349","chr20","33798631","33798926","12","3326423"
"chr5","37139803","37140107","chr20","33813325","33813629","17","3326478"
"chr5","37143590","37143878","chr20","33817014","33817302","5","3326576"
"chr5","37151949","37152221","chr20","33824838","33825110","4","3327111"
"chr5","37186362","37186656","chr20","33858939","33859238","17","3327423"
"chr5","37199362","37199512","chr20","33871959","33872109","5","3327403"
"chr5","37207634","37207897","chr20","33880093","33880356","6","3327541"
"chr5","37227676","37227957","chr20","33900001","33900282","8","3327675"
"chr5","37256220","37256540","chr20","33931738","33932058","13","3324482"
"chr5","37273805","37274105","chr9","35192580","35192878","67","2081225"
"chr5","37290255","37290542","chr20","33965548","33965834","7","3324707"
"chr5","37316287","37316415","chr20","33991876","33992004","6","3324411"
"chr5","37316456","37316611","chr20","33992033","33992188","1","3324423"
"chr5","37375094","37375226","chr20","34050109","34050242","5","3324985"
"chr5","37434471","37434604","chr20","34109489","34109622","0","3324982"
"chr5","37509289","37509378","chr20","34186260","34186349","2","3323029"
"chr5","37509424","37509564","chr20","34186395","34186529","6","3323029"
"chr5","37542359","37542677","chr11","101127654","101127960","61","63585295"
"chr5","37598793","37599080","chr20","34275571","34275848","15","3323222"
"chr5","37599893","37599946","chr20","34276683","34276736","1","3323210"
"chr5","37697696","37697872","chr20","34374556","34374732","4","3323140"
"chr5","37705403","37705694","chr20","34382246","34382537","2","3323157"
"chr5","37793624","37793932","chr20","34471100","34471414","12","3322524"
"chr5","37893200","37893502","chr20","34571139","34571434","10","3322061"
"chr5","37908169","37908465","chr20","34586466","34586762","23","3321703"
"chr5","37992454","37992730","chr20","34670000","34670276","4","3322454"
"chr5","38051098","38051351","chr20","34729451","34729704","8","3321647"
"chr5","38100804","38101111","chr20","34778891","34779204","8","3321913"
"chr5","38106036","38106318","chr20","34784165","34784492","46","3321871"
"chr5","38276944","38277262","chrX","17397177","17397481","63","20879767"
"chr5","38325955","38326277","chr20","35017635","35017958","4","3308320"
"chr5","38422101","38422405","chr20","35116739","35117037","12","3305362"
"chr5","38434662","38434953","chr20","35129216","35129505","12","3305446"
"chr5","38456125","38456390","chr20","35149371","35149636","6","3306754"
"chr5","38481293","38481562","chr20","35174739","35175004","8","3306554"
"chr5","38604685","38604994","chr20","35300841","35301130","27","3303844"
"chr5","38606661","38606976","chr20","35303139","35303455","4","3303522"
"chr5","38608315","38608508","chr16","48745480","48745675","38","10137165"
"chr5","38632611","38632908","chr20","35329415","35329712","5","3303196"
"chr5","38683928","38684239","chr3","153060925","153061233","55","114376997"
"chr5","38720645","38720949","chr20","35418075","35418382","9","3302570"
"chr5","38735101","38735193","chr10","65918776","65918871","23","27183675"
"chr5","38738215","38738520","chr20","35436725","35437024","18","3301490"
"chr5","38772288","38772588","chr20","35471295","35471592","16","3300993"
"chr5","38792115","38792413","chr20","35490956","35491266","17","3301159"
"chr5","38800281","38800580","chr20","35499447","35499746","8","3300834"
"chr5","38801419","38801511","chr20","35500585","35500677","4","3300834"
"chr5","38808117","38808328","chr20","35507229","35507445","17","3300888"
"chr5","38821760","38822072","chr20","35519780","35520080","20","3301980"
"chr5","38834677","38835003","chr20","35532681","35533001","15","3301996"
"chr5","38836149","38836438","chr20","35534474","35534762","11","3301675"
"chr5","38837902","38838226","chr20","35536238","35536562","8","3301664"
"chr5","38838928","38839089","chr20","35537326","35537487","7","3301602"
"chr5","38839115","38839228","chr20","35537513","35537626","3","3301602"
"chr5","38856457","38856691","chr20","35555229","35555464","3","3301228"
"chr5","38870575","38870778","chr20","35568422","35568624","9","3302153"
"chr5","38871205","38871484","chr20","35569072","35569350","14","3302133"
"chr5","38881747","38882058","chr20","35579116","35579427","5","3302631"
"chr5","38885043","38885216","chr7","110262172","110262341","39","71377129"
"chr5","38890288","38890444","chr20","35587620","35587774","10","3302668"
"chr5","38890716","38890727","chr2","50348018","50348030","4","11457302"
"chr5","38891004","38891202","chr20","35588364","35588565","11","3302640"
"chr5","38894949","38894994","chr20","35592315","35592360","1","3302634"
"chr5","38895328","38895508","chr20","35592692","35592874","7","3302636"
"chr5","38896027","38896317","chr20","35593392","35593682","9","3302635"
"chr5","38897737","38897873","chr1","38670343","38670477","29","227394"
"chr5","38900456","38900736","chr20","35598013","35598298","6","3302443"
"chr5","38900751","38900903","chr9","15339800","15339953","31","23560951"
"chr5","38914522","38914791","chr20","35612308","35612577","7","3302214"
"chr5","38943696","38943945","chr20","35640851","35641108","11","3302845"
"chr5","38947161","38947453","chr20","35644305","35644617","24","3302856"
"chr5","38950258","38950563","chr14","108304405","108304714","55","69354147"
"chr5","38957675","38957927","chr20","35654649","35654922","30","3303026"
"chr5","38959905","38960129","chr20","35656893","35657154","44","3303012"
"chr5","38962058","38962273","chr20","35659052","35659276","16","3303006"
"chr5","38969934","38970158","chr20","35667583","35667807","5","3302351"
"chr5","38972142","38972413","chr20","35669794","35670063","8","3302348"
"chr5","38982361","38982653","chr20","35679756","35680048","4","3302605"
"chr5","39051195","39051511","chr20","35749243","35749559","4","3301952"
"chr5","39053036","39053346","chr20","35751909","35752224","8","3301127"
"chr5","39060438","39060773","chr20","35759340","35759676","7","3301098"
"chr5","39062203","39062476","chr20","35760881","35761146","14","3301322"
"chr5","39073628","39073910","chr20","35772296","35772586","14","3301332"
"chr5","39076285","39076581","chr20","35774722","35775018","3","3301563"
"chr5","39078460","39078742","chr20","35776911","35777205","14","3301549"
"chr5","39082271","39082565","chr20","35780395","35780691","7","3301876"
"chr5","39085067","39085350","chr20","35783533","35783816","2","3301534"
"chr5","39090421","39090609","chr4","152685312","152685497","38","113594891"
"chr5","39090653","39090728","chr1","23191755","23191840","22","15898898"
"chr5","39099380","39099441","chr20","35797255","35797308","8","3302125"
"chr5","39099442","39099577","chr20","35797309","35797444","1","3302133"
"chr5","39109721","39109936","chr20","35808461","35808675","5","3301260"
"chr5","39110001","39110307","chr20","35808740","35809042","8","3301261"
"chr5","39120690","39120989","chr20","35819218","35819516","3","3301472"
"chr5","39130471","39130784","chr20","35830003","35830313","7","3300468"
"chr5","39163056","39163355","chr20","35860964","35861260","11","3302092"
"chr5","39197953","39198067","chr20","35897060","35897171","16","3300893"
"chr5","39198378","39198498","chr7","78400","78509","33","39119978"
"chr5","39198877","39199038","chr20","35897517","35897700","42","3301360"
"chr5","39199351","39199567","chr7","20814","21022","51","39178537"
"chr5","39223756","39224026","chr20","35922036","35922315","15","3301720"
"chr5","39231166","39231323","chr3","44026871","44027043","41","4795705"
"chr5","39236451","39236732","chr20","35934680","35934972","18","3301771"
"chr5","39243916","39244199","chr20","35942161","35942453","18","3301755"
"chr5","39269076","39269390","chr20","35968153","35968468","9","3300923"
"chr5","39277966","39278275","chr6","70501055","70501362","70","31223089"
"chr5","39288936","39289138","chr20","35987986","35988188","5","3300950"
"chr5","39308675","39308998","chr2","83637244","83637544","73","44328569"
"chr5","39315076","39315353","chr20","36014034","36014314","12","3301042"
"chr5","39328372","39328665","chr20","36027308","36027600","15","3301064"
"chr5","39339720","39339974","chr20","36039648","36039902","8","3300072"
"chr5","39348343","39348643","chr20","36048264","36048576","21","3300079"
"chr5","39354339","39354560","chr20","36056884","36057094","14","3297455"
"chr5","39361948","39362241","chr20","36064097","36064390","3","3297851"
"chr5","39363639","39363765","chr20","36065796","36065927","6","3297843"
"chr5","39391104","39391178","chr20","36093584","36093658","1","3297520"
"chr5","39391366","39391654","chr20","36093846","36094147","15","3297520"
"chr5","39392912","39393210","chr20","36095461","36095762","9","3297451"
"chr5","39406522","39406835","chr20","36109528","36109846","12","3296994"
"chr5","39410281","39410426","chr20","36113293","36113438","3","3296988"
"chr5","39410459","39410638","chr20","36113488","36113677","12","3296971"
"chr5","39411494","39411788","chr20","36114529","36114822","7","3296965"
"chr5","39515126","39515425","chr20","36217181","36217481","8","3297945"
"chr5","39522905","39523179","chr20","36225183","36225457","14","3297722"
"chr5","39537056","39537349","chr20","36239047","36239339","12","3298009"
"chr5","39544260","39544559","chr4","17352329","17352627","53","22191931"
"chr5","39550426","39550710","chr20","36252330","36252635","31","3298096"
"chr5","39590367","39590669","chr20","36292890","36293177","22","3297477"
"chr5","39592946","39593262","chr20","36295456","36295759","20","3297490"
"chr5","39604293","39604558","JH683179","955","1238","26","39603338"
"chr5","39626916","39627225","chr20","36325352","36325664","12","3301564"
"chr5","39636305","39636601","chr20","36334759","36335027","33","3301546"
"chr5","39675209","39675498","chr20","36376047","36376336","9","3299162"
"chr5","39731132","39731429","chr20","36431535","36431832","12","3299597"
"chr5","39775850","39776128","chr20","36476465","36476761","20","3299385"
"chr5","39877856","39878155","chr11","95219088","95219380","53","55341232"
"chr5","39883144","39883293","chr20","36583367","36583513","5","3299777"
"chr5","39886170","39886479","chr20","36586388","36586697","2","3299782"
"chr5","39904114","39904404","chr20","36605173","36605462","16","3298941"
"chr5","39925898","39926209","chr20","36625167","36625482","12","3300731"
"chr5","39946194","39946384","chr20","36646402","36646595","6","3299792"
"chr5","39962171","39962430","chr20","36662429","36662683","8","3299742"
"chr5","39972333","39972629","chr20","36672573","36672865","16","3299760"
"chr5","40011126","40011427","chr20","36711203","36711508","14","3299923"
"chr5","40016496","40016772","chr20","36716527","36716834","49","3299969"
"chr5","40019572","40019880","chr20","36719667","36719974","10","3299905"
"chr5","40023288","40023559","chr20","36723383","36723675","30","3299905"
"chr5","40086088","40086380","chr20","36787445","36787738","9","3298643"
"chr5","40093811","40093963","chr20","36795194","36795340","11","3298617"
"chr5","40102839","40103107","chr20","36804170","36804438","10","3298669"
"chr5","40114988","40115290","chr20","36816666","36816973","13","3298322"
"chr5","40115798","40116101","chr20","36817490","36817801","19","3298308"
"chr5","40148327","40148626","chr20","36850819","36851116","15","3297508"
"chr5","40206434","40206680","chr20","36908505","36908779","33","3297929"
"chr5","40231340","40231630","chr20","36933141","36933428","16","3298199"
"chr5","40273629","40273843","chr20","36975905","36976113","14","3297724"
"chr5","40329875","40329946","chr20","37036006","37036082","8","3293869"
"chr5","40354600","40354912","chr20","37060479","37060792","10","3294121"
"chr5","40367408","40367724","chr20","37073315","37073599","48","3294093"
"chr5","40454005","40454309","chr20","37169071","37169374","5","3284934"
"chr5","40468408","40468715","chr2","102816315","102816623","57","62347907"
"chr5","40477093","40477379","chr20","37188690","37188979","16","3288403"
"chr5","40595372","40595678","chr20","37313286","37313579","23","3282086"
"chr5","40607662","40607928","chr20","9889995","9890260","62","30717667"
"chr5","40612320","40612618","chr20","37331333","37331631","4","3280987"
"chr5","40614369","40614664","chr20","37333379","37333675","8","3280990"
"chr5","40627866","40628151","chr20","37347477","37347752","22","3280389"
"chr5","40630864","40631140","chr20","37350448","37350724","8","3280416"
"chr5","40635595","40635732","chr1","128804331","128804470","27","88168736"
"chr5","40680808","40681090","chr20","37400624","37400905","7","3280184"
"chr5","40681612","40681811","chr20","37401425","37401607","22","3280187"
"chr5","40689125","40689351","chr20","37408590","37408816","6","3280535"
"chr5","40796229","40796346","chr16","42538597","42538718","21","1742368"
"chr5","40805153","40805438","chr20","37524918","37525208","19","3280235"
"chr5","40861306","40861589","chr7","16633464","16633747","51","24227842"
"chr5","40870447","40870608","chr20","37587774","37587936","4","3282673"
"chr5","40885432","40885720","chr20","37602761","37603070","52","3282671"
"chr5","40935358","40935480","chr20","37653959","37654091","11","3281399"
"chr5","40971624","40971914","chr20","37690914","37691205","6","3280710"
"chr5","41023495","41023780","chr20","37742398","37742683","6","3281097"
"chr5","41053899","41054043","chr11","121092295","121092441","28","80038396"
"chr5","41115579","41115885","chr20","37834922","37835214","22","3280657"
"chr5","41126710","41126953","chr13","24581020","24581268","44","16545690"
"chr5","41206125","41206443","chr20","37925710","37926025","17","3280415"
"chr5","41246723","41246782","chr20","37967228","37967287","2","3279495"
"chr5","41355927","41356163","chr20","38076866","38077102","6","3279061"
"chr5","41367416","41367503","chr7","63626727","63626811","14","22259311"
"chr5","41423086","41423379","chr17","68838851","68839137","60","27415765"
"chr5","41456423","41456722","chr20","38174942","38175240","9","3281481"
"chr5","41462744","41463048","chr20","38181234","38181532","13","3281510"
"chr5","41949987","41950236","chr20","38596590","38596836","11","3353397"
"chr5","42027849","42028135","chr20","38674730","38675011","8","3353119"
"chr5","42053859","42054142","chr20","38703527","38703837","31","3350332"
"chr5","42088331","42088634","chr20","38738901","38739200","8","3349430"
"chr5","42096223","42096532","chr20","38746032","38746344","13","3350191"
"chr5","42137521","42137685","chr20","38787321","38787489","6","3350200"
"chr5","42207194","42207487","chr20","38857203","38857495","8","3349991"
"chr5","42258468","42258786","chr20","38909702","38910017","9","3348766"
"chr5","42279707","42279983","chr20","38930974","38931270","29","3348733"
"chr5","42314052","42314314","chr20","38961833","38962094","4","3352219"
"chr5","42314372","42314529","chr4","123473830","123473989","35","81159458"
"chr5","42315427","42315714","chr20","38962585","38962872","10","3352842"
"chr5","42318213","42318503","chr20","38966161","38966469","28","3352052"
"chr5","42321222","42321531","chr20","38969131","38969419","30","3352091"
"chr5","42326103","42326391","chr20","38973987","38974304","35","3352116"
"chr5","42326891","42327192","chr15","106344008","106344321","65","64017117"
"chr5","42351294","42351582","chr20","38999745","39000000","40","3351549"
"chr5","42401634","42401933","chr20","39050714","39051017","11","3350920"
"chr5","42440570","42440858","chr20","39088403","39088691","7","3352167"
"chr5","42444762","42445065","chr20","39092575","39092877","12","3352187"
"chr5","42448097","42448227","chr20","39096165","39096295","3","3351932"
"chr5","42454600","42454734","chr20","39102418","39102549","5","3352182"
"chr5","42486099","42486409","chr20","39135442","39135760","13","3350657"
"chr5","42494332","42494618","chr20","39144226","39144516","19","3350106"
"chr5","42495745","42496083","chr20","39145658","39145995","17","3350087"
"chr5","42501670","42501828","chr20","39151524","39151682","2","3350146"
"chr5","42502130","42502166","chr1","1980648","1980684","15","40521482"
"chr5","42505796","42505902","chr20","39155661","39155767","3","3350135"
"chr5","42505929","42506103","chr20","39155772","39155967","35","3350157"
"chr5","42530568","42530863","chr20","39181561","39181857","16","3349007"
"chr5","42531834","42532116","chr1","26173950","26174229","56","16357884"
"chr5","42549826","42549962","chr15","36676455","36676583","37","5873371"
"chr5","42569893","42570202","chr20","39272417","39272723","51","3297476"
"chr5","42616567","42616873","chr20","39272417","39272723","9","3344150"
"chr5","42628017","42628330","chr20","39272417","39272723","51","3355600"
"chr5","42640912","42641209","chr1","31729180","31729474","60","10911732"
"chr5","42648787","42649088","chr4","30245827","30246127","61","12402960"
"chr5","42649532","42649623","chr7","17265184","17265272","16","25384348"
"chr5","42649895","42649949","chr20","39302037","39302091","3","3347858"
"chr5","42650772","42651056","chr20","39303821","39304120","20","3346951"
"chr5","42662553","42662824","chr20","39321011","39321280","16","3341542"
"chr5","42669288","42669589","chr20","39323209","39323487","29","3346079"
"chr5","42675625","42675923","chr20","39329064","39329361","8","3346561"
"chr5","42677068","42677355","chr4","102262454","102262737","59","59585386"
"chr5","42677534","42677823","chr20","39333357","39333646","8","3344177"
"chr5","42698366","42698577","chr20","39354230","39354437","6","3344136"
"chr5","42722555","42722851","chr20","39379010","39379316","16","3343545"
"chr5","42752135","42752418","chr20","39408589","39408872","7","3343546"
"chr5","42760446","42760735","chr20","39416883","39417195","31","3343563"
"chr5","42773513","42773647","chr20","39429254","39429413","25","3344259"
"chr5","42790545","42790855","chr20","39446266","39446576","11","3344279"
"chr5","42800920","42801205","chr20","39456350","39456635","3","3344570"
"chr5","42801353","42801685","chr20","39456783","39457106","16","3344570"
"chr5","42804390","42804678","chr20","39459832","39460119","9","3344558"
"chr5","42810472","42810786","chr20","39465874","39466186","10","3344598"
"chr5","42856403","42856701","chr20","39511974","39512272","6","3344429"
"chr5","42857381","42857674","chr20","39512946","39513243","14","3344435"
"chr5","42863817","42864126","chr20","39519359","39519650","32","3344458"
"chr5","42866016","42866326","chr3","43162236","43162539","54","296220"
"chr5","42906893","42907178","chr20","39564170","39564453","6","3342723"
"chr5","42913192","42913455","chr20","39570284","39570547","3","3342908"
"chr5","42930033","42930289","chr20","39587009","39587263","11","3343024"
"chr5","42950140","42950453","chr20","39607464","39607777","7","3342676"
"chr5","42950840","42951168","chr20","39608162","39608491","8","3342678"
"chr5","42959221","42959521","chr20","39616916","39617225","13","3342305"
"chr5","42959588","42959889","chr20","39617292","39617580","19","3342296"
"chr5","42960034","42960172","chr20","39617712","39617852","7","3342322"
"chr5","42984407","42984701","chr20","39642068","39642358","10","3342339"
"chr5","42993241","42993534","chr20","39650897","39651203","21","3342344"
"chr5","42998015","42998318","chr20","39655683","39655986","0","3342332"
"chr5","43038389","43038480","chr1","43088445","43088535","13","50056"
"chr5","43038546","43038738","chr20","39695614","39695808","7","3342932"
"chr5","43047991","43048291","chr20","39705042","39705349","16","3342949"
"chr5","43053854","43054179","chr20","39710893","39711206","27","3342961"
"chr5","43055049","43055360","chr19","41082233","41082542","74","1972816"
"chr5","43075927","43076238","chr20","39733020","39733331","15","3342907"
"chr5","43100823","43101023","chr20","39757649","39757849","4","3343174"
"chr5","43108955","43109230","chr20","39765767","39766042","11","3343188"
"chr5","43128937","43129016","chr19","17931953","17932032","17","25196984"
"chr5","43129045","43129168","chr1","96094837","96094956","22","52965792"
"chr5","43140590","43140899","chr20","39795330","39795635","12","3345260"
"chr5","43141095","43141378","chr20","39796139","39796415","12","3344956"
"chr5","43143696","43143980","chr20","39798753","39799052","17","3344943"
"chr5","43151798","43152100","chr20","39813750","39814052","5","3338048"
"chr5","43152214","43152478","chr20","39814167","39814430","9","3338047"
"chr5","43152845","43153103","chr20","39814798","39815057","6","3338047"
"chr5","43157986","43158300","chr13","89680781","89681096","60","46522795"
"chr5","43159891","43160185","chr20","39812475","39812775","8","3347416"
"chr5","43177295","43177588","chr20","39832777","39833079","10","3344518"
"chr5","43181944","43182246","chr20","39837732","39838034","4","3344212"
"chr5","43198867","43199178","chr20","39854602","39854910","14","3344265"
"chr5","43202943","43203075","chr20","39858315","39858448","5","3344628"
"chr5","43203375","43203538","chr20","39858748","39858909","3","3344627"
"chr5","43215388","43215703","chr20","39870654","39870947","32","3344734"
"chr5","43227068","43227363","chr20","39882615","39882910","7","3344453"
"chr5","43227368","43227497","chr20","39882911","39883050","13","3344457"
"chr5","43238332","43238599","chr20","39892754","39893024","11","3345578"
"chr5","43251896","43252056","chr1","12782836","12783000","26","30469060"
"chr5","43257973","43258245","chr20","39915393","39915665","10","3342580"
"chr5","43269318","43269610","chr20","39926672","39926964","3","3342646"
"chr5","43277360","43277645","chr20","39935248","39935554","26","3342112"
"chr5","43279078","43279229","chr14","63608556","63608715","30","20329478"
"chr5","43279485","43279636","chr10","31427839","31427995","34","11851646"
"chr5","43279662","43279766","chr6","165327290","165327396","20","122047628"
"chr5","43288484","43288608","chr20","39946643","39946774","11","3341841"
"chr5","43288620","43288865","chr20","39946781","39947025","6","3341839"
"chr5","43293319","43293609","chr20","39951822","39952116","13","3341497"
"chr5","43302471","43302758","chr1","22940926","22941211","58","20361545"
"chr5","43307648","43307971","chr9","85125068","85125376","67","41817420"
"chr5","43326109","43326404","chr20","39984572","39984872","10","3341537"
"chr5","43330886","43331185","chr9","61562805","61563109","81","18231919"
"chr5","43352498","43352793","chr20","60002582","60002880","51","16650084"
"chr5","43362946","43363001","chr20","40021753","40021808","0","3341193"
"chr5","43363031","43363202","chr20","40021838","40022006","7","3341193"
"chr5","43369659","43369963","chr20","40028432","40028736","14","3341227"
"chr5","43373456","43373754","chr20","40032234","40032532","8","3341222"
"chr5","43400034","43400341","chr20","40059057","40059364","7","3340977"
"chr5","43414021","43414319","chr20","40073322","40073621","5","3340699"
"chr5","43427861","43428163","chr20","40088048","40088344","13","3339813"
"chr5","43428282","43428577","chr20","40088048","40088344","41","3340234"
"chr5","43434185","43434476","chr20","40094245","40094536","3","3339940"
"chr5","43456050","43456118","chr20","40115825","40115893","1","3340225"
"chr5","43478281","43478433","chr20","40138310","40138462","3","3339971"
"chr5","43490330","43490653","chr20","40150102","40150416","17","3340228"
"chr5","43492276","43492430","chr14","63608556","63608715","33","20116280"
"chr5","43492456","43492572","chr13","60731646","60731762","19","17239190"
"chr5","43522266","43522342","chr20","40177837","40177913","0","3344429"
"chr5","43536739","43537053","chr20","40192049","40192361","14","3344690"
"chr5","43538230","43538321","chr20","40193385","40193472","6","3344845"
"chr5","43621687","43621989","chr1","26064246","26064545","49","17557441"
"chr5","43650099","43650324","chr20","40306033","40306259","10","3344066"
"chr5","43654749","43655039","chr20","40310680","40310969","6","3344069"
"chr5","43658202","43658475","chr20","40314133","40314407","8","3344069"
"chr5","43698472","43698800","chr20","40354389","40354717","8","3344083"
"chr5","43721774","43722055","chr20","40379383","40379695","40","3342391"
"chr5","43724287","43724551","chr20","40381953","40382219","10","3342334"
"chr5","43749727","43750001","chr20","40406981","40407253","12","3342746"
"chr5","43753455","43753779","chr20","40411042","40411376","19","3342413"
"chr5","43756062","43756372","chr20","40413655","40413965","9","3342407"
"chr5","43757325","43757639","chr20","40414909","40415225","11","3342416"
"chr5","43768182","43768480","chr20","40425428","40425726","9","3342754"
"chr5","43771475","43771777","chr20","40428546","40428846","8","3342929"
"chr5","43775740","43775854","chrX","119258896","119259010","20","75483156"
"chr5","43779326","43779383","chr6","65604634","65604691","12","21825308"
"chr5","43785170","43785474","chr20","40443398","40443698","11","3341772"
"chr5","43787388","43787671","chrX","141419232","141419516","62","97631844"
"chr5","43791809","43792110","chr20","40447493","40447797","10","3344316"
"chr5","43797836","43798144","chr20","40453502","40453808","10","3344334"
"chr5","43801957","43802260","chr3","51138546","51138828","71","7336589"
"chr5","43803447","43803753","chr20","40459402","40459665","55","3344045"
"chr5","43808717","43808997","chr20","40464439","40464725","16","3344278"
"chr5","43814302","43814578","chr11","121663322","121663590","66","77849020"
"chr5","43819637","43819903","chr20","40475055","40475323","8","3344582"
"chr5","43828152","43828446","chr20","40483582","40483880","14","3344570"
"chr5","43834224","43834512","chr20","40489094","40489382","9","3345130"
"chr5","43840746","43841036","chr20","40495865","40496158","6","3344881"
"chr5","43864014","43864336","chr20","40519086","40519405","10","3344928"
"chr5","43865330","43865614","chr20","40520338","40520622","2","3344992"
"chr5","43873222","43873561","chr11","125856690","125857032","68","81983468"
"chr5","43873968","43874271","chr20","40528980","40529288","18","3344988"
"chr5","43882757","43882918","chr14","17464426","17464584","28","26418331"
"chr5","43900791","43901087","chr20","40555893","40556190","10","3344898"
"chr5","43905917","43906193","chr14","14864487","14864770","54","29041430"
"chr5","43912205","43912531","chr20","40567600","40567922","9","3344605"
"chr5","43915337","43915625","chr1","17220580","17220877","54","26694757"
"chr5","43934599","43934899","chr9","123818237","123818533","57","79883638"
"chr5","43949908","43950203","chr20","40605444","40605740","3","3344464"
"chr5","43990553","43990806","chr1","5325347","5325595","53","38665206"
"chr5","43994163","43994461","chr20","40651415","40651715","6","3342748"
"chr5","44003546","44003704","chr19","14673246","14673394","37","29330300"
"chr5","44014464","44014760","chr20","40672564","40672871","20","3341900"
"chr5","44032482","44032791","chr20","40691121","40691429","12","3341361"
"chr5","44036669","44036838","chr20","40695326","40695495","5","3341343"
"chr5","44053082","44053403","chr20","40711597","40711930","24","3341485"
"chr5","44053413","44053691","chr20","40711938","40712238","28","3341475"
"chr5","44059682","44059980","chr20","40718490","40718792","17","3341192"
"chr5","44064184","44064489","chr20","40723358","40723662","12","3340826"
"chr5","44064564","44064792","chr20","40723733","40723960","7","3340831"
"chr5","44078038","44078319","chr7","24721573","24721853","43","19356465"
"chr5","44078358","44078370","chr20","36292857","36292869","1","7785501"
"chr5","44086662","44086940","chr20","40731315","40731593","3","3355347"
"chr5","44106859","44107193","chr20","40751483","40751830","32","3355376"
"chr5","44144613","44144912","JH682036","357821","358117","53","43786792"
"chr5","44153408","44153689","chr20","40798400","40798682","5","3355008"
"chr5","44166868","44167155","chr9","95117184","95117463","68","50950316"
"chr5","44186148","44186418","chr4","37087253","37087526","74","7098895"
"chr5","44232517","44232829","chr20","40878251","40878561","12","3354266"
"chr5","44258778","44259056","chr20","40904249","40904528","9","3354529"
"chr5","44264771","44264833","chr10","80981007","80981065","13","36716236"
"chr5","44264882","44265040","chr20","40910011","40910171","5","3354871"
"chr5","44277443","44277747","chr20","40922890","40923200","13","3354553"
"chr5","44283818","44284108","chr15","22258204","22258505","52","22025614"
"chr5","44305865","44305989","chr4","85649826","85649950","19","41343961"
"chr5","44313704","44314017","chr20","40959748","40960051","15","3353956"
"chr5","44323154","44323423","chr20","40969210","40969479","8","3353944"
"chr5","44334624","44334796","chr3","2024698","2024867","30","42309926"
"chr5","44335073","44335096","chr6","84161173","84161199","6","39826100"
"chr5","44335560","44335860","chr20","40983842","40984135","19","3351718"
"chr5","44344933","44345240","chr20","40994165","40994473","11","3350768"
"chr5","44347348","44347658","chr20","40996879","40997162","35","3350469"
"chr5","44357345","44357647","chr20","41007131","41007438","15","3350214"
"chr5","44362232","44362374","chr10","12286075","12286221","25","32076157"
"chr5","44382876","44383170","chr2","173219206","173219502","54","128836330"
"chr5","44398436","44398717","chr1","159614491","159614771","51","115216055"
"chr5","44479914","44480215","chr20","41129586","41129897","22","3350328"
"chr5","44493422","44493500","chr20","41144386","41144464","2","3349036"
"chr5","44493991","44494247","chr20","41144950","41145206","8","3349041"
"chr5","44504139","44504436","chr20","41155704","41155997","10","3348435"
"chr5","44506241","44506384","chr20","41158118","41158255","10","3348123"
"chr5","44506392","44506554","chr20","41158263","41158427","10","3348129"
"chr5","44511704","44511971","chr20","41161696","41161963","4","3350008"
"chr5","44513696","44513954","chr20","41163689","41163938","13","3350007"
"chr5","44514351","44514546","chr1","150593735","150593929","30","106079384"
"chr5","44516596","44516805","chr13","24720396","24720611","44","19796200"
"chr5","44547174","44547452","chr20","41199403","41199681","2","3347771"
"chr5","44559350","44559596","chr20","41211547","41211791","9","3347803"
"chr5","44562990","44563126","chr20","41215512","41215648","2","3347478"
"chr5","44563726","44563891","chr20","41216253","41216417","5","3347473"
"chr5","44588774","44588908","chr20","41241861","41242004","13","3346913"
"chr5","44593971","44594080","chr8","90064854","90064963","20","45470883"
"chr5","44594139","44594438","chr19","16323637","16323934","52","28270502"
"chr5","44595533","44595790","chr20","41252762","41253019","9","3342771"
"chr5","44605627","44605926","chr20","41272831","41273130","6","3332796"
"chr5","44622881","44623046","chr4","123473830","123473989","31","78850949"
"chr5","44623463","44623596","chr19","30336158","30336285","22","14287305"
"chr5","44634716","44634854","chr19","42217504","42217645","30","2417212"
"chr5","44647560","44647922","chr20","41306465","41306775","60","3341095"
"chr5","44651320","44651457","chr1","1658615","1658747","27","42992705"
"chr5","44651663","44651776","chr4","107387856","107387970","32","62736193"
"chr5","44666961","44667237","chr20","41327071","41327345","8","3339890"
"chr5","44667709","44668023","chr20","41327819","41328131","22","3339890"
"chr5","44672040","44672350","chr20","41347278","41347587","11","3324762"
"chr5","44677094","44677174","chr16","6545373","6545453","10","38131721"
"chr5","44677368","44677501","chr8","122423393","122423533","22","77746025"
"chr5","44706579","44706877","chr20","41367928","41368226","7","3338651"
"chr5","44716363","44716633","chr20","41375172","41375441","8","3341191"
"chr5","44731844","44732126","chr20","41397057","41397346","13","3334787"
"chr5","44732195","44732476","chr20","41397419","41397700","4","3334776"
"chr5","44735076","44735370","chr20","41400298","41400609","27","3334778"
"chr5","44741099","44741380","chr20","41405998","41406279","12","3335101"
"chr5","44741846","44742145","chr20","41400298","41400609","32","3341548"
"chr5","44747555","44747836","chr20","41405998","41406279","12","3341557"
"chr5","44757576","44757906","chr20","41416577","41416927","30","3340999"
"chr5","44766747","44767032","chr20","41425896","41426181","9","3340851"
"chr5","44787211","44787488","chr20","41443824","41444102","10","3343387"
"chr5","44824612","44824922","chr20","41480855","41481162","16","3343757"
"chr5","44841632","44841937","chr20","41498112","41498412","8","3343520"
"chr5","44875564","44875876","chr20","41533134","41533448","14","3342430"
"chr5","44922907","44923198","chr20","41587238","41587529","5","3335669"
"chr5","44926455","44926784","chr14","11303111","11303440","56","33623344"
"chr5","44963503","44963799","chr20","41628339","41628633","20","3335164"
"chr5","45040804","45041094","chr20","27237939","27238231","61","17802865"
"chr5","45042313","45042606","chr20","41713917","41714196","23","3328396"
"chr5","45066447","45066770","chr20","41738040","41738364","12","3328407"
"chr5","45106188","45106348","chr20","41777352","41777523","16","3328836"
"chr5","45113942","45114255","chr9","102340368","102340668","61","57226426"
"chr5","45137323","45137602","chr20","41804232","41804510","15","3333091"
"chr5","45146132","45146381","chr20","41812318","41812575","16","3333814"
"chr5","45151171","45151452","chr20","41817368","41817640","21","3333803"
"chr5","45159592","45159878","chr20","41825842","41826128","10","3333750"
"chr5","45295032","45295297","chr8","31825080","31825346","58","13469952"
"chr5","45613572","45613858","chr10","18918672","18918950","62","26694900"
"chr5","45738058","45738165","chr2","185869971","185870075","22","140131913"
"chr5","45789880","45790150","chr9","56456050","56456320","52","10666170"
"chr5","45862344","45862644","chr20","42541677","42541985","38","3320667"
"chr5","45872090","45872156","chr20","42551761","42551827","5","3320329"
"chr5","45944433","45944593","chr20","42622773","42622932","7","3321660"
"chr5","45944632","45944729","chr20","42622956","42623056","3","3321676"
"chr5","46106031","46106316","chr20","42782011","42782298","6","3324020"
"chr5","46184778","46185104","chr20","42864515","42864846","14","3320263"
"chr5","46189149","46189216","chr20","42868902","42868969","2","3320247"
"chr5","46235510","46235703","chr14","66273866","66274056","55","20038356"
"chr5","46235740","46235843","chrX","92490765","92490869","20","46255025"
"chr5","46243839","46244007","chr19","3254478","3254646","30","42989361"
"chr5","46262245","46262545","chr20","42940793","42941089","35","3321452"
"chr5","46517548","46517845","chr20","43191314","43191616","18","3326234"
"chr5","46532562","46532865","chr20","43205690","43205999","18","3326872"
"chr5","46587155","46587373","chr20","43259759","43259977","4","3327396"
"chr5","46625313","46625525","chr20","43296741","43296953","5","3328572"
"chr5","46774138","46774411","chr20","43447378","43447653","10","3326760"
"chr5","46789578","46789707","chr20","43462608","43462740","8","3326970"
"chr5","46793581","46793874","chr20","43466510","43466806","18","3327071"
"chr5","46848509","46848867","chr20","43522596","43522958","10","3325913"
"chr5","46882144","46882442","chr20","43552955","43553258","15","3329189"
"chr5","47121654","47121836","chr20","43794880","43795062","1","3326774"
"chr5","47121875","47121991","chr20","43795096","43795214","6","3326779"
"chr5","47134213","47134503","chr20","43812896","43813186","7","3321317"
"chr5","47146644","47146768","chr19","3127570","3127696","19","44019074"
"chr5","47146986","47147139","chr1","37945855","37946005","32","9201131"
"chr5","47186023","47186312","chr20","43863019","43863351","54","3323004"
"chr5","47318647","47318948","chr20","43997782","43998107","28","3320865"
"chr5","47343406","47343729","chr20","44022559","44022880","16","3320847"
"chr5","47573594","47573906","chr3","51622492","51622797","58","4048898"
"chr5","47623896","47624124","chr9","59289779","59290004","50","11665883"
"chr5","47682457","47682720","chr13","4382000","4382263","58","43300457"
"chr5","47687791","47688069","chr17","543137","543428","64","47144654"
"chr5","47761092","47761389","chr20","44240462","44240754","9","3520630"
"chr5","47767985","47768293","chr4","105856318","105856619","66","58088333"
"chr5","47810211","47810391","chr20","44288564","44288739","11","3521647"
"chr5","47810418","47810533","chr20","44288781","44288896","0","3521637"
"chr5","47879231","47879518","chr20","44357942","44358207","29","3521289"
"chr5","47958238","47958547","chr20","44435694","44436003","5","3522544"
"chr5","47968163","47968480","chr20","44445800","44446117","8","3522363"
"chr5","47999646","47999937","chr20","44475985","44476283","14","3523661"
"chr5","48091373","48091668","chr20","44567642","44567937","10","3523731"
"chr5","48142390","48142671","chr20","44619292","44619580","16","3523098"
"chr5","48199784","48200092","chr20","44678136","44678445","12","3521648"
"chr5","48250106","48250399","chr20","44728473","44728773","11","3521633"
"chr5","48333118","48333291","chr2","111096349","111096517","32","62763231"
"chr5","48360023","48360320","chr20","44839299","44839599","11","3520724"
"chr5","48396811","48397075","chr20","44875941","44876205","7","3520870"
"chr5","48436630","48436888","chr20","44916267","44916525","5","3520363"
"chr5","48443175","48443488","chr20","44922829","44923140","16","3520346"
"chr5","48449872","48450172","chr20","44929443","44929752","23","3520429"
"chr5","48481829","48482120","chr20","44966933","44967224","11","3514896"
"chr5","48488920","48489242","chr20","44974028","44974347","24","3514892"
"chr5","48624872","48625183","chr20","45109464","45109773","5","3515408"
"chr5","48668960","48669218","chr20","45154213","45154471","8","3514747"
"chr5","48711210","48711529","chr20","45196661","45196980","9","3514549"
"chr5","48714468","48714626","chr20","45199942","45200100","2","3514526"
"chr5","48731495","48731763","chr20","45218324","45218592","3","3513171"
"chr5","48749803","48750052","chr20","45236630","45236894","30","3513173"
"chr5","48877245","48877551","chr20","45367065","45367372","15","3510180"
"chr5","48990663","48990966","chr20","45478243","45478543","9","3512420"
"chr5","49093282","49093557","chr20","45580938","45581252","48","3512344"
"chr5","49103351","49103633","chr9","85163891","85164156","75","36060540"
"chr5","49127192","49127531","chr20","45613839","45614196","38","3513353"
"chr5","49163067","49163377","chr3","14485595","14485905","64","34677472"
"chr5","49227578","49227875","chr20","45714361","45714656","20","3513217"
"chr5","49259347","49259632","chr20","45753772","45754057","7","3505575"
"chr5","49330435","49330714","chr20","45825302","45825583","7","3505133"
"chr5","49341657","49341799","chr20","45836612","45836754","4","3505045"
"chr5","49380535","49380844","chr16","22294372","22294673","57","27086163"
"chr5","49411614","49411887","chr4","104755415","104755694","60","55343801"
"chr5","49580890","49581184","chr20","46078841","46079133","9","3502049"
"chr5","49642057","49642346","chr20","46140619","46140910","7","3501438"
"chr5","49729941","49730248","chr12","38458678","38458979","60","11271263"
"chr5","49784772","49785086","chr20","46278788","46279083","27","3505984"
"chr5","49819116","49819200","chr20","46313574","46313658","3","3505542"
"chr5","49848965","49849045","chr20","46342987","46343067","4","3505978"
"chr5","49849295","49849491","chr20","46343298","46343500","32","3505997"
"chr5","49888250","49888516","chr20","46382480","46382742","9","3505770"
"chr5","49993539","49993887","chr20","46486298","46486622","29","3507241"
"chr5","50020936","50021101","chr1","139933203","139933372","36","89912267"
"chr5","50021132","50021258","chr1","212671582","212671706","26","162650450"
"chr5","50090322","50090619","chr20","46584449","46584742","13","3505873"
"chr5","50118796","50119079","chr20","46613088","46613370","9","3505708"
"chr5","50272199","50272482","chr20","46771488","46771770","22","3500711"
"chr5","50345944","50346240","chr20","46846308","46846615","24","3499636"
"chr5","50356130","50356298","chr20","46856451","46856624","8","3499679"
"chr5","50369288","50369542","chr20","46868751","46869009","12","3500537"
"chr5","50379786","50379942","chr20","46879432","46879586","6","3500354"
"chr5","50380016","50380137","chr20","46879620","46879741","2","3500396"
"chr5","50402339","50402627","chr20","46902810","46903094","4","3499529"
"chr5","50439732","50440039","chr20","46942308","46942616","8","3497424"
"chr5","50451325","50451596","chr20","46953996","46954264","12","3497329"
"chr5","50604104","50604392","chr20","47104205","47104498","10","3499899"
"chr5","50616902","50617124","chr20","47117365","47117588","25","3499537"
"chr5","50637912","50638215","chr20","47138957","47139257","10","3498955"
"chr5","50736738","50737005","chr20","47235706","47236004","36","3501032"
"chr5","50761155","50761262","chr2","101346745","101346853","16","50585590"
"chr5","50761377","50761500","chrX","112241983","112242097","25","61480606"
"chr5","50787127","50787401","chr1","56969909","56970172","66","6182782"
"chr5","50813495","50813778","chr20","47312340","47312634","25","3501155"
"chr5","50850926","50850983","chr5","139369160","139369219","12","88518234"
"chr5","50940986","50941303","chr16","25211732","25212053","75","25729254"
"chr5","50962006","50962320","chr20","47459404","47459727","18","3502602"
"chr5","51062003","51062289","chr20","47558867","47559150","10","3503136"
"chr5","51167077","51167383","chr20","47663872","47664182","9","3503205"
"chr5","51199666","51199946","chr20","47696378","47696655","9","3503288"
"chr5","51233662","51233908","chr20","47735820","47736032","39","3497842"
"chr5","51244319","51244601","chr5","173464621","173464902","65","122220302"
"chr5","51376441","51376750","chr20","47877478","47877787","6","3498963"
"chr5","51428197","51428490","chr20","47930681","47930974","7","3497516"
"chr5","51546369","51546644","chr20","48048315","48048593","7","3498054"
"chr5","51563292","51563583","chr20","48070754","48071066","29","3492538"
"chr5","51573393","51573698","chr20","48081838","48082141","8","3491555"
"chr5","51604079","51604382","chr20","48111994","48112288","17","3492085"
"chr5","51639013","51639289","chr20","48151865","48152124","23","3487148"
"chr5","51640470","51640759","chr20","48153301","48153604","22","3487169"
"chr5","51702601","51702772","chr20","48214952","48215115","14","3487649"
"chr5","51713062","51713350","chr20","48225132","48225420","8","3487930"
"chr5","51898577","51898861","chr20","48412199","48412490","17","3486378"
"chr5","51906042","51906194","chr20","48419683","48419835","3","3486359"
"chr5","51906396","51906520","chr11","121323916","121324042","23","69417520"
"chr5","51908893","51909091","chr20","48422695","48422889","10","3486198"
"chr5","51924546","51924837","chr20","48438627","48438912","12","3485919"
"chr5","51936247","51936260","chr3","15539298","15539308","4","36396949"
"chr5","51936547","51936669","chr16","56134012","56134133","26","4197465"
"chr5","51949503","51949673","chrX","37752435","37752603","38","14197068"
"chr5","52011507","52011799","chr20","48526132","48526432","18","3485375"
"chr5","52077731","52078017","chr1","95246773","95247060","60","43169042"
"chr5","52098584","52098805","chr7","40872150","40872364","41","11226434"
"chr5","52148664","52148845","chr5","166377538","166377723","62","114228874"
"chr5","52152521","52152826","chr20","48667987","48668270","23","3484534"
"chr5","52197234","52197525","chr20","48712326","48712615","9","3484908"
"chr5","52219037","52219351","chr20","48734140","48734454","12","3484897"
"chr5","52233081","52233376","chr20","48748516","48748816","21","3484565"
"chr5","52234742","52234839","chr20","48750179","48750276","4","3484563"
"chr5","52238263","52238572","chr20","48753283","48753592","3","3484980"
"chr5","52239064","52239358","chr20","48754085","48754378","9","3484979"
"chr5","52279249","52279512","chr20","48794217","48794482","7","3485032"
"chr5","52285131","52285448","chr20","48800117","48800428","16","3485014"
"chr5","52290664","52290981","chr20","48805669","48805991","13","3484995"
"chr5","52306384","52306666","chr20","48819694","48819976","8","3486690"
"chr5","52354037","52354321","chr20","48867526","48867810","3","3486511"
"chr5","52357846","52358064","chr20","48868898","48869116","8","3488948"
"chr5","52358916","52359215","chr20","48873322","48873618","10","3485594"
"chr5","52364104","52364259","chr20","48878237","48878392","5","3485867"
"chr5","52369492","52369687","chr20","48884428","48884638","28","3485064"
"chr5","52374622","52374917","chr20","48889251","48889547","6","3485371"
"chr5","52376835","52377134","chr1","115027393","115027686","46","62650558"
"chr5","52386087","52386378","chr20","48900484","48900775","4","3485603"
"chr5","52392072","52392368","chr20","48906446","48906742","9","3485626"
"chr5","52399012","52399322","chr20","48913652","48913935","35","3485360"
"chr5","52401686","52401999","chr3","42988227","42988525","70","9413459"
"chr5","52407822","52408101","chr20","48920912","48921191","6","3486910"
"chr5","52408141","52408443","chr20","48921231","48921518","21","3486910"
"chr5","52411037","52411333","chr20","48924143","48924439","3","3486894"
"chr5","52416007","52416187","chr20","48929016","48929184","14","3486991"
"chr5","52436553","52436840","chr20","48950332","48950609","22","3486221"
"chr5","52442797","52443103","chr20","48957235","48957544","13","3485562"
"chr5","52445173","52445469","chr20","48959611","48959894","22","3485562"
"chr5","52458456","52458747","chr20","48973208","48973499","3","3485248"
"chr5","52466691","52466887","chr20","48981396","48981605","15","3485295"
"chr5","52470166","52470465","chr20","48984858","48985166","16","3485308"
"chr5","52483456","52483762","chr20","48997425","48997736","12","3486031"
"chr5","52485721","52486008","chr20","49000018","49000285","22","3485703"
"chr5","52494353","52494637","chr20","49008603","49008892","13","3485750"
"chr5","52495702","52495980","chr20","49009959","49010237","5","3485743"
"chr5","52497209","52497476","chr20","49011432","49011729","35","3485777"
"chr5","52507718","52508001","chr20","49021991","49022277","7","3485727"
"chr5","52510965","52511203","chr20","49025563","49025801","7","3485402"
"chr5","52514066","52514362","chr20","49028884","49029177","9","3485182"
"chr5","52521318","52521621","chr20","49036333","49036626","13","3484985"
"chr5","52522380","52522672","chr20","49037306","49037593","7","3485074"
"chr5","52529173","52529475","chr20","49044106","49044402","12","3485067"
"chr5","52532445","52532834","chr20","49047391","49047703","85","3485054"
"chr5","52557606","52557917","chr20","49072735","49073046","4","3484871"
"chr5","52559023","52559127","chr20","49074167","49074271","4","3484856"
"chr5","52560294","52560590","chr20","49075444","49075741","7","3484850"
"chr5","52571150","52571453","chr20","49086948","49087250","7","3484202"
"chr5","52573878","52574062","chr20","49089856","49090014","32","3484022"
"chr5","52574346","52574483","chr20","49090292","49090429","5","3484054"
"chr5","52579553","52579845","chr20","49095333","49095626","7","3484220"
"chr5","52579869","52580199","chr20","49095634","49095978","27","3484235"
"chr5","52584131","52584428","chr20","49100286","49100586","14","3483845"
"chr5","52592697","52592903","chr20","49108978","49109183","8","3483719"
"chr5","52635457","52635759","chr20","49148724","49149022","7","3486733"
"chr5","52639307","52639542","chr20","49152536","49152767","13","3486771"
"chr5","52648667","52648902","chr20","49152536","49152767","13","3496131"
"chr5","52649564","52649852","chr20","49177490","49177771","37","3472074"
"chr5","52651334","52651440","chr7","129979248","129979346","22","77327914"
"chr5","52653000","52653307","chr20","49148724","49149022","43","3504276"
"chr5","52656513","52656732","chr20","49152536","49152767","37","3503977"
"chr5","52661710","52662003","chr20","49148724","49149022","36","3512986"
"chr5","52662760","52662993","chr20","49152536","49152767","39","3510224"
"chr5","52671251","52671491","chr17","27781811","27782049","56","24889440"
"chr5","52682177","52682472","chr6","52245518","52245818","54","436659"
"chr5","52682854","52682971","chr20","56727108","56727225","5","4044254"
"chr5","52709163","52709454","chr20","56700889","56701179","10","3991726"
"chr5","52711295","52711412","chr20","56698924","56699041","2","3987629"
"chr5","52711417","52711678","chr20","56698334","56698595","7","3986917"
"chr5","52712023","52712097","chr20","56697383","56697463","7","3985360"
"chr5","52718876","52719191","chr1","71741527","71741836","67","19022651"
"chr5","52721645","52721825","chr20","56685472","56685652","4","3963827"
"chr5","52724230","52724337","chr2","69271792","69271900","22","16547562"
"chr5","52731188","52731433","chr20","56678087","56678348","21","3946899"
"chr5","52736496","52736676","chr20","56671522","56671699","22","3935026"
"chr5","52736979","52737108","chr20","56671097","56671232","10","3934118"
"chr5","52737854","52737935","chr4","107273116","107273192","23","54535262"
"chr5","52744628","52744759","chr20","56662813","56662944","1","3918185"
"chr5","52747233","52747524","chr19","46993338","46993638","63","5753895"
"chr5","52755828","52756139","chr20","56651658","56651970","11","3895830"
"chr5","52770269","52770551","chr20","56637080","56637361","10","3866811"
"chr5","52776155","52776455","chr12","99689911","99690212","53","46913756"
"chr5","52777359","52777572","chr7","40872150","40872364","43","11905209"
"chr5","52777614","52777912","chr20","56630083","56630369","19","3852469"
"chr5","52780980","52781292","chr20","56626796","56627111","12","3845816"
"chr5","52791050","52791266","chr20","56616787","56617000","8","3825737"
"chr5","52830512","52830805","chr20","56579015","56579294","20","3748503"
"chr5","52844259","52844532","chr3","10842594","10842866","58","42001665"
"chr5","52858796","52859086","chr20","56550561","56550864","31","3691765"
"chr5","52866309","52866531","chr20","56542070","56542289","8","3675761"
"chr5","52870458","52870750","chr3","19204117","19204411","49","33666341"
"chr5","52873633","52873799","chr13","93024819","93024980","27","40151186"
"chr5","52876373","52876669","chr20","56532493","56532786","13","3656120"
"chr5","52879741","52880061","chr20","56529053","56529373","7","3649312"
"chr5","52880719","52880843","chr20","56528273","56528395","6","3647554"
"chr5","52880844","52881127","chr20","56527987","56528270","9","3647143"
"chr5","52882543","52882744","chr20","56526368","56526569","3","3643825"
"chr5","52886754","52887039","chr20","56521086","56521371","10","3634332"
"chr5","52888673","52888836","chr20","56519274","56519447","13","3630601"
"chr5","52896105","52896419","chr20","56513397","56513691","33","3617292"
"chr5","52920222","52920506","chr20","56489001","56489286","6","3568779"
"chr5","52929456","52929709","chr20","56480129","56480382","6","3550673"
"chr5","52932430","52932716","chr20","56477156","56477443","9","3544726"
"chr5","52934966","52935256","chr20","56474616","56474907","10","3539650"
"chr5","52936222","52936514","chr20","56473355","56473651","10","3537133"
"chr5","52947695","52948014","chr20","56461654","56461969","26","3513959"
"chr5","52963776","52964069","chr20","56446359","56446652","5","3482583"
"chr5","52974600","52974900","chr20","56435464","56435758","17","3460864"
"chr5","52975077","52975265","chr20","56435093","56435282","8","3460016"
"chr5","53008905","53009189","chr20","56397274","56397558","8","3388369"
"chr5","53009966","53010084","chr4","30240512","30240627","33","22769454"
"chr5","53012208","53012290","chr20","56394189","56394271","2","3381981"
"chr5","53038620","53038819","chr12","21152236","21152428","57","31886384"
"chr5","53042094","53042234","chr20","56370618","56370758","2","3328524"
"chr5","53048454","53048577","chr20","56364707","56364830","3","3316253"
"chr5","53051391","53051562","chr20","56361409","56361581","5","3310018"
"chr5","53055450","53055660","chr20","56357065","56357266","15","3301615"
"chr5","53058205","53058366","chr20","56353697","56353860","3","3295492"
"chr5","53059723","53060045","chr20","56352030","56352352","12","3292307"
"chr5","53060801","53060932","chr20","56351459","56351594","7","3290658"
"chr5","53063998","53064163","chr20","56348218","56348387","7","3284220"
"chr5","53081133","53081427","chr20","56333375","56333669","12","3252242"
"chr5","53113481","53113549","chr20","56293938","56294006","1","3180457"
"chr5","53120868","53121179","chr20","56285915","56286221","14","3165047"
"chr5","53129052","53129233","chr20","56277601","56277764","20","3148549"
"chr5","53136093","53136403","chr20","56269340","56269650","13","3133247"
"chr5","53137693","53137984","chr20","56267762","56268051","10","3130069"
"chr5","53142474","53142672","chr20","56263083","56263294","20","3120609"
"chr5","53144752","53144905","chr5","1888026","1888179","37","51256726"
"chr5","53144922","53145189","chr20","56260610","56260890","21","3115688"
"chr5","53157423","53157558","chr20","56248045","56248178","3","3090622"
"chr5","53160818","53160946","chr7","15394911","15395040","24","37765907"
"chr5","53169186","53169504","chr20","56235394","56235713","6","3066208"
"chr5","53172898","53173178","chr20","56232035","56232315","3","3059137"
"chr5","53174183","53174477","chr20","56230758","56231052","4","3056575"
"chr5","53186964","53187243","JH682236","10341","10604","26","53176623"
"chr5","53193440","53193737","JH682236","17472","17769","3","53175968"
"chr5","53242269","53242565","JH682236","66948","67244","6","53175321"
"chr5","53276529","53276738","JH682236","117908","118138","37","53158621"
"chr5","53276767","53276968","JH682236","118463","118666","5","53158304"
"chr5","53277007","53277299","JH682236","98263","98555","11","53178744"
"chr5","53278275","53278515","chr5","1833229","1833470","55","51445046"
"chr5","53302821","53302903","JH682236","130069","130143","11","53172752"
"chr5","53306646","53306752","chr14","17216875","17216980","19","36089771"
"chr5","53315744","53316048","JH682236","134374","134678","12","53181370"
"chr5","53319275","53319500","chr2","156827871","156828094","47","103508596"
"chr5","53334355","53334649","JH682236","160741","161034","3","53173614"
"chr5","53351121","53351226","JH682236","182271","182384","13","53168850"
"chr5","53351899","53352197","JH682236","183153","183453","6","53168746"
"chr5","53353633","53353919","JH682236","184884","185181","19","53168749"
"chr5","53359863","53360158","JH682236","191044","191340","6","53168819"
"chr5","53361129","53361427","chr3","2797380","2797675","51","50563749"
"chr5","53368534","53368820","JH682236","199899","200206","27","53168635"
"chr5","53374203","53374445","chr14","52216423","52216666","56","1157780"
"chr5","53377089","53377392","JH682236","208851","209154","12","53168238"
"chr5","53410194","53410481","JH682236","244835","245122","3","53165359"
"chr5","53418483","53418697","JH682236","253383","253597","7","53165100"
"chr5","53425121","53425427","JH682236","259952","260258","7","53165169"
"chr5","53430585","53430745","chr7","8631901","8632057","42","44798684"
"chr5","53431325","53431591","chr1","56969909","56970172","70","3538584"
"chr5","53437522","53437819","JH682236","272512","272813","71","53165010"
"chr5","53442329","53442516","chr6","33866955","33867140","41","19575374"
"chr5","53444047","53444345","chr10","35758880","35759177","49","17685167"
"chr5","53444348","53444667","chr9","95122753","95123061","66","41678405"
"chr5","53447130","53447425","chr20","56225773","56226070","6","2778643"
"chr5","53450085","53450381","chr20","56223070","56223365","9","2772985"
"chr5","53470547","53470654","chr20","56203589","56203697","3","2733042"
"chr5","53476764","53476782","chr10","10594930","10594946","3","42881834"
"chr5","53477088","53477102","chr1","15674466","15674479","5","37802622"
"chr5","53496980","53497148","chr20","56183000","56183168","10","2686020"
"chr5","53497710","53497991","chr20","56182148","56182438","22","2684438"
"chr5","53500847","53501145","chr10","31970440","31970736","52","21530407"
"chr5","53509304","53509596","chr2","91890474","91890769","59","38381170"
"chr5","53512064","53512164","chr20","56163381","56163481","3","2651317"
"chr5","53512426","53512549","chr20","56162997","56163118","5","2650571"
"chr5","53514894","53515020","chr20","56160523","56160652","4","2645629"
"chr5","53515321","53515498","chr20","56160056","56160227","9","2644735"
"chr5","53519179","53519488","chr11","99553570","99553887","67","46034391"
"chr5","53522546","53522839","chr20","56153150","56153443","4","2630604"
"chr5","53529379","53529683","chr15","9527950","9528251","62","44001429"
"chr5","53559218","53559419","chr20","56114538","56114739","6","2555320"
"chr5","53560005","53560158","chr20","56114088","56114241","4","2554083"
"chr5","53575213","53575351","chr11","52337746","52337886","40","1237467"
"chr5","53586194","53586470","chr20","56086290","56086566","4","2500096"
"chr5","53592905","53593218","chr20","56079887","56080200","6","2486982"
"chr5","53593686","53593850","chr20","56078167","56078317","22","2484481"
"chr5","53594737","53594881","chr20","56077185","56077329","3","2482448"
"chr5","53596736","53596870","chr20","56075268","56075386","19","2478532"
"chr5","53597186","53597456","chr20","56074340","56074610","13","2477154"
"chr5","53610215","53610382","chr20","56059035","56059200","11","2448820"
"chr5","53610420","53610541","chr20","56058880","56059003","6","2448460"
"chr5","53614783","53615089","chr20","56054434","56054741","6","2439651"
"chr5","53618109","53618246","chr20","56051591","56051726","5","2433482"
"chr5","53618554","53618701","chr20","56051145","56051275","20","2432591"
"chr5","53653218","53653372","chr19","14673246","14673394","36","38979972"
"chr5","53657927","53658243","chr20","56008193","56008513","15","2350266"
"chr5","53665667","53665955","chr20","55999024","55999317","18","2333357"
"chr5","53667671","53667806","chr20","55997468","55997597","9","2329797"
"chr5","53667963","53668206","chr20","55997062","55997305","8","2329099"
"chr5","53681788","53681923","chr20","55979730","55979864","5","2297942"
"chr5","53691039","53691312","chr20","55970668","55970944","10","2279629"
"chr5","53694839","53695021","chr19","43378448","43378623","33","10316391"
"chr5","53710300","53710441","chr20","55950593","55950728","10","2240293"
"chr5","53713492","53713801","chr20","55947247","55947556","8","2233755"
"chr5","53717945","53718242","chr20","55943317","55943618","11","2225372"
"chr5","53733295","53733424","chr7","15394911","15395040","19","38338384"
"chr5","53737609","53737739","chr20","55923539","55923685","26","2185930"
"chr5","53738812","53739081","chr20","55922546","55922815","3","2183734"
"chr5","53744037","53744204","chr2","143218482","143218646","28","89474445"
"chr5","53753903","53754198","chr20","55906667","55906957","10","2152764"
"chr5","53756983","53757285","chr9","118375917","118376218","56","64618934"
"chr5","53759084","53759334","chr3","153372936","153373170","53","99613852"
"chr5","53759977","53760149","chr20","55901165","55901334","5","2141188"
"chr5","53764281","53764571","chr20","55897198","55897488","7","2132917"
"chr5","53766472","53766764","chr20","55894995","55895287","8","2128523"
"chr5","53769749","53770052","chr20","55891756","55892048","15","2122007"
"chr5","53771513","53771684","chr8","119852658","119852833","29","66081145"
"chr5","53772534","53772807","chr20","55889328","55889599","11","2116794"
"chr5","53779944","53780165","chr12","65179390","65179599","55","11399446"
"chr5","53781360","53781667","chr20","55878569","55878876","10","2097209"
"chr5","53783205","53783503","chr20","55876737","55877034","5","2093532"
"chr5","53795628","53795921","chr17","72880935","72881238","62","19085307"
"chr5","53797646","53797933","chr20","55866452","55866745","13","2068806"
"chr5","53812221","53812473","chr5","175400136","175400371","61","121587915"
"chr5","53816592","53816882","chr20","55847454","55847701","48","2030862"
"chr5","53859471","53859787","chr20","55803683","55803997","11","1944212"
"chr5","53909486","53909761","chr20","55754110","55754385","8","1844624"
"chr5","53913167","53913477","chr20","55750914","55751226","15","1837747"
"chr5","53958499","53958782","chr20","55704729","55705013","14","1746230"
"chr5","53970760","53970915","chr5","71626465","71626625","33","17655705"
"chr5","54012747","54013044","chr20","55654560","55654861","13","1641813"
"chr5","54023358","54023648","chr20","55641586","55641876","10","1618228"
"chr5","54024234","54024523","chr20","55640714","55641000","9","1616480"
"chr5","54039661","54039928","chr20","55625279","55625566","33","1585618"
"chr5","54041172","54041474","chr20","55623731","55624042","18","1582559"
"chr5","54046153","54046239","chr20","55618883","55618969","1","1572730"
"chr5","54048562","54048863","chr20","55616261","55616560","20","1567699"
"chr5","54060130","54060427","chr20","55604687","55604980","10","1544557"
"chr5","54070959","54071221","chr20","55597177","55597441","11","1526218"
"chr5","54111266","54111440","chr20","55561357","55561531","5","1450091"
"chr5","54111705","54111838","chr20","55560953","55561084","8","1449248"
"chr5","54122856","54122971","chr20","55551000","55551113","5","1428144"
"chr5","54128278","54128376","chr20","55545564","55545662","3","1417286"
"chr5","54128412","54128595","chr20","55545345","55545520","9","1416933"
"chr5","54182945","54183266","chr20","55494796","55495101","21","1311851"
"chr5","54205633","54205937","chr20","55471820","55472122","16","1266187"
"chr5","54306521","54306827","chr20","55369947","55370255","7","1063426"
"chr5","54356543","54356811","chr20","55320120","55320388","8","963577"
"chr5","54364528","54364610","chr20","55312503","55312585","2","947975"
"chr5","54383379","54383658","chr20","55294056","55294335","5","910677"
"chr5","54408684","54408999","chr8","24442474","24442776","64","29966210"
"chr5","54436791","54437012","chr16","72899222","72899445","57","18462431"
"chr5","54448086","54448427","chr20","55228090","55228425","16","780004"
"chr5","54467924","54468252","chr20","55207583","55207910","12","739659"
"chr5","54486265","54486572","chr20","55188141","55188448","9","701876"
"chr5","54488176","54488384","chr20","55185971","55186186","25","697795"
"chr5","54489474","54489744","chr20","55184633","55184903","10","695159"
"chr5","54527199","54527508","chr20","55146982","55147278","21","619783"
"chr5","54536204","54536408","chr20","55140398","55140598","13","604194"
"chr5","54539970","54540251","chr20","55136564","55136846","8","596594"
"chr5","54587969","54588274","chr20","55089183","55089489","10","501214"
"chr5","54600799","54600932","chr20","55076274","55076407","4","475475"
"chr5","54601232","54601414","chr20","55075764","55075935","29","474532"
"chr5","54610890","54611108","chr20","55066082","55066300","3","455192"
"chr5","54615169","54615475","chr20","55061729","55062036","7","446560"
"chr5","54630502","54630771","chr1","202493014","202493283","52","147862512"
"chr5","54637701","54637874","chr10","61265748","61265920","31","6628047"
"chr5","54647408","54647671","chr20","55026262","55026531","9","378854"
"chr5","54668700","54668998","chr20","54999594","54999892","7","330894"
"chr5","54676331","54676672","chr20","54992201","54992507","44","315870"
"chr5","54682610","54682883","chr20","54986035","54986303","5","303425"
"chr5","54697241","54697551","chr20","54971103","54971408","10","273862"
"chr5","54739664","54739766","chr1","42759655","42759752","22","11980009"
"chr5","54755933","54756212","chr20","54923240","54923513","37","167307"
"chr5","54759510","54759821","chr20","54919458","54919767","12","159948"
"chr5","54767041","54767322","chr20","54912439","54912720","5","145398"
"chr5","54789534","54789834","chr20","54889532","54889844","14","99998"
"chr5","54791474","54791760","chr20","54887645","54887931","6","96171"
"chr5","54801853","54802136","chr20","54876945","54877233","7","75092"
"chr5","54809198","54809484","chr1","202516445","202516736","63","147707247"
"chr5","54819964","54820271","chr20","54856989","54857291","8","37025"
"chr5","54830108","54830422","chr20","54846498","54846809","7","16390"
"chr5","54839548","54839670","chr15","4557512","4557626","27","50282036"
"chr5","54842000","54842281","chr20","54834652","54834942","32","7348"
"chr5","54847617","54847904","chr20","54829275","54829562","3","18342"
"chr5","54849669","54849972","chr20","54827207","54827509","6","22462"
"chr5","54858992","54859269","chr12","20754332","20754612","49","34104660"
"chr5","54861205","54861437","chr20","54815043","54815275","11","46162"
"chr5","54871192","54871495","chr16","47397286","47397584","55","7473906"
"chr5","54871605","54871784","chr20","54804217","54804400","7","67388"
"chr5","54875857","54876084","chr20","54800049","54800272","10","75808"
"chr5","54876865","54877173","chr20","54798927","54799253","26","77938"
"chr5","54887248","54887539","chr20","54788149","54788442","6","99099"
"chr5","54892420","54892700","chr20","54782982","54783252","15","109438"
"chr5","54908514","54908623","chr20","54766569","54766678","2","141945"
"chr5","54908950","54909200","chr20","3053218","3053475","74","51855732"
"chr5","54909832","54909986","chr20","54765217","54765369","5","144615"
"chr5","54920815","54921121","chr20","54754731","54755041","8","166084"
"chr5","54921380","54921584","chr20","54754269","54754476","17","167111"
"chr5","54923584","54923894","chr20","54752101","54752412","10","171483"
"chr5","54940448","54940728","chr20","54742157","54742460","30","198291"
"chr5","54941473","54941760","chr20","54741148","54741435","8","200325"
"chr5","54950784","54950911","chr20","54732638","54732765","2","218146"
"chr5","54951524","54951700","chr20","54732154","54732327","4","219370"
"chr5","54956010","54956202","chr20","54728169","54728375","23","227841"
"chr5","54956547","54956845","chr20","54727397","54727692","10","229150"
"chr5","54959012","54959305","chr20","54725156","54725449","8","233856"
"chr5","54960207","54960525","chr8","93226324","93226633","69","38266117"
"chr5","54972261","54972444","chr20","54710913","54711094","6","261348"
"chr5","54973215","54973535","chr20","54718506","54718797","34","254709"
"chr5","54975956","54976263","chr20","54715273","54715545","37","260683"
"chr5","55009337","55009636","chrX","9069614","9069919","62","45939723"
"chr5","55017066","55017387","chr20","54669399","54669737","23","347667"
"chr5","55017466","55017763","chr20","54669025","54669320","9","348441"
"chr5","55028428","55028664","chr11","82387520","82387742","49","27359092"
"chr5","55032769","55033057","chr20","54650397","54650688","10","382372"
"chr5","55033065","55033275","chr20","54650219","54650393","43","382846"
"chr5","55033583","55033660","chr1","146054287","146054366","21","91020704"
"chr5","55043295","55043451","chr7","131162919","131163073","28","76119624"
"chr5","55048683","55048976","chr20","54633807","54634100","9","414876"
"chr5","55054586","55054885","chr20","54628324","54628601","28","426262"
"chr5","55059567","55059831","chr20","54623363","54623627","5","436204"
"chr5","55071037","55071338","chr20","54612171","54612473","11","458866"
"chr5","55072841","55073041","chr1","35936800","35937000","40","19136041"
"chr5","55076656","55076935","chr20","54606399","54606678","5","470257"
"chr5","55090442","55090762","chr20","54597170","54597474","27","493272"
"chr5","55096798","55097102","chr20","54590649","54590953","7","506149"
"chr5","55100060","55100362","chr20","54587341","54587657","57","512719"
"chr5","55103585","55103717","chr1","21721800","21721934","13","33381785"
"chr5","55107099","55107390","chr20","54579718","54580004","18","527381"
"chr5","55110789","55111089","chr20","54576011","54576311","5","534778"
"chr5","55111761","55112064","chr20","54575028","54575333","6","536733"
"chr5","55114194","55114491","chr20","54572725","54573021","9","541469"
"chr5","55114868","55115021","chr20","54572198","54572352","7","542670"
"chr5","55116316","55116444","chr20","54570731","54570862","8","545585"
"chr5","55127410","55127658","chr1","203997434","203997688","54","148870024"
"chr5","55138064","55138359","chr20","54548844","54549134","20","589220"
"chr5","55140329","55140616","chr20","54546593","54546878","9","593736"
"chr5","55141791","55141946","chr20","54545242","54545397","3","596549"
"chr5","55142234","55142363","chr20","54544825","54544953","8","597409"
"chr5","55173162","55173427","chr20","54514106","54514371","8","659056"
"chr5","55174587","55174890","chr20","54512637","54512944","27","661950"
"chr5","55189365","55189658","chr20","54503503","54503796","6","685862"
"chr5","55192783","55192989","chr20","54500179","54500385","2","692604"
"chr5","55196877","55197154","chr20","54496154","54496431","4","700723"
"chr5","55201065","55201284","chr20","54491867","54492086","3","709198"
"chr5","55283883","55284168","chr20","54408236","54408521","6","875647"
"chr5","55286764","55287066","chr20","54404366","54404668","2","882398"
"chr5","55320889","55321169","chr20","54370642","54370925","7","950247"
"chr5","55328587","55328850","chr20","54363279","54363540","5","965308"
"chr5","55356284","55356600","chr20","54335350","54335662","8","1020934"
"chr5","55363819","55364111","chr20","54327850","54328142","7","1035969"
"chr5","55409522","55409638","chr20","54282058","54282173","3","1127464"
"chr5","55466549","55466671","chr20","54220380","54220504","3","1246169"
"chr5","55563156","55563239","chr10","13477994","13478070","24","42085162"
"chr5","55565135","55565293","chr20","54117237","54117395","6","1447898"
"chr5","55569044","55569307","chr20","54113233","54113486","12","1455811"
"chr5","55601750","55602032","chr20","54080617","54080899","6","1521133"
"chr5","55637958","55638122","chr20","54044757","54044924","6","1593201"
"chr5","55660471","55660757","chr20","54017813","54018099","6","1642658"
"chr5","55663562","55663867","chr20","54014711","54015016","5","1648851"
"chr5","55674273","55674603","chrX","44037154","44037484","68","11637119"
"chr5","55685973","55686187","chr12","67237172","67237391","41","11551199"
"chr5","55706307","55706468","chr20","21179351","21179502","38","34526956"
"chr5","55720361","55720637","chr20","53958934","53959212","12","1761427"
"chr5","55727055","55727336","chr20","4882859","4883147","61","50844196"
"chr5","55728887","55729059","chr20","53951346","53951518","4","1777541"
"chr5","55729666","55729798","chr20","53950608","53950740","2","1779058"
"chr5","55735708","55735754","chr20","53944658","53944704","0","1791050"
"chr5","55738495","55738792","chr20","53941620","53941917","4","1796875"
"chr5","55739861","55740168","chr20","53940314","53940582","44","1799547"
"chr5","55747160","55747469","chr20","53932749","53933061","13","1814411"
"chr5","55750718","55751005","chr20","53928148","53928435","3","1822570"
"chr5","55753011","55753154","chr20","53925987","53926142","14","1827024"
"chr5","55753466","55753623","chr4","43031533","43031689","31","12721933"
"chr5","55753657","55753676","chr13","14420582","14420599","4","41333075"
"chr5","55776435","55776724","chr20","53903233","53903525","28","1873202"
"chr5","55781919","55782227","chr20","53896329","53896605","42","1885590"
"chr5","55801461","55801785","chr20","53876554","53876859","25","1924907"
"chr5","55811634","55811956","chr20","53866411","53866725","20","1945223"
"chr5","55823923","55824248","chr11","63571007","63571332","84","7747084"
"chr5","55824330","55824614","chr19","44201821","44202104","62","11622509"
"chr5","55827136","55827433","chr20","22795040","22795315","70","33032096"
"chr5","55831867","55832106","chr20","53845891","53846139","18","1985976"
"chr5","55835088","55835205","chr2","135364689","135364804","19","79529601"
"chr5","55840970","55841165","chr20","53836913","53837107","7","2004057"
"chr5","55859795","55860090","chr20","53818174","53818469","6","2041621"
"chr5","55863958","55864250","chr20","53813697","53813989","5","2050261"
"chr5","55940324","55940624","chr20","53733458","53733752","10","2206866"
"chr5","55954260","55954513","chr20","53719583","53719855","23","2234677"
"chr5","55967929","55968103","chr20","53706057","53706231","4","2261872"
"chr5","55982775","55982875","chr20","29290541","29290642","10","26692234"
"chr5","55988488","55988760","chr20","53685350","53685622","8","2303138"
"chr5","55995074","55995345","chr1","29988934","29989193","61","26006140"
"chr5","56020206","56020493","chr20","53653933","53654215","15","2366273"
"chr5","56022120","56022413","chr20","53651996","53652292","17","2370124"
"chr5","56034171","56034463","chr20","53639949","53640240","34","2394222"
"chr5","56040021","56040322","chr20","53634052","53634345","20","2405969"
"chr5","56041516","56041826","chr20","53632553","53632860","12","2408963"
"chr5","56043819","56044124","chr20","53630528","53630831","9","2413291"
"chr5","56047827","56048127","chr20","53626529","53626828","12","2421298"
"chr5","56068643","56068702","chr1","161214050","161214110","14","105145407"
"chr5","56069005","56069232","chr8","95877669","95877893","48","39808664"
"chr5","56076886","56077185","chr20","53597687","53597980","17","2479199"
"chr5","56078541","56078816","chr20","53596032","53596318","19","2482509"
"chr5","56105698","56105980","chr20","53568203","53568488","17","2537495"
"chr5","56109893","56110191","chr20","53564022","53564317","9","2545871"
"chr5","56123678","56123996","chr20","53550613","53550925","12","2573065"
"chr5","56127421","56127731","chr20","53546878","53547192","7","2580543"
"chr5","56132451","56132717","chr20","53541479","53541746","7","2590972"
"chr5","56139456","56139766","chr20","53534414","53534723","5","2605042"
"chr5","56141239","56141542","chr20","53532623","53532898","33","2608616"
"chr5","56143142","56143448","chr17","77730330","77730626","67","21587188"
"chr5","56144198","56144508","chr20","53529666","53529969","14","2614532"
"chr5","56165112","56165415","chr20","53508840","53509143","5","2656272"
"chr5","56166003","56166123","chr20","53508109","53508233","6","2657894"
"chr5","56200987","56201296","chr20","53473012","53473321","6","2727975"
"chr5","56209779","56210086","chr20","53466496","53466796","19","2743283"
"chr5","56212899","56213209","chr20","53463388","53463698","6","2749511"
"chr5","56216698","56217000","chr20","53459636","53459914","32","2757062"
"chr5","56217180","56217467","chr13","8362071","8362358","59","47855109"
"chr5","56234944","56235244","chr8","93440212","93440515","63","37205268"
"chr5","56242640","56242940","chr20","53434288","53434586","9","2808352"
"chr5","56265955","56266263","chr1","65255674","65255956","57","8989719"
"chr5","56283835","56283984","chr20","53392693","53392842","3","2891142"
"chr5","56291830","56292110","chr20","53384735","53385017","9","2907095"
"chr5","56324870","56325177","chr20","53352637","53352940","8","2972233"
"chr5","56359517","56359818","chr20","53316820","53317105","20","3042697"
"chr5","56366794","56367083","chr20","53309546","53309832","12","3057248"
"chr5","56474740","56475050","chr20","53204415","53204723","18","3270325"
"chr5","56545906","56546205","chr20","53132646","53132937","10","3413260"
"chr5","56576582","56576695","chr13","41518075","41518182","24","15058507"
"chr5","56577085","56577195","chr11","84193525","84193632","28","27616440"
"chr5","56599990","56600275","chr20","53078273","53078558","4","3521717"
"chr5","56620304","56620615","chrX","46200808","46201119","60","10419496"
"chr5","56623445","56623748","chr20","53054866","53055183","22","3568579"
"chr5","56631119","56631429","chr20","53047188","53047493","13","3583931"
"chr5","56736900","56737075","chr20","52946218","52946393","2","3790682"
"chr5","56742375","56742685","chr20","52940549","52940864","14","3801826"
"chr5","56749372","56749678","chr20","52933568","52933871","15","3815804"
"chr5","56822889","56823171","chr20","52860251","52860533","7","3962638"
"chr5","56835537","56835681","chr20","52847906","52848050","2","3987631"
"chr5","56835941","56836120","chr20","52847466","52847646","4","3988475"
"chr5","56841899","56842227","chr20","52841351","52841680","11","4000548"
"chr5","56857451","56857758","chr20","52825787","52826089","18","4031664"
"chr5","56914745","56914844","chr20","52769549","52769648","2","4145196"
"chr5","56939938","56940239","chr20","52743709","52744010","8","4196229"
"chr5","56991073","56991373","chr20","52691639","52691923","26","4299434"
"chr5","56992295","56992569","chr6","127634703","127634966","60","70642408"
"chr5","57033178","57033464","chr20","52649321","52649607","8","4383857"
"chr5","57082467","57082652","chr11","122274374","122274548","56","65191907"
"chr5","57110974","57111247","chr20","52572510","52572783","13","4538464"
"chr5","57113718","57113868","chr10","13063054","13063208","29","44050664"
"chr5","57172291","57172580","chr20","52512019","52512307","11","4660272"
"chr5","57237950","57238235","chr20","52444632","52444922","14","4793318"
"chr5","57311313","57311575","chr20","52377511","52377782","16","4933802"
"chr5","57327076","57327357","chr20","52365483","52365761","18","4961593"
"chr5","57328318","57328627","chr20","52364237","52364545","10","4964081"
"chr5","57333808","57334035","chr20","52358834","52359061","5","4974974"
"chr5","57335686","57335986","chr20","52356880","52357175","9","4978806"
"chr5","57337837","57338070","chr2","87828821","87829050","50","30490984"
"chr5","57340538","57340780","chr20","52352081","52352329","13","4988457"
"chr5","57346683","57346985","chr20","52345904","52346206","9","5000779"
"chr5","57347005","57347121","chr12","21471440","21471552","21","35875565"
"chr5","57368433","57368679","chr11","93604681","93604934","57","36236248"
"chr5","57390735","57391022","chr20","52307020","52307307","11","5083715"
"chr5","57397227","57397505","chr20","52300254","52300527","16","5096973"
"chr5","57413073","57413369","chr20","52284420","52284716","5","5128653"
"chr5","57414173","57414466","chr20","52283352","52283641","18","5130821"
"chr5","57435318","57435604","chr20","52261129","52261420","18","5174189"
"chr5","57436108","57436421","chr20","52260320","52260632","19","5175788"
"chr5","57447117","57447413","chr20","52249415","52249727","22","5197702"
"chr5","57459953","57460249","chr20","52235608","52235911","8","5224345"
"chr5","57460250","57460530","chr20","52235326","52235607","11","5224924"
"chr5","57487350","57487661","chr14","92998547","92998853","49","35511197"
"chr5","57490713","57490843","chr20","52205283","52205413","4","5285430"
"chr5","57491651","57491914","chr20","52204227","52204490","5","5287424"
"chr5","57492914","57493207","chr4","4436304","4436604","53","53056610"
"chr5","57494142","57494339","chr20","52201456","52201657","12","5292686"
"chr5","57494662","57494795","chr20","52201003","52201137","9","5293659"
"chr5","57499591","57499895","chr20","52195562","52195867","9","5304029"
"chr5","57509419","57509721","chr20","52185522","52185828","15","5323897"
"chr5","57516752","57516994","chr11","47134079","47134301","50","10382673"
"chr5","57522373","57522682","chr20","52172280","52172593","19","5350093"
"chr5","57542896","57543156","chr20","52151164","52151443","20","5391732"
"chr5","57544207","57544514","chr3","85757424","85757724","65","28213217"
"chr5","57547043","57547174","chr20","52147158","52147288","5","5399885"
"chr5","57547612","57547914","chr4","24567157","24567462","54","32980455"
"chr5","57551366","57551667","chr20","52142031","52142330","15","5409335"
"chr5","57563878","57564171","chr20","52129833","52130124","12","5434045"
"chr5","57569640","57569935","chr20","52124680","52124975","7","5444960"
"chr5","57574215","57574523","chr1","85729944","85730252","63","28155729"
"chr5","57575218","57575512","chr20","52119137","52119431","7","5456081"
"chr5","57590011","57590069","chr7","159497286","159497348","9","101907275"
"chr5","57590070","57590246","chr16","31090258","31090438","43","26499812"
"chr5","57594106","57594414","chr20","52100762","52101066","9","5493344"
"chr5","57600597","57600779","chr20","52094249","52094461","43","5506348"
"chr5","57602347","57602532","chr20","52092157","52092352","19","5510190"
"chr5","57606625","57606944","chr20","52087445","52087764","7","5519180"
"chr5","57612956","57613223","chr20","52080813","52081080","7","5532143"
"chr5","57613662","57613973","chr1","139182353","139182662","53","81568691"
"chr5","57626056","57626352","chr20","52066543","52066837","30","5559513"
"chr5","57631630","57631919","chr20","52061218","52061508","17","5570412"
"chr5","57638504","57638787","chr20","52054407","52054715","33","5584097"
"chr5","57641422","57641722","chr20","52051516","52051815","5","5589906"
"chr5","57650414","57650694","chr20","52040944","52041224","2","5609470"
"chr5","57664234","57664406","chr16","28621891","28622060","40","29042343"
"chr5","57664558","57664857","chr20","52028152","52028443","18","5636406"
"chr5","57673359","57673670","chr20","52018430","52018742","9","5654929"
"chr5","57678500","57678669","chr20","52013652","52013821","4","5664848"
"chr5","57680890","57681165","chr20","52011160","52011434","12","5669730"
"chr5","57681685","57681974","chr20","52010350","52010639","0","5671335"
"chr5","57687849","57688105","chr20","52004237","52004504","19","5683612"
"chr5","57697119","57697422","chr15","56527536","56527835","58","1169583"
"chr5","57718433","57718600","chr20","51972610","51972777","3","5745823"
"chr5","57719509","57719704","chr20","51971800","51971995","4","5747709"
"chr5","57721713","57722016","chr20","51969467","51969769","6","5752246"
"chr5","57722640","57722946","chr20","51968539","51968844","9","5754101"
"chr5","57736291","57736540","chr20","51954276","51954528","7","5782015"
"chr5","57743233","57743532","chr20","51947286","51947584","5","5795947"
"chr5","57759414","57759703","chr20","51930755","51931045","3","5828659"
"chr5","57761568","57761877","chr20","51928583","51928889","11","5832985"
"chr5","57773358","57773511","chr20","51916948","51917101","3","5856410"
"chr5","57773747","57773906","chr20","51916553","51916712","6","5857194"
"chr5","57786856","57787024","chr20","51903427","51903597","4","5883429"
"chr5","57791141","57791428","chr20","51898916","51899202","10","5892225"
"chr5","57792954","57793223","chr20","51896984","51897275","30","5895970"
"chr5","57800327","57800622","chr20","51889686","51889990","14","5910641"
"chr5","57801204","57801472","chr20","51888850","51889118","7","5912354"
"chr5","57802468","57802588","chr13","25829961","25830083","23","31972507"
"chr5","57802889","57803083","chr2","48536192","48536378","42","9266697"
"chr5","57827443","57827565","chr20","51862758","51862882","4","5964685"
"chr5","57828653","57828864","chr20","51861462","51861673","6","5967191"
"chr5","57843184","57843489","chr20","51845384","51845682","11","5997800"
"chr5","57853471","57853750","chr20","51834397","51834676","3","6019074"
"chr5","57863032","57863339","chr20","51825333","51825631","18","6037699"
"chr5","57896048","57896217","chr20","56761401","56761558","41","1134647"
"chr5","57896518","57896647","chr4","126174713","126174844","20","68278195"
"chr5","57897400","57897583","chr17","77000005","77000189","42","19102605"
"chr5","57912864","57913156","chr20","51775093","51775377","12","6137771"
"chr5","57921649","57921964","chr20","51766759","51767074","7","6154890"
"chr5","57925013","57925120","chr20","51763609","51763716","1","6161404"
"chr5","57971506","57971809","chr20","51716408","51716712","12","6255098"
"chr5","57972771","57973067","chr20","51715141","51715445","16","6257630"
"chr5","57980081","57980392","chr20","51707790","51708100","8","6272291"
"chr5","57983768","57984079","chr20","51704384","51704703","16","6279384"
"chr5","57991677","57991990","chr20","51696578","51696897","18","6295099"
"chr5","58002976","58003280","chr20","51685074","51685373","11","6317902"
"chr5","58007060","58007211","chr20","51681158","51681309","3","6325902"
"chr5","58012887","58012987","chr13","24471364","24471466","23","33541523"
"chr5","58013070","58013140","chr5","159002076","159002138","21","100989006"
"chr5","58013436","58013559","chr16","51773320","51773442","27","6240116"
"chr5","58016274","58016398","chr20","51671987","51672107","8","6344287"
"chr5","58016428","58016598","chr20","51671791","51671959","9","6344637"
"chr5","58023936","58024234","chr20","51663349","51663647","17","6360587"
"chr5","58029511","58029830","chr20","51657477","51657782","24","6372034"
"chr5","58031409","58031710","chr20","51655609","51655893","38","6375800"
"chr5","58035952","58036205","chr20","51651374","51651627","4","6384578"
"chr5","58044955","58045271","chr20","51642211","51642521","8","6402744"
"chr5","58045608","58045894","chr9","93083908","93084193","8","35038300"
"chr5","58047900","58048030","chr20","51639470","51639600","2","6408430"
"chr5","58053986","58054272","chr20","51633341","51633627","3","6420645"
"chr5","58062184","58062493","chr20","51624476","51624785","11","6437708"
"chr5","58068833","58069131","chr20","51618638","51618941","10","6450195"
"chr5","58083382","58083645","chr20","51603778","51604031","18","6479604"
"chr5","58116407","58116685","chr20","51571077","51571361","13","6545330"
"chr5","58118614","58118753","chr20","51568660","51568786","16","6549954"
"chr5","58120102","58120391","chr20","51567060","51567349","1","6553042"
"chr5","58122972","58123056","chr20","51564404","51564488","0","6558568"
"chr5","58123563","58123834","chr20","51563618","51563896","17","6559945"
"chr5","58140619","58140909","chr7","150126938","150127230","62","91986319"
"chr5","58149640","58149935","chr7","125986589","125986881","50","67836949"
"chr5","58150970","58151121","chr12","63492488","63492637","32","5341518"
"chr5","58165930","58166231","chr20","51529200","51529501","7","6636730"
"chr5","58175822","58176049","chr2","165641343","165641574","47","107465521"
"chr5","58176349","58176432","chr3","109986164","109986245","11","51809815"
"chr5","58176739","58177018","chr20","51517627","51517926","31","6659112"
"chr5","58188385","58188654","chr20","51505991","51506261","5","6682394"
"chr5","58189446","58189753","chr20","51504889","51505199","17","6684557"
"chr5","58200487","58200593","chr20","51494266","51494376","5","6706221"
"chr5","58200881","58200946","chr20","51493915","51493978","5","6706966"
"chr5","58206379","58206675","chr20","51488031","51488323","11","6718348"
"chr5","58215509","58215668","chr3","160144613","160144771","28","101929104"
"chr5","58224451","58224724","chr20","51459850","51460123","4","6764601"
"chr5","58234416","58234661","chr20","51454316","51454593","36","6780100"
"chr5","58242806","58243107","chr17","12240055","12240355","62","46002751"
"chr5","58246610","58246895","chr20","51441069","51441349","16","6805541"
"chr5","58249807","58250132","chr12","80433480","80433799","73","22183673"
"chr5","58256654","58256946","chr20","51431016","51431305","6","6825638"
"chr5","58267025","58267324","chr20","51420031","51420335","9","6846994"
"chr5","58270965","58271117","chr20","51416239","51416380","15","6854726"
"chr5","58284513","58284673","chr20","51403172","51403332","5","6881341"
"chr5","58308372","58308633","chr20","51379880","51380141","8","6928492"
"chr5","58314599","58314761","chr20","51372605","51372771","7","6941994"
"chr5","58326736","58326996","chr20","51364344","51364633","37","6962392"
"chr5","58330905","58331069","chr1","45065798","45065959","38","13265107"
"chr5","58343940","58344053","chr20","51343069","51343186","6","7000871"
"chr5","58351507","58351837","chr20","51334473","51334802","8","7017034"
"chr5","58361992","58362253","chr20","51322317","51322579","4","7039675"
"chr5","58364609","58364910","chr20","51319326","51319626","16","7045283"
"chr5","58370926","58371236","chr20","51312674","51312984","5","7058252"
"chr5","58379796","58380105","chr20","51302560","51302858","19","7077236"
"chr5","58390574","58390864","chr20","51291791","51292083","7","7098783"
"chr5","58405965","58406247","chr20","51276084","51276366","8","7129881"
"chr5","58410290","58410568","chr20","51271822","51272119","25","7138468"
"chr5","58416592","58416890","chr20","51265799","51266078","28","7150793"
"chr5","58420362","58420652","chr20","51261712","51262003","3","7158650"
"chr5","58421258","58421551","chr20","51260818","51261109","9","7160440"
"chr5","58430459","58430755","chr12","99689911","99690212","69","41259452"
"chr5","58434449","58434707","chr4","35684015","35684288","48","22750434"
"chr5","58441200","58441482","chr20","51241815","51242102","15","7199385"
"chr5","58453485","58453738","chr20","51233426","51233671","18","7220059"
"chr5","58462495","58462750","chr20","51218811","51219064","10","7243684"
"chr5","58467256","58467574","chr20","51214235","51214523","43","7253021"
"chr5","58470697","58470999","chr20","51209146","51209449","8","7261551"
"chr5","58497830","58497986","chr17","52222366","52222518","30","6275464"
"chr5","58506614","58506840","chr20","51171052","51171284","11","7335562"
"chr5","58513623","58513708","chr3","41728810","41728887","18","16784813"
"chr5","58514015","58514219","chrX","99881690","99881893","32","41367675"
"chr5","58514879","58515011","chr20","51163457","51163583","6","7351422"
"chr5","58536108","58536402","chr20","51142002","51142300","10","7394106"
"chr5","58545529","58545821","chr20","51131607","51131899","11","7413922"
"chr5","58558323","58558624","chr20","51116224","51116525","5","7442099"
"chr5","58567483","58567758","chr20","51106672","51106948","14","7460811"
"chr5","58572354","58572654","chr2","44882107","44882408","55","13690247"
"chr5","58574457","58574661","chr20","51100220","51100429","11","7474237"
"chr5","58577041","58577319","chr20","51097094","51097375","12","7479947"
"chr5","58579538","58579838","chr20","51094587","51094892","16","7484951"
"chr5","58587309","58587599","chr7","14286956","14287238","62","44300353"
"chr5","58591898","58592179","chr20","51081572","51081870","25","7510326"
"chr5","58593156","58593456","chr15","5023540","5023842","49","53569616"
"chr5","58599110","58599273","chr10","27501941","27502094","31","31097169"
"chr5","58607579","58607820","chr4","84589217","84589447","55","25981638"
"chr5","58633340","58633475","chr10","81587137","81587272","21","22953797"
"chr5","58633476","58633784","chr10","50389396","50389695","58","8244080"
"chr5","58637378","58637564","chr20","51034793","51034975","11","7602585"
"chr5","58640265","58640446","chr11","120284888","120285064","39","61644623"
"chr5","58642825","58643116","chr7","49571405","49571710","55","9071420"
"chr5","58647379","58647519","chr15","67621085","67621211","45","8973706"
"chr5","58658658","58658963","chr4","152226280","152226592","56","93567622"
"chr5","58660401","58660703","chr20","51013467","51013765","12","7646934"
"chr5","58670385","58670733","chr20","51003043","51003395","19","7667342"
"chr5","58676991","58677110","chr20","50998002","50998122","7","7678989"
"chr5","58677410","58677432","chr20","50997683","50997701","5","7679727"
"chr5","58677716","58677898","chr20","50997222","50997388","17","7680494"
"chr5","58683431","58683745","chr1","46792670","46792969","93","11890761"
"chr5","58685804","58686079","chr19","4051500","4051775","5","54634304"
"chr5","58688158","58688484","chr20","50983587","50983882","36","7704571"
"chr5","58692735","58692861","chr20","50978585","50978706","9","7714150"
"chr5","58697505","58697814","chr20","50973772","50974080","6","7723733"
"chr5","58699428","58699688","chr5","52984284","52984532","61","5715144"
"chr5","58712370","58712666","chr20","50959215","50959512","17","7753155"
"chr5","58724336","58724614","chrX","41457035","41457309","45","17267301"
"chr5","58735210","58735359","chr20","50937929","50938078","2","7797281"
"chr5","58735630","58735687","chr20","50937601","50937658","1","7798029"
"chr5","58748947","58749076","chr12","80614773","80614908","31","21865826"
"chr5","58759869","58760169","chr20","50911750","50912066","26","7848119"
"chr5","58770413","58770723","chr20","50901467","50901776","7","7868946"
"chr5","58775141","58775456","chr20","50897136","50897449","16","7878005"
"chr5","58781805","58781920","chr20","50891384","50891499","1","7890421"
"chr5","58782227","58782378","chr20","50890925","50891077","7","7891302"
"chr5","58784544","58784676","chr13","9241378","9241499","32","49543166"
"chr5","58788688","58788850","chr20","50884303","50884456","11","7904385"
"chr5","58797458","58797774","chr20","50874514","50874833","10","7922944"
"chr5","58799747","58800037","chr20","50870717","50871005","9","7929030"
"chr5","58803154","58803457","chr2","106388382","106388678","71","47585228"
"chr5","58805971","58806066","chr15","38079462","38079553","26","20726509"
"chr5","58807012","58807125","chr20","50863315","50863432","6","7943697"
"chr5","58807420","58807540","chr20","50862904","50863023","4","7944516"
"chr5","58808413","58808575","chr20","50861858","50862017","12","7946555"
"chr5","58811443","58811729","chr20","50858915","50859159","54","7952528"
"chr5","58812373","58812682","chr20","50857904","50858212","13","7954469"
"chr5","58817571","58817881","chr20","50852784","50853093","12","7964787"
"chr5","58821672","58822002","chr20","50848497","50848827","6","7973175"
"chr5","58825418","58825567","chr2","100069015","100069158","34","41243597"
"chr5","58829584","58829740","chr20","50840789","50840951","10","7988795"
"chr5","58832622","58832920","chr20","50837605","50837896","13","7995017"
"chr5","58840977","58841240","chr20","50828781","50829051","11","8012196"
"chr5","58848546","58848692","chr20","50821571","50821717","5","8026975"
"chr5","58848700","58848998","chr20","53352637","53352940","46","5496063"
"chr5","58855799","58856088","chr2","81897820","81898117","58","23042021"
"chr5","58871223","58871464","chr20","50798937","50799178","10","8072286"
"chr5","58891352","58891514","chr4","123473830","123473989","25","64582478"
"chr5","58891695","58891708","chr1","158417999","158418010","4","99526304"
"chr5","58899783","58900042","chr20","50768374","50768640","9","8131409"
"chr5","58909521","58909634","chr20","50758477","50758585","8","8151044"
"chr5","58974199","58974511","chr20","50696329","50696641","5","8277870"
"chr5","58981579","58981875","chr20","50688964","50689264","9","8292615"
"chr5","58994814","58994985","chr20","50675878","50676055","9","8318936"
"chr5","59009638","59009947","chrX","15697361","15697669","46","43312277"
"chr5","59010734","59010858","chr20","50660040","50660163","3","8350694"
"chr5","59011167","59011333","chr20","50659575","50659734","12","8351592"
"chr5","59025199","59025504","chr20","50645497","50645798","12","8379702"
"chr5","59067382","59067677","chr20","50603235","50603525","13","8464147"
"chr5","59077365","59077513","chr20","50594751","50594889","14","8482614"
"chr5","59089839","59090119","chr20","50581732","50582012","9","8508107"
"chr5","59092463","59092681","chr20","50578867","50579083","6","8513596"
"chr5","59095274","59095568","chr20","50575673","50575964","13","8519601"
"chr5","59104617","59104904","chr20","50566473","50566754","10","8538144"
"chr5","59104936","59105114","chr2","43232993","43233164","35","15871943"
"chr5","59111101","59111389","chr20","50559928","50560209","12","8551173"
"chr5","59113578","59113893","chr20","50557407","50557720","17","8556171"
"chr5","59130627","59130928","chr20","50540351","50540637","22","8590276"
"chr5","59141676","59141989","chr20","50528758","50529077","10","8612918"
"chr5","59147133","59147440","chr20","50523005","50523310","11","8624128"
"chr5","59162421","59162765","chr20","50506710","50507054","15","8655711"
"chr5","59165278","59165587","chr20","50504081","50504381","17","8661197"
"chr5","59177990","59178291","chr20","50490887","50491205","23","8687103"
"chr5","59183173","59183446","chr20","50485652","50485970","54","8697521"
"chr5","59200851","59200977","chr7","23009438","23009561","26","36191413"
"chr5","59201041","59201218","chr7","59806548","59806726","53","605507"
"chr5","59206875","59207208","chr20","50462266","50462595","16","8744609"
"chr5","59213686","59213968","chr20","50454878","50455155","9","8758808"
"chr5","59214488","59214648","chr12","93463713","93463873","33","34249225"
"chr5","59221010","59221308","chr20","50447691","50447989","4","8773319"
"chr5","59223083","59223393","chr20","50445603","50445912","4","8777480"
"chr5","59224246","59224418","chr20","50444585","50444750","8","8779661"
"chr5","59224713","59224853","chr20","50444147","50444287","3","8780566"
"chr5","59225152","59225430","chr20","50443571","50443848","5","8781581"
"chr5","59226016","59226193","chr20","50442799","50442977","1","8783217"
"chr5","59229095","59229268","chr20","50441386","50441561","3","8787709"
"chr5","59231942","59232240","chr20","50438414","50438711","7","8793528"
"chr5","59242511","59242784","chr20","50427341","50427614","8","8815170"
"chr5","59255206","59255477","chr20","50414672","50414943","7","8840534"
"chr5","59278037","59278352","chr20","50390710","50391032","17","8887327"
"chr5","59299341","59299649","chr20","50367004","50367308","15","8932337"
"chr5","59320328","59320625","chr20","50345153","50345480","37","8975175"
"chr5","59326084","59326386","chr20","50339687","50339989","8","8986397"
"chr5","59350400","59350569","chr20","50316179","50316348","5","9034221"
"chr5","59350864","59351008","chr20","50315732","50315876","4","9035132"
"chr5","59384736","59385040","chr9","95489236","95489532","65","36104500"
"chr5","59385101","59385406","chr1","125070092","125070386","62","65684991"
"chr5","59401439","59401572","chr20","50267342","50267477","4","9134097"
"chr5","59401866","59402002","chr20","50266909","50267045","1","9134957"
"chr5","59421462","59421772","chr20","50246220","50246528","10","9175242"
"chr5","59445570","59445873","chr20","50225015","50225318","3","9220555"
"chr5","59448813","59449117","chr20","50221492","50221791","14","9227321"
"chr5","59450173","59450466","chr20","50219768","50220075","20","9230405"
"chr5","59453818","59453990","chr20","50216238","50216410","6","9237580"
"chr5","59458523","59458826","chr20","50211200","50211524","31","9247323"
"chr5","59460451","59460744","chr20","50209302","50209605","19","9251149"
"chr5","59463153","59463487","chr20","3206117","3206426","68","56257036"
"chr5","59465672","59465844","chr20","50216238","50216410","6","9249434"
"chr5","59501426","59501497","chr20","50167353","50167424","0","9334073"
"chr5","59501802","59501969","chr2","77490260","77490427","35","17988458"
"chr5","59506846","59507144","chr20","50161426","50161722","10","9345420"
"chr5","59546811","59546926","chr2","160576044","160576152","24","101029233"
"chr5","59547410","59547475","chr11","52937047","52937110","17","6610363"
"chr5","59547781","59547867","chr19","50873987","50874077","20","8673794"
"chr5","59575982","59576254","chr20","50090723","50090996","7","9485259"
"chr5","59578094","59578383","chr20","50088552","50088841","5","9489542"
"chr5","59579682","59579951","chr14","108767643","108767905","75","49187961"
"chr5","59585419","59585561","chr20","50081577","50081719","3","9503842"
"chr5","59585856","59585977","chr20","50081164","50081285","5","9504692"
"chr5","59585978","59586118","chr12","67256179","67256308","44","7670201"
"chr5","59589392","59589528","chr20","50077520","50077656","3","9511872"
"chr5","59589855","59590015","chr20","50077036","50077200","10","9512819"
"chr5","59622794","59623080","chr20","50042171","50042457","4","9580623"
"chr5","59630306","59630613","chr20","50032802","50033109","3","9597504"
"chr5","59636018","59636318","chr20","50026777","50027083","14","9609241"
"chr5","59652279","59652558","chr20","50004733","50005012","8","9647546"
"chr5","59655562","59655861","chr20","50001438","50001737","9","9654124"
"chr5","59662947","59663262","chr20","49993977","49994292","9","9668970"
"chr5","59664137","59664435","chr20","49992804","49993102","5","9671333"
"chr5","59664444","59664753","chr20","49992488","49992795","12","9671956"
"chr5","59665181","59665353","chr20","49991603","49991767","14","9673578"
"chr5","59665656","59665707","chr20","49991256","49991307","0","9674400"
"chr5","59665991","59666066","chr20","49990867","49990959","19","9675124"
"chr5","59669835","59670132","chr20","49987266","49987561","8","9682569"
"chr5","59701106","59701399","chr20","49954291","49954584","4","9746815"
"chr5","59711345","59711477","chr20","49944202","49944334","5","9767143"
"chr5","59711737","59711815","chr20","49943865","49943942","1","9767872"
"chr5","59712194","59712482","chr20","49943194","49943484","10","9769000"
"chr5","59712565","59712851","chr3","42478926","42479215","53","17233639"
"chr5","59731807","59732071","chr9","56456050","56456320","55","3275757"
"chr5","59741782","59742070","chr20","49916445","49916732","8","9825337"
"chr5","59748749","59749035","chr20","49909505","49909793","6","9839244"
"chr5","59750813","59751084","chr20","49907155","49907435","11","9843658"
"chr5","59762143","59762350","chr20","49897197","49897404","1","9864946"
"chr5","59779042","59779339","chr20","49878212","49878473","39","9900830"
"chr5","59801743","59802067","chr20","49856225","49856534","27","9945518"
"chr5","59812973","59813274","chr20","49844047","49844346","9","9968926"
"chr5","59814328","59814589","chr20","49842737","49842998","4","9971591"
"chr5","59819495","59819817","chr10","12090238","12090558","59","47729257"
"chr5","59832276","59832574","chr20","49824207","49824505","2","10008069"
"chr5","59835633","59835931","chr20","49824207","49824505","2","10011426"
"chr5","59847152","59847439","chr20","49813207","49813488","13","10033945"
"chr5","59851071","59851365","chr20","49808706","49809006","16","10042365"
"chr5","59854378","59854676","chr20","49805409","49805707","9","10048969"
"chr5","59857431","59857552","chr20","49802537","49802658","1","10054894"
"chr5","59857573","59857854","chr20","49802223","49802516","22","10055350"
"chr5","59860293","59860567","chr15","41760460","41760737","64","18099833"
"chr5","59875152","59875320","chr20","49782157","49782325","4","10092995"
"chr5","59883893","59884066","chr3","45869996","45870172","36","14013897"
"chr5","59884820","59885086","chr20","49773216","49773491","14","10111604"
"chr5","59892566","59892861","chr20","49764875","49765170","1","10127691"
"chr5","59899429","59899732","chr20","49758015","49758308","17","10141414"
"chr5","59924838","59924947","chr11","27275028","27275139","20","32649810"
"chr5","59928768","59929069","chr20","49728529","49728828","9","10200239"
"chr5","59939199","59939313","chr20","49723410","49723524","3","10215789"
"chr5","59950349","59950579","chr8","37318217","37318438","56","22632132"
"chr5","59950877","59950904","chr9","56569092","56569115","6","3381785"
"chr5","59955005","59955158","chr2","185410650","185410807","41","125455645"
"chr5","59956217","59956244","chr1","191136964","191136985","6","131180747"
"chr5","59956579","59956692","chr11","94362131","94362241","21","34405552"
"chr5","59962391","59962561","chr20","49698735","49698880","26","10263656"
"chr5","59962865","59962996","chr20","49698294","49698425","5","10264571"
"chr5","59963861","59964131","chr20","49697154","49697448","30","10266707"
"chr5","59964172","59964182","chr7","14279755","14279765","0","45684417"
"chr5","59969728","59969833","chr10","37729748","37729859","22","22239980"
"chr5","59971239","59971518","chr20","25431198","25431466","70","34540041"
"chr5","59971524","59971691","chr8","92951340","92951502","44","32979816"
"chr5","59971720","59971807","chr20","49687688","49687775","4","10284032"
"chr5","59985405","59985666","chr20","49673819","49674099","24","10311586"
"chr5","59988712","59989022","chr20","49670468","49670779","6","10318244"
"chr5","59989556","59989817","chr20","49668590","49668850","5","10320966"
"chr5","59992803","59993099","chrX","15697361","15697669","59","44295442"
"chr5","59993505","59993807","chr20","49664589","49664893","5","10328916"
"chr5","60021219","60021419","chr20","49637070","49637275","7","10384149"
"chr5","60021730","60021875","chr20","49636614","49636759","3","10385116"
"chr5","60082942","60083099","chr16","17342658","17342822","30","42740284"
"chr5","60093574","60093841","chr20","49562737","49563004","5","10530837"
"chr5","60101907","60102216","chr20","49554614","49554945","26","10547293"
"chr5","60108127","60108324","chr20","49548475","49548699","28","10559652"
"chr5","60108381","60108392","chr1","205258045","205258056","2","145149664"
"chr5","60133445","60133716","chr20","49523874","49524145","3","10609571"
"chr5","60137497","60137788","chr20","49519832","49520115","16","10617665"
"chr5","60138728","60138978","chr20","49518635","49518885","5","10620093"
"chr5","60139113","60139245","chr20","49518379","49518511","2","10620734"
"chr5","60146759","60146888","chr20","49510776","49510905","2","10635983"
"chr5","60146889","60147189","chr7","49571405","49571710","44","10575484"
"chr5","60147190","60147365","chr20","49510292","49510464","9","10636898"
"chr5","60185344","60185466","chr20","49471555","49471673","7","10713789"
"chr5","60235013","60235312","chr20","49423690","49423989","4","10811323"
"chr5","60298799","60299106","chr20","49359439","49359746","6","10939360"
"chr5","60303090","60303322","chr20","49355245","49355476","7","10947845"
"chr5","60318281","60318594","chr20","49339473","49339778","16","10978808"
"chr5","60336290","60336426","chr20","49319584","49319728","10","11016706"
"chr5","60341148","60341296","chr20","49320062","49320210","6","11021086"
"chr5","60341630","60341778","chr20","49319584","49319728","6","11022046"
"chr5","60343091","60343390","chr20","49314295","49314593","16","11028796"
"chr5","60360082","60360378","chr20","49297483","49297779","2","11062599"
"chr5","60372154","60372318","chr20","49285835","49285999","7","11086319"
"chr5","60379454","60379754","chr1","212279754","212280053","58","151900300"
"chr5","60383150","60383313","chr20","49275626","49275785","12","11107524"
"chr5","60383608","60383711","chr20","49275230","49275332","7","11108378"
"chr5","60389382","60389675","chr20","49269266","49269560","6","11120116"
"chr5","60427407","60427682","chr20","49243253","49243523","7","11184154"
"chr5","60431635","60431820","chr20","49238474","49238699","44","11193161"
"chr5","60432058","60432333","chr20","49238198","49238473","2","11193860"
"chr5","60432351","60432488","chr5","167292973","167293102","29","106860622"
"chr5","60442596","60442697","chr20","49228494","49228595","0","11214102"
"chr5","60450829","60451054","chr4","42686105","42686316","55","17764724"
"chr5","60454155","60454453","chr20","49217814","49218109","8","11236341"
"chr5","60462598","60462828","chr20","49210036","49210266","6","11252562"
"chr5","60477322","60477598","chr20","49195541","49195817","5","11281781"
"chr5","60487558","60487866","chr20","49185937","49186251","15","11301621"
"chr5","60492566","60492687","chr19","7159964","7160082","14","53332602"
"chr5","60493007","60493194","chr11","58356332","58356518","42","2136675"
"chr5","60495459","60495777","chr20","49179232","49179559","22","11316227"
"chr5","60497246","60497528","chr20","49177490","49177771","8","11319756"
"chr5","60510460","60510774","chr20","56739287","56739603","14","3771173"
"chr5","60512951","60513227","chr20","56741782","56742066","18","3771169"
"chr5","60528411","60528707","chr20","56758536","56758830","8","3769875"
"chr5","60531476","60531633","chr20","56761401","56761558","4","3770075"
"chr5","60531649","60531783","chr20","56761574","56761708","2","3770075"
"chr5","60532617","60532900","chr20","56762300","56762582","12","3770317"
"chr5","60534157","60534452","chr20","56765109","56765406","11","3769048"
"chr5","60546344","60546630","chr20","56777154","56777438","12","3769190"
"chr5","60554415","60554749","chr20","56785271","56785615","17","3769144"
"chr5","60561487","60561644","chr20","56792030","56792191","8","3769457"
"chr5","60563359","60563642","chr20","56793899","56794182","14","3769460"
"chr5","60571713","60571892","chr11","122274374","122274548","47","61702661"
"chr5","60612750","60612818","chr16","4865959","4866026","10","55746791"
"chr5","60618429","60618729","chr20","56850118","56850418","6","3768311"
"chr5","60621397","60621681","chr20","56853441","56853724","5","3767956"
"chr5","60622493","60622790","chr20","56854532","56854834","12","3767961"
"chr5","60625706","60626020","chr6","74294843","74295131","82","13669137"
"chr5","60630495","60630796","chr20","56862531","56862832","8","3767964"
"chr5","60633903","60633994","chr20","56866242","56866333","2","3767661"
"chr5","60634018","60634265","chrX","7994088","7994328","70","52639930"
"chr5","60634555","60634868","chr20","56867107","56867422","9","3767448"
"chr5","60639287","60639578","chr20","56871539","56871823","15","3767748"
"chr5","60653855","60654154","chr20","56885725","56886016","14","3768130"
"chr5","60672915","60673153","chr20","56904873","56905155","58","3768042"
"chr5","60693023","60693157","chr2","90436127","90436263","20","29743104"
"chr5","60693466","60693652","chr1","162197692","162197889","54","101504226"
"chr5","60694679","60695012","chr11","51829366","51829695","69","8865313"
"chr5","60697318","60697622","chr14","96900137","96900446","68","36202819"
"chr5","60699703","60700002","chr20","56936242","56936531","17","3763461"
"chr5","60700043","60700197","chr20","56936572","56936728","7","3763471"
"chr5","60700354","60700659","chr20","56936885","56937188","11","3763469"
"chr5","60711320","60711413","chr20","56948976","56949069","2","3762344"
"chr5","60713441","60713741","chr10","29378575","29378877","53","31334866"
"chr5","60727228","60727527","chr20","56965469","56965773","11","3761759"
"chr5","60738754","60739047","chr2","47911084","47911382","54","12827670"
"chr5","60751467","60751780","chr20","56990358","56990671","7","3761109"
"chr5","60757448","60757542","chr20","56996305","56996409","14","3761143"
"chr5","60757847","60758029","chr20","56996719","56996881","28","3761128"
"chr5","60760029","60760332","chr20","56999186","56999481","16","3760843"
"chr5","60763014","60763268","chr20","57002159","57002426","17","3760855"
"chr5","60764907","60765205","chr20","57004377","57004674","9","3760530"
"chr5","60765229","60765515","chr20","57005002","57005286","6","3760227"
"chr5","60768991","60769226","chr20","57008745","57008978","8","3760246"
"chr5","60774426","60774727","chr20","57014665","57014963","6","3759761"
"chr5","60778411","60778697","chr20","57018953","57019239","6","3759458"
"chr5","60796402","60796615","chr20","57037584","57037793","8","3758818"
"chr5","60824637","60824729","chr20","57067589","57067681","2","3757048"
"chr5","60829270","60829396","chr20","57071812","57071938","5","3757458"
"chr5","60850079","60850297","chr20","57094829","57095044","13","3755250"
"chr5","60883780","60884031","chr20","57121127","57121372","11","3762653"
"chr5","60885743","60886009","chr20","57130540","57130806","8","3755203"
"chr5","60889212","60889336","chr20","57132338","57132458","7","3756874"
"chr5","60889624","60889806","chr20","57132751","57132934","8","3756873"
"chr5","60890105","60890141","chr18","13638683","13638718","8","47251422"
"chr5","60890636","60890794","chr20","57135170","57135320","12","3755466"
"chr5","60892243","60892550","chr20","57137050","57137352","10","3755193"
"chr5","60901055","60901331","chr20","57146551","57146775","54","3754504"
"chr5","60902921","60903239","chr20","57148582","57148909","17","3754339"
"chr5","60924776","60924949","chr20","57170395","57170566","17","3754381"
"chr5","60925252","60925314","chr20","57170870","57170932","1","3754382"
"chr5","60930616","60930888","chr20","57176449","57176724","12","3754167"
"chr5","60934055","60934346","chr20","57179900","57180208","24","3754155"
"chr5","60936559","60936868","chr20","57183111","57183416","16","3753448"
"chr5","60937257","60937436","chr20","57183805","57183981","5","3753452"
"chr5","60937755","60937883","chr20","57184294","57184423","3","3753461"
"chr5","60938299","60938616","chr20","57184838","57185155","14","3753461"
"chr5","60986128","60986423","chr9","110793503","110793797","62","49807375"
"chr5","60989636","60989724","chr20","57238056","57238144","3","3751580"
"chr5","60995883","60996193","chr7","64061219","64061524","63","3065336"
"chr5","61037152","61037439","chr20","57284780","57285068","22","3752372"
"chr5","61094506","61094797","chr20","57346036","57346326","12","3748470"
"chr5","61095607","61095890","chr20","57347137","57347419","10","3748470"
"chr5","61102386","61102477","chr10","31887697","31887792","17","29214689"
"chr5","61135840","61136138","chr20","57388566","57388858","11","3747274"
"chr5","61145978","61146144","chr16","25302138","25302304","33","35843840"
"chr5","61146182","61146271","chr20","57437400","57437477","28","3708782"
"chr5","61153713","61153839","chrX","61671031","61671155","24","517318"
"chr5","61166397","61166562","chr1","26754110","26754273","35","34412287"
"chr5","61169402","61169738","chr20","57414591","57414927","11","3754811"
"chr5","61177215","61177509","chr20","57422367","57422653","11","3754848"
"chr5","61191223","61191554","chr10","18889924","18890257","78","42301299"
"chr5","61191555","61191631","chr20","50167353","50167424","16","11024202"
"chr5","61195168","61195230","chr20","57440999","57441064","3","3754169"
"chr5","61195436","61195728","chr1","130713307","130713605","64","69517871"
"chr5","61198991","61199126","chr16","49484330","49484464","25","11714661"
"chr5","61201782","61201939","chr12","84864232","84864385","43","23662450"
"chr5","61202254","61202281","chr12","59076859","59076884","10","2125395"
"chr5","61215391","61215666","chr20","57473329","57473616","19","3742062"
"chr5","61231637","61231928","chr20","57489971","57490264","8","3741666"
"chr5","61257721","61258015","chr20","57517199","57517492","8","3740522"
"chr5","61259107","61259407","chr20","57518581","57518885","16","3740526"
"chr5","61284388","61284689","chr20","57543720","57544021","4","3740668"
"chr5","61292542","61292830","chr12","103248004","103248280","73","41955462"
"chr5","61317207","61317487","chr20","57574739","57575019","20","3742468"
"chr5","61332293","61332591","chr20","57594844","57595138","13","3737449"
"chr5","61614806","61615080","chr20","57873799","57874074","11","3741007"
"chr5","61650126","61650364","chr13","25791775","25792011","47","35858351"
"chr5","61760153","61760410","chr20","58021858","58022114","6","3738295"
"chr5","61796079","61796363","chr20","58058554","58058839","19","3737525"
"chr5","61830939","61831062","chr20","58093165","58093288","2","3737774"
"chr5","61868335","61868538","chr20","58130796","58131034","39","3737539"
"chr5","61872007","61872300","chr20","58134426","58134718","11","3737581"
"chr5","61950051","61950350","chr20","58212814","58213115","9","3737237"
"chr5","62229010","62229146","chr20","58500577","58500687","29","3728433"
"chr5","62254048","62254201","chr20","58525650","58525790","20","3728398"
"chr5","62293027","62293339","chr20","58564728","58565042","11","3728299"
"chr5","62299080","62299392","chr20","58571038","58571350","18","3728042"
"chr5","62319887","62320166","chr20","58591850","58592128","17","3728037"
"chr5","62358036","62358292","chr9","93341845","93342102","73","30983809"
"chr5","62381091","62381233","chr2","86794548","86794690","27","24413457"
"chr5","62449750","62449920","chr20","58722992","58723163","5","3726758"
"chr5","62449966","62450083","chr20","58723197","58723310","6","3726769"
"chr5","62518410","62518622","chr20","58792295","58792505","16","3726115"
"chr5","62576779","62577082","chr20","58852851","58853124","37","3723928"
"chr5","62625407","62625721","chr20","58901752","58902053","18","3723655"
"chr5","62729407","62729729","chr20","59008838","59009178","30","3720569"
"chr5","62733822","62734116","chr20","59013302","59013607","25","3720520"
"chr5","62773580","62773844","chr20","59063251","59063515","5","3710329"
"chr5","62780119","62780406","chr20","59069561","59069869","36","3710558"
"chr5","62792323","62792597","chr20","59081731","59081999","17","3710592"
"chr5","62809067","62809359","chr20","59097391","59097683","6","3711676"
"chr5","62850115","62850370","chr20","59138426","59138680","18","3711689"
"chr5","62853850","62854127","chr20","59141577","59141854","18","3712273"
"chr5","62872214","62872505","chr20","59159610","59159901","6","3712604"
"chr5","62910766","62911051","chr20","59197844","59198134","17","3712922"
"chr5","62949099","62949209","chr4","140915854","140915964","24","77966755"
"chr5","62954104","62954391","chr20","59241912","59242188","19","3712192"
"chr5","62991503","62991803","chr20","59279159","59279459","6","3712344"
"chr5","63058976","63059274","chr20","59345407","59345698","15","3713569"
"chr5","63074019","63074232","chr20","59360995","59361208","6","3713024"
"chr5","63085108","63085371","chr20","59372178","59372441","7","3712930"
"chr5","63099746","63100032","chr20","59387224","59387495","25","3712522"
"chr5","63157117","63157412","chr20","59445036","59445325","17","3712081"
"chr5","63166723","63167022","chr7","114860161","114860461","56","51693438"
"chr5","63173867","63174162","chr20","59461897","59462198","13","3711970"
"chr5","63211409","63211711","chr2","47911084","47911382","54","15300325"
"chr5","63267238","63267525","chr20","59558527","59558814","13","3708711"
"chr5","63281002","63281218","chr20","59572574","59572791","5","3708428"
"chr5","63298474","63298644","chr11","110402020","110402179","39","47103546"
"chr5","63349954","63350256","chr20","59641884","59642187","11","3708070"
"chr5","63364721","63365004","chr4","33552362","33552646","59","29812359"
"chr5","63375712","63376023","chr20","59668299","59668600","19","3707413"
"chr5","63396750","63396842","chr20","59690416","59690509","5","3706334"
"chr5","63406004","63406284","chr20","59700117","59700407","21","3705887"
"chr5","63413833","63413908","chr8","99313465","99313544","19","35899632"
"chr5","63465941","63466224","chr20","59761140","59761425","13","3704801"
"chr5","63511998","63512294","chr20","59807795","59808090","14","3704203"
"chr5","63552030","63552309","chr19","41286519","41286796","56","22265511"
"chr5","63555856","63556121","chr20","59849304","59849569","6","3706552"
"chr5","63563110","63563144","chr1","1980648","1980684","8","61582462"
"chr5","63581290","63581588","chr20","59875947","59876245","11","3705343"
"chr5","63628901","63629224","chr20","59924151","59924469","20","3704750"
"chr5","63637935","63638184","chr20","59933603","59933853","14","3704332"
"chr5","63651514","63651810","chr20","59946906","59947202","14","3704608"
"chr5","63685573","63685653","chr20","59981183","59981267","8","3704390"
"chr5","63706956","63707257","chr20","60002582","60002880","8","3704374"
"chr5","63716631","63716852","chr20","60011590","60011806","11","3705041"
"chr5","63732998","63733323","chr20","60029636","60029955","23","3703362"
"chr5","63733464","63733800","chr20","60030091","60030423","18","3703373"
"chr5","63748427","63748710","chr20","60044607","60044890","5","3703820"
"chr5","63781969","63782277","chr13","118672535","118672846","49","54890566"
"chr5","63801620","63801869","chr16","28836784","28837030","60","34964836"
"chr5","63825098","63825306","chr20","60120864","60121071","25","3704234"
"chr5","63828914","63829224","chr20","60124646","60124964","15","3704268"
"chr5","63844688","63844998","chr20","60140388","60140677","29","3704300"
"chr5","63878967","63879268","chr20","60174311","60174612","7","3704656"
"chr5","63935455","63935669","chr20","60231643","60231857","3","3703812"
"chr5","63942606","63942910","chr20","60238811","60239109","14","3703795"
"chr5","63974517","63974686","chr7","42009999","42010168","31","21964518"
"chr5","64011623","64011890","chr7","91374709","91374974","75","27363086"
"chr5","64015886","64015960","chr3","10720688","10720758","21","53295198"
"chr5","64029458","64029781","chr1","204842844","204843149","72","140813386"
"chr5","64070106","64070122","chr16","59611897","59611914","3","4458209"
"chr5","64101191","64101483","chr20","60399540","60399833","9","3701651"
"chr5","64103700","64103999","chr20","60402027","60402317","15","3701673"
"chr5","64115663","64115957","chr20","60413579","60413875","15","3702084"
"chr5","64146012","64146305","chr20","60444676","60444968","17","3701336"
"chr5","64164973","64165140","chr10","71698588","71698750","38","7533615"
"chr5","64176073","64176387","chr20","60475080","60475393","11","3700993"
"chr5","64183956","64184282","chr20","60482994","60483318","18","3700962"
"chr5","64186797","64186939","chr20","60485859","60486021","26","3700938"
"chr5","64197765","64197900","chr7","50119985","50120120","22","14077780"
"chr5","64198247","64198422","chr7","14562161","14562333","36","49636086"
"chr5","64213430","64213739","chr20","60512128","60512418","26","3701302"
"chr5","64214430","64214739","chr15","24619152","24619463","53","39595278"
"chr5","64215862","64216144","chr20","60514412","60514691","15","3701450"
"chr5","64219162","64219449","chr20","60517729","60518010","17","3701433"
"chr5","64220220","64220375","chr8","118347227","118347388","34","54127007"
"chr5","64222320","64222509","chr20","60520497","60520688","15","3701823"
"chr5","64222774","64222900","chr20","60521002","60521128","5","3701772"
"chr5","64238922","64239222","chr20","60537906","60538211","19","3701016"
"chr5","64252572","64252850","chr20","60551587","60551852","20","3700985"
"chr5","64264847","64265138","chr20","60564582","60564877","14","3700265"
"chr5","64276582","64276898","chr20","60576607","60576918","20","3699975"
"chr5","64328674","64328940","chr20","60628243","60628523","35","3700431"
"chr5","64346616","64346892","chr20","60646430","60646715","22","3700186"
"chr5","64367440","64367747","chr20","60667231","60667543","11","3700209"
"chr5","64370157","64370459","chr20","60670202","60670503","12","3699955"
"chr5","64380350","64380504","chr8","75844675","75844825","33","11464325"
"chr5","64387743","64388042","chr20","60687273","60687574","9","3700470"
"chr5","64390123","64390417","chr20","60689653","60689951","17","3700470"
"chr5","64402445","64402755","chr15","56527536","56527835","66","7874909"
"chr5","64403762","64403823","chr20","60702774","60702834","1","3700988"
"chr5","64409502","64409806","chr20","60708511","60708815","7","3700991"
"chr5","64410705","64410979","chr20","60709714","60709975","23","3700991"
"chr5","64411685","64411989","chr20","60710501","60710805","4","3701184"
"chr5","64415070","64415397","chr20","60713841","60714164","21","3701229"
"chr5","64419601","64419909","chr20","60718388","60718685","27","3701213"
"chr5","64429468","64429780","chr20","60728175","60728487","7","3701293"
"chr5","64440340","64440635","chr14","31817216","31817510","67","32623124"
"chr5","64452303","64452589","chr20","60751226","60751501","24","3701077"
"chr5","64496247","64496560","chr20","60795446","60795758","24","3700801"
"chr5","64512670","64512936","chr20","60810710","60811020","56","3701960"
"chr5","64525646","64525925","chr20","60823957","60824239","17","3701689"
"chr5","64570963","64571287","chr20","60868833","60869152","10","3702130"
"chr5","64571795","64572104","chr20","60869664","60869973","7","3702131"
"chr5","64602295","64602578","chr20","60899262","60899541","13","3703033"
"chr5","64627918","64628231","chr20","60924598","60924909","11","3703320"
"chr5","64663697","64663984","chr20","60960256","60960543","12","3703441"
"chr5","64712515","64712808","chr20","61008853","61009159","22","3703662"
"chr5","64839268","64839562","chr20","61134583","61134881","38","3704685"
"chr5","64942521","64942801","chr20","61237998","61238287","19","3704523"
"chr5","64946100","64946412","chr20","61241592","61241903","15","3704508"
"chr5","64952162","64952485","chr20","61248755","61249074","14","3703407"
"chr5","65118315","65118463","chr20","61415038","61415186","1","3703277"
"chr5","65143092","65143374","chr20","61439886","61440177","13","3703206"
"chr5","65162122","65162399","chr20","61458530","61458837","43","3703592"
"chr5","65175953","65176266","chr20","61472692","61473003","16","3703261"
"chr5","65404359","65404661","chr20","61702672","61702982","16","3701687"
"chr5","65438175","65438463","chr20","61737090","61737378","6","3701085"
"chr5","65504966","65505244","chr20","61803810","61804081","18","3701156"
"chr5","65532287","65532575","chr20","61830205","61830494","11","3702082"
"chr5","65656444","65656746","chr20","61952635","61952925","15","3703809"
"chr5","65919671","65919955","chr20","62226552","62226864","39","3693119"
"chr5","65963575","65963891","chr20","62269674","62269990","15","3693901"
"chr5","66135710","66136016","chrX","15697361","15697669","45","50438349"
"chr5","66184118","66184418","chr20","62489834","62490128","19","3694284"
"chr5","66221117","66221425","chr20","62527089","62527390","19","3694028"
"chr5","66319477","66319772","chr20","62625420","62625714","13","3694057"
"chr5","66337291","66337426","chr20","62643390","62643527","13","3693901"
"chr5","66340009","66340298","chr20","62645847","62646136","5","3694162"
"chr5","66355091","66355258","chr20","62661246","62661419","9","3693845"
"chr5","66358467","66358753","chr20","62664542","62664827","10","3693925"
"chr5","66441632","66441744","chr20","62747404","62747517","4","3694228"
"chr5","66442899","66443088","chr20","62748654","62748842","20","3694245"
"chr5","66466897","66467152","chr20","62771267","62771522","5","3695630"
"chr5","66471768","66472087","chr20","62778196","62778501","17","3693572"
"chr5","66476424","66476563","chr20","62783121","62783260","4","3693303"
"chr5","66476861","66477022","chr20","62783556","62783718","5","3693305"
"chr5","66481830","66482117","chr20","62788245","62788523","19","3693585"
"chr5","66484000","66484165","chr20","62790405","62790573","7","3693595"
"chr5","66486560","66486679","chr20","62792685","62792811","12","3693875"
"chr5","66486993","66487183","chr20","62793124","62793314","5","3693869"
"chr5","66502294","66502579","chr20","62808219","62808507","7","3694075"
"chr5","66537323","66537587","chr20","62844956","62845220","12","3692367"
"chr5","66539975","66540281","chr20","62847815","62848119","7","3692160"
"chr5","66553640","66553942","chr14","76425095","76425392","58","9871455"
"chr5","66557835","66558137","chr20","62865912","62866193","39","3691923"
"chr5","66561188","66561354","chr13","43519585","43519755","23","23041603"
"chr5","66569552","66569652","chr20","17557701","17557793","24","49011851"
"chr5","66571847","66571984","chr20","62879781","62879918","5","3692066"
"chr5","66579748","66580053","chr20","62889896","62890194","18","3689852"
"chr5","66594920","66595042","chr20","62903482","62903604","4","3691438"
"chr5","66606529","66606765","chr20","62914881","62915116","8","3691648"
"chr5","66630467","66630783","chr20","62938838","62939099","59","3691629"
"chr5","66642129","66642417","chr20","62950342","62950630","8","3691787"
"chr5","66647801","66647951","chr20","62956554","62956715","29","3691247"
"chr5","66648251","66648380","chr20","62957017","62957146","3","3691234"
"chr5","66658450","66658736","chr20","62967465","62967757","16","3690985"
"chr5","66680292","66680596","chr20","62990501","62990802","10","3689791"
"chr5","66694488","66694767","chr20","63005083","63005372","23","3689405"
"chr5","66698102","66698379","chr20","63008960","63009237","11","3689142"
"chr5","66709369","66709661","chr20","63022639","63022930","10","3686730"
"chr5","66731831","66732145","chr20","63045534","63045845","20","3686297"
"chr5","66749446","66749606","chr20","63063613","63063760","17","3685833"
"chr5","66807377","66807658","chr20","63116873","63117163","15","3690504"
"chr5","66814720","66815009","chr20","63123965","63124258","13","3690755"
"chr5","66815068","66815372","chr20","63124317","63124623","9","3690751"
"chr5","66815718","66815839","chr20","63124969","63125090","0","3690749"
"chr5","66815873","66816030","chr20","63125120","63125277","1","3690753"
"chr5","66824846","66825118","chr20","63134134","63134410","8","3690712"
"chr5","66831781","66832102","chr20","63141386","63141711","16","3690395"
"chr5","66839821","66840035","chr20","63149255","63149459","20","3690566"
"chr5","66853506","66853758","chr9","42503974","42504226","89","24349532"
"chr5","66857837","66858175","chr20","63167592","63167923","16","3690245"
"chr5","66861097","66861376","chr20","63171393","63171673","8","3689704"
"chr5","66863979","66864186","chr20","63174240","63174467","32","3689739"
"chr5","66866429","66866499","chr16","60896903","60896971","14","5969526"
"chr5","66866779","66867105","chr5","74399701","74399997","93","7532922"
"chr5","66872585","66872700","chr20","63182389","63182522","21","3690196"
"chr5","66902229","66902542","chr20","63213608","63213921","7","3688621"
"chr5","66903669","66903681","chr1","21482875","21482886","3","45420794"
"chr5","66904029","66904173","chr10","15324813","15324952","27","51579216"
"chr5","66939550","66939850","chr20","63251646","63251945","16","3687904"
"chr5","66948172","66948461","chr20","63260206","63260494","10","3687966"
"chr5","66954300","66954496","chr3","45488472","45488653","61","21465828"
"chr5","66954803","66954997","chr20","63266317","63266510","9","3688486"
"chr5","66956012","66956074","chrX","125126162","125126222","12","58170150"
"chr5","66958715","66958995","chr20","63270112","63270392","4","3688603"
"chr5","66976855","66977120","chr20","63287858","63288123","7","3688997"
"chr5","67026651","67026960","chr20","63338302","63338611","9","3688349"
"chr5","67028942","67029215","chr20","63340621","63340893","16","3688321"
"chr5","67187116","67187419","chr20","63492440","63492763","30","3694676"
"chr5","67190217","67190500","chr20","63494982","63495247","25","3695235"
"chr5","67193014","67193309","chr20","63497783","63498077","6","3695231"
"chr5","67196093","67196383","chr20","63500894","63501184","7","3695199"
"chr5","67196879","67197172","chr20","63501675","63501958","24","3695204"
"chr5","67202151","67202447","chr20","63506937","63507234","9","3695214"
"chr5","67204820","67205131","chr20","63509711","63510021","10","3695109"
"chr5","67258964","67259251","chr20","63565097","63565380","8","3693867"
"chr5","67260973","67261226","chr20","63567103","63567356","7","3693870"
"chr5","67307939","67308236","chr20","63614016","63614321","13","3693923"
"chr5","67316550","67316716","chr20","63622328","63622494","6","3694222"
"chr5","67317008","67317145","chr20","63622795","63622932","11","3694213"
"chr5","67338838","67339126","chr20","63644398","63644694","16","3694440"
"chr5","67364086","67364373","chr20","63669425","63669715","13","3694661"
"chr5","67383045","67383214","chr14","11559606","11559770","32","55823439"
"chr5","67435211","67435371","chr20","63740792","63740957","9","3694419"
"chr5","67503695","67503982","chr20","63809728","63810012","6","3693967"
"chr5","67508077","67508354","chr20","63814066","63814365","27","3694011"
"chr5","67560989","67561264","chr20","63861153","63861426","3","3699836"
"chr5","67563645","67563808","chr20","63863332","63863495","6","3700313"
"chr5","67567651","67567863","chr20","63867225","63867422","20","3700426"
"chr5","67592570","67592864","chr3","67232271","67232564","52","360299"
"chr5","67594612","67594835","chr20","63896806","63897034","13","3697806"
"chr5","67662286","67662582","chr20","63964744","63965040","8","3697542"
"chr5","67677474","67677656","chr20","63980231","63980412","7","3697243"
"chr5","67678018","67678120","chr20","63980774","63980875","9","3697244"
"chr5","67706867","67707079","chr20","64009953","64010172","17","3696914"
"chr5","67707661","67707758","chr20","64010754","64010851","1","3696907"
"chr5","67739786","67740074","chr20","64046258","64046545","8","3693528"
"chr5","67789046","67789325","chr20","64095340","64095619","12","3693706"
"chr5","67839831","67840124","chr18","55508409","55508710","60","12331422"
"chr5","67858588","67858892","chr20","64168195","64168500","8","3690393"
"chr5","67968265","67968557","chr20","64276759","64277063","19","3691506"
"chr5","68043066","68043376","chr20","64351325","64351635","5","3691741"
"chr5","68166243","68166542","chr20","64474259","64474562","30","3691984"
"chr5","68187816","68188116","chr20","64495541","64495841","6","3692275"
"chr5","68280019","68280310","chr20","64587361","64587663","36","3692658"
"chr5","68320463","68320787","chr11","50330487","50330804","67","17989976"
"chr5","68439677","68440005","chr20","64745825","64746136","24","3693852"
"chr5","68720515","68720789","chr20","65039936","65040209","22","3680579"
"chr5","68742688","68742979","chr20","65062412","65062701","14","3680276"
"chr5","68757169","68757445","chr20","65076277","65076547","16","3680892"
"chr5","68809964","68810238","chr20","65129156","65129403","33","3680808"
"chr5","68873295","68873606","chr20","65191853","65192159","9","3681442"
"chr5","68892870","68893011","chr14","61647335","61647457","34","7245535"
"chr5","68901837","68902128","chr20","65220504","65220796","19","3681333"
"chr5","69000638","69000930","chrX","40303897","40304177","65","28696741"
"chr5","69025307","69025617","chr20","65344075","65344370","26","3681232"
"chr5","69027373","69027689","chr20","65346110","65346427","6","3681263"
"chr5","69044594","69044734","chr20","65363476","65363617","10","3681118"
"chr5","69046117","69046282","chr20","65365008","65365165","10","3681109"
"chr5","69046839","69046860","chr13","125432389","125432411","5","56385550"
"chr5","69046865","69046990","chr20","65365741","65365873","11","3681124"
"chr5","69063232","69063390","chr10","14462717","14462877","31","54600515"
"chr5","69071962","69072259","chr20","65390710","65391008","5","3681252"
"chr5","69075194","69075490","chr20","65393940","65394237","5","3681254"
"chr5","69102819","69103113","chr20","65421009","65421303","13","3681810"
"chr5","69167893","69168203","chr20","65486027","65486336","8","3681866"
"chr5","69210447","69210749","chr20","65528420","65528722","3","3682027"
"chr5","69220136","69220427","chr20","65537779","65538067","21","3682357"
"chr5","69267193","69267499","chr20","65585629","65585934","10","3681564"
"chr5","69276113","69276429","chr20","65594898","65595214","5","3681215"
"chr5","69278064","69278351","chr6","148536307","148536588","49","79258243"
"chr5","69307638","69307839","chr20","65618616","65618818","7","3689022"
"chr5","69314363","69314596","chr20","65625348","65625575","19","3689015"
"chr5","69320009","69320309","chr20","65630949","65631248","14","3689060"
"chr5","69328245","69328402","chr20","65639155","65639316","6","3689090"
"chr5","69354002","69354098","chr20","65666529","65666625","3","3687473"
"chr5","69395522","69395832","chr13","41851851","41852159","60","27543671"
"chr5","69423242","69423409","chr20","65736139","65736306","4","3687103"
"chr5","69478032","69478209","chr20","65791964","65792144","8","3686068"
"chr5","69484689","69484948","chr20","65798589","65798857","21","3686100"
"chr5","69487416","69487733","chr20","65801306","65801617","16","3686110"
"chr5","69510661","69510794","chr20","65825582","65825715","4","3685079"
"chr5","69511107","69511282","chr20","65826027","65826204","7","3685080"
"chr5","69513769","69514048","chr20","65828660","65828966","39","3685109"
"chr5","69514757","69514981","chr20","65829678","65829903","9","3685079"
"chr5","69518509","69518797","chr20","65833456","65833755","32","3685053"
"chr5","69532941","69533245","chr20","65849249","65849553","9","3683692"
"chr5","69550816","69551111","chr20","65869036","65869332","11","3681780"
"chr5","69565114","69565339","chr20","65884016","65884236","13","3681098"
"chr5","69572507","69572814","chr20","65891425","65891729","11","3681082"
"chr5","69575387","69575699","chr20","65894299","65894612","21","3681088"
"chr5","69580117","69580443","chr15","102857337","102857650","75","33277220"
"chr5","69597270","69597432","chr11","110402020","110402179","29","40804750"
"chr5","69597727","69597855","chr7","63754692","63754819","21","5843035"
"chr5","69600938","69601229","chr20","65920055","65920357","17","3680883"
"chr5","69624662","69624979","chr20","65943794","65944088","33","3680868"
"chr5","69639208","69639495","chr20","65958294","65958585","14","3680914"
"chr5","69661447","69661576","chr16","849038","849168","25","68812409"
"chr5","69670834","69671114","chr20","65990367","65990647","7","3680467"
"chr5","69677152","69677255","chr20","65996627","65996732","4","3680525"
"chr5","69699619","69699856","chr20","66019444","66019681","8","3680175"
"chr5","69717759","69718080","chr9","110725444","110725766","60","41007685"
"chr5","69740422","69740733","chr20","66060444","66060753","23","3679978"
"chr5","69756092","69756177","chr20","66072231","66072316","2","3683861"
"chr5","69774875","69775172","chr5","142260583","142260891","67","72485708"
"chr5","69786483","69786789","chr4","152226280","152226592","55","82439797"
"chr5","69811052","69811342","chr20","66121324","66121614","5","3689728"
"chr5","69831707","69832018","chr20","66142629","66142951","19","3689078"
"chr5","69834102","69834401","chr20","66145056","66145355","12","3689046"
"chr5","69836009","69836337","chr8","13586654","13586977","80","56249355"
"chr5","69866046","69866346","chr20","66177082","66177367","21","3688964"
"chr5","69867783","69867885","chr13","26700415","26700501","36","43167368"
"chr5","69872401","69872682","chr20","66184331","66184621","15","3688070"
"chr5","69904190","69904421","chr20","66216714","66216958","26","3687476"
"chr5","69908035","69908253","chr20","66220541","66220765","17","3687494"
"chr5","69919768","69920049","chr20","66232415","66232702","15","3687353"
"chr5","69924906","69925224","chr20","66237558","66237874","17","3687348"
"chr5","69927742","69927958","chr20","66240927","66241109","48","3686815"
"chr5","69928270","69928385","chr20","66241489","66241596","11","3686781"
"chr5","69943426","69943524","chr20","66258924","66259023","4","3684502"
"chr5","69943850","69943981","chr20","66259340","66259469","5","3684510"
"chr5","69952655","69952965","chr20","66268485","66268784","18","3684170"
"chr5","69954312","69954406","chr20","66270426","66270520","3","3683886"
"chr5","69959922","69960131","chr10","71033152","71033356","50","1073230"
"chr5","69973520","69973789","chr20","66290394","66290662","7","3683126"
"chr5","69973812","69974128","chr20","66290683","66290996","12","3683129"
"chr5","69974940","69975056","chr20","66291806","66291922","3","3683134"
"chr5","69975088","69975212","chr20","66291951","66292075","2","3683137"
"chr5","69989997","69990308","chr20","66305913","66306224","9","3684084"
"chr5","69993013","69993306","chr20","66309445","66309738","17","3683568"
"chr5","70003504","70003696","chr1","23872213","23872387","42","46131291"
"chr5","70009899","70010195","chr20","66325425","66325721","7","3684474"
"chr5","70022168","70022427","chr8","68882795","68883049","48","1139373"
"chr5","70033886","70034199","chrX","41341410","41341721","53","28692476"
"chr5","70034953","70035249","chr20","66350043","66350339","8","3684910"
"chr5","70039932","70040221","chr20","66355052","66355339","19","3684880"
"chr5","70040805","70040939","chr20","66355923","66356057","7","3684882"
"chr5","70041102","70041279","chr20","66356221","66356397","5","3684881"
"chr5","70041653","70041666","chr1","190347546","190347559","2","120305893"
"chr5","70049272","70049516","chr20","66363267","66363510","10","3686005"
"chr5","70057610","70057886","chr20","66372266","66372550","31","3685344"
"chr5","70067330","70067546","chr20","66381747","66381965","10","3685583"
"chr5","70078900","70079043","chr20","66392824","66392964","13","3686076"
"chr5","70081301","70081472","chr11","83531256","83531426","42","13449955"
"chr5","70081784","70081940","chr20","66395763","66395905","18","3686021"
"chr5","70089187","70089473","chr20","66403510","66403807","21","3685677"
"chr5","70090150","70090315","chr20","66404506","66404670","6","3685644"
"chr5","70113455","70113755","chr20","66427519","66427819","3","3685936"
"chr5","70127381","70127528","chr20","66441468","66441591","28","3685913"
"chr5","70127822","70127840","chr1","28172824","28172841","5","41954998"
"chr5","70141049","70141243","chr20","66454771","66454965","2","3686278"
"chr5","70161478","70161533","chr8","28824525","28824574","14","41336953"
"chr5","70177253","70177409","chr2","43194047","43194197","32","26983206"
"chr5","70200023","70200146","chr5","43405822","43405943","26","26794201"
"chr5","70200176","70200295","chr7","19596811","19596930","17","50603365"
"chr5","70217892","70218182","chr6","172279903","172280171","73","102062011"
"chr5","70221115","70221261","chr2","115461284","115461440","26","45240169"
"chr5","70222691","70222922","chr20","66537201","66537410","27","3685490"
"chr5","70235881","70236183","chr20","66551384","66551683","7","3684497"
"chr5","70237257","70237556","chr20","66552767","66553065","7","3684490"
"chr5","70242285","70242594","chr20","66557775","66558072","22","3684510"
"chr5","70245835","70245849","chr11","120940667","120940680","4","50694832"
"chr5","70257263","70257541","chr20","66572606","66572884","6","3684657"
"chr5","70276191","70276454","chr20","66591434","66591699","15","3684757"
"chr5","70291399","70291686","chr20","66606138","66606407","21","3685261"
"chr5","70304219","70304556","chr2","167664248","167664541","95","97360029"
"chr5","70306086","70306329","chr20","66620728","66620970","11","3685358"
"chr5","70310255","70310507","chr20","66624597","66624866","24","3685658"
"chr5","70315342","70315606","chr20","66629646","66629906","19","3685696"
"chr5","70317175","70317474","chr20","66631501","66631805","17","3685674"
"chr5","70317865","70318179","chr1","28768857","28769160","69","41549008"
"chr5","70319054","70319351","chr20","66633216","66633513","6","3685838"
"chr5","70323099","70323266","chr20","66637509","66637676","9","3685590"
"chr5","70346992","70347273","chr20","66662529","66662783","51","3684463"
"chr5","70348112","70348208","chr8","28787933","28788030","15","41560179"
"chr5","70364720","70364817","chr20","66680950","66681044","5","3683770"
"chr5","70371826","70372176","chr20","622680","623014","65","69749146"
"chr5","70396691","70396770","chr20","66715758","66715837","0","3680933"
"chr5","70398184","70398484","chr20","66717576","66717870","14","3680608"
"chr5","70398492","70398786","chr20","66717878","66718175","13","3680614"
"chr5","70404097","70404370","chr20","66723796","66724100","36","3680301"
"chr5","70415103","70415416","chr20","66733943","66734256","11","3681160"
"chr5","70433910","70434208","chr20","66754574","66754870","13","3679336"
"chr5","70449656","70449953","chr20","66770233","66770528","12","3679423"
"chr5","70466975","70467285","chr13","42100035","42100348","58","28366940"
"chr5","70481571","70481879","chr20","66802673","66802981","10","3678898"
"chr5","70516471","70516592","chr20","66837802","66837923","6","3678669"
"chr5","70551344","70551561","chr7","43301114","43301334","51","27250230"
"chr5","70551562","70551643","chr10","13747312","13747395","14","56804250"
"chr5","70551948","70552135","chr20","66872051","66872240","9","3679897"
"chr5","70554293","70554659","chr20","66874406","66874746","44","3679887"
"chr5","70568469","70568773","chr20","66888540","66888843","9","3679929"
"chr5","70569908","70570209","chr4","32784260","32784556","56","37785648"
"chr5","70591673","70591938","chr20","66912282","66912545","12","3679391"
"chr5","70607284","70607592","chr20","66928178","66928486","10","3679106"
"chr5","70616257","70616422","chr20","66937434","66937599","11","3678823"
"chr5","70616725","70616852","chr20","66937900","66938027","8","3678825"
"chr5","70626253","70626512","chr20","66947327","66947582","11","3678926"
"chr5","70660638","70660898","chr14","119049832","119050102","53","48389194"
"chr5","70672460","70672711","chr20","66995474","66995725","9","3676986"
"chr5","70716784","70717014","chr4","113612592","113612804","56","42895808"
"chr5","70739691","70739828","chr2","99912358","99912493","23","29172667"
"chr5","70778464","70778683","chr20","67104047","67104266","4","3674417"
"chr5","70785995","70786274","chr3","153340997","153341284","55","82555002"
"chr5","70789746","70790050","chr20","67115467","67115765","8","3674279"
"chr5","70810671","70810822","chr20","69810264","69810420","32","1000407"
"chr5","70821055","70821350","chr20","67146324","67146619","5","3674731"
"chr5","70821923","70822230","chr20","67147192","67147508","17","3674731"
"chr5","70827439","70827740","chr20","67152124","67152426","8","3675315"
"chr5","70865638","70865850","chr20","67189966","67190154","28","3675672"
"chr5","70886636","70886767","chr20","16085815","16085941","25","54800821"
"chr5","70887446","70887694","chr20","67212052","67212334","45","3675394"
"chr5","70905027","70905324","chr20","67229420","67229717","8","3675607"
"chr5","70916150","70916415","chr20","67240119","67240388","21","3676031"
"chr5","70943116","70943414","chr1","139574463","139574753","61","68631347"
"chr5","70944419","70944714","chr20","67269700","67270001","10","3674719"
"chr5","70951493","70951768","chr3","67205723","67206001","58","3745770"
"chr5","70954725","70955010","chr20","67280561","67280846","4","3674164"
"chr5","70971325","70971440","chr20","67297168","67297283","2","3674157"
"chr5","70971737","70971931","chr20","67297565","67297758","4","3674172"
"chr5","71009595","71009885","chr20","67335317","67335607","6","3674278"
"chr5","71015555","71015863","chr20","67341103","67341412","10","3674452"
"chr5","71035194","71035351","chr20","67360498","67360657","11","3674696"
"chr5","71053847","71053998","chr20","67379204","67379355","4","3674643"
"chr5","71093645","71093941","chr20","67418461","67418764","23","3675184"
"chr5","71098887","71098965","chr10","26958746","26958817","21","44140141"
"chr5","71102540","71102836","chr3","88246803","88247090","61","17144263"
"chr5","71103550","71103877","chr20","13846401","13846736","59","57257149"
"chr5","71105231","71105540","chr13","45932391","45932692","61","25172840"
"chr5","71110950","71111090","chr18","38158672","38158795","45","32952278"
"chr5","71125502","71125756","chr20","67450336","67450594","7","3675166"
"chr5","71134976","71135272","chr20","67459751","67460047","5","3675225"
"chr5","71139352","71139659","chr20","67464142","67464442","16","3675210"
"chr5","71147625","71147845","chr20","67472352","67472550","25","3675273"
"chr5","71154473","71154517","chr3","139974736","139974777","11","68820263"
"chr5","71160829","71161076","chr20","67486592","67486838","7","3674237"
"chr5","71163951","71164085","chr1","13051263","13051399","20","58112688"
"chr5","71165150","71165478","chr20","67492012","67492340","11","3673138"
"chr5","71178116","71178403","chr20","67505224","67505529","36","3672892"
"chr5","71179839","71180152","chr20","67508291","67508570","43","3671548"
"chr5","71220847","71220973","chr20","67551073","67551199","1","3669774"
"chr5","71239838","71240131","chr20","67568970","67569263","3","3670868"
"chr5","71252033","71252354","chr3","36367896","36368206","70","34884137"
"chr5","71253726","71254014","chr20","67582936","67583234","17","3670790"
"chr5","71279205","71279486","chr20","67608455","67608735","10","3670750"
"chr5","71283410","71283644","chr20","67612290","67612524","9","3671120"
"chr5","71370570","71370864","chr20","67701348","67701648","13","3669222"
"chr5","71404569","71404860","chr20","67735320","67735613","9","3669249"
"chr5","71479662","71479962","chr20","67810773","67811072","4","3668889"
"chr5","71495171","71495444","chr20","67826097","67826376","17","3669074"
"chr5","71512936","71513224","chr20","67845009","67845287","20","3667927"
"chr5","71519059","71519376","chr20","67851610","67851930","7","3667449"
"chr5","71545962","71546230","chr2","69399030","69399302","63","2146932"
"chr5","71556741","71557010","chr20","67889388","67889657","4","3667353"
"chr5","71680200","71680493","chr20","68012775","68013071","14","3667425"
"chr5","71786656","71786957","chr20","68120273","68120575","8","3666383"
"chr5","71840718","71841021","chr20","68175455","68175758","7","3665263"
"chr5","71860254","71860561","chr20","68194765","68195056","29","3665489"
"chr5","71876564","71876599","chr20","68211075","68211106","4","3665489"
"chr5","71947828","71948099","chr20","68283569","68283875","43","3664259"
"chr5","71987878","71988191","chr20","68327125","68327445","19","3660753"
"chr5","72044299","72044576","chr20","68382750","68383027","10","3661549"
"chr5","72336509","72336697","chr20","68676565","68676755","7","3659944"
"chr5","72442726","72443026","chr20","68785307","68785599","10","3657419"
"chr5","72531779","72532082","chr20","68876117","68876420","4","3655662"
"chr5","72548316","72548600","chr20","68893211","68893497","19","3655105"
"chr5","72556524","72556773","chr20","68901114","68901357","11","3655410"
"chr5","72562982","72563130","chr20","68907494","68907668","27","3655488"
"chr5","72569782","72569977","chr20","68913992","68914192","9","3655790"
"chr5","72622488","72622665","chr20","68966219","68966386","11","3656269"
"chr5","72624321","72624606","chr13","108040087","108040372","53","35415766"
"chr5","72626060","72626205","chr3","50438878","50439023","33","22187182"
"chr5","72636560","72636856","chr20","68980306","68980602","9","3656254"
"chr5","72638213","72638302","chr20","68981922","68982011","1","3656291"
"chr5","72638618","72638832","chr20","68982325","68982532","12","3656293"
"chr5","72649245","72649528","chr20","68993107","68993413","30","3656138"
"chr5","72656267","72656551","chr20","69000132","69000416","11","3656135"
"chr5","72697257","72697553","chr2","186502325","186502623","52","113805068"
"chr5","72734760","72735031","chr20","69078410","69078684","17","3656350"
"chr5","72745955","72746244","chr20","69090316","69090604","9","3655639"
"chr5","72746333","72746647","chr20","69090693","69091007","10","3655640"
"chr5","72748936","72749179","chr20","69093601","69093838","13","3655335"
"chr5","72754601","72754739","chr5","140362320","140362459","32","67607719"
"chr5","72754771","72754884","chr2","87322923","87323035","22","14568152"
"chr5","72764354","72764473","chr20","69108777","69108898","4","3655577"
"chr5","72797740","72798023","chr20","69143154","69143436","7","3654586"
"chr5","72800978","72801292","chr20","69147029","69147343","4","3653949"
"chr5","72821219","72821521","chr20","69166465","69166767","15","3654754"
"chr5","72822040","72822332","chr13","9582965","9583260","59","63239075"
"chr5","72865895","72866203","chr20","69213025","69213334","15","3652870"
"chr5","72882905","72882922","chr20","69226344","69226361","2","3656561"
"chr5","72893304","72893474","chr20","69235495","69235655","16","3657809"
"chr5","72904523","72904825","chr20","69246267","69246571","11","3658256"
"chr5","72927791","72928085","chr20","69270449","69270741","9","3657342"
"chr5","72955399","72955570","chr20","69298327","69298498","26","3657072"
"chr5","72963428","72963732","chr20","69306335","69306628","25","3657093"
"chr5","72978154","72978446","chr20","69320250","69320542","6","3657904"
"chr5","72981528","72981831","chr1","100889362","100889665","55","27907834"
"chr5","72986250","72986557","chr20","69330818","69331125","11","3655432"
"chr5","73037735","73037851","chr20","69364621","69364737","5","3673114"
"chr5","73113706","73113988","chr20","69443149","69443429","7","3670557"
"chr5","73122564","73122860","chr20","69452086","69452383","12","3670478"
"chr5","73183554","73183856","chr20","69521440","69521733","19","3662114"
"chr5","73188802","73188941","chr20","69526977","69527096","24","3661825"
"chr5","73193599","73193874","chr20","69532075","69532350","8","3661524"
"chr5","73193900","73193922","chr20","69532380","69532401","1","3661520"
"chr5","73238510","73238811","chr20","69579292","69579589","18","3659218"
"chr5","73244174","73244435","chr20","69584642","69584902","10","3659532"
"chr5","73277670","73277972","chr20","69618618","69618922","10","3659052"
"chr5","73312297","73312459","chr15","7716740","7716909","33","65595557"
"chr5","73320977","73321226","chr20","69662162","69662409","15","3658815"
"chr5","73342594","73342800","chr3","45613516","45613724","41","27729078"
"chr5","73351033","73351163","chr20","69692850","69692980","4","3658183"
"chr5","73378313","73378611","chr20","69719817","69720116","8","3658496"
"chr5","73429537","73429822","chr20","69774677","69774961","23","3654860"
"chr5","73436502","73436791","chr20","69781598","69781879","17","3654904"
"chr5","73436987","73437295","chr20","69782075","69782382","7","3654912"
"chr5","73510314","73510617","chr20","69855553","69855856","9","3654761"
"chr5","73598169","73598486","chr20","69943605","69943951","44","3654564"
"chr5","73725822","73726040","chr4","42686105","42686316","36","31039717"
"chr5","73856044","73856211","chr15","36889646","36889809","39","36966398"
"chr5","73935780","73936020","chr3","37308911","37309161","61","36626869"
"chr5","73937208","73937242","chr3","53164389","53164420","6","20772819"
"chr5","73938280","73938450","chr3","41868999","41869175","31","32069281"
"chr5","73942395","73942546","chr19","14673246","14673394","31","59269149"
"chr5","73948818","73949096","chr20","70283186","70283465","4","3665632"
"chr5","73949636","73949946","chr20","70284979","70285284","8","3664657"
"chr5","73962677","73962910","chr20","70297874","70298107","5","3664803"
"chr5","73965502","73965790","chr2","77583301","77583600","61","3617799"
"chr5","73987001","73987307","chr7","131213675","131213973","63","57226674"
"chr5","73995464","73995766","chr20","70330214","70330501","24","3665250"
"chr5","74003964","74004088","chr6","31305357","31305486","30","42698607"
"chr5","74026902","74027196","chr20","70363456","70363754","11","3663446"
"chr5","74041295","74041605","chr20","70384775","70385086","8","3656520"
"chr5","74045502","74045619","chr20","70378674","70378791","7","3666828"
"chr5","74048491","74048608","chr20","70378674","70378791","7","3669817"
"chr5","74051993","74052205","chr13","64022072","64022284","44","10029921"
"chr5","74059815","74060109","chr20","70392691","70392983","9","3667124"
"chr5","74135956","74136252","chr10","30001295","30001591","49","44134661"
"chr5","74234848","74235009","chr20","70572408","70572578","13","3662440"
"chr5","74235319","74235455","chr20","70572887","70573023","5","3662432"
"chr5","74333123","74333310","chr20","70671678","70671863","5","3661445"
"chr5","74371262","74371548","chr20","70708145","70708431","8","3663117"
"chr5","74385619","74385785","chr20","70725148","70725308","13","3660471"
"chr5","74385935","74386230","chr20","70725457","70725751","18","3660478"
"chr5","74441731","74441990","chr20","70780938","70781202","14","3660793"
"chr5","74470445","74470680","chr13","24884014","24884250","52","49586431"
"chr5","74481242","74481394","chr6","167269323","167269454","41","92788081"
"chr5","74503511","74503776","chr20","70842725","70842990","5","3660786"
"chr5","74524234","74524399","chr20","17880331","17880497","47","56643903"
"chr5","74578583","74578745","chr8","7033682","7033846","33","67544901"
"chr5","74631706","74631876","chr20","70989549","70989719","6","3642157"
"chr5","74659108","74659275","chr20","71016439","71016604","9","3642669"
"chr5","74663482","74663656","chr20","71020757","71020931","8","3642725"
"chr5","74676887","74677106","chr20","71043208","71043427","8","3633679"
"chr5","74679174","74679434","chr20","71034428","71034699","17","3644746"
"chr5","74685046","74685220","chr20","71045946","71046120","11","3639100"
"chr5","74686274","74686582","chr20","71047202","71047473","43","3639072"
"chr5","74693072","74693215","chr1","194853591","194853723","37","120160519"
"chr5","74693228","74693278","chr5","145534944","145534994","10","70841716"
"chr5","74696286","74696616","chr6","90232125","90232433","73","15535839"
"chr5","74707384","74707693","chrX","10836682","10836986","62","63870702"
"chr5","74715112","74715373","chr20","71073923","71074182","11","3641189"
"chr5","74718078","74718278","chr5","142436236","142436432","39","67718158"
"chr5","74727415","74727631","chr20","71086758","71086972","8","3640657"
"chr5","74737905","74738026","chr2","125169724","125169841","24","50431819"
"chr5","74739279","74739408","chr20","71099744","71099871","5","3639535"
"chr5","74759593","74759819","chr9","31207243","31207461","65","43552350"
"chr5","74762277","74762372","chr20","71122952","71123047","2","3639325"
"chr5","74770444","74770573","chr10","2130477","2130608","23","72639967"
"chr5","74785049","74785246","chr20","71147024","71147221","6","3638025"
"chr5","74801216","74801451","chr7","19509923","19510154","48","55291293"
"chr5","74806341","74806634","chr20","71167615","71167919","18","3638726"
"chr5","74807854","74808057","chr20","71180031","71180234","9","3627823"
"chr5","74817876","74818174","chr20","71184859","71185157","7","3633017"
"chr5","74829176","74829270","chr20","71196578","71196672","3","3632598"
"chr5","74834375","74834505","chr20","71201744","71201874","1","3632631"
"chr5","74844167","74844454","chr4","36062293","36062565","59","38781874"
"chr5","74848103","74848406","chr20","71218970","71219273","3","3629133"
"chr5","74850954","74851074","chr11","4764033","4764157","22","70086921"
"chr5","74866274","74866456","chr1","2954010","2954189","54","71912264"
"chr5","74866766","74866896","chr2","87140260","87140382","24","12273494"
"chr5","74871716","74871843","chr20","71240102","71240224","12","3631614"
"chr5","74872455","74872793","chrX","7154436","7154747","85","67718019"
"chr5","74883839","74884021","chr20","71244619","71244771","34","3639220"
"chr5","74890029","74890232","chr14","265781","265976","49","74624248"
"chr5","74891927","74892085","chr14","112511149","112511314","32","37619222"
"chr5","74903547","74903788","chr11","84039461","84039702","79","9135914"
"chr5","74917155","74917432","chr20","71280551","71280831","10","3636604"
"chr5","74921628","74921652","chr10","75925478","75925502","6","1003850"
"chr5","74921914","74922078","chr16","51003294","51003447","54","23918620"
"chr5","74935905","74936194","chr20","71306654","71306943","7","3629251"
"chr5","74976224","74976481","chr20","71347262","71347522","11","3628962"
"chr5","75009351","75009643","chr20","71383610","71383902","14","3625741"
"chr5","75025035","75025193","chr20","71402870","71403025","5","3622165"
"chr5","75027856","75028156","chr20","71405672","71405973","7","3622184"
"chr5","75052337","75052495","chr20","71431114","71431268","6","3621223"
"chr5","75052799","75052813","chr3","52233071","52233083","5","22819728"
"chr5","75077634","75077810","chr16","15778375","15778547","33","59299259"
"chr5","75081116","75081394","chr20","71462908","71463181","16","3618208"
"chr5","75084021","75084156","chr14","111534427","111534584","44","36450406"
"chr5","75090160","75090432","chr20","71470949","71471221","11","3619211"
"chr5","75094330","75094625","chr20","71474833","71475125","8","3619497"
"chr5","75096680","75096983","chr20","71477041","71477350","15","3619639"
"chr5","75100173","75100243","chr20","71480540","71480617","10","3619633"
"chr5","75100244","75100385","chr20","71480618","71480759","6","3619626"
"chr5","75103501","75103805","chr20","71484175","71484478","14","3619326"
"chr5","75121960","75122145","chr20","71501960","71502145","3","3620000"
"chr5","75123888","75124020","chr20","71503691","71503823","2","3620197"
"chr5","75137674","75137935","chr20","71515979","71516240","9","3621695"
"chr5","75145268","75145541","chr20","71525198","71525466","13","3620070"
"chr5","75152340","75152511","chr20","71532687","71532860","8","3619653"
"chr5","75158246","75158534","chr20","71538179","71538467","3","3620067"
"chr5","75206636","75206829","chr20","71587658","71587855","12","3618978"
"chr5","75208928","75209220","chr20","71594440","71594734","13","3614488"
"chr5","75222787","75222914","chr20","71607276","71607405","19","3615511"
"chr5","75223211","75223411","chr20","71607716","71607902","18","3615495"
"chr5","75229382","75229548","chr13","70483392","70483558","39","4745990"
"chr5","75248491","75248784","chr20","71635090","71635389","8","3613401"
"chr5","75250417","75250719","chr16","25081648","25081959","17","50168769"
"chr5","75251411","75251685","chr20","71637769","71638054","24","3613642"
"chr5","75272123","75272415","chrX","60616670","60616967","60","14655453"
"chr5","75301611","75301790","chr20","71696033","71696210","4","3605578"
"chr5","75312611","75312885","chr20","71704308","71704582","5","3608303"
"chr5","75344534","75344677","chr20","71737404","71737541","9","3607130"
"chr5","75352995","75353266","chr20","71746418","71746708","23","3606577"
"chr6","3145652","3145956","chr19","3167710","3168005","17","22058"
"chr6","8257370","8257680","chr15","8381421","8381725","63","124051"
"chr6","8912734","8912912","chr15","8542392","8542564","33","370342"
"chr6","12189549","12189844","chr19","12304861","12305168","21","115312"
"chr6","25558985","25559281","chr19","25071820","25072169","56","487165"
"chr6","27656026","27656323","chr15","39047083","39047375","59","11391057"
"chr6","28049375","28049605","chr3","47651682","47651913","41","19602307"
"chr6","31063957","31064268","chr19","30647951","30648260","13","416006"
"chr6","37093149","37093457","chr19","37200356","37200660","13","107207"
"chr6","39976677","39976966","chr19","39920262","39920551","5","56415"
"chr6","43515833","43516108","chr19","43634874","43635149","12","119041"
"chr6","44564376","44564691","chr19","44768018","44768333","7","203642"
"chr6","2054","2271","chr1","56220488","56220697","53","56218434"
"chr6","11382","11652","chr10","26059826","26060100","59","26048444"
"chr6","13158","13308","chr19","11760","11924","18","1398"
"chr6","21555","21782","chr19","21507","21745","13","48"
"chr6","121343","121488","chr19","120577","120711","13","766"
"chr6","162304","162536","chr19","161850","162087","8","454"
"chr6","187474","187767","chr16","26045115","26045411","52","25857641"
"chr6","198093","198384","chr19","193143","193435","21","4950"
"chr6","199077","199212","chr10","81984349","81984482","26","81785272"
"chr6","213526","213587","chr19","211655","211716","4","1871"
"chr6","216567","216735","chr1","184282893","184283059","43","184066326"
"chr6","233590","233856","chr19","225817","226085","20","7773"
"chr6","245428","245579","chr2","172227852","172227991","30","171982424"
"chr6","283320","283491","chr19","271277","271448","9","12043"
"chr6","290715","290999","chr19","289666","289944","12","1049"
"chr6","335121","335402","chr19","325401","325683","10","9720"
"chr6","348203","348473","chr19","340836","341122","38","7367"
"chr6","353625","353741","chr7","148664648","148664755","21","148311023"
"chr6","380969","381107","chr2","172227852","172227991","19","171846883"
"chr6","398975","399159","chr19","386339","386508","19","12636"
"chr6","401451","401750","chr19","391763","392081","100","9688"
"chr6","406599","406789","chr19","397123","397306","15","9476"
"chr6","447415","447549","chr13","19492404","19492536","26","19044989"
"chr6","454921","455037","chr19","438535","438673","29","16386"
"chr6","455946","456110","chr14","63608556","63608715","30","63152610"
"chr6","478386","478664","chr19","460796","461074","9","17590"
"chr6","487459","487509","chr19","471224","471267","9","16235"
"chr6","488388","488450","chr20","376914","376974","15","111474"
"chr6","494729","494912","chr4","41449689","41449865","46","40954960"
"chr6","494957","495060","chr19","480497","480603","6","14460"
"chr6","495540","495812","chr19","477541","477801","23","17999"
"chr6","508748","509028","chr9","5765156","5765435","52","5256408"
"chr6","509339","509360","chr16","69709699","69709722","3","69200360"
"chr6","525809","525929","chr19","510169","510289","5","15640"
"chr6","528442","528569","chrX","73031186","73031299","15","72502744"
"chr6","534025","534137","chr19","519760","519872","3","14265"
"chr6","538128","538316","chr19","19789207","19789392","8","19251079"
"chr6","538580","538616","chr17","25267494","25267527","10","24728914"
"chr6","538648","538745","chr7","156362019","156362111","26","155823371"
"chr6","541656","541954","chr19","526425","526724","9","15231"
"chr6","565439","565571","chr7","53387112","53387243","21","52821673"
"chr6","567987","568172","chr19","30107195","30107379","39","29539208"
"chr6","568762","568878","chrX","108971246","108971363","23","108402484"
"chr6","573439","573572","chr10","62547981","62548114","20","61974542"
"chr6","574455","574627","chr7","131017268","131017442","31","130442813"
"chr6","583606","583728","chr1","45459451","45459559","25","44875845"
"chr6","607669","607815","chr19","587280","587435","17","20389"
"chr6","607874","608008","chr19","587484","587616","6","20390"
"chr6","612422","612701","chr19","592043","592295","32","20379"
"chr6","615151","615321","chr19","594902","595068","5","20249"
"chr6","615624","615759","chr19","595368","595503","5","20256"
"chr6","624147","624379","chr19","604807","605041","6","19340"
"chr6","656750","656881","chr14","72844030","72844163","22","72187280"
"chr6","660332","660484","chr19","640332","640467","25","20000"
"chr6","662900","663184","chr10","30221212","30221500","77","29558312"
"chr6","665166","665306","chr19","644894","645038","8","20272"
"chr6","665625","665823","chr19","645349","645549","8","20276"
"chr6","688082","688396","chr19","661744","662051","14","26338"
"chr6","695577","695755","chr20","41265103","41265284","38","40569526"
"chr6","697932","698226","chr19","671948","672242","13","25984"
"chr6","700635","700716","chr20","71250226","71250307","11","70549591"
"chr6","706815","707102","chr19","678295","678585","8","28520"
"chr6","713731","714020","chr19","684888","685178","10","28843"
"chr6","719980","720087","chr19","696640","696747","3","23340"
"chr6","723044","723185","chr19","697383","697526","5","25661"
"chr6","726530","726789","chr19","695408","695689","31","31122"
"chr6","727138","727465","chr3","51992589","51992910","63","51265451"
"chr6","733486","733692","chr2","88031797","88031980","64","87298311"
"chr6","758298","758585","chr19","729096","729378","20","29202"
"chr6","778934","779100","chr3","173526190","173526356","32","172747256"
"chr6","800425","800720","chr19","775483","775771","16","24942"
"chr6","831830","832042","chr19","804025","804218","25","27805"
"chr6","835875","835976","chrX","92490765","92490869","22","91654890"
"chr6","857112","857175","chr1","153808105","153808165","9","152950993"
"chr6","857603","857651","chr19","828808","828856","0","28795"
"chr6","857962","858170","chr19","829170","829374","10","28792"
"chr6","872844","873140","chr19","835836","836136","24","37008"
"chr6","893440","893737","chr19","855388","855682","9","38052"
"chr6","903051","903345","chr19","865974","866268","9","37077"
"chr6","920234","920534","chr19","880859","881159","11","39375"
"chr6","960322","960517","chr7","131140114","131140314","55","130179792"
"chr6","960835","960892","chr3","134186523","134186580","12","133225688"
"chr6","979477","979741","chr19","948425","948695","27","31052"
"chr6","984625","984867","chr19","954370","954618","15","30255"
"chr6","985177","985472","chr19","954947","955236","9","30230"
"chr6","1007656","1007986","chr19","977690","978009","16","29966"
"chr6","1009835","1009965","chr4","15145821","15145944","40","14135986"
"chr6","1011919","1012195","chr19","33254085","33254361","64","32242166"
"chr6","1073737","1073891","chr11","109772847","109772998","36","108699110"
"chr6","1077299","1077432","chr19","1050769","1050902","7","26530"
"chr6","1082996","1083153","chr19","1056137","1056294","29","26859"
"chr6","1099362","1099702","chr19","1076941","1077247","39","22421"
"chr6","1100191","1100261","chr1","25250540","25250614","16","24150349"
"chr6","1106040","1106224","chr17","71856461","71856638","29","70750421"
"chr6","1106526","1106542","chr10","71080075","71080090","3","69973549"
"chr6","1119453","1119566","chr19","1103444","1103560","6","16009"
"chr6","1121080","1121377","chr19","1105379","1105671","13","15701"
"chr6","1121861","1122163","chr1","34647970","34648266","65","33526109"
"chr6","1147668","1147791","chr19","1131534","1131657","6","16134"
"chr6","1148786","1149069","chr19","1132662","1132945","8","16124"
"chr6","1167707","1167767","chr12","72016960","72017018","18","70849253"
"chr6","1211134","1211347","chr9","60876511","60876709","65","59665377"
"chr6","1227067","1227262","chr19","1206421","1206619","16","20646"
"chr6","1227559","1227706","chr19","1206919","1207066","5","20640"
"chr6","1234599","1234742","chr19","1215074","1215217","6","19525"
"chr6","1235051","1235202","chr19","1215523","1215685","16","19528"
"chr6","1246359","1246666","chr19","1227580","1227847","60","18779"
"chr6","1256832","1257123","chr19","1240201","1240502","22","16631"
"chr6","1257183","1257410","chr19","1242331","1242564","13","14852"
"chr6","1257720","1257760","chr19","1242867","1242907","2","14853"
"chr6","1272368","1272539","chr19","1256238","1256417","17","16130"
"chr6","1273922","1274101","chr19","1256238","1256417","12","17684"
"chr6","1274995","1275134","chr1","110359669","110359814","30","109084674"
"chr6","1294708","1295010","chr5","142565235","142565540","58","141270527"
"chr6","1304416","1304693","chr19","1289042","1289328","21","15374"
"chr6","1312533","1312697","chr19","1317050","1317214","4","4517"
"chr6","1322008","1322134","chr19","1298656","1298782","0","23352"
"chr6","1322435","1322594","chr19","1299084","1299243","3","23351"
"chr6","1340887","1341167","chr19","1326852","1327132","6","14035"
"chr6","1343057","1343321","chr19","1329294","1329555","18","13763"
"chr6","1362126","1362388","chr19","1350964","1351226","3","11162"
"chr6","1369100","1369374","chr19","1361128","1361408","10","7972"
"chr6","1373752","1374037","chr7","68601320","68601602","45","67227568"
"chr6","1401964","1402195","chr3","673055","673269","65","728909"
"chr6","1424098","1424368","chr19","1414299","1414577","19","9799"
"chr6","1429940","1430116","chr19","9566578","9566738","52","8136638"
"chr6","1431158","1431460","chr19","1421974","1422276","12","9184"
"chr6","1431462","1431627","chr19","1422278","1422434","12","9184"
"chr6","1437570","1437886","chr20","8681328","8681624","78","7243758"
"chr6","1442876","1443157","chr19","1434183","1434464","7","8693"
"chr6","1448042","1448341","chr19","1438911","1439210","6","9131"
"chr6","1469316","1469481","chr19","1460121","1460257","31","9195"
"chr6","1469793","1469972","chr19","1460948","1461115","19","8845"
"chr6","1470819","1471082","chr19","1461971","1462243","18","8848"
"chr6","1472093","1472375","chr19","1463280","1463563","14","8813"
"chr6","1472784","1472983","chr4","113414559","113414779","57","111941775"
"chr6","1490641","1490761","chr8","77358540","77358662","16","75867899"
"chr6","1490798","1490935","chr16","7170696","7170804","47","5679898"
"chr6","1497565","1497812","chr19","1491402","1491643","17","6163"
"chr6","1510025","1510297","chr7","85385788","85386076","25","83875763"
"chr6","1511947","1512238","chr19","1494307","1494598","4","17640"
"chr6","1525646","1525823","chr19","1500547","1500717","10","25099"
"chr6","1527131","1527310","chr19","1511154","1511311","22","15977"
"chr6","1558874","1558936","chr1","86128485","86128542","13","84569611"
"chr6","1578072","1578361","chr19","1557292","1557581","15","20780"
"chr6","1585337","1585492","chr10","14462717","14462877","31","12877380"
"chr6","1594790","1595088","chr19","1574282","1574580","5","20508"
"chr6","1604388","1604520","chr3","162197994","162198125","24","160593606"
"chr6","1611487","1611810","chr19","1591035","1591357","7","20452"
"chr6","1639657","1639841","chr19","1620170","1620354","3","19487"
"chr6","1687925","1688086","chr7","30215685","30215845","33","28527760"
"chr6","1702032","1702266","chr9","95065423","95065646","52","93363391"
"chr6","1727077","1727255","chrX","7269639","7269810","35","5542562"
"chr6","1736759","1737041","chr19","1717796","1718080","12","18963"
"chr6","1739328","1739603","chr19","1720199","1720474","12","19129"
"chr6","1762157","1762451","chr4","69077877","69078163","59","67315720"
"chr6","1773528","1773613","chr19","1769557","1769641","2","3971"
"chr6","1778021","1778299","chr19","1759647","1759932","11","18374"
"chr6","1796721","1797006","chr19","1791680","1791959","16","5041"
"chr6","1804764","1804927","chr19","1788397","1788559","3","16367"
"chr6","1813889","1814152","chr4","134030031","134030284","60","132216142"
"chr6","1815984","1816168","chrX","44611948","44612115","50","42795964"
"chr6","1816650","1816806","chr10","14462717","14462877","29","12646067"
"chr6","1820226","1820535","chr19","1804193","1804492","18","16033"
"chr6","1833608","1833902","chr19","1811608","1811902","6","22000"
"chr6","1843936","1844048","chr9","43217699","43217811","24","41373763"
"chr6","1859258","1859373","chr19","1844378","1844493","6","14880"
"chr6","1867692","1867989","chr10","62655662","62655957","50","60787970"
"chr6","1875047","1875337","chr19","1861559","1861862","27","13488"
"chr6","1879156","1879454","chr19","1865682","1865991","24","13474"
"chr6","1882306","1882620","chr19","1870899","1871217","10","11407"
"chr6","1890856","1890988","chr13","71849473","71849604","24","69958617"
"chr6","1926092","1926205","chr19","35469003","35469113","30","33542911"
"chr6","1926240","1926415","chr19","1933471","1933640","9","7231"
"chr6","1927709","1927910","chr19","1934943","1935123","27","7234"
"chr6","1928668","1928749","chr20","35173318","35173398","28","33244650"
"chr6","1935553","1935859","chr20","51302560","51302858","61","49367007"
"chr6","1946434","1946596","chr19","1931438","1931600","7","14996"
"chr6","2031673","2031839","chr3","34832220","34832387","39","32800547"
"chr6","2035931","2036250","chr19","2039146","2039470","13","3215"
"chr6","2053735","2054042","chr19","2056540","2056846","10","2805"
"chr6","2055765","2055808","chr15","35908640","35908683","10","33852875"
"chr6","2084515","2084686","chr19","2096200","2096385","28","11685"
"chr6","2088696","2088839","chr19","2100699","2100843","10","12003"
"chr6","2093867","2094040","chr19","2104895","2105096","32","11028"
"chr6","2097913","2098078","chr19","2116270","2116438","6","18357"
"chr6","2116488","2116785","chr19","2128962","2129261","11","12474"
"chr6","2151676","2151818","chr3","2928640","2928760","40","776964"
"chr6","2155618","2155937","JH679934","32155","32467","14","2123463"
"chr6","2163362","2163660","JH679934","24747","25061","52","2138615"
"chr6","2171186","2171444","chr11","64348478","64348729","54","62177292"
"chr6","2175596","2175898","JH679934","11558","11842","25","2164038"
"chr6","2194377","2194673","chr1","34615486","34615780","54","32421109"
"chr6","2202491","2202646","chr19","2178346","2178503","6","24145"
"chr6","2229139","2229429","chr9","57648963","57649252","50","55419824"
"chr6","2242488","2242582","chr19","2227969","2228062","2","14519"
"chr6","2253648","2253965","chr19","2238595","2238911","12","15053"
"chr6","2254595","2254905","chr7","126601320","126601621","62","124346725"
"chr6","2256795","2257107","chr19","2241839","2242148","24","14956"
"chr6","2306096","2306430","chr19","2296022","2296357","23","10074"
"chr6","2324154","2324320","chr9","102282987","102283142","36","99958833"
"chr6","2339147","2339164","chr11","110960474","110960488","5","108621327"
"chr6","2340310","2340585","chr19","2334803","2335075","12","5507"
"chr6","2345072","2345084","chr9","24282761","24282774","5","21937689"
"chr6","2345414","2345467","chr19","2339973","2340024","3","5441"
"chr6","2351952","2352267","chr19","2346868","2347162","27","5084"
"chr6","2358297","2358454","chr11","112541490","112541655","29","110183193"
"chr6","2375844","2376154","chr19","2367599","2367909","9","8245"
"chr6","2387877","2388068","chr19","2384083","2384272","16","3794"
"chr6","2388367","2388481","chr19","2384571","2384698","17","3796"
"chr6","2389601","2389911","chr19","2385799","2386109","8","3802"
"chr6","2419422","2419728","chr19","2417489","2417787","19","1933"
"chr6","2433718","2434000","chr19","2431173","2431457","13","2545"
"chr6","2451676","2451945","chr19","2449236","2449505","15","2440"
"chr6","2466558","2466871","chr19","2463326","2463639","18","3232"
"chr6","2468325","2468596","chr19","2465102","2465377","16","3223"
"chr6","2489700","2489878","chr16","57677375","57677549","28","55187675"
"chr6","2490597","2490715","chr11","116579694","116579814","22","114089097"
"chr6","2559764","2560046","chr19","2556697","2556980","11","3067"
"chr6","2571751","2571926","chr19","2569084","2569272","18","2667"
"chr6","2606909","2607232","chr19","2606731","2607056","7","178"
"chr6","2611763","2612054","chr19","2610986","2611292","29","777"
"chr6","2613885","2614169","chr19","2612958","2613242","7","927"
"chr6","2619139","2619400","chr19","2618252","2618514","4","887"
"chr6","2638816","2639112","chr19","2645412","2645708","5","6596"
"chr6","2676961","2677017","chr12","95723167","95723218","11","93046206"
"chr6","2712456","2712766","chr1","129944347","129944658","53","127231891"
"chr6","2715504","2715636","chr1","38100145","38100281","32","35384641"
"chr6","2716531","2716705","chr19","2729133","2729307","4","12602"
"chr6","2720781","2721001","chr19","2733031","2733251","11","12250"
"chr6","2740747","2741056","chr19","2754697","2755000","28","13950"
"chr6","2744691","2744947","chr1","157281198","157281450","68","154536507"
"chr6","2769422","2769691","chr19","2783456","2783730","15","14034"
"chr6","2775161","2775294","chr10","28671644","28671771","24","25896483"
"chr6","2786082","2786199","chr19","2811828","2811945","3","25746"
"chr6","2793589","2793660","chr16","64755709","64755772","18","61962120"
"chr6","2793977","2794037","chr14","55598372","55598433","13","52804395"
"chr6","2794254","2794287","chr4","33646754","33646781","13","30852500"
"chr6","2796230","2796541","chr19","2806454","2806760","16","10224"
"chr6","2821259","2821555","chr19","2838461","2838739","34","17202"
"chr6","2837421","2837729","chr19","2851610","2851919","20","14189"
"chr6","2845583","2845732","chr2","28719102","28719249","23","25873519"
"chr6","2851336","2851465","chr2","49066195","49066322","17","46214859"
"chr6","2851478","2851628","chr19","2871066","2871219","7","19588"
"chr6","2866179","2866486","chr5","169227","169528","54","2696952"
"chr6","2875216","2875416","chr19","2893758","2893958","4","18542"
"chr6","2892555","2892866","chr19","2910932","2911238","17","18377"
"chr6","2905600","2905761","chrX","47622369","47622525","27","44716769"
"chr6","2912139","2912305","chr11","2903895","2904062","24","8244"
"chr6","2927242","2927548","chr19","2944572","2944878","19","17330"
"chr6","2935655","2935866","chr19","2952338","2952554","13","16683"
"chr6","2944349","2944669","chr19","2963104","2963422","5","18755"
"chr6","2958633","2958791","chr19","2977681","2977842","9","19048"
"chr6","2968673","2968740","chr8","120281072","120281144","16","117312399"
"chr6","2986991","2987163","chr19","3004543","3004712","12","17552"
"chr6","2987480","2987613","chr19","3005031","3005164","1","17551"
"chr6","3007294","3007486","chr3","47934675","47934850","55","44927381"
"chr6","3007791","3007916","chr13","47572248","47572372","15","44564457"
"chr6","3025270","3025361","chr15","15787980","15788074","16","12762710"
"chr6","3053342","3053648","chr11","111655411","111655704","69","108602069"
"chr6","3054681","3054829","chr19","3078766","3078908","15","24085"
"chr6","3059590","3059846","chr19","3083664","3083949","37","24074"
"chr6","3066514","3066674","chr19","3073349","3073500","13","6835"
"chr6","3095668","3095969","chr19","3116641","3116942","17","20973"
"chr6","3097237","3097533","chr19","3118416","3118707","21","21179"
"chr6","3098634","3098751","chr19","3119816","3119929","10","21182"
"chr6","3098809","3099009","chr19","3120015","3120208","23","21206"
"chr6","3100456","3100569","chr19","3121657","3121770","4","21201"
"chr6","3103363","3103544","chr3","2024698","2024867","36","1078665"
"chr6","3103624","3103795","chr19","3124343","3124473","43","20719"
"chr6","3106901","3107024","chr19","3127570","3127696","8","20669"
"chr6","3122290","3122588","chr19","3142243","3142541","7","19953"
"chr6","3145961","3146009","chr20","14196650","14196697","13","11050689"
"chr6","3146311","3146418","chr6","31597142","31597254","23","28450831"
"chr6","3152581","3152890","chr19","3174084","3174388","12","21503"
"chr6","3154366","3154497","chr19","3175850","3175981","10","21484"
"chr6","3166650","3166941","chr3","9885358","9885654","51","6718708"
"chr6","3184254","3184560","chr19","3210409","3210711","10","26155"
"chr6","3187933","3188079","chr19","3213747","3213893","2","25814"
"chr6","3188389","3188530","chr19","3214202","3214346","6","25813"
"chr6","3196133","3196442","chr19","3222710","3223020","16","26577"
"chr6","3196443","3196577","chr19","3223024","3223155","10","26581"
"chr6","3198109","3198255","chr17","90065624","90065764","31","86867515"
"chr6","3198536","3198670","chr2","187025948","187026082","21","183827412"
"chr6","3202810","3203106","chr19","3229127","3229417","31","26317"
"chr6","3203163","3203284","chr7","27522130","27522249","17","24318967"
"chr6","3205484","3205773","chr19","3233630","3233921","24","28146"
"chr6","3215938","3216245","chr19","3244416","3244710","26","28478"
"chr6","3225953","3226229","chr2","92277567","92277854","61","89051614"
"chr6","3235620","3235902","chr2","147630797","147631078","60","144395177"
"chr6","3237078","3237240","chr19","3265464","3265620","13","28386"
"chr6","3251161","3251452","chr19","3278586","3278897","51","27425"
"chr6","3254406","3254609","chr9","60876511","60876709","51","57622105"
"chr6","3261398","3261563","chr19","3289835","3290002","7","28437"
"chr6","3262116","3262408","chr19","3291813","3292117","22","29697"
"chr6","3276088","3276378","chr19","3307064","3307353","12","30976"
"chr6","3284256","3284416","chr7","46204257","46204412","30","42920001"
"chr6","3287479","3287556","chr19","3318483","3318560","3","31004"
"chr6","3303525","3303626","chr11","85978460","85978564","15","82674935"
"chr6","3314399","3314692","chrX","20983668","20983957","49","17669269"
"chr6","3316873","3317010","chr8","119475005","119475142","22","116158132"
"chr6","3319044","3319213","chr14","11559606","11559770","29","8240562"
"chr6","3343169","3343456","chr19","3378867","3379159","14","35698"
"chr6","3356518","3356671","chr16","18819593","18819742","38","15463075"
"chr6","3356672","3356720","chrX","939789","939841","10","2416883"
"chr6","3368568","3368613","chr19","3404847","3404890","4","36279"
"chr6","3382323","3382620","chr9","59519395","59519692","55","56137072"
"chr6","3398242","3398547","chr19","3430882","3431187","15","32640"
"chr6","3412574","3412714","chr19","3445798","3445938","3","33224"
"chr6","3449731","3450031","chr19","3483134","3483436","7","33403"
"chr6","3456121","3456270","chrX","44098136","44098280","24","40642015"
"chr6","3456578","3456660","chr19","13172641","13172724","4","9716063"
"chr6","3457855","3457924","chr4","102671361","102671430","17","99213506"
"chr6","3458689","3458784","chrX","122790606","122790686","29","119331917"
"chr6","3459611","3459803","chr19","3492568","3492746","17","32957"
"chr6","3460114","3460246","chr4","10232061","10232191","21","6771947"
"chr6","3465195","3465447","chr2","55986552","55986791","68","52521357"
"chr6","3467072","3467194","chr7","125902593","125902716","26","122435521"
"chr6","3467589","3467686","chr7","70444956","70445052","21","66977367"
"chr6","3477692","3477992","chr16","44745004","44745304","54","41267312"
"chr6","3487575","3487850","chr19","3521074","3521390","46","33499"
"chr6","3507137","3507426","chr2","184830359","184830654","52","181323222"
"chr6","3516031","3516163","chr13","8059386","8059520","26","4543355"
"chr6","3516470","3516651","chr14","67129250","67129427","28","63612780"
"chr6","3550568","3550662","chr8","37054813","37054901","27","33504245"
"chr6","3557017","3557320","chr19","3585350","3585651","14","28333"
"chr6","3559861","3560157","chr19","3597242","3597530","19","37381"
"chr6","3580442","3580766","chr8","68977991","68978300","70","65397549"
"chr6","3592214","3592419","chr3","88934032","88934235","44","85341818"
"chr6","3599977","3600172","chr5","1712601","1712792","38","1887376"
"chr6","3610869","3611150","chr19","3657080","3657359","8","46211"
"chr6","3634139","3634331","chr19","3673042","3673220","18","38903"
"chr6","3651145","3651307","chrX","61049663","61049821","32","57398518"
"chr6","3654151","3654444","chr19","3689489","3689778","24","35338"
"chr6","3656963","3657236","chr19","3693138","3693440","47","36175"
"chr6","3659018","3659256","chr19","3695197","3695424","20","36179"
"chr6","3662800","3662893","chr19","3699014","3699107","3","36214"
"chr6","3668150","3668426","chr19","3703758","3704034","3","35608"
"chr6","3679443","3679614","chr1","56272835","56272998","30","52593392"
"chr6","3686554","3686844","chr19","3726142","3726436","12","39588"
"chr6","3703137","3703405","chr5","813414","813700","60","2889723"
"chr6","3710148","3710219","chr19","3750636","3750706","3","40488"
"chr6","3711531","3711701","chr20","22154242","22154420","40","18442711"
"chr6","3723149","3723423","chr1","127896341","127896622","63","124173192"
"chr6","3765359","3765632","chr19","3813218","3813506","25","47859"
"chr6","3786368","3786636","chr19","3834688","3834955","8","48320"
"chr6","3799540","3799836","chr19","3849943","3850238","9","50403"
"chr6","3837081","3837291","chr19","3890980","3891189","6","53899"
"chr6","3841135","3841432","chr5","172587347","172587650","64","168746212"
"chr6","3846799","3847107","chr19","3901842","3902148","18","55043"
"chr6","3848069","3848226","chr19","3903112","3903269","7","55043"
"chr6","3850744","3850865","chr19","3905806","3905927","2","55062"
"chr6","3862245","3862549","chr19","3917756","3918062","12","55511"
"chr6","3863422","3863693","chr19","3919021","3919289","14","55599"
"chr6","3863821","3863994","chr18","43174622","43174788","46","39310801"
"chr6","3863996","3864055","chr16","23924156","23924211","16","20060160"
"chr6","3867341","3867642","chr19","3921435","3921736","9","54094"
"chr6","3884428","3884731","chr19","3941626","3941932","6","57198"
"chr6","3886376","3886669","chr19","3943186","3943491","18","56810"
"chr6","3887116","3887419","chr19","3943940","3944246","7","56824"
"chr6","3888568","3888644","chr19","3945431","3945507","2","56863"
"chr6","3890036","3890219","chr19","3947945","3948125","13","57909"
"chr6","3894778","3894901","chr19","3952931","3953053","6","58153"
"chr6","3900550","3900854","chr5","104770841","104771143","55","100870291"
"chr6","3901795","3902144","chr1","23542732","23543072","81","19640937"
"chr6","3903097","3903157","chr19","3963263","3963320","7","60166"
"chr6","3912136","3912442","chr19","3973855","3974158","13","61719"
"chr6","3913448","3913721","chr10","20733883","20734167","61","16820435"
"chr6","3923908","3924219","chr7","92332842","92333152","61","88408934"
"chr6","3940081","3940361","chr6","50494463","50494746","57","46554382"
"chr6","3940379","3940420","chr14","6765227","6765269","5","2824848"
"chr6","3950069","3950384","chr19","4013818","4014133","12","63749"
"chr6","3968010","3968150","chr19","4032137","4032273","8","64127"
"chr6","3968773","3968969","chr19","4032901","4033101","23","64128"
"chr6","3982943","3983224","chr19","4050415","4050727","40","67472"
"chr6","3994092","3994277","chr1","80020580","80020767","34","76026488"
"chr6","4000982","4001269","chrX","107297815","107298105","55","103296833"
"chr6","4001922","4002220","chr2","47911084","47911382","51","43909162"
"chr6","4044883","4045185","chr19","4123948","4124250","8","79065"
"chr6","4055757","4056046","chr13","26649155","26649437","62","22593398"
"chr6","4070338","4070430","chr7","129708483","129708574","4","125638145"
"chr6","4076538","4076843","chr7","129715229","129715537","22","125638691"
"chr6","4082995","4083008","chr1","129636817","129636828","3","125553822"
"chr6","4083302","4083462","chr19","4150120","4150280","9","66818"
"chr6","4084071","4084166","chr19","4150859","4150951","4","66788"
"chr6","4084175","4084321","chr19","4150960","4151106","7","66785"
"chr6","4112556","4112855","chr19","4180150","4180451","12","67594"
"chr6","4124683","4124791","chr19","4191934","4192041","3","67251"
"chr6","4145386","4145691","chr19","4213928","4214225","14","68542"
"chr6","4151929","4152206","chr17","90075621","90075904","58","85923692"
"chr6","4166123","4166434","chr19","4236590","4236903","14","70467"
"chr6","4182246","4182462","chr19","4252353","4252560","18","70107"
"chr6","4188991","4189300","chr19","4259094","4259405","12","70103"
"chr6","4190948","4191024","chr19","4260970","4261037","10","70022"
"chr6","4191337","4191584","chr19","4261345","4261591","12","70008"
"chr6","4206483","4206832","chr19","4279641","4279998","21","73158"
"chr6","4210574","4210894","chr19","4288788","4289103","16","78214"
"chr6","4212055","4212339","chr19","4290574","4290855","13","78519"
"chr6","4215784","4215906","chr5","51039231","51039352","27","46823447"
"chr6","4228981","4229159","chr19","4305024","4305203","9","76043"
"chr6","4229461","4229599","chr19","4305794","4305932","2","76333"
"chr6","4262596","4262889","chr1","192056521","192056805","55","187793925"
"chr6","4269562","4269739","chr3","161043146","161043319","37","156773584"
"chr6","4290954","4291229","chr19","4353020","4353295","10","62066"
"chr6","4292222","4292399","chr3","161043146","161043319","37","156750924"
"chr6","4294160","4294458","chr19","4379553","4379832","26","85393"
"chr6","4297082","4297365","chr19","4382163","4382448","9","85081"
"chr6","4319457","4319471","chr1","109427498","109427509","3","105108041"
"chr6","4319786","4319961","chr19","4403380","4403554","8","83594"
"chr6","4324663","4324973","chr19","4414751","4415071","24","90088"
"chr6","4364204","4364429","chr19","4459173","4459395","5","94969"
"chr6","4371913","4372102","chr13","71842081","71842251","42","67470168"
"chr6","4373691","4373934","chr19","4472692","4472935","2","99001"
"chr6","4380979","4381142","chr6","69024868","69025040","43","64643889"
"chr6","4392076","4392180","chr1","3078007","3078112","23","1314069"
"chr6","4414618","4414924","chr19","4522852","4523158","9","108234"
"chr6","4455497","4455651","chr16","38107036","38107190","29","33651539"
"chr6","4455959","4456086","chrX","13996135","13996270","28","9540176"
"chr6","4470444","4470745","chr2","149220987","149221284","59","144750543"
"chr6","4477857","4478153","chr2","47911084","47911382","55","43433227"
"chr6","4481818","4481942","chr2","171842800","171842921","24","167360982"
"chr6","4481984","4482147","chr10","83046737","83046899","36","78564753"
"chr6","4509432","4509594","chr11","38369515","38369683","27","33860083"
"chr6","4512259","4512385","chr19","4581014","4581134","9","68755"
"chr6","4513023","4513167","chr19","11481676","11481817","30","6968653"
"chr6","4515715","4516012","chr19","4581449","4581744","9","65734"
"chr6","4518487","4518797","chr19","4589299","4589609","8","70812"
"chr6","4524261","4524380","chr20","50891384","50891499","24","46367123"
"chr6","4526283","4526423","chr6","117784554","117784697","37","113258271"
"chr6","4548003","4548305","chr19","4627895","4628197","2","79892"
"chr6","4548335","4548587","chrX","141024796","141025052","62","136476461"
"chr6","4548589","4548648","chr9","57301970","57302028","10","52753381"
"chr6","4548701","4548765","chr10","16173252","16173314","8","11624551"
"chr6","4570966","4571258","chr19","4649855","4650147","6","78889"
"chr6","4577248","4577418","chr19","4658174","4658357","20","80926"
"chr6","4577896","4578059","chr19","4658882","4659047","11","80986"
"chr6","4578369","4578508","chr19","4659366","4659509","8","80997"
"chr6","4600155","4600412","chr19","4683516","4683785","18","83361"
"chr6","4602090","4602390","chr19","4685165","4685466","13","83075"
"chr6","4619517","4619714","chr17","24119423","24119621","36","19499906"
"chr6","4620026","4620167","chr19","4703077","4703218","8","83051"
"chr6","4622489","4622595","chr19","4705710","4705819","6","83221"
"chr6","4623191","4623395","chr19","4706417","4706621","8","83226"
"chr6","4627800","4627980","chr19","4712221","4712391","15","84421"
"chr6","4639716","4639849","chr19","4725810","4725943","3","86094"
"chr6","4642608","4642857","chr3","138700033","138700275","64","134057425"
"chr6","4646295","4646592","chr19","4732738","4733029","14","86443"
"chr6","4646595","4646901","chr19","4733032","4733338","3","86437"
"chr6","4672611","4672912","chr19","4758799","4759101","8","86188"
"chr6","4674074","4674363","chr19","4759947","4760224","21","85873"
"chr6","4674524","4674775","chr19","4760389","4760614","31","85865"
"chr6","4678330","4678543","chr5","148075213","148075417","48","143396883"
"chr6","4709983","4710154","chr19","4796347","4796514","13","86364"
"chr6","4713901","4714195","chr5","142637298","142637591","53","137923397"
"chr6","4714854","4715014","chr19","4801273","4801444","16","86419"
"chr6","4727910","4728182","chr19","4813195","4813465","4","85285"
"chr6","4735112","4735393","chr19","4820508","4820791","9","85396"
"chr6","4743449","4743640","chr1","125184404","125184583","39","120440955"
"chr6","4754680","4754945","chr19","4840981","4841246","13","86301"
"chr6","4763034","4763194","chr11","109860880","109861035","27","105097846"
"chr6","4782950","4783235","chr1","28978297","28978584","58","24195347"
"chr6","4788155","4788443","chr19","4875022","4875310","6","86867"
"chr6","4798048","4798293","chr19","4884902","4885144","7","86854"
"chr6","4817340","4817575","chr19","4904057","4904282","17","86717"
"chr6","4825669","4825966","chr19","4912556","4912851","11","86887"
"chr6","4847500","4847521","chr2","149869102","149869117","9","145021602"
"chr6","4849819","4849951","chr19","4938422","4938554","9","88603"
"chr6","4853845","4853911","chr19","4942360","4942426","1","88515"
"chr6","4854161","4854234","chr19","4942693","4942783","17","88532"
"chr6","4866776","4866907","chrX","6936247","6936384","26","2069471"
"chr6","4874868","4875186","chr19","4964915","4965219","48","90047"
"chr6","4875621","4875914","chr19","4965663","4965956","8","90042"
"chr6","4950726","4950887","chr19","5042032","5042186","11","91306"
"chr6","4951153","4951232","chr19","5042454","5042533","2","91301"
"chr6","4953526","4953757","chr14","18442982","18443216","52","13489456"
"chr6","4954773","4954869","chr19","520624","520708","23","4434149"
"chr6","4955165","4955297","chr19","8562917","8563049","6","3607752"
"chr6","4956543","4956774","chr14","18442982","18443216","52","13486439"
"chr6","4963120","4963410","chr19","5052243","5052533","8","89123"
"chr6","4974376","4974655","chr5","33703173","33703447","55","28728797"
"chr6","5012157","5012368","chr19","5103088","5103327","35","90931"
"chr6","5020174","5020428","chr1","180757143","180757380","85","175736969"
"chr6","5056974","5057247","chr19","5150164","5150437","7","93190"
"chr6","5061017","5061262","chr19","5153758","5154007","11","92741"
"chr6","5061437","5061602","chr19","5154180","5154331","19","92743"
"chr6","5064532","5064805","chr19","5157556","5157837","34","93024"
"chr6","5070324","5070634","chr19","5163371","5163666","20","93047"
"chr6","5080029","5080339","chr19","5173272","5173582","7","93243"
"chr6","5121147","5121305","chr1","35189927","35190090","25","30068780"
"chr6","5121348","5121468","chr3","44935087","44935207","17","39813739"
"chr6","5162725","5163022","chr19","5259593","5259891","13","96868"
"chr6","5164340","5164639","chr7","101602473","101602769","56","96438133"
"chr6","5171880","5172192","chr19","5269553","5269865","4","97673"
"chr6","5188005","5188219","chr19","5286188","5286402","7","98183"
"chr6","5188298","5188470","chr19","5286481","5286652","8","98183"
"chr6","5188596","5188669","chr19","5286767","5286840","2","98171"
"chr6","5197245","5197521","chr1","22047855","22048155","64","16850610"
"chr6","5203522","5203668","chr10","12286075","12286221","29","7082553"
"chr6","5203695","5203992","chr19","5299976","5300273","12","96281"
"chr6","5204485","5204765","chr1","22940926","22941211","64","17736441"
"chr6","5206721","5206999","chr19","5303051","5303322","19","96330"
"chr6","5212220","5212512","chr19","5309511","5309803","3","97291"
"chr6","5215452","5215573","chr10","61329698","61329813","21","56114246"
"chr6","5218138","5218438","chr19","5317903","5318203","10","99765"
"chr6","5232500","5232573","chr1","66509914","66509985","18","61277414"
"chr6","5232574","5232732","chr3","40079355","40079508","34","34846781"
"chr6","5234635","5234795","chr13","37888752","37888912","30","32654117"
"chr6","5253585","5253851","chr19","5357242","5357508","3","103657"
"chr6","5254473","5254568","chr4","40873220","40873312","27","35618747"
"chr6","5261484","5261547","chr7","39038812","39038876","12","33777328"
"chr6","5261548","5261701","chr3","42810073","42810224","35","37548525"
"chr6","5263641","5263951","chr19","5367403","5367713","11","103762"
"chr6","5295209","5295298","chr19","5400071","5400161","3","104862"
"chr6","5313017","5313294","chr19","5418070","5418349","14","105053"
"chr6","5333253","5333400","chr19","5439527","5439689","23","106274"
"chr6","5346220","5346331","chr1","139954765","139954873","17","134608545"
"chr6","5346637","5346813","chr19","5452961","5453142","7","106324"
"chr6","5368314","5368412","chr19","5477693","5477791","2","109379"
"chr6","5368976","5369245","chr19","5478353","5478622","6","109377"
"chr6","5388043","5388110","chr11","117360171","117360241","16","111972128"
"chr6","5388136","5388302","chr16","21928800","21928967","36","16540664"
"chr6","5390788","5391078","chr19","5502484","5502806","41","111696"
"chr6","5394917","5395072","chr19","5509258","5509413","8","114341"
"chr6","5397858","5398054","chr3","44613544","44613717","49","39215686"
"chr6","5408873","5409165","chr9","85506045","85506341","53","80097172"
"chr6","5413875","5414162","chr19","5532663","5532976","30","118788"
"chr6","5437721","5438014","chr19","5550775","5551069","7","113054"
"chr6","5443326","5443664","chr19","5582285","5582634","17","138959"
"chr6","5471650","5471716","chr16","16996169","16996232","18","11524519"
"chr6","5484169","5484369","chr19","5632298","5632496","14","148129"
"chr6","5484668","5484683","chr1","21482875","21482886","4","15998207"
"chr6","5489017","5489307","chr19","5624086","5624377","7","135069"
"chr6","5532938","5533199","chr4","105487055","105487332","69","99954117"
"chr6","5533206","5533500","chr16","31689462","31689756","86","26156256"
"chr6","5557457","5557600","chr15","598374","598523","31","4959083"
"chr6","5572352","5572495","chr15","598374","598523","31","4973978"
"chr6","5575820","5576115","chr16","51645391","51645686","58","46069571"
"chr6","5653548","5653833","chr19","5786136","5786439","26","132588"
"chr6","5657712","5657876","chr19","5790579","5790734","14","132867"
"chr6","5675709","5675870","chr19","5810207","5810368","11","134498"
"chr6","5676180","5676313","chr19","5810670","5810803","3","134490"
"chr6","5698418","5698679","chr19","5833702","5833957","13","135284"
"chr6","5725577","5725817","chr5","175400136","175400371","59","169674559"
"chr6","5726196","5726416","chr6","51151632","51151853","49","45425436"
"chr6","5732018","5732320","chr19","5868272","5868567","15","136254"
"chr6","5766015","5766188","chr19","5902025","5902199","7","136010"
"chr6","5783146","5783457","chr19","5920480","5920785","10","137334"
"chr6","5784720","5785017","chr19","5922040","5922338","14","137320"
"chr6","5816948","5817230","chr10","37746028","37746306","60","31929080"
"chr6","5819814","5820106","chr19","5956712","5957010","11","136898"
"chr6","5820994","5821210","chr19","5957878","5958094","4","136884"
"chr6","5839926","5840206","chr19","5971716","5972012","21","131790"
"chr6","5873236","5873368","chr7","20121693","20121826","23","14248457"
"chr6","5874200","5874375","chr15","102217712","102217880","37","96343512"
"chr6","5880533","5880845","chr19","6019440","6019769","24","138907"
"chr6","5886033","5886214","chr7","19517713","19517888","44","13631680"
"chr6","5892982","5893255","chr7","132571962","132572230","72","126678980"
"chr6","5899134","5899428","chr19","6037874","6038168","5","138740"
"chr6","5943572","5943740","chr19","6091219","6091380","12","147647"
"chr6","5944027","5944104","chr11","117360171","117360241","19","111416144"
"chr6","5944733","5945025","chr19","6092686","6092974","11","147953"
"chr6","5966044","5966332","chr19","6109158","6109477","47","143114"
"chr6","5970512","5970813","chr2","167664248","167664541","52","161693736"
"chr6","5972094","5972368","chr15","91105824","91106095","65","85133730"
"chr6","5979653","5979754","chr8","41186290","41186390","19","35206637"
"chr6","5980971","5981263","chr1","33473154","33473456","57","27492183"
"chr6","5998502","5998644","chr20","21270882","21271018","21","15272380"
"chr6","5998946","5999115","chr12","35606960","35607127","26","29608014"
"chr6","6000929","6000941","chr1","8928246","8928258","4","2927317"
"chr6","6040413","6040714","chr19","6192552","6192847","19","152139"
"chr6","6040745","6040881","chr6","172208530","172208677","36","166167785"
"chr6","6041188","6041325","chr19","6193325","6193461","4","152137"
"chr6","6041625","6041804","chr19","6193757","6193936","7","152132"
"chr6","6058958","6059294","chr19","6205894","6206230","5","146936"
"chr6","6073417","6073670","chr19","6229054","6229304","7","155637"
"chr6","6075037","6075314","chr19","6230679","6230949","16","155642"
"chr6","6086672","6086855","chr19","6242962","6243145","4","156290"
"chr6","6090988","6091308","chr19","6247845","6248134","40","156857"
"chr6","6097220","6097520","chr19","6253654","6253945","19","156434"
"chr6","6106954","6107254","chr19","6253654","6253945","19","146700"
"chr6","6109526","6109827","chrX","21040106","21040404","69","14930580"
"chr6","6122438","6122475","chr3","44827294","44827332","11","38704856"
"chr6","6127094","6127360","chr19","6287940","6288205","5","160846"
"chr6","6130415","6130681","chr19","6287940","6288205","5","157525"
"chr6","6141607","6141764","chr6","148135774","148135932","29","141994167"
"chr6","6164083","6164374","chr19","6326761","6327050","11","162678"
"chr6","6165941","6166085","chr19","6329159","6329303","5","163218"
"chr6","6166378","6166545","chr19","6329598","6329761","9","163220"
"chr6","6188224","6188515","chr19","6355923","6356214","14","167699"
"chr6","6209395","6209627","chr19","6377668","6377893","10","168273"
"chr6","6219840","6219910","chr20","14309840","14309907","11","8090000"
"chr6","6219911","6220063","chr16","18819593","18819742","24","12599682"
"chr6","6237393","6237688","chr19","6415223","6415529","20","177830"
"chr6","6243630","6243934","chr19","6421544","6421849","10","177914"
"chr6","6253585","6253807","chr19","6431212","6431447","20","177627"
"chr6","6271511","6271667","chr19","6442740","6442894","7","171229"
"chr6","6283535","6283599","chr3","40058589","40058650","11","33775054"
"chr6","6290185","6290475","chr19","6474383","6474649","30","184198"
"chr6","6303884","6304162","chr19","6488090","6488374","13","184206"
"chr6","6316367","6316665","chr19","6500507","6500806","3","184140"
"chr6","6325759","6325939","chr19","6511185","6511375","28","185426"
"chr6","6343383","6343531","chr4","123473830","123473989","37","117130447"
"chr6","6345430","6345635","chr19","6533544","6533712","49","188114"
"chr6","6346819","6347111","chr4","112871723","112872010","60","106524904"
"chr6","6351641","6351805","chr7","106427382","106427546","35","100075741"
"chr6","6361922","6362015","chr19","6551811","6551904","5","189889"
"chr6","6440602","6440891","chr19","6633804","6634097","17","193202"
"chr6","6447659","6447792","chr1","28999769","28999900","24","22552110"
"chr6","6491629","6491892","chr19","6680506","6680768","11","188877"
"chr6","6560949","6561122","chr5","173617858","173618025","33","167056909"
"chr6","6582561","6582717","chr18","5782847","5783004","30","799714"
"chr6","6582736","6583019","chr19","6727901","6728206","35","145165"
"chr6","6595000","6595229","chr9","88613544","88613768","56","82018544"
"chr6","6602377","6602677","chr19","6746883","6747209","35","144506"
"chr6","6646910","6647210","chr13","124875372","124875677","61","118228462"
"chr6","6666870","6667033","chr19","6813497","6813660","9","146627"
"chr6","6667038","6667163","chr19","6813665","6813790","1","146627"
"chr6","6681704","6681875","chr19","6826155","6826320","8","144451"
"chr6","6721258","6721469","chr19","6870885","6871096","4","149627"
"chr6","6736393","6736686","chr19","6892002","6892298","18","155609"
"chr6","6747251","6747516","chr10","82949030","82949297","44","76201779"
"chr6","6758561","6758759","chr19","6914243","6914444","5","155682"
"chr6","6758760","6758925","chr19","6914445","6914606","8","155685"
"chr6","6765821","6766124","chr19","6922262","6922557","18","156441"
"chr6","6775044","6775154","chr19","6929968","6930078","0","154924"
"chr6","6789559","6789836","chr4","107835992","107836277","57","101046433"
"chr6","6790909","6791129","chr19","6946253","6946473","3","155344"
"chr6","6794461","6794681","chr19","6946253","6946473","3","151792"
"chr6","6798240","6798538","chr19","6950842","6951151","24","152602"
"chr6","6806709","6806998","chr13","62709032","62709312","72","55902323"
"chr6","6807617","6807801","chr19","6962678","6962848","24","155061"
"chr6","6808357","6808678","chr19","6963386","6963695","32","155029"
"chr6","6820313","6820539","chr17","90056068","90056294","52","83235755"
"chr6","6826320","6826490","chr19","1864380","1864550","34","4961940"
"chr6","6838178","6838351","chr19","6997493","6997667","8","159315"
"chr6","6863938","6864007","chr19","7029904","7029973","5","165966"
"chr6","6873644","6873808","chr14","18925179","18925342","30","12051535"
"chr6","6879468","6879803","chr20","622680","623014","67","6256788"
"chr6","6882230","6882395","chr10","83253028","83253183","32","76370798"
"chr6","6882396","6882700","chr19","7050656","7050961","12","168260"
"chr6","6892922","6893218","chr2","144569373","144569671","71","137676451"
"chr6","6898954","6899266","chr19","7067888","7068190","19","168934"
"chr6","6919276","6919541","chr19","7078669","7078933","13","159393"
"chr6","6928946","6929248","chr19","7088640","7088954","24","159694"
"chr6","6929665","6929923","chr19","7089368","7089626","3","159703"
"chr6","6940716","6941014","chr19","7100652","7100950","15","159936"
"chr6","6942998","6943289","chr19","7102939","7103230","15","159941"
"chr6","6968193","6968439","chr19","7131140","7131403","26","162947"
"chr6","6978581","6978880","chr19","7141299","7141592","30","162718"
"chr6","6982704","6983009","chr19","7145371","7145676","3","162667"
"chr6","7042729","7042920","chr12","30669160","30669350","35","23626431"
"chr6","7060458","7060764","chr19","7230836","7231142","7","170378"
"chr6","7075843","7075923","chr1","130442089","130442168","18","123366246"
"chr6","7082009","7082158","chr16","18819593","18819742","25","11737584"
"chr6","7082159","7082249","chr1","190655363","190655447","17","183573204"
"chr6","7161793","7161912","chr11","49188286","49188402","24","42026493"
"chr6","7162210","7162366","chr1","9350553","9350709","31","2188343"
"chr6","7166785","7167084","chr2","44882107","44882408","59","37715322"
"chr6","7193633","7193922","chr19","7365928","7366215","6","172295"
"chr6","7202287","7202584","chr19","7378583","7378880","9","176296"
"chr6","7203465","7203779","chr19","7379735","7380050","18","176270"
"chr6","7213573","7213726","chr16","679950","680101","31","6533623"
"chr6","7213737","7213890","chr16","679950","680101","31","6533787"
"chr6","7214288","7214423","chr3","40069149","40069277","29","32854861"
"chr6","7227380","7227674","chr19","7402225","7402519","8","174845"
"chr6","7259265","7259399","chr19","7429640","7429774","3","170375"
"chr6","7269098","7269389","chr11","65614989","65615267","71","58345891"
"chr6","7276725","7276792","chr1","202541422","202541489","5","195264697"
"chr6","7331437","7331585","chr19","7473252","7473400","1","141815"
"chr6","7332163","7332334","chr19","7472277","7472448","2","140114"
"chr6","7336903","7337081","chr8","27352041","27352214","40","20015138"
"chr6","7340491","7340821","chr19","7463062","7463392","12","122571"
"chr6","7353295","7353585","chr19","7448666","7448955","7","95371"
"chr6","7358011","7358170","chr12","13614701","13614861","28","6256690"
"chr6","7387108","7387373","chr14","11758420","11758684","55","4371312"
"chr6","7400674","7400971","chr6","134251498","134251796","53","126850824"
"chr6","7402607","7402768","chr3","34083106","34083268","35","26680499"
"chr6","7402769","7403056","chr13","42501441","42501727","51","35098672"
"chr6","7403057","7403191","chr1","13051263","13051399","21","5648206"
"chr6","7407557","7407784","chr11","109771579","109771818","66","102364022"
"chr6","7410202","7410365","chr6","148049809","148049964","55","140639607"
"chr6","7410391","7410606","chr10","37889717","37889905","67","30479326"
"chr6","7441219","7441504","chrX","15783794","15784082","49","8342575"
"chr6","7446975","7447305","chr2","94564948","94565269","79","87117973"
"chr6","7451350","7451593","chr13","99878868","99879107","58","92427518"
"chr6","7456265","7456402","chr1","34512524","34512644","35","27056259"
"chr6","7456894","7456946","chr1","159818644","159818693","8","152361750"
"chr6","7465851","7466152","chr14","30200281","30200571","46","22734430"
"chr6","7470135","7470446","chr3","13334990","13335300","62","5864855"
"chr6","7474217","7474325","chr3","157051887","157051998","21","149577670"
"chr6","7474324","7474410","chr4","2744439","2744523","13","4729885"
"chr6","7500002","7500230","chr17","11398459","11398688","41","3898457"
"chr6","7506563","7506666","chr13","26811151","26811251","20","19304588"
"chr6","7506967","7507001","chr15","9659349","9659384","8","2152382"
"chr6","7507309","7507487","chr13","47285224","47285397","37","39777915"
"chr6","7518905","7519203","chr6","51072032","51072325","56","43553127"
"chr6","7542950","7543101","chr3","3776853","3777003","28","3766097"
"chr6","7555613","7555914","chr7","13203184","13203497","74","5647571"
"chr6","7560498","7560656","chr11","110402020","110402179","24","102841522"
"chr6","7569989","7570159","chr1","217814415","217814581","36","210244426"
"chr6","7573267","7573413","chr4","71486007","71486161","37","63912740"
"chr6","7599911","7600201","chr11","108458033","108458317","59","100858122"
"chr6","7605781","7606048","chr9","56456050","56456320","46","48850269"
"chr6","7608530","7608702","chr19","4403380","4403554","39","3205150"
"chr6","7614036","7614337","chr1","161479667","161479958","51","153865631"
"chr6","7616838","7617006","chr14","62603712","62603871","36","54986874"
"chr6","7617514","7617590","chr2","33626076","33626151","13","26008562"
"chr6","7622262","7622338","chr2","33626076","33626151","13","26003814"
"chr6","7624580","7624697","chr3","154543697","154543812","28","146919117"
"chr6","7630166","7630440","chr7","130097722","130097988","70","122467556"
"chr6","7638853","7639006","chr8","98442947","98443094","35","90804094"
"chr6","7639310","7639465","chr11","109671602","109671756","31","102032292"
"chr6","7644505","7644804","chr14","30200281","30200571","51","22555776"
"chr6","7647657","7647943","chr20","26454084","26454365","57","18806427"
"chr6","7649103","7649410","chr4","103468600","103468909","61","95819497"
"chr6","7662186","7662357","chr7","16093772","16093938","33","8431586"
"chr6","7663416","7663545","chr4","69395839","69395963","29","61732423"
"chr6","7663847","7664015","chr10","20541227","20541391","41","12877380"
"chr6","7677111","7677418","chr10","35839501","35839806","62","28162390"
"chr6","7691384","7691433","chrX","51016106","51016154","10","43324722"
"chr6","7702370","7702658","chr19","7556141","7556429","3","146229"
"chr6","7705320","7705611","chr11","30046486","30046779","51","22341166"
"chr6","7707396","7707562","chr2","78396898","78397056","30","70689502"
"chr6","7712981","7713149","chr19","7562663","7562844","18","150318"
"chr6","7727680","7727967","chr19","7581355","7581645","11","146325"
"chr6","7741457","7741626","chr9","75744890","75745060","40","68003433"
"chr6","7741678","7741796","chrX","108130012","108130129","25","100388334"
"chr6","7753859","7754037","chr19","7609867","7610024","30","143992"
"chr6","7760461","7760719","chr19","7619733","7619988","10","140728"
"chr6","7768085","7768339","chr19","7628454","7628730","25","139631"
"chr6","7774551","7774849","chr19","7636745","7637045","8","137806"
"chr6","7777086","7777275","chr19","7639924","7640113","6","137162"
"chr6","7777575","7777702","chr19","7640724","7640849","6","136851"
"chr6","7780400","7780533","chr5","114158890","114159022","17","106378490"
"chr6","7783744","7784064","chr19","7648184","7648499","10","135560"
"chr6","7787009","7787270","chr19","7651225","7651516","42","135784"
"chr6","7787303","7787501","chr19","7651557","7651755","5","135746"
"chr6","7788837","7789152","chr9","109066590","109066880","73","101277753"
"chr6","7791333","7791493","chr1","28144895","28145057","30","20353562"
"chr6","7798623","7798755","chr19","7663827","7663960","2","134796"
"chr6","7800842","7801175","chr19","7666428","7666756","13","134414"
"chr6","7802345","7802630","chr19","7667604","7667889","7","134741"
"chr6","7814879","7815092","chr19","7681207","7681420","1","133672"
"chr6","7829322","7829388","chr4","28058444","28058500","21","20229122"
"chr6","7834056","7834336","chr19","7699787","7700067","7","134269"
"chr6","7847965","7848035","chr16","25477961","25478031","12","17629996"
"chr6","7859728","7859839","chr10","12220227","12220334","32","4360499"
"chr6","7860146","7860157","chr9","74269","74280","2","7785877"
"chr6","7860460","7860478","chr8","127849238","127849254","4","119988778"
"chr6","7863903","7864033","chr19","7730975","7731086","21","132928"
"chr6","7865481","7865597","chr19","7734152","7734268","2","131329"
"chr6","7866801","7867105","chr19","7735476","7735777","8","131325"
"chr6","7868387","7868710","chr19","7737099","7737419","5","131288"
"chr6","7880353","7880644","chr19","7747499","7747789","10","132854"
"chr6","7906628","7906907","chr19","7779344","7779629","18","127284"
"chr6","7915194","7915347","chr19","7789572","7789725","3","125622"
"chr6","7926693","7926998","chr19","7804081","7804386","8","122612"
"chr6","7946232","7946515","chr19","7824262","7824544","12","121970"
"chr6","7982288","7982590","chr19","7858716","7859031","25","123572"
"chr6","7986231","7986465","chr19","7862670","7862905","6","123561"
"chr6","7988063","7988145","chr15","28625858","28625944","24","20637795"
"chr6","7989664","7989727","chr7","52832784","52832847","18","44843120"
"chr6","8011485","8011787","chr19","7889752","7890066","18","121733"
"chr6","8014902","8015205","chr19","7895265","7895560","11","119637"
"chr6","8043080","8043368","chr19","7923342","7923628","14","119738"
"chr6","8048564","8048845","chr19","7935205","7935497","20","113359"
"chr6","8051259","8051575","chr19","7930109","7930442","30","121150"
"chr6","8057021","8057302","chr19","7940652","7940962","36","116369"
"chr6","8065951","8066240","chr19","7940652","7940962","37","125299"
"chr6","8067020","8067296","chr19","7937217","7937509","28","129803"
"chr6","8079423","8079598","chr6","101946024","101946185","45","93866601"
"chr6","8101175","8101471","chr19","7979580","7979876","5","121595"
"chr6","8102913","8103214","chr19","7981306","7981607","6","121607"
"chr6","8109271","8109577","chr19","7986629","7986937","18","122642"
"chr6","8118764","8118980","chr6","134348570","134348782","37","126229806"
"chr6","8242968","8243276","chr19","8061532","8061840","14","181436"
"chr6","8243839","8243979","chr4","30232549","30232666","44","21988710"
"chr6","8291457","8291754","chr1","10043974","10044262","58","1752517"
"chr6","8298714","8298873","chr16","39517032","39517192","28","31218318"
"chr6","8306202","8306405","chr8","69577131","69577335","36","61270929"
"chr6","8307777","8307986","chrX","64018433","64018648","43","55710656"
"chr6","8314898","8315207","chr14","18083728","18084031","59","9768830"
"chr6","8321783","8321925","chr9","29896034","29896175","31","21574251"
"chr6","8322228","8322243","chr1","18239975","18239988","4","9917747"
"chr6","8322536","8322662","chr5","51039231","51039352","26","42716695"
"chr6","8338519","8338673","chr19","8085341","8085507","14","253178"
"chr6","8344251","8344549","chr14","103931688","103931984","55","95587437"
"chr6","8378817","8378935","chrX","107219702","107219815","36","98840885"
"chr6","8380377","8380675","chr1","29362261","29362560","50","20981884"
"chr6","8395865","8395977","chr19","8138960","8139072","6","256905"
"chr6","8396463","8396756","chr19","8139558","8139852","11","256905"
"chr6","8479812","8479960","chr6","32710535","32710676","45","24230723"
"chr6","8483720","8483835","chr10","47057934","47058048","18","38574214"
"chr6","8494590","8494865","chr19","8272079","8272361","63","222511"
"chr6","8500003","8500140","chr7","45443390","45443520","52","36943387"
"chr6","8502393","8502557","chr19","8279956","8280118","6","222437"
"chr6","8505051","8505170","chr6","41255012","41255132","21","32749961"
"chr6","8507064","8507369","chr19","8284909","8285220","11","222155"
"chr6","8518818","8519105","chr19","8296330","8296608","20","222488"
"chr6","8521433","8521727","chr19","8299246","8299540","7","222187"
"chr6","8530326","8530626","chr19","8308191","8308495","10","222135"
"chr6","8531592","8531668","chr17","63855307","63855382","16","55323715"
"chr6","8536158","8536463","chr19","8318167","8318470","12","217991"
"chr6","8546835","8547104","chr19","8329523","8329797","18","217312"
"chr6","8561803","8562055","chr11","122019072","122019331","69","113457269"
"chr6","8577488","8577612","chr10","28014358","28014487","23","19436870"
"chr6","8579137","8579190","chr6","106717550","106717603","9","98138413"
"chr6","8584343","8584635","chr19","8373567","8373846","22","210776"
"chr6","8612671","8612859","chr19","8405755","8405942","6","206916"
"chr6","8629844","8630133","chr19","8424205","8424484","14","205639"
"chr6","8646821","8646960","chr19","8441081","8441225","9","205740"
"chr6","8646961","8647258","chr19","8441226","8441526","14","205735"
"chr6","8648641","8648800","chr19","8442932","8443080","14","205709"
"chr6","8657881","8658143","chr19","8455018","8455280","10","202863"
"chr6","8666624","8666867","chr19","8462124","8462391","31","204500"
"chr6","8668327","8668491","chr19","8468122","8468310","27","200205"
"chr6","8668816","8668953","chr5","75126902","75127037","26","66458086"
"chr6","8669892","8670040","chr9","20377689","20377836","30","11707797"
"chr6","8672858","8672929","chr3","165938836","165938901","19","157265978"
"chr6","8672931","8673048","chr16","41022957","41023066","27","32350026"
"chr6","8673087","8673194","chr19","8466002","8466113","7","207085"
"chr6","8675678","8675834","chr11","122996862","122997012","30","114321184"
"chr6","8675835","8676050","chr3","34731746","34731971","68","26055911"
"chr6","8691965","8692251","chr13","8121064","8121348","45","570901"
"chr6","8699915","8700053","chr19","8498785","8498922","6","201130"
"chr6","8700347","8700512","chr19","8499217","8499392","17","201130"
"chr6","8701987","8702302","chr19","8501539","8501856","21","200448"
"chr6","8710798","8710911","chr19","8510591","8510703","5","200207"
"chr6","8711411","8711460","chr19","8511202","8511252","3","200209"
"chr6","8712039","8712178","chr10","86917888","86918032","30","78205849"
"chr6","8712206","8712326","chr19","8512240","8512358","2","199966"
"chr6","8727929","8728091","chr19","8529867","8530032","9","198062"
"chr6","8732001","8732265","chr19","8533945","8534203","17","198056"
"chr6","8733125","8733320","chr19","8535062","8535221","47","198063"
"chr6","8743747","8743825","chr19","8542396","8542478","8","201351"
"chr6","8758727","8758952","chr19","8558220","8558431","21","200507"
"chr6","8772317","8772396","chr6","8905671","8905741","26","133354"
"chr6","8775246","8775387","chr19","8577849","8577990","7","197397"
"chr6","8793272","8793402","chr16","45399017","45399156","34","36605745"
"chr6","8806676","8806820","chr19","8615079","8615223","5","191597"
"chr6","8807190","8807410","chr19","8615730","8615986","40","191460"
"chr6","8827489","8827755","chr19","8643563","8643828","5","183926"
"chr6","8830990","8831270","chr2","147144669","147144952","58","138313679"
"chr6","8833127","8833257","chr1","38048675","38048797","38","29215548"
"chr6","8835737","8835902","chr6","133093690","133093831","27","124257953"
"chr6","8836162","8836173","chr7","161464701","161464713","4","152628539"
"chr6","8837476","8837621","chr19","8654554","8654690","12","182922"
"chr6","8839943","8840158","chrX","44838785","44839000","59","35998842"
"chr6","8845402","8845462","chr3","10761706","10761770","10","1916304"
"chr6","8845463","8845505","chr1","18855109","18855152","4","10009646"
"chr6","8851448","8851567","chr19","8678928","8679046","3","172520"
"chr6","8851615","8851796","chr19","8679078","8679249","14","172537"
"chr6","8860120","8860262","chr16","36038941","36039074","30","27178821"
"chr6","8870887","8871180","chr19","8701152","8701469","44","169735"
"chr6","8873687","8873748","chr3","40058589","40058650","12","31184902"
"chr6","8873809","8874059","chr10","29702122","29702340","78","20828313"
"chr6","8887397","8887554","chr19","42217504","42217645","38","33330107"
"chr6","8892033","8892304","chr19","8727371","8727642","9","164662"
"chr6","8892484","8892792","chr19","8727822","8728119","18","164662"
"chr6","8904088","8904439","chr19","8731861","8732215","17","172227"
"chr6","8909646","8909778","chr10","2130477","2130608","27","6779169"
"chr6","8910286","8910572","chr19","8740387","8740673","10","169899"
"chr6","8913212","8913348","chr16","49484330","49484464","19","40571118"
"chr6","8919251","8919431","chr19","8757163","8757321","25","162088"
"chr6","8919729","8919746","chr2","101297692","101297708","7","92377963"
"chr6","8922620","8922760","chr10","28014822","28014963","34","19092202"
"chr6","8924017","8924031","chr1","166255009","166255020","3","157330992"
"chr6","8925916","8926219","chr19","8763369","8763673","12","162547"
"chr6","8926831","8927049","chr2","87659256","87659475","44","78732425"
"chr6","8945382","8945676","chr19","8779451","8779746","11","165931"
"chr6","8953688","8953990","chr19","8791680","8791971","20","162008"
"chr6","8959160","8959332","chr19","8796949","8797125","11","162211"
"chr6","8960965","8961273","chr19","8798758","8799055","19","162207"
"chr6","8961869","8962156","chr19","8800002","8800289","8","161867"
"chr6","8964222","8964488","chr19","8802321","8802610","40","161901"
"chr6","8966473","8966759","chr14","62603032","62603323","63","53636559"
"chr6","8967475","8967605","chr19","8805933","8806063","5","161542"
"chr6","8968308","8968418","chr19","8806765","8806875","3","161543"
"chr6","8969022","8969108","chr19","8807477","8807563","2","161545"
"chr6","8970909","8971215","chr6","42260255","42260550","50","33289346"
"chr6","8976916","8977150","chr19","8815025","8815259","11","161891"
"chr6","8987593","8987710","chrX","112241983","112242097","25","103254390"
"chr6","9008403","9008704","chr19","8851490","8851791","9","156913"
"chr6","9010019","9010317","chr19","8854810","8855109","7","155209"
"chr6","9010502","9010775","chr19","8855297","8855567","8","155205"
"chr6","9023237","9023544","chr19","8869206","8869494","24","154031"
"chr6","9025834","9025853","chr9","91417087","91417104","4","82391253"
"chr6","9026155","9026462","chr19","8876837","8877140","7","149318"
"chr6","9026463","9026577","chr19","8877141","8877251","9","149322"
"chr6","9036871","9036953","chr19","8894860","8894944","3","142011"
"chr6","9037186","9037450","chr7","77448762","77449023","53","68411576"
"chr6","9037486","9037814","chr11","6844540","6844871","80","2192946"
"chr6","9039096","9039401","chr19","8871932","8872237","13","167164"
"chr6","9040268","9040569","chr19","8873104","8873405","11","167164"
"chr6","9040891","9041088","chr20","56357065","56357266","48","47316174"
"chr6","9106316","9106473","chrX","121442692","121442847","38","112336376"
"chr6","9117603","9117738","chr1","14816698","14816833","38","5699095"
"chr6","9118647","9118825","chr19","8969413","8969587","11","149234"
"chr6","9139198","9139508","chr15","25793315","25793627","69","16654117"
"chr6","9139879","9140190","chr19","8993132","8993443","6","146747"
"chr6","9157089","9157401","chr19","9010380","9010690","14","146709"
"chr6","9159945","9160068","chr19","9018644","9018767","2","141301"
"chr6","9160368","9160562","chr19","9019069","9019263","4","141299"
"chr6","9170228","9170361","chr19","9029242","9029375","0","140986"
"chr6","9175659","9175973","chr19","9034678","9034971","32","140981"
"chr6","9180658","9180672","chr19","9040275","9040289","1","140383"
"chr6","9180926","9181062","chr19","9040540","9040676","4","140386"
"chr6","9189399","9189548","chr15","40360535","40360676","36","31171136"
"chr6","9189587","9189608","chr20","36818556","36818575","3","27628969"
"chr6","9195677","9195860","chr20","71292867","71293030","46","62097190"
"chr6","9196191","9196321","chr19","9063139","9063269","7","133052"
"chr6","9196607","9196768","chr19","9063555","9063709","7","133052"
"chr6","9202987","9203009","chr3","13254676","13254699","5","4051689"
"chr6","9203055","9203201","chr19","9069765","9069908","6","133290"
"chr6","9231648","9231947","chr10","74537497","74537770","66","65305849"
"chr6","9238998","9239224","chr19","9107642","9107862","10","131356"
"chr6","9245784","9245922","chr19","9114679","9114817","3","131105"
"chr6","9246925","9246936","chr3","45466039","45466051","4","36219114"
"chr6","9247226","9247379","chr19","9118102","9118257","11","129124"
"chr6","9258014","9258025","chr1","13821976","13821987","1","4563962"
"chr6","9258348","9258655","chr19","9135138","9135445","7","123210"
"chr6","9258656","9258870","chr1","30228392","30228598","44","20969736"
"chr6","9262053","9262368","chr20","25253165","25253473","54","15991112"
"chr6","9264198","9264506","chr19","9129520","9129803","37","134678"
"chr6","9272342","9272519","chr18","18487579","18487750","40","9215237"
"chr6","9272521","9272563","chr6","74911936","74911976","8","65639415"
"chr6","9274824","9274964","chr2","147125635","147125759","33","137850811"
"chr6","9274965","9275286","chr19","9147572","9147908","20","127393"
"chr6","9275408","9275706","chr19","9148030","9148339","12","127378"
"chr6","9277110","9277396","chr19","9155100","9155401","24","122010"
"chr6","9278549","9278639","chr8","15987521","15987606","15","6708972"
"chr6","9278659","9278944","chr19","9155421","9155706","6","123238"
"chr6","9293063","9293197","chr19","9170278","9170412","2","122785"
"chr6","9294807","9295102","chr19","9172416","9172714","11","122391"
"chr6","9303771","9303907","chr19","9189883","9190019","8","113888"
"chr6","9304199","9304381","chr19","9190310","9190492","9","113889"
"chr6","9313023","9313285","chr19","9202115","9202386","17","110908"
"chr6","9314660","9314950","chr19","9204088","9204380","9","110572"
"chr6","9323014","9323057","chr5","75142717","75142755","11","65819703"
"chr6","9329063","9329360","chr16","21320831","21321123","58","11991768"
"chr6","9339673","9339981","chr19","9230521","9230829","6","109152"
"chr6","9352347","9352631","chr13","9734300","9734583","45","381953"
"chr6","9353178","9353389","chr4","42686105","42686316","40","33332927"
"chr6","9374534","9374827","chr19","9270408","9270704","6","104126"
"chr6","9389365","9389523","chr19","9286789","9286947","1","102576"
"chr6","9391366","9391668","chr19","9289084","9289386","11","102282"
"chr6","9395809","9396028","chr19","9292875","9293094","8","102934"
"chr6","9396700","9396818","chr13","88847812","88847931","31","79451112"
"chr6","9397130","9397281","chr9","49985840","49985993","33","40588710"
"chr6","9399527","9399828","chr19","9297628","9297929","8","101899"
"chr6","9405417","9405676","chr19","9303448","9303707","10","101969"
"chr6","9428614","9428791","chr19","9342302","9342479","2","86312"
"chr6","9432330","9432599","chr19","9346030","9346299","4","86300"
"chr6","9432973","9433153","chr19","9346667","9346847","8","86306"
"chr6","9436298","9436612","chr19","9349849","9350158","16","86449"
"chr6","9442991","9443028","chr7","39634194","39634228","11","30191203"
"chr6","9443712","9443877","chr1","152928618","152928784","34","143484906"
"chr6","9463082","9463228","chr19","9378636","9378781","2","84446"
"chr6","9463508","9463611","chr4","4771987","4772093","21","4691521"
"chr6","9472926","9473220","chr19","9386603","9386894","21","86323"
"chr6","9474968","9475117","chr19","9394120","9394261","13","80848"
"chr6","9475428","9475582","chr19","9394567","9394721","2","80861"
"chr6","9484465","9484778","chr1","127843206","127843513","72","118358741"
"chr6","9497992","9498300","chrX","15697361","15697669","50","6199369"
"chr6","9505509","9505688","chr19","9422454","9422635","7","83055"
"chr6","9526834","9526990","chr9","69623029","69623188","46","60096195"
"chr6","9527034","9527139","chr9","6125225","6125328","15","3401809"
"chr6","9530828","9531159","chr19","9450796","9451124","24","80032"
"chr6","9533100","9533420","chr19","9453413","9453717","22","79687"
"chr6","9539931","9540204","chr19","9460406","9460680","4","79525"
"chr6","9540561","9540863","chr19","9461037","9461337","7","79524"
"chr6","9542676","9542783","chr5","135158660","135158762","21","125615984"
"chr6","9542841","9542906","chr3","151051767","151051825","20","141508926"
"chr6","9544684","9544839","chr19","9465137","9465292","4","79547"
"chr6","9545733","9546033","chr19","9466233","9466519","21","79500"
"chr6","9552509","9552650","chr19","9481426","9481568","4","71083"
"chr6","9553079","9553280","chr19","9481998","9482196","5","71081"
"chr6","9553581","9553687","chr19","9482742","9482849","2","70839"
"chr6","9562352","9562618","chr19","9492483","9492751","11","69869"
"chr6","9567970","9568210","chr19","9497854","9498094","3","70116"
"chr6","9568599","9568884","chr14","6145160","6145440","65","3423439"
"chr6","9577550","9577715","chr1","66887413","66887590","42","57309863"
"chr6","9583023","9583237","chr19","9512009","9512216","12","71014"
"chr6","9585694","9585871","chr1","12749579","12749753","41","3163885"
"chr6","9587360","9587691","chr19","9520009","9520294","51","67351"
"chr6","9594527","9594612","chr1","64423569","64423653","15","54829042"
"chr6","9596494","9596800","chrX","121188280","121188585","61","111591786"
"chr6","9599163","9599240","chr8","5663671","5663745","16","3935492"
"chr6","9601995","9602047","chrX","46137496","46137548","6","36535501"
"chr6","9602048","9602110","chr20","10976550","10976613","10","1374502"
"chr6","9603469","9603522","chr19","9544665","9544718","0","58804"
"chr6","9614647","9614933","chr19","9555891","9556176","3","58756"
"chr6","9619714","9620011","chr9","106530616","106530926","75","96910902"
"chr6","9621558","9621849","chr19","9562822","9563115","16","58736"
"chr6","9622423","9622642","chr19","9563669","9563884","9","58754"
"chr6","9624150","9624308","chr11","93931965","93932124","31","84307815"
"chr6","9624618","9624758","chr10","31972968","31973110","27","22348350"
"chr6","9639380","9639538","chrX","121442692","121442847","28","111803312"
"chr6","9639556","9639735","chr4","123511019","123511203","31","113871463"
"chr6","9639890","9640184","chr2","50050161","50050451","59","40410271"
"chr6","9643649","9643842","chr19","9596313","9596506","7","47336"
"chr6","9651041","9651208","chr3","2024698","2024867","33","7626343"
"chr6","9651872","9652152","chr19","9601716","9601996","4","50156"
"chr6","9658727","9658815","chr6","133320309","133320399","18","123661582"
"chr6","9666707","9666856","chr10","65746323","65746471","29","56079616"
"chr6","9683655","9683925","chr19","9634020","9634291","5","49635"
"chr6","9698758","9699056","chr19","9648933","9649225","12","49825"
"chr6","9700829","9701001","chr1","89498730","89498918","50","79797901"
"chr6","9702743","9703052","chr19","9653849","9654158","5","48894"
"chr6","9710685","9710773","chr19","9667689","9667782","7","42996"
"chr6","9711392","9711585","chr19","9668754","9668905","44","42638"
"chr6","9728558","9728880","chr9","86326036","86326346","67","76597478"
"chr6","9731256","9731580","chr19","9683635","9683942","74","47621"
"chr6","9735633","9735942","chr19","9689041","9689350","7","46592"
"chr6","9736422","9736533","chr19","9689773","9689884","3","46649"
"chr6","9736726","9736808","chr10","51607274","51607352","24","41870548"
"chr6","9743517","9743784","chr19","9697680","9697947","9","45837"
"chr6","9747648","9747753","chr14","108999830","108999934","21","99252182"
"chr6","9750682","9750765","chr19","9704340","9704423","0","46342"
"chr6","9751062","9751218","chr19","9704717","9704873","5","46345"
"chr6","9753585","9753668","chr19","9706929","9707012","2","46656"
"chr6","9775507","9775802","chr19","9729227","9729525","8","46280"
"chr6","9780726","9781028","chr19","9734445","9734747","4","46281"
"chr6","9784218","9784506","chr19","9738266","9738574","34","45952"
"chr6","9805848","9806140","chr19","9757340","9757632","17","48508"
"chr6","9806781","9807046","chr19","9758280","9758542","18","48501"
"chr6","9824577","9824879","chr19","9775327","9775631","14","49250"
"chr6","9825860","9825975","chr19","9776607","9776722","1","49253"
"chr6","9837534","9837825","chr19","9787769","9788059","7","49765"
"chr6","9841324","9841589","chr19","9791819","9792110","28","49505"
"chr6","9844095","9844389","chr19","9803404","9803694","8","40691"
"chr6","9844895","9845035","chr19","9804157","9804298","5","40738"
"chr6","9845339","9845358","chr19","9804602","9804620","2","40737"
"chr6","9861790","9861945","chr3","35144163","35144321","28","25282373"
"chr6","9869108","9869412","chr16","65324390","65324695","62","55455282"
"chr6","9875652","9875943","chr11","50254076","50254361","62","40378424"
"chr6","9881539","9881822","chr7","75473714","75473991","64","65592175"
"chr6","9885107","9885232","chr4","65813127","65813256","33","55928020"
"chr6","9888443","9888757","chr19","9844678","9844993","10","43765"
"chr6","9893010","9893219","chr19","9849999","9850208","3","43011"
"chr6","9898383","9898685","chr19","9854091","9854389","11","44292"
"chr6","9899538","9899825","chr19","9855225","9855498","64","44313"
"chr6","9903668","9903839","chr19","9862004","9862175","5","41664"
"chr6","9911184","9911483","chr19","9870720","9871020","8","40464"
"chr6","9922888","9923197","chr16","40018289","40018562","87","30095401"
"chr6","9924474","9924770","chr19","9883798","9884094","6","40676"
"chr6","9928929","9929217","chr19","9886795","9887083","12","42134"
"chr6","9929266","9929503","chr19","9887131","9887362","21","42135"
"chr6","9930675","9930889","chr19","9888459","9888668","11","42216"
"chr6","9933281","9933316","chr14","17270498","17270540","11","7337217"
"chr6","9945268","9945578","chr19","9915063","9915372","11","30205"
"chr6","9945995","9946121","chr19","9915796","9915922","4","30199"
"chr6","9948807","9949090","chr19","9918957","9919240","8","29850"
"chr6","9974272","9974392","chr19","9943596","9943716","2","30676"
"chr6","9975013","9975146","chr11","109839605","109839739","22","99864592"
"chr6","9980855","9981013","chr19","9950034","9950186","8","30821"
"chr6","9981861","9981982","chr19","9951554","9951669","6","30307"
"chr6","9983027","9983339","chr19","9952386","9952694","7","30641"
"chr6","9984379","9984628","chr19","9953731","9953980","7","30648"
"chr6","9985171","9985287","chr19","9954523","9954639","3","30648"
"chr6","9995671","9995788","chr16","50725703","50725815","25","40730032"
"chr6","10028842","10029130","chr16","73736952","73737242","54","63708110"
"chr6","10034021","10034299","chr19","10005554","10005831","5","28467"
"chr6","10043197","10043360","chr19","10014739","10014903","2","28458"
"chr6","10045737","10045999","chr19","10017286","10017547","10","28451"
"chr6","10046001","10046174","chr19","5226471","5226635","43","4819530"
"chr6","10046659","10046975","chr19","10018211","10018526","17","28448"
"chr6","10050038","10050172","chr13","44660166","44660296","23","34610128"
"chr6","10051165","10051484","chr14","76162875","76163180","74","66111710"
"chr6","10051535","10051834","chr19","10023133","10023432","5","28402"
"chr6","10068085","10068397","chr19","10049256","10049568","14","18829"
"chr6","10069287","10069550","chr19","10047733","10047996","4","21554"
"chr6","10081683","10081786","chr19","10064754","10064857","3","16929"
"chr6","10081819","10081995","chr19","10064891","10065066","5","16928"
"chr6","10092903","10093179","chr19","10076658","10076936","13","16245"
"chr6","10102880","10103102","chr19","10124384","10124606","6","21504"
"chr6","10119979","10120107","chr20","39102418","39102549","17","28982439"
"chr6","10120934","10121208","chr11","122354616","122354898","62","112233682"
"chr6","10123803","10123921","chr15","78900845","78900955","40","68777042"
"chr6","10142099","10142406","chr3","42988227","42988525","58","32846128"
"chr6","10142556","10142858","chr19","10166135","10166438","6","23579"
"chr6","10146707","10146859","chr14","63998309","63998458","29","53851602"
"chr6","10147622","10147901","chrX","50118130","50118426","56","39970508"
"chr6","10149574","10149799","chr19","10174344","10174569","5","24770"
"chr6","10186258","10186353","chr10","631506","631600","16","9554752"
"chr6","10186518","10186652","chr18","66738454","66738584","23","56551936"
"chr6","10187982","10188274","chr19","10215900","10216191","7","27918"
"chr6","10189661","10189963","chr19","10217588","10217873","20","27927"
"chr6","10192663","10192949","chr19","10220672","10220958","13","28009"
"chr6","10212794","10212916","chr19","10240346","10240473","8","27552"
"chr6","10213215","10213384","chr19","10240778","10240946","12","27563"
"chr6","10214392","10214511","chr8","76075784","76075903","25","65861392"
"chr6","10215364","10215524","chr19","10242932","10243092","6","27568"
"chr6","10215535","10215840","chr19","10243102","10243408","23","27567"
"chr6","10218535","10218667","chr19","10252740","10252874","10","34205"
"chr6","10236916","10237224","chr19","10263466","10263775","12","26550"
"chr6","10238783","10239088","chr10","50389396","50389695","61","40150613"
"chr6","10239388","10239670","chr19","10266260","10266541","9","26872"
"chr6","10255110","10255275","chr19","10281734","10281894","11","26624"
"chr6","10255366","10255642","chr19","10281980","10282266","25","26614"
"chr6","10266057","10266338","chr19","10285817","10286096","16","19760"
"chr6","10273730","10274017","chr3","160642299","160642590","64","150368569"
"chr6","10274561","10274624","chr1","29648118","29648178","16","19373557"
"chr6","10274848","10274963","chr1","85858415","85858535","28","75583567"
"chr6","10286834","10287170","chr19","10306530","10306863","12","19696"
"chr6","10288303","10288596","chr19","10308350","10308643","6","20047"
"chr6","10312467","10312607","chr19","10332796","10332937","3","20329"
"chr6","10324099","10324139","chr1","35268455","35268498","12","24944356"
"chr6","10324447","10324617","chr19","2116270","2116438","35","8208177"
"chr6","10325481","10325641","chr19","10347067","10347227","3","21586"
"chr6","10325923","10325990","chr19","10347541","10347608","1","21618"
"chr6","10331881","10332170","chr19","10352907","10353202","19","21026"
"chr6","10333789","10334094","chr19","10354819","10355123","8","21030"
"chr6","10336987","10337292","chr19","10356876","10357186","16","19889"
"chr6","10344380","10344660","chr20","63270112","63270392","57","52925732"
"chr6","10348441","10348748","chr8","116506898","116507200","69","106158457"
"chr6","10364291","10364416","chr11","4764033","4764157","17","5600258"
"chr6","10364710","10364823","chr7","117138063","117138173","32","106773353"
"chr6","10365319","10365467","chr19","14673246","14673394","36","4307927"
"chr6","10383287","10383467","chr19","10418197","10418377","8","34910"
"chr6","10385255","10385414","chr19","10415678","10415839","6","30423"
"chr6","10389106","10389412","chr19","10420569","10420877","22","31463"
"chr6","10393067","10393357","chr19","10423990","10424280","5","30923"
"chr6","10394195","10394489","chr19","10425123","10425422","16","30928"
"chr6","10395036","10395334","chr19","10425969","10426267","10","30933"
"chr6","10423620","10423925","chr19","10455134","10455438","14","31514"
"chr6","10425165","10425463","chr19","10456667","10456968","24","31502"
"chr6","10428071","10428351","chr19","10459575","10459867","24","31504"
"chr6","10435252","10435539","chr8","10801709","10801991","48","366457"
"chr6","10435841","10436247","chr11","25310374","25310739","115","14874533"
"chr6","10442361","10442652","chr19","10471457","10471745","12","29096"
"chr6","10446763","10447046","chr19","10479392","10479675","0","32629"
"chr6","10454839","10455150","chr9","67667961","67668270","54","57213122"
"chr6","10465873","10466200","chr19","10506133","10506460","4","40260"
"chr6","10477201","10477344","chr19","10518895","10519038","3","41694"
"chr6","10483785","10484089","chr9","105109553","105109859","52","94625768"
"chr6","10484414","10484525","chr1","198465701","198465806","31","187981287"
"chr6","10484821","10485037","chr7","91116341","91116557","13","80631520"
"chr6","10486128","10486288","chr19","10528801","10528969","27","42673"
"chr6","10486581","10486723","chr19","10529280","10529416","14","42699"
"chr6","10489350","10489483","chr19","10539012","10539149","5","49662"
"chr6","10489736","10489929","chr19","10539397","10539597","15","49661"
"chr6","10498105","10498472","chr9","12531314","12531682","89","2033209"
"chr6","10501421","10501713","chr19","10546244","10546541","10","44823"
"chr6","10504099","10504113","chr1","34301008","34301023","4","23796909"
"chr6","10506621","10506944","chr3","33322699","33323037","87","22816078"
"chr6","10513774","10514065","chr5","148303287","148303589","62","137789513"
"chr6","10514289","10514554","chr1","55177330","55177590","47","44663041"
"chr6","10518885","10519008","chr18","13251705","13251824","32","2732820"
"chr6","10519059","10519359","chr9","55764860","55765163","55","45245801"
"chr6","10522002","10522295","chr19","10568586","10568884","14","46584"
"chr6","10523268","10523400","chrX","9915889","9916020","19","607379"
"chr6","10523691","10523831","chr15","22824677","22824809","28","12300986"
"chr6","10524730","10524859","chr19","10571980","10572106","6","47250"
"chr6","10541314","10541593","chr19","10591127","10591399","13","49813"
"chr6","10571910","10571969","chr18","17236993","17237056","10","6665083"
"chr6","10585987","10586289","chr5","50326113","50326424","52","39740126"
"chr6","10588324","10588605","chr19","10648639","10648911","13","60315"
"chr6","10591264","10591561","chr19","10642063","10642341","29","50799"
"chr6","10593123","10593427","chr19","10650794","10651076","25","57671"
"chr6","10600906","10601189","chr4","155177047","155177330","53","144576141"
"chr6","10602492","10602807","chr4","152226280","152226592","53","141623788"
"chr6","10605596","10605907","chr19","10664262","10664576","12","58666"
"chr6","10610972","10611167","chr19","10669944","10670145","12","58972"
"chr6","10622558","10622862","chr19","10681025","10681317","17","58467"
"chr6","10631550","10631840","chr19","10686838","10687150","35","55288"
"chr6","10638684","10638978","chr19","10694561","10694847","16","55877"
"chr6","10639231","10639533","chr19","10695430","10695732","2","56199"
"chr6","10670266","10670421","chr1","11405759","11405892","41","735493"
"chr6","10675128","10675426","chr19","10730520","10730813","15","55392"
"chr6","10678594","10678727","chr19","10737862","10737996","4","59268"
"chr6","10701290","10701512","chr15","23738007","23738223","65","13036717"
"chr6","10723593","10723867","chr19","10782211","10782485","5","58618"
"chr6","10733458","10733544","chr1","157829766","157829843","24","147096308"
"chr6","10757891","10758076","chr7","33121501","33121685","45","22363610"
"chr6","10758724","10759023","chr11","107623443","107623751","76","96864719"
"chr6","10817111","10817407","chr19","10884728","10885024","9","67617"
"chr6","10856206","10856402","chr19","10924290","10924498","15","68084"
"chr6","10867261","10867413","chr19","10934835","10934987","1","67574"
"chr6","10879552","10879603","chr14","32319368","32319418","5","21439816"
"chr6","10882715","10882997","chr19","10952687","10952968","8","69972"
"chr6","10886567","10886666","chr19","10962151","10962250","4","75584"
"chr6","10886990","10887280","chr19","10962575","10962876","31","75585"
"chr6","10922041","10922346","chr19","11001925","11002230","9","79884"
"chr6","10932351","10932633","chr19","11012232","11012513","6","79881"
"chr6","10964727","10964998","chr19","11043594","11043878","30","78867"
"chr6","10970965","10971262","chr19","11050120","11050386","41","79155"
"chr6","10973398","10973585","chr7","58729599","58729780","38","47756201"
"chr6","10991058","10991368","chr19","11072767","11073064","28","81709"
"chr6","11004853","11005138","chr19","11089644","11089937","11","84791"
"chr6","11028053","11028198","chr16","607734","607880","29","10420319"
"chr6","11029163","11029415","chr19","11114749","11114995","17","85586"
"chr6","11047642","11047754","chr2","173707376","173707489","25","162659734"
"chr6","11056196","11056498","chr19","11139557","11139863","8","83361"
"chr6","11070141","11070411","chr19","11155113","11155383","3","84972"
"chr6","11075321","11075609","chr19","11160321","11160609","2","85000"
"chr6","11075749","11076039","chr19","11160749","11161012","33","85000"
"chr6","11079336","11079636","chr19","11164313","11164608","12","84977"
"chr6","11085220","11085398","chr15","55549666","55549835","38","44464446"
"chr6","11105212","11105525","chr19","11189496","11189806","11","84284"
"chr6","11108159","11108277","chr1","140327079","140327198","18","129218920"
"chr6","11111308","11111517","chr19","11191946","11192157","7","80638"
"chr6","11111853","11112140","chr19","11192497","11192792","24","80644"
"chr6","11117120","11117359","chr19","11204156","11204396","9","87036"
"chr6","11117510","11117591","chr19","11204547","11204628","0","87037"
"chr6","11122194","11122503","chr19","11208904","11209214","6","86710"
"chr6","11126327","11126616","chr19","11215829","11216112","27","89502"
"chr6","11126970","11127250","chr4","154168512","154168802","52","143041542"
"chr6","11129324","11129481","chr19","11219098","11219279","25","89774"
"chr6","11129856","11130136","chr19","11219643","11219923","5","89787"
"chr6","11133176","11133476","chr19","11222842","11223142","5","89666"
"chr6","11139681","11139745","chr1","30644596","30644660","12","19504915"
"chr6","11142337","11142642","chr19","11229793","11230083","33","87456"
"chr6","11171128","11171414","chr19","11258142","11258453","53","87014"
"chr6","11211764","11212046","chr19","11303034","11303322","15","91270"
"chr6","11219749","11220045","chr16","41671981","41672272","49","30452232"
"chr6","11234531","11234813","chr3","40342184","40342467","63","29107653"
"chr6","11301340","11301667","chr2","172761695","172762025","71","161460355"
"chr6","11302488","11302793","chr2","44882107","44882408","52","33579619"
"chr6","11303679","11303974","chr19","11379957","11380260","22","76278"
"chr6","11305858","11306009","chr19","11383477","11383629","3","77619"
"chr6","11318113","11318364","chr19","11391537","11391787","13","73424"
"chr6","11319951","11320091","chr7","132272614","132272762","39","120952663"
"chr6","11320548","11320803","chr19","11396675","11396930","14","76127"
"chr6","11322291","11322563","chr19","11402570","11402843","4","80279"
"chr6","11328217","11328507","chr19","11397909","11398199","10","69692"
"chr6","11342487","11342781","chr19","11420627","11420926","15","78140"
"chr6","11342784","11342994","chr5","135865920","135866138","64","124523136"
"chr6","11350178","11350301","chr19","11428330","11428456","5","78152"
"chr6","11373657","11373805","chr1","134818310","134818457","33","123444653"
"chr6","11380152","11380311","chr19","11459509","11459667","19","79357"
"chr6","11380313","11380601","chr19","11459668","11459951","13","79355"
"chr6","11384902","11385057","chr1","135158414","135158570","40","123773512"
"chr6","11385339","11385566","chr19","11465900","11466127","2","80561"
"chr6","11422249","11422545","chr19","11502773","11503069","3","80524"
"chr6","11424674","11424999","chr19","11505225","11505543","27","80551"
"chr6","11455974","11456097","chr19","11537794","11537920","7","81820"
"chr6","11457833","11457843","chr19","11539949","11539959","0","82116"
"chr6","11458185","11458321","chr19","11540301","11540439","2","82116"
"chr6","11465075","11465193","chr19","11547091","11547211","7","82016"
"chr6","11465477","11465654","chr12","51838064","51838237","10","40372587"
"chr6","11465993","11466296","chr19","11548016","11548319","6","82023"
"chr6","11468316","11468465","chr2","100069015","100069158","43","88600699"
"chr6","11486394","11486552","chr19","11568381","11568541","3","81987"
"chr6","11491129","11491417","chr19","11573067","11573373","28","81938"
"chr6","11492013","11492315","chr7","45269231","45269537","60","33777218"
"chr6","11499538","11499835","chr19","11580992","11581289","7","81454"
"chr6","11503049","11503171","chr13","25952629","25952746","42","14449580"
"chr6","11527575","11527859","chr19","11615916","11616241","45","88341"
"chr6","11528535","11528629","chr1","109807044","109807144","26","98278509"
"chr6","11533200","11533414","chrX","38471702","38471908","52","26938502"
"chr6","11538708","11538985","chr19","11628993","11629265","7","90285"
"chr6","11544706","11544801","chr19","11636275","11636370","1","91569"
"chr6","11545110","11545304","chr19","11636670","11636866","10","91560"
"chr6","11546786","11546904","chr14","15683668","15683791","23","4136882"
"chr6","11558411","11558688","chr19","11649215","11649489","7","90804"
"chr6","11559226","11559360","chr16","20631316","20631450","30","9072090"
"chr6","11561588","11561834","chr19","11654676","11654922","3","93088"
"chr6","11565965","11566178","chr19","11659386","11659601","5","93421"
"chr6","11568508","11568785","chr19","11649215","11649489","7","80707"
"chr6","11578355","11578639","chr4","10521860","10522142","62","1056495"
"chr6","11596946","11597103","chr19","11690563","11690720","6","93617"
"chr6","11597379","11597447","chr7","46204185","46204229","27","34606806"
"chr6","11597723","11597856","chr11","46246889","46247023","12","34649166"
"chr6","11598170","11598331","chr19","11691654","11691815","6","93484"
"chr6","11601512","11601662","chr19","11695307","11695457","2","93795"
"chr6","11614148","11614454","chr19","11707463","11707766","8","93315"
"chr6","11615580","11615774","chr19","11708896","11709079","11","93316"
"chr6","11615993","11616116","chr19","11709311","11709442","12","93318"
"chr6","11641909","11642106","chr19","11735194","11735391","11","93285"
"chr6","11647722","11647800","chr11","114385185","114385262","13","102737463"
"chr6","11676520","11676780","chr19","11773899","11774160","5","97379"
"chr6","11763156","11763437","chr19","11861025","11861305","12","97869"
"chr6","11785406","11785699","chr19","11883263","11883566","15","97857"
"chr6","11817810","11818119","chr19","11915747","11916053","13","97937"
"chr6","11826033","11826192","chr19","11924022","11924181","5","97989"
"chr6","11862576","11862723","chr20","22206450","22206577","43","10343874"
"chr6","11863020","11863169","chr2","172564454","172564591","29","160701434"
"chr6","11868885","11869081","chr19","11969874","11970091","25","100989"
"chr6","11869394","11869502","chr19","11970402","11970511","4","101008"
"chr6","11877977","11878277","chr19","11981681","11981981","5","103704"
"chr6","11879254","11879415","chr2","86795301","86795463","32","74916047"
"chr6","11879727","11879776","chr14","32319368","32319418","3","20439641"
"chr6","11893155","11893248","chr20","2811901","2811994","21","9081254"
"chr6","11897048","11897266","chr7","126973137","126973355","34","115076089"
"chr6","11903104","11903264","chr19","12011595","12011766","23","108491"
"chr6","11908173","11908373","chr6","70760693","70760890","41","58852520"
"chr6","11935427","11935741","chr19","12054270","12054584","37","118843"
"chr6","11943646","11943927","chr2","81902537","81902820","65","69958891"
"chr6","11965755","11966056","chr19","12081342","12081649","21","115587"
"chr6","11969210","11969509","chr19","12085204","12085510","11","115994"
"chr6","11974601","11974897","chr19","12090394","12090697","18","115793"
"chr6","12002862","12002926","chr19","12119223","12119287","4","116361"
"chr6","12006574","12006673","chr19","12123499","12123598","2","116925"
"chr6","12008426","12008703","chr19","12125369","12125648","7","116943"
"chr6","12025014","12025317","chr19","12140352","12140661","13","115338"
"chr6","12030753","12031047","chr19","12146790","12147083","58","116037"
"chr6","12035847","12035970","chr4","33514863","33514986","15","21479016"
"chr6","12043944","12044101","chr19","12160195","12160352","2","116251"
"chr6","12045982","12046260","chr19","12162251","12162528","10","116269"
"chr6","12046290","12046444","chr19","12162558","12162715","9","116268"
"chr6","12048291","12048592","chr19","12164522","12164839","22","116231"
"chr6","12058258","12058573","chr19","12174678","12174977","23","116420"
"chr6","12069590","12069875","chr6","75447221","75447507","52","63377631"
"chr6","12078101","12078246","chr6","50544347","50544475","36","38466246"
"chr6","12079718","12080022","chr19","12192727","12193038","18","113009"
"chr6","12083481","12083562","chr19","12196629","12196711","3","113148"
"chr6","12083935","12084132","chr19","12197084","12197281","7","113149"
"chr6","12085304","12085617","chr19","12198444","12198760","6","113140"
"chr6","12085883","12086186","chr19","12199026","12199328","6","113143"
"chr6","12088467","12088774","chr19","12201621","12201942","27","113154"
"chr6","12097963","12098268","chr19","12211404","12211713","18","113441"
"chr6","12107999","12108175","chr19","12221719","12221895","8","113720"
"chr6","12109914","12110192","chr19","12223537","12223815","11","113623"
"chr6","12115608","12115911","chr3","40382841","40383151","65","28267233"
"chr6","12124029","12124329","chr19","12238908","12239221","26","114879"
"chr6","12131665","12131951","chr19","12245624","12245910","4","113959"
"chr6","12137470","12137549","chr13","19314587","19314665","17","7177117"
"chr6","12138216","12138527","chr13","41864267","41864570","59","29726051"
"chr6","12140080","12140231","chr19","12255639","12255790","3","115559"
"chr6","12141386","12141674","chr19","12251385","12251679","37","109999"
"chr6","12146498","12146788","chr19","12260310","12260606","8","113812"
"chr6","12147498","12147796","chr19","12261638","12261942","7","114140"
"chr6","12164324","12164529","chr19","12278153","12278360","8","113829"
"chr6","12173216","12173399","chr19","12288491","12288667","15","115275"
"chr6","12185398","12185518","chr19","12300837","12300959","4","115439"
"chr6","12185588","12185858","chr1","136204419","136204661","100","124018831"
"chr6","12188553","12188873","chr19","12303936","12304250","15","115383"
"chr6","12203465","12203765","chr19","12321058","12321358","6","117593"
"chr6","12215275","12215581","chr19","12333047","12333355","14","117772"
"chr6","12215872","12216159","chr19","12333646","12333933","7","117774"
"chr6","12247073","12247379","chr19","12365327","12365633","12","118254"
"chr6","12252969","12253256","chr19","12371059","12371346","7","118090"
"chr6","12255244","12255561","chr12","99689911","99690212","60","87434667"
"chr6","12269925","12270089","chr15","59327625","59327787","31","47057700"
"chr6","12288051","12288167","chr16","22255402","22255514","20","9967351"
"chr6","12297156","12297464","chr7","25185886","25186189","54","12888730"
"chr6","12302625","12302797","chr19","12412617","12412796","17","109992"
"chr6","12303275","12303392","chr2","45322893","45323016","19","33019618"
"chr6","12314056","12314372","chr19","12403928","12404203","49","89872"
"chr6","12314818","12315118","chr19","12415768","12416064","13","100950"
"chr6","12316039","12316356","chr19","12417293","12417607","17","101254"
"chr6","12347834","12348002","chr19","12453490","12453665","11","105656"
"chr6","12354814","12354936","chr3","49893567","49893680","26","37538753"
"chr6","12355190","12355231","chr13","36192546","36192579","13","23837356"
"chr6","12355717","12355869","chr19","12462009","12462163","7","106292"
"chr6","12357667","12357832","chrX","14138574","14138739","31","1780907"
"chr6","12358132","12358146","chr14","44894488","44894502","4","32536356"
"chr6","12359105","12359202","chr5","173638672","173638763","29","161279567"
"chr6","12361681","12361820","chr19","12466912","12467050","10","105231"
"chr6","12365788","12366060","chr15","54377800","54378061","63","42012012"
"chr6","12366708","12367016","chr19","12471697","12472007","7","104989"
"chr6","12370758","12371055","chr19","12475083","12475381","10","104325"
"chr6","12372739","12373021","chr19","12477104","12477385","10","104365"
"chr6","12382850","12382972","chr1","29467408","29467511","40","17084558"
"chr6","12384278","12384595","chr19","12489292","12489617","12","105014"
"chr6","12388318","12388567","chr1","109563011","109563250","52","97174693"
"chr6","12410600","12410746","chr10","2464482","2464626","29","9946118"
"chr6","12427880","12428063","chr19","12537754","12537936","9","109874"
"chr6","12451086","12451397","chr13","84452913","84453227","57","72001827"
"chr6","12467686","12467977","chr19","12581798","12582089","4","114112"
"chr6","12468622","12468784","chrX","6584787","6584950","31","5883835"
"chr6","12474190","12474341","chr14","15277936","15278089","31","2803746"
"chr6","12477161","12477460","chr19","12591539","12591838","14","114378"
"chr6","12480199","12480471","chr19","12601349","12601652","38","121150"
"chr6","12496304","12496472","chr13","8757901","8758069","27","3738403"
"chr6","12513931","12514212","chr19","12629575","12629858","12","115644"
"chr6","12519897","12520059","chr7","40598761","40598917","43","28078864"
"chr6","12528360","12528635","chr19","12641138","12641409","7","112778"
"chr6","12528655","12528798","chr10","2464482","2464626","28","10064173"
"chr6","12530280","12530408","chr10","81051629","81051755","23","68521349"
"chr6","12531115","12531409","chr19","12644541","12644841","21","113426"
"chr6","12532694","12532979","chr19","12646497","12646716","76","113803"
"chr6","12540160","12540433","chr19","12654140","12654439","36","113980"
"chr6","12545581","12545884","chr19","12659390","12659694","7","113809"
"chr6","12547905","12548189","chr1","1273028","1273294","55","11274877"
"chr6","12548985","12549145","chr19","12662809","12662970","7","113824"
"chr6","12549752","12549762","chr13","85866445","85866455","2","73316693"
"chr6","12558507","12558779","chr19","12673992","12674262","4","115485"
"chr6","12559576","12559860","chr19","12675357","12675640","3","115781"
"chr6","12565098","12565415","chr7","4891823","4892134","58","7673275"
"chr6","12573137","12573295","chr7","59197023","59197182","37","46623886"
"chr6","12573607","12573824","chr19","12691498","12691710","11","117891"
"chr6","12596469","12596613","chr1","129762276","129762417","31","117165807"
"chr6","12596909","12597086","chr7","18856915","18857091","31","6260006"
"chr6","12604821","12604994","chr19","12724091","12724265","5","119270"
"chr6","12605616","12605629","chr2","172820531","172820541","3","160214915"
"chr6","12606486","12606676","chrX","140774146","140774339","48","128167660"
"chr6","12606736","12607026","chr7","125138276","125138568","52","112531540"
"chr6","12631983","12632271","chr19","12752631","12752929","16","120648"
"chr6","12642442","12642734","chr19","12768688","12768980","10","126246"
"chr6","12655782","12656079","chr19","12796647","12796952","13","140865"
"chr6","12668448","12668627","chr13","24052458","24052635","42","11384010"
"chr6","12669482","12669583","chr6","106363043","106363146","17","93693561"
"chr6","12672410","12672477","chr19","39112581","39112648","17","26440171"
"chr6","12673414","12673571","chr11","47005213","47005373","42","34331799"
"chr6","12676028","12676308","chr19","12805431","12805706","12","129403"
"chr6","12682110","12682392","chr19","12812649","12812936","10","130539"
"chr6","12694065","12694367","chr19","12823953","12824256","6","129888"
"chr6","12711955","12712062","chr7","14569784","14569892","16","1857829"
"chr6","12721951","12722093","chr11","1672187","1672324","25","11049764"
"chr6","12722409","12722554","chrX","51314960","51315116","40","38592551"
"chr6","12739665","12739947","chr17","39014903","39015180","46","26275238"
"chr6","12751433","12751704","chr19","12887634","12887901","12","136201"
"chr6","12768788","12769099","chr19","12909210","12909526","14","140422"
"chr6","12777057","12777356","chr19","12917632","12917931","5","140575"
"chr6","12816055","12816344","chr19","12957786","12958076","6","141731"
"chr6","12823040","12823351","chr19","12951681","12951992","9","128641"
"chr6","12823354","12823674","chr19","12951995","12952292","70","128641"
"chr6","12823742","12823984","chrX","44147511","44147746","58","31323769"
"chr6","12824020","12824084","chr1","6641003","6641065","9","6183017"
"chr6","12828676","12828985","chr19","12969848","12970160","9","141172"
"chr6","12833076","12833353","chr19","12974890","12975176","24","141814"
"chr6","12833750","12834036","chr19","12975573","12975870","14","141823"
"chr6","12834668","12834963","chr19","12977126","12977409","26","142458"
"chr6","12840877","12841042","chr19","12983436","12983601","4","142559"
"chr6","12841333","12841484","chr19","12983892","12984041","13","142559"
"chr6","12852816","12852856","chr1","177756608","177756646","7","164903792"
"chr6","12862914","12863094","chr19","13004972","13005152","8","142058"
"chr6","12864308","12864488","chr19","13006354","13006534","5","142046"
"chr6","12864781","12864914","chr19","13006831","13006964","1","142050"
"chr6","12873183","12873488","chr19","13015293","13015591","21","142110"
"chr6","12876496","12876806","chrX","46852707","46853016","49","33976211"
"chr6","12896733","12897033","chr19","13041971","13042278","25","145238"
"chr6","12899193","12899316","chrX","19112370","19112485","48","6213177"
"chr6","12908636","12908875","chr19","13055608","13055857","23","146972"
"chr6","12921724","12921888","chr10","14462717","14462877","29","1540993"
"chr6","12922492","12922786","chr4","34131396","34131685","52","21208904"
"chr6","12922804","12922867","chr10","16721566","16721632","14","3798762"
"chr6","12932697","12932994","chrX","141365274","141365565","56","128432577"
"chr6","12943039","12943295","chr19","13081556","13081841","38","138517"
"chr6","12943341","12943589","chr5","21840062","21840305","49","8896721"
"chr6","12955282","12955593","chr19","13093846","13094112","56","138564"
"chr6","12966846","12967216","chr7","38976492","38976848","69","26009646"
"chr6","12975827","12976116","chr19","13117718","13118007","1","141891"
"chr6","12977913","12978199","chr3","84807089","84807372","45","71829176"
"chr6","12989305","12989436","chr10","31201117","31201246","30","18211812"
"chr6","12990764","12990912","chr3","35842007","35842153","33","22851243"
"chr6","12991223","12991235","chr3","40642897","40642908","2","27651674"
"chr6","12996368","12996502","chr19","13135648","13135783","7","139280"
"chr6","12996826","12996925","chr19","13136110","13136216","9","139284"
"chr6","13009610","13009793","chr19","13150082","13150263","8","140472"
"chr6","13010096","13010231","chr19","13150567","13150703","7","140471"
"chr6","13014343","13014651","chr17","20154749","20155043","58","7140406"
"chr6","13018341","13018503","chr19","13157143","13157305","3","138802"
"chr6","13044439","13044626","chr19","13183306","13183488","8","138867"
"chr6","13045319","13045609","chr19","13184202","13184490","21","138883"
"chr6","13047347","13047475","chr19","13182875","13183009","10","135528"
"chr6","13061332","13061612","chr19","13198408","13198705","23","137076"
"chr6","13062712","13063024","chr19","13199768","13200064","25","137056"
"chr6","13070079","13070232","chr19","13207322","13207494","32","137243"
"chr6","13070549","13070559","chr3","105994005","105994015","1","92923456"
"chr6","13071847","13071958","chr15","20098219","20098332","16","7026372"
"chr6","13078694","13079002","chr13","41851851","41852159","56","28773157"
"chr6","13079393","13079687","chr19","13218008","13218308","14","138615"
"chr6","13080026","13080036","chr15","93134928","93134938","0","80054902"
"chr6","13080345","13080518","chr10","14462717","14462877","42","1382372"
"chr6","13084281","13084586","chr8","52207669","52207973","86","39123388"
"chr6","13085183","13085480","chr19","13224174","13224471","15","138991"
"chr6","13086854","13087028","chr10","14462717","14462877","42","1375863"
"chr6","13090791","13091096","chr8","52207669","52207973","86","39116878"
"chr6","13091696","13091993","chr19","13224174","13224471","15","132478"
"chr6","13110938","13111126","chr19","13244988","13245175","9","134050"
"chr6","13111374","13111508","chr19","13245423","13245555","6","134049"
"chr6","13121296","13121594","chr19","13253480","13253768","23","132184"
"chr6","13124609","13124801","chr7","148674141","148674325","37","135549532"
"chr6","13142818","13142989","chr9","20868136","20868298","40","7725318"
"chr6","13157053","13157222","chr19","13287350","13287525","12","130297"
"chr6","13157848","13157983","chr19","13288148","13288285","5","130300"
"chr6","13162445","13162764","chr4","51463371","51463679","63","38300926"
"chr6","13162940","13163199","chr8","67288416","67288676","72","54125476"
"chr6","13172280","13172565","chr19","13297438","13297719","11","125158"
"chr6","13191388","13191530","chr19","13316709","13316849","6","125321"
"chr6","13200510","13200632","chr19","13325906","13326028","5","125396"
"chr6","13233515","13233814","chr19","13357203","13357502","11","123688"
"chr6","13253736","13253911","chr14","107727063","107727234","52","94473327"
"chr6","13264249","13264547","chr19","13384532","13384829","11","120283"
"chr6","13266793","13266957","chr10","36037990","36038154","28","22771197"
"chr6","13285535","13285750","chr5","118770428","118770646","41","105484893"
"chr6","13288807","13289091","chr16","22294372","22294673","53","9005565"
"chr6","13295566","13295866","chr19","13415203","13415503","12","119637"
"chr6","13298804","13298952","chr19","13418697","13418850","13","119893"
"chr6","13391860","13392153","chr19","13520933","13521225","6","129073"
"chr6","13392954","13393255","chr19","13522029","13522332","15","129075"
"chr6","13396600","13396913","chr19","13525347","13525656","12","128747"
"chr6","13397839","13398143","chr19","13526897","13527201","10","129058"
"chr6","13412894","13413192","chr19","13541904","13542189","23","129010"
"chr6","13434587","13434703","chr19","13565768","13565884","1","131181"
"chr6","13440160","13440468","chr17","20154749","20155043","58","6714589"
"chr6","13460030","13460178","chr20","3720307","3720459","28","9739723"
"chr6","13505774","13506093","chr1","199676376","199676659","87","186170602"
"chr6","13535541","13535681","chr7","120306136","120306278","24","106770595"
"chr6","13547840","13548137","chr19","13677593","13677882","15","129753"
"chr6","13569893","13570073","chr3","42411287","42411467","33","28841394"
"chr6","13589665","13589951","chr19","13723683","13723977","13","134018"
"chr6","13649726","13650029","chr19","13771966","13772268","4","122240"
"chr6","13657552","13657855","chr19","13780481","13780795","19","122929"
"chr6","13662250","13662543","chr19","13785390","13785680","13","123140"
"chr6","13665722","13666028","chr19","13789924","13790221","16","124202"
"chr6","13669445","13669743","chr19","13795856","13796158","12","126411"
"chr6","13673402","13673711","chr19","13800731","13801039","12","127329"
"chr6","13680204","13680512","chrX","41341410","41341721","65","27661206"
"chr6","13697583","13697738","chr8","117676971","117677126","36","103979388"
"chr6","13703352","13703625","chr19","13829832","13830103","14","126480"
"chr6","13706546","13706606","chr13","42250192","42250250","17","28543646"
"chr6","13706855","13706882","chr3","66456685","66456708","9","52749830"
"chr6","13707534","13707709","chr19","13833196","13833372","14","125662"
"chr6","13729151","13729213","chr1","86128485","86128542","14","72399334"
"chr6","13730520","13730681","chr12","93463713","93463873","30","79733193"
"chr6","13736260","13736552","chr19","13864145","13864440","11","127885"
"chr6","13774923","13775254","chr19","13902675","13903016","25","127752"
"chr6","13778653","13778961","chr19","13908514","13908815","15","129861"
"chr6","13784437","13784732","chr19","13914453","13914752","20","130016"
"chr6","13786294","13786580","chr19","13916030","13916316","13","129736"
"chr6","13788397","13788761","chr19","13918142","13918490","23","129745"
"chr6","13792817","13793124","chr19","13922391","13922699","9","129574"
"chr6","13806528","13806543","chr9","20973335","20973349","1","7166807"
"chr6","13806594","13806883","chr8","58962988","58963265","50","45156394"
"chr6","13807085","13807395","chr19","13943590","13943904","14","136505"
"chr6","13823232","13823400","chr18","1524202","1524363","32","12299030"
"chr6","13823434","13823548","chr11","109582250","109582359","24","95758816"
"chr6","13859329","13859628","chr19","13990607","13990920","19","131278"
"chr6","13862362","13862614","chr19","13993663","13993882","45","131301"
"chr6","13863254","13863517","chr19","13994470","13994734","7","131216"
"chr6","13901797","13902106","chr19","14032963","14033269","4","131166"
"chr6","13907413","13907535","chr19","14047749","14047881","17","140336"
"chr6","13912976","13913106","chr1","69384327","69384457","33","55471351"
"chr6","13924674","13924955","chr19","14054959","14055233","8","130285"
"chr6","13924975","13925292","chr19","14055260","14055572","9","130285"
"chr6","13928256","13928378","chr19","14047749","14047881","17","119493"
"chr6","13946847","13947008","chrX","49524523","49524692","33","35577676"
"chr6","13947315","13947388","chr2","99778088","99778157","21","85830773"
"chr6","13948118","13948412","chr19","14075535","14075831","10","127417"
"chr6","13949349","13949645","chr19","14076763","14077061","4","127414"
"chr6","13950653","13950777","chr19","14078071","14078195","6","127418"
"chr6","13962249","13962464","chr10","89915538","89915755","25","75953289"
"chr6","13967773","13967999","chr19","14093589","14093815","7","125816"
"chr6","13968922","13969195","chr19","14095049","14095323","8","126127"
"chr6","13983938","13984225","chr19","14110456","14110739","13","126518"
"chr6","13992660","13992952","chr19","14119236","14119528","3","126576"
"chr6","13996867","13997173","chr19","14123210","14123514","12","126343"
"chr6","14009740","14010029","chr19","14136695","14136969","23","126955"
"chr6","14014439","14014735","chr19","14141338","14141631","8","126899"
"chr6","14024841","14025133","chr19","14151361","14151637","23","126520"
"chr6","14062435","14062693","chr19","14189412","14189669","4","126977"
"chr6","14071704","14071881","chr19","14198454","14198631","5","126750"
"chr6","14072155","14072301","chr19","14198904","14199050","4","126749"
"chr6","14089258","14089561","chr19","14217535","14217838","15","128277"
"chr6","14108802","14108821","chr18","4415220","4415238","3","9693582"
"chr6","14108980","14109264","chr4","129672172","129672452","60","115563192"
"chr6","14114175","14114485","chr19","14243827","14244106","37","129652"
"chr6","14115040","14115157","chr19","14244666","14244779","6","129626"
"chr6","14115459","14115523","chr3","119384103","119384148","29","105268644"
"chr6","14115801","14116015","chr19","14245075","14245294","8","129274"
"chr6","14124478","14124637","chr19","14257501","14257644","19","133023"
"chr6","14124930","14125222","chr19","14257934","14258235","15","133004"
"chr6","14127491","14127762","chr19","14260266","14260541","13","132775"
"chr6","14129491","14129568","chr19","14262585","14262662","3","133094"
"chr6","14146216","14146539","chr19","14279214","14279537","15","132998"
"chr6","14166136","14166430","chr19","14300835","14301133","7","134699"
"chr6","14234408","14234583","chr1","124297285","124297463","31","110062877"
"chr6","14234646","14234779","chr6","132458178","132458307","30","118223532"
"chr6","14278434","14278547","chr19","14428836","14428949","1","150402"
"chr6","14345373","14345679","chr13","41851851","41852159","60","27506478"
"chr6","14369696","14369990","chr12","33483567","33483868","61","19113871"
"chr6","14376613","14376884","chr1","119227996","119228273","63","104851383"
"chr6","14377308","14377599","chr19","14511379","14511702","37","134071"
"chr6","14382337","14382648","chr19","14516358","14516668","12","134021"
"chr6","14393975","14394257","chr19","14528187","14528467","10","134212"
"chr6","14395732","14396042","chr20","27160084","27160391","52","12764352"
"chr6","14409761","14409890","chr19","14542101","14542230","3","132340"
"chr6","14410227","14410348","chr19","14542583","14542703","8","132356"
"chr6","14521768","14522078","chr19","14652171","14652498","30","130403"
"chr6","14523302","14523380","chr19","14653748","14653826","1","130446"
"chr6","14539273","14539570","chr8","61938663","61938963","52","47399390"
"chr6","14543236","14543414","chr5","172558063","172558242","43","158014827"
"chr6","14544632","14544858","chrX","9520448","9520678","47","5024184"
"chr6","14547797","14548094","chr19","14676217","14676507","10","128420"
"chr6","14584888","14585065","chr14","100454195","100454362","33","85869307"
"chr6","14586215","14586430","chr19","14715524","14715737","15","129309"
"chr6","14591504","14591708","chr8","69577131","69577335","35","54985627"
"chr6","14602294","14602597","chr19","28718617","28718918","55","14116323"
"chr6","14607592","14607893","chr19","14734258","14734563","12","126666"
"chr6","14634341","14634648","chr19","14762536","14762851","13","128195"
"chr6","14638625","14638895","chr19","14767334","14767604","5","128709"
"chr6","14641208","14641352","chr11","44976604","44976745","27","30335396"
"chr6","14641378","14641391","chr7","56844898","56844911","2","42203520"
"chr6","14641672","14641975","chr19","14770374","14770677","15","128702"
"chr6","14648293","14648588","chr19","14777253","14777548","18","128960"
"chr6","14649022","14649200","chr19","14777981","14778157","18","128959"
"chr6","14649513","14649649","chr19","14778472","14778606","8","128959"
"chr6","14662539","14662832","chr19","14792837","14793136","15","130298"
"chr6","14664589","14664888","chr19","14794955","14795251","6","130366"
"chr6","14675489","14675780","chr19","14805984","14806276","7","130495"
"chr6","14677522","14677698","chr19","14807961","14808136","10","130439"
"chr6","14678011","14678142","chr19","14808449","14808581","4","130438"
"chr6","14679377","14679650","chr13","108828551","108828824","62","94149174"
"chr6","14684273","14684568","chr19","14814023","14814321","13","129750"
"chr6","14700574","14700845","chr19","14830065","14830336","4","129491"
"chr6","14722559","14722866","chr1","140573700","140574004","59","125851141"
"chr6","14746135","14746432","chr19","14868158","14868455","13","122023"
"chr6","14750415","14750715","chr19","14872853","14873152","12","122438"
"chr6","14771655","14771827","chrX","107282587","107282754","30","92510932"
"chr6","14775044","14775248","chr15","36190565","36190758","45","21415521"
"chr6","14775296","14775343","chr2","98600672","98600718","10","83825376"
"chr6","14777202","14777493","chr20","4819299","4819585","69","9957903"
"chr6","14778722","14779011","chr19","14896905","14897207","17","118183"
"chr6","14787752","14788042","chr19","14902408","14902698","5","114656"
"chr6","14790005","14790300","chr19","14906899","14907194","10","116894"
"chr6","14792897","14793214","chr19","14910795","14911112","6","117898"
"chr6","14797833","14798014","chr3","42298682","42298860","33","27500849"
"chr6","14801335","14801461","chr5","51039231","51039352","18","36237896"
"chr6","14803743","14803996","chr1","72540371","72540620","47","57736628"
"chr6","14804414","14804608","chr19","14923474","14923668","7","119060"
"chr6","14804910","14805016","chr19","14923978","14924081","8","119068"
"chr6","14807870","14808161","chr19","14927035","14927326","5","119165"
"chr6","14808600","14808661","chr1","135263123","135263181","12","120454523"
"chr6","14808838","14808994","chr19","14928000","14928156","7","119162"
"chr6","14809553","14809783","chr7","41885820","41886049","66","27076267"
"chr6","14816893","14817192","chr19","14936457","14936761","16","119564"
"chr6","14817962","14818261","chr19","14937537","14937836","8","119575"
"chr6","14818700","14819003","chr19","14939392","14939698","14","120692"
"chr6","14824258","14824526","chr10","28760348","28760611","57","13936090"
"chr6","14827151","14827458","chr3","150569212","150569522","53","135742061"
"chr6","14841277","14841573","chr19","14963728","14964020","8","122451"
"chr6","14845123","14845350","chr19","14968226","14968454","8","123103"
"chr6","14847648","14847793","chr19","14970775","14970903","22","123127"
"chr6","14852432","14852728","chr19","14975156","14975456","9","122724"
"chr6","14870462","14870720","chr19","14994999","14995250","11","124537"
"chr6","14902618","14902914","chr19","15029608","15029904","7","126990"
"chr6","14918838","14918908","chr19","15045767","15045837","0","126929"
"chr6","14923104","14923401","chr19","15050660","15050959","15","127556"
"chr6","14931414","14931531","chr19","15059253","15059370","1","127839"
"chr6","14932584","14932725","chr5","56417696","56417842","23","41485112"
"chr6","14939252","14939556","chr5","171762200","171762490","56","156822948"
"chr6","14967371","14967666","chr16","42390761","42391062","53","27423390"
"chr6","14986802","14987114","chr19","15116874","15117185","14","130072"
"chr6","15011959","15012265","chr19","15141354","15141678","35","129395"
"chr6","15012313","15012606","chr19","15141728","15142021","8","129415"
"chr6","15018606","15018895","chr19","15150474","15150760","12","131868"
"chr6","15022197","15022297","chr20","49228494","49228595","19","34206297"
"chr6","15038547","15038635","chr19","15169283","15169371","1","130736"
"chr6","15058845","15059096","chr19","15190721","15190973","8","131876"
"chr6","15070210","15070506","chr19","15201973","15202269","2","131763"
"chr6","15103456","15103618","chr9","66700561","66700724","31","51597105"
"chr6","15122140","15122435","chr19","15255059","15255354","4","132919"
"chr6","15145263","15145517","chr19","15278821","15279105","46","133558"
"chr6","15156863","15157163","chr19","15292185","15292487","10","135322"
"chr6","15160499","15160797","chr19","15295625","15295924","11","135126"
"chr6","15167570","15167857","chr19","15302418","15302704","10","134848"
"chr6","15173422","15173530","chr19","696640","696747","23","14476782"
"chr6","15173842","15174031","chr19","27266639","27266821","35","12092797"
"chr6","15180558","15180665","chr7","41387648","41387756","13","26207090"
"chr6","15185082","15185338","chr12","63586872","63587130","52","48401790"
"chr6","15192808","15192979","chr3","170699419","170699589","38","155506611"
"chr6","15202263","15202522","chr13","43501004","43501272","59","28298741"
"chr6","15203470","15203774","chr14","67365075","67365375","50","52161605"
"chr6","15208007","15208292","chr7","115474282","115474567","50","100266275"
"chr6","15219986","15220265","chr19","15311413","15311682","19","91427"
"chr6","15227799","15227917","chr4","105561361","105561479","26","90333562"
"chr6","15238382","15238528","chr19","15329591","15329745","12","91209"
"chr6","15241303","15241423","chr19","15332819","15332939","6","91516"
"chr6","15241451","15241632","chr19","15332963","15333150","12","91512"
"chr6","15241918","15242231","chr19","15333459","15333753","36","91541"
"chr6","15243229","15243529","chr19","15335033","15335339","19","91804"
"chr6","15250821","15251094","chr5","36616104","36616377","57","21365283"
"chr6","15252922","15253068","chr19","15329591","15329745","12","76669"
"chr6","15255839","15255959","chr19","15332819","15332939","6","76980"
"chr6","15255987","15256168","chr19","15332963","15333150","12","76976"
"chr6","15256454","15256767","chr19","15333459","15333753","36","77005"
"chr6","15257762","15258062","chr19","15335033","15335339","19","77271"
"chr6","15267099","15267372","chr5","36616104","36616377","57","21349005"
"chr6","15273571","15273747","chr1","41621732","41621898","42","26348161"
"chr6","15286557","15286830","chr1","52728948","52729232","61","37442391"
"chr6","15289502","15289641","chr2","172227852","172227991","34","156938350"
"chr6","15299415","15299698","chr19","15355069","15355354","19","55654"
"chr6","15303757","15304047","chr19","15351477","15351764","15","47720"
"chr6","15311057","15311362","chr10","20084732","20084995","81","4773675"
"chr6","15326420","15326689","chr19","15372246","15372520","31","45826"
"chr6","15344734","15344849","chr19","15391816","15391934","5","47082"
"chr6","15350988","15351299","chr19","15398060","15398375","19","47072"
"chr6","15352746","15353042","chr19","15399827","15400128","16","47081"
"chr6","15357443","15357743","chr19","15404491","15404795","16","47048"
"chr6","15361039","15361284","chr19","15408073","15408340","28","47034"
"chr6","15364456","15364745","chr19","15411209","15411503","9","46753"
"chr6","15366307","15366390","chr7","63626727","63626811","13","48260420"
"chr6","15373065","15373221","chr19","15420796","15420952","4","47731"
"chr6","15373497","15373647","chr10","65746323","65746471","24","50372826"
"chr6","15393635","15393882","chr11","83810681","83810926","49","68417046"
"chr6","15408074","15408200","chr19","15456994","15457129","10","48920"
"chr6","15440070","15440292","chr3","45613516","45613724","48","30173446"
"chr6","15451550","15451824","chr19","15500696","15501013","56","49146"
"chr6","15465092","15465399","chr19","15514361","15514667","11","49269"
"chr6","15466392","15466492","chr6","61113512","61113607","26","45647120"
"chr6","15475044","15475326","chr19","15524104","15524386","9","49060"
"chr6","15475495","15475755","chr19","15524559","15524819","12","49064"
"chr6","15477992","15478102","chr7","132107772","132107886","19","116629780"
"chr6","15480797","15481044","chr2","45071472","45071709","52","29590675"
"chr6","15497884","15498152","chr19","15545204","15545481","15","47320"
"chr6","15506550","15506840","chr14","7153919","7154206","59","8352631"
"chr6","15514664","15514968","chr19","15562289","15562586","20","47625"
"chr6","15527287","15527587","chr19","15576727","15577022","15","49440"
"chr6","15546133","15546270","chr19","15596045","15596182","1","49912"
"chr6","15546568","15546731","chr19","15596473","15596636","6","49905"
"chr6","15547315","15547482","chrX","50777688","50777855","44","35230373"
"chr6","15547773","15547890","chr19","15597722","15597839","2","49949"
"chr6","15550601","15550878","chr19","15600564","15600847","31","49963"
"chr6","15552359","15552536","chr19","15602209","15602386","1","49850"
"chr6","15552840","15552882","chr19","15602683","15602725","1","49843"
"chr6","15556631","15556937","chr5","129484486","129484788","56","113927855"
"chr6","15564028","15564326","chr19","15613824","15614129","14","49796"
"chr6","15578511","15578817","chr19","15628349","15628657","12","49838"
"chr6","15579534","15579838","chr19","15629378","15629672","18","49844"
"chr6","15584197","15584460","chr19","15634322","15634580","17","50125"
"chr6","15585613","15585925","chr19","15635725","15636036","11","50112"
"chr6","15586689","15586891","chr3","39861348","39861550","34","24274659"
"chr6","15590124","15590417","chr19","15640274","15640567","8","50150"
"chr6","15591860","15592117","chr19","15642021","15642278","10","50161"
"chr6","15593815","15594127","chr7","63531408","63531718","64","47937593"
"chr6","15600517","15600815","chr3","39265225","39265528","70","23664708"
"chr6","15614768","15614961","chr19","15663637","15663830","2","48869"
"chr6","15615996","15616084","chr15","9038122","9038207","26","6577874"
"chr6","15626716","15626980","chr19","15677719","15677984","12","51003"
"chr6","15633577","15633738","chr5","58102327","58102485","37","42468750"
"chr6","15633761","15634034","chr19","15684616","15684889","4","50855"
"chr6","15637989","15638287","chr19","15689169","15689467","11","51180"
"chr6","15645511","15645779","chr19","15695089","15695357","6","49578"
"chr6","15646841","15647013","chr3","16450104","16450276","54","803263"
"chr6","15647268","15647571","chr19","15696855","15697156","29","49587"
"chr6","15648519","15648823","chr19","15698103","15698408","9","49584"
"chr6","15649039","15649326","chr19","15698624","15698909","10","49585"
"chr6","15650114","15650279","chr19","15699627","15699792","3","49513"
"chr6","15656401","15656544","chr19","15705849","15705993","1","49448"
"chr6","15662796","15662932","chr19","15712539","15712674","5","49743"
"chr6","15663534","15663550","chr1","45182829","45182846","6","29519295"
"chr6","15663948","15664101","chr19","15713606","15713768","17","49658"
"chr6","15681632","15681738","chr3","10050569","10050672","23","5631063"
"chr6","15683380","15683666","chr19","15733268","15733552","9","49888"
"chr6","15684110","15684248","chr3","144623907","144624030","40","128939797"
"chr6","15695156","15695447","chr19","15744004","15744293","5","48848"
"chr6","15729362","15729496","chr19","15779070","15779204","7","49708"
"chr6","15729799","15729824","chr19","15779503","15779528","2","49704"
"chr6","15733355","15733533","chr7","131644256","131644424","44","115910901"
"chr6","15758309","15758595","chr19","15798956","15799247","10","40647"
"chr6","15765347","15765614","chr19","15806166","15806436","14","40819"
"chr6","15785448","15785606","chr19","15823164","15823322","4","37716"
"chr6","15788628","15788928","chr19","15826045","15826345","5","37417"
"chr6","15817434","15817672","chr19","15856154","15856393","8","38720"
"chr6","15827548","15827718","chr19","15865847","15866015","7","38299"
"chr6","15827987","15828143","chr19","15866284","15866440","2","38297"
"chr6","15868623","15868796","chr1","11980907","11981080","34","3887716"
"chr6","15868829","15868974","chr11","82935462","82935610","32","67066633"
"chr6","15872072","15872325","chr19","15911931","15912185","30","39859"
"chr6","15877329","15877625","chr3","174135902","174136193","62","158258573"
"chr6","15886854","15887023","chr4","35083225","35083392","26","19196371"
"chr6","15887369","15887381","chr13","107299184","107299196","0","91411815"
"chr6","15887692","15887966","chr19","15930875","15931144","7","43183"
"chr6","15895447","15895704","chr19","15939274","15939531","4","43827"
"chr6","15896535","15896607","chr6","84577771","84577838","18","68681236"
"chr6","15897343","15897480","chr5","78587456","78587592","21","62690113"
"chr6","15933620","15933816","chr7","58729599","58729780","39","42795979"
"chr6","15934387","15934554","chr10","14462717","14462877","29","1471670"
"chr6","15948163","15948450","chr19","15950142","15950429","2","1979"
"chr6","15952468","15952794","chr14","103561503","103561817","69","87609035"
"chr6","15952825","15953105","chr1","178586436","178586714","64","162633611"
"chr6","15981036","15981356","chr19","15992682","15992972","39","11646"
"chr6","15986325","15986520","chr15","101403181","101403371","35","85416856"
"chr6","15991856","15992143","chr19","16007379","16007668","12","15523"
"chr6","15993288","15993455","chr5","141044382","141044545","27","125051094"
"chr6","16012612","16012731","chr10","12127351","12127481","28","3885261"
"chr6","16017392","16017630","chr13","24884014","24884250","50","8866622"
"chr6","16030962","16031004","chr8","5927095","5927135","5","10103867"
"chr6","16031005","16031183","chr13","92615305","92615488","35","76584300"
"chr6","16031514","16031554","chr19","16045820","16045851","10","14306"
"chr6","16055842","16055972","chr19","16072235","16072367","7","16393"
"chr6","16056275","16056461","chr19","16072672","16072836","31","16397"
"chr6","16056462","16056556","chr19","16072856","16072951","24","16394"
"chr6","16056596","16056788","chr19","16072994","16073164","26","16398"
"chr6","16075857","16076158","chr19","16095018","16095318","14","19161"
"chr6","16087653","16087962","chr19","16104533","16104837","11","16880"
"chr6","16091422","16091713","chr8","139057439","139057732","52","122966017"
"chr6","16113561","16113829","chr14","37305977","37306235","48","21192416"
"chr6","16120687","16120912","chr9","14985544","14985772","50","1135143"
"chr6","16136289","16136397","chr20","2858506","2858617","15","13277783"
"chr6","16136596","16136806","chr3","39861348","39861550","49","23724752"
"chr6","16150137","16150465","chr19","16169764","16170075","32","19627"
"chr6","16153491","16153754","chr19","16173767","16174027","9","20276"
"chr6","16159616","16159935","chr19","16179604","16179923","13","19988"
"chr6","16162585","16162893","chr19","16182976","16183282","9","20391"
"chr6","16168658","16168801","chr19","16189658","16189799","9","21000"
"chr6","16174012","16174181","chr19","16197115","16197290","16","23103"
"chr6","16174489","16174631","chr19","16197594","16197736","5","23105"
"chr6","16185232","16185530","chr7","37314940","37315240","48","21129708"
"chr6","16188912","16189170","chr19","16212630","16212888","2","23718"
"chr6","16203396","16203570","chr19","16227060","16227234","8","23664"
"chr6","16203862","16204005","chr19","16227527","16227670","2","23665"
"chr6","16218798","16218964","chr19","16246233","16246426","29","27435"
"chr6","16218965","16219275","chr19","16246740","16247050","4","27775"
"chr6","16219276","16219335","chr19","16247051","16247108","6","27775"
"chr6","16240489","16240500","chr3","41735084","41735095","3","25494595"
"chr6","16240501","16240816","chr19","16258546","16258844","32","18045"
"chr6","16240817","16240984","chr19","16258845","16259010","5","18028"
"chr6","16242494","16242792","chr19","16270251","16270549","6","27757"
"chr6","16274629","16274920","chr19","16307376","16307673","12","32747"
"chr6","16289403","16289688","chr6","134251498","134251796","58","117962095"
"chr6","16293056","16293357","chr19","16323637","16323934","12","30581"
"chr6","16295483","16295787","chr19","16326065","16326369","5","30582"
"chr6","16297322","16297620","chr19","16327949","16328246","10","30627"
"chr6","16303928","16304129","chr14","12752968","12753161","44","3550960"
"chr6","16308405","16308559","chr19","16339008","16339166","5","30603"
"chr6","16324622","16324930","chr19","16355203","16355521","21","30581"
"chr6","16326821","16327128","chr19","14342610","14342920","54","1984211"
"chr6","16327856","16327990","chr15","40922130","40922264","18","24594274"
"chr6","16328287","16328441","chr10","83253028","83253183","34","66924741"
"chr6","16328746","16328761","chr1","56670819","56670831","3","40342073"
"chr6","16329282","16329584","chr19","16358001","16358314","15","28719"
"chr6","16340311","16340456","chr19","16369426","16369572","6","29115"
"chr6","16342886","16343058","chr13","7960128","7960302","39","8382758"
"chr6","16343933","16344102","chr19","16373390","16373559","1","29457"
"chr6","16345054","16345202","chr19","16374515","16374663","5","29461"
"chr6","16346105","16346437","chr19","16375569","16375896","10","29464"
"chr6","16351602","16351900","chr19","16382105","16382396","26","30503"
"chr6","16352572","16352872","chr19","16390492","16390792","7","37920"
"chr6","16362279","16362586","chr19","16395168","16395476","9","32889"
"chr6","16365244","16365470","chr19","16392008","16392234","10","26764"
"chr6","16366715","16367028","chr19","16398246","16398563","14","31531"
"chr6","16369745","16370066","chr19","16401831","16402153","10","32086"
"chr6","16372171","16372350","chr5","106811248","106811420","43","90439077"
"chr6","16372889","16372924","chr16","17703172","17703203","13","1330283"
"chr6","16373204","16373214","chr7","161495062","161495072","4","145121858"
"chr6","16373500","16373606","chr3","123692686","123692782","30","107319186"
"chr6","16375670","16375947","chr19","16415321","16415625","42","39651"
"chr6","16379197","16379471","chr19","16419219","16419493","9","40022"
"chr6","16390384","16390698","chr11","22327399","22327710","59","5937015"
"chr6","16394489","16394731","chr20","4252141","4252403","83","12142348"
"chr6","16396272","16396471","chr15","38880814","38881003","56","22484542"
"chr6","16396638","16396729","chr14","108537150","108537233","16","92140512"
"chr6","16397288","16397350","chr10","59037068","59037122","16","42639780"
"chr6","16397630","16397801","chr10","82239382","82239543","33","65841752"
"chr6","16398249","16398359","chr7","78099743","78099855","18","61701494"
"chr6","16400976","16401270","chr19","16440380","16440674","6","39404"
"chr6","16410156","16410450","chr19","16440380","16440674","6","30224"
"chr6","16413038","16413343","chr19","16444577","16444880","8","31539"
"chr6","16426291","16426539","chr19","16459833","16460082","9","33542"
"chr6","16451122","16451436","chr19","16483852","16484160","14","32730"
"chr6","16452268","16452572","chr19","16484986","16485290","5","32718"
"chr6","16452619","16452934","chr5","19920562","19920869","61","3467943"
"chr6","16460218","16460415","chr10","14117161","14117353","64","2343057"
"chr6","16464823","16465061","chr19","16500965","16501209","14","36142"
"chr6","16466283","16466585","chr6","50666377","50666682","47","34200094"
"chr6","16467504","16467772","chr3","129184864","129185144","59","112717360"
"chr6","16473237","16473421","chr19","16510650","16510826","15","37413"
"chr6","16476537","16476831","chr2","73673617","73673899","55","57197080"
"chr6","16488836","16489152","chr13","41851851","41852159","68","25363015"
"chr6","16495306","16495472","chr19","16532875","16533047","11","37569"
"chr6","16495815","16495953","chr19","16533349","16533476","14","37534"
"chr6","16496904","16497215","chr1","120346116","120346429","74","103849212"
"chr6","16497909","16498071","chr19","16536040","16536200","10","38131"
"chr6","16502236","16502465","chr19","16541023","16541252","5","38787"
"chr6","16503088","16503247","chr19","16541874","16542033","10","38786"
"chr6","16504721","16504901","chr2","48565458","48565631","37","32060737"
"chr6","16505244","16505381","chr6","132308916","132309054","24","115803672"
"chr6","16506956","16507039","chr19","16546380","16546463","3","39424"
"chr6","16508029","16508156","chr19","16548740","16548867","5","40711"
"chr6","16508452","16508614","chr19","16549164","16549317","17","40712"
"chr6","16522290","16522439","chr7","16477600","16477747","28","44690"
"chr6","16523788","16524084","chr19","16566233","16566530","8","42445"
"chr6","16525031","16525326","chrX","15662330","15662626","55","862701"
"chr6","16539576","16539796","chr19","16582649","16582848","27","43073"
"chr6","16539834","16539913","chr2","86476520","86476585","25","69936686"
"chr6","16543807","16544115","chr19","16586521","16586829","2","42714"
"chr6","16545264","16545535","chr19","16587969","16588240","4","42705"
"chr6","16549542","16549701","chr11","122236943","122237101","31","105687401"
"chr6","16557548","16557853","chr19","16596131","16596440","10","38583"
"chr6","16561870","16561935","chr10","16885873","16885925","22","324003"
"chr6","16575704","16575925","chr19","16616632","16616852","5","40928"
"chr6","16593387","16593563","chr5","159139975","159140150","32","142546588"
"chr6","16594125","16594285","chr19","16637554","16637714","3","43429"
"chr6","16597045","16597321","chr1","4156865","4157121","73","12440180"
"chr6","16601873","16601948","chr5","102000001","102000077","13","85398128"
"chr6","16602253","16602332","chr19","16644665","16644743","3","42412"
"chr6","16602606","16602768","chr19","16645017","16645179","3","42411"
"chr6","16611360","16611539","chr19","16653209","16653386","7","41849"
"chr6","16611835","16611954","chr19","16653684","16653803","4","41849"
"chr6","16614835","16615136","chr20","55866452","55866745","56","39251617"
"chr6","16625751","16625849","chr19","16663461","16663559","2","37710"
"chr6","16652410","16652529","chr19","16695172","16695291","1","42762"
"chr6","16656235","16656395","chr19","16699987","16700148","4","43752"
"chr6","16665627","16665763","chr4","32910946","32911076","30","16245319"
"chr6","16674624","16674937","chr9","32668102","32668409","54","15993478"
"chr6","16676557","16676859","chr19","16720449","16720751","14","43892"
"chr6","16690922","16691234","chr19","16734267","16734598","39","43345"
"chr6","16706002","16706292","chr19","16750772","16751063","4","44770"
"chr6","16715083","16715352","chr19","16761783","16762052","9","46700"
"chr6","16719964","16720288","chr19","16768416","16768743","19","48452"
"chr6","16724588","16724749","chr19","16773041","16773205","7","48453"
"chr6","16725944","16726101","chr19","16775354","16775521","15","49410"
"chr6","16726102","16726407","chr4","104622535","104622838","53","87896433"
"chr6","16726408","16726419","chr9","112320401","112320412","1","95593993"
"chr6","16727139","16727186","chr19","43567588","43567637","9","26840449"
"chr6","16745578","16745852","chr19","16799109","16799387","16","53531"
"chr6","16752515","16752812","chr19","16806029","16806326","8","53514"
"chr6","16790808","16791105","chr19","16844437","16844732","11","53629"
"chr6","16791893","16792158","chr19","16845521","16845786","3","53628"
"chr6","16794169","16794276","chr19","16848019","16848126","1","53850"
"chr6","16796988","16797273","chr15","97040813","97041109","58","80243825"
"chr6","16801828","16801917","chr11","85269828","85269916","12","68468000"
"chr6","16815237","16815434","chr3","12994117","12994313","34","3821120"
"chr6","16821400","16821565","chr19","16874935","16875122","25","53535"
"chr6","16830971","16831131","chr19","16886820","16886980","4","55849"
"chr6","16836408","16836596","chr19","16898175","16898366","10","61767"
"chr6","16841194","16841488","chr19","16902639","16902936","10","61445"
"chr6","16844833","16845114","chr19","16906602","16906888","13","61769"
"chr6","16855403","16855758","chr19","16919722","16920076","24","64319"
"chr6","16859199","16859287","chr7","63626727","63626811","14","46767528"
"chr6","16859305","16859429","chr5","53009160","53009286","23","36149855"
"chr6","16859723","16859881","chr1","90638868","90639033","32","73779145"
"chr6","16862151","16862379","chr19","16932276","16932504","3","70125"
"chr6","16865462","16865779","chr19","16935909","16936226","14","70447"
"chr6","16873513","16873577","chr14","114488152","114488220","13","97614639"
"chr6","16873578","16873730","chr3","41431924","41432076","30","24558346"
"chr6","16875135","16875293","chr1","202426861","202427019","33","185551726"
"chr6","16875688","16876040","chr19","16943085","16943421","35","67397"
"chr6","16879066","16879198","chr1","129526265","129526398","19","112647199"
"chr6","16879199","16879384","chr19","16946873","16947050","14","67674"
"chr6","16879686","16879800","chr19","16947360","16947479","12","67674"
"chr6","16880126","16880189","chr7","133769823","133769894","18","116889697"
"chr6","16881184","16881293","chr2","185869971","185870075","22","168988787"
"chr6","16883658","16883745","chr19","4597905","4597993","16","12285753"
"chr6","16885296","16885454","chr19","16956752","16956910","6","71456"
"chr6","16886326","16886615","chr19","16950367","16950675","25","64041"
"chr6","16911738","16912045","chr19","16982410","16982718","9","70672"
"chr6","16921290","16921447","chr2","149735683","149735826","36","132814393"
"chr6","16943256","16943526","chr19","17014565","17014841","16","71309"
"chr6","16957527","16957836","chr19","17029092","17029392","15","71565"
"chr6","16961295","16961462","chr14","5555395","5555561","44","11405900"
"chr6","16968334","16968612","chr19","17040979","17041259","6","72645"
"chr6","16989144","16989373","chr19","17061877","17062106","6","72733"
"chr6","17000972","17001133","chr19","17074536","17074705","10","73564"
"chr6","17022213","17022252","chrX","13167231","13167269","8","3854982"
"chr6","17022733","17022871","chr5","4450724","4450860","34","12572009"
"chr6","17060499","17060657","chr19","17143458","17143616","7","82959"
"chr6","17060967","17061088","chr19","17143924","17144044","3","82957"
"chr6","17070450","17070755","chr19","17153054","17153346","16","82604"
"chr6","17086700","17086980","chr19","17169973","17170243","19","83273"
"chr6","17142860","17143167","chr19","17237220","17237527","5","94360"
"chr6","17166381","17166671","chr19","17259257","17259552","13","92876"
"chr6","17170873","17171013","chr6","72075482","72075601","34","54904609"
"chr6","17181474","17181795","chr3","14485595","14485905","64","2695879"
"chr6","17193804","17193966","chr17","82447529","82447690","36","65253725"
"chr6","17195621","17195918","chr19","17289654","17289947","7","94033"
"chr6","17211182","17211451","chr5","171821261","171821527","60","154610079"
"chr6","17211630","17211885","chr13","94860727","94860968","65","77649097"
"chr6","17211902","17212084","chr1","163823073","163823253","32","146611171"
"chr6","17215205","17215508","chr19","17309607","17309913","15","94402"
"chr6","17218901","17219068","chr19","17313328","17313495","5","94427"
"chr6","17219366","17219436","chr19","17313797","17313866","4","94431"
"chr6","17222791","17222992","chr19","17317210","17317411","7","94419"
"chr6","17269172","17269458","chr19","17363445","17363731","9","94273"
"chr6","17274362","17274671","chr19","17368067","17368378","11","93705"
"chr6","17278644","17278863","chr19","17372331","17372550","6","93687"
"chr6","17283334","17283619","chr19","17378531","17378816","9","95197"
"chr6","17284613","17284922","chr19","17380419","17380726","6","95806"
"chr6","17286548","17286854","chr19","17384930","17385236","3","98382"
"chr6","17289241","17289408","chr4","119074513","119074677","27","101785272"
"chr6","17289988","17290292","chr19","17382301","17382606","10","92313"
"chr6","17296359","17296640","chr19","17390560","17390843","4","94201"
"chr6","17297775","17298074","chr19","17391979","17392278","8","94204"
"chr6","17316218","17316424","chr19","17411256","17411462","6","95038"
"chr6","17338391","17338566","chr19","17430001","17430177","7","91610"
"chr6","17339520","17339820","chr19","17431118","17431419","19","91598"
"chr6","17345893","17346189","chr11","125243755","125244045","58","107897862"
"chr6","17348017","17348305","chr19","17446202","17446500","17","98185"
"chr6","17361351","17361519","chr19","17459825","17459993","1","98474"
"chr6","17363659","17363891","chr1","112243141","112243383","53","94879482"
"chr6","17366771","17367068","chr13","86694872","86695169","51","69328101"
"chr6","17383103","17383398","chr19","17482476","17482771","9","99373"
"chr6","17390460","17390670","chr19","17489507","17489719","6","99047"
"chr6","17401006","17401292","chr19","17501637","17501923","3","100631"
"chr6","17407466","17407629","chr8","48518198","48518367","30","31110732"
"chr6","17408870","17409038","chr5","32443904","32444074","37","15035034"
"chr6","17413038","17413201","chr8","48518198","48518367","30","31105160"
"chr6","17413496","17413517","chr19","43074751","43074769","6","25661255"
"chr6","17414427","17414595","chr5","32443904","32444074","37","15029477"
"chr6","17416898","17417195","chr10","35535561","35535860","49","18118663"
"chr6","17417316","17417389","chr1","34800369","34800443","16","17383053"
"chr6","17419130","17419411","chr19","17513662","17513945","5","94532"
"chr6","17423751","17423805","chrX","112421642","112421693","15","94997891"
"chr6","17426032","17426118","chr14","18598273","18598352","20","1172241"
"chr6","17446675","17446845","chr19","17544989","17545160","6","98314"
"chr6","17447138","17447346","chr19","17545452","17545648","14","98314"
"chr6","17460746","17460887","chr19","40676036","40676184","28","23215290"
"chr6","17463141","17463427","chr19","17561678","17561965","6","98537"
"chr6","17473817","17474053","chr19","17572149","17572385","9","98332"
"chr6","17486498","17486797","chr19","17584883","17585182","6","98385"
"chr6","17490824","17491012","chr20","36646402","36646595","46","19155578"
"chr6","17499766","17500000","chr19","17599042","17599306","40","99276"
"chr6","17501879","17502018","chr9","93160954","93161077","41","75659075"
"chr6","17506565","17506747","chr19","17604668","17604859","15","98103"
"chr6","17517818","17518101","chr19","17616079","17616362","5","98261"
"chr6","17545090","17545386","chr19","17644665","17644953","15","99575"
"chr6","17566911","17567061","chr10","81822431","81822569","43","64255520"
"chr6","17572907","17573192","chr19","17673146","17673432","6","100239"
"chr6","17581568","17581859","chr10","28855549","28855840","67","11273981"
"chr6","17583587","17583865","chr19","17681868","17682179","38","98281"
"chr6","17589156","17589453","chr19","17687319","17687605","22","98163"
"chr6","17599986","17600274","chr11","112408841","112409133","60","94808855"
"chr6","17601863","17602142","chr19","17700491","17700770","1","98628"
"chr6","17608229","17608530","chr19","17708008","17708309","10","99779"
"chr6","17609352","17609667","chr19","17709123","17709434","25","99771"
"chr6","17616578","17616800","chr19","17716228","17716450","2","99650"
"chr6","17619157","17619456","chr19","17719102","17719396","11","99945"
"chr6","17625194","17625502","chr19","17724124","17724437","21","98930"
"chr6","17629892","17630197","chr19","17728801","17729105","9","98909"
"chr6","17634439","17634586","chr19","17733030","17733175","11","98591"
"chr6","17634901","17635108","chr19","17733475","17733655","38","98574"
"chr6","17650896","17651187","chr19","17756074","17756375","15","105178"
"chr6","17654506","17654809","chr19","17749580","17749880","9","95074"
"chr6","17656316","17656488","chr19","17757807","17757984","21","101491"
"chr6","17656553","17656853","chr19","17758049","17758353","6","101496"
"chr6","17658503","17658800","chr19","17750766","17751061","13","92263"
"chr6","17671656","17671971","chr14","103561503","103561817","62","85889847"
"chr6","17679972","17680276","chrX","17125928","17126236","80","554044"
"chr6","17680440","17680750","chr19","17780923","17781241","10","100483"
"chr6","17688862","17689149","chr19","17789409","17789699","12","100547"
"chr6","17690367","17690666","chr19","17791143","17791442","4","100776"
"chr6","17699762","17699970","chr19","17800516","17800722","5","100754"
"chr6","17701580","17701876","chr19","17802680","17802977","8","101100"
"chr6","17705679","17705964","chr19","17806778","17807068","10","101099"
"chr6","17717919","17718185","chr19","17816333","17816599","4","98414"
"chr6","17720311","17720605","chr19","17818719","17819012","5","98408"
"chr6","17731540","17731553","chr19","2525855","2525868","2","15205685"
"chr6","17731631","17731914","chr19","17836561","17836841","11","104930"
"chr6","17750906","17751173","chr19","17856359","17856626","9","105453"
"chr6","17754154","17754399","chr19","17859902","17860147","4","105748"
"chr6","17759620","17759925","chr19","17865156","17865446","20","105536"
"chr6","17759950","17760254","chr19","17865480","17865782","11","105530"
"chr6","17772204","17772510","chr19","17878871","17879173","8","106667"
"chr6","17775818","17776030","chr19","17883088","17883294","8","107270"
"chr6","17781241","17781516","chr19","17889087","17889362","5","107846"
"chr6","17783093","17783369","chr8","44115676","44115967","61","26332583"
"chr6","17786613","17786895","chr19","17894792","17895079","11","108179"
"chr6","17791675","17791872","chr6","16199787","16199985","43","1591888"
"chr6","17802004","17802139","chr19","17911212","17911347","1","109208"
"chr6","17813398","17813700","chr13","44773453","44773752","62","26960055"
"chr6","17821576","17821655","chr19","17931953","17932032","5","110377"
"chr6","17822392","17822693","chr19","17933816","17934120","11","111424"
"chr6","17822954","17823157","chr19","17934379","17934566","19","111425"
"chr6","17823756","17823911","chr19","17937063","17937224","6","113307"
"chr6","17830191","17830256","chr1","45929207","45929267","16","28099016"
"chr6","17832705","17832841","chr8","128372425","128372560","24","110539720"
"chr6","17834238","17834329","chr3","48157715","48157805","18","30323477"
"chr6","17844022","17844132","chr7","77599294","77599406","19","59755272"
"chr6","17845698","17845974","chr19","17958959","17959235","10","113261"
"chr6","17850592","17850892","chr19","17963855","17964155","7","113263"
"chr6","17853158","17853466","chr2","101388871","101389178","52","83535713"
"chr6","17861338","17861584","chr19","17975203","17975452","8","113865"
"chr6","17878519","17878673","chr19","17993619","17993781","15","115100"
"chr6","17887086","17887140","chr19","18001869","18001923","2","114783"
"chr6","17887141","17887418","chr19","18001924","18002186","20","114783"
"chr6","17888678","17889025","chr8","8454666","8455007","81","9434012"
"chr6","17894638","17894846","chr19","18010007","18010215","3","115369"
"chr6","17896007","17896292","chr19","18011393","18011678","5","115386"
"chr6","17899119","17899272","chr11","65960052","65960209","27","48060933"
"chr6","17905011","17905306","chr19","18020693","18020957","39","115682"
"chr6","17907406","17907555","chr5","78587456","78587592","35","60680050"
"chr6","17910616","17910803","chr19","18025689","18025874","4","115073"
"chr6","17916316","17916604","chr15","39047083","39047375","59","21130767"
"chr6","17944791","17945091","chr19","18061167","18061464","4","116376"
"chr6","17957989","17958271","chr19","18073998","18074287","9","116009"
"chr6","17966206","17966482","chr19","18082503","18082779","2","116297"
"chr6","17977573","17977852","chr3","128950956","128951248","68","110973383"
"chr6","17978342","17978476","chr19","18096174","18096305","3","117832"
"chr6","17990449","17990530","chr17","7877709","7877789","20","10112740"
"chr6","17993362","17993537","chr19","18110681","18110856","2","117319"
"chr6","18022146","18022317","chr19","18138941","18139107","11","116795"
"chr6","18022616","18022757","chr19","18139410","18139551","2","116794"
"chr6","18038576","18038840","chr19","18158185","18158449","8","119609"
"chr6","18041612","18041915","chr19","18165031","18165334","4","123419"
"chr6","18062957","18063176","chr16","39997475","39997689","39","21934518"
"chr6","18063807","18063859","chr19","18184476","18184522","7","120669"
"chr6","18064163","18064333","chr4","35852287","35852450","28","17788124"
"chr6","18076364","18076667","chr19","18197236","18197526","18","120872"
"chr6","18128001","18128185","chr19","18249985","18250171","6","121984"
"chr6","18128206","18128489","chr19","18250192","18250475","6","121986"
"chr6","18137379","18137458","chr1","146054287","146054366","20","127916908"
"chr6","18137770","18137780","chr5","34385735","34385746","4","16247965"
"chr6","18138096","18138264","chr13","37699798","37699966","28","19561702"
"chr6","18138600","18138884","chrX","107187636","107187923","52","89049036"
"chr6","18143056","18143208","chr19","18269594","18269743","9","126538"
"chr6","18145537","18145832","chr19","18265868","18266145","28","120331"
"chr6","18147297","18147563","chr1","30332304","30332596","61","12185007"
"chr6","18152730","18152951","chr19","18278252","18278425","52","125522"
"chr6","18153219","18153355","chr19","18278748","18278882","6","125529"
"chr6","18183475","18183758","chr19","18309183","18309466","8","125708"
"chr6","18215242","18215554","chr16","41812244","41812543","63","23597002"
"chr6","18265867","18266175","chr19","18389673","18389982","6","123806"
"chr6","18310899","18311047","chr19","11159237","11159384","33","7151662"
"chr6","18319944","18320277","chr19","18632653","18632962","59","312709"
"chr6","18381354","18381596","chr19","18529579","18529827","35","148225"
"chr6","18391949","18392253","chr19","18744972","18745275","33","353023"
"chr6","18407257","18407590","chr19","18416888","18417216","14","9631"
"chr6","18423600","18423851","chr19","18436224","18436475","2","12624"
"chr6","18426692","18426806","chr19","18439316","18439432","2","12624"
"chr6","18467365","18467554","chr19","18485698","18485887","5","18333"
"chr6","18509574","18509822","chr19","18529579","18529827","2","20005"
"chr6","18526787","18527040","chr19","18549061","18549318","13","22274"
"chr6","18554986","18555236","chr19","18581425","18581676","2","26439"
"chr6","18573255","18573564","chr19","18598537","18598834","25","25282"
"chr6","18584670","18584973","chr19","18611705","18612006","9","27035"
"chr6","18617375","18617630","chr19","18549061","18549318","41","68314"
"chr6","18665176","18665475","chr19","18673624","18673923","7","8448"
"chr6","18684735","18685035","chr19","18893439","18893727","50","208704"
"chr6","18710814","18711069","chr19","18728934","18729189","0","18120"
"chr6","18725843","18726146","chr19","18744972","18745275","15","19129"
"chr6","18742107","18742397","chr19","18761528","18761818","8","19421"
"chr6","18748001","18748289","chr19","18767375","18767670","14","19374"
"chr6","18777307","18777560","chr19","18794829","18795069","18","17522"
"chr6","18798620","18798872","chr19","18581425","18581676","35","217195"
"chr6","18846765","18847057","chr19","18893439","18893727","14","46674"
"chr6","18945343","18945654","chr19","18958334","18958642","5","12991"
"chr6","18968755","18969047","chr19","18981807","18982099","3","13052"
"chr6","19022665","19022962","chr12","57440584","57440872","65","38417919"
"chr6","19042842","19043009","chr13","37699798","37699966","40","18656956"
"chr6","19043329","19043475","chr7","66141410","66141542","42","47098081"
"chr6","19044452","19044744","chr19","19058792","19059079","7","14340"
"chr6","19083921","19084008","chr19","20110858","20110949","23","1026937"
"chr6","19085040","19085125","chr19","20110858","20110949","30","1025818"
"chr6","19085611","19085698","chr19","20110858","20110949","25","1025247"
"chr6","19086939","19087220","chr11","6555732","6556015","52","12531207"
"chr6","19112352","19112630","chrX","55251365","55251639","21","36139013"
"chr6","19140954","19141216","chr19","20695847","20696140","39","1554893"
"chr6","19183947","19184190","chr13","57971791","57972040","64","38787844"
"chr6","19186750","19187021","chr6","126650613","126650885","53","107463863"
"chr6","19217356","19217664","chr16","20194767","20195077","4","977411"
"chr6","19235918","19236185","chr19","20659307","20659575","11","1423389"
"chr6","19257813","19257928","chr2","77231227","77231352","28","57973414"
"chr6","19258056","19258213","chr6","131377998","131378160","38","112119942"
"chr6","19260422","19260683","chr19","19135880","19136141","4","124542"
"chr6","19356357","19356640","chr19","19228949","19229250","26","127408"
"chr6","19366516","19366805","chr19","20630980","20631273","65","1264464"
"chr6","19372466","19372768","chr19","19244903","19245204","15","127563"
"chr6","19385772","19386063","chr19","19257614","19257907","9","128158"
"chr6","19440538","19440723","chr19","19343891","19344109","37","96647"
"chr6","19441237","19441323","chr19","19344951","19345031","10","96286"
"chr6","19441905","19442128","chr19","19343891","19344109","7","98014"
"chr6","19442637","19442723","chr19","19344951","19345031","9","97686"
"chr6","19459446","19459741","chr19","19361045","19361344","16","98401"
"chr6","19510208","19510350","chr19","19757133","19757279","29","246925"
"chr6","19522830","19523122","chr19","19431165","19431454","10","91665"
"chr6","19523254","19523386","chr19","19431591","19431721","3","91663"
"chr6","19525939","19526237","chr19","19434246","19434545","8","91693"
"chr6","19526700","19526831","chr19","19435004","19435135","6","91696"
"chr6","19548982","19549260","chr19","19463022","19463297","10","85960"
"chr6","19560821","19561162","chr19","19474376","19474731","21","86445"
"chr6","19597471","19597754","chr19","19497258","19497541","5","100213"
"chr6","19641392","19641693","chr19","19552321","19552622","5","89071"
"chr6","19648768","19649056","chr19","19559828","19560102","20","88940"
"chr6","19663706","19663743","chr19","19582019","19582056","0","81687"
"chr6","19719586","19719696","chr14","6515503","6515615","23","13204083"
"chr6","19728199","19728490","chr19","19629501","19629792","6","98698"
"chr6","19738898","19739207","chr19","19642291","19642604","28","96607"
"chr6","19745193","19745487","chr19","19647857","19648152","15","97336"
"chr6","19758031","19758338","chr19","19595483","19595809","46","162548"
"chr6","19763097","19763330","chr3","128206065","128206304","59","108442968"
"chr6","19839569","19839826","chr19","20363723","20363989","62","524154"
"chr6","19850298","19850554","chr19","19978148","19978404","22","127850"
"chr6","19894370","19894672","chr19","19806740","19807046","13","87630"
"chr6","19934812","19934822","chr7","85386103","85386113","0","65451291"
"chr6","19934856","19934997","chr5","105024490","105024635","30","85089634"
"chr6","20014752","20015040","chr19","19826882","19827170","9","187870"
"chr6","20094207","20094513","chr19","19909161","19909467","9","185046"
"chr6","20108719","20108989","chr19","19927257","19927525","5","181462"
"chr6","20158134","20158378","chr19","19978148","19978404","19","179986"
"chr6","20227757","20228074","chr12","62799016","62799324","73","42571259"
"chr6","20236298","20236454","chr19","20067197","20067365","17","169101"
"chr6","20247706","20248001","chr19","19629501","19629792","79","618205"
"chr6","20282396","20282495","chr10","9670097","9670199","19","10612299"
"chr6","20298971","20299264","chr7","123718994","123719282","76","103420023"
"chr6","20309420","20309717","chr13","61013429","61013730","55","40704009"
"chr6","20326441","20326455","chr17","72134473","72134487","1","51808032"
"chr6","20326481","20326774","chr3","52964593","52964865","81","32638112"
"chr6","20386764","20387096","chr1","164663573","164663895","77","144276809"
"chr6","20425093","20425376","chr14","21160986","21161269","73","735893"
"chr6","20468106","20468413","chr19","13789924","13790221","60","6678182"
"chr6","20512760","20513039","chr3","52964593","52964865","68","32451833"
"chr6","20522126","20522432","chr3","38584626","38584921","62","18062500"
"chr6","20529808","20530101","chr7","14483821","14484118","70","6045987"
"chr6","20532038","20532133","chr8","96649061","96649154","16","76117023"
"chr6","20560255","20560543","chr7","14286956","14287238","75","6273299"
"chr6","20574361","20574628","chr19","19927257","19927525","71","647104"
"chr6","20609025","20609168","chr12","92451179","92451318","37","71842154"
"chr6","20609661","20609750","chr13","48074157","48074236","25","27464496"
"chr6","20609936","20610065","chrX","61671031","61671155","32","41061095"
"chr6","20610260","20610574","chr2","90884759","90885054","69","70274499"
"chr6","20610686","20610806","chr14","61647335","61647457","22","41036649"
"chr6","20617878","20618038","chr9","17489159","17489316","42","3128719"
"chr6","20618039","20618122","chr9","56569424","56569511","19","35951385"
"chr6","20618242","20618529","chr14","31139081","31139358","87","10520839"
"chr6","20634502","20634788","chr3","53279460","53279745","75","32644958"
"chr6","20643673","20643816","chr19","20067197","20067365","34","576476"
"chr6","20651710","20651883","chr4","119074513","119074677","36","98422803"
"chr6","20651918","20652022","chr6","115807384","115807489","19","95155466"
"chr6","20763708","20763815","chr7","70444956","70445052","36","49681248"
"chr6","20799992","20800266","chr19","19463022","19463297","55","1336970"
"chr6","20823750","20823921","chr7","36378179","36378355","35","15554429"
"chr6","20884529","20884812","chr1","109215125","109215406","69","88330596"
"chr6","21061238","21061481","chr19","20200309","20200576","67","860929"
"chr6","21132994","21133245","chr6","90799933","90800190","69","69666939"
"chr6","21133962","21134240","chr4","119713035","119713321","67","98579073"
"chr6","21196429","21196706","chr7","147769026","147769287","71","126572597"
"chr6","21290190","21290458","chr17","4324885","4325154","69","16965305"
"chr6","21291487","21291754","chr19","20200309","20200576","9","1091178"
"chr6","21310752","21311017","chr1","16014612","16014884","71","5296140"
"chr6","21356734","21357011","chr19","20106614","20106891","15","1250120"
"chr6","21392180","21392472","chr19","19463022","19463297","72","1929158"
"chr6","21411899","21411986","chr1","64903265","64903343","31","43491366"
"chr6","21412142","21412428","chr19","20596759","20597035","50","815383"
"chr6","21412578","21412716","chr19","20597189","20597324","18","815389"
"chr6","21439436","21439646","chr19","20332913","20333118","36","1106523"
"chr6","21512665","21512904","chr4","43105703","43105947","73","21593038"
"chr6","21549707","21549794","chr15","22318144","22318226","28","768437"
"chr6","21560027","21560285","chr19","20570017","20570275","4","990010"
"chr6","21593818","21593896","chr8","139390357","139390427","26","117796539"
"chr6","21594047","21594334","chr19","20596759","20597035","17","997288"
"chr6","21594490","21594626","chr19","20597189","20597324","1","997301"
"chr6","21627908","21628201","chr19","20630980","20631273","6","996928"
"chr6","22790781","22791085","chr19","22212411","22212695","24","578370"
"chr6","22804381","22804438","chr8","28824525","28824574","17","6020144"
"chr6","22804457","22804606","chr19","22223139","22223295","14","581318"
"chr6","22804846","22804984","chr2","46434","46586","37","22758412"
"chr6","22807633","22807888","chr19","22226456","22226723","21","581177"
"chr6","22808032","22808159","chr19","22226855","22226992","16","581177"
"chr6","23034267","23034567","chr3","49634161","49634472","58","26599894"
"chr6","23050038","23050315","chr19","22511077","22511354","6","538961"
"chr6","23247000","23247149","chr19","22718461","22718610","8","528539"
"chr6","23254617","23254765","chr19","22726129","22726277","6","528488"
"chr6","23257309","23257594","chr19","22728768","22729082","37","528541"
"chr6","23283567","23283880","chr5","46461086","46461387","73","23177519"
"chr6","23403996","23404242","chr19","22886565","22886812","9","517431"
"chr6","23437476","23437598","chr19","22925193","22925315","3","512283"
"chr6","23495647","23495932","chr19","22977430","22977715","6","518217"
"chr6","23503100","23503386","chr19","22984907","22985195","12","518193"
"chr6","23537103","23537263","chr3","178210714","178210870","35","154673611"
"chr6","23572119","23572328","chr19","23055266","23055479","13","516853"
"chr6","23590687","23590971","chrX","45599398","45599690","59","22008711"
"chr6","23625951","23626156","chr19","23109381","23109559","42","516570"
"chr6","23626201","23626319","chr19","23109612","23109730","4","516589"
"chr6","23643641","23643836","chr19","23134279","23134454","24","509362"
"chr6","23699401","23699676","chr19","23193199","23193478","6","506202"
"chr6","23713637","23713930","chr19","23207428","23207720","10","506209"
"chr6","23730701","23730991","chr19","23222534","23222820","14","508167"
"chr6","23820567","23820881","chr19","23311629","23311938","11","508938"
"chr6","23890203","23890499","chr19","23381402","23381705","16","508801"
"chr6","23961948","23962002","chr19","23451835","23451889","0","510113"
"chr6","23976976","23977117","chr19","23468557","23468696","8","508419"
"chr6","23993905","23994213","chr19","23484452","23484764","15","509453"
"chr6","23996635","23996777","chr19","23487186","23487328","4","509449"
"chr6","24078761","24078909","chr19","23569821","23569969","4","508940"
"chr6","24104767","24104945","chr11","45377982","45378154","35","21273215"
"chr6","24268595","24268898","chr19","23761238","23761541","5","507357"
"chr6","24270211","24270345","chr19","23762854","23762988","8","507357"
"chr6","24317507","24317804","chr19","23811105","23811402","17","506402"
"chr6","24326638","24326788","chr19","23820231","23820380","4","506407"
"chr6","24462294","24462571","chr19","23957693","23957954","28","504601"
"chr6","24579175","24579464","chr19","24075749","24076038","10","503426"
"chr6","24638389","24638669","chr19","24135573","24135884","43","502816"
"chr6","24692781","24692956","chr19","24189190","24189363","17","503591"
"chr6","24708458","24708491","chr10","18349163","18349196","4","6359295"
"chr6","24709602","24709704","chr19","24206466","24206568","5","503136"
"chr6","24718715","24719024","chr19","24224155","24224468","17","494560"
"chr6","24722555","24722788","chr19","24217998","24218231","4","504557"
"chr6","24728230","24728531","chr19","24227031","24227305","34","501199"
"chr6","24729292","24729412","chr1","19748519","19748641","33","4980773"
"chr6","24732546","24732823","chr11","42076305","42076571","80","17343759"
"chr6","24746017","24746327","chr19","24244351","24244655","11","501666"
"chr6","24752173","24752434","chr19","24250493","24250790","41","501680"
"chr6","24800190","24800492","chr19","24297762","24298048","32","502428"
"chr6","24804959","24805279","chr19","24303565","24303882","19","501394"
"chr6","24817215","24817304","chr1","157829766","157829843","22","133012551"
"chr6","24817370","24817515","chr3","9178205","9178330","53","15639165"
"chr6","24827545","24827828","chr19","24338113","24338396","6","489432"
"chr6","24828934","24829212","chr19","24339514","24339790","14","489420"
"chr6","24854281","24854436","chr19","24363883","24364038","2","490398"
"chr6","24872167","24872471","chr19","24382208","24382508","18","489959"
"chr6","24883968","24884246","chr19","24396505","24396783","6","487463"
"chr6","24890017","24890158","chr4","78979056","78979187","35","54089039"
"chr6","24890497","24890775","chr19","24396505","24396783","6","493992"
"chr6","24896241","24896530","chr16","41671981","41672272","50","16775740"
"chr6","24897995","24898174","chr16","42030742","42030915","32","17132747"
"chr6","24908217","24908313","chrX","107340760","107340852","17","82432543"
"chr6","24928608","24928805","chr14","100609395","100609599","45","75680787"
"chr6","24948822","24949123","chr18","1139830","1140130","71","23808992"
"chr6","24978215","24978392","chr19","24485465","24485632","17","492750"
"chr6","24997991","24998266","chr19","24507365","24507651","53","490626"
"chr6","25176937","25177245","chr19","24688585","24688889","16","488352"
"chr6","25262911","25262967","chr11","110640487","110640539","10","85377576"
"chr6","25291757","25292047","chr19","24805731","24806027","17","486026"
"chr6","25300256","25300389","chr19","24814389","24814519","5","485867"
"chr6","25316342","25316526","chr19","24830658","24830842","3","485684"
"chr6","25323389","25323688","chrX","96168692","96168977","60","70845303"
"chr6","25343114","25343413","chr2","21697149","21697445","64","3645965"
"chr6","25375390","25375719","chr19","24890209","24890522","27","485181"
"chr6","25384295","25384523","chr19","24898840","24899068","4","485455"
"chr6","25384583","25384642","chr4","121284352","121284413","11","95899769"
"chr6","25406825","25407046","chr19","24921215","24921439","9","485610"
"chr6","25489995","25490275","chr6","65772660","65772931","61","40282665"
"chr6","25506778","25507056","chr19","25018999","25019277","9","487779"
"chr6","25517494","25517648","chr10","85522515","85522663","33","60005021"
"chr6","25558936","25558950","chr1","15101615","15101626","3","10457321"
"chr6","25679022","25679327","chr19","25194636","25194941","1","484386"
"chr6","25728203","25728327","chr19","25244169","25244296","9","484034"
"chr6","25769602","25769942","chr19","25285644","25285964","31","483958"
"chr6","25786105","25786396","chr18","41366645","41366936","59","15580540"
"chr6","25893069","25893355","chr19","25409673","25409928","41","483396"
"chr6","25947802","25948115","chr19","25464222","25464526","25","483580"
"chr6","25964085","25964200","chr19","25480204","25480305","15","483881"
"chr6","25975424","25975727","chr19","25491464","25491757","20","483960"
"chr6","26001925","26002196","chr19","25518644","25518904","24","483281"
"chr6","26004519","26004629","chr19","25521250","25521360","3","483269"
"chr6","26005087","26005193","chr19","25521814","25521920","1","483273"
"chr6","26043755","26044049","chr19","25560127","25560424","20","483628"
"chr6","26076105","26076411","chr19","25592368","25592674","13","483737"
"chr6","26078420","26078653","chr13","24884014","24884250","64","1194406"
"chr6","26155789","26156099","chr19","25670849","25671163","15","484940"
"chr6","26285977","26286272","chr19","25796374","25796669","4","489603"
"chr6","26303050","26303353","chr19","25813068","25813372","7","489982"
"chr6","26392745","26393026","chr19","25901883","25902164","0","490862"
"chr6","26419560","26419697","chr10","82238956","82239091","21","55819396"
"chr6","26423861","26424145","chr19","25933143","25933416","16","490718"
"chr6","26428594","26428903","chr19","25937933","25938243","11","490661"
"chr6","26438435","26438651","chr19","25947598","25947805","21","490837"
"chr6","26452604","26452888","chrX","45459917","45460198","61","19007313"
"chr6","26517974","26518197","chr19","26027655","26027878","6","490319"
"chr6","26542409","26542728","chr20","39705042","39705349","70","13162633"
"chr6","26544081","26544335","chr19","26056806","26057043","27","487275"
"chr6","26545982","26546282","chr19","26058696","26058990","12","487286"
"chr6","26561575","26561876","chr19","26073550","26073849","14","488025"
"chr6","26588328","26588626","chr19","26100883","26101180","13","487445"
"chr6","26636519","26636638","chr19","26153522","26153641","1","482997"
"chr6","26636679","26636764","chr19","4597905","4597993","16","22038774"
"chr6","26657420","26657724","chr19","26174660","26174953","25","482760"
"chr6","26673275","26673554","chr19","26190576","26190855","9","482699"
"chr6","26758069","26758388","chr19","26276229","26276547","7","481840"
"chr6","26791370","26791649","chr19","26309857","26310162","33","481513"
"chr6","26838772","26839066","chr19","26356835","26357118","23","481937"
"chr6","26866378","26866497","chr19","26387959","26388078","4","478419"
"chr6","26866981","26867179","chr19","26388562","26388761","8","478419"
"chr6","26884897","26885062","chr19","26406856","26407035","17","478041"
"chr6","26885091","26885220","chr16","54596164","54596297","28","27711073"
"chr6","26909493","26909790","chr19","26462687","26462986","11","446806"
"chr6","26971138","26971424","chr19","26528266","26528554","10","442872"
"chr6","26994883","26995133","chr8","76427874","76428118","54","49432991"
"chr6","26995488","26995533","chr7","12956510","12956553","9","14038978"
"chr6","27027313","27027535","chr19","26584265","26584487","11","443048"
"chr6","27116613","27116906","chr19","26674968","26675262","11","441645"
"chr6","27131479","27131758","chr19","26689913","26690192","6","441566"
"chr6","27174181","27174447","chr19","26731393","26731659","3","442788"
"chr6","27183628","27183799","chr19","26740735","26740897","11","442893"
"chr6","27211080","27211417","chr19","26767905","26768207","40","443175"
"chr6","27237430","27237733","chr4","59473134","59473428","50","32235704"
"chr6","27261658","27261949","chr19","26818602","26818891","14","443056"
"chr6","27280482","27280573","chr1","24072214","24072303","15","3208268"
"chr6","27282144","27282440","chr19","26842768","26843068","7","439376"
"chr6","27298717","27299026","chr19","26858451","26858757","15","440266"
"chr6","27326830","27327136","chr19","26886853","26887165","16","439977"
"chr6","27329402","27329689","chr19","26889278","26889562","9","440124"
"chr6","27344445","27344726","chr19","26903026","26903324","27","441419"
"chr6","27348084","27348298","chr19","26906677","26906862","34","441407"
"chr6","27369382","27369696","chr19","26928895","26929209","22","440487"
"chr6","27370445","27370722","chr19","26929958","26930241","14","440487"
"chr6","27375267","27375496","chr19","26934640","26934902","37","440627"
"chr6","27375826","27375890","chr19","26935199","26935268","6","440627"
"chr6","27387395","27387645","chr1","112243141","112243383","55","84855746"
"chr6","27433029","27433191","chr11","109860880","109861035","27","82427851"
"chr6","27438345","27438624","chr19","26996838","26997117","3","441507"
"chr6","27445473","27445638","chr19","27003755","27003919","2","441718"
"chr6","27446413","27446551","chr19","27004695","27004833","3","441718"
"chr6","27450761","27450876","chr1","167901424","167901540","20","140450663"
"chr6","27452129","27452430","chr17","4186333","4186632","52","23265796"
"chr6","27462499","27462789","chr19","27020788","27021078","7","441711"
"chr6","27473615","27473898","chr19","27031846","27032125","17","441769"
"chr6","27474312","27474527","chr19","27032538","27032756","9","441774"
"chr6","27476880","27477183","chr19","27035437","27035736","31","441443"
"chr6","27479965","27480260","chr19","27038494","27038791","7","441471"
"chr6","27480487","27480796","chr19","27039011","27039322","11","441476"
"chr6","27494553","27494858","chr19","27053098","27053400","7","441455"
"chr6","27541033","27541337","chr19","27099688","27099987","17","441345"
"chr6","27572398","27572707","chr19","27131737","27132039","28","440661"
"chr6","27574095","27574377","chr7","89468182","89468470","61","61894087"
"chr6","27579357","27579649","chr13","8385127","8385426","55","19194230"
"chr6","27585047","27585283","chr19","27143931","27144167","4","441116"
"chr6","27595135","27595434","chr19","27154088","27154391","13","441047"
"chr6","27611973","27612131","chr19","27170354","27170522","12","441619"
"chr6","27612132","27612462","chr19","27170525","27170846","18","441607"
"chr6","27612463","27612477","chr1","8928246","8928258","3","18684217"
"chr6","27614938","27615231","chr14","6799945","6800241","53","20814993"
"chr6","27632935","27633195","chr9","124548816","124549088","67","96915881"
"chr6","27651514","27651814","chr4","132023114","132023423","62","104371600"
"chr6","27654304","27654621","chr7","51567455","51567765","65","23913151"
"chr6","27670492","27670799","chr1","28519593","28519896","56","849101"
"chr6","27674473","27674754","chr19","27234108","27234388","16","440365"
"chr6","27679702","27679880","chr19","27239417","27239595","8","440285"
"chr6","27702621","27702929","chr19","27263555","27263874","23","439066"
"chr6","27714020","27714210","chr1","23189801","23189980","47","4524219"
"chr6","27717997","27718270","chr19","27279461","27279712","25","438536"
"chr6","27737331","27737609","chr19","27299366","27299643","11","437965"
"chr6","27754407","27754696","chr19","27316847","27317142","11","437560"
"chr6","27760963","27761027","chr3","41742560","41742624","15","13981597"
"chr6","27792648","27792982","chr19","27355879","27356214","8","436769"
"chr6","27802676","27802961","chr19","27365591","27365880","12","437085"
"chr6","27807637","27807748","chr3","157051887","157051998","17","129244250"
"chr6","27813820","27814098","chr13","89200096","89200382","68","61386276"
"chr6","27851412","27851575","chr19","27414562","27414732","16","436850"
"chr6","27854081","27854216","chr20","5354555","5354688","21","22499526"
"chr6","27857254","27857413","chr18","55869658","55869818","32","28012404"
"chr6","27876532","27876800","chr19","27439403","27439678","33","437129"
"chr6","27883576","27883884","chr19","27446913","27447220","16","436663"
"chr6","27897352","27897636","chr19","27461032","27461316","11","436320"
"chr6","27898804","27898986","chr19","27462493","27462675","6","436311"
"chr6","27916324","27916502","chr19","27480240","27480412","9","436084"
"chr6","27950945","27951216","chr1","34614102","34614378","59","6663157"
"chr6","27953100","27953159","chr4","30197889","30197946","19","2244789"
"chr6","27953841","27953973","chr12","32712535","32712667","24","4758694"
"chr6","27963260","27963548","chr4","128666038","128666323","51","100702778"
"chr6","27967165","27967471","chr19","27534652","27534957","7","432513"
"chr6","27981875","27982171","chr19","27549387","27549679","18","432488"
"chr6","27982623","27982752","chr19","27550135","27550258","11","432488"
"chr6","27983650","27983938","chr19","27551263","27551552","10","432387"
"chr6","27985831","27985988","chrX","49745559","49745718","27","21759728"
"chr6","27987521","27987850","chr19","27554835","27555166","12","432686"
"chr6","27987854","27988137","chr19","27555170","27555455","13","432684"
"chr6","27992912","27993225","chr19","27560191","27560504","8","432721"
"chr6","27994342","27994639","chr19","27561618","27561910","12","432724"
"chr6","27994975","27995297","chr1","31113174","31113485","69","3118199"
"chr6","28004863","28005107","chr19","27573124","27573361","19","431739"
"chr6","28005122","28005432","chr19","27573376","27573692","22","431746"
"chr6","28033664","28033953","chr5","135094211","135094500","56","107060547"
"chr6","28038628","28038673","chr6","148291297","148291342","12","120252669"
"chr6","28038675","28038953","chr17","71881513","71881788","58","43842838"
"chr6","28042556","28042848","chr8","66032653","66032943","60","37990097"
"chr6","28051869","28052078","chr4","84719245","84719464","39","56667376"
"chr6","28052167","28052252","chr19","27621669","27621754","2","430498"
"chr6","28052438","28052655","chr19","27621939","27622156","9","430499"
"chr6","28053386","28053641","chr19","27622890","27623144","11","430496"
"chr6","28061892","28062158","chr19","27631128","27631389","12","430764"
"chr6","28064314","28064479","chr19","27633700","27633865","4","430614"
"chr6","28065106","28065405","chr19","27634830","27635129","9","430276"
"chr6","28069520","28069811","chr19","27639596","27639887","5","429924"
"chr6","28092685","28092984","chr19","27662404","27662700","10","430281"
"chr6","28095506","28095807","chrX","46200808","46201119","66","18105302"
"chr6","28098630","28098798","chr19","27668376","27668541","6","430254"
"chr6","28103728","28103909","chr19","27673961","27674127","24","429767"
"chr6","28109786","28109831","chr19","27679052","27679097","0","430734"
"chr6","28110138","28110316","chr19","27679404","27679571","14","430734"
"chr6","28112847","28113141","chr19","27682366","27682655","15","430481"
"chr6","28114232","28114525","chr7","56330857","56331155","59","28216625"
"chr6","28125029","28125326","chr4","112871723","112872010","78","84746694"
"chr6","28134470","28134757","chr19","27705694","27705998","22","428776"
"chr6","28135118","28135409","chr19","27706347","27706638","10","428771"
"chr6","28144020","28144299","chr4","13092091","13092375","59","15051929"
"chr6","28154652","28154944","chr19","27727081","27727377","16","427571"
"chr6","28180080","28180368","chr19","27752846","27753135","6","427234"
"chr6","28186152","28186456","chr19","27759012","27759304","23","427140"
"chr6","28200548","28200856","chr19","27773450","27773752","19","427098"
"chr6","28200896","28201063","chr19","27773790","27773959","5","427106"
"chr6","28201505","28201632","chr19","27774401","27774528","2","427104"
"chr6","28201633","28201938","chr11","101102453","101102748","68","72900820"
"chr6","28201960","28202261","chr19","27774854","27775155","9","427106"
"chr6","28263150","28263431","chr19","27835836","27836122","15","427314"
"chr6","28297355","28297645","chr6","156887783","156888072","64","128590428"
"chr6","28301118","28301414","chr19","27875720","27876016","14","425398"
"chr6","28336515","28336776","chr19","27911982","27912233","15","424533"
"chr6","28337090","28337110","chr1","161175085","161175105","0","132837995"
"chr6","28358142","28358431","chr19","27934772","27935066","22","423370"
"chr6","28360484","28360780","chr19","27937261","27937557","23","423223"
"chr6","28362088","28362373","chr19","27938862","27939144","11","423226"
"chr6","28371469","28371777","chr19","27949192","27949501","12","422277"
"chr6","28374915","28375208","chr19","27952649","27952942","4","422266"
"chr6","28394692","28394812","chr8","95162107","95162229","20","66767415"
"chr6","28395103","28395284","chr19","27975335","27975526","15","419768"
"chr6","28397507","28397787","chr19","27977391","27977698","34","420116"
"chr6","28404989","28405282","chr19","27984880","27985173","8","420109"
"chr6","28412674","28412952","chr19","27992301","27992567","19","420373"
"chr6","28413724","28414048","chr19","27993362","27993687","9","420362"
"chr6","28452683","28452996","chr19","28031115","28031428","15","421568"
"chr6","28497159","28497399","chr19","28076132","28076372","7","421027"
"chr6","28525260","28525561","chr19","28102676","28102977","13","422584"
"chr6","28557171","28557433","chr19","28135754","28136012","12","421417"
"chr6","28599998","28600178","chr14","4191239","4191412","34","24408759"
"chr6","28600484","28600602","chr20","11444007","11444128","23","17156477"
"chr6","28610914","28610961","chr19","28192035","28192082","0","418879"
"chr6","28611568","28611883","chr2","79560508","79560814","63","50948940"
"chr6","28612154","28612435","chr19","28193469","28193750","5","418685"
"chr6","28621227","28621520","chr19","28202018","28202311","3","419209"
"chr6","28633025","28633161","chr19","28213603","28213739","2","419422"
"chr6","28667661","28667949","chr20","36014034","36014314","55","7346373"
"chr6","28669209","28669220","chr5","109335192","109335203","0","80665983"
"chr6","28669258","28669542","chr19","28248400","28248694","20","420858"
"chr6","28696014","28696318","chr19","28275454","28275761","11","420560"
"chr6","28732111","28732415","chr19","28311056","28311350","19","421055"
"chr6","28748937","28749229","chr13","42593757","42594054","62","13844820"
"chr6","28828645","28828819","chr7","131017268","131017442","32","102188623"
"chr6","28829106","28829251","chr7","18520920","18521061","22","10308186"
"chr6","28858427","28858730","chr19","28446457","28446759","12","411970"
"chr6","28865654","28865957","chr19","28453057","28453349","20","412597"
"chr6","28893390","28893647","chr19","28485095","28485354","13","408295"
"chr6","28914922","28915205","chr19","28506645","28506929","8","408277"
"chr6","28926537","28926698","chr1","185923305","185923457","28","156996768"
"chr6","28951876","28952170","chr19","28543393","28543686","5","408483"
"chr6","28954386","28954697","chr12","99775777","99776096","66","70821391"
"chr6","28960644","28960950","chr19","28552213","28552516","12","408431"
"chr6","28961938","28962211","chr19","28553508","28553789","14","408430"
"chr6","28963692","28963856","chr19","28555272","28555420","22","408420"
"chr6","28995397","28995696","chr19","28587407","28587707","4","407990"
"chr6","29005382","29005662","chr19","28597484","28597803","46","407898"
"chr6","29020491","29020784","chr19","28613145","28613436","10","407346"
"chr6","29057851","29058153","chr19","28649605","28649903","11","408246"
"chr6","29058603","29058880","chr19","28650660","28650940","15","407943"
"chr6","29061140","29061295","chr20","11334333","11334491","28","17726807"
"chr6","29062335","29062609","chr3","10842594","10842866","54","18219741"
"chr6","29080008","29080281","chr19","28672537","28672814","18","407471"
"chr6","29084373","29084691","chr19","28676887","28677207","22","407486"
"chr6","29098638","29098945","chr19","28691351","28691653","18","407287"
"chr6","29101114","29101406","chr19","28693662","28693958","11","407452"
"chr6","29106398","29106558","chrX","112459585","112459748","25","83353187"
"chr6","29109304","29109610","chr19","38458407","38458711","51","9349103"
"chr6","29124541","29124828","chr19","28718617","28718918","21","405924"
"chr6","29129690","29130012","chr19","28723803","28724108","22","405887"
"chr6","29132323","29132452","chr19","40758560","40758690","23","11626237"
"chr6","29133049","29133360","chr19","28727491","28727802","10","405558"
"chr6","29135214","29135227","chr4","145371086","145371099","2","116235872"
"chr6","29135536","29135682","chr19","28730008","28730151","7","405528"
"chr6","29138162","29138512","chr3","46330527","46330868","81","17192365"
"chr6","29149094","29149398","chr19","28743842","28744151","13","405252"
"chr6","29152126","29152416","chr19","28746935","28747225","5","405191"
"chr6","29161794","29162099","chr19","28758762","28759057","17","403032"
"chr6","29175019","29175281","chr19","28775197","28775458","5","399822"
"chr6","29175472","29175757","chr19","28775646","28775934","15","399826"
"chr6","29196677","29197026","chr9","106530616","106530926","105","77333939"
"chr6","29199367","29199482","chr19","28799890","28799977","29","399477"
"chr6","29199526","29199820","chr19","28800388","28800681","9","399138"
"chr6","29203858","29204016","chr2","84229064","84229218","33","55025206"
"chr6","29219127","29219426","chr19","28820114","28820413","5","399013"
"chr6","29230103","29230411","chr19","28831745","28832053","5","398358"
"chr6","29235262","29235574","chr19","28837722","28838034","7","397540"
"chr6","29244040","29244311","chr19","28846500","28846771","6","397540"
"chr6","29244452","29244724","chr19","28846917","28847188","9","397535"
"chr6","29252499","29252760","chr19","28855252","28855514","5","397247"
"chr6","29253725","29253840","chr3","98073592","98073703","27","68819867"
"chr6","29254135","29254295","chr3","171688320","171688476","32","142434185"
"chr6","29261088","29261387","chr19","28858348","28858663","25","402740"
"chr6","29261593","29261893","chr19","28858863","28859173","20","402730"
"chr6","29275084","29275207","chr19","28878226","28878376","29","396858"
"chr6","29283525","29283839","chrX","7154436","7154747","56","22129089"
"chr6","29284837","29285015","chr19","28886612","28886790","3","398225"
"chr6","29290487","29290580","chr4","146141693","146141785","19","116851206"
"chr6","29293639","29293819","chr19","28895769","28895949","15","397870"
"chr6","29294122","29294257","chr19","28896253","28896388","1","397869"
"chr6","29295632","29295915","chr19","28897779","28898045","23","397853"
"chr6","29296977","29297268","chr15","74997352","74997644","54","45700375"
"chr6","29309986","29310237","chr16","73796312","73796573","54","44486326"
"chr6","29331863","29331982","chr1","93006966","93007090","29","63675103"
"chr6","29335564","29335861","chr19","28939107","28939394","13","396457"
"chr6","29338973","29339274","chr19","28942971","28943266","10","396002"
"chr6","29362890","29363236","chr1","65029556","65029903","71","35666666"
"chr6","29371750","29371988","chr1","191212387","191212611","58","161840637"
"chr6","29383936","29384072","chr19","1298656","1298782","31","28085280"
"chr6","29384092","29384136","chr6","148291297","148291342","7","118907205"
"chr6","29386968","29387146","chr7","147810756","147810933","28","118423788"
"chr6","29387447","29387582","chr6","10063624","10063754","29","19323823"
"chr6","29390002","29390148","chr19","28996591","28996737","0","393411"
"chr6","29409021","29409194","chr19","29016725","29016898","5","392296"
"chr6","29409988","29410095","chr19","29017713","29017815","6","392275"
"chr6","29448502","29448763","chr16","42880853","42881116","59","13432351"
"chr6","29448998","29449225","chr19","29049666","29049899","25","399332"
"chr6","29451996","29452257","chr19","29052775","29053038","8","399221"
"chr6","29453241","29453343","chr1","188856213","188856313","15","159402972"
"chr6","29464289","29464350","chr6","33215730","33215788","15","3751441"
"chr6","29471133","29471382","chr19","29066172","29066438","22","404961"
"chr6","29479467","29479628","chr19","29082794","29082950","8","396673"
"chr6","29481977","29482186","chr19","29085297","29085503","7","396680"
"chr6","29482254","29482543","chr19","29085574","29085863","11","396680"
"chr6","29492229","29492397","chr19","29096131","29096290","15","396098"
"chr6","29497156","29497445","chr19","29101085","29101373","7","396071"
"chr6","29518998","29519013","chr15","88360174","88360188","4","58841176"
"chr6","29524415","29524710","chr19","29128596","29128893","11","395819"
"chr6","29525906","29526075","chr7","17036882","17037043","36","12489024"
"chr6","29529146","29529428","chr19","29133903","29134176","18","395243"
"chr6","29529461","29529484","chr11","100832966","100832990","5","71303505"
"chr6","29533290","29533436","chr3","104055274","104055407","41","74521984"
"chr6","29535839","29535998","chr1","159504220","159504375","31","129968381"
"chr6","29536081","29536210","chr13","84094452","84094583","21","54558371"
"chr6","29541954","29542120","chr4","119074513","119074677","28","89532559"
"chr6","29549085","29549381","chr20","14939394","14939684","60","14609691"
"chr6","29551833","29552140","chr19","29158766","29159075","9","393067"
"chr6","29568405","29568677","chr19","29177753","29178028","9","390652"
"chr6","29570321","29570596","chr19","29179674","29179956","14","390647"
"chr6","29613369","29613675","chrX","104319695","104320000","50","74706326"
"chr6","29614340","29614644","chr5","170098","170395","56","29444242"
"chr6","29644775","29645061","chr19","29179674","29179956","47","465101"
"chr6","29669484","29669749","chr2","78855951","78856210","60","49186467"
"chr6","29706105","29706396","chr19","29269833","29270124","2","436272"
"chr6","29733121","29733175","chr7","129903052","129903103","11","100169931"
"chr6","29747131","29747254","chr19","29321120","29321233","14","426011"
"chr6","29827119","29827257","chr19","29413883","29414021","2","413236"
"chr6","29827403","29827714","chr19","29414167","29414480","6","413236"
"chr6","29841328","29841635","chr19","29429398","29429698","13","411930"
"chr6","29872656","29872963","chr19","29460831","29461138","9","411825"
"chr6","29894813","29895101","chr19","29485351","29485639","3","409462"
"chr6","29895679","29895856","chr8","89222726","89222899","32","59327047"
"chr6","29896159","29896172","chr1","190347546","190347559","3","160451387"
"chr6","29898651","29898955","chr19","29489166","29489469","14","409485"
"chr6","29907463","29907772","chr19","29500648","29500954","15","406815"
"chr6","29924847","29925058","chr4","155306309","155306518","35","125381462"
"chr6","29942888","29943200","chr19","29536680","29536988","12","406208"
"chr6","29952705","29952798","chr19","29546534","29546620","10","406171"
"chr6","29991253","29991537","chr19","29586221","29586498","18","405032"
"chr6","29996328","29996434","chr10","12220227","12220334","23","17776101"
"chr6","30012647","30012816","chr19","29614142","29614311","4","398505"
"chr6","30034815","30034937","chr2","85795101","85795227","21","55760286"
"chr6","30035232","30035319","chr5","80226599","80226687","29","50191367"
"chr6","30035322","30035377","chr7","126552400","126552456","11","96517078"
"chr6","30053140","30053216","chr19","29657377","29657453","2","395763"
"chr6","30061493","30061798","chr19","29666043","29666354","9","395450"
"chr6","30082674","30082776","chr19","29688022","29688127","5","394652"
"chr6","30083072","30083266","chr19","29688430","29688628","12","394642"
"chr6","30092064","30092362","chr2","78493440","78493742","50","48401376"
"chr6","30110851","30110986","chr19","29717283","29717418","6","393568"
"chr6","30111289","30111444","chr19","29717721","29717881","9","393568"
"chr6","30161202","30161505","chr19","29771915","29772218","7","389287"
"chr6","30192709","30192872","chr4","119074513","119074677","30","88881804"
"chr6","30194560","30194759","chr19","29807262","29807460","7","387298"
"chr6","30195317","30195469","chr7","144409615","144409761","25","114214298"
"chr6","30207507","30207812","chr19","29820625","29820919","21","386882"
"chr6","30213523","30213616","chr19","29826611","29826704","4","386912"
"chr6","30277272","30277571","chr19","29889973","29890275","15","387299"
"chr6","30280889","30281024","chr19","29893661","29893790","8","387228"
"chr6","30310950","30311243","chr19","29923731","29924026","7","387219"
"chr6","30317289","30317439","chr19","29930047","29930197","3","387242"
"chr6","30320223","30320536","chr19","36311762","36312070","68","5991539"
"chr6","30329594","30329618","chr1","180296468","180296494","6","149966874"
"chr6","30329651","30329923","chr11","112612188","112612462","63","82282537"
"chr6","30333643","30333947","chr19","29939202","29939506","6","394441"
"chr6","30337497","30337810","chr19","29943073","29943386","6","394424"
"chr6","30345053","30345330","chr19","29950406","29950713","41","394647"
"chr6","30350183","30350352","chr11","38369515","38369683","30","8019332"
"chr6","30353190","30353363","chr7","25941776","25941912","55","4411414"
"chr6","30358409","30358452","chr19","29966327","29966370","1","392082"
"chr6","30360456","30360735","chr19","29968376","29968655","9","392080"
"chr6","30366438","30366737","chr19","29974699","29974999","8","391739"
"chr6","30366739","30366908","chr19","29975001","29975174","11","391738"
"chr6","30371579","30371888","chr19","29980154","29980463","8","391425"
"chr6","30394263","30394524","chr19","30004306","30004567","6","389957"
"chr6","30415978","30416325","chr19","30025831","30026167","18","390147"
"chr6","30443862","30444147","chr19","30053465","30053751","8","390397"
"chr6","30456980","30457272","chr19","30066909","30067201","5","390071"
"chr6","30466042","30466335","chr19","30075964","30076257","1","390078"
"chr6","30500806","30500987","chr19","30107195","30107379","9","393611"
"chr6","30533099","30533289","chr19","30150601","30150791","4","382498"
"chr6","30568145","30568281","chr19","30179544","30179669","15","388601"
"chr6","30574933","30575237","chr19","30192404","30192702","30","382529"
"chr6","30575271","30575515","chr13","24581020","24581268","43","5994251"
"chr6","30579204","30579495","chr19","30197029","30197331","13","382175"
"chr6","30583482","30583779","chr19","30192725","30193035","28","390757"
"chr6","30587468","30587757","chr19","30197029","30197331","15","390439"
"chr6","30599667","30599947","chr11","34933570","34933852","60","4333903"
"chr6","30602707","30602996","chr3","104066726","104067014","60","73464019"
"chr6","30604890","30605184","chr13","68829303","68829596","75","38224413"
"chr6","30606132","30606436","chr2","66282126","66282426","60","35675994"
"chr6","30620819","30621086","chr19","30232895","30233163","6","387924"
"chr6","30650858","30651135","chr1","20102386","20102638","77","10548472"
"chr6","30659090","30659472","chr4","29283729","29284103","95","1375361"
"chr6","30661557","30661675","chr19","30267576","30267694","4","393981"
"chr6","30684117","30684397","chr19","30291327","30291607","5","392790"
"chr6","30717576","30717848","chr10","29047313","29047589","52","1670263"
"chr6","30725717","30726070","chr16","8730167","8730509","91","21995550"
"chr6","30738576","30738868","chr19","30336286","30336581","6","402290"
"chr6","30745275","30745575","chr19","30343452","30343752","16","401823"
"chr6","30794991","30795247","chr19","30394583","30394839","10","400408"
"chr6","30804125","30804273","chr2","43194047","43194197","27","12389922"
"chr6","30805147","30805445","chr19","30404581","30404883","13","400566"
"chr6","30815268","30815562","chr19","30414849","30415144","17","400419"
"chr6","30817814","30817952","chr19","30417393","30417535","8","400421"
"chr6","30818262","30818397","chr19","30417844","30417976","6","400418"
"chr6","30825712","30826012","chr19","30424952","30425247","7","400760"
"chr6","30829577","30829878","chr19","30428815","30429095","33","400762"
"chr6","30831904","30832090","chr14","50632782","50632970","43","19800878"
"chr6","30832464","30832562","chr4","35751803","35751900","22","4919339"
"chr6","30834021","30834306","chr19","30433236","30433502","28","400785"
"chr6","30834440","30834695","chr19","30433635","30433899","16","400805"
"chr6","30834820","30835129","chr19","30434024","30434336","11","400796"
"chr6","30837813","30838102","chr19","30437013","30437303","9","400800"
"chr6","30863577","30863852","chr2","48404026","48404304","56","17540449"
"chr6","30870373","30870533","chr19","30470103","30470262","6","400270"
"chr6","30879335","30879451","chr20","13293930","13294044","20","17585405"
"chr6","30880714","30881022","chr19","30485318","30485605","25","395396"
"chr6","30892389","30892700","chr18","55627826","55628135","54","24735437"
"chr6","30895659","30895954","chrX","20978439","20978730","49","9917220"
"chr6","30903436","30903739","chr19","30512250","30512553","6","391186"
"chr6","30909598","30909755","chr1","134951463","134951628","31","104041865"
"chr6","30914792","30915072","chr19","30524537","30524817","7","390255"
"chr6","30918670","30918776","chr19","30528420","30528525","9","390250"
"chr6","30947897","30948177","chr19","30558763","30559044","5","389134"
"chr6","30949473","30949765","chr19","30560336","30560629","7","389137"
"chr6","30953620","30953917","chr4","104492669","104492965","54","73539049"
"chr6","30956485","30956781","chr3","2797380","2797675","53","28159105"
"chr6","30960676","30960731","chr12","53654439","53654488","7","22693763"
"chr6","30960849","30960974","chr12","53653885","53654004","8","22693036"
"chr6","30961733","30962039","chr1","203490003","203490305","56","172528270"
"chr6","30968670","30968952","chr12","53645057","53645341","14","22676387"
"chr6","30982302","30982488","chr12","53631112","53631298","5","22648810"
"chr6","31029897","31030190","chr14","3432776","3433056","66","27597121"
"chr6","31030654","31030967","chr19","30611902","30612216","12","418752"
"chr6","31034136","31034436","chr19","30615382","30615666","22","418754"
"chr6","31038726","31038765","chr15","7360775","7360812","7","23677951"
"chr6","31039079","31039314","chr19","30620932","30621195","36","418147"
"chr6","31047391","31047685","chr19","30628096","30628390","7","419295"
"chr6","31059145","31059278","chr19","30642527","30642663","5","416618"
"chr6","31065385","31065421","chr1","4590193","4590229","4","26475192"
"chr6","31065422","31065733","chr2","44247952","44248260","55","13182530"
"chr6","31066903","31066966","chr12","30545255","30545314","13","521648"
"chr6","31068840","31069149","chr4","1331704","1332007","61","29737136"
"chr6","31071134","31071428","chrX","41341410","41341721","63","10270276"
"chr6","31087727","31088024","chr19","30680696","30680997","10","407031"
"chr6","31088736","31089028","chr19","30681504","30681797","4","407232"
"chr6","31105624","31105919","chr19","30699738","30700026","19","405886"
"chr6","31109610","31109768","chr19","39085981","39086136","29","7976371"
"chr6","31110075","31110180","chr20","17557701","17557793","27","13552374"
"chr6","31121185","31121414","chr19","30716340","30716569","4","404845"
"chr6","31121431","31121750","chr19","30716589","30716909","15","404842"
"chr6","31123661","31123923","chr11","109753147","109753413","67","78629486"
"chr6","31125599","31125668","chr19","30720282","30720351","4","405317"
"chr6","31128214","31128310","chr19","30724764","30724861","5","403450"
"chr6","31145501","31145796","chr19","30739882","30740180","12","405619"
"chr6","31149892","31150178","chr19","30744413","30744700","4","405479"
"chr6","31171620","31171917","chr19","30774833","30775129","16","396787"
"chr6","31188327","31188629","chr19","30787120","30787413","22","401207"
"chr6","31194655","31194811","chr11","12033610","12033771","31","19161045"
"chr6","31200472","31200765","chr19","30795923","30796220","9","404549"
"chr6","31213179","31213472","chr3","3505584","3505883","56","27707595"
"chr6","31233670","31233967","chr19","30832678","30832982","14","400992"
"chr6","31234146","31234439","chr6","162857806","162858106","60","131623660"
"chr6","31237551","31237692","chr1","47596342","47596495","33","16358791"
"chr6","31292906","31293191","chr19","30891353","30891636","9","401553"
"chr6","31301920","31302238","chr19","30900826","30901139","14","401094"
"chr6","31320941","31321050","chr11","6600507","6600612","29","24720434"
"chr6","31324051","31324265","chr19","30923126","30923309","45","400925"
"chr6","31327401","31327699","chr19","30927186","30927484","5","400215"
"chr6","31339619","31339971","chr17","7766714","7767055","87","23572905"
"chr6","31361183","31361314","chr19","30961991","30962123","6","399192"
"chr6","31361998","31362110","chr19","30963120","30963235","6","398878"
"chr6","31365038","31365169","chr19","30967753","30967884","6","397285"
"chr6","31365479","31365642","chr19","30968189","30968359","12","397290"
"chr6","31383544","31383639","chr4","107915832","107915927","14","76532288"
"chr6","31391545","31391664","chr9","57895123","57895243","23","26503578"
"chr6","31392179","31392486","chr19","30995450","30995760","7","396729"
"chr6","31395724","31396016","chr19","30999632","30999924","9","396092"
"chr6","31421858","31422188","chr19","31026852","31027193","28","395006"
"chr6","31425509","31425819","chr19","31031326","31031635","14","394183"
"chr6","31433494","31433809","chr19","31039707","31040022","13","393787"
"chr6","31447017","31447302","chrX","6578559","6578839","53","24868458"
"chr6","31480136","31480407","chr19","31080524","31080828","44","399612"
"chr6","31496114","31496410","chr16","18813379","18813673","77","12682735"
"chr6","31499088","31499394","chr1","33010955","33011254","56","1511867"
"chr6","31513081","31513385","chr19","31114327","31114607","31","398754"
"chr6","31514142","31514436","chr7","113677816","113678111","54","82163674"
"chr6","31538084","31538219","chrX","117923287","117923422","22","86385203"
"chr6","31542802","31543096","chr19","31144967","31145261","11","397835"
"chr6","31545085","31545374","chr19","31146941","31147230","2","398144"
"chr6","31552008","31552297","chr19","31153789","31154078","16","398219"
"chr6","31554884","31555188","chr19","31156801","31157113","20","398083"
"chr6","31555190","31555347","chr19","31157115","31157271","3","398075"
"chr6","31562971","31563258","chr19","31165466","31165753","13","397505"
"chr6","31574668","31574965","chr19","31174971","31175272","8","399697"
"chr6","31588543","31588730","chr19","31189257","31189444","2","399286"
"chr6","31593949","31594264","chr19","31195295","31195611","14","398654"
"chr6","31595837","31596126","chr19","31197546","31197835","5","398291"
"chr6","31597439","31597743","chr19","31199132","31199421","36","398307"
"chr6","31606038","31606315","chr19","31207357","31207634","3","398681"
"chr6","31612546","31612845","chr19","31219017","31219316","4","393529"
"chr6","31613404","31613619","chr18","71888328","71888531","42","40274924"
"chr6","31622783","31622931","chr10","28532962","28533098","42","3089821"
"chr6","31622932","31623002","chr1","42852789","42852856","13","11229857"
"chr6","31623943","31624228","chr19","31225431","31225701","23","398512"
"chr6","31624544","31624851","chr19","31226383","31226682","12","398161"
"chr6","31632219","31632344","chr19","31234215","31234336","7","398004"
"chr6","31633838","31634119","chr19","31235811","31236092","7","398027"
"chr6","31642323","31642623","chr1","158880012","158880315","60","127237689"
"chr6","31646471","31646762","chr19","31248285","31248577","12","398186"
"chr6","31661072","31661357","chr19","31263866","31264149","15","397206"
"chr6","31680309","31680590","chr19","31283171","31283411","50","397138"
"chr6","31684957","31685058","chr7","10912904","10913003","15","20772053"
"chr6","31742195","31742511","chr19","31347333","31347649","11","394862"
"chr6","31764380","31764658","chr19","31376400","31376681","14","387980"
"chr6","31795833","31796038","chr1","217630781","217630972","53","185834948"
"chr6","31798114","31798409","chr19","31411523","31411816","11","386591"
"chr6","31829253","31829557","chr19","31441815","31442115","11","387438"
"chr6","31879506","31879780","chr19","31493879","31494153","9","385627"
"chr6","31930379","31930678","chr19","31546330","31546625","19","384049"
"chr6","31938623","31938866","chr13","24581020","24581268","48","7357603"
"chr6","31979576","31979833","chr19","31595802","31596059","3","383774"
"chr6","31982441","31982631","chr19","31599303","31599489","13","383138"
"chr6","31993689","31993702","chr13","72970503","72970513","3","40976814"
"chr6","31993728","31994008","chr19","31612314","31612611","36","381414"
"chr6","32004875","32005173","chr16","44745004","44745304","46","12740129"
"chr6","32054500","32054671","chr7","145808597","145808766","43","113754097"
"chr6","32057239","32057537","chr19","31675087","31675386","8","382152"
"chr6","32058981","32059264","chr19","31676817","31677123","29","382164"
"chr6","32080709","32081014","chr19","31701691","31701989","14","379018"
"chr6","32095137","32095428","chr19","31718498","31718801","16","376639"
"chr6","32103111","32103411","chr19","31726979","31727277","6","376132"
"chr6","32109734","32110033","chr19","31733908","31734205","6","375826"
"chr6","32125219","32125516","chr4","42143224","42143519","53","10018005"
"chr6","32130212","32130483","chr4","38371100","38371378","71","6240888"
"chr6","32150628","32150920","chr19","31755866","31756157","10","394762"
"chr6","32177076","32177372","chr12","89683420","89683718","47","57506344"
"chr6","32213154","32213381","chr4","42223322","42223552","48","10010168"
"chr6","32231994","32232274","chr10","72182940","72183214","60","39950946"
"chr6","32240314","32240588","chr19","31840142","31840424","15","400172"
"chr6","32301345","32301634","chr16","18768739","18769026","63","13532606"
"chr6","32302170","32302466","chr19","31907731","31908017","13","394439"
"chr6","32326615","32326929","chr19","31931800","31932068","53","394815"
"chr6","32327199","32327474","chr19","31932472","31932747","5","394727"
"chr6","32346333","32346485","chr19","31953742","31953894","5","392591"
"chr6","32385346","32385630","chr19","31990962","31991240","9","394384"
"chr6","32397539","32397832","chr19","32002805","32003101","11","394734"
"chr6","32427604","32427907","chr19","32033126","32033429","9","394478"
"chr6","32428116","32428415","chr19","32033652","32033929","32","394464"
"chr6","32436968","32437200","chr19","32045509","32045741","1","391459"
"chr6","32443767","32444074","chr19","32052469","32052775","12","391298"
"chr6","32448134","32448431","chr6","134251498","134251796","54","101803364"
"chr6","32453806","32453956","chr6","148154766","148154916","23","115700960"
"chr6","32458710","32458995","chr19","31248285","31248577","49","1210425"
"chr6","32467102","32467410","chr19","32074871","32075180","4","392231"
"chr6","32483040","32483322","chr8","10034943","10035230","48","22448097"
"chr6","32488048","32488339","chr19","32096251","32096544","14","391797"
"chr6","32510415","32510658","chr19","32118575","32118819","9","391840"
"chr6","32511716","32511966","chr19","32120189","32120439","7","391527"
"chr6","32513302","32513492","chr19","32125480","32125670","3","387822"
"chr6","32514549","32514665","chr19","32126737","32126853","1","387812"
"chr6","32515433","32515730","chr8","125108902","125109193","60","92593469"
"chr6","32515735","32515774","chr20","3450719","3450758","4","29065016"
"chr6","32516025","32516347","chr19","32128212","32128532","11","387813"
"chr6","32517290","32517467","chr19","32130530","32130707","3","386760"
"chr6","32518238","32518415","chr19","32131489","32131666","3","386749"
"chr6","32522871","32523057","chr19","32136048","32136226","8","386823"
"chr6","32523351","32523471","chr7","19596811","19596930","14","12926540"
"chr6","32531937","32532220","chr19","32144804","32145087","3","387133"
"chr6","32538875","32538926","chr4","7549914","7549964","9","24988961"
"chr6","32539638","32539827","JH680086","78840","79035","54","32460798"
"chr6","32545359","32545663","chr19","32159082","32159386","6","386277"
"chr6","32552058","32552323","chr19","32165917","32166175","13","386141"
"chr6","32556325","32556450","chr19","32169822","32169944","6","386503"
"chr6","32571873","32572165","chr8","124977856","124978147","49","92405983"
"chr6","32579201","32579509","chr19","32189428","32189736","8","389773"
"chr6","32581859","32582024","chr19","32192098","32192261","2","389761"
"chr6","32588933","32589160","chr19","32199343","32199571","6","389590"
"chr6","32599263","32599558","chr19","32209637","32209909","32","389626"
"chr6","32601351","32601621","chr19","32211733","32211989","21","389618"
"chr6","32603491","32603827","chr19","32213864","32214169","48","389627"
"chr6","32605169","32605459","chr19","32215507","32215797","12","389662"
"chr6","32608831","32608971","chr19","32219379","32219519","4","389452"
"chr6","32615155","32615461","chr19","32226227","32226503","39","388928"
"chr6","32617700","32617983","chr19","32228767","32229056","9","388933"
"chr6","32624783","32625090","chr19","32235905","32236207","16","388878"
"chr6","32626351","32626520","chr19","32237464","32237632","5","388887"
"chr6","32637457","32637596","chr2","172227852","172227991","27","139590395"
"chr6","32647768","32648027","chr19","32258933","32259192","7","388835"
"chr6","32653160","32653446","chr19","32264644","32264911","28","388516"
"chr6","32658547","32658857","chr19","32270051","32270360","10","388496"
"chr6","32672463","32672684","chr19","32284257","32284484","8","388206"
"chr6","32687718","32687856","chr14","115035774","115035918","22","82348056"
"chr6","32722433","32722742","chr19","32335453","32335758","16","386980"
"chr6","32739314","32739627","chr19","32354191","32354503","12","385123"
"chr6","32745620","32745933","chr19","32354191","32354503","12","391429"
"chr6","32761651","32761928","chr19","32370199","32370437","42","391452"
"chr6","32784670","32784957","chr19","32393722","32394006","12","390948"
"chr6","32795466","32795581","chr2","150020755","150020867","25","117225289"
"chr6","32799219","32799517","chr19","32408639","32408937","9","390580"
"chr6","32817483","32817775","chr19","32429194","32429487","13","388289"
"chr6","32826819","32827021","chr19","32439748","32439948","6","387071"
"chr6","32832921","32833218","chr19","32446600","32446904","13","386321"
"chr6","32838552","32838856","chr19","32451373","32451680","9","387179"
"chr6","32871263","32871565","chr19","32487143","32487445","7","384120"
"chr6","32874505","32874817","chr7","33136288","33136598","47","261783"
"chr6","32878660","32878692","chr19","32495164","32495196","0","383496"
"chr6","32879004","32879317","chr19","32495508","32495818","8","383496"
"chr6","32880298","32880600","chr19","32504312","32504614","5","375986"
"chr6","32887979","32888055","chr1","202541422","202541489","20","169653443"
"chr6","32888352","32888615","chr2","78855951","78856210","65","45967599"
"chr6","32888619","32888888","chr19","32506938","32507206","9","381681"
"chr6","32893738","32894048","chr19","32512069","32512367","18","381669"
"chr6","32911546","32911831","chr19","32530120","32530405","8","381426"
"chr6","32918059","32918335","chr19","32539229","32539509","11","378830"
"chr6","32921186","32921316","chr1","110258390","110258520","25","77337204"
"chr6","32938002","32938288","chr19","32557837","32558118","7","380165"
"chr6","32945990","32946275","chr19","32566651","32566960","28","379339"
"chr6","32955379","32955599","chr19","32575153","32575375","14","380226"
"chr6","32974923","32975227","chr19","32596023","32596331","10","378900"
"chr6","32983087","32983249","chr19","32604329","32604496","8","378758"
"chr6","32983255","32983436","chr2","12329997","12330159","62","20653258"
"chr6","32991660","32991953","chr1","67042253","67042549","53","34050593"
"chr6","32995125","32995176","JH679735","4121","4171","6","32991004"
"chr6","33005473","33005773","chr11","94676051","94676349","56","61670578"
"chr6","33019891","33020170","chr10","12280561","12280838","63","20739330"
"chr6","33034060","33034225","chr19","32654362","32654527","4","379698"
"chr6","33045200","33045533","chr1","64773556","64773874","95","31728356"
"chr6","33070858","33071038","chr1","67267341","67267514","49","34196483"
"chr6","33083514","33083816","chr19","32703474","32703768","17","380040"
"chr6","33095647","33095760","chr2","163647516","163647636","22","130551869"
"chr6","33098976","33099252","chr19","32719121","32719394","10","379855"
"chr6","33116764","33116902","chr10","60586310","60586446","42","27469546"
"chr6","33117084","33117157","chr19","32738381","32738454","1","378703"
"chr6","33126788","33127095","chr19","32749882","32750189","10","376906"
"chr6","33127525","33127836","chr19","32750989","32751296","12","376536"
"chr6","33128833","33129158","chr2","44247952","44248260","70","11119119"
"chr6","33129378","33129545","chr19","32752810","32752978","7","376568"
"chr6","33130203","33130499","chr19","32753627","32753923","8","376576"
"chr6","33135315","33135592","chr1","22388566","22388852","52","10746749"
"chr6","33140392","33140693","chr19","32759865","32760169","17","380527"
"chr6","33142305","33142472","chr19","10014739","10014903","32","23127566"
"chr6","33166206","33166343","chr5","45846137","45846271","21","12679931"
"chr6","33168942","33169244","chr19","32790845","32791148","12","378097"
"chr6","33169959","33170267","chr19","32791862","32792169","7","378097"
"chr6","33193562","33193804","chr19","32815579","32815841","28","377983"
"chr6","33197669","33197850","chr19","32821570","32821751","3","376099"
"chr6","33197885","33198000","chr19","32821778","32821893","1","376107"
"chr6","33203201","33203494","chr19","32825118","32825419","11","378083"
"chr6","33204272","33204562","chr3","44067077","44067369","60","10862805"
"chr6","33206086","33206138","chr19","32827981","32828036","4","378105"
"chr6","33226167","33226457","chr19","32848765","32849064","14","377402"
"chr6","33226792","33226905","chr19","32849571","32849684","2","377221"
"chr6","33235969","33236280","chr19","32858974","32859276","23","376995"
"chr6","33238485","33238502","chr19","32861933","32861950","0","376552"
"chr6","33238813","33238935","chr1","30369482","30369604","22","2869331"
"chr6","33244396","33244458","chr4","7549914","7549964","17","25694482"
"chr6","33244437","33244500","chr4","7549914","7549964","16","25694523"
"chr6","33247428","33247576","chr19","32870735","32870883","3","376693"
"chr6","33247878","33248033","chr19","32871181","32871340","11","376697"
"chr6","33250064","33250329","chr6","172279903","172280171","59","139029839"
"chr6","33259978","33260060","chr19","32885543","32885625","2","374435"
"chr6","33266338","33266502","chr2","20303806","20303971","30","12962532"
"chr6","33271579","33271897","chr19","32899317","32899625","38","372262"
"chr6","33286776","33286996","chr19","32914822","32915067","34","371954"
"chr6","33288236","33288369","chr3","144473073","144473196","47","111184837"
"chr6","33296108","33296386","chr8","56667878","56668147","63","23371770"
"chr6","33296981","33297163","chr19","32930718","32930886","17","366263"
"chr6","33300152","33300202","chr19","32931192","32931245","3","368960"
"chr6","33317216","33317447","chr19","32948957","32949205","24","368259"
"chr6","33336925","33337206","chr19","32969644","32969925","8","367281"
"chr6","33360484","33360805","chr8","34777212","34777529","55","1416728"
"chr6","33368622","33368883","chr19","33001827","33002084","10","366795"
"chr6","33375347","33375497","chr5","1888026","1888179","35","31487321"
"chr6","33386526","33386640","chr3","77321553","77321650","31","43935027"
"chr6","33388859","33389170","chr19","33022551","33022862","8","366308"
"chr6","33390969","33391159","chr19","33025275","33025439","34","365694"
"chr6","33391454","33391597","chr19","33025735","33025877","9","365719"
"chr6","33392600","33392892","chr19","33027008","33027300","10","365592"
"chr6","33396488","33396788","chr19","33030507","33030790","28","365981"
"chr6","33397839","33398084","chr19","33032868","33033113","6","364971"
"chr6","33400592","33400943","chr11","103819543","103819873","105","70418951"
"chr6","33405557","33405846","chr2","12052111","12052399","65","21353446"
"chr6","33407031","33407342","chr19","33050931","33051257","27","356100"
"chr6","33410828","33411125","chr19","33061405","33061720","28","349423"
"chr6","33419952","33420249","chr19","33070206","33070495","19","349746"
"chr6","33424627","33424790","chr19","33074335","33074495","9","350292"
"chr6","33431745","33432066","chr19","33081798","33082117","16","349947"
"chr6","33441979","33442197","chr19","33091905","33092123","7","350074"
"chr6","33445443","33445642","chr19","33096021","33096231","16","349422"
"chr6","33451243","33451373","chr19","33103099","33103235","11","348144"
"chr6","33451680","33451800","chr19","33103539","33103659","3","348141"
"chr6","33452222","33452501","chr19","33104085","33104367","12","348137"
"chr6","33463138","33463422","chr2","99715928","99716221","60","66252790"
"chr6","33477246","33477427","chr19","33134914","33135098","12","342332"
"chr6","33486749","33487053","chr19","33132644","33132949","7","354105"
"chr6","33490579","33490736","chr14","63608556","63608715","28","30117977"
"chr6","33496157","33496465","chr19","33150033","33150344","15","346124"
"chr6","33496473","33496790","chr19","33150352","33150668","5","346121"
"chr6","33497930","33498023","chr1","18170763","18170860","28","15327167"
"chr6","33499621","33499938","chr19","33153367","33153683","16","346254"
"chr6","33501794","33501959","chr3","152433547","152433713","36","118931753"
"chr6","33507046","33507346","chr19","33161825","33162125","4","345221"
"chr6","33525198","33525362","chr19","33183046","33183207","6","342152"
"chr6","33526211","33526499","chr14","18307707","18308001","48","15218504"
"chr6","33527851","33527979","chr19","33184143","33184274","9","343708"
"chr6","33533432","33533723","chr19","33190326","33190615","8","343106"
"chr6","33548459","33548579","chr10","30484458","30484572","34","3064001"
"chr6","33556910","33557213","chr19","33214098","33214409","12","342812"
"chr6","33562059","33562391","chr3","51992589","51992910","77","18430530"
"chr6","33566099","33566330","chr19","33224340","33224571","4","341759"
"chr6","33570075","33570250","chr19","33228046","33228224","9","342029"
"chr6","33572344","33572639","chr19","33230324","33230637","27","342020"
"chr6","33585077","33585389","chr1","129944347","129944658","52","96359270"
"chr6","33587579","33587843","chr19","33246394","33246659","10","341185"
"chr6","33599861","33600167","chr7","25185886","25186189","56","8413975"
"chr6","33611482","33611787","chr19","33279477","33279805","25","332005"
"chr6","33612088","33612364","chr19","33280093","33280380","18","331995"
"chr6","33613581","33613899","chr19","33281513","33281844","21","332068"
"chr6","33614031","33614201","chr19","33281962","33282131","3","332069"
"chr6","33626221","33626348","chr19","33293612","33293739","6","332609"
"chr6","33626652","33626837","chr19","33294042","33294227","3","332610"
"chr6","33631733","33632042","chr18","15078343","15078646","52","18553390"
"chr6","33632751","33632965","chrX","50264118","50264341","64","16631367"
"chr6","33634015","33634156","chr19","33304410","33304551","5","329605"
"chr6","33639163","33639470","chr19","33310096","33310403","10","329067"
"chr6","33655423","33655589","chr9","88967166","88967333","33","55311743"
"chr6","33660666","33660882","chr7","131216719","131216916","76","97556053"
"chr6","33660883","33661140","chr1","138018836","138019108","62","104357953"
"chr6","33661141","33661307","chr4","35852287","35852450","29","2191146"
"chr6","33663195","33663511","chr19","33339933","33340249","5","323262"
"chr6","33664125","33664417","chr19","33340859","33341151","9","323266"
"chr6","33679762","33680066","chr19","33355872","33356175","6","323890"
"chr6","33680405","33680708","chr19","33356951","33357252","8","323454"
"chr6","33683860","33684158","chr19","33360397","33360697","7","323463"
"chr6","33693092","33693157","chr19","33370316","33370381","1","322776"
"chr6","33696009","33696303","chr19","33373142","33373435","12","322867"
"chr6","33702946","33703233","chr20","53928148","53928435","44","20225202"
"chr6","33706348","33706655","chr19","33384134","33384439","16","322214"
"chr6","33713378","33713517","chr3","44087622","44087755","23","10374244"
"chr6","33713842","33714004","chr4","114306341","114306495","44","80592499"
"chr6","33732199","33732356","chr19","33410488","33410644","5","321711"
"chr6","33737047","33737347","chr19","33415696","33415992","11","321351"
"chr6","33742562","33742673","chr3","154543697","154543812","19","120801135"
"chr6","33752782","33753087","chr19","33431308","33431613","15","321474"
"chr6","33776620","33776733","chr19","33456513","33456629","4","320107"
"chr6","33777534","33777815","chr19","33457436","33457718","9","320098"
"chr6","33780745","33780879","chr4","111285285","111285418","23","77504540"
"chr6","33780991","33781294","chr3","12783650","12783947","50","20997341"
"chr6","33782115","33782208","chr19","33462240","33462333","3","319875"
"chr6","33783032","33783310","chr19","33463444","33463722","3","319588"
"chr6","33785020","33785321","chr19","33464584","33464885","11","320436"
"chr6","33796777","33797044","chr11","109753147","109753413","65","75956370"
"chr6","33797379","33797552","chr19","33477259","33477433","12","320120"
"chr6","33801604","33801673","chr4","43955090","43955165","14","10153486"
"chr6","33803579","33803715","chr1","93779266","93779399","30","59975687"
"chr6","33805457","33805766","chr19","33485180","33485490","11","320277"
"chr6","33811024","33811335","chr19","33490803","33491113","8","320221"
"chr6","33818226","33818537","chr19","33490803","33491113","7","327423"
"chr6","33825338","33825649","chr3","49236490","49236797","49","15411152"
"chr6","33829109","33829424","chr14","21285117","21285433","54","12543992"
"chr6","33829896","33830010","chr1","124807739","124807852","16","90977843"
"chr6","33833205","33833304","chr20","23004775","23004876","18","10828430"
"chr6","33841101","33841427","chr19","28743842","28744151","61","5097259"
"chr6","33849234","33849495","chr19","33520761","33521019","5","328473"
"chr6","33850342","33850357","chr13","27923969","27923981","3","5926373"
"chr6","33850491","33850507","chr11","108818380","108818395","4","74967889"
"chr6","33851346","33851499","chr2","88940880","88941034","27","55089534"
"chr6","33861809","33862040","chr19","33524210","33524441","5","337599"
"chr6","33872714","33872972","chr19","33549914","33550193","31","322800"
"chr6","33874041","33874357","chrX","142116490","142116801","66","108242449"
"chr6","33882558","33882884","chr19","28743842","28744151","61","5138716"
"chr6","33890807","33891115","chr19","33559657","33559966","18","331150"
"chr6","33892152","33892463","chr7","19575336","19575642","58","14316816"
"chr6","33893376","33893669","chr19","33561919","33562212","7","331457"
"chr6","33910599","33910692","chr19","33578715","33578818","14","331884"
"chr6","33929388","33929528","chr6","38143328","38143467","25","4213940"
"chr6","33931902","33932177","chr19","33600134","33600410","12","331768"
"chr6","33937456","33937752","chr19","33605197","33605495","10","332259"
"chr6","33941028","33941246","chr7","1919134","1919352","41","32021894"
"chr6","33956373","33956473","chr10","6546419","6546525","17","27409954"
"chr6","33957339","33957518","chr19","33625310","33625489","6","332029"
"chr6","33957520","33957817","chr3","179399156","179399444","49","145441636"
"chr6","33986050","33986324","chr19","33654711","33654985","6","331339"
"chr6","34004739","34005018","chr19","33675311","33675590","9","329428"
"chr6","34048799","34048970","chr19","33716450","33716620","6","332349"
"chr6","34049268","34049395","chr19","33716924","33717049","6","332344"
"chr6","34050783","34050988","chr19","33718322","33718525","2","332461"
"chr6","34051285","34051358","chr10","29611349","29611418","17","4439936"
"chr6","34053648","34053752","chr19","33722938","33723042","3","330710"
"chr6","34054041","34054189","chr19","33723332","33723480","8","330709"
"chr6","34056684","34057007","chr19","33725964","33726264","29","330720"
"chr6","34064997","34065159","chr1","111429353","111429516","29","77364356"
"chr6","34065444","34065594","chr19","33734789","33734930","13","330655"
"chr6","34070462","34070601","chr15","24898076","24898208","33","9172386"
"chr6","34073131","34073319","chr19","33743006","33743178","22","330125"
"chr6","34095511","34095705","chr19","33765718","33765912","4","329793"
"chr6","34095990","34096122","chr19","33766197","33766329","3","329793"
"chr6","34099398","34099700","chr19","33769823","33770127","9","329575"
"chr6","34120054","34120194","chr2","172227852","172227991","32","138107798"
"chr6","34124010","34124227","chr11","130089781","130089993","48","95965771"
"chr6","34127402","34127600","chr3","87486704","87486902","38","53359302"
"chr6","34131197","34131341","chr10","75881274","75881418","36","41750077"
"chr6","34133612","34133912","chr19","33809309","33809593","23","324303"
"chr6","34137202","34137501","chr19","33812913","33813223","16","324289"
"chr6","34141956","34142220","chr19","33817676","33817948","18","324280"
"chr6","34150603","34150817","chr19","33827105","33827326","11","323498"
"chr6","34284301","34284585","chr19","33976521","33976800","20","307780"
"chr6","34356447","34356721","chr19","34146656","34146940","18","209791"
"chr6","34384987","34385130","chr19","34175362","34175507","8","209625"
"chr6","34385439","34385610","chr19","34175796","34175993","28","209643"
"chr6","34397102","34397370","chr19","34189312","34189589","13","207790"
"chr6","34440828","34441046","chr19","34249248","34249467","9","191580"
"chr6","34454675","34454930","chr19","34264843","34265102","15","189832"
"chr6","34466778","34467058","chr19","34278550","34278849","26","188228"
"chr6","34473548","34473836","chr19","34285637","34285925","4","187911"
"chr6","34476181","34476468","chr19","34288303","34288576","25","187878"
"chr6","34477461","34477755","chr19","34290595","34290886","13","186866"
"chr6","34484666","34484944","chr19","34298151","34298429","3","186515"
"chr6","34494819","34495102","chr19","34308898","34309181","12","185921"
"chr6","34529480","34529653","chr12","13614701","13614861","44","20914779"
"chr6","34556585","34556694","chr19","34369556","34369665","1","187029"
"chr6","34585704","34585803","chr19","34406762","34406861","0","178942"
"chr6","34620029","34620199","chr19","34441481","34441658","21","178548"
"chr6","34624702","34624995","chr1","220325224","220325517","54","185700522"
"chr6","34629907","34630192","chr19","34453337","34453622","7","176570"
"chr6","34648835","34649143","chr19","34460175","34460477","17","188660"
"chr6","34657966","34658220","chr19","34476737","34476992","7","181229"
"chr6","34660786","34661113","chr13","88599158","88599470","82","53938372"
"chr6","34679114","34679422","chr7","159108069","159108371","54","124428955"
"chr6","34686069","34686348","chr19","34506741","34507029","19","179328"
"chr6","34702289","34702542","chr19","34523123","34523376","8","179166"
"chr6","34708323","34708614","chr19","34528987","34529278","4","179336"
"chr6","34722199","34722507","chr19","34543738","34544052","14","178461"
"chr6","34726295","34726613","chr19","34548381","34548697","12","177914"
"chr6","34731837","34732157","chr19","34553974","34554294","5","177863"
"chr6","34751196","34751497","chrX","27894759","27895057","55","6856437"
"chr6","34754837","34755118","chr19","34585517","34585798","5","169320"
"chr6","34755670","34755991","chr19","34580230","34580548","10","175440"
"chr6","34762078","34762172","chr19","34587834","34587920","11","174244"
"chr6","34764648","34764948","chr19","34590277","34590588","22","174371"
"chr6","34770426","34770570","chr19","34592351","34592493","7","178075"
"chr6","34770874","34771038","chr19","34592798","34592962","5","178076"
"chr6","34772488","34772649","chr10","14462717","14462877","32","20309771"
"chr6","34780457","34780708","chr19","34602336","34602602","31","178121"
"chr6","34781094","34781413","chr19","34602966","34603285","14","178128"
"chr6","34783071","34783207","chr1","12337297","12337429","24","22445774"
"chr6","34784973","34785283","chr19","34606846","34607145","25","178127"
"chr6","34796492","34796785","chr19","34617871","34618167","10","178621"
"chr6","34810209","34810385","chr19","34632706","34632895","17","177503"
"chr6","34810716","34810861","chr19","34633204","34633349","2","177512"
"chr6","34811995","34812293","chr19","34641495","34641794","6","170500"
"chr6","34828823","34828905","chr17","83888017","83888096","19","49059194"
"chr6","34828986","34829179","chr6","100320429","100320628","51","65491443"
"chr6","34835376","34835539","chr19","34658765","34658928","2","176611"
"chr6","34838812","34839115","chr19","34662057","34662360","10","176755"
"chr6","34842204","34842514","chr19","34665474","34665784","9","176730"
"chr6","34869336","34869647","chrX","112768108","112768414","66","77898772"
"chr6","34870758","34871045","chr19","34696932","34697225","16","173826"
"chr6","34883611","34883784","chr19","34710908","34711101","23","172703"
"chr6","34890639","34890974","chr7","120152320","120152630","80","85261681"
"chr6","34891519","34891829","chr19","34722396","34722707","9","169123"
"chr6","34893348","34893591","chr19","34724582","34724827","10","168766"
"chr6","34895570","34895716","chr16","72864787","72864940","38","37969217"
"chr6","34901533","34901617","chr7","123379466","123379550","20","88477933"
"chr6","34903151","34903457","chr19","34732908","34733189","33","170243"
"chr6","34903600","34903894","chr2","78493440","78493742","51","43589840"
"chr6","34907176","34907403","chr19","34736798","34737028","14","170378"
"chr6","34907949","34908062","chr19","34737570","34737685","6","170379"
"chr6","34913613","34913881","chr19","34743293","34743562","10","170320"
"chr6","34915277","34915356","chr18","38839209","38839283","19","3923932"
"chr6","34916727","34916841","chr2","87322923","87323035","19","52406196"
"chr6","34931473","34931776","chr4","119713035","119713321","63","84781562"
"chr6","34936623","34936721","chr19","34763428","34763526","2","173195"
"chr6","34936723","34936803","chr19","34763528","34763608","0","173195"
"chr6","34941079","34941371","chr19","34769845","34770144","38","171234"
"chr6","34945478","34945794","chr13","84267549","84267857","54","49322071"
"chr6","34947520","34947765","chr19","34776535","34776824","49","170985"
"chr6","34947846","34948157","chr19","34776900","34777200","27","170946"
"chr6","34950016","34950311","chr19","34779061","34779365","20","170955"
"chr6","34968841","34969067","chr19","34799134","34799352","15","169707"
"chr6","34972324","34972633","chr19","34802492","34802801","15","169832"
"chr6","34977345","34977652","chr1","48846864","48847162","59","13869519"
"chr6","34978982","34979281","chr19","34809048","34809357","19","169934"
"chr6","34980426","34980724","chr19","34810513","34810798","20","169913"
"chr6","34984640","34984935","chr2","172936939","172937233","46","137952299"
"chr6","34986527","34986831","chr13","41851851","41852159","59","6865324"
"chr6","34998729","34998938","chr19","34829743","34829952","4","168986"
"chr6","35010721","35010871","chr19","34846615","34846772","9","164106"
"chr6","35015094","35015397","chr19","34851308","34851611","12","163786"
"chr6","35045551","35045830","chr19","34882831","34883111","7","162720"
"chr6","35055932","35056234","chr19","34893081","34893390","17","162851"
"chr6","35080886","35081092","chr19","34919013","34919226","16","161873"
"chr6","35085895","35086183","chr19","34923695","34923977","15","162200"
"chr6","35098809","35099116","chr7","114771143","114771443","66","79672334"
"chr6","35103917","35104164","chr19","34942523","34942776","20","161394"
"chr6","35109688","35109965","chr19","34949564","34949830","18","160124"
"chr6","35112100","35112414","chrX","46852707","46853016","59","11740607"
"chr6","35112711","35112970","chr1","64867733","64867995","52","29755022"
"chr6","35117898","35118197","chr19","34955682","34955985","13","162216"
"chr6","35128965","35129284","chr19","34962340","34962645","21","166625"
"chr6","35148052","35148351","chr9","110733855","110734154","55","75585803"
"chr6","35150016","35150155","chr19","34988308","34988442","8","161708"
"chr6","35151950","35152242","chr19","34990544","34990840","11","161406"
"chr6","35155051","35155344","chr19","34993644","34993931","9","161407"
"chr6","35157856","35158166","chr19","34996446","34996756","6","161410"
"chr6","35159648","35159961","chr19","34998105","34998415","11","161543"
"chr6","35173395","35173694","chr19","35012268","35012557","16","161127"
"chr6","35174770","35175068","chr20","5010965","5011264","53","30163805"
"chr6","35191925","35192026","chr14","10540730","10540819","25","24651195"
"chr6","35205951","35206254","chrX","107058428","107058734","57","71852477"
"chr6","35208279","35208535","chr19","35051877","35052129","13","156402"
"chr6","35216285","35216416","chr19","35060178","35060309","6","156107"
"chr6","35227292","35227582","chr19","35071630","35071921","35","155662"
"chr6","35234838","35234942","chr19","35079161","35079265","1","155677"
"chr6","35245800","35246112","chr19","35090908","35091221","13","154892"
"chr6","35248148","35248439","chr19","35092842","35093133","7","155306"
"chr6","35249940","35250247","chr19","35094657","35094964","4","155283"
"chr6","35266606","35266830","chr19","35111438","35111666","10","155168"
"chr6","35268125","35268282","chr1","93308587","93308724","44","58040462"
"chr6","35289065","35289196","chr19","35131689","35131820","4","157376"
"chr6","35295729","35296013","chr19","35139701","35140018","45","156028"
"chr6","35305549","35305841","chr19","35148767","35149080","41","156782"
"chr6","35307185","35307478","chr19","35150394","35150696","17","156791"
"chr6","35311484","35311692","chr19","35154047","35154255","11","157437"
"chr6","35327087","35327375","chr19","35280654","35280933","15","46433"
"chr6","35332007","35332211","chr19","35285356","35285568","41","46651"
"chr6","35358184","35358399","chr19","35316458","35316665","13","41726"
"chr6","35457915","35458121","chr19","35419488","35419694","9","38427"
"chr6","35471703","35471875","chr19","35443802","35443976","15","27901"
"chr6","35483554","35483635","chr20","55312503","55312585","14","19828949"
"chr6","35486256","35486477","chr19","35456993","35457214","6","29263"
"chr6","35486930","35487052","chr19","35457685","35457807","3","29245"
"chr6","35493262","35493556","chr14","52879118","52879412","61","17385856"
"chr6","35515730","35516074","chr20","62661421","62661767","91","27145691"
"chr6","35530259","35530546","chr19","35504731","35505018","9","25528"
"chr6","35531304","35531581","chr19","35505775","35506052","15","25529"
"chr6","35543137","35543456","chr13","92870661","92870964","67","57327524"
"chr6","35548248","35548557","chr7","41328936","41329244","50","5780688"
"chr6","35552397","35552584","chr19","35527384","35527575","8","25013"
"chr6","35553264","35553405","chr7","120260360","120260501","24","84707096"
"chr6","35553406","35553487","chr3","13933660","13933742","15","21619746"
"chr6","35562509","35562824","chr19","35537527","35537845","6","24982"
"chr6","35566707","35566983","chr19","35543793","35544072","10","22914"
"chr6","35568577","35568695","chr19","35545664","35545782","0","22913"
"chr6","35572569","35572843","chr19","35549623","35549899","23","22946"
"chr6","35589067","35589237","chr19","35565971","35566141","3","23096"
"chr6","35589544","35589673","chr19","35566448","35566577","4","23096"
"chr6","35594974","35595092","chrX","99038782","99038902","27","63443808"
"chr6","35604597","35604794","chr19","35581183","35581380","0","23414"
"chr6","35612452","35612625","chr19","35588710","35588883","5","23742"
"chr6","35636802","35637093","chrX","96283975","96284267","51","60647173"
"chr6","35650755","35650791","chr4","14956334","14956369","8","20694421"
"chr6","35651093","35651166","chr8","47954404","47954481","18","12303311"
"chr6","35657002","35657315","chr19","35632734","35633050","20","24268"
"chr6","35661475","35661565","chr19","42176058","42176147","21","6514583"
"chr6","35662395","35662683","chr19","35643926","35644214","10","18469"
"chr6","35663543","35663668","chr19","35639703","35639833","5","23840"
"chr6","35665010","35665310","chr19","35641186","35641486","12","23824"
"chr6","35667474","35667748","chr19","35635869","35636143","7","31605"
"chr6","35680171","35680475","chr19","35658214","35658490","34","21957"
"chr6","35688369","35688653","chr19","35666370","35666654","2","21999"
"chr6","35692448","35692749","chr19","35670795","35671096","3","21653"
"chr6","35698415","35698648","chr9","66362561","66362793","47","30664146"
"chr6","35704130","35704303","chr19","35682499","35682669","10","21631"
"chr6","35713179","35713447","chr19","35691292","35691560","8","21887"
"chr6","35720002","35720012","chr16","15391248","15391258","1","20328754"
"chr6","35720310","35720479","chr19","35698409","35698577","8","21901"
"chr6","35727759","35728062","chr19","35706626","35706923","8","21133"
"chr6","35728414","35728687","chr19","35707285","35707558","9","21129"
"chr6","35755553","35755843","chr19","35734644","35734938","17","20909"
"chr6","35756522","35756697","chr19","35735610","35735785","2","20912"
"chr6","35771655","35771961","chr19","35750761","35751069","12","20894"
"chr6","35788378","35788506","chr19","35763830","35763938","22","24548"
"chr6","35827536","35827835","chr19","35785970","35786248","47","41566"
"chr6","35836765","35837064","chr19","35785970","35786248","30","50795"
"chr6","35916285","35916567","chr19","35888756","35889038","10","27529"
"chr6","35964887","35965065","chr19","35936845","35937030","10","28042"
"chr6","35965120","35965238","chr1","96094837","96094956","15","60129717"
"chr6","35975958","35976255","chr19","35947358","35947663","15","28600"
"chr6","36008996","36009307","chr19","35979225","35979538","11","29771"
"chr6","36014446","36014743","chr19","35985800","35986099","5","28646"
"chr6","36048301","36048455","chr19","36029396","36029550","1","18905"
"chr6","36049828","36050097","chr19","36031257","36031526","10","18571"
"chr6","36053541","36053708","chr10","14462717","14462877","30","21590824"
"chr6","36063287","36063546","chr19","36044588","36044844","3","18699"
"chr6","36063656","36063935","chr11","119630307","119630588","45","83566651"
"chr6","36098848","36099002","chr19","36081253","36081407","4","17595"
"chr6","36107274","36107608","chr19","36090182","36090510","17","17092"
"chr6","36109357","36109660","chr19","36092984","36093279","15","16373"
"chr6","36110882","36111129","chr19","36094507","36094754","1","16375"
"chr6","36148114","36148285","chr19","36130111","36130278","6","18003"
"chr6","36152981","36153293","chr19","36138651","36138949","19","14330"
"chr6","36170726","36171012","chr19","36157894","36158179","7","12832"
"chr6","36172182","36172494","chr19","36159280","36159591","18","12902"
"chr6","36172801","36172887","chr19","36159898","36159984","2","12903"
"chr6","36173183","36173379","chr19","36160589","36160787","8","12594"
"chr6","36178448","36178751","chr19","36166408","36166707","11","12040"
"chr6","36180147","36180457","chr19","36168097","36168409","8","12050"
"chr6","36187463","36187766","chrX","27894759","27895057","65","8292704"
"chr6","36213880","36214169","chr19","36204622","36204916","12","9258"
"chr6","36214734","36215028","chr19","36205514","36205797","14","9220"
"chr6","36220584","36220711","chr19","36211273","36211392","12","9311"
"chr6","36233982","36234256","chr19","36224645","36224919","6","9337"
"chr6","36236865","36237185","chr19","36227132","36227452","6","9733"
"chr6","36239147","36239434","chr19","36229170","36229457","9","9977"
"chr6","36250975","36251274","chr19","36240985","36241284","4","9990"
"chr6","36251331","36251487","chr18","42345274","42345410","35","6093943"
"chr6","36252538","36252845","chr19","36242547","36242854","7","9991"
"chr6","36253739","36254023","chr19","36243744","36244028","4","9995"
"chr6","36287094","36287291","chr19","36277257","36277449","11","9837"
"chr6","36288120","36288270","chr19","36278281","36278441","11","9839"
"chr6","36288591","36288726","chr19","36278733","36278868","2","9858"
"chr6","36289492","36289724","chr19","36279639","36279865","13","9853"
"chr6","36301215","36301333","chr19","36291595","36291713","5","9620"
"chr6","36301634","36301820","chr19","36292025","36292210","4","9609"
"chr6","36311588","36311878","chr19","36302161","36302452","9","9427"
"chr6","36318682","36318992","chr19","36308713","36309024","9","9969"
"chr6","36321733","36322034","chr19","36311762","36312070","14","9971"
"chr6","36323738","36324037","chr19","36314067","36314366","11","9671"
"chr6","36327826","36328123","chr19","36318177","36318479","17","9649"
"chr6","36328846","36329100","chr19","36319276","36319531","12","9570"
"chr6","36346530","36346832","chr19","36337218","36337522","11","9312"
"chr6","36388670","36388952","chr19","36379134","36379430","20","9536"
"chr6","36392754","36393062","chr19","36383536","36383837","19","9218"
"chr6","36416098","36416347","chr19","36407129","36407408","52","8969"
"chr6","36417344","36417639","chr19","36408401","36408696","5","8943"
"chr6","36427008","36427092","chr19","36418720","36418804","3","8288"
"chr6","36432707","36432984","chr1","64488499","64488769","65","28055792"
"chr6","36433014","36433027","chr19","36425288","36425301","0","7726"
"chr6","36462971","36463145","chrX","107430136","107430308","36","70967165"
"chr6","36463452","36463586","chr11","46246889","46247023","15","9783437"
"chr6","36464063","36464184","chr14","55660200","55660324","23","19196137"
"chr6","36466316","36466627","chr19","36459766","36460077","5","6550"
"chr6","36466924","36467103","chr19","36460374","36460545","9","6550"
"chr6","36467414","36467562","chr19","36460855","36461008","11","6559"
"chr6","36501347","36501632","chr19","36498226","36498510","5","3121"
"chr6","36502291","36502561","chr19","36499477","36499775","40","2814"
"chr6","36506391","36506650","chr19","36504470","36504729","9","1921"
"chr6","36511799","36512113","chr1","30097544","30097868","78","6414255"
"chr6","36531085","36531348","chr19","36530974","36531238","4","111"
"chr6","36533992","36534305","chr19","36533895","36534210","5","97"
"chr6","36544529","36544805","chr11","121352926","121353191","77","84808397"
"chr6","36552309","36552603","chr19","36552384","36552679","6","75"
"chr6","36562959","36563240","chr19","36563103","36563382","7","144"
"chr6","36571271","36571565","chr19","36572113","36572408","4","842"
"chr6","36575069","36575293","chr19","36575939","36576163","0","870"
"chr6","36576650","36576956","chr17","76159820","76160134","59","39583170"
"chr6","36582712","36582970","chr5","595691","595948","53","35987021"
"chr6","36583354","36583454","chr19","36584251","36584350","4","897"
"chr6","36585824","36585984","chr10","463482","463641","33","36122342"
"chr6","36586308","36586450","chr19","36587204","36587342","7","896"
"chr6","36586746","36586887","chr19","36587643","36587784","6","897"
"chr6","36591909","36592217","chr19","36590427","36590735","11","1482"
"chr6","36599684","36599821","chr19","36598804","36598941","2","880"
"chr6","36600133","36600298","chr19","36599252","36599425","13","881"
"chr6","36608965","36609234","chr19","36606950","36607213","14","2015"
"chr6","36620174","36620312","chr2","87936677","87936810","23","51316503"
"chr6","36622857","36623035","chr19","36623190","36623374","8","333"
"chr6","36633112","36633383","chr13","29178242","29178510","42","7454870"
"chr6","36637618","36637915","chr19","36634710","36635018","21","2908"
"chr6","36674194","36674480","chr19","36671651","36671938","8","2543"
"chr6","36678604","36678726","chr19","36676106","36676228","0","2498"
"chr6","36682695","36682806","chr19","36679987","36680101","4","2708"
"chr6","36683111","36683312","chr19","36680410","36680591","24","2701"
"chr6","36688411","36688606","chr4","42686105","42686316","47","5997694"
"chr6","36706228","36706517","chr19","36704334","36704623","1","1894"
"chr6","36715112","36715283","chr19","36714167","36714330","13","945"
"chr6","36715589","36715738","chr19","36714635","36714785","3","954"
"chr6","36716149","36716440","chr19","36715197","36715488","7","952"
"chr6","36716554","36716856","chr19","36715602","36715898","13","952"
"chr6","36718260","36718382","chr19","36716999","36717107","21","1261"
"chr6","36732224","36732513","chr19","36731383","36731672","16","841"
"chr6","36773659","36773946","chr19","36770770","36771063","11","2889"
"chr6","36827607","36827923","chr19","36825712","36826035","15","1895"
"chr6","36899431","36899732","chr19","37100009","37100305","8","200578"
"chr6","36915703","36916003","chr2","149220987","149221284","52","112305284"
"chr6","36920072","36920380","chr2","184470933","184471234","60","147550861"
"chr6","36934679","36934874","chr12","32383743","32383930","43","4550936"
"chr6","36935510","36935610","chr17","10782653","10782748","19","26152857"
"chr6","36937584","36937897","chr20","53473012","53473321","71","16535428"
"chr6","36940506","36940792","chr11","6555732","6556015","57","30384774"
"chr6","36943163","36943484","chr3","87626219","87626544","60","50683056"
"chr6","36946332","36946465","chr2","62399089","62399222","20","25452757"
"chr6","36946780","36946936","chr11","46117268","46117429","29","9170488"
"chr6","36949560","36949868","chr7","48829694","48829990","61","11880134"
"chr6","36962952","36963104","chr7","24531972","24532123","32","12430980"
"chr6","36967185","36967309","chr1","69741688","69741813","24","32774503"
"chr6","36967610","36967787","chr1","37933735","37933919","43","966125"
"chr6","36974712","36974861","chr4","43080170","43080307","32","6105458"
"chr6","36981948","36982249","chr12","89683420","89683718","49","52701472"
"chr6","36983086","36983313","chrX","9520448","9520678","40","27462638"
"chr6","36985153","36985432","chr9","90524786","90525060","45","53539633"
"chr6","36997649","36997928","chr11","121699164","121699421","81","84701515"
"chr6","37004328","37004643","chrX","41341410","41341721","58","4337082"
"chr6","37005385","37005527","chr3","37842458","37842607","24","837073"
"chr6","37007925","37008194","chr16","73796312","73796573","64","36788387"
"chr6","37008329","37008608","chr19","37113323","37113611","19","104994"
"chr6","37009308","37009465","chr19","37114291","37114448","6","104983"
"chr6","37010369","37010508","chr19","37114686","37114813","14","104317"
"chr6","37013339","37013626","chr14","7153919","7154206","52","29859420"
"chr6","37014893","37015200","chr19","37118565","37118872","2","103672"
"chr6","37019687","37019855","chr6","153579550","153579715","38","116559863"
"chr6","37019903","37020032","chr19","8823333","8823462","20","28196570"
"chr6","37022909","37023211","chr19","37127224","37127523","6","104315"
"chr6","37036064","37036202","chr1","1658615","1658747","27","35377449"
"chr6","37037926","37038218","chr19","37142765","37143065","23","104839"
"chr6","37043297","37043536","chr19","37148165","37148451","54","104868"
"chr6","37045892","37046067","chr6","85139536","85139711","36","48093644"
"chr6","37046937","37047066","chr11","124217966","124218098","24","87171029"
"chr6","37054656","37054945","chr4","141670860","141671156","62","104616204"
"chr6","37056093","37056259","chr19","37162232","37162399","1","106139"
"chr6","37056558","37056706","chr19","37162698","37162846","4","106140"
"chr6","37077636","37077714","chr3","38066494","38066560","22","988858"
"chr6","37078684","37078980","chr19","37185222","37185481","42","106538"
"chr6","37079164","37079286","chr19","37185698","37185820","4","106534"
"chr6","37079575","37079756","chr19","37186117","37186298","4","106542"
"chr6","37079829","37080137","chr19","37186371","37186679","11","106542"
"chr6","37081351","37081663","chr19","37195930","37196236","13","114579"
"chr6","37083844","37084134","chr19","37189016","37189306","5","105172"
"chr6","37091064","37091355","chr19","37198267","37198554","6","107203"
"chr6","37092500","37092776","chr19","37199699","37199962","34","107199"
"chr6","37101752","37102112","chr19","37208990","37209344","16","107238"
"chr6","37102728","37103007","chr19","37210318","37210590","18","107590"
"chr6","37103402","37103710","chr19","37210985","37211266","36","107583"
"chr6","37122487","37122777","chr19","37229703","37229999","9","107216"
"chr6","37126464","37126741","chr20","2899227","2899498","64","34227237"
"chr6","37126745","37127044","chr19","37234376","37234664","17","107631"
"chr6","37136040","37136167","chr7","52810378","52810499","34","15674338"
"chr6","37136184","37136488","chr19","37244104","37244401","16","107920"
"chr6","37151893","37152178","chr4","36588688","36588979","60","563205"
"chr6","37154377","37154403","chr16","72234591","72234615","4","35080214"
"chr6","37154712","37154984","chr7","159550513","159550789","58","122395801"
"chr6","37162621","37162915","chr19","37279660","37279958","10","117039"
"chr6","37179031","37179344","chr19","37286662","37286970","18","107631"
"chr6","37198528","37198822","chr19","37306061","37306355","4","107533"
"chr6","37204424","37204727","chr19","37311956","37312262","9","107532"
"chr6","37210584","37210870","chr15","41531442","41531726","49","4320858"
"chr6","37213799","37214033","chr1","111199492","111199714","50","73985693"
"chr6","37214375","37214573","chr19","37321919","37322121","6","107544"
"chr6","37218479","37218768","chr19","37325858","37326150","15","107379"
"chr6","37230203","37230499","chr19","37342753","37343049","14","112550"
"chr6","37239222","37239511","chr19","37350728","37351017","2","111506"
"chr6","37242817","37242902","chr19","37354150","37354235","4","111333"
"chr6","37244451","37244737","chr19","37355750","37356036","5","111299"
"chr6","37280485","37280772","chr19","37393644","37393929","6","113159"
"chr6","37283077","37283331","chr19","37396219","37396473","0","113142"
"chr6","37286998","37287151","chr19","37399830","37399982","3","112832"
"chr6","37322432","37322732","chr7","144722358","144722661","56","107399926"
"chr6","37334031","37334097","chr18","51499572","51499640","17","14165541"
"chr6","37361697","37361973","chr19","37480041","37480306","15","118344"
"chr6","37363214","37363499","chr19","37481542","37481852","36","118328"
"chr6","37418619","37418912","chr19","37540111","37540404","5","121492"
"chr6","37487237","37487501","chr19","37607368","37607629","8","120131"
"chr6","37529605","37529896","chr19","37649177","37649467","8","119572"
"chr6","37535770","37536038","chr1","12027559","12027812","62","25508211"
"chr6","37539125","37539431","chr19","37660529","37660834","12","121404"
"chr6","37560695","37560808","chr19","37682265","37682382","5","121570"
"chr6","37560988","37561104","chr19","37682567","37682683","1","121579"
"chr6","37561729","37561944","chr19","37683307","37683522","1","121578"
"chr6","37582058","37582348","chr19","37705845","37706136","7","123787"
"chr6","37583603","37583693","chr19","37707384","37707474","2","123781"
"chr6","37584806","37585132","chr19","37708577","37708904","26","123771"
"chr6","37628105","37628202","chr9","104568600","104568700","22","66940495"
"chr6","37647258","37647543","chr19","37771380","37771680","23","124122"
"chr6","37688794","37688993","chr19","37818110","37818306","5","129316"
"chr6","37746667","37746958","chr19","37877714","37878012","13","131047"
"chr6","37750062","37750407","chr19","37881054","37881396","25","130992"
"chr6","37750558","37750695","chr7","39087247","39087382","22","1336689"
"chr6","37750698","37750775","chr1","179599376","179599456","14","141848678"
"chr6","37779978","37780258","chr19","37915883","37916163","3","135905"
"chr6","37841516","37841783","chr19","37977380","37977679","39","135864"
"chr6","37861136","37861312","chr19","37999386","37999562","13","138250"
"chr6","37886927","37887214","chr19","38025351","38025636","10","138424"
"chr6","37891298","37891431","chr19","38029431","38029564","1","138133"
"chr6","37902633","37902773","chr19","38041259","38041398","5","138626"
"chr6","37917203","37917426","chr19","38059062","38059253","38","141859"
"chr6","37939140","37939399","chr19","38081669","38081928","6","142529"
"chr6","37943354","37943490","chr19","38085879","38086015","3","142525"
"chr6","37943799","37943909","chr19","38086318","38086416","23","142519"
"chr6","37944186","37944252","chr19","38086693","38086754","6","142507"
"chr6","37959830","37960113","chr3","29291801","29292082","47","8668029"
"chr6","37960145","37960158","chr3","151370667","151370680","1","113410522"
"chr6","37972170","37972468","chr19","38115243","38115547","14","143073"
"chr6","37982914","37983200","chr9","116429460","116429745","59","78446546"
"chr6","38000343","38000655","chr1","15913862","15914170","63","22086481"
"chr6","38003479","38003746","chr1","11489497","11489768","54","26513982"
"chr6","38014065","38014223","chr19","43411371","43411524","32","5397306"
"chr6","38045941","38046139","chr19","38187307","38187499","16","141366"
"chr6","38058101","38058407","chr12","64088089","64088390","54","26029988"
"chr6","38074787","38074925","chr11","97458042","97458175","33","59383255"
"chr6","38087134","38087439","chr19","38147246","38147551","11","60112"
"chr6","38109861","38110169","chr19","38168443","38168751","14","58582"
"chr6","38110239","38110528","chr19","38168818","38169107","6","58579"
"chr6","38113407","38113470","chr19","38172273","38172344","10","58866"
"chr6","38131830","38132126","chr19","38193338","38193633","12","61508"
"chr6","38135850","38136146","chr19","38197092","38197388","6","61242"
"chr6","38143760","38144074","chr19","38206977","38207290","18","63217"
"chr6","38152853","38153085","chr19","38216287","38216524","22","63434"
"chr6","38154999","38155281","chr19","38218463","38218747","4","63464"
"chr6","38157051","38157067","chr7","56844898","56844911","4","18687847"
"chr6","38167864","38168173","chr19","38231406","38231715","4","63542"
"chr6","38190698","38190852","chr19","14673246","14673394","41","23517452"
"chr6","38190981","38191077","chr6","139956525","139956610","20","101765544"
"chr6","38204609","38204917","chr19","38271917","38272225","6","67308"
"chr6","38205972","38206226","chr19","38273591","38273846","7","67619"
"chr6","38207859","38208158","chr7","41928332","41928624","56","3720473"
"chr6","38211185","38211316","chr19","38270456","38270587","6","59271"
"chr6","38212357","38212665","chr19","38271917","38272225","6","59560"
"chr6","38213720","38213974","chr19","38273591","38273846","7","59871"
"chr6","38221362","38221551","chr11","94783606","94783792","34","56562244"
"chr6","38244155","38244351","chr3","69171826","69172021","48","30927671"
"chr6","38246931","38247047","chr9","88436818","88436931","18","50189887"
"chr6","38248057","38248295","chr3","172605060","172605286","56","134357003"
"chr6","38252588","38252753","chr19","38314118","38314283","2","61530"
"chr6","38255596","38255905","chr3","74896192","74896496","63","36640596"
"chr6","38258599","38258681","chr19","38320106","38320188","2","61507"
"chr6","38266067","38266184","chr19","38328843","38328960","5","62776"
"chr6","38268576","38268883","chr19","38331352","38331659","9","62776"
"chr6","38269293","38269578","chr19","38332076","38332355","13","62783"
"chr6","38277002","38277162","chr19","38339009","38339170","3","62007"
"chr6","38277450","38277584","chr19","38339460","38339594","3","62010"
"chr6","38281333","38281634","chr19","38344459","38344760","8","63126"
"chr6","38282879","38283086","chr19","38346330","38346505","37","63451"
"chr6","38283378","38283689","chr19","38346800","38347108","11","63422"
"chr6","38285292","38285441","chr6","65604236","65604384","30","27318944"
"chr6","38285746","38285879","chr19","38349172","38349305","3","63426"
"chr6","38304099","38304378","chr19","38372041","38372319","7","67942"
"chr6","38306646","38306942","chr15","92728954","92729252","53","54422308"
"chr6","38308673","38308975","chr19","38367681","38367987","12","59008"
"chr6","38310891","38311181","chr19","38376996","38377284","7","66105"
"chr6","38312926","38313223","chr15","22258204","22258505","48","16054722"
"chr6","38316020","38316163","chr19","38382093","38382236","1","66073"
"chr6","38316478","38316637","chr19","38382548","38382705","3","66070"
"chr6","38316639","38316938","chr19","38382707","38383005","20","66068"
"chr6","38325071","38325368","chr19","38392369","38392667","4","67298"
"chr6","38330183","38330349","chr6","148135774","148135932","32","109805591"
"chr6","38333628","38333911","chr19","38400701","38400984","9","67073"
"chr6","38337611","38337900","chr19","38404765","38405049","10","67154"
"chr6","38353097","38353415","chr1","130888805","130889106","85","92535708"
"chr6","38354059","38354159","chr2","112237158","112237252","19","73883099"
"chr6","38354178","38354471","chr19","38422523","38422791","47","68345"
"chr6","38357343","38357639","chr19","38425744","38426043","19","68401"
"chr6","38369961","38370074","chr14","67846295","67846408","22","29476334"
"chr6","38370981","38371167","chr1","848385","848567","47","37522596"
"chr6","38373610","38373894","JH682906","100412","100697","8","38273198"
"chr6","38381646","38381803","chr2","149546178","149546324","48","111164532"
"chr6","38394859","38395139","chr2","77592884","77593158","55","39198025"
"chr6","38395450","38395592","JH682906","64489","64630","6","38330961"
"chr6","38402151","38402279","chr1","129148010","129148141","25","90745859"
"chr6","38412034","38412331","JH682906","51654","51961","18","38360380"
"chr6","38415333","38415573","chr3","36201756","36201985","52","2213577"
"chr6","38424877","38424966","JH682906","38979","39067","2","38385898"
"chr6","38435277","38435571","JH682906","27720","28014","5","38407557"
"chr6","38437242","38437521","JH682906","25771","26049","3","38411471"
"chr6","38438135","38438357","JH682906","24936","25158","6","38413199"
"chr6","38440086","38440371","chr9","80951927","80952214","72","42511841"
"chr6","38440377","38440673","JH682906","20812","21108","5","38419565"
"chr6","38450892","38451186","chr11","45323823","45324117","52","6872931"
"chr6","38461053","38461201","chr9","94576843","94576986","32","56115790"
"chr6","38461617","38461781","chr19","33025275","33025439","30","5436342"
"chr6","38461978","38462143","JH682906","1205","1370","2","38460773"
"chr6","38471671","38472021","chr4","113000059","113000390","73","74528388"
"chr6","38473629","38473920","chr19","38440938","38441229","13","32691"
"chr6","38476757","38477067","chr8","17014783","17015087","62","21461974"
"chr6","38479692","38479986","chr19","38447572","38447866","10","32120"
"chr6","38481060","38481367","chr2","66111349","66111658","60","27630289"
"chr6","38488606","38488743","chr19","38457951","38458086","7","30655"
"chr6","38489052","38489356","chr19","38458407","38458711","10","30645"
"chr6","38489357","38489503","chr19","38458712","38458854","6","30645"
"chr6","38492396","38492710","chr19","38462039","38462351","14","30357"
"chr6","38506501","38506691","chr13","108242720","108242914","45","69736219"
"chr6","38507375","38507493","chr14","75381063","75381176","23","36873688"
"chr6","38542391","38542701","chr13","41851851","41852159","59","3309460"
"chr6","38547657","38547953","chr19","38523825","38524121","4","23832"
"chr6","38548854","38549134","chr19","38525025","38525310","14","23829"
"chr6","38554813","38555091","chr19","38530985","38531280","18","23828"
"chr6","38565716","38565927","chr19","38542173","38542384","10","23543"
"chr6","38566168","38566483","chr19","38542625","38542947","21","23543"
"chr6","38568960","38569269","chr19","38545749","38546054","16","23211"
"chr6","38594880","38595159","chr19","38573563","38573833","20","21317"
"chr6","38604442","38604749","chr19","38583101","38583411","13","21341"
"chr6","38627589","38627699","chr2","21100657","21100766","18","17526932"
"chr6","38628140","38628333","chr7","132782735","132782912","61","94154595"
"chr6","38629273","38629432","chr19","38604550","38604711","4","24723"
"chr6","38645743","38646043","chr19","38628130","38628430","4","17613"
"chr6","38650744","38651040","chr19","38635022","38635318","14","15722"
"chr6","38651881","38652175","chr19","38636702","38636998","10","15179"
"chr6","38654448","38654528","chr10","51607274","51607352","10","12952826"
"chr6","38673635","38673916","chr19","38658803","38659100","24","14832"
"chr6","38680699","38681000","chr19","38666207","38666507","16","14492"
"chr6","38688088","38688250","chr12","35011112","35011282","34","3676976"
"chr6","38707017","38707184","chr14","17928432","17928600","30","20778585"
"chr6","38708608","38708874","chr19","38690705","38690971","12","17903"
"chr6","38726222","38726529","chr8","30770102","30770397","52","7956120"
"chr6","38732304","38732567","chr8","18033459","18033730","51","20698845"
"chr6","38737890","38738152","chr19","38723499","38723751","13","14391"
"chr6","38742538","38742646","chr1","215472697","215472799","20","176730159"
"chr6","38742953","38743119","chr19","38728549","38728722","10","14404"
"chr6","38745062","38745375","chr19","38730120","38730428","19","14942"
"chr6","38747622","38747926","chr19","38733707","38734012","20","13915"
"chr6","38756762","38757029","chr19","38743447","38743712","10","13315"
"chr6","38758709","38758846","chr19","38745403","38745538","4","13306"
"chr6","38768511","38768645","chr19","38754506","38754638","6","14005"
"chr6","38768951","38768962","chr10","16927175","16927186","3","21841776"
"chr6","38770003","38770301","chr19","38755995","38756296","18","14008"
"chr6","38771450","38771470","chr11","53010695","53010714","4","14239245"
"chr6","38771780","38772055","chr1","204138470","204138718","79","165366690"
"chr6","38780767","38781034","chr19","38766717","38766985","12","14050"
"chr6","38787643","38787767","chr19","38778621","38778759","16","9022"
"chr6","38795557","38795703","chr19","38788067","38788214","4","7490"
"chr6","38796768","38797056","chr19","38786498","38786790","14","10270"
"chr6","38824904","38825215","chr19","38817729","38818035","15","7175"
"chr6","38825259","38825544","chr19","38818079","38818363","5","7180"
"chr6","38826811","38827043","chr19","38819940","38820172","4","6871"
"chr6","38848340","38848638","chr19","38843256","38843550","8","5084"
"chr6","38865143","38865425","chr19","38861191","38861473","17","3952"
"chr6","38875757","38876060","chr19","38874038","38874346","19","1719"
"chr6","38884584","38884768","chr19","34860936","34861106","41","4023648"
"chr6","38886341","38886475","chr1","37382799","37382931","24","1503542"
"chr6","38890064","38890187","chr14","53330918","53331043","18","14440854"
"chr6","38890227","38890524","chr2","97022915","97023209","61","58132688"
"chr6","38900904","38901039","chr19","38899856","38899991","0","1048"
"chr6","38901354","38901539","chr19","38900311","38900491","7","1043"
"chr6","38903448","38903721","chr19","38902360","38902634","4","1088"
"chr6","38906956","38907256","chr19","38906213","38906513","8","743"
"chr6","38907475","38907650","chr19","38906733","38906908","5","742"
"chr6","38911473","38911780","chr19","38911150","38911447","13","323"
"chr6","38937434","38937612","chr19","38940610","38940788","5","3176"
"chr6","38937909","38937921","chr19","38941399","38941411","0","3490"
"chr6","38943724","38944008","chr19","38947590","38947874","5","3866"
"chr6","38952448","38952752","chr19","38956631","38956933","15","4183"
"chr6","38958096","38958392","chr19","38962266","38962560","5","4170"
"chr6","38961092","38961303","chr19","38965563","38965767","14","4471"
"chr6","38961608","38961704","chr19","38966082","38966177","2","4474"
"chr6","38968396","38968686","chr19","38973432","38973722","8","5036"
"chr6","38984125","38984264","chr19","38989267","38989415","16","5142"
"chr6","38984875","38985003","chr4","163665416","163665541","11","124680541"
"chr6","38985178","38985335","chr4","163665083","163665243","16","124679905"
"chr6","38986642","38986800","chr19","38991667","38991814","16","5025"
"chr6","38988685","38988975","chr4","69077877","69078163","56","30089192"
"chr6","38993738","38993898","chr1","29993140","29993298","25","9000598"
"chr6","38998301","38998589","chr19","39002539","39002833","10","4238"
"chr6","39003286","39003452","chr19","39007227","39007393","5","3941"
"chr6","39003759","39003790","chr20","26384073","26384099","8","12619686"
"chr6","39004088","39004204","chr11","30819298","30819411","19","8184790"
"chr6","39015873","39016177","chr19","39018235","39018537","22","2362"
"chr6","39020350","39020648","chr19","39022722","39023018","8","2372"
"chr6","39024554","39024625","chr2","14893150","14893215","18","24131404"
"chr6","39045061","39045357","chr19","39046974","39047252","27","1913"
"chr6","39051582","39051878","chr19","39053461","39053729","34","1879"
"chr6","39057805","39058016","chr15","25544065","25544269","56","13513740"
"chr6","39061222","39061533","chr19","39061699","39062008","6","477"
"chr6","39064308","39064540","chr16","4991562","4991799","51","34072746"
"chr6","39071974","39072118","chr16","51097787","51097931","40","12025813"
"chr6","39074370","39074675","chr19","39078927","39079232","7","4557"
"chr6","39074750","39074856","chr19","39079308","39079413","6","4558"
"chr6","39081158","39081313","chr19","39085981","39086136","6","4823"
"chr6","39083261","39083322","chr19","39088264","39088326","6","5003"
"chr6","39084439","39084609","chrX","37752435","37752603","25","1332004"
"chr6","39101286","39101602","chr19","39107057","39107378","17","5771"
"chr6","39101753","39102104","chr11","120908742","120909086","72","81806989"
"chr6","39102617","39102859","chr19","39108372","39108628","19","5755"
"chr6","39105636","39105766","chr19","39111389","39111502","18","5753"
"chr6","39114038","39114162","chr19","39125277","39125401","2","11239"
"chr6","39114916","39115201","chr19","39126144","39126433","17","11228"
"chr6","39123364","39123504","chr19","39136179","39136313","18","12815"
"chr6","39126536","39126781","chr19","39139364","39139608","7","12828"
"chr6","39131018","39131238","chr6","51151632","51151853","38","12020614"
"chr6","39132212","39132473","chr9","22199067","22199317","64","16933145"
"chr6","39133090","39133112","chr19","39156609","39156634","4","23519"
"chr6","39138975","39139287","chr19","39157196","39157510","11","18221"
"chr6","39142133","39142209","chr19","39160726","39160802","1","18593"
"chr6","39148259","39148287","chr19","39153673","39153705","5","5414"
"chr6","39148551","39148707","chr19","39153969","39154135","13","5418"
"chr6","39148711","39148843","chr19","39154148","39154280","4","5437"
"chr6","39160174","39160482","chr19","39176057","39176369","18","15883"
"chr6","39162821","39162932","chr19","39178713","39178833","11","15892"
"chr6","39164081","39164346","chr19","39179976","39180245","12","15895"
"chr6","39164667","39164705","chrX","6972755","6972787","8","32191912"
"chr6","39166049","39166371","chr20","21806093","21806406","66","17359956"
"chr6","39168332","39168633","chr19","39184398","39184699","4","16066"
"chr6","39168655","39168955","chr8","119300003","119300299","57","80131348"
"chr6","39169050","39169248","chr19","39185435","39185631","13","16385"
"chr6","39169832","39169987","chr19","39186222","39186375","6","16390"
"chr6","39188812","39188968","chr19","39206579","39206733","22","17767"
"chr6","39194169","39194488","chr19","39211744","39212062","10","17575"
"chr6","39196055","39196332","chr19","39213625","39213902","3","17570"
"chr6","39224312","39224621","chr19","39243071","39243369","18","18759"
"chr6","39247815","39248010","chr13","26807831","26808026","41","12439984"
"chr6","39306492","39306698","chr19","39331121","39331327","3","24629"
"chr6","39333708","39333836","chr4","43561239","43561356","25","4227531"
"chr6","39335273","39335609","chr19","39358585","39358892","33","23312"
"chr6","39340278","39340506","chr15","99486679","99486907","56","60146401"
"chr6","39343132","39343415","chr19","39366618","39366915","17","23486"
"chr6","39343836","39343876","chr15","20149189","20149229","6","19194647"
"chr6","39362116","39362395","chr3","12644640","12644921","48","26717476"
"chr6","39375030","39375378","chr1","48009647","48009984","68","8634617"
"chr6","39376551","39376841","chr19","39399450","39399741","15","22899"
"chr6","39378366","39378660","chr7","123718994","123719282","75","84340628"
"chr6","39384007","39384307","chr19","39412980","39413272","21","28973"
"chr6","39385440","39385730","chr19","39414405","39414702","21","28965"
"chr6","39397986","39398285","chr19","39426682","39426960","27","28696"
"chr6","39398713","39399024","chr19","39427427","39427738","12","28714"
"chr6","39400607","39400897","chr19","38628130","38628430","51","772477"
"chr6","39419474","39419748","chr19","39447166","39447440","8","27692"
"chr6","39439037","39439321","chr19","39468968","39469252","3","29931"
"chr6","39445354","39445664","chr19","39472001","39472303","13","26647"
"chr6","39456971","39457259","chr19","39482894","39483182","7","25923"
"chr6","39461380","39461514","chr19","46828841","46828976","19","7367461"
"chr6","39465359","39465666","chr19","39491427","39491764","37","26068"
"chr6","39491672","39491852","chr13","60629700","60629873","37","21138028"
"chr6","39495550","39495869","chr5","176937510","176937826","75","137441960"
"chr6","39508853","39509136","chr9","42581241","42581525","58","3072388"
"chr6","39543829","39543929","chr1","198465701","198465806","21","158921872"
"chr6","39570603","39570801","chr16","43212690","43212877","45","3642087"
"chr6","39598374","39598664","chr19","39527895","39528183","14","70479"
"chr6","39606039","39606322","chr19","39534436","39534702","24","71603"
"chr6","39606873","39607100","chr9","94815349","94815573","53","55208476"
"chr6","39607158","39607226","chr3","43257586","43257653","12","3650428"
"chr6","39608965","39609278","chr19","39537000","39537314","10","71965"
"chr6","39654032","39654329","chr19","39585531","39585830","9","68501"
"chr6","39661867","39662248","chr1","45668006","45668379","109","6006139"
"chr6","39678365","39678674","chr19","39611572","39611879","5","66793"
"chr6","39681568","39681877","chr19","39614758","39615070","11","66810"
"chr6","39687781","39688076","chr2","113084935","113085229","65","73397154"
"chr6","39693580","39693624","chr6","148291297","148291342","10","108597717"
"chr6","39693625","39693815","chr19","18485698","18485887","35","21207927"
"chr6","39694828","39695099","chrX","41432644","41432924","55","1737816"
"chr6","39708193","39708253","chr15","105169373","105169433","10","65461180"
"chr6","39710569","39710887","chr19","39643951","39644258","23","66618"
"chr6","39715320","39715632","chr3","128147186","128147495","63","88431866"
"chr6","39717131","39717432","chr19","39651008","39651310","6","66123"
"chr6","39723466","39723750","chr1","121994182","121994464","51","82270716"
"chr6","39736398","39736703","chr19","39670688","39670992","4","65710"
"chr6","39740188","39740482","chr19","39674469","39674752","15","65719"
"chr6","39748730","39749057","chr1","26606474","26606791","70","13142256"
"chr6","39757932","39758245","chr3","49634161","49634472","53","9876229"
"chr6","39791871","39792027","chr19","39713476","39713640","11","78395"
"chr6","39800197","39800352","chr19","39722103","39722266","26","78094"
"chr6","39802244","39802548","chr19","39724159","39724460","6","78085"
"chr6","39804576","39804833","chr19","39727148","39727414","13","77428"
"chr6","39820375","39820668","chr19","39752337","39752630","7","68038"
"chr6","39822444","39822751","chr19","39754416","39754717","18","68028"
"chr6","39823487","39823700","chr19","39756551","39756765","5","66936"
"chr6","39824516","39824640","chr19","39757577","39757699","6","66939"
"chr6","39824945","39825127","chr19","39758001","39758182","13","66944"
"chr6","39825425","39825438","chr1","205258045","205258056","3","165432620"
"chr6","39828881","39829193","chr4","36593951","36594258","57","3234930"
"chr6","39829968","39830282","chr6","33100388","33100695","57","6729580"
"chr6","39833315","39833432","chr4","12199879","12199996","30","27633436"
"chr6","39834363","39834523","chr19","39769443","39769593","17","64920"
"chr6","39838770","39838999","chr19","39774446","39774679","12","64324"
"chr6","39876516","39876589","chr16","4369632","4369706","21","35506884"
"chr6","39878972","39879108","chr16","1698484","1698613","21","38180488"
"chr6","39879400","39879571","chr4","119074513","119074677","38","79195113"
"chr6","39879715","39879803","chr20","2197020","2197105","15","37682695"
"chr6","39881522","39881829","chr19","39819633","39819935","14","61889"
"chr6","39896673","39896837","chr19","39834542","39834725","20","62131"
"chr6","39902141","39902396","chr19","39840330","39840585","4","61811"
"chr6","39903319","39903619","chr19","39841515","39841808","16","61804"
"chr6","39904800","39905101","chr19","39842962","39843253","18","61838"
"chr6","39911184","39911472","chr19","39849361","39849645","16","61823"
"chr6","39928967","39929104","chr19","39868005","39868141","4","60962"
"chr6","39929300","39929473","chr19","39868337","39868510","4","60963"
"chr6","39979278","39979536","chr19","39922872","39923132","7","56406"
"chr6","39997850","39998112","chr19","39941148","39941410","14","56702"
"chr6","40002259","40002559","chr19","39946484","39946784","11","55775"
"chr6","40002971","40003253","chr19","39947189","39947470","15","55782"
"chr6","40018258","40018434","chr19","39962630","39962800","12","55628"
"chr6","40019502","40019666","chr15","34671369","34671534","30","5348133"
"chr6","40026460","40026742","chr2","87803247","87803538","49","47776787"
"chr6","40029953","40030242","chr14","7153919","7154206","65","32876034"
"chr6","40037171","40037454","chr19","39981297","39981584","14","55874"
"chr6","40041611","40041907","chr11","6443103","6443394","62","33598508"
"chr6","40047898","40048200","chr19","39992229","39992531","4","55669"
"chr6","40049395","40049675","chr19","39993688","39993968","8","55707"
"chr6","40057104","40057424","chr19","40002010","40002326","10","55094"
"chr6","40057757","40058055","chr19","40002976","40003273","7","54781"
"chr6","40063040","40063275","chr4","6834072","6834310","48","33228968"
"chr6","40066211","40066227","chr1","104032729","104032745","4","63966518"
"chr6","40066524","40066693","chr19","40011906","40012046","31","54618"
"chr6","40067005","40067016","chr7","38556032","38556042","1","1510973"
"chr6","40089118","40089159","chr19","40034895","40034936","1","54223"
"chr6","40089497","40089654","chr19","40035262","40035396","28","54235"
"chr6","40102526","40102894","chr1","9412789","9413153","100","30689737"
"chr6","40104504","40104624","chr3","5702645","5702765","23","34401859"
"chr6","40104659","40104814","chr13","82144285","82144440","31","42039626"
"chr6","40117608","40117914","chr19","40049694","40050000","7","67914"
"chr6","40118437","40118735","chr19","40050522","40050819","11","67915"
"chr6","40119283","40119442","chrX","38470038","38470194","34","1649245"
"chr6","40122254","40122385","chr19","40073527","40073660","7","48727"
"chr6","40122711","40122864","chr19","40073971","40074120","5","48740"
"chr6","40123877","40124178","chr19","40075110","40075414","12","48767"
"chr6","40131582","40131870","chr19","40063014","40063308","14","68568"
"chr6","40132782","40132939","chr19","40064220","40064388","15","68562"
"chr6","40133137","40133236","chr19","40064575","40064680","9","68562"
"chr6","40133661","40133784","chr4","17500554","17500677","26","22633107"
"chr6","40134699","40134867","chrX","38836775","38836941","34","1297924"
"chr6","40140450","40140701","chrX","49961541","49961788","62","9821091"
"chr6","40144057","40144287","chrX","44102397","44102629","64","3958340"
"chr6","40145638","40145899","chr19","40089002","40089264","7","56636"
"chr6","40155001","40155084","chr19","40096984","40097067","1","58017"
"chr6","40155386","40155607","chr16","61643476","61643688","45","21488090"
"chr6","40157129","40157422","chr8","33702808","33703101","66","6454321"
"chr6","40160530","40160750","chr19","40103769","40103988","4","56761"
"chr6","40171390","40171482","chr19","40115482","40115579","8","55908"
"chr6","40173124","40173234","chr19","40117197","40117308","3","55927"
"chr6","40173291","40173591","chr13","86694872","86695169","57","46521581"
"chr6","40177538","40177659","chr19","40121340","40121449","14","56198"
"chr6","40178867","40178943","chr19","28677487","28677561","19","11501380"
"chr6","40185893","40186184","chr19","40137052","40137342","5","48841"
"chr6","40189769","40189883","chr19","40129778","40129892","4","59991"
"chr6","40190139","40190302","chr19","40130146","40130313","9","59993"
"chr6","40198910","40199122","chr19","40147383","40147600","17","51527"
"chr6","40200249","40200337","chr19","40148741","40148829","4","51508"
"chr6","40200693","40200975","chr19","40149179","40149447","16","51514"
"chr6","40214157","40214333","chr19","40159568","40159738","12","54589"
"chr6","40223146","40223275","chr19","40168883","40169016","5","54263"
"chr6","40229427","40229694","chr19","40174895","40175164","6","54532"
"chr6","40236997","40237141","chr19","40182817","40182961","2","54180"
"chr6","40237459","40237613","chr19","40183274","40183426","6","54185"
"chr6","40241351","40241614","chr19","40187344","40187607","8","54007"
"chr6","40244707","40245042","chr20","57414591","57414927","71","17169884"
"chr6","40252186","40252480","chr19","40198137","40198431","7","54049"
"chr6","40256727","40257015","chr19","40203321","40203609","5","53406"
"chr6","40275951","40276231","chr19","40223029","40223309","9","52922"
"chr6","40279003","40279310","chr19","40226070","40226373","11","52933"
"chr6","40279997","40280178","chr19","40227047","40227228","0","52950"
"chr6","40281045","40281344","chr19","40228106","40228394","13","52939"
"chr6","40282425","40282618","chr1","30228392","30228598","40","10054033"
"chr6","40290278","40290574","chr19","40237827","40238128","10","52451"
"chr6","40299110","40299412","chr19","40246959","40247285","27","52151"
"chr6","40302000","40302058","chr7","126552400","126552456","11","86250400"
"chr6","40302473","40302766","chr19","40250347","40250630","15","52126"
"chr6","40304143","40304197","chr19","40252001","40252055","0","52142"
"chr6","40304532","40304669","chr1","1980205","1980345","33","38324327"
"chr6","40305679","40305949","chr19","40253865","40254135","4","51814"
"chr6","40309393","40309680","chr19","40257545","40257830","9","51848"
"chr6","40310591","40310904","chr19","40258744","40259064","16","51847"
"chr6","40319673","40319847","chr19","40268110","40268282","3","51563"
"chr6","40333434","40333741","chr19","40276326","40276625","14","57108"
"chr6","40358283","40358614","chr20","60002582","60002880","76","19644299"
"chr6","40359054","40359349","chr19","40308652","40308946","9","50402"
"chr6","40370189","40370486","chr7","147310304","147310607","53","106940115"
"chr6","40381914","40382044","chr19","40334782","40334912","7","47132"
"chr6","40382363","40382516","chr19","40335230","40335394","13","47133"
"chr6","40398821","40399110","chr19","40356378","40356669","8","42443"
"chr6","40403822","40403996","chr13","37699798","37699966","38","2704024"
"chr6","40404293","40404428","chr19","40357259","40357392","5","47034"
"chr6","40424485","40424629","chr19","40377148","40377308","21","47337"
"chr6","40424902","40425038","chr7","26963619","26963755","35","13461283"
"chr6","40426448","40426726","chr9","39527421","39527692","59","899027"
"chr6","40428444","40428653","chr3","45613516","45613724","49","5185072"
"chr6","40436931","40437235","chr19","40390314","40390580","43","46617"
"chr6","40446538","40446812","chr19","40400506","40400775","11","46032"
"chr6","40448222","40448410","chr19","40403399","40403587","5","44823"
"chr6","40463445","40463732","chr19","40421922","40422217","12","41523"
"chr6","40471047","40471153","chr2","73187524","73187625","24","32716477"
"chr6","40473661","40473982","chr4","161831784","161832114","80","121358123"
"chr6","40474006","40474313","chr2","147481445","147481744","61","107007439"
"chr6","40479378","40479662","chr2","155849752","155850024","66","115370374"
"chr6","40485856","40486085","chr19","40450819","40451048","1","35037"
"chr6","40497087","40497273","chr16","18676418","18676598","38","21820669"
"chr6","40500343","40500490","chr19","40463811","40463943","15","36532"
"chr6","40503712","40504008","chr19","40466999","40467294","5","36713"
"chr6","40509984","40510239","chr19","40474132","40474408","29","35852"
"chr6","40512441","40512728","chr19","40476612","40476900","17","35829"
"chr6","40525166","40525467","chr19","40491659","40491960","7","33507"
"chr6","40527718","40527986","chr7","124798854","124799134","66","84271136"
"chr6","40533069","40533384","chr1","26964612","26964914","62","13568457"
"chr6","40542558","40542799","chr19","40516107","40516348","2","26451"
"chr6","40543167","40543290","chr19","40517007","40517131","8","26160"
"chr6","40543635","40543802","chr19","40517457","40517631","11","26178"
"chr6","40544102","40544233","chr19","40517924","40518051","11","26178"
"chr6","40544242","40544305","chr11","105291412","105291473","15","64747170"
"chr6","40564798","40565092","chr3","42883597","42883894","60","2318799"
"chr6","40573501","40573735","chr1","181101273","181101503","56","140527772"
"chr6","40575312","40575601","chr15","76924584","76924870","52","36349272"
"chr6","40603705","40603994","chr19","40578582","40578872","7","25123"
"chr6","40613274","40613560","chr19","40588701","40588987","10","24573"
"chr6","40621926","40622254","chr1","190650210","190650531","70","150028284"
"chr6","40622584","40622702","chr19","40598229","40598345","4","24355"
"chr6","40631917","40632044","chr19","40607565","40607692","0","24352"
"chr6","40632978","40633281","chr19","40608635","40608934","17","24343"
"chr6","40645015","40645302","chr19","40622172","40622449","14","22843"
"chr6","40657390","40657503","chr4","131412367","131412482","20","90754977"
"chr6","40657544","40657680","chr1","41210201","41210331","26","552657"
"chr6","40664448","40664751","chr19","40640499","40640802","7","23949"
"chr6","40665156","40665253","chr19","40640878","40640981","8","24278"
"chr6","40666832","40667119","chr5","72601094","72601385","64","31934262"
"chr6","40668850","40669133","chr19","40644806","40645079","20","24044"
"chr6","40679147","40679319","chr16","53329934","53330102","37","12650787"
"chr6","40679632","40679761","chr10","27543763","27543893","23","13135869"
"chr6","40681414","40681576","chr19","40657502","40657662","11","23912"
"chr6","40684247","40684542","chr4","132354492","132354788","51","91670245"
"chr6","40689705","40689996","chr19","40668381","40668673","11","21324"
"chr6","40693179","40693337","chr19","40667346","40667506","3","25833"
"chr6","40695001","40695291","chr19","40671364","40671656","39","23637"
"chr6","40695765","40695921","chr10","13063054","13063208","31","27632711"
"chr6","40696249","40696385","chr19","40672929","40673069","13","23320"
"chr6","40698855","40699133","chr3","178244240","178244525","52","137545385"
"chr6","40719510","40719838","chr5","43864843","43865161","77","3145333"
"chr6","40720936","40721229","chr17","20154749","20155043","48","20566187"
"chr6","40724388","40724679","chr19","40701832","40702123","7","22556"
"chr6","40727041","40727325","chr19","40704508","40704793","14","22533"
"chr6","40730983","40731234","chr19","40706707","40706953","14","24276"
"chr6","40761073","40761370","chr2","164269237","164269534","49","123508164"
"chr6","40767552","40767730","chr1","163126356","163126532","36","122358804"
"chr6","40781710","40781997","chr19","40755709","40756005","29","26001"
"chr6","40784561","40784896","chr13","86590504","86590826","69","45805943"
"chr6","40784900","40785120","chr11","82387520","82387742","39","41602620"
"chr6","40785511","40785595","chr1","200695508","200695592","16","159909997"
"chr6","40834628","40834979","chr19","40808263","40808586","45","26365"
"chr6","40869252","40869489","chr7","50056681","50056920","53","9187429"
"chr6","40872063","40872366","chr19","40848281","40848582","5","23782"
"chr6","40899533","40899826","chr19","40886132","40886422","16","13401"
"chr6","40901669","40901965","chr19","40888573","40888869","3","13096"
"chr6","40907764","40908029","chr19","40894070","40894334","7","13694"
"chr6","40910119","40910436","chr19","40896952","40897269","8","13167"
"chr6","40911763","40912068","chr19","40898600","40898905","6","13163"
"chr6","40915366","40915677","chr19","40903225","40903524","27","12141"
"chr6","40917319","40917491","chr19","40904456","40904628","2","12863"
"chr6","40918663","40918862","chr19","40905782","40905972","14","12881"
"chr6","40919205","40919485","chr19","40907772","40908044","13","11433"
"chr6","40940463","40940764","chr19","40923353","40923647","19","17110"
"chr6","40944020","40944307","chr19","40928197","40928490","12","15823"
"chr6","40947485","40947764","chr19","40933349","40933627","7","14136"
"chr6","40963237","40963529","chr19","40945644","40945936","6","17593"
"chr6","40966759","40967068","chr19","40949096","40949405","4","17663"
"chr6","40973002","40973285","chr19","40955283","40955566","2","17719"
"chr6","40977060","40977175","chr19","40959022","40959138","3","18038"
"chr6","40977273","40977382","chr3","152795645","152795755","24","111818372"
"chr6","40980562","40980811","chr4","34011025","34011247","57","6969537"
"chr6","40982381","40982680","chr19","40966203","40966502","9","16178"
"chr6","40985982","40986186","chr3","171417259","171417440","51","130431277"
"chr6","41005805","41006113","chr19","40989189","40989502","14","16616"
"chr6","41024489","41024773","chr19","41008360","41008642","5","16129"
"chr6","41043419","41043684","chr19","41029462","41029721","15","13957"
"chr6","41066295","41066577","chr19","41057905","41058180","13","8390"
"chr6","41071502","41071772","chr19","41062322","41062590","16","9180"
"chr6","41074790","41075100","chr11","50004656","50004962","57","8929866"
"chr6","41084086","41084385","chr19","41074073","41074371","19","10013"
"chr6","41088178","41088483","chr19","41078214","41078514","14","9964"
"chr6","41093056","41093345","chr19","41087189","41087477","6","5867"
"chr6","41097807","41098117","chr19","41090474","41090775","16","7333"
"chr6","41101727","41102030","chr19","41153354","41153653","11","51627"
"chr6","41109394","41109577","chr19","41102525","41102705","8","6869"
"chr6","41110650","41110988","chr19","41103550","41103877","28","7100"
"chr6","41126490","41126670","chr19","41126484","41126663","12","6"
"chr6","41127045","41127231","chr15","9816630","9816799","43","31310415"
"chr6","41136913","41137215","chr2","85207977","85208278","51","44071064"
"chr6","41140938","41141006","chr20","14309840","14309907","20","26831098"
"chr6","41145968","41146287","chr19","41145418","41145737","11","550"
"chr6","41146735","41147013","chr19","41153354","41153653","28","6619"
"chr6","41150250","41150542","chr19","41148134","41148426","8","2116"
"chr6","41155486","41155775","chr19","41159023","41159312","5","3537"
"chr6","41158599","41158887","chr19","41163020","41163308","8","4421"
"chr6","41164395","41164676","chr19","41168717","41169019","29","4322"
"chr6","41201825","41202109","chr19","41204980","41205264","9","3155"
"chr6","41206663","41206733","chr19","41210688","41210764","6","4025"
"chr6","41207057","41207189","chr11","124140433","124140563","24","82933376"
"chr6","41207462","41207792","chr19","41211498","41211830","19","4036"
"chr6","41211831","41212139","chr2","107910239","107910551","56","66698408"
"chr6","41216831","41217098","chr19","41220938","41221201","13","4107"
"chr6","41222691","41222968","chr19","41227152","41227428","13","4461"
"chr6","41223716","41223904","chr19","41228113","41228304","6","4397"
"chr6","41244704","41244994","chr7","109017308","109017597","63","67772604"
"chr6","41263252","41263566","chr19","41268796","41269109","5","5544"
"chr6","41277381","41277556","chr10","455265","455435","37","40822116"
"chr6","41277590","41277676","chr9","20041691","20041780","24","21235899"
"chr6","41277719","41278009","chr10","86922334","86922627","55","45644615"
"chr6","41285739","41286032","chr19","41286519","41286796","24","780"
"chr6","41316520","41316589","chr1","44746983","44747047","13","3430463"
"chr6","41320016","41320282","chr19","41314113","41314382","8","5903"
"chr6","41345575","41345679","chr5","20259577","20259676","14","21085998"
"chr6","41345860","41346151","chr1","63718073","63718356","67","22372213"
"chr6","41351338","41351399","chr11","121742736","121742790","16","80391398"
"chr6","41356134","41356427","chr19","41359243","41359533","12","3109"
"chr6","41359126","41359423","chr19","41362885","41363193","21","3759"
"chr6","41418370","41418685","chr19","41423177","41423495","22","4807"
"chr6","41528964","41529238","chr19","41529846","41530128","17","882"
"chr6","41530098","41530334","chr19","41531018","41531286","38","920"
"chr6","41533210","41533532","chr19","41534749","41535055","22","1539"
"chr6","41540055","41540214","chrX","141531520","141531674","26","99991465"
"chr6","41545586","41545692","chr3","152795645","152795755","18","111250059"
"chr6","41552560","41552840","chr10","26059826","26060100","51","15492734"
"chr6","41581776","41581909","chr19","41582354","41582487","9","578"
"chr6","41585124","41585419","chr19","41587250","41587545","4","2126"
"chr6","41594982","41595266","chr19","41597686","41597992","30","2704"
"chr6","41610055","41610224","chr19","41616202","41616389","20","6147"
"chr6","41613041","41613163","chr19","41610729","41610853","3","2312"
"chr6","41613472","41613662","chr19","41611387","41611575","8","2085"
"chr6","41618456","41618739","chr3","40827683","40827967","63","790773"
"chr6","41628486","41628654","chr7","52873514","52873681","34","11245028"
"chr6","41637366","41637530","chr19","41641822","41641984","9","4456"
"chr6","41637834","41637966","chr19","41642290","41642422","10","4456"
"chr6","41666257","41666392","chr19","41670458","41670593","3","4201"
"chr6","41666700","41666856","chr19","41670900","41671056","4","4200"
"chr6","41691128","41691247","chr3","154543697","154543812","15","112852569"
"chr6","41692009","41692384","chr14","9893399","9893741","97","31798610"
"chr6","41702419","41702718","chr19","41708581","41708872","42","6162"
"chr6","41711114","41711287","chr19","41718646","41718825","14","7532"
"chr6","41754325","41754613","chr9","31537611","31537903","52","10216714"
"chr6","41792470","41792586","chr19","41801304","41801421","3","8834"
"chr6","41820682","41820985","chr19","41836145","41836448","5","15463"
"chr6","41828011","41828173","chr7","79456905","79457080","41","37628894"
"chr6","41828476","41828616","chr19","41835088","41835227","6","6612"
"chr6","41830295","41830577","chr19","41844380","41844659","12","14085"
"chr6","41830613","41830666","chr4","87009896","87009951","16","45179283"
"chr6","41831626","41831903","chr19","41846026","41846303","4","14400"
"chr6","41833028","41833285","chr19","41848348","41848605","5","15320"
"chr6","41834931","41835233","chr19","41850273","41850573","5","15342"
"chr6","41855336","41855500","chr19","41870666","41870835","15","15330"
"chr6","41884780","41885023","chr19","41901592","41901835","6","16812"
"chr6","41898609","41898937","chr19","41926975","41927277","35","28366"
"chr6","41902084","41902255","chr3","78048927","78049100","43","36146843"
"chr6","41902704","41902836","chr11","84387535","84387667","28","42484831"
"chr6","41929904","41930208","chr19","41946408","41946725","23","16504"
"chr6","41934789","41935093","chr19","41973128","41973423","13","38339"
"chr6","41939059","41939355","chr19","41951867","41952139","34","12808"
"chr6","41941254","41941482","chr1","197498153","197498380","43","155556899"
"chr6","41949341","41949660","chr19","41965637","41965949","18","16296"
"chr6","41953587","41953713","chr19","41971192","41971318","4","17605"
"chr6","41954020","41954216","chr19","41979880","41980076","4","25860"
"chr6","41959477","41959611","chr19","41985845","41985979","4","26368"
"chr6","41959906","41960045","chr19","41986274","41986413","2","26368"
"chr6","41973001","41973296","chr19","41999427","41999712","18","26426"
"chr6","41977954","41978079","chr1","179016694","179016818","22","137038740"
"chr6","41982881","41983056","chr19","42009644","42009824","14","26763"
"chr6","41983358","41983416","chr19","42010123","42010181","3","26765"
"chr6","41983889","41984142","chr19","42010654","42010907","10","26765"
"chr6","41994994","41995288","chr19","42022804","42023098","6","27810"
"chr6","42015636","42015929","chr19","42045133","42045451","33","29497"
"chr6","42024050","42024174","chr3","152474105","152474228","21","110450055"
"chr6","42024482","42024660","chr14","84109323","84109498","37","42084841"
"chr6","42029248","42029375","chr19","42058626","42058755","7","29378"
"chr6","42029672","42029810","chr19","42059057","42059197","8","29385"
"chr6","42035055","42035216","chr1","23596488","23596653","28","18438567"
"chr6","42045541","42045864","chr19","42068512","42068771","65","22971"
"chr6","42061532","42061847","chr6","71945525","71945829","63","29883993"
"chr6","42064271","42064478","chr1","54551656","54551867","47","12487385"
"chr6","42070193","42070323","chr19","42088160","42088290","1","17967"
"chr6","42083482","42083659","chr19","42102215","42102374","25","18733"
"chr6","42083962","42084086","chr19","42103003","42103139","18","19041"
"chr6","42091135","42091475","chr7","129403533","129403873","97","87312398"
"chr6","42091476","42091624","chr19","42125862","42126010","6","34386"
"chr6","42091654","42091755","chr19","42126050","42126147","8","34396"
"chr6","42091756","42091771","chr9","28313212","28313227","4","13778544"
"chr6","42093318","42093507","chr1","159463959","159464154","47","117370641"
"chr6","42101359","42101539","chr19","42115378","42115576","22","14019"
"chr6","42101570","42101687","chr19","42115598","42115714","3","14028"
"chr6","42106987","42107199","chr19","42124398","42124609","9","17411"
"chr6","42116464","42116687","chr19","42149055","42149275","9","32591"
"chr6","42133013","42133161","chr2","172227852","172227991","27","130094839"
"chr6","42140569","42140733","chr19","42167521","42167687","11","26952"
"chr6","42143614","42143880","chr19","42170220","42170486","1","26606"
"chr6","42146480","42146693","chr1","38318663","38318872","49","3827817"
"chr6","42148220","42148399","chr19","42178726","42178905","5","30506"
"chr6","42148692","42148838","chr19","42179206","42179369","21","30514"
"chr6","42156791","42157119","chr19","42185974","42186276","47","29183"
"chr6","42158595","42158702","chr6","126703454","126703568","23","84544859"
"chr6","42160090","42160213","chr19","42198042","42198158","10","37952"
"chr6","42160248","42160307","chr16","40062286","40062339","11","2097962"
"chr6","42160645","42160868","chr19","42198610","42198857","27","37965"
"chr6","42162665","42162914","chr19","42198610","42198857","15","35945"
"chr6","42167189","42167273","chr19","42204987","42205071","1","37798"
"chr6","42167840","42167986","chr7","58979998","58980134","39","16812158"
"chr6","42168881","42168933","chr19","42206665","42206717","0","37784"
"chr6","42169841","42170015","chr19","42207611","42207803","23","37770"
"chr6","42177195","42177498","chr19","42215857","42216158","12","38662"
"chr6","42179086","42179227","chr19","42217504","42217645","3","38418"
"chr6","42181665","42181968","chr7","130143130","130143438","64","87961465"
"chr6","42183096","42183253","chr19","42221479","42221638","4","38383"
"chr6","42183556","42183705","chr19","42221943","42222092","2","38387"
"chr6","42199630","42199916","chr19","42239177","42239467","14","39547"
"chr6","42202489","42202771","chr19","42242035","42242323","16","39546"
"chr6","42204271","42204453","chr19","42243841","42244035","19","39570"
"chr6","42204749","42204873","chr19","42244331","42244455","0","39582"
"chr6","42210509","42210663","chr19","42250082","42250246","20","39573"
"chr6","42212745","42213059","chr19","42252315","42252629","5","39570"
"chr6","42216078","42216387","chr19","42255470","42255780","7","39392"
"chr6","42217262","42217305","chr19","42256656","42256699","1","39394"
"chr6","42219508","42219782","chr19","42258880","42259154","5","39372"
"chr6","42219784","42220079","chr19","42259156","42259451","8","39372"
"chr6","42220270","42220359","chr7","17265184","17265272","18","24955086"
"chr6","42220668","42220892","chr19","42260669","42260894","8","40001"
"chr6","42229798","42229945","chr19","42267040","42267185","6","37242"
"chr6","42230263","42230403","chr19","42267502","42267658","21","37239"
"chr6","42244002","42244095","chr19","42283486","42283579","2","39484"
"chr6","42244139","42244220","chr19","42283613","42283694","2","39474"
"chr6","42244516","42244656","chr19","42283990","42284131","6","39474"
"chr6","42288342","42288632","chr19","42330279","42330525","53","41937"
"chr6","42299105","42299280","chr19","42341462","42341636","8","42357"
"chr6","42310238","42310524","chr19","42352092","42352378","4","41854"
"chr6","42331982","42332281","chr4","154948284","154948586","59","112616302"
"chr6","42336461","42336761","chr19","42379594","42379898","23","43133"
"chr6","42344689","42344887","chr19","42387837","42388029","12","43148"
"chr6","42345170","42345308","chr19","42388315","42388455","8","43145"
"chr6","42347675","42347822","chr19","42390762","42390907","6","43087"
"chr6","42365676","42365968","chr19","42409400","42409696","13","43724"
"chr6","42389452","42389773","chr1","40349716","40350025","61","2039736"
"chr6","42390224","42390511","chr19","42438043","42438330","7","47819"
"chr6","42395571","42395863","chr19","42441695","42441978","14","46124"
"chr6","42397150","42397444","chr9","28950811","28951097","59","13446339"
"chr6","42406639","42406911","chr2","44888841","44889083","75","2482202"
"chr6","42419913","42420204","chr5","99807059","99807353","69","57387146"
"chr6","42426032","42426328","chr19","42455363","42455659","8","29331"
"chr6","42427527","42427823","chr19","42456859","42457153","5","29332"
"chr6","42428387","42428541","chr19","42457719","42457874","6","29332"
"chr6","42432836","42433123","chr19","42470123","42470418","19","37287"
"chr6","42436640","42436802","chr19","42462001","42462171","15","25361"
"chr6","42440225","42440529","chr19","42471165","42471469","9","30940"
"chr6","42442703","42442980","chr3","109505522","109505799","47","67062819"
"chr6","42453358","42453662","chr19","42483862","42484166","11","30504"
"chr6","42483766","42484052","chr19","42519416","42519702","6","35650"
"chr6","42503528","42503612","chr19","42537626","42537710","2","34098"
"chr6","42503927","42504129","chr1","11327207","11327391","59","31176720"
"chr6","42513367","42513643","chr19","42547004","42547280","4","33637"
"chr6","42514025","42514062","chr1","46432746","46432787","12","3918721"
"chr6","42525953","42526244","chr19","42559957","42560248","5","34004"
"chr6","42547100","42547386","chr19","42581733","42582018","7","34633"
"chr6","42547949","42548223","chr19","42582581","42582855","4","34632"
"chr6","42555878","42556179","chr19","42592116","42592419","9","36238"
"chr6","42559066","42559263","chr7","120531145","120531344","45","77972079"
"chr6","42563802","42564120","chr19","42599816","42600102","37","36014"
"chr6","42565633","42565753","chr20","19814709","19814828","20","22750924"
"chr6","42577986","42578254","chr19","42615721","42615988","7","37735"
"chr6","42579549","42579863","chr1","45510278","45510576","63","2930729"
"chr6","42581195","42581488","chr16","59760836","59761134","56","17179641"
"chr6","42624724","42624885","chr19","42664178","42664339","5","39454"
"chr6","42625303","42625596","chr14","30200281","30200571","74","12425022"
"chr6","42632542","42632811","chr19","42672267","42672546","16","39725"
"chr6","42634166","42634471","chr19","42673910","42674228","22","39744"
"chr6","42634879","42634980","chr19","42674632","42674733","1","39753"
"chr6","42636394","42636560","chr19","42676098","42676253","17","39704"
"chr6","42646247","42646522","chr2","155939299","155939572","60","113293052"
"chr6","42649210","42649451","chr19","42691691","42691934","8","42481"
"chr6","42650565","42650724","chr19","42693216","42693381","10","42651"
"chr6","42665657","42665917","chr2","25136524","25136774","73","17529133"
"chr6","42667966","42668210","chr19","42712757","42713005","9","44791"
"chr6","42675163","42675456","chr19","42718800","42719093","8","43637"
"chr6","42680491","42680754","chr19","42723745","42724018","19","43254"
"chr6","42686369","42686446","chr19","42732850","42732931","6","46481"
"chr6","42692392","42692657","chr19","42747736","42748028","47","55344"
"chr6","42722193","42722329","chr19","42779341","42779477","3","57148"
"chr6","42722377","42722645","chr19","42779857","42780157","39","57480"
"chr6","42725920","42726054","chr19","42783046","42783178","5","57126"
"chr6","42733570","42733635","chr19","42793764","42793829","0","60194"
"chr6","42733864","42734095","chr19","42794058","42794291","11","60194"
"chr6","42737209","42737505","chr19","42797402","42797705","13","60193"
"chr6","42749904","42749996","chr11","108175220","108175313","17","65425316"
"chr6","42758473","42758757","chr19","42820703","42820987","9","62230"
"chr6","42760636","42760909","chr19","42822875","42823152","22","62239"
"chr6","42761406","42761673","chr19","42823646","42823875","39","62240"
"chr6","42775008","42775218","chr19","42837621","42837834","7","62613"
"chr6","42784412","42784716","chr19","42847801","42848105","12","63389"
"chr6","42784882","42785170","chr19","42848271","42848559","7","63389"
"chr6","42825575","42825637","chr8","124931380","124931440","12","82105805"
"chr6","42831424","42831711","chr3","104066726","104067014","54","61235302"
"chr6","42849622","42849803","chr19","28878864","28879046","35","13970758"
"chr6","42850062","42850176","chr3","154543697","154543812","24","111693635"
"chr6","42854332","42854418","chr2","63954686","63954771","16","21100354"
"chr6","42879237","42879543","chr10","14743584","14743890","63","28135653"
"chr6","42881273","42881552","chr13","97075394","97075670","51","54194121"
"chr6","42891772","42891878","chr1","158500001","158500087","39","115608229"
"chr6","42897930","42898227","chr19","42973468","42973765","9","75538"
"chr6","42912913","42913222","chr19","42994884","42995190","17","81971"
"chr6","42913854","42914031","chr19","42998115","42998292","3","84261"
"chr6","42916678","42916976","chr19","43000949","43001269","29","84271"
"chr6","42923098","42923360","chr7","16396582","16396826","64","26526516"
"chr6","42930729","42931013","chr19","43024031","43024316","20","93302"
"chr6","42939031","42939315","chr19","43024031","43024316","20","85000"
"chr6","42941787","42942065","chr19","43027463","43027748","19","85676"
"chr6","42946791","42947087","chr16","71626907","71627197","73","28680116"
"chr6","42948278","42948440","chr19","43036758","43036919","5","88480"
"chr6","42950178","42950458","chr19","43039275","43039555","6","89097"
"chr6","42952652","42952913","chr19","43042143","43042404","8","89491"
"chr6","42953463","42953765","chr19","43042935","43043241","23","89472"
"chr6","42966762","42966950","chr1","19278268","19278458","44","23688494"
"chr6","42975974","42976260","chr9","89427456","89427739","54","46451482"
"chr6","42978110","42978188","chr20","50167353","50167424","16","7189243"
"chr6","42978507","42978679","chr19","43068598","43068770","1","90091"
"chr6","43023626","43023900","chr19","43119020","43119295","4","95394"
"chr6","43055808","43056102","chr19","43152446","43152741","10","96638"
"chr6","43062897","43063185","chr3","176288014","176288302","53","133225117"
"chr6","43076146","43076301","chr1","127493573","127493724","6","84417427"
"chr6","43094117","43094405","chr19","43196876","43197165","10","102759"
"chr6","43101481","43101543","chr3","40058589","40058650","19","3042892"
"chr6","43112979","43113240","chr19","43212046","43212317","17","99067"
"chr6","43121519","43121823","chr19","43225335","43225632","14","103816"
"chr6","43129767","43130051","chr19","43233311","43233595","4","103544"
"chr6","43135601","43135888","chr19","43238717","43238993","23","103116"
"chr6","43136023","43136311","chr15","74758892","74759180","55","31622869"
"chr6","43138635","43138923","chr19","43241976","43242264","6","103341"
"chr6","43142169","43142473","chr19","43245508","43245803","18","103339"
"chr6","43166910","43167190","chr19","43275099","43275373","18","108189"
"chr6","43175516","43175656","chr14","14756844","14756978","27","28418672"
"chr6","43187095","43187242","chr19","43294920","43295067","2","107825"
"chr6","43187342","43187630","chr19","43295479","43295767","7","108137"
"chr6","43199043","43199309","chr19","43312846","43313090","35","113803"
"chr6","43201062","43201362","chr19","43310108","43310408","6","109046"
"chr6","43209789","43210100","chr7","52979858","52980163","72","9770069"
"chr6","43215763","43216068","chr19","43328130","43328434","10","112367"
"chr6","43227363","43227499","chr19","43340001","43340135","6","112638"
"chr6","43227514","43227686","chr19","43340142","43340318","19","112628"
"chr6","43233096","43233407","chr19","43345640","43345945","9","112544"
"chr6","43243897","43244092","chr17","1681144","1681322","59","41562753"
"chr6","43244350","43244485","chr19","43358006","43358141","4","113656"
"chr6","43255286","43255578","chr10","59443884","59444176","57","16188598"
"chr6","43258882","43259055","chr1","188751467","188751638","43","145492585"
"chr6","43259287","43259415","chr20","929087","929213","30","42330200"
"chr6","43261248","43261423","chr19","43378448","43378623","31","117200"
"chr6","43274232","43274392","chr19","43389532","43389692","10","115300"
"chr6","43274721","43274852","chr19","43390025","43390156","5","115304"
"chr6","43276482","43276711","chr19","43392123","43392328","30","115641"
"chr6","43277059","43277356","chr19","43392674","43392975","11","115615"
"chr6","43279499","43279801","chr19","43395424","43395726","15","115925"
"chr6","43280377","43280456","chr19","43396302","43396381","3","115925"
"chr6","43281214","43281515","chr14","106361295","106361592","59","63080081"
"chr6","43281989","43282291","chr19","43397911","43398213","10","115922"
"chr6","43300851","43301143","chr19","43416301","43416582","21","115450"
"chr6","43337314","43337603","chr19","43450619","43450907","8","113305"
"chr6","43354196","43354504","chr2","101040194","101040507","62","57685998"
"chr6","43358083","43358233","chr6","169794377","169794541","48","126436294"
"chr6","43362156","43362327","chr19","43476185","43476354","7","114029"
"chr6","43362328","43362520","chr19","43476355","43476550","6","114027"
"chr6","43367691","43367986","chr20","54669025","54669320","61","11301334"
"chr6","43400635","43400902","chr19","43515468","43515730","11","114833"
"chr6","43414640","43414656","chr19","43530989","43531005","0","116349"
"chr6","43414954","43415124","chr19","43531305","43531475","9","116351"
"chr6","43421493","43421667","chr19","43538335","43538481","30","116842"
"chr6","43434219","43434515","chr19","43552583","43552880","10","118364"
"chr6","43450594","43450898","chr19","43569254","43569559","10","118660"
"chr6","43452688","43452979","chr19","43571350","43571638","9","118662"
"chr6","43454799","43455079","chr19","43572763","43573045","10","117964"
"chr6","43456083","43456390","chr19","43574058","43574365","8","117975"
"chr6","43468733","43468868","chr19","43587740","43587875","3","119007"
"chr6","43469155","43469310","chr19","43588165","43588319","13","119010"
"chr6","43469636","43469932","chr19","43588983","43589284","14","119347"
"chr6","43472225","43472431","chr19","43591565","43591772","6","119340"
"chr6","43485181","43485348","chr1","23596488","23596653","31","19888693"
"chr6","43488248","43488546","chr14","106361295","106361592","54","62873047"
"chr6","43492902","43493184","chr11","91425287","91425568","67","47932385"
"chr6","43505259","43505511","chr11","60263043","60263277","61","16757784"
"chr6","43510070","43510216","chr1","25816259","25816404","37","17693811"
"chr6","43511733","43511860","chr19","43631320","43631447","2","119587"
"chr6","43524704","43524979","chr19","43644119","43644395","17","119415"
"chr6","43530156","43530462","chr6","125462129","125462434","58","81931973"
"chr6","43544746","43545036","chr19","43661546","43661836","10","116800"
"chr6","43545831","43546007","chr4","43010625","43010796","52","535206"
"chr6","43549879","43550037","chr19","43668052","43668202","23","118173"
"chr6","43604122","43604406","chr12","80341595","80341882","49","36737473"
"chr6","43618062","43618311","chr19","43738131","43738380","8","120069"
"chr6","43640703","43641010","chr7","106842256","106842567","51","63201553"
"chr6","43647164","43647449","chr19","43767952","43768237","5","120788"
"chr6","43649272","43649626","chr7","130770108","130770434","78","87120836"
"chr6","43654196","43654476","chr19","43776577","43776862","21","122381"
"chr6","43664825","43665118","chr19","43786340","43786633","7","121515"
"chr6","43673383","43673696","chr19","43795485","43795797","12","122102"
"chr6","43699926","43700223","chr19","43823568","43823864","5","123642"
"chr6","43701455","43701678","chr12","21152436","21152660","48","22549019"
"chr6","43701755","43701823","chr4","95388095","95388162","16","51686340"
"chr6","43703943","43704179","chr19","43827647","43827884","5","123704"
"chr6","43705408","43705688","chr19","43829111","43829391","4","123703"
"chr6","43722260","43722287","chr1","160224244","160224272","5","116501984"
"chr6","43722334","43722483","chr1","152928618","152928784","44","109206284"
"chr6","43732060","43732326","chr19","43856293","43856567","14","124233"
"chr6","43740968","43741285","chr19","43865158","43865475","10","124190"
"chr6","43764706","43764772","chr19","43887517","43887583","0","122811"
"chr6","43766246","43766554","chr19","43889383","43889679","20","123137"
"chr6","43771144","43771414","chr19","43894284","43894550","14","123140"
"chr6","43783472","43783775","chr19","43907224","43907527","10","123752"
"chr6","43789349","43789660","chr19","43913753","43914064","9","124404"
"chr6","43791638","43791787","chr19","43916055","43916204","8","124417"
"chr6","43793633","43793818","chr19","43918039","43918226","7","124406"
"chr6","43807267","43807518","chr10","12632187","12632435","56","31175080"
"chr6","43810891","43811153","chr16","59949775","59950041","61","16138884"
"chr6","43816255","43816546","chr19","43941963","43942255","8","125708"
"chr6","43818242","43818463","chr19","43944271","43944502","15","126029"
"chr6","43820904","43821193","chr8","43649924","43650209","63","170980"
"chr6","43834000","43834131","chr19","43960076","43960203","6","126076"
"chr6","43835630","43835885","chr19","43962662","43962917","4","127032"
"chr6","43851366","43851632","chr19","43977001","43977275","26","125635"
"chr6","43854706","43855001","chr19","43980289","43980589","15","125583"
"chr6","43958341","43958565","chr19","44100023","44100252","21","141682"
"chr6","43967243","43967428","chr10","82247433","82247616","39","38280190"
"chr6","43968071","43968168","chr18","38839111","38839208","13","5128960"
"chr6","43993685","43993996","chr19","44134093","44134404","5","140408"
"chr6","43994216","43994335","chr19","44134624","44134742","4","140408"
"chr6","43994364","43994509","chr19","44134772","44134918","5","140408"
"chr6","44012692","44012912","chr19","44156025","44156257","14","143333"
"chr6","44015207","44015351","chr4","41247205","41247346","29","2768002"
"chr6","44015682","44015696","chr2","18643214","18643228","3","25372468"
"chr6","44044719","44045027","chr19","44188185","44188483","18","143466"
"chr6","44048042","44048333","chr19","44191512","44191805","11","143470"
"chr6","44058016","44058297","chr19","44201821","44202104","7","143805"
"chr6","44063935","44064224","chr8","135126833","135127120","55","91062898"
"chr6","44072762","44072865","chr19","44209467","44209570","2","136705"
"chr6","44109616","44109708","chr19","44255176","44255268","3","145560"
"chr6","44168527","44168825","chr19","44319967","44320265","4","151440"
"chr6","44180846","44181102","chr19","44331944","44332200","6","151098"
"chr6","44187138","44187339","chr19","44338129","44338351","26","150991"
"chr6","44203513","44203815","chr19","44354128","44354429","14","150615"
"chr6","44207906","44208246","chr19","44358528","44358838","41","150622"
"chr6","44222203","44222492","chr19","44371331","44371620","14","149128"
"chr6","44224332","44224463","chr19","44373445","44373576","1","149113"
"chr6","44238191","44238522","chr1","219440817","219441145","70","175202626"
"chr6","44240263","44240571","chr6","143542879","143543191","60","99302616"
"chr6","44242659","44242966","chr6","73753256","73753561","57","29510597"
"chr6","44258442","44258753","chr19","44410639","44410950","8","152197"
"chr6","44273257","44273564","chr19","44425745","44426046","51","152488"
"chr6","44280368","44280475","chr1","163954934","163955041","23","119674566"
"chr6","44280818","44280994","chrX","112453371","112453542","29","68172553"
"chr6","44281043","44281246","chr3","173325146","173325338","57","129044103"
"chr6","44281457","44281470","chr8","96282562","96282575","5","52001105"
"chr6","44297644","44297792","chr1","15506373","15506526","41","28791271"
"chr6","44297823","44297931","chr11","132254282","132254398","28","87956459"
"chr6","44311075","44311365","chr9","57648963","57649252","61","13337888"
"chr6","44328440","44328572","chr19","44487211","44487345","4","158771"
"chr6","44329124","44329158","chr3","44827294","44827332","9","498170"
"chr6","44329167","44329290","chr4","160987117","160987239","12","116657950"
"chr6","44337887","44338087","chr19","44500663","44500861","6","162776"
"chr6","44338376","44338481","chr3","13311891","13311994","15","31026485"
"chr6","44367911","44368193","chr19","44575026","44575312","14","207115"
"chr6","44413355","44413640","chr19","44620360","44620649","17","207005"
"chr6","44442368","44442649","chr19","44645763","44646042","24","203395"
"chr6","44456930","44457086","chr19","44660718","44660874","7","203788"
"chr6","44464926","44465225","chr19","44668593","44668890","12","203667"
"chr6","44483380","44483685","chr19","44687226","44687522","28","203846"
"chr6","44493712","44493835","chr19","44697257","44697382","5","203545"
"chr6","44498549","44498838","chr19","44702286","44702592","32","203737"
"chr6","44514305","44514601","chr19","44718030","44718326","7","203725"
"chr6","44536131","44536282","chr19","44739908","44740076","22","203777"
"chr6","44536586","44536672","chr19","44740381","44740466","6","203795"
"chr6","44559671","44559756","chr19","44763305","44763390","3","203634"
"chr6","44562515","44562862","chr19","44766156","44766503","15","203641"
"chr6","44593518","44593788","chr19","44797581","44797847","8","204063"
"chr6","44599536","44599855","chr19","44803612","44803943","28","204076"
"chr6","44633122","44633426","chr19","44844132","44844439","6","211010"
"chr6","44649816","44649992","chr19","44860951","44861127","4","211135"
"chr6","44651622","44651787","chr19","44863613","44863778","4","211991"
"chr6","44668094","44668402","chr19","44880031","44880348","12","211937"
"chr6","44670290","44670584","chr19","44882565","44882861","19","212275"
"chr6","44722227","44722531","chr19","44935192","44935495","7","212965"
"chr6","44730774","44731039","chr19","44944474","44944759","27","213700"
"chr6","44753381","44753673","chr19","44974354","44974654","14","220973"
"chr6","44766202","44766487","chr19","44988150","44988435","4","221948"
"chr6","44806154","44806453","chr19","45035002","45035292","20","228848"
"chr6","44837917","44838159","chr19","45066162","45066404","5","228245"
"chr6","44853177","44853478","chr19","45082370","45082671","7","229193"
"chr6","44854026","44854318","chr19","45083219","45083510","7","229193"
"chr6","44858680","44858966","chr19","45087862","45088149","6","229182"
"chr6","44871110","44871122","chr3","150473488","150473501","4","105602378"
"chr6","44871425","44871559","chr1","24057739","24057872","34","20813686"
"chr6","44873246","44873556","chr19","45101939","45102249","12","228693"
"chr6","44875576","44875710","chr2","184466521","184466652","20","139590945"
"chr6","44876082","44876162","chr6","131754080","131754156","16","86877998"
"chr6","44893438","44893729","chr19","45121496","45121782","11","228058"
"chr6","44896471","44896781","chr19","45124516","45124822","9","228045"
"chr6","44902916","44903096","chr6","128103757","128103928","44","83200841"
"chr6","44909336","44909626","chr19","45137908","45138193","20","228572"
"chr6","44932382","44932659","chr19","45163825","45164102","9","231443"
"chr6","44942249","44942420","chr9","21745253","21745427","41","23196996"
"chr6","44947734","44948044","chr19","45180979","45181284","13","233245"
"chr6","44948392","44948620","chr19","45181625","45181867","24","233233"
"chr6","44949001","44949203","chr19","45182223","45182425","10","233222"
"chr6","44972270","44972424","chr19","45205803","45205954","25","233533"
"chr6","44978260","44978391","chr19","45211994","45212120","7","233734"
"chr6","44980378","44980686","chr19","45214086","45214369","34","233708"
"chr6","44980730","44980889","chr19","45214424","45214583","2","233694"
"chr6","44981630","44981771","chr19","45215324","45215465","2","233694"
"chr6","44983002","44983303","chr4","42143224","42143519","54","2839778"
"chr6","44988085","44988388","chr19","45221928","45222230","12","233843"
"chr6","44989842","44990066","chr19","45223692","45223914","14","233850"
"chr6","44994699","44994992","chr19","45228504","45228795","16","233805"
"chr6","44998286","44998600","chr1","141739371","141739677","63","96741085"
"chr6","45014201","45014449","chr19","45249481","45249729","4","235280"
"chr6","45067373","45067601","chr11","132209715","132209942","54","87142342"
"chr6","45078869","45079165","chr19","45316085","45316402","24","237216"
"chr6","45079227","45079373","chr18","53970803","53970943","41","8891576"
"chr6","45095701","45095904","chr5","35383631","35383814","63","9712070"
"chr6","45112474","45112728","chr19","45350974","45351228","8","238500"
"chr6","45126481","45126780","chr20","20292282","20292577","56","24834199"
"chr6","45132458","45132583","chr19","45372170","45372305","13","239712"
"chr6","45142002","45142159","chr10","66975614","66975768","31","21833612"
"chr6","45146486","45146716","chr3","161810116","161810345","72","116663630"
"chr6","45149831","45149975","chr19","45381991","45382135","7","232160"
"chr6","45169444","45169720","chr19","45410680","45410954","11","241236"
"chr6","45183634","45183930","chr19","45426688","45426973","21","243054"
"chr6","45185625","45185926","chr19","45428671","45428981","12","243046"
"chr6","45197790","45198070","chr19","45441552","45441820","22","243762"
"chr6","45203462","45203758","chr19","45469242","45469534","11","265780"
"chr6","45210223","45210386","chr19","45476233","45476396","2","266010"
"chr6","45214791","45215089","chr19","45482093","45482394","10","267302"
"chr6","45233917","45234202","chr19","45504109","45504386","13","270192"
"chr6","45254733","45255006","chr19","45528962","45529237","8","274229"
"chr6","45255007","45255051","chr19","45529238","45529282","1","274231"
"chr6","45266239","45266515","chr19","45699076","45699347","50","432837"
"chr6","45294754","45294915","chr19","46458283","46458443","21","1163529"
"chr6","45308108","45308389","chr19","45586761","45587049","13","278653"
"chr6","45308488","45308616","chr19","45587149","45587277","3","278661"
"chr6","45316967","45317191","chr1","31109629","31109849","60","14207338"
"chr6","45318151","45318311","chr7","53483520","53483679","25","8165369"
"chr6","45347741","45348035","chr19","45628917","45629202","19","281176"
"chr6","45348389","45348679","chr19","45825651","45825948","39","477262"
"chr6","45355544","45355825","chr19","45638206","45638489","13","282662"
"chr6","45377885","45377986","chr19","46315263","46315366","22","937378"
"chr6","45383683","45383975","chr19","45699076","45699347","60","315393"
"chr6","45387082","45387192","chr19","45675999","45676110","1","288917"
"chr6","45392793","45392977","chr19","45667966","45668150","3","275173"
"chr6","45414078","45414377","chr19","45734474","45734773","8","320396"
"chr6","45431546","45431842","chr1","124078288","124078585","61","78646742"
"chr6","45458542","45458607","chr6","126611090","126611154","23","81152548"
"chr6","45462614","45462646","chr12","18094653","18094685","4","27367961"
"chr6","45462654","45462754","chr3","170580820","170580922","19","125118166"
"chr6","45462797","45462947","chr19","45540398","45540549","18","77601"
"chr6","45463601","45463881","chr13","46321996","46322262","61","858395"
"chr6","45474552","45474855","chr19","45921153","45921454","51","446601"
"chr6","45475873","45476147","chr2","44408892","44409163","63","1066981"
"chr6","45477742","45478028","chr6","69030413","69030704","47","23552671"
"chr6","45486453","45486498","chrX","138580388","138580425","12","93093935"
"chr6","45487262","45487432","chr19","45806683","45806843","34","319421"
"chr6","45497251","45497395","chr6","135088942","135089087","40","89591691"
"chr6","45497657","45497852","chr8","6196949","6197137","47","39300708"
"chr6","45500797","45501091","chr19","45921153","45921454","66","420356"
"chr6","45502267","45502554","chr6","69030413","69030704","43","23528146"
"chr6","45512042","45512373","chr9","39592158","39592500","75","5919884"
"chr6","45515807","45515967","chr19","45806683","45806843","4","290876"
"chr6","45530299","45530449","chr19","45725604","45725734","36","195305"
"chr6","45536041","45536335","chr6","139967245","139967543","74","94431204"
"chr6","45538015","45538298","chr6","69030413","69030704","50","23492398"
"chr6","45543614","45543746","chr19","45572768","45572899","15","29154"
"chr6","45554198","45554302","chr19","46315263","46315366","21","761065"
"chr6","45564671","45564996","chr19","46334793","46335112","73","770122"
"chr6","45571047","45571376","chr19","46334793","46335112","79","763746"
"chr6","45573880","45574010","chr19","45572768","45572899","14","1112"
"chr6","45583678","45583945","chr19","45825050","45825326","16","241372"
"chr6","45584271","45584567","chr19","45825651","45825948","13","241380"
"chr6","45599665","45599835","chr19","45841474","45841644","13","241809"
"chr6","45627728","45627848","chr19","45861997","45862125","12","234269"
"chr6","45628295","45628459","chr19","45862433","45862590","10","234138"
"chr6","45636143","45636405","chr7","17235007","17235268","65","28401136"
"chr6","45638081","45638162","chr19","45883073","45883166","16","244992"
"chr6","45639222","45639519","chr19","45884176","45884475","4","244954"
"chr6","45640245","45640360","chr19","45885203","45885322","6","244958"
"chr6","45642001","45642255","chr19","45886960","45887214","6","244959"
"chr6","45652752","45653077","chr1","48009647","48009984","72","2356895"
"chr6","45657424","45657583","chr19","46458283","46458443","25","800859"
"chr6","45671956","45672092","chr19","45916733","45916869","5","244777"
"chr6","45672397","45672574","chr19","45917174","45917355","7","244777"
"chr6","45683894","45684052","chr19","45929263","45929420","4","245369"
"chr6","45702322","45702607","chr19","45948793","45949078","13","246471"
"chr6","45727567","45727823","chr19","45974751","45975007","1","247184"
"chr6","45728384","45728697","chr19","45975854","45976161","9","247470"
"chr6","45748715","45749019","chr19","45988999","45989313","22","240284"
"chr6","45771404","45771676","chr19","46026251","46026490","42","254847"
"chr6","45773349","45773655","chr15","76074451","76074753","53","30301102"
"chr6","45790179","45790472","chr19","46043691","46043987","13","253512"
"chr6","45792864","45793170","chr19","46046335","46046640","9","253471"
"chr6","45801096","45801229","chr18","62221602","62221733","18","16420506"
"chr6","45821528","45821823","chr19","46071744","46072035","8","250216"
"chr6","45823599","45823677","chr19","46074964","46075046","7","251365"
"chr6","45824074","45824229","chr12","13614701","13614861","30","32209373"
"chr6","45845895","45846178","chr19","46096380","46096661","16","250485"
"chr6","45847422","45847708","chr19","46097908","46098198","11","250486"
"chr6","45862934","45863084","chr19","46110047","46110194","11","247113"
"chr6","45869199","45869488","chr19","46124067","46124356","8","254868"
"chr6","45877102","45877398","chr19","46132102","46132397","13","255000"
"chr6","45892105","45892410","chr19","46146890","46147180","30","254785"
"chr6","45955994","45956247","chr19","46214789","46215049","18","258795"
"chr6","45970385","45970686","chr19","46230256","46230557","5","259871"
"chr6","46011821","46012131","chr11","51357004","51357309","69","5345183"
"chr6","46019337","46019518","chr19","46275227","46275409","3","255890"
"chr6","46033372","46033659","chr19","45825651","45825948","32","207721"
"chr6","46034007","46034284","chr19","46292582","46292899","66","258575"
"chr6","46057294","46057403","chr19","46315263","46315366","7","257969"
"chr6","46059228","46059334","chr19","46317290","46317396","4","258062"
"chr6","46059860","46060067","chr19","46317905","46318115","9","258045"
"chr6","46067363","46067662","chr19","46324621","46324920","7","257258"
"chr6","46068059","46068345","chr19","46452100","46452383","39","384041"
"chr6","46073046","46073178","chr19","46330607","46330739","5","257561"
"chr6","46088395","46088644","chr19","46347285","46347542","14","258890"
"chr6","46123727","46124016","chr19","46379389","46379677","10","255662"
"chr6","46126385","46126519","chr19","34988308","34988442","26","11138077"
"chr6","46134582","46134713","chr19","46330607","46330739","17","196025"
"chr6","46160686","46161006","chr19","46292582","46292899","75","131896"
"chr6","46164174","46164400","chr1","93016186","93016399","49","46852012"
"chr6","46175257","46175390","chr11","111931690","111931822","25","65756433"
"chr6","46178470","46178599","chr1","184900161","184900285","28","138721691"
"chr6","46183584","46183891","chr11","30468161","30468469","60","15715423"
"chr6","46197067","46197368","chr19","46451263","46451564","7","254196"
"chr6","46197724","46198007","chr19","46452100","46452383","10","254376"
"chr6","46202839","46203064","chr7","91116341","91116557","46","44913502"
"chr6","46217024","46217310","chr19","46472403","46472687","23","255379"
"chr6","46223075","46223215","chrX","864241","864385","27","45358834"
"chr6","46225309","46225408","chr13","99945303","99945402","17","53719994"
"chr6","46268617","46268745","chr19","46527178","46527317","14","258561"
"chr6","46269064","46269209","chr19","46527635","46527780","3","258571"
"chr6","46276638","46276898","chr19","46535322","46535607","36","258684"
"chr6","46293581","46293895","chr19","46551390","46551707","3","257809"
"chr6","46295476","46295808","chr19","46553843","46554176","18","258367"
"chr6","46303826","46304005","chr19","46563685","46563864","2","259859"
"chr6","46304596","46304885","chr19","46564450","46564744","7","259854"
"chr6","46306068","46306329","chr19","46565924","46566185","9","259856"
"chr6","46316588","46316808","chr11","130089781","130089993","47","83773193"
"chr6","46319198","46319360","chr19","46579029","46579191","4","259831"
"chr6","46331247","46331545","chr19","46593077","46593355","31","261830"
"chr6","46346411","46346567","chr19","46610707","46610864","5","264296"
"chr6","46351156","46351276","chr19","46615425","46615549","7","264269"
"chr6","46359959","46360257","chr19","46623688","46623991","8","263729"
"chr6","46368507","46368795","chr19","46632619","46632907","4","264112"
"chr6","46380924","46381214","chr19","46645819","46646104","11","264895"
"chr6","46382036","46382127","chr9","13607586","13607676","19","32774450"
"chr6","46382860","46383161","chr19","46652377","46652667","14","269517"
"chr6","46384818","46385104","chr19","46662681","46662963","17","277863"
"chr6","46386723","46387006","chr19","46664114","46664385","27","277391"
"chr6","46391615","46391903","chr19","46650193","46650494","25","258578"
"chr6","46398746","46398853","chr19","46661176","46661283","14","262430"
"chr6","46401225","46401488","chr19","46666948","46667214","9","265723"
"chr6","46402835","46403109","chr19","46668565","46668828","18","265730"
"chr6","46407013","46407277","chr19","46672734","46673007","17","265721"
"chr6","46410340","46410606","chr19","46676071","46676343","7","265731"
"chr6","46412273","46412558","chr19","46679524","46679798","15","267251"
"chr6","46414434","46414699","chr19","46681707","46681983","19","267273"
"chr6","46417397","46417674","chr19","46747519","46747800","27","330122"
"chr6","46419527","46419628","chr19","46669466","46669565","30","249939"
"chr6","46419889","46420153","chr19","46711743","46712008","22","291854"
"chr6","46423104","46423200","chr19","46669466","46669565","19","246362"
"chr6","46423424","46423645","chr1","31109629","31109849","69","15313795"
"chr6","46426737","46426879","chr19","46683204","46683346","30","256467"
"chr6","46427452","46427715","chr19","46715512","46715772","12","288060"
"chr6","46428634","46428932","chr19","46716715","46716985","35","288081"
"chr6","46442862","46443139","chr19","46747519","46747800","27","304657"
"chr6","46444735","46445016","chr19","46731890","46732153","28","287155"
"chr6","46450530","46450795","chr19","46679524","46679798","48","228994"
"chr6","46455773","46455867","chr19","46682809","46682906","28","227036"
"chr6","46457012","46457101","chr19","46682809","46682906","27","225797"
"chr6","46457315","46457328","chr3","160810454","160810466","11","114353139"
"chr6","46457646","46457724","chr15","20113910","20113989","24","26343736"
"chr6","46459840","46460102","chr19","46739174","46739439","7","279334"
"chr6","46461015","46461301","chr19","46740332","46740626","19","279317"
"chr6","46465635","46465901","chr19","46697698","46697961","11","232063"
"chr6","46468760","46469029","chr19","46699469","46699731","15","230709"
"chr6","46469996","46470257","chr19","46721886","46722147","23","251890"
"chr6","46471161","46471443","chr19","46748708","46748989","11","277547"
"chr6","46475625","46475892","chr19","46666948","46667214","52","191323"
"chr6","46477758","46477991","chr19","46712534","46712813","60","234776"
"chr6","46478211","46478277","chr4","27924851","27924917","15","18553360"
"chr6","46481932","46482189","chr2","78855951","78856210","59","32374019"
"chr6","46492446","46492615","chr16","46684535","46684709","34","192089"
"chr6","46492993","46493274","chr19","46765793","46766074","8","272800"
"chr6","46495541","46495820","chr1","194330092","194330371","63","147834551"
"chr6","46501107","46501401","chr19","46775495","46775811","41","274388"
"chr6","46503194","46503246","chr14","66678278","66678338","14","20175084"
"chr6","46503390","46503673","chr19","46777806","46778092","18","274416"
"chr6","46515724","46516044","chr19","46793913","46794232","12","278189"
"chr6","46516148","46516411","chr19","46794336","46794601","11","278188"
"chr6","46518702","46518989","chr19","46799363","46799668","23","280661"
"chr6","46520226","46520239","chrX","6394563","6394575","2","40125663"
"chr6","46520533","46520695","chr19","46797761","46797925","11","277228"
"chr6","46522419","46522624","chr19","10261191","10261401","44","36261228"
"chr6","46528663","46528933","chr5","46451590","46451863","55","77073"
"chr6","46540227","46540519","chr19","46822571","46822882","26","282344"
"chr6","46544019","46544181","chr2","187026390","187026555","41","140482371"
"chr6","46548681","46548975","chr19","46827299","46827593","10","278618"
"chr6","46554568","46554870","chr19","46840596","46840894","17","286028"
"chr6","46580230","46580348","chr19","46867836","46867954","5","287606"
"chr6","46594987","46595286","chr19","46882658","46882958","9","287671"
"chr6","46627137","46627440","chr19","46915108","46915409","7","287971"
"chr6","46636222","46636526","chr19","46923920","46924224","15","287698"
"chr6","46639880","46640166","chr19","46927586","46927874","9","287706"
"chr6","46663589","46663895","chr19","46952095","46952409","16","288506"
"chr6","46673184","46673486","chr19","46962261","46962563","10","289077"
"chr6","46678907","46679158","chr19","43033330","43033582","12","3645577"
"chr6","46691609","46691792","chr4","71615984","71616162","35","24924375"
"chr6","46691843","46691960","chrX","108971246","108971363","15","62279403"
"chr6","46693720","46694010","chr19","46982163","46982453","5","288443"
"chr6","46695090","46695224","chr19","46983544","46983675","17","288454"
"chr6","46696624","46696718","chr19","12716277","12716373","19","33980347"
"chr6","46702784","46703085","chr19","46991266","46991567","4","288482"
"chr6","46705438","46705736","chr19","46993338","46993638","10","287900"
"chr6","46708028","46708146","chrX","108971246","108971363","15","62263218"
"chr6","46708183","46708341","chr1","159504220","159504375","32","112796037"
"chr6","46712892","46713112","chr19","47000002","47000173","51","287110"
"chr6","46717784","46718067","chr19","47005414","47005715","25","287630"
"chr6","46733199","46733501","chr19","47020198","47020500","16","286999"
"chr6","46735916","46736077","chr19","47023762","47023928","9","287846"
"chr6","46740932","46741215","chr19","47026952","47027239","14","286020"
"chr6","46742780","46743080","chr3","150376105","150376398","56","103633325"
"chr6","46760313","46760605","chr4","100530810","100531098","68","53770497"
"chr6","46765821","46766028","chr1","30228392","30228598","40","16537429"
"chr6","46771341","46771445","chr19","47060210","47060309","6","288869"
"chr6","46771475","46771622","chr19","47060361","47060509","5","288886"
"chr6","46787448","46787721","chr5","109503337","109503630","70","62715889"
"chr6","46844101","46844300","chr16","4471408","4471596","43","42372693"
"chr6","46864884","46865184","chr19","47169772","47170075","11","304888"
"chr6","46871956","46872194","chr19","47166385","47166623","7","294429"
"chr6","46897561","46897861","chr19","47182929","47183225","8","285368"
"chr6","46923254","46923538","chr9","15521242","15521531","63","31402012"
"chr6","46927381","46927542","chr19","47210569","47210730","3","283188"
"chr6","47033939","47034241","chr19","47336843","47337146","13","302904"
"chr6","47094613","47094849","chr19","47398813","47399049","6","304200"
"chr6","47105824","47105958","chr19","47409805","47409939","6","303981"
"chr6","47106256","47106440","chr19","47410235","47410412","14","303979"
"chr6","47149811","47149943","chr19","47454283","47454409","7","304472"
"chr6","47171538","47171833","chr19","47476002","47476295","8","304464"
"chr6","47196933","47197215","chr19","47504663","47504979","42","307730"
"chr6","47317119","47317415","chr19","47636749","47637047","20","319630"
"chr6","47506153","47506446","chr4","100436066","100436333","72","52929913"
"chr6","47509284","47509578","chr19","47788944","47789229","51","279660"
"chr6","47516615","47516881","chr19","47799738","47800001","9","283123"
"chr6","47542132","47542408","chr19","47828922","47829226","53","286790"
"chr6","47548028","47548248","chr16","41210751","41210968","37","6337277"
"chr6","47548249","47548299","chr14","32319368","32319418","3","15228881"
"chr6","47556921","47557182","chr19","47847974","47848233","16","291053"
"chr6","47558423","47558458","chr19","47849623","47849657","4","291200"
"chr6","47558753","47558882","chr19","47849950","47850077","8","291197"
"chr6","47559176","47559237","chr19","47850374","47850435","2","291198"
"chr6","47566728","47566895","chr10","35844967","35845130","39","11721761"
"chr6","47573231","47573408","chr19","47864814","47864990","15","291583"
"chr6","47573467","47573801","chr19","47865045","47865368","21","291578"
"chr6","47575322","47575577","chr19","47867046","47867297","16","291724"
"chr6","47578060","47578254","chr19","47869881","47870075","10","291821"
"chr6","47580199","47580463","chr19","47871703","47871969","11","291504"
"chr6","47583117","47583406","chr19","47874898","47875189","16","291781"
"chr6","47595505","47595716","chr7","1919134","1919352","48","45676371"
"chr6","47610514","47610797","chr19","47906727","47907010","9","296213"
"chr6","47611049","47611136","chr19","47907264","47907329","24","296215"
"chr6","47615242","47615551","chr19","47909798","47910094","21","294556"
"chr6","47622544","47622704","chr13","37888752","37888912","28","9733792"
"chr6","47625685","47625737","chr19","47922507","47922559","1","296822"
"chr6","47626034","47626114","chr19","47922853","47922927","7","296819"
"chr6","47641193","47641257","chr19","26935199","26935268","15","20705994"
"chr6","47641549","47641644","chr19","47941069","47941164","4","299520"
"chr6","47641976","47642052","chr19","47941472","47941548","3","299496"
"chr6","47642166","47642231","chr19","47941661","47941727","2","299495"
"chr6","47644057","47644182","chr7","106492413","106492535","16","58848356"
"chr6","47644228","47644392","chr12","35011112","35011282","34","12633116"
"chr6","47650801","47651102","chr19","47951029","47951333","13","300228"
"chr6","47655778","47656065","chr19","47955420","47955707","9","299642"
"chr6","47661311","47661601","chr3","157652954","157653239","50","109991643"
"chr6","47693851","47694153","chr19","47996130","47996418","25","302279"
"chr6","47697219","47697389","chr8","26425979","26426141","35","21271240"
"chr6","47700041","47700179","chr19","48004339","48004474","6","304298"
"chr6","47700798","47701085","chr19","48005094","48005380","6","304296"
"chr6","47723565","47723726","chr19","48029313","48029474","2","305748"
"chr6","47730388","47730506","chr19","48037724","48037846","6","307336"
"chr6","47735134","47735436","chr6","55175973","55176282","72","7440839"
"chr6","47738065","47738179","chr7","132107772","132107886","20","84369707"
"chr6","47747241","47747408","chr19","48055175","48055317","25","307934"
"chr6","47747702","47747834","chr19","48055619","48055753","8","307917"
"chr6","47778501","47778767","chr19","48087621","48087887","4","309120"
"chr6","47790098","47790277","chr19","48100445","48100603","25","310347"
"chr6","47794621","47794941","chr4","36593951","36594258","57","11200670"
"chr6","47806397","47806628","chr19","48112034","48112233","44","305637"
"chr6","47809624","47809895","chr19","48115210","48115483","8","305586"
"chr6","47833685","47833997","chr19","48143377","48143689","9","309692"
"chr6","47834032","47834300","chr19","48143724","48143991","7","309692"
"chr6","47839559","47839817","chr6","139956259","139956518","58","92116700"
"chr6","47843105","47843150","chr19","48153165","48153210","3","310060"
"chr6","47843215","47843500","chr19","48153274","48153564","22","310059"
"chr6","47845023","47845148","chr19","48155434","48155559","6","310411"
"chr6","47890126","47890426","chr19","48201649","48201931","34","311523"
"chr6","47895280","47895548","chr19","48205384","48205649","19","310104"
"chr6","47897313","47897451","chr1","38009038","38009171","22","9888275"
"chr6","47897805","47897963","chr8","68681919","68682072","38","20784114"
"chr6","47900071","47900369","chr19","48209580","48209878","8","309509"
"chr6","47936342","47936546","chr1","18045383","18045586","38","29890959"
"chr6","47939063","47939363","chr19","48244611","48244911","10","305548"
"chr6","47958157","47958431","chr19","48271275","48271549","8","313118"
"chr6","47984466","47984754","chr19","48298091","48298406","31","313625"
"chr6","47996103","47996376","chr19","48310369","48310652","21","314266"
"chr6","47997892","47998053","chr6","31409990","31410151","39","16587902"
"chr6","47999692","47999813","chr9","26937961","26938081","24","21061731"
"chr6","48014093","48014427","chr1","216385363","216385697","65","168371270"
"chr6","48016131","48016443","chr19","48335002","48335332","34","318871"
"chr6","48027875","48028188","chr19","48347009","48347291","37","319134"
"chr6","48034709","48034857","chr19","48345217","48345371","35","310508"
"chr6","48059443","48059714","chr19","48370959","48371231","9","311516"
"chr6","48060779","48060869","chr19","48372311","48372402","5","311532"
"chr6","48090462","48090748","chr19","48404419","48404709","17","313957"
"chr6","48097488","48097754","chr9","90524786","90525060","59","42427298"
"chr6","48102169","48102458","chr19","48419284","48419573","6","317115"
"chr6","48109196","48109495","chr19","48426453","48426747","24","317257"
"chr6","48115787","48115814","chr19","48432688","48432715","1","316901"
"chr6","48137971","48138184","chr7","155505038","155505252","45","107367067"
"chr6","48141133","48141419","chr19","48461423","48461708","11","320290"
"chr6","48143735","48143908","chrX","45893021","45893191","37","2250714"
"chr6","48163692","48164041","chr11","6844540","6844871","69","41319152"
"chr6","48172819","48173100","chr19","42438043","42438330","50","5734776"
"chr6","48191971","48192182","chr15","2014627","2014829","58","46177344"
"chr6","48192519","48192637","chrX","46908426","46908546","15","1284093"
"chr6","48200829","48200987","chr17","82447529","82447690","27","34246700"
"chr6","48213261","48213429","chr19","48535407","48535562","31","322146"
"chr6","48215513","48215714","chr19","48537558","48537759","6","322045"
"chr6","48221117","48221390","chr19","48544322","48544603","15","323205"
"chr6","48221391","48221460","chr4","17278584","17278644","19","30942807"
"chr6","48230102","48230250","chr19","48553213","48553359","5","323111"
"chr6","48274214","48274521","chr1","48206853","48207151","68","67361"
"chr6","48307808","48307849","chr19","48631016","48631058","2","323208"
"chr6","48312592","48312760","chrX","49524523","49524692","28","1211931"
"chr6","48324296","48324614","chr19","48646889","48647203","16","322593"
"chr6","48366161","48366270","chr18","41793958","41794063","23","6572203"
"chr6","48379135","48379426","chr18","62408752","62409047","59","14029617"
"chr6","48381836","48382127","chr19","48705716","48706007","13","323880"
"chr6","48388936","48389090","chr19","13135648","13135783","37","35253288"
"chr6","48442385","48442688","chr19","48766221","48766528","15","323836"
"chr6","48443806","48443895","chr9","61070475","61070560","22","12626669"
"chr6","48443897","48443970","chr4","35877984","35878045","20","12565913"
"chr6","48458750","48459064","chr19","48782299","48782608","22","323549"
"chr6","48466925","48467201","chr19","48790947","48791222","6","324022"
"chr6","48474248","48474403","chr19","48798339","48798494","5","324091"
"chr6","48478112","48478406","chr19","48800827","48801135","21","322715"
"chr6","48491863","48492163","chr19","48817082","48817383","12","325219"
"chr6","48551818","48552112","chr19","48878475","48878770","9","326657"
"chr6","48552948","48553098","chr17","27668154","27668287","32","20884794"
"chr6","48577693","48577986","chr19","48907391","48907678","18","329698"
"chr6","48582997","48583163","chr1","185781085","185781244","29","137198088"
"chr6","48658625","48658880","chr1","203437600","203437853","57","154778975"
"chr6","48660353","48660653","chr19","48990435","48990738","13","330082"
"chr6","48685441","48685736","chr19","49016045","49016357","33","330604"
"chr6","48718754","48718856","chr19","34859409","34859494","30","13859345"
"chr6","48723557","48723804","chr19","49058826","49059076","9","335269"
"chr6","48729002","48729308","chr19","49064664","49064966","20","335662"
"chr6","48737748","48737894","chr19","49087150","49087291","8","349402"
"chr6","48754404","48754550","chr19","49087150","49087291","8","332746"
"chr6","48782078","48782364","chr19","49114694","49114981","5","332616"
"chr6","48783712","48783844","chr19","49116331","49116462","4","332619"
"chr6","48784757","48784895","chr1","25436620","25436763","42","23348137"
"chr6","48796852","48797162","chr19","49129479","49129785","6","332627"
"chr6","48802719","48802851","chr11","111931690","111931822","25","63128971"
"chr6","48808483","48808788","chr19","49141277","49141614","44","332794"
"chr6","48818322","48818381","chr11","26500005","26500063","14","22318317"
"chr6","48818386","48818541","chr3","178210714","178210870","33","129392328"
"chr6","48819293","48819592","chr19","49152014","49152316","11","332721"
"chr6","48819983","48820232","chr19","49152713","49152961","6","332730"
"chr6","48820233","48820333","chr19","49152962","49153062","3","332729"
"chr6","48821668","48821911","chr20","15677747","15677982","68","33143921"
"chr6","48829677","48829972","chr19","49156236","49156532","14","326559"
"chr6","48834210","48834513","chr19","49166698","49166995","20","332488"
"chr6","48842499","48842808","chr19","49176057","49176363","8","333558"
"chr6","48895591","48895885","chr19","49236305","49236597","6","340714"
"chr6","48901525","48901786","chr19","49242219","49242480","7","340694"
"chr6","48941612","48941903","chr19","49279187","49279483","18","337575"
"chr6","48944685","48944941","chr19","49282219","49282509","36","337534"
"chr6","48951259","48951557","chr19","49289095","49289395","6","337836"
"chr6","48961728","48961778","chr19","49298935","49298985","1","337207"
"chr6","48962361","48962596","chr19","49299558","49299780","18","337197"
"chr6","48963207","48963239","chr19","49300395","49300427","0","337188"
"chr6","48978785","48979041","chr19","49315824","49316085","12","337039"
"chr6","49015197","49015486","chr19","49351983","49352275","10","336786"
"chr6","49024909","49025217","chr2","101764441","101764747","48","52739532"
"chr6","49063528","49063819","chr19","49399500","49399792","6","335972"
"chr6","49098246","49098549","chr19","49435575","49435874","13","337329"
"chr6","49115320","49115629","chr19","49454708","49455013","10","339388"
"chr6","49281622","49281909","chr19","49622775","49623065","10","341153"
"chr6","49334739","49335017","chr19","49680081","49680362","9","345342"
"chr6","49353035","49353357","chr19","49700875","49701199","12","347840"
"chr6","49362956","49363260","chr1","65362110","65362446","86","15999154"
"chr6","49366935","49367244","chr4","35119120","35119410","71","14247815"
"chr6","49368990","49369289","chr19","49717146","49717445","4","348156"
"chr6","49372223","49372513","chr19","49720373","49720668","16","348150"
"chr6","49390723","49391016","chr19","49741046","49741341","13","350323"
"chr6","49398457","49398725","chr1","64160076","64160359","69","14761619"
"chr6","49407955","49408124","chr7","19596956","19597120","36","29810999"
"chr6","49414251","49414531","chr19","49766279","49766563","14","352028"
"chr6","49430723","49431002","chr19","49782922","49783198","15","352199"
"chr6","49433202","49433504","chr19","49785661","49785961","10","352459"
"chr6","49436954","49437251","chr19","49789412","49789716","16","352458"
"chr6","49446591","49446740","chr2","62188847","62189000","28","12742256"
"chr6","49446768","49446949","chr19","49799388","49799559","11","352620"
"chr6","49477084","49477362","chr19","49829598","49829897","26","352514"
"chr6","49486179","49486490","chr19","49838688","49838999","5","352509"
"chr6","49511763","49511894","chr14","56213052","56213184","20","6701289"
"chr6","49512192","49512335","chr10","26495960","26496111","37","23016232"
"chr6","49525726","49526004","chr19","49880606","49880901","22","354880"
"chr6","49532091","49532415","chr19","49887089","49887422","40","354998"
"chr6","49537937","49538009","chr6","134194500","134194566","13","84656563"
"chr6","49545715","49546025","chr19","49891311","49891627","40","345596"
"chr6","49564673","49564955","chr19","49920172","49920473","32","355499"
"chr6","49567568","49567648","chr19","49922933","49923013","2","355365"
"chr6","49567945","49567996","chr19","49923309","49923360","1","355364"
"chr6","49570898","49571028","chr12","39104384","39104516","31","10466514"
"chr6","49578157","49578295","chr19","49933802","49933951","34","355645"
"chr6","49583259","49583528","chr9","90524786","90525060","50","40941527"
"chr6","49593948","49594046","chr19","49950843","49950938","6","356895"
"chr6","49597858","49598158","chr19","49954746","49955051","19","356888"
"chr6","49623860","49624164","chr19","49982315","49982618","12","358455"
"chr6","49640483","49640783","chr8","10034943","10035230","61","39605540"
"chr6","49671661","49671953","chr19","50031503","50031794","11","359842"
"chr6","49686948","49687243","chr19","50047052","50047345","9","360104"
"chr6","49692070","49692209","chr19","3197905","3198040","28","46494165"
"chr6","49694609","49694751","chr19","50055173","50055312","4","360564"
"chr6","49695057","49695116","chr19","50055618","50055677","4","360561"
"chr6","49709353","49709450","chr19","6969099","6969192","21","42740254"
"chr6","49710445","49710756","chr19","50070917","50071235","20","360472"
"chr6","49719568","49719834","chr19","50090755","50091018","59","371187"
"chr6","49730063","49730330","chr19","50090755","50091018","15","360692"
"chr6","49758462","49758674","chrX","14158827","14159037","47","35599635"
"chr6","49819865","49820045","chr7","58729599","58729780","37","8909734"
"chr6","49820486","49820579","chr13","24151350","24151438","24","25669136"
"chr6","49906335","49906635","chr19","50275131","50275444","23","368796"
"chr6","50017896","50018212","chr19","50391956","50392214","65","374060"
"chr6","50018431","50018706","chr19","50392431","50392684","32","374000"
"chr6","50025268","50025561","chr19","50400098","50400396","13","374830"
"chr6","50052914","50053222","chr2","62859840","62860152","53","12806926"
"chr6","50082801","50083103","chr19","50459208","50459504","14","376407"
"chr6","50114452","50114733","chr17","71852249","71852523","82","21737797"
"chr6","50118551","50118832","chr17","71852249","71852523","82","21733698"
"chr6","50128034","50128336","chr2","149220987","149221284","64","99092953"
"chr6","50147079","50147336","chr19","50521781","50522038","7","374702"
"chr6","50171058","50171351","chr19","50546207","50546499","13","375149"
"chr6","50194034","50194326","chr19","50571438","50571728","8","377404"
"chr6","50198829","50199123","chr19","50576297","50576591","6","377468"
"chr6","50204505","50204778","chr19","50583244","50583517","3","378739"
"chr6","50231516","50231797","chr19","50611095","50611378","11","379579"
"chr6","50235497","50235778","chr19","50611095","50611378","11","375598"
"chr6","50250998","50251287","chr8","135790598","135790893","66","85539600"
"chr6","50251960","50252124","chr19","50630807","50630968","6","378847"
"chr6","50252412","50252427","chr19","50631256","50631271","0","378844"
"chr6","50267411","50267720","chr19","50637079","50637390","9","369668"
"chr6","50281083","50281364","chr19","50651734","50652044","36","370651"
"chr6","50286605","50286910","chrX","121188280","121188585","48","70901675"
"chr6","50288574","50288780","chr19","50666025","50666234","10","377451"
"chr6","50292084","50292218","chr19","50656581","50656715","6","364497"
"chr6","50292522","50292696","chr19","50657019","50657195","14","364497"
"chr6","50313485","50313722","chr19","50688147","50688381","5","374662"
"chr6","50314059","50314348","chr19","50688720","50689013","10","374661"
"chr6","50314857","50315031","chr19","50689482","50689650","8","374625"
"chr6","50332106","50332384","chr19","50706402","50706680","7","374296"
"chr6","50350176","50350472","chr19","50723274","50723564","10","373098"
"chr6","50351764","50352052","chr19","50725556","50725863","35","373792"
"chr6","50354380","50354686","chr19","50728183","50728499","18","373803"
"chr6","50376795","50377109","chr19","50752228","50752542","5","375433"
"chr6","50384209","50384365","chr20","26612038","26612199","26","23772171"
"chr6","50406031","50406313","chr19","50786901","50787178","13","380870"
"chr6","50411012","50411311","chr19","50791855","50792129","34","380843"
"chr6","50416559","50416864","chr3","17405849","17406153","67","33010710"
"chr6","50438835","50438997","chr13","29297954","29298110","41","21140881"
"chr6","50440007","50440300","chr19","50821109","50821413","26","381102"
"chr6","50444890","50445049","chr2","187026390","187026555","40","136581500"
"chr6","50457931","50458215","chr19","50829113","50829397","6","371182"
"chr6","50463354","50463515","chr19","50846122","50846285","8","382768"
"chr6","50469201","50469491","chr19","50853477","50853767","6","384276"
"chr6","50478432","50478710","chr19","50863973","50864251","3","385541"
"chr6","50481634","50481686","chr19","50867156","50867208","1","385522"
"chr6","50481992","50482163","chr19","50867515","50867688","10","385523"
"chr6","50487598","50487881","chr19","50873172","50873461","9","385574"
"chr6","50490685","50490931","chr19","50883647","50883894","8","392962"
"chr6","50497505","50497723","chr19","50880270","50880484","4","382765"
"chr6","50501198","50501472","chr19","50888668","50888943","5","387470"
"chr6","50522953","50523020","chr19","50906570","50906637","2","383617"
"chr6","50543098","50543430","chr19","50930793","50931122","14","387695"
"chr6","50552620","50552911","chr19","50940088","50940377","6","387468"
"chr6","50554168","50554463","chr19","50941633","50941928","30","387465"
"chr6","50561735","50561991","chr19","50949897","50950152","7","388162"
"chr6","50562100","50562228","chr19","50950260","50950389","2","388160"
"chr6","50562535","50562704","chr19","50950699","50950864","7","388164"
"chr6","50569412","50569729","chr19","50957753","50958054","21","388341"
"chr6","50573443","50573752","chr19","50961789","50962098","4","388346"
"chr6","50574105","50574383","chr19","50962452","50962730","10","388347"
"chr6","50580753","50581027","chr4","118530706","118530983","59","67949953"
"chr6","50582191","50582411","chr19","50970517","50970778","45","388326"
"chr6","50621443","50621724","chr19","51014971","51015252","6","393528"
"chr6","50635347","50635508","chr8","61583633","61583792","31","10948286"
"chr6","50649288","50649423","chr16","52855317","52855451","20","2206029"
"chr6","50650045","50650220","chr10","87423992","87424165","36","36773947"
"chr6","50654107","50654421","chr19","51048526","51048840","11","394419"
"chr6","50733498","50733618","chr1","30433367","30433485","20","20300131"
"chr6","50748759","50748970","chr19","51147108","51147319","5","398349"
"chr6","50769599","50769904","chr3","9039630","9039934","58","41729969"
"chr6","50770198","50770481","chr19","51167875","51168152","13","397677"
"chr6","50771329","50771485","chr10","36139901","36140054","34","14631428"
"chr6","50771867","50771912","chr4","20337879","20337923","9","30433988"
"chr6","50807210","50807370","chr14","63608556","63608715","31","12801346"
"chr6","50819470","50819606","chr19","51224137","51224273","3","404667"
"chr6","50841607","50841909","chr19","51246207","51246509","4","404600"
"chr6","50846497","50846802","chr19","51250926","51251228","10","404429"
"chr6","50865991","50866127","chr19","51281078","51281214","2","415087"
"chr6","50866741","50867049","chr19","51281827","51282127","14","415086"
"chr7","57016312","57016363","chr11","28776209","28776259","11","28240103"
"chr7","60686243","60686521","chr5","103975334","103975611","13","43289091"
"chr7","83492693","83492944","chr3","5597848","5598087","68","77894845"
"chr7","97910669","97910795","chr5","141265752","141265876","5","43355083"
"chr7","110493540","110493826","chr5","153502672","153502958","6","43009132"
"chr7","111411181","111411473","chrX","38833115","38833403","56","72578066"
"chr7","119930804","119931100","chr5","163129096","163129394","10","43198292"
"chr7","64465","64731","chr5","59696949","59697215","8","59632484"
"chr7","64739","64829","chr5","59697219","59697313","9","59632480"
"chr7","146883","146979","chr5","59742786","59742882","5","59595903"
"chr7","211763","212029","chr5","59742518","59742784","6","59530755"
"chr7","212033","212125","chr5","59742786","59742882","9","59530753"
"chr7","285309","285573","chr5","59820593","59820857","9","59535284"
"chr7","285575","285667","chr5","59820859","59820956","7","59535284"
"chr7","500374","500672","chr5","59991322","59991626","21","59490948"
"chr7","501189","501481","chr5","59992164","59992433","36","59490975"
"chr7","540395","540521","chr11","6589098","6589220","7","6048703"
"chr7","553481","553772","chr5","60042375","60042666","3","59488894"
"chr7","594179","594368","chr5","60100501","60100687","11","59506322"
"chr7","616557","616718","chr7","19134920","19135085","40","18518363"
"chr7","616733","616753","chr3","84748152","84748170","5","84131419"
"chr7","617514","617627","chr5","60120183","60120296","4","59502669"
"chr7","630465","630722","chr5","60132626","60132883","10","59502161"
"chr7","638260","638536","chr5","60140340","60140625","14","59502080"
"chr7","693212","693506","chr5","60196537","60196830","9","59503325"
"chr7","721553","721822","chr5","60225108","60225377","12","59503555"
"chr7","722291","722580","chr5","60225845","60226141","20","59503554"
"chr7","744346","744548","chr10","69547738","69547924","66","68803392"
"chr7","748683","748991","chr7","111283263","111283566","61","110534580"
"chr7","796768","797059","chr5","60301962","60302253","15","59505194"
"chr7","857024","857319","chr5","60361914","60362208","11","59504890"
"chr7","917761","918040","chr5","60422264","60422530","21","59504503"
"chr7","925370","925504","chr20","50266909","50267045","33","49341539"
"chr7","927469","927760","chr5","60430974","60431261","18","59503505"
"chr7","1178779","1178964","chr18","2856824","2857035","53","1678045"
"chr7","1179068","1179373","chr5","60677239","60677547","21","59498171"
"chr7","1209645","1209967","chr10","66929452","66929757","92","65719807"
"chr7","1247736","1248043","chr5","60757268","60757576","7","59509532"
"chr7","1361130","1361340","chr5","60868547","60868757","13","59507417"
"chr7","1377667","1377930","chr5","60884553","60884816","9","59506886"
"chr7","1390445","1390754","chr5","60897253","60897557","14","59506808"
"chr7","1439378","1439675","chr4","34669088","34669380","61","33229710"
"chr7","1534130","1534319","chr5","61044031","61044217","6","59509901"
"chr7","1611494","1611774","chr1","26153930","26154211","47","24542436"
"chr7","1644206","1644496","chr18","15625274","15625581","22","13981068"
"chr7","1682410","1682695","chr5","61189165","61189464","25","59506755"
"chr7","1701650","1701818","chr5","61208343","61208512","6","59506693"
"chr7","1780304","1780420","chr5","61293081","61293197","3","59512777"
"chr7","1880475","1880789","chr1","29968074","29968383","72","28087599"
"chr7","1958990","1959092","chr5","61474941","61475043","4","59515951"
"chr7","1961330","1961541","chr5","61477274","61477485","3","59515944"
"chr7","2041922","2042211","chr5","61573569","61573856","17","59531647"
"chr7","2083552","2083846","chr5","61613058","61613347","13","59529506"
"chr7","2172101","2172385","chr5","61701836","61702119","5","59529735"
"chr7","2342894","2343195","chr5","61872913","61873214","7","59530019"
"chr7","2377712","2378000","chr19","9322586","9322881","64","6944874"
"chr7","2383849","2384149","chr5","61912790","61913118","40","59528941"
"chr7","2459507","2459786","chr5","61979180","61979460","18","59519673"
"chr7","2554263","2554469","chr7","108900968","108901182","45","106346705"
"chr7","2557567","2557863","chr5","62083238","62083522","25","59525671"
"chr7","2573027","2573254","chr5","62099576","62099802","19","59526549"
"chr7","2736332","2736627","chr5","62294654","62294944","20","59558322"
"chr7","2781808","2782081","chr5","62344931","62345209","21","59563123"
"chr7","2863465","2863749","chr5","62422737","62423019","7","59559272"
"chr7","2977877","2978162","chr5","62537052","62537337","13","59559175"
"chr7","3233348","3233636","chr5","62804974","62805262","7","59571626"
"chr7","3474699","3474944","chr7","53313421","53313652","65","49838722"
"chr7","3595059","3595358","chr11","85044682","85044977","69","81449623"
"chr7","3686056","3686357","chr5","63253525","63253820","33","59567469"
"chr7","3918796","3918943","chr5","63495665","63495815","5","59576869"
"chr7","4394552","4394838","chr5","63974243","63974529","15","59579691"
"chr7","4490641","4490966","chr5","64074784","64075097","20","59584143"
"chr7","4502250","4502529","chr5","64086664","64086947","8","59584414"
"chr7","4601197","4601494","chr5","64197883","64198181","19","59596686"
"chr7","4657445","4657716","chr5","64255448","64255737","34","59598003"
"chr7","4679936","4680192","chr5","64279037","64279299","19","59599101"
"chr7","4856108","4856168","chr7","46165464","46165523","10","41309356"
"chr7","4856169","4856317","chr16","18819593","18819742","32","13963424"
"chr7","4863565","4863838","chr5","64438793","64439066","7","59575228"
"chr7","4914078","4914385","chr5","64487686","64487985","21","59573608"
"chr7","4944319","4944595","chr5","64517937","64518249","45","59573618"
"chr7","5033507","5033647","chr5","64602188","64602330","7","59568681"
"chr7","5126352","5126469","chr5","64702124","64702254","15","59575772"
"chr7","5309759","5310033","chr5","64908115","64908390","26","59598356"
"chr7","5334429","5334687","chr5","64932970","64933228","10","59598541"
"chr7","5413204","5413498","chr5","65012361","65012664","34","59599157"
"chr7","5593027","5593140","chr3","39214185","39214291","33","33621158"
"chr7","5836702","5836923","chr10","50816329","50816542","47","44979627"
"chr7","5848716","5849003","chr3","153340997","153341284","70","147492281"
"chr7","5931871","5932170","chr5","65568296","65568595","8","59636425"
"chr7","5943250","5943534","chr5","65579740","65580007","26","59636490"
"chr7","6017975","6018264","chr6","51072032","51072325","49","45054057"
"chr7","6207014","6207093","chr5","65849197","65849276","4","59642183"
"chr7","6222895","6223180","chr5","65864792","65865077","7","59641897"
"chr7","6276070","6276358","chr5","65925271","65925560","6","59649201"
"chr7","6281851","6281980","chr5","65931052","65931181","3","59649201"
"chr7","6282728","6282856","chr5","65931928","65932056","0","59649200"
"chr7","6299947","6300053","chr6","106363043","106363146","23","100063096"
"chr7","6300113","6300342","chr7","24453818","24454052","55","18153705"
"chr7","6323992","6324153","chr5","65977891","65978048","9","59653899"
"chr7","6570832","6571065","chr5","66222459","66222692","12","59651627"
"chr7","6593537","6593775","chr5","66247416","66247654","5","59653879"
"chr7","6803213","6803506","chr5","66461003","66461305","15","59657790"
"chr7","6832192","6832474","chr5","66490064","66490346","8","59657872"
"chr7","6845128","6845422","chr5","66503069","66503360","9","59657941"
"chr7","6890043","6890166","chr5","66547725","66547848","4","59657682"
"chr7","6890434","6890742","chr5","66548110","66548394","27","59657676"
"chr7","6918822","6918961","chr1","1658615","1658747","21","5260207"
"chr7","6925061","6925363","chr5","66584294","66584617","42","59659233"
"chr7","6926521","6926821","chr7","42951017","42951323","60","36024496"
"chr7","6928780","6929091","chr5","66588030","66588341","7","59659250"
"chr7","6943256","6943576","chr5","66602897","66603206","17","59659641"
"chr7","6965358","6965581","chr5","66624560","66624782","6","59659202"
"chr7","7067681","7067996","chr5","66725334","66725657","11","59657653"
"chr7","7089396","7089670","chr5","66747070","66747344","5","59657674"
"chr7","7090786","7090874","chr5","66748460","66748548","0","59657674"
"chr7","7096524","7096712","chr5","66754210","66754404","9","59657686"
"chr7","7224160","7224425","chr5","66918110","66918409","47","59693950"
"chr7","7333486","7333786","chr5","67025659","67025957","13","59692173"
"chr7","7337418","7337743","chr5","67029564","67029895","17","59692146"
"chr7","7480306","7480389","chr5","67175099","67175182","0","59694793"
"chr7","7509752","7510038","chr5","67204595","67204898","20","59694843"
"chr7","7648501","7648746","chr12","65210749","65210999","73","57562248"
"chr7","7649987","7650294","chr5","67345436","67345709","40","59695449"
"chr7","7666197","7666492","chr5","67361350","67361641","14","59695153"
"chr7","7670751","7670828","chrX","99039175","99039252","12","91368424"
"chr7","7696667","7696948","chr5","67399081","67399362","6","59702414"
"chr7","7783141","7783432","chr5","67487842","67488133","10","59704701"
"chr7","7785302","7785369","chr5","67489999","67490066","2","59704697"
"chr7","7832350","7832639","chr5","67541233","67541522","5","59708883"
"chr7","7929149","7929457","chr5","67639387","67639695","6","59710238"
"chr7","7935444","7935714","chr10","85183460","85183721","68","77248016"
"chr7","8228427","8228723","chr5","67930301","67930586","38","59701874"
"chr7","8241871","8242155","chr5","67944917","67945201","6","59703046"
"chr7","8331938","8332208","chr5","68042073","68042346","20","59710135"
"chr7","8404956","8405132","chr5","68116190","68116368","4","59711234"
"chr7","8473161","8473367","chr5","68188871","68189081","9","59715710"
"chr7","8489540","8489843","chr5","68213155","68213467","14","59723615"
"chr7","8547028","8547295","chr5","68274325","68274591","6","59727297"
"chr7","8568327","8568644","chr5","68298074","68298392","17","59729747"
"chr7","8618530","8618673","chr2","87383421","87383551","50","78764891"
"chr7","8649830","8649929","chr5","68385214","68385313","0","59735384"
"chr7","8795784","8796005","chr9","91322383","91322601","44","82526599"
"chr7","8947037","8947190","chr19","28996591","28996737","35","20049554"
"chr7","9130547","9130846","chr9","57622760","57623059","58","48492213"
"chr7","9308156","9308410","chr5","69072496","69072750","9","59764340"
"chr7","9476601","9476920","chr5","69254963","69255269","24","59778362"
"chr7","9567459","9567790","chr5","69355999","69356293","51","59788540"
"chr7","9579027","9579315","chr5","69367572","69367865","46","59788545"
"chr7","9691512","9691809","chr5","69486057","69486369","19","59794545"
"chr7","9889320","9889629","chr1","28768857","28769160","65","18879537"
"chr7","10216922","10217225","chr5","70009560","70009863","6","59792638"
"chr7","10224759","10224966","chr5","70017243","70017486","40","59792484"
"chr7","10277420","10277505","chr5","70065014","70065099","2","59787594"
"chr7","10278530","10278750","chr5","70066125","70066355","18","59787595"
"chr7","10438317","10438628","chr5","70227607","70227910","15","59789290"
"chr7","10498789","10499061","chr5","70288439","70288700","26","59789650"
"chr7","10551532","10551821","chr7","39728335","39728615","66","29176803"
"chr7","10617155","10617463","chr5","70406389","70406685","24","59789234"
"chr7","10633751","10634020","chr18","54606288","54606546","66","43972537"
"chr7","10657152","10657436","chr5","70444037","70444329","15","59786885"
"chr7","10770977","10771194","chr5","70564886","70565104","2","59793909"
"chr7","10825109","10825419","chr5","70608841","70609151","4","59783732"
"chr7","10943938","10944232","chr5","70735974","70736276","17","59792036"
"chr7","10945538","10945817","chr5","70737583","70737861","9","59792045"
"chr7","11091785","11091997","chr5","70884142","70884354","5","59792357"
"chr7","11170621","11170897","chr5","70963718","70964026","36","59793097"
"chr7","11172927","11173200","chr5","70966013","70966286","9","59793086"
"chr7","11376153","11376435","chr5","71182280","71182561","15","59806127"
"chr7","11503915","11504142","chr1","64146265","64146492","69","52642350"
"chr7","11538750","11539028","chr5","71341621","71341899","7","59802871"
"chr7","11551301","11551506","chr5","71354224","71354429","0","59802923"
"chr7","11552528","11552803","chr5","71355453","71355728","3","59802925"
"chr7","11581010","11581304","chr5","71383834","71384128","4","59802824"
"chr7","11603846","11604135","chr5","71407483","71407785","16","59803637"
"chr7","11618236","11618517","chr5","71421913","71422197","11","59803677"
"chr7","11653910","11654239","chr5","71458957","71459266","40","59805047"
"chr7","11658312","11658449","chr7","77886179","77886317","33","66227867"
"chr7","11658813","11658982","chr5","71463509","71463702","28","59804696"
"chr7","11659980","11660234","chr7","106512843","106513084","57","94852863"
"chr7","11663944","11664231","chr5","71468665","71468950","6","59804721"
"chr7","11667429","11667728","chr5","71472154","71472452","7","59804725"
"chr7","11698008","11698300","chr5","71503516","71503807","8","59805508"
"chr7","11711629","11711794","chr1","23596488","23596653","35","11884859"
"chr7","11722088","11722359","chr5","71527925","71528196","5","59805837"
"chr7","11725360","11725675","chr5","71531203","71531518","8","59805843"
"chr7","11735723","11735834","chr5","71541837","71541949","3","59806114"
"chr7","11746334","11746647","chr5","71588916","71589227","13","59842582"
"chr7","11759460","11759648","chr5","71610036","71610225","5","59850576"
"chr7","11769839","11770138","chr5","71614243","71614535","12","59844404"
"chr7","11771232","11771363","chr9","87325485","87325612","28","75554253"
"chr7","11785814","11785941","chr5","71628420","71628538","10","59842606"
"chr7","11786234","11786393","chr5","71628831","71628976","16","59842597"
"chr7","11787077","11787394","chr5","78616003","78616301","79","66828926"
"chr7","11791630","11791726","chr5","71633522","71633614","6","59841892"
"chr7","11804141","11804434","chr5","71639632","71639926","3","59835491"
"chr7","11807045","11807179","chr5","71646492","71646626","4","59839447"
"chr7","11807296","11807594","chr16","32727194","32727487","62","20919898"
"chr7","11808149","11808288","chr5","71647833","71647985","14","59839684"
"chr7","11810529","11810681","chr8","36390059","36390210","29","24579530"
"chr7","11826302","11826569","chr5","71671960","71672227","5","59845658"
"chr7","11832220","11832313","chr4","5050642","5050731","21","6781578"
"chr7","11833426","11833582","chr10","35224557","35224713","31","23391131"
"chr7","11834449","11834592","chr1","9667266","9667402","28","2167183"
"chr7","11847227","11847337","chr5","71695627","71695737","2","59848400"
"chr7","11847684","11847852","chr5","71696083","71696277","34","59848399"
"chr7","11848101","11848432","chr5","71696491","71696813","16","59848390"
"chr7","11849541","11849740","chr1","87672048","87672249","39","75822507"
"chr7","11867715","11867839","chr5","71717508","71717631","5","59849793"
"chr7","11889673","11889984","chr5","71785409","71785718","9","59895736"
"chr7","11893707","11894004","chr5","71791287","71791591","12","59897580"
"chr7","11895197","11895289","chr6","132838576","132838666","19","120943379"
"chr7","11900221","11900522","chr5","71795850","71796147","16","59895629"
"chr7","11904892","11905173","chr5","71800818","71801100","6","59895926"
"chr7","11935722","11935984","chr5","71830686","71830948","6","59894964"
"chr7","11939668","11939951","chr5","71834612","71834890","11","59894944"
"chr7","11942569","11942864","chr5","71837510","71837804","10","59894941"
"chr7","11966394","11966698","chr5","71861842","71862161","21","59895448"
"chr7","11973200","11973499","chr5","71868764","71869066","13","59895564"
"chr7","11975558","11975698","chr5","71871126","71871267","2","59895568"
"chr7","11980084","11980260","chr5","71875636","71875814","4","59895552"
"chr7","11981602","11981745","chr5","71877156","71877299","2","59895554"
"chr7","11985944","11986227","chr5","71881492","71881776","6","59895548"
"chr7","12013011","12013298","chr5","71907835","71908120","5","59894824"
"chr7","12021662","12021823","chr9","54920627","54920788","27","42898965"
"chr7","12022883","12023193","chr5","71918447","71918751","17","59895564"
"chr7","12031548","12031841","chr5","71927144","71927437","5","59895596"
"chr7","12035753","12035957","chr4","42686105","42686316","45","30650352"
"chr7","12039554","12039786","chr5","71934527","71934759","3","59894973"
"chr7","12042915","12043159","chr8","135279357","135279609","51","123236442"
"chr7","12044678","12044960","chr5","71939480","71939762","6","59894802"
"chr7","12059302","12059623","chr5","71954393","71954711","13","59895091"
"chr7","12066939","12067219","chr5","71962072","71962351","4","59895133"
"chr7","12085383","12085673","chr1","125070092","125070386","58","112984709"
"chr7","12102473","12102781","chr5","71999233","71999543","12","59896760"
"chr7","12104766","12105029","chr5","72001173","72001427","28","59896407"
"chr7","12108257","12108556","chr5","72005103","72005398","13","59896846"
"chr7","12108559","12108866","chr5","72005401","72005683","36","59896842"
"chr7","12112259","12112569","chr5","72009389","72009707","16","59897130"
"chr7","12113653","12113963","chr5","72010775","72011081","11","59897122"
"chr7","12116229","12116520","chr5","72013337","72013638","15","59897108"
"chr7","12123357","12123615","chr14","18129780","18130033","62","6006423"
"chr7","12170357","12170651","chr5","72068111","72068402","8","59897754"
"chr7","12196969","12197084","chr5","72098362","72098471","10","59901393"
"chr7","12207270","12207529","chr5","72088751","72089028","22","59881481"
"chr7","12207576","12207653","chr16","1206077","1206154","13","11001499"
"chr7","12216776","12217082","chr5","72111274","72111581","4","59894498"
"chr7","12217083","12217213","chr5","72111603","72111715","30","59894520"
"chr7","12222792","12223076","chr5","72116994","72117279","7","59894202"
"chr7","12236863","12237094","chr5","72131046","72131276","7","59894183"
"chr7","12237230","12237523","chr5","72131404","72131707","13","59894174"
"chr7","12259171","12259470","chr5","72152790","72153092","11","59893619"
"chr7","12268381","12268670","chr5","72161344","72161638","13","59892963"
"chr7","12273900","12274190","chr5","72166851","72167160","23","59892951"
"chr7","12281502","12281805","chr5","72174174","72174477","7","59892672"
"chr7","12282278","12282420","chr5","72174949","72175091","0","59892671"
"chr7","12282977","12283275","chr5","72175650","72175948","7","59892673"
"chr7","12304495","12304795","chr5","72196832","72197128","11","59892337"
"chr7","12317531","12317854","chr5","72209967","72210282","19","59892436"
"chr7","12318861","12319245","chr10","23370320","23370672","106","11051459"
"chr7","12324521","12324809","chr5","72216984","72217276","9","59892463"
"chr7","12334144","12334462","chr15","56527536","56527835","72","44193392"
"chr7","12350835","12351116","chr11","11529370","11529651","48","821465"
"chr7","12351163","12351187","chr1","112425615","112425640","3","100074452"
"chr7","12365773","12366027","chr5","72259057","72259312","7","59893284"
"chr7","12437989","12438302","chr5","72333473","72333786","7","59895484"
"chr7","12450651","12450921","chr5","72345461","72345731","1","59894810"
"chr7","12466886","12467188","chr5","72362198","72362496","14","59895312"
"chr7","12475293","12475601","chr5","72370608","72370917","4","59895315"
"chr7","12479628","12479793","chr5","72374980","72375132","14","59895352"
"chr7","12486902","12487213","chr5","72382233","72382541","15","59895331"
"chr7","12488491","12488740","chr5","72383819","72384067","5","59895328"
"chr7","12488746","12489038","chr5","72384073","72384365","4","59895327"
"chr7","12490889","12491176","chr5","72386158","72386450","11","59895269"
"chr7","12491803","12492082","chr3","125030767","125031037","57","112538964"
"chr7","12501587","12501872","chr5","72397195","72397479","11","59895608"
"chr7","12515844","12516117","chr5","72411719","72411992","5","59895875"
"chr7","12523805","12523849","chr19","45529238","45529282","6","33005433"
"chr7","12523853","12524014","chr9","6234636","6234799","29","6289217"
"chr7","12525134","12525354","chr5","72420996","72421216","2","59895862"
"chr7","12529719","12529992","chr5","72425870","72426143","8","59896151"
"chr7","12534233","12534389","chr5","72429899","72430060","5","59895666"
"chr7","12536668","12536943","chr5","72432795","72433071","13","59896127"
"chr7","12555803","12555977","chr5","72451979","72452157","13","59896176"
"chr7","12557710","12557998","chr5","72453905","72454193","3","59896195"
"chr7","12559678","12560000","chr8","68808553","68808854","99","56248875"
"chr7","12562037","12562153","chr5","72457958","72458074","2","59895921"
"chr7","12562227","12562465","chr5","72458192","72458425","12","59895965"
"chr7","12564460","12564745","chrX","7001285","7001551","73","5563175"
"chr7","12573711","12574020","chr7","63531408","63531718","51","50957697"
"chr7","12578147","12578279","chr5","72473535","72473668","5","59895388"
"chr7","12578315","12578491","chr5","72473704","72473878","5","59895389"
"chr7","12583269","12583555","chr5","72478662","72478957","14","59895393"
"chr7","12596998","12597284","chr5","72492428","72492699","21","59895430"
"chr7","12600274","12600573","chr5","72495694","72495995","8","59895420"
"chr7","12603957","12604273","chr5","72499379","72499695","11","59895422"
"chr7","12609524","12609744","chr5","72505227","72505464","26","59895703"
"chr7","12612013","12612166","chr5","72507732","72507894","14","59895719"
"chr7","12614643","12614949","chr5","72510661","72510963","15","59896018"
"chr7","12618866","12619151","chr5","72514431","72514712","6","59895565"
"chr7","12620168","12620468","chr5","72515759","72516059","4","59895591"
"chr7","12622686","12622928","chr5","72518276","72518519","7","59895590"
"chr7","12624508","12624809","chr5","72520090","72520391","8","59895582"
"chr7","12657599","12657897","chr5","72554244","72554542","10","59896645"
"chr7","12661973","12662255","chr5","72558616","72558898","5","59896643"
"chr7","12680504","12680793","chr5","72577954","72578243","10","59897450"
"chr7","12684440","12684713","chr5","72581857","72582130","7","59897417"
"chr7","12692085","12692367","chr5","72599003","72599284","9","59906918"
"chr7","12694170","12694462","chr5","72601094","72601385","6","59906924"
"chr7","12697073","12697354","chr5","72603973","72604255","7","59906900"
"chr7","12698102","12698398","chr5","72605002","72605301","7","59906900"
"chr7","12724419","12724729","chr5","72633850","72634162","12","59909431"
"chr7","12728737","12728959","chr5","72638170","72638393","3","59909433"
"chr7","12748063","12748371","chr5","72658159","72658460","16","59910096"
"chr7","12814883","12815187","chr5","72725294","72725598","4","59910411"
"chr7","12840176","12840506","chr5","72752819","72753120","37","59912643"
"chr7","12844620","12844912","chr5","72757302","72757597","12","59912682"
"chr7","12854432","12854710","chr5","72767235","72767513","5","59912803"
"chr7","12901936","12902234","chr5","72820404","72820713","27","59918468"
"chr7","12926140","12926441","chr5","72915888","72916189","4","59989748"
"chr7","12969596","12969896","chr5","72960882","72961182","5","59991286"
"chr7","13001002","13001297","chr5","72992404","72992699","2","59991402"
"chr7","13024539","13024700","chr5","73015389","73015550","2","59990850"
"chr7","13024701","13025009","chr5","73015551","73015859","2","59990850"
"chr7","13025010","13025142","chr5","73015860","73015992","2","59990850"
"chr7","13054218","13054503","chr5","73044661","73044945","9","59990443"
"chr7","13055845","13056145","chr5","73046286","73046543","47","59990441"
"chr7","13090026","13090309","chr5","73082848","73083131","2","59992822"
"chr7","13091987","13092253","chr5","73084810","73085103","34","59992823"
"chr7","13100656","13100960","chr5","73093473","73093785","16","59992817"
"chr7","13104946","13105226","chr5","73097740","73098020","5","59992794"
"chr7","13115132","13115434","chr5","73107917","73108219","11","59992785"
"chr7","13116183","13116417","chr5","73108980","73109206","10","59992797"
"chr7","13140957","13141232","chr5","73133788","73134060","7","59992831"
"chr7","13143239","13143363","chr7","92478365","92478489","31","79335126"
"chr7","13146187","13146486","chr5","73139336","73139642","12","59993149"
"chr7","13178651","13178933","chr5","73171718","73172017","23","59993067"
"chr7","13179458","13179758","chr5","73172540","73172842","10","59993082"
"chr7","13184955","13185265","chr5","73178053","73178362","4","59993098"
"chr7","13187393","13187680","chr5","73180486","73180773","3","59993093"
"chr7","13192749","13193043","chr5","73185143","73185436","8","59992394"
"chr7","13194166","13194463","chr5","73186562","73186836","28","59992396"
"chr7","13197201","13197337","chr19","38899856","38899991","33","25702655"
"chr7","13205397","13205710","chr5","73197726","73198038","3","59992329"
"chr7","13207287","13207490","chr14","118730965","118731167","54","105523678"
"chr7","13269750","13270038","chr5","73261039","73261318","17","59991289"
"chr7","13289186","13289451","chr5","73281954","73282220","4","59992768"
"chr7","13390114","13390414","chr19","28718617","28718918","52","15328503"
"chr7","13431254","13431430","chr5","73422543","73422715","10","59991289"
"chr7","13522802","13523097","chr7","50593040","50593326","63","37070238"
"chr7","13539511","13539676","chr5","73531175","73531340","0","59991664"
"chr7","13567413","13567711","chr5","73559951","73560249","6","59992538"
"chr7","13591857","13592113","chr5","73586855","73587111","5","59994998"
"chr7","13623339","13623646","chr5","73618582","73618906","22","59995243"
"chr7","13679506","13679751","chr19","29049666","29049899","56","15370160"
"chr7","13681893","13682198","chr5","73685730","73686034","5","60003837"
"chr7","13702607","13702885","chr5","73706441","73706748","34","60003834"
"chr7","13769756","13770064","chr5","73774378","73774682","11","60004622"
"chr7","13842778","13843077","chr5","73850847","73851182","50","60008069"
"chr7","13861347","13861643","chr5","73869528","73869824","10","60008181"
"chr7","13865853","13866160","chr4","39258933","39259239","55","25393080"
"chr7","13897424","13897628","chr1","55250354","55250560","46","41352930"
"chr7","13897629","13897671","chr15","6815216","6815259","5","7082413"
"chr7","13920974","13921285","chr10","31493508","31493817","59","17572534"
"chr7","13928720","13929034","chr5","73942803","73943118","9","60014083"
"chr7","13937903","13938187","chr5","73952613","73952881","41","60014710"
"chr7","13991642","13991894","chr5","74006173","74006422","7","60014531"
"chr7","13997011","13997315","chr13","41851851","41852159","53","27854840"
"chr7","14055510","14055816","chr5","74070786","74071089","10","60015276"
"chr7","14068197","14068501","chr5","74083430","74083734","5","60015233"
"chr7","14100395","14100697","chr5","74115261","74115563","9","60014866"
"chr7","14105396","14105686","chr5","74120253","74120543","4","60014857"
"chr7","14109652","14109964","chr5","74124504","74124816","6","60014852"
"chr7","14136674","14136927","chr5","74151555","74151809","6","60014881"
"chr7","14152304","14152614","chr5","74166885","74167191","12","60014581"
"chr7","14172998","14173298","chr5","74187340","74187644","19","60014342"
"chr7","14183814","14184137","chr5","74198147","74198446","28","60014333"
"chr7","14204858","14204993","chr1","18863826","18863959","33","4658968"
"chr7","14205270","14205391","chr5","74222547","74222668","4","60017277"
"chr7","14211962","14212268","chr8","26857087","26857388","64","12645125"
"chr7","14219961","14220269","chr5","74237068","74237377","4","60017107"
"chr7","14223934","14224182","chr5","74241011","74241256","9","60017077"
"chr7","14267618","14267720","chr5","74284414","74284514","8","60016796"
"chr7","14273064","14273190","chr1","127802671","127802794","26","113529607"
"chr7","14277282","14277417","chr5","74293626","74293764","9","60016344"
"chr7","14277423","14277734","chr5","74293767","74294073","10","60016344"
"chr7","14296140","14296429","chr5","74310234","74310523","4","60014094"
"chr7","14296464","14296495","chr4","76826337","76826364","7","62529873"
"chr7","14311616","14311742","chr14","111735431","111735557","21","97423815"
"chr7","14313691","14313812","chr14","6669230","6669349","26","7644461"
"chr7","14314055","14314354","chr5","74328267","74328566","10","60014212"
"chr7","14315824","14315976","chr5","74330027","74330178","4","60014203"
"chr7","14332715","14333034","chr5","74347100","74347407","17","60014385"
"chr7","14334934","14335228","chr5","74349263","74349550","10","60014329"
"chr7","14341433","14341715","chr5","74353478","74353756","7","60012045"
"chr7","14345643","14345920","chr12","19952816","19953094","59","5607173"
"chr7","14348918","14349176","chr5","74362904","74363167","11","60013986"
"chr7","14366916","14367238","chr5","74382076","74382396","7","60015160"
"chr7","14377831","14377947","chr5","74392872","74392988","0","60015041"
"chr7","14379587","14379863","chr10","18366549","18366827","55","3986962"
"chr7","14384685","14384983","chr5","74399701","74399997","19","60015016"
"chr7","14391115","14391419","chr13","124875372","124875677","48","110484257"
"chr7","14391902","14392070","chr5","74406910","74407060","20","60015008"
"chr7","14393903","14394196","chr5","74408892","74409185","3","60014989"
"chr7","14422478","14422765","chr5","74432404","74432691","6","60009926"
"chr7","14423114","14423418","chr3","2797380","2797675","63","11625734"
"chr7","14468700","14468877","chr20","30935460","30935643","33","16466760"
"chr7","14468904","14469021","chr5","78092985","78093100","21","63624081"
"chr7","14474562","14474809","chr5","74485837","74486083","3","60011275"
"chr7","14484285","14484598","chr5","74495498","74495808","9","60011213"
"chr7","14501646","14501945","chr5","74512822","74513122","13","60011176"
"chr7","14508213","14508351","chr11","1808170","1808304","20","12700043"
"chr7","14516622","14516905","chr5","74527797","74528071","24","60011175"
"chr7","14542783","14543063","chr5","74555255","74555539","10","60012472"
"chr7","14551143","14551399","chr3","124267872","124268144","67","109716729"
"chr7","14551449","14551547","chr5","74566488","74566585","2","60015039"
"chr7","14559026","14559323","chr5","74573818","74574118","6","60014792"
"chr7","14567376","14567672","chr5","74582428","74582724","5","60015052"
"chr7","14576633","14576911","chr5","74592076","74592369","27","60015443"
"chr7","14590340","14590620","chr5","74606545","74606835","16","60016205"
"chr7","14592778","14593045","chr5","74608972","74609238","19","60016194"
"chr7","14611531","14611838","chr5","74629381","74629685","12","60017850"
"chr7","14615551","14615609","chr8","102013401","102013459","8","87397850"
"chr7","14616659","14616713","chr10","16885873","16885925","7","2269214"
"chr7","14629395","14629675","chr5","74645638","74645927","23","60016243"
"chr7","14687818","14687957","chr5","74706272","74706411","3","60018454"
"chr7","14713412","14713687","chr5","74731968","74732249","11","60018556"
"chr7","14749123","14749415","chr5","74767698","74768008","24","60018575"
"chr7","14810696","14811004","chrX","96318063","96318367","54","81507367"
"chr7","14813996","14814176","chr11","64297155","64297331","42","49483159"
"chr7","14814182","14814236","chr1","21550283","21550332","12","6736101"
"chr7","14914996","14915285","chr5","74940845","74941134","9","60025849"
"chr7","14937432","14937729","chr5","74964252","74964549","8","60026820"
"chr7","14989408","14989680","chr5","75016694","75016966","5","60027286"
"chr7","14990249","14990432","chr5","75017535","75017718","3","60027286"
"chr7","14998665","14998898","chr5","75025955","75026188","4","60027290"
"chr7","15031115","15031411","chr5","75062046","75062344","11","60030931"
"chr7","15065322","15065611","chr5","75102022","75102323","18","60036700"
"chr7","15090062","15090343","chr5","75126619","75126900","6","60036557"
"chr7","15090344","15090481","chr5","75126902","75127037","3","60036558"
"chr7","15104346","15104639","chr1","129087396","129087689","62","113983050"
"chr7","15106537","15106575","chr5","75142717","75142755","2","60036180"
"chr7","15108670","15108956","chr5","75144881","75145168","12","60036211"
"chr7","15148546","15148868","chr5","75183644","75183919","53","60035098"
"chr7","15158793","15159117","chr5","75193317","75193618","32","60034524"
"chr7","15165380","15165638","chr5","75199901","75200158","7","60034521"
"chr7","15186587","15186838","chr5","75223014","75223265","3","60036427"
"chr7","15189359","15189647","chr5","75225787","75226075","6","60036428"
"chr7","15189953","15190100","chr3","75119322","75119465","38","59929369"
"chr7","15207169","15207490","chr5","75245369","75245690","8","60038200"
"chr7","15209950","15210264","chr5","75248132","75248429","19","60038182"
"chr7","15262723","15263018","chr5","75311713","75312003","14","60048990"
"chr7","15300636","15300930","chr5","75354994","75355294","10","60054358"
"chr7","15448800","15449105","chr5","75494319","75494639","20","60045519"
"chr7","15455965","15456193","chr5","75501482","75501710","1","60045517"
"chr7","15476451","15476760","chr5","75527083","75527392","6","60050632"
"chr7","15651784","15652078","chr5","75706228","75706523","3","60054444"
"chr7","15674627","15674927","chr5","75729318","75729625","14","60054691"
"chr7","15678293","15678606","chr5","75732896","75733209","11","60054603"
"chr7","15693691","15693703","chr5","57939322","57939333","3","42245631"
"chr7","15698274","15698415","chr5","75757424","75757580","21","60059150"
"chr7","15710283","15710477","chr1","163126356","163126532","49","147416073"
"chr7","15743520","15743814","chr5","75811449","75811737","8","60067929"
"chr7","15744981","15745294","chr5","75812911","75813224","2","60067930"
"chr7","15784875","15785006","chr5","75854107","75854237","4","60069232"
"chr7","15785131","15785292","chr5","75854362","75854523","5","60069231"
"chr7","15789710","15790023","chr1","102513771","102514085","58","86724061"
"chr7","15797664","15797891","chr17","90056068","90056294","52","74258404"
"chr7","15799523","15799809","chr5","75868695","75868981","15","60069172"
"chr7","15814234","15814406","chr11","12397891","12398062","31","3416343"
"chr7","15814442","15814560","chr6","168702580","168702698","19","152888138"
"chr7","15823483","15823785","chr5","75892054","75892352","8","60068571"
"chr7","15840498","15840792","chr5","75909349","75909651","11","60068851"
"chr7","15843406","15843701","chr9","26171818","26172114","52","10328412"
"chr7","15847567","15847873","chr5","75916146","75916455","7","60068579"
"chr7","15862611","15862677","chr5","75931637","75931703","0","60069026"
"chr7","15862958","15863081","chr5","75931984","75932107","2","60069026"
"chr7","15898318","15898614","chr5","75973195","75973488","13","60074877"
"chr7","15905142","15905446","chr5","75979673","75979977","5","60074531"
"chr7","15909706","15909862","chr5","75984221","75984377","1","60074515"
"chr7","15971609","15971912","chr5","76050239","76050547","13","60078630"
"chr7","15974180","15974485","chr7","49571405","49571710","61","33597225"
"chr7","16030751","16031023","chr5","76097003","76097275","5","60066252"
"chr7","16043440","16043746","chr5","76109706","76110018","12","60066266"
"chr7","16059695","16059806","chr5","76126072","76126183","2","60066377"
"chr7","16138207","16138512","chr6","87232277","87232583","64","71094070"
"chr7","16213150","16213357","chr5","76277086","76277293","8","60063936"
"chr7","16234393","16234723","chr5","76298074","76298399","15","60063681"
"chr7","16257446","16257738","chr5","76318358","76318650","6","60060912"
"chr7","16287160","16287451","chr5","76349672","76349963","7","60062512"
"chr7","16317984","16318185","chr5","76380134","76380336","9","60062150"
"chr7","16322803","16323137","chr5","76387426","76387731","34","60064623"
"chr7","16350082","16350433","chr5","76414605","76414948","16","60064523"
"chr7","16579301","16579606","chr5","76642928","76643240","14","60063627"
"chr7","17919728","17920015","chr5","59468965","59469229","32","41549237"
"chr7","17962820","17963105","chr5","59425972","59426290","42","41463152"
"chr7","18066605","18066914","chr5","59302315","59302628","8","41235710"
"chr7","18087676","18087834","chr5","59281848","59282006","8","41194172"
"chr7","18096928","18097214","chr5","59272811","59273097","6","41175883"
"chr7","18199919","18200039","chr5","59175005","59175125","5","40975086"
"chr7","18313889","18314131","chr3","155349563","155349791","60","137035674"
"chr7","18355063","18355359","chr5","59030510","59030809","21","40675447"
"chr7","18419051","18419332","chr5","58981716","58981996","8","40562665"
"chr7","18832797","18833101","chr5","58633170","58633474","11","39800373"
"chr7","18833102","18833222","chr5","58633049","58633169","2","39799947"
"chr7","18855745","18855962","chr5","58610245","58610461","8","39754500"
"chr7","18901083","18901273","chr20","2647274","2647471","44","16253809"
"chr7","18969920","18970227","chr5","58483801","58484082","32","39513881"
"chr7","18981230","18981537","chr5","58472522","58472829","7","39491292"
"chr7","18982312","18982586","chr5","58471471","58471751","12","39489159"
"chr7","19002094","19002395","chr5","58452155","58452455","3","39450061"
"chr7","19023938","19024224","chr5","58429530","58429813","13","39405592"
"chr7","19043535","19043840","chr5","58409620","58409926","9","39366085"
"chr7","19050456","19050740","chr5","58402727","58403011","25","39352271"
"chr7","19125898","19126202","chr5","58326342","58326643","18","39200444"
"chr7","19137856","19138075","chr5","58314521","58314733","10","39176665"
"chr7","19150396","19150501","chr5","58302530","58302634","5","39152134"
"chr7","19151576","19151844","chr5","58301132","58301397","18","39149556"
"chr7","19205204","19205477","chr5","58248149","58248418","12","39042945"
"chr7","19206895","19207192","chr5","58246493","58246789","7","39039598"
"chr7","19229908","19230198","chr5","58224073","58224371","17","38994165"
"chr7","19244248","19244583","chr11","130982502","130982828","95","111738254"
"chr7","19246371","19246512","chr6","121105377","121105513","28","101859006"
"chr7","19252044","19252058","chr1","34267936","34267953","5","15015892"
"chr7","19261427","19261735","chr5","58192927","58193236","6","38931500"
"chr7","19266536","19266835","chr5","58187792","58188095","11","38921256"
"chr7","19278650","19278910","chr5","58175813","58176073","6","38897163"
"chr7","19308770","19309010","chr5","58141123","58141363","10","38832353"
"chr7","19327089","19327250","chr5","58127454","58127615","4","38800365"
"chr7","19338824","19339128","chr5","58115261","58115563","10","38776437"
"chr7","19339312","19339593","chr5","58114647","58114892","42","38775335"
"chr7","19339594","19339756","chr2","87382072","87382238","32","68042478"
"chr7","19345265","19345558","chr5","58097929","58098221","8","38752664"
"chr7","19352805","19352969","chr5","58102327","58102485","13","38749522"
"chr7","19353201","19353449","chr18","16392466","16392684","77","2960735"
"chr7","19358099","19358392","chr7","119985759","119986055","53","100627660"
"chr7","19372623","19372906","chr5","58081767","58082056","18","38709144"
"chr7","19397964","19398273","chr5","58052880","58053193","14","38654916"
"chr7","19404147","19404264","chr5","58046379","58046502","11","38642232"
"chr7","19421764","19422083","chr5","58027159","58027475","18","38605395"
"chr7","19422322","19422625","chr5","58026614","58026918","3","38604292"
"chr7","19428941","19429240","chr5","58019951","58020300","57","38591010"
"chr7","19429466","19429623","chr5","58019554","58019714","22","38590088"
"chr7","19429634","19429807","chr4","71615984","71616162","22","52186350"
"chr7","19429833","19429845","chr12","53486848","53486859","10","34057015"
"chr7","19430119","19430245","chr5","58019117","58019243","4","38588998"
"chr7","19440001","19440303","chr5","58009073","58009375","6","38569072"
"chr7","19442389","19442662","chr5","58006705","58006978","4","38564316"
"chr7","19460915","19461211","chr5","57982671","57982967","4","38521756"
"chr7","19466685","19466971","chr5","57976770","57977058","8","38510085"
"chr7","19472073","19472339","chr15","75137118","75137390","65","55665045"
"chr7","19476574","19476887","chr5","57966755","57967068","7","38490181"
"chr7","19486799","19487085","chr5","57957573","57957859","6","38470774"
"chr7","19500824","19501113","chr5","57944263","57944552","4","38443439"
"chr7","19501357","19501574","chr5","57943804","57944019","3","38442447"
"chr7","19505670","19505972","chr3","153060925","153061233","56","133555255"
"chr7","19518175","19518341","chr17","50631400","50631554","36","31113225"
"chr7","19518645","19518770","chr2","85795101","85795227","22","66276456"
"chr7","19522021","19522301","chr5","57923310","57923590","8","38401289"
"chr7","19551126","19551422","chr5","57892792","57893077","21","38341666"
"chr7","19562089","19562375","chr5","57881835","57882129","18","38319746"
"chr7","19566653","19566971","chr15","90416208","90416517","66","70849555"
"chr7","19568039","19568347","chr5","57875824","57876137","15","38307785"
"chr7","19570974","19571258","chr5","57872859","57873144","7","38301885"
"chr7","19573750","19574053","chr5","57870046","57870353","13","38296296"
"chr7","19593979","19594278","chr5","57849506","57849804","13","38255527"
"chr7","19608882","19609117","chr5","57834385","57834620","5","38225503"
"chr7","19621533","19621844","chr5","57821581","57821904","19","38200048"
"chr7","19651405","19651557","chr5","57791870","57792040","21","38140465"
"chr7","19712668","19712998","chr5","57727575","57727893","16","38014907"
"chr7","19748413","19748724","chr5","57692209","57692520","7","37943796"
"chr7","19810682","19810797","chr5","57628841","57628957","5","37818159"
"chr7","19810836","19811010","chr5","57628621","57628795","4","37817785"
"chr7","19877092","19877277","chr14","11444738","11444919","37","8432354"
"chr7","19877313","19877450","chr7","12585742","12585873","32","7291571"
"chr7","19941836","19941984","chr5","57498548","57498697","7","37556712"
"chr7","19988634","19988781","chr13","24635744","24635876","43","4647110"
"chr7","20000244","20000454","chr5","57436542","57436753","6","37436298"
"chr7","20134880","20135163","chr5","57317001","57317283","6","37182121"
"chr7","20169786","20170020","chr5","57270218","57270452","11","37100432"
"chr7","20199578","20199859","chr5","57241701","57241987","16","37042123"
"chr7","20203594","20203878","chr5","57237716","57238000","11","37034122"
"chr7","20490716","20491020","chr5","56984187","56984482","17","36493471"
"chr7","20558175","20558529","chr5","56921230","56921575","16","36363055"
"chr7","20645616","20645896","chr5","56847519","56847805","23","36201903"
"chr7","20652791","20653111","chr5","56840973","56841293","15","36188182"
"chr7","20758299","20758581","chr5","56730658","56730950","19","35972359"
"chr7","20886794","20887076","chr5","56596770","56597052","5","35709976"
"chr7","20936732","20937040","chr5","56545746","56546052","11","35609014"
"chr7","21062285","21062439","chr5","56417696","56417842","12","35355411"
"chr7","21184478","21184745","chr5","56288740","56289009","7","35104262"
"chr7","21221516","21221811","chr5","56245340","56245639","9","35023824"
"chr7","21281057","21281334","chr5","56183097","56183372","10","34902040"
"chr7","21283807","21284100","chr5","56180325","56180616","7","34896518"
"chr7","21289398","21289590","chr5","56174861","56175034","29","34885463"
"chr7","21289633","21289665","chr17","44895479","44895514","6","23605846"
"chr7","21441569","21441870","chr5","56017307","56017608","19","34575738"
"chr7","21508043","21508084","chr2","133706148","133706182","11","112198105"
"chr7","21525578","21525737","chr5","55932781","55932917","25","34407203"
"chr7","21543318","21543627","chr5","55914644","55914942","20","34371326"
"chr7","21550559","21550851","chr5","55907013","55907304","11","34356454"
"chr7","21563140","21563460","chr5","55894068","55894389","5","34330928"
"chr7","21569040","21569156","chr5","55888409","55888514","15","34319369"
"chr7","21580032","21580328","chr5","55877241","55877539","10","34297209"
"chr7","21604518","21604648","chr5","158569038","158569168","21","136964520"
"chr7","21610851","21611150","chr5","55846176","55846475","2","34235325"
"chr7","21623958","21624267","chr5","55833039","55833346","11","34209081"
"chr7","21640101","21640341","chr1","33525524","33525766","79","11885423"
"chr7","21653730","21654041","chr5","55803037","55803345","9","34149307"
"chr7","21839842","21840126","chr5","55622599","55622883","11","33782757"
"chr7","21848894","21849177","chr2","49076216","49076505","60","27227322"
"chr7","21873440","21873722","chr5","55589925","55590200","17","33716485"
"chr7","21966604","21966879","chr5","55498842","55499117","7","33532238"
"chr7","21994417","21994715","chr5","55471654","55471938","28","33477237"
"chr7","22086345","22086666","chr5","55381641","55381964","26","33295296"
"chr7","22179752","22180017","chr3","40504415","40504676","66","18324663"
"chr7","22198122","22198417","chr5","55273429","55273721","10","33075307"
"chr7","22364209","22364485","chr5","55106566","55106848","14","32742357"
"chr7","22458468","22458770","chr5","55010888","55011197","17","32552420"
"chr7","22687720","22687969","chr5","54751709","54751951","13","32063989"
"chr7","22783626","22783921","chr5","54656654","54656948","14","31873028"
"chr7","22840392","22840703","chr5","54599036","54599312","45","31758644"
"chr7","22897023","22897339","chr5","54542355","54542666","24","31645332"
"chr7","22984656","22984952","chr5","54453334","54453630","7","31468678"
"chr7","23055002","23055153","chr5","54384111","54384262","5","31329109"
"chr7","23055369","23055379","chr1","41526213","41526224","1","18470844"
"chr7","23124387","23124567","chr5","54315795","54315978","5","31191408"
"chr7","23131854","23132163","chr5","54308187","54308495","2","31176333"
"chr7","23174982","23175289","chr5","54259992","54260290","19","31085010"
"chr7","23333329","23333559","chr5","54097056","54097288","8","30763727"
"chr7","23381325","23381636","chr5","54047232","54047524","37","30665907"
"chr7","23427164","23427482","chr1","34527100","34527400","73","11099936"
"chr7","23439557","23439864","chr5","53987475","53987796","23","30547918"
"chr7","23457690","23457925","chr5","53970236","53970472","7","30512546"
"chr7","23474722","23475005","chr16","49862914","49863196","77","26388192"
"chr7","23653544","23653633","chr19","33205593","33205680","23","9552049"
"chr7","23806602","23806738","chr14","63745594","63745727","20","39938992"
"chr7","23892569","23892752","chr5","53523620","53523801","9","29631051"
"chr7","23953612","23953857","chr5","53453726","53453971","10","29500114"
"chr7","23954580","23954860","chr5","53452730","53453011","17","29498150"
"chr7","23962767","23963071","chr5","53444385","53444696","13","29481618"
"chr7","24010283","24010483","chr5","53394691","53394891","2","29384408"
"chr7","24033436","24033735","chr5","53371566","53371864","8","29338130"
"chr7","24035447","24035736","chr5","53369579","53369868","7","29334132"
"chr7","24043680","24043960","chr5","53361343","53361626","12","29317663"
"chr7","24055548","24055861","chr5","53349048","53349366","17","29293500"
"chr7","24056877","24057179","chr5","53347705","53348015","15","29290828"
"chr7","24080005","24080292","chr5","53324022","53324337","39","29244017"
"chr7","24082676","24082981","chr5","53321396","53321700","4","29238720"
"chr7","24086991","24087132","chr6","65110840","65110974","25","41023849"
"chr7","24106496","24106806","chr19","35664759","35665072","68","11558263"
"chr7","24111700","24111984","chr5","53292713","53292997","11","29181013"
"chr7","24130803","24131100","chr5","53271660","53271958","13","29140857"
"chr7","24144525","24144809","chr5","53256600","53256884","4","29112075"
"chr7","24173612","24173923","chr5","53228837","53229138","14","29055225"
"chr7","24184949","24185221","chr16","697627","697896","77","23487322"
"chr7","24227411","24227632","chr5","53176275","53176495","8","28948864"
"chr7","24233331","24233617","chr5","53169169","53169455","11","28935838"
"chr7","24260138","24260251","chr5","53140107","53140220","1","28879969"
"chr7","24260562","24260753","chr5","53139594","53139794","27","28879032"
"chr7","24296211","24296508","chr5","53103521","53103818","3","28807310"
"chr7","24297031","24297299","chr5","53102723","53102992","4","28805692"
"chr7","24303434","24303569","chr5","53096451","53096586","2","28793017"
"chr7","24303866","24304036","chr5","53095984","53096154","4","28792118"
"chr7","24333718","24334043","chr15","36670969","36671286","60","12337251"
"chr7","24341015","24341287","chr5","53058087","53058359","5","28717072"
"chr7","24345106","24345408","chr5","53053947","53054251","6","28708841"
"chr7","24351007","24351322","chr5","53049175","53049495","22","28698168"
"chr7","24354674","24354886","chr5","53044814","53045023","12","28690140"
"chr7","24379494","24379798","chr5","53020667","53020993","34","28641173"
"chr7","24380316","24380480","chr14","63608556","63608715","23","39228240"
"chr7","24381319","24381619","chr5","53018860","53019157","8","28637541"
"chr7","24383121","24383425","chr5","53017062","53017368","11","28633941"
"chr7","24386710","24387021","chr5","53013400","53013683","35","28626690"
"chr7","24388117","24388422","chr5","53011968","53012267","23","28623851"
"chr7","24391311","24391436","chr5","53009160","53009286","2","28617849"
"chr7","24392027","24392226","chr5","53008371","53008570","10","28616344"
"chr7","24400261","24400570","chr5","52999378","52999687","14","28599117"
"chr7","24415781","24416029","chr5","52984284","52984532","4","28568503"
"chr7","24418777","24419041","chr5","35718571","35718843","75","11299794"
"chr7","24436408","24436703","chr5","52963353","52963642","9","28526945"
"chr7","24436856","24437162","chr5","52962889","52963198","16","28526033"
"chr7","24446330","24446628","chr5","52953400","52953698","3","28507070"
"chr7","24456361","24456554","chr5","52943504","52943697","3","28487143"
"chr7","24463048","24463230","chr5","52936845","52937029","10","28473797"
"chr7","24464096","24464206","chr5","52935869","52935980","11","28471773"
"chr7","24468579","24468743","chr5","52931350","52931514","6","28462771"
"chr7","24501286","24501583","chr5","52898575","52898878","16","28397289"
"chr7","24521248","24521519","chr5","52878562","52878833","6","28357314"
"chr7","24538920","24539203","chr5","52860852","52861134","8","28321932"
"chr7","24549496","24549781","chr5","52850158","52850443","5","28300662"
"chr7","24600873","24601200","chr5","52798229","52798554","10","28197356"
"chr7","24620351","24620641","chr5","52778914","52779205","7","28158563"
"chr7","24657896","24658176","chr5","52742476","52742758","9","28084580"
"chr7","24664221","24664361","chr5","52736277","52736417","6","28072056"
"chr7","24664650","24664813","chr5","52735822","52735979","13","28071172"
"chr7","24768851","24768996","chr5","52633286","52633431","7","27864435"
"chr7","24769333","24769496","chr5","52632813","52632977","6","27863480"
"chr7","24797279","24797473","chr5","52604291","52604485","3","27807012"
"chr7","24829336","24829628","chr5","52571128","52571420","4","27741792"
"chr7","24830731","24831031","chr5","52569725","52570024","10","27738994"
"chr7","24843147","24843456","chr5","52557897","52558200","16","27714750"
"chr7","24872539","24872816","chr5","52528130","52528407","12","27655591"
"chr7","24876552","24876861","chr5","52524185","52524494","9","27647633"
"chr7","24930881","24931188","chr5","52469395","52469695","17","27538514"
"chr7","24942230","24942521","chr5","52458011","52458297","13","27515781"
"chr7","24943161","24943461","chr5","52457078","52457381","11","27513917"
"chr7","24952000","24952275","chr5","52448633","52448915","11","27496633"
"chr7","24959391","24959702","chr5","52441587","52441914","23","27482196"
"chr7","24965755","24966052","chr5","52435274","52435559","17","27469519"
"chr7","25013886","25014011","chr5","52387865","52387990","3","27373979"
"chr7","25014321","25014499","chr5","52387405","52387566","21","27373084"
"chr7","25049522","25049681","chr5","52352008","52352167","4","27302486"
"chr7","25064267","25064539","chr5","52337384","52337674","35","27273117"
"chr7","25075417","25075688","chr5","52323252","52323524","10","27247835"
"chr7","25092733","25092896","chr5","52305390","52305553","5","27212657"
"chr7","25096044","25096322","chr5","52301934","52302228","36","27205890"
"chr7","25127576","25127889","chr5","52270526","52270824","20","27142950"
"chr7","25145276","25145563","chr5","52252156","52252467","39","27106880"
"chr7","25152330","25152469","chr5","52245321","52245461","1","27092991"
"chr7","25164249","25164494","chr5","52232963","52233208","3","27068714"
"chr7","25165166","25165470","chr5","52231992","52232290","12","27066826"
"chr7","25168594","25168891","chr5","52228626","52228923","6","27060032"
"chr7","25172360","25172660","chr5","52224905","52225205","10","27052545"
"chr7","25203775","25204101","chr16","25211732","25212053","61","7957"
"chr7","25210411","25210613","chr5","52186432","52186634","0","26976021"
"chr7","25234115","25234253","chr5","52162733","52162891","24","26928618"
"chr7","25264158","25264434","chr5","52132063","52132334","19","26867905"
"chr7","25281096","25281391","chr6","51232058","51232350","53","25950962"
"chr7","25291103","25291415","chr5","52107222","52107543","24","26816119"
"chr7","25316632","25316920","chr5","52081836","52082124","7","26765204"
"chr7","25318962","25319285","chr5","52079427","52079800","63","26760465"
"chr7","25323576","25323800","chr5","52074797","52075020","3","26751221"
"chr7","25331856","25332155","chr5","52066339","52066642","12","26734483"
"chr7","25355434","25355643","chr13","108242720","108242914","46","82887286"
"chr7","25362987","25363295","chr5","52032870","52033176","10","26669883"
"chr7","25366596","25366905","chr5","52029157","52029443","29","26662561"
"chr7","25392037","25392333","chr5","52004808","52005104","9","26612771"
"chr7","25560883","25561033","chr5","51841131","51841285","7","26280248"
"chr7","25561335","25561467","chr5","51840698","51840830","5","26279363"
"chr7","25562410","25562683","chr1","48167728","48168009","59","22605318"
"chr7","25566056","25566350","chr5","51835939","51836233","4","26269883"
"chr7","25569292","25569585","chr5","51832692","51832985","7","26263400"
"chr7","25570753","25570877","chr5","51831444","51831569","1","26260691"
"chr7","25578799","25578984","chr5","51823361","51823547","3","26244562"
"chr7","25579672","25579982","chr5","51822365","51822672","9","26242693"
"chr7","25586175","25586485","chr5","51815890","51816207","12","26229715"
"chr7","25586703","25586991","chr5","51815383","51815665","18","26228680"
"chr7","25597133","25597413","chr5","51804850","51805130","9","26207717"
"chr7","25597873","25598164","chr5","51804099","51804390","3","26206226"
"chr7","25601308","25601464","chr5","51801024","51801180","1","26199716"
"chr7","25601677","25601808","chr5","51800681","51800812","1","26199004"
"chr7","25602245","25602357","chr10","46679056","46679164","41","21076811"
"chr7","25614997","25615287","chr5","51786364","51786651","10","26171367"
"chr7","25653466","25653764","chr5","51746119","51746414","6","26092653"
"chr7","25665016","25665177","chr3","150425172","150425312","41","124760156"
"chr7","25673553","25673877","chr5","51725988","51726300","18","26052435"
"chr7","25681502","25681812","chrX","44351849","44352136","80","18670347"
"chr7","25933286","25933562","chr5","174891442","174891728","82","148958156"
"chr7","26016954","26017264","chr5","51373038","51373337","15","25356084"
"chr7","26018328","26018454","chr5","51371868","51371994","3","25353540"
"chr7","26032544","26032852","chr5","51357789","51358098","12","25325245"
"chr7","26108516","26108720","chr5","51275884","51276081","9","25167368"
"chr7","26178103","26178406","chr5","51208843","51209146","4","25030740"
"chr7","26220913","26221289","chr5","51166287","51166663","7","24945374"
"chr7","26277512","26277820","chr5","51109555","51109852","16","24832043"
"chr7","26279696","26279973","chr5","51107454","51107731","6","24827758"
"chr7","26282870","26283168","chr5","51104272","51104564","9","24821402"
"chr7","26290083","26290409","chr5","51097031","51097350","10","24806948"
"chr7","26291980","26292275","chr5","51095165","51095462","6","24803185"
"chr7","26329071","26329360","chr5","51056043","51056331","10","24726972"
"chr7","26330478","26330649","chr8","61473883","61474049","35","35143405"
"chr7","26330734","26330857","chr1","48200300","48200409","32","21869566"
"chr7","26337204","26337486","chr5","51047876","51048158","6","24710672"
"chr7","26341447","26341630","chr5","51039679","51039870","17","24698232"
"chr7","26341935","26342078","chr5","51039231","51039352","27","24697296"
"chr7","26355424","26355675","chr5","51025003","51025255","2","24669579"
"chr7","26360705","26361012","chr5","51019733","51020030","17","24659028"
"chr7","26361526","26361817","chr5","51018919","51019210","3","24657393"
"chr7","26362184","26362353","chr5","51018375","51018550","8","24656191"
"chr7","26362637","26362778","chr5","51017951","51018091","4","24655314"
"chr7","26375854","26376136","chr5","51004573","51004859","9","24628719"
"chr7","26386999","26387228","chr5","50993412","50993641","5","24606413"
"chr7","26403535","26403637","chr5","50976098","50976200","1","24572563"
"chr7","26408824","26409123","chr5","50970208","50970507","3","24561384"
"chr7","26514577","26514860","chr5","50865838","50866121","8","24351261"
"chr7","26514910","26514924","chr10","20601012","20601026","2","5913898"
"chr7","26614449","26614756","chr5","50763275","50763589","14","24148826"
"chr7","26659497","26659897","chr14","57283615","57283957","118","30624118"
"chr7","26672976","26673079","chr5","50704969","50705072","1","24031993"
"chr7","26673122","26673288","chr5","50704752","50704918","4","24031630"
"chr7","26684025","26684298","chr5","50693280","50693551","11","24009255"
"chr7","26687989","26688279","chr5","50689462","50689752","5","24001473"
"chr7","26699015","26699291","chr5","50677995","50678270","13","23978980"
"chr7","26718242","26718548","chr5","50654701","50655006","22","23936459"
"chr7","26762511","26762816","chr5","50615044","50615352","11","23852533"
"chr7","26782628","26782892","chr4","4902587","4902853","66","21880041"
"chr7","26851950","26852242","chr13","27498484","27498766","67","646534"
"chr7","26868972","26869221","chr5","50502696","50502939","11","23633724"
"chr7","26877887","26878125","chr18","16392466","16392684","54","10485421"
"chr7","26886346","26886644","chr5","50485269","50485568","9","23598923"
"chr7","26943932","26944148","chr13","71930372","71930585","44","44986440"
"chr7","26985739","26986047","chr5","50387518","50387821","18","23401779"
"chr7","27003020","27003304","chr5","50370713","50371014","28","23367693"
"chr7","27006855","27007156","chr5","50366862","50367170","11","23360007"
"chr7","27020461","27020736","chr5","50353278","50353561","13","23332817"
"chr7","27023567","27023874","chr5","50350145","50350449","9","23326578"
"chr7","27033530","27033696","chr5","50340508","50340685","18","23306978"
"chr7","27038479","27038782","chr5","50335803","50336104","15","23297324"
"chr7","27044053","27044214","chr5","50330414","50330566","10","23286361"
"chr7","27048270","27048581","chr5","50326113","50326424","4","23277843"
"chr7","27084291","27084575","chr5","50290613","50290890","8","23206322"
"chr7","27084584","27084897","chr5","50290291","50290604","7","23205707"
"chr7","27095631","27095761","chr5","50279399","50279529","4","23183768"
"chr7","27098105","27098286","chr5","50276869","50277051","11","23178764"
"chr7","27105176","27105484","chr5","50268329","50268638","11","23163153"
"chr7","27107074","27107363","chr5","50266500","50266788","7","23159426"
"chr7","27132734","27133041","chr1","113923965","113924259","65","86791231"
"chr7","27145782","27145887","chr5","50228801","50228910","4","23083019"
"chr7","27150985","27151262","chr5","50223420","50223691","8","23072435"
"chr7","27156366","27156641","chr5","50218051","50218326","13","23061685"
"chr7","27160142","27160442","chr5","50214364","50214664","4","23054222"
"chr7","27165108","27165398","chr5","50209609","50209899","5","23044501"
"chr7","27174002","27174088","chr15","38079462","38079553","15","10905460"
"chr7","27174666","27174953","chr11","115941293","115941577","62","88766627"
"chr7","27185993","27186309","chr5","50187755","50188065","23","23001762"
"chr7","27217686","27217933","chr8","85460154","85460403","50","58242468"
"chr7","27219414","27219584","chr5","50152916","50153087","7","22933502"
"chr7","27219886","27220175","chr5","50152316","50152604","8","22932430"
"chr7","27240271","27240552","chr5","50131233","50131514","11","22890962"
"chr7","27253888","27254132","chr5","50118020","50118264","5","22864132"
"chr7","27331075","27331366","chr5","50039593","50039884","8","22708518"
"chr7","27332857","27332938","chr5","50038017","50038098","0","22705160"
"chr7","27377284","27377568","chr11","118153392","118153687","60","90776108"
"chr7","27386611","27386747","chr5","49984065","49984201","4","22597454"
"chr7","27394607","27394780","chr5","49976184","49976357","3","22581577"
"chr7","27395240","27395364","chr5","49975668","49975800","13","22580428"
"chr7","27412293","27412472","chr5","49958493","49958675","8","22546200"
"chr7","27520371","27520667","chr5","49850118","49850409","21","22329747"
"chr7","27535452","27535722","chr5","49834452","49834712","14","22299000"
"chr7","27604649","27604884","chr5","49761189","49761424","8","22156540"
"chr7","27876773","27877032","chr5","49483663","49483916","13","21606890"
"chr7","27978195","27978340","chr5","49383228","49383371","3","21405033"
"chr7","27989199","27989513","chr5","49371995","49372309","9","21382796"
"chr7","28000654","28000940","chr5","49358011","49358315","32","21357357"
"chr7","28019522","28019810","chr5","49338842","49339136","18","21319320"
"chr7","28147128","28147428","chrX","7312938","7313223","64","20834190"
"chr7","28168747","28169060","chr5","49183596","49183897","20","21014849"
"chr7","28248047","28248327","chr5","49103340","49103625","20","20855293"
"chr7","28396061","28396357","chr5","48953090","48953391","37","20557029"
"chr7","28450837","28451139","chr5","48897658","48897958","6","20446821"
"chr7","28525251","28525489","chr5","48822002","48822251","26","20296751"
"chr7","28590993","28591271","chr5","48753186","48753464","6","20162193"
"chr7","28661796","28662063","chr5","48681656","48681904","25","20019860"
"chr7","28686921","28687237","chr5","48655359","48655680","22","19968438"
"chr7","28746661","28746959","chr5","48591561","48591859","6","19844900"
"chr7","28894235","28894395","chr7","53483520","53483679","29","24589285"
"chr7","28894431","28894546","chr7","123468950","123469069","18","94574519"
"chr7","28927856","28928136","chr5","48408848","48409128","10","19480992"
"chr7","28989628","28989797","chr5","48348116","48348283","11","19358488"
"chr7","29002886","29003156","chr5","48334722","48334990","6","19331836"
"chr7","29060928","29061223","chr5","48265882","48266189","18","19204954"
"chr7","29093630","29093955","chr5","48233069","48233363","36","19139439"
"chr7","29281356","29281652","chr5","48044597","48044904","22","18763241"
"chr7","29323187","29323482","chr5","48000613","48000912","15","18677426"
"chr7","29324339","29324659","chr5","47999425","47999772","45","18675086"
"chr7","29362566","29362836","chr5","47960680","47960953","15","18598114"
"chr7","29507584","29507941","chr5","47814297","47814657","11","18306713"
"chr7","29521825","29521917","chr5","47800866","47800958","2","18279041"
"chr7","29539077","29539353","chr5","47783377","47783687","50","18244300"
"chr7","29540859","29541133","chr5","47781585","47781887","36","18240726"
"chr7","29782750","29783058","chr5","47539126","47539433","6","17756376"
"chr7","29803434","29803738","chr5","47518432","47518746","16","17714998"
"chr7","29819431","29819740","chr5","47501620","47501932","16","17682189"
"chr7","29845944","29846251","chr5","47474800","47475102","15","17628856"
"chr7","29853875","29854179","chr5","47466625","47466937","14","17612750"
"chr7","29862711","29862851","chr5","47457560","47457688","17","17594849"
"chr7","29863168","29863334","chr5","47457074","47457240","3","17593906"
"chr7","29867862","29868131","chr5","47451952","47452223","20","17584090"
"chr7","29900887","29900912","chr1","11873645","11873666","5","18027242"
"chr7","29901001","29901281","chr8","23676331","23676615","60","6224670"
"chr7","29947026","29947274","chr5","47376703","47376951","3","17429677"
"chr7","29999072","29999207","chr19","41813759","41813892","25","11814687"
"chr7","29999233","29999359","chr4","33514863","33514986","21","3515630"
"chr7","30058254","30058552","chr4","24567157","24567462","56","5491097"
"chr7","30120637","30120843","chr5","47211518","47211722","7","17090881"
"chr7","30143801","30144075","chr5","47187917","47188204","17","17044116"
"chr7","30200588","30200870","chr5","47131290","47131573","11","16930702"
"chr7","30256798","30257100","chr5","47075279","47075581","9","16818481"
"chr7","30296180","30296498","chr5","47034587","47034880","29","16738407"
"chr7","30354210","30354492","chr5","46973707","46973989","3","16619497"
"chr7","30393445","30393756","chr5","46934498","46934797","21","16541053"
"chr7","30432892","30433184","chr5","46894596","46894878","21","16461704"
"chr7","30534486","30534768","chr5","46783131","46783434","32","16248645"
"chr7","30570754","30571029","chr5","46750184","46750459","6","16179430"
"chr7","30596752","30597055","chr5","46721344","46721647","11","16124592"
"chr7","30627891","30628127","chr5","46690283","46690512","11","16062392"
"chr7","30641267","30641550","chr5","46677275","46677558","7","16036008"
"chr7","30642358","30642582","chr5","46676228","46676464","17","16033870"
"chr7","30651273","30651565","chr5","46667059","46667352","3","16015786"
"chr7","30655905","30656186","chr5","46662459","46662740","13","16006554"
"chr7","30656548","30656685","chr5","46661963","46662100","4","16005415"
"chr7","30667929","30668233","chr5","46654268","46654569","17","15986339"
"chr7","30676917","30676960","chr15","21357492","21357535","3","9319425"
"chr7","30676961","30677249","chr5","46644039","46644343","26","15967078"
"chr7","30679353","30679535","chr17","90173024","90173197","36","59493671"
"chr7","30700358","30700639","chr5","46622668","46622949","1","15922310"
"chr7","30701254","30701276","chr3","43935721","43935742","1","13234467"
"chr7","30701308","30701543","chr5","46621770","46622005","7","15920462"
"chr7","30712218","30712365","chr5","46608498","46608645","3","15896280"
"chr7","30739793","30740078","chr5","46579887","46580172","3","15840094"
"chr7","30752034","30752288","chr5","46567751","46568003","6","15815717"
"chr7","30755271","30755574","chr5","46564424","46564734","13","15809153"
"chr7","30773042","30773328","chr5","46549147","46549433","7","15776105"
"chr7","30773621","30773686","chr5","46548493","46548558","4","15774872"
"chr7","30779275","30779409","chr5","46542808","46542959","18","15763533"
"chr7","30782906","30782975","chr7","18990177","18990249","12","11792729"
"chr7","30783936","30784223","chr5","46537959","46538262","24","15754023"
"chr7","30789085","30789234","chr19","39769443","39769593","29","8980358"
"chr7","30792673","30792977","chr5","46527523","46527836","17","15734850"
"chr7","30800040","30800386","chr5","46519715","46520061","6","15719675"
"chr7","30802454","30802711","chr5","46516782","46517041","7","15714328"
"chr7","30812479","30812760","chr5","46506732","46507011","12","15694253"
"chr7","30815689","30815998","chr5","46503413","46503722","4","15687724"
"chr7","30818936","30819201","chr18","1368064","1368332","51","29450872"
"chr7","30825918","30826194","chr5","46491863","46492143","8","15665945"
"chr7","30831680","30831954","chr3","50031247","50031529","56","19199567"
"chr7","30833415","30833702","chrX","50831232","50831522","52","19997817"
"chr7","30836747","30837035","chr5","46479496","46479782","5","15642749"
"chr7","30841422","30841751","chr5","46474179","46474508","7","15632757"
"chr7","30851709","30852008","chr5","46463310","46463609","9","15611601"
"chr7","30853930","30854237","chr5","46461086","46461387","13","15607156"
"chr7","30863156","30863440","chr5","46451590","46451863","13","15588434"
"chr7","30873946","30874107","chr5","46441003","46441171","11","15567057"
"chr7","30875010","30875138","chr5","46439975","46440104","4","15564965"
"chr7","30890044","30890290","chr5","46423522","46423768","3","15533478"
"chr7","30911195","30911354","chr8","20115756","20115916","27","10795439"
"chr7","30915615","30915923","chr5","46397738","46398046","5","15482123"
"chr7","30928837","30929149","chr5","46378316","46378612","20","15449479"
"chr7","30933846","30934150","chr5","46384664","46384958","20","15450818"
"chr7","30990918","30991047","chr5","46320987","46321125","10","15330069"
"chr7","31040474","31040769","chr5","46269710","46270003","8","15229236"
"chr7","31044371","31044665","chr5","46267189","46267486","18","15222818"
"chr7","31091609","31091907","chr5","46207577","46207864","23","15115968"
"chr7","31124305","31124609","chr5","46180676","46180978","11","15056371"
"chr7","31131733","31132035","chrX","62293041","62293348","59","31161308"
"chr7","31145102","31145257","chr5","46161146","46161301","7","15016044"
"chr7","31157377","31157677","chr9","85506045","85506341","50","54348668"
"chr7","31161982","31162277","chr5","46147010","46147306","16","14985028"
"chr7","31194564","31194847","chr5","46115378","46115661","2","14920814"
"chr7","31200581","31200741","chr9","26143190","26143342","41","5057391"
"chr7","31200771","31200880","chr3","144568592","144568703","21","113367821"
"chr7","31203532","31203815","chr12","14348133","14348414","55","16855399"
"chr7","31205780","31206069","chr5","46104347","46104635","6","14898567"
"chr7","31226466","31226679","chr5","46083101","46083314","4","14856635"
"chr7","31264123","31264423","chr1","53885823","53886111","64","22621700"
"chr7","31264577","31264845","chr5","46044632","46044890","17","14780055"
"chr7","31272483","31272781","chr5","46036325","46036623","1","14763842"
"chr7","31272911","31273109","chr5","46035996","46036194","8","14763085"
"chr7","31279344","31279649","chr5","46029409","46029710","16","14750065"
"chr7","31299412","31299651","chr5","46011225","46011482","49","14711813"
"chr7","31323283","31323583","chr5","45987479","45987778","5","14664196"
"chr7","31336017","31336318","chr5","45974597","45974896","10","14638580"
"chr7","31353961","31354237","chr5","45956836","45957112","7","14602875"
"chr7","31356593","31356869","chr5","45954203","45954479","6","14597610"
"chr7","31360622","31360858","chr5","45950210","45950447","3","14589588"
"chr7","31360985","31361250","chr5","45949799","45950074","16","14588814"
"chr7","31377549","31377852","chr5","45927994","45928296","7","14550445"
"chr7","31378023","31378329","chr19","46914609","46914920","56","15536586"
"chr7","31390596","31390775","chr5","45917366","45917564","21","14526770"
"chr7","31396492","31396782","chr5","45909731","45910021","8","14513239"
"chr7","31419571","31419819","chr7","160002807","160003056","55","128583236"
"chr7","31419973","31420009","chr7","159514506","159514543","5","128094533"
"chr7","31420685","31420986","chr5","45884325","45884627","3","14463640"
"chr7","31434714","31434754","chr20","25736096","25736136","11","5698618"
"chr7","31434755","31435065","chr7","111283263","111283566","48","79848508"
"chr7","31435066","31435220","chr16","66471408","66471557","33","35036342"
"chr7","31439034","31439342","chr5","45865281","45865600","17","14426247"
"chr7","31444002","31444285","chr5","45860085","45860368","3","14416083"
"chr7","31449278","31449545","chr5","45855361","45855628","9","14406083"
"chr7","31454588","31454876","chr5","45849693","45849981","4","14395105"
"chr7","31455392","31455690","chr5","45848881","45849177","8","14393489"
"chr7","31473257","31473566","chr5","45831153","45831463","18","14357896"
"chr7","31500476","31500707","chr5","45803337","45803557","16","14302861"
"chr7","31525721","31526016","chr5","45776004","45776297","13","14250283"
"chr7","31551194","31551499","chr5","45744183","45744487","11","14192989"
"chr7","31555526","31555738","chr5","45708642","45708854","7","14153116"
"chr7","31610607","31610680","chr5","20339254","20339327","16","11271353"
"chr7","31610681","31610825","chr2","172527496","172527638","25","140916815"
"chr7","31622611","31622901","chr5","45663030","45663315","28","14040419"
"chr7","31643125","31643208","chr5","45642777","45642860","0","13999652"
"chr7","31650057","31650359","chr5","45635387","45635684","13","13985330"
"chr7","31656943","31657136","chr5","45628603","45628796","2","13971660"
"chr7","31663982","31664274","chr5","45621447","45621740","8","13957465"
"chr7","31680521","31680803","chr1","121994182","121994464","55","90313661"
"chr7","31685446","31685747","chr5","45594289","45594590","6","13908843"
"chr7","31692696","31692979","chr5","45587414","45587697","10","13894718"
"chr7","31695069","31695367","chr5","45584994","45585297","14","13889925"
"chr7","31697743","31698041","chr5","45582368","45582625","43","13884625"
"chr7","31698662","31698948","chr5","45581442","45581728","8","13882780"
"chr7","31706554","31706848","chr7","130342408","130342705","71","98635854"
"chr7","31708819","31709137","chr5","45571994","45572311","7","13863175"
"chr7","31715151","31715457","chr5","45565682","45565988","7","13850531"
"chr7","31728611","31728834","chr5","45552178","45552401","3","13823567"
"chr7","31731542","31731812","chr5","45549140","45549405","11","13817598"
"chr7","31734588","31734856","chr1","65442515","65442795","66","33707927"
"chr7","31735277","31735572","chr5","45545507","45545800","13","13810230"
"chr7","31759725","31759747","chr4","112456239","112456258","8","80696514"
"chr7","31766891","31767201","chr4","36593951","36594258","50","4827060"
"chr7","31776241","31776337","chr11","110032530","110032623","21","78256289"
"chr7","31776338","31776479","chr5","45505236","45505377","2","13728898"
"chr7","31797448","31797718","chr5","45483739","45483995","22","13686291"
"chr7","31802627","31802927","chr1","109952594","109952891","58","78149967"
"chr7","31803078","31803408","chr11","82343675","82344006","69","50540597"
"chr7","31812437","31812575","chr5","45469525","45469663","3","13657088"
"chr7","31812844","31812986","chr5","45469106","45469248","5","13656262"
"chr7","31812988","31813165","chr5","45468928","45469104","5","13655940"
"chr7","31814301","31814607","chr10","50786296","50786590","57","18971995"
"chr7","31815514","31815640","chr5","45466462","45466579","11","13650948"
"chr7","31824600","31824903","chr11","1642825","1643131","61","30181775"
"chr7","31830258","31830570","chr5","45451641","45451956","10","13621383"
"chr7","31838475","31838757","chr5","45443446","45443728","17","13604971"
"chr7","31838790","31838810","chr5","45443389","45443409","0","13604599"
"chr7","31841772","31841861","chr1","24072214","24072303","18","7769558"
"chr7","31842175","31842388","chr5","45439794","45440008","9","13597619"
"chr7","31845497","31845816","chr5","45436358","45436669","18","13590861"
"chr7","31856501","31856811","chr5","45425332","45425636","17","13568831"
"chr7","31859706","31859880","chr2","187026390","187026555","48","155166684"
"chr7","31860320","31860590","chr5","45421194","45421466","15","13560874"
"chr7","31863965","31864239","chr5","45417535","45417809","10","13553570"
"chr7","31864527","31864769","chr5","45417004","45417247","10","13552477"
"chr7","31866466","31866688","chr5","45415168","45415387","7","13548702"
"chr7","31872310","31872596","chr5","45409265","45409543","24","13536955"
"chr7","31873113","31873400","chr5","45408445","45408736","12","13535332"
"chr7","31880175","31880466","chr5","45401689","45401981","4","13521514"
"chr7","31883260","31883532","chr5","45398637","45398927","22","13515377"
"chr7","31890488","31890759","chr5","45391476","45391747","12","13500988"
"chr7","31903603","31903772","chr3","173526190","173526356","29","141622587"
"chr7","31911482","31911754","chr2","48335167","48335453","57","16423685"
"chr7","31926457","31926744","chrX","142451085","142451374","66","110524628"
"chr7","31929709","31930007","chr8","70539683","70539976","53","38609974"
"chr7","31935904","31936195","chrX","90714841","90715125","57","58778937"
"chr7","31936287","31936569","chr7","122518704","122518988","65","90582417"
"chr7","31951388","31951539","chr15","83109965","83110112","37","51158577"
"chr7","31962675","31962946","chr13","97075394","97075670","50","65112719"
"chr7","31979903","31980189","chr3","150376105","150376398","63","118396202"
"chr7","31980786","31981085","chr16","44745004","44745304","54","12764218"
"chr7","31985878","31986186","chr10","34374299","34374608","51","2388421"
"chr7","32005563","32005831","chr3","160818351","160818618","55","128812788"
"chr7","32016091","32016275","chr1","66887413","66887590","34","34871322"
"chr7","32017911","32018149","chr19","4459173","4459395","60","27558738"
"chr7","32018541","32018850","chr1","14612826","14613129","63","17405715"
"chr7","32027529","32027669","chr5","45356290","45356430","1","13328761"
"chr7","32072592","32072904","chr5","45311987","45312293","15","13239395"
"chr7","32078985","32079271","chr5","45305647","45305933","5","13226662"
"chr7","32085518","32085842","chr5","45299070","45299402","32","13213552"
"chr7","32103274","32103570","chr5","45279411","45279707","11","13176137"
"chr7","32108104","32108386","chr5","45274541","45274824","3","13166437"
"chr7","32113606","32113780","chr5","45269024","45269193","12","13155418"
"chr7","32113845","32113870","chr8","95824347","95824366","16","63710502"
"chr7","32113920","32114052","chr1","29281668","29281796","23","2832252"
"chr7","32124069","32124332","chr5","45258441","45258719","28","13134372"
"chr7","32132466","32132725","chr1","12027559","12027812","65","20104907"
"chr7","32156932","32157238","chr2","91188458","91188766","60","59031526"
"chr7","32182450","32182748","chr5","45196660","45196966","13","13014210"
"chr7","32224977","32225250","chr5","45152953","45153245","41","12927976"
"chr7","32311718","32312015","chr5","45067442","45067738","6","12755724"
"chr7","32439873","32440160","chr5","44935933","44936220","6","12496060"
"chr7","32459481","32459633","chr5","44916534","44916685","4","12457053"
"chr7","32483001","32483277","chr5","44893216","44893492","10","12410215"
"chr7","32520847","32521135","chr5","44852756","44853037","10","12331909"
"chr7","32577088","32577418","chr1","26606474","26606791","66","5970614"
"chr7","32592427","32592711","chr16","40376507","40376790","56","7784080"
"chr7","32607099","32607394","chr5","44752344","44752640","8","12145245"
"chr7","32805204","32805504","chr5","44544528","44544839","23","11739324"
"chr7","32882926","32883054","JH682662","6020","6141","29","32876906"
"chr7","32883859","32883898","chr14","17270498","17270540","10","15613361"
"chr7","32961996","32962262","chr5","44389448","44389714","8","11427452"
"chr7","32973613","32973802","chr5","44376989","44377179","6","11403376"
"chr7","32974204","32974493","chr2","131035064","131035329","79","98060860"
"chr7","32975540","32975745","chr5","44375089","44375264","33","11399549"
"chr7","32996471","32996755","chr5","44348601","44348885","10","11352130"
"chr7","32999304","32999600","chr7","124269347","124269646","61","91270043"
"chr7","33016319","33016642","chr3","43023873","43024189","68","10007554"
"chr7","33023316","33023606","chr5","44321336","44321625","13","11298020"
"chr7","33039681","33039986","chr5","44304410","44304716","12","11264729"
"chr7","33061712","33062004","chr5","44282269","44282559","8","11220557"
"chr7","33068138","33068435","chr5","44275862","44276158","9","11207724"
"chr7","33069737","33070042","chr5","44274256","44274562","10","11204519"
"chr7","33075394","33075669","chr19","10648639","10648911","65","22426755"
"chr7","33088563","33088862","chr5","44255121","44255410","18","11166558"
"chr7","33106115","33106414","chr5","44237190","44237484","15","11131075"
"chr7","33129098","33129393","chr5","44215930","44216226","7","11086832"
"chr7","33141236","33141492","chr5","44204123","44204379","3","11062887"
"chr7","33157450","33157591","chr7","144409615","144409761","34","111252165"
"chr7","33157726","33157844","chr11","31536687","31536806","24","1621039"
"chr7","33193618","33193905","chr5","44151223","44151521","19","10957605"
"chr7","33203611","33203926","chr5","44141174","44141489","8","10937563"
"chr7","33212642","33212948","chr5","44131858","44132151","20","10919216"
"chr7","33226189","33226475","JH682082","6595","6881","8","33219594"
"chr7","33231718","33232002","JH682082","12050","12354","24","33219668"
"chr7","33234047","33234364","JH682082","14678","14979","27","33219369"
"chr7","33238024","33238259","chr1","120821974","120822200","59","87583950"
"chr7","33250588","33250880","JH682082","30525","30818","7","33220063"
"chr7","33284943","33285091","chr2","117555870","117556023","28","84270927"
"chr7","33285972","33286211","chr7","156871585","156871829","47","123585613"
"chr7","33312582","33312899","JH682082","97331","97650","9","33215251"
"chr7","33339512","33339630","JH682082","125508","125626","2","33214004"
"chr7","33342172","33342359","JH682082","128128","128324","13","33214044"
"chr7","33347761","33348057","JH682082","133726","134010","16","33214035"
"chr7","33450402","33450611","JH682082","233687","233903","9","33216715"
"chr7","33827628","33827944","chr5","76963913","76964228","12","43136285"
"chr7","33903721","33903882","chr5","77042399","77042561","13","43138678"
"chr7","33923369","33923664","chr5","77063885","77064179","13","43140516"
"chr7","33944819","33945107","chr5","77084245","77084534","9","43139426"
"chr7","34008493","34008768","chr5","77147632","77147907","4","43139139"
"chr7","34085777","34086056","chr5","77227147","77227429","14","43141370"
"chr7","34117027","34117322","chr5","77258107","77258420","27","43141080"
"chr7","34129789","34130035","chr5","77270825","77271066","9","43141036"
"chr7","34131659","34131771","chr11","47835168","47835282","22","13703509"
"chr7","34132054","34132222","chr10","83046737","83046899","37","48914683"
"chr7","34285561","34285692","chr5","77426794","77426925","5","43141233"
"chr7","34385411","34385691","chr5","77529283","77529561","5","43143872"
"chr7","34464965","34465268","chr5","77611295","77611598","10","43146330"
"chr7","34518779","34519053","chr5","77664965","77665240","14","43146186"
"chr7","34590491","34590774","chr5","77742852","77743143","23","43152361"
"chr7","34598689","34598975","chr2","113565080","113565367","58","78966391"
"chr7","34613494","34613817","chr5","77766563","77766887","7","43153069"
"chr7","34691529","34691801","chr5","77844799","77845085","28","43153270"
"chr7","34728850","34729152","chr5","77882400","77882700","10","43153550"
"chr7","34729301","34729584","chr5","77882761","77883069","40","43153460"
"chr7","34744267","34744557","chr5","77896678","77896966","5","43152411"
"chr7","34790741","34790943","chr5","77943831","77943995","49","43153090"
"chr7","34796242","34796529","chr5","77949587","77949874","12","43153345"
"chr7","34803804","34804139","chr5","77956946","77957278","6","43153142"
"chr7","34847830","34848020","chr5","77998731","77998941","26","43150901"
"chr7","34904334","34904646","chr5","78055207","78055501","27","43150873"
"chr7","34913182","34913264","chr5","78064126","78064208","2","43150944"
"chr7","34920685","34920976","chr5","78071919","78072217","14","43151234"
"chr7","34941319","34941430","chr13","14686139","14686251","23","20255180"
"chr7","34945982","34946270","chr5","78097423","78097707","13","43151441"
"chr7","34955457","34955749","chr6","7002055","7002344","79","27953402"
"chr7","34964316","34964596","chr5","78114223","78114503","3","43149907"
"chr7","34971109","34971391","chr5","78121164","78121444","5","43150055"
"chr7","34998999","34999274","chr5","78149408","78149686","8","43150409"
"chr7","35020111","35020404","chr5","78171271","78171564","4","43151160"
"chr7","35062649","35062807","chr5","78213339","78213514","20","43150690"
"chr7","35093194","35093467","chr5","78244192","78244464","5","43150998"
"chr7","35141276","35141577","chr5","78294632","78294933","6","43153356"
"chr7","35154081","35154331","chr5","78306612","78306862","5","43152531"
"chr7","35182191","35182466","chr1","64137879","64138152","54","28955688"
"chr7","35234007","35234310","chr5","78390691","78390995","11","43156684"
"chr7","35235063","35235354","chr5","78391747","78392047","14","43156684"
"chr7","35237947","35238254","chr5","78394420","78394732","12","43156473"
"chr7","35239881","35240174","chr5","78397100","78397392","17","43157219"
"chr7","35265126","35265427","chr5","78422499","78422800","8","43157373"
"chr7","35267181","35267484","chr5","78424562","78424872","22","43157381"
"chr7","35268534","35268650","chr5","78425939","78426055","2","43157405"
"chr7","35284555","35284851","chr18","28146197","28146497","59","7138358"
"chr7","35294224","35294520","chr18","28146197","28146497","59","7148027"
"chr7","35295200","35295366","chr1","11995803","11995968","30","23299397"
"chr7","35319715","35319888","chr3","45869996","45870172","32","10550281"
"chr7","35319898","35320197","chr7","25185886","25186189","65","10134012"
"chr7","35328668","35328956","chr5","78477827","78478115","15","43149159"
"chr7","35345824","35346109","chr5","78494708","78494996","9","43148884"
"chr7","35349139","35349441","chr5","78498023","78498325","5","43148884"
"chr7","35369690","35369965","chr5","78519007","78519301","23","43149317"
"chr7","35425796","35426061","chr5","78574317","78574577","12","43148521"
"chr7","35438631","35438769","chr5","78587456","78587592","5","43148825"
"chr7","35439072","35439223","chr5","78588030","78588181","3","43148958"
"chr7","35457525","35457665","chr5","78606636","78606776","3","43149111"
"chr7","35458748","35458919","chr5","78607861","78608032","4","43149113"
"chr7","35465685","35465986","chr5","78614755","78615051","15","43149070"
"chr7","35467011","35467309","chr5","78616003","78616301","3","43148992"
"chr7","35475217","35475508","chr5","78624484","78624775","6","43149267"
"chr7","35477110","35477419","chr5","78626369","78626679","14","43149259"
"chr7","35490977","35491279","chr5","78640244","78640530","27","43149267"
"chr7","35518403","35518671","chr5","78667802","78668071","3","43149399"
"chr7","35561365","35561657","chr5","78711293","78711582","16","43149928"
"chr7","35565222","35565292","chr5","78715502","78715573","4","43150280"
"chr7","35579348","35579546","chr5","78727750","78727948","2","43148402"
"chr7","35582131","35582409","chr5","78730534","78730815","8","43148403"
"chr7","35583611","35583920","chr5","78732022","78732328","14","43148411"
"chr7","35585813","35586051","chr5","78734228","78734466","8","43148415"
"chr7","35591932","35592132","chr5","78740754","78740951","5","43148822"
"chr7","35592163","35592283","chr5","78740990","78741107","6","43148827"
"chr7","35597553","35597844","chr5","78746394","78746720","46","43148841"
"chr7","35612451","35612729","chr6","72133044","72133322","52","36520593"
"chr7","35617522","35617800","chr5","78767290","78767569","15","43149768"
"chr7","35624598","35624868","chr5","78775189","78775472","19","43150591"
"chr7","35650135","35650439","chr5","78800615","78800935","27","43150480"
"chr7","35707231","35707518","chr5","78851453","78851740","4","43144222"
"chr7","35712700","35712795","chr5","78856649","78856740","7","43143949"
"chr7","35713099","35713195","chr5","78857048","78857137","8","43143949"
"chr7","35730417","35730715","chr5","78875507","78875813","16","43145090"
"chr7","35756799","35757100","chr1","48559638","48559943","46","12802839"
"chr7","35757422","35757709","chr5","78902357","78902634","15","43144935"
"chr7","35776106","35776209","chr5","78921300","78921402","1","43145194"
"chr7","35807166","35807466","chr5","78952272","78952564","14","43145106"
"chr7","35811897","35812302","chr2","98033846","98034226","115","62221949"
"chr7","35837061","35837146","chr5","97094538","97094621","16","61257477"
"chr7","35837620","35837907","chr5","78983157","78983441","6","43145537"
"chr7","35845632","35845927","chr5","78991487","78991784","8","43145855"
"chr7","35849709","35849995","chr5","78995564","78995849","6","43145855"
"chr7","35857786","35858088","chr5","79003650","79003955","11","43145864"
"chr7","35876641","35876954","chr5","79022828","79023149","19","43146187"
"chr7","35881078","35881338","chr5","79027829","79028089","6","43146751"
"chr7","35882600","35882904","chr5","79029348","79029646","15","43146748"
"chr7","35922008","35922318","chr5","79069607","79069933","18","43147599"
"chr7","35927539","35927828","chr5","79075189","79075458","26","43147650"
"chr7","35938371","35938491","chrX","41760475","41760598","19","5822104"
"chr7","35939712","35940006","chr5","79087343","79087637","6","43147631"
"chr7","35952000","35952306","chr5","79099582","79099889","19","43147582"
"chr7","36012716","36013024","chr5","79159592","79159894","14","43146876"
"chr7","36017268","36017539","chr5","33703173","33703447","58","2314095"
"chr7","36025824","36026017","chr13","84196586","84196782","55","48170762"
"chr7","36026114","36026184","chr8","33737537","33737608","13","2288577"
"chr7","36028993","36029271","chr5","79175721","79176003","19","43146728"
"chr7","36036406","36036576","chr3","125233005","125233176","35","89196599"
"chr7","36101365","36101654","chr5","79249258","79249547","2","43147893"
"chr7","36128306","36128451","chr5","79275816","79275970","10","43147510"
"chr7","36131524","36131808","chr5","79278970","79279256","9","43147446"
"chr7","36150677","36150973","chr5","79298555","79298851","6","43147878"
"chr7","36174183","36174471","chr5","79321438","79321727","4","43147255"
"chr7","36194188","36194436","chr5","79348887","79349134","7","43154699"
"chr7","36247171","36247472","chr5","79400760","79401053","18","43153589"
"chr7","36271130","36271354","chr5","79425902","79426125","6","43154772"
"chr7","36295351","36295470","chr5","79450969","79451088","5","43155618"
"chr7","36295500","36295677","chr5","79451122","79451299","1","43155622"
"chr7","36301312","36301604","chr10","26050260","26050565","59","10251052"
"chr7","36309464","36309767","chr5","79464910","79465205","12","43155446"
"chr7","36312558","36312664","chr14","50562208","50562314","15","14249650"
"chr7","36313291","36313564","chr5","79467932","79468205","7","43154641"
"chr7","36314671","36314951","chr5","79469309","79469589","13","43154638"
"chr7","36316296","36316570","chr5","79470922","79471196","6","43154626"
"chr7","36367791","36367981","chr5","79528281","79528471","5","43160490"
"chr7","36375357","36375647","chr5","79535846","79536136","4","43160489"
"chr7","36378884","36379199","chr4","152226280","152226592","65","115847396"
"chr7","36384967","36385281","chr5","79545864","79546177","13","43160897"
"chr7","36387594","36387770","chr5","79548477","79548649","8","43160883"
"chr7","36395669","36395975","chr5","79556552","79556860","10","43160883"
"chr7","36401570","36401878","chr5","79556552","79556860","5","43154982"
"chr7","36420918","36421204","chr5","79575970","79576256","2","43155052"
"chr7","36423697","36423933","chr9","54641286","54641526","52","18217589"
"chr7","36432552","36432841","chr5","79587434","79587724","12","43154882"
"chr7","36439837","36440118","chr5","79594706","79595012","45","43154869"
"chr7","36440584","36440870","chr5","79595485","79595769","10","43154901"
"chr7","36441941","36442253","chr9","96132475","96132771","61","59690534"
"chr7","36444643","36444775","chr5","79599433","79599566","6","43154790"
"chr7","36447742","36447817","chr5","79602532","79602607","3","43154790"
"chr7","36447818","36447868","chr5","79602608","79602654","4","43154790"
"chr7","36467603","36467736","chr5","79623160","79623305","17","43155557"
"chr7","36479917","36480214","chr5","79635723","79636018","11","43155806"
"chr7","36483805","36484082","chr5","79639624","79639937","38","43155819"
"chr7","36485610","36485781","chr9","31830662","31830825","34","4654948"
"chr7","36546515","36546799","chr13","82780946","82781233","64","46234431"
"chr7","36562289","36562574","chr5","79717275","79717556","12","43154986"
"chr7","36564729","36565029","chr5","79720014","79720314","8","43155285"
"chr7","36567229","36567383","chr5","79721787","79721939","8","43154558"
"chr7","36567692","36567813","chr5","79722250","79722362","9","43154558"
"chr7","36581017","36581137","chr12","80392778","80392901","18","43811761"
"chr7","36581358","36581557","chr16","45301217","45301409","45","8719859"
"chr7","36591170","36591471","chr5","79743612","79743910","12","43152442"
"chr7","36591506","36591672","chr5","79743945","79744111","1","43152439"
"chr7","36610497","36610596","chr5","79762942","79763047","8","43152445"
"chr7","36612325","36612523","chr5","79764760","79764951","19","43152435"
"chr7","36621347","36621644","chr5","79774068","79774358","15","43152721"
"chr7","36628599","36628901","chr5","79781692","79781994","7","43153093"
"chr7","36645451","36645493","chr7","160066261","160066300","6","123420810"
"chr7","36647896","36648175","chr5","79801281","79801560","0","43153385"
"chr7","36650727","36651038","chr5","79804123","79804430","14","43153396"
"chr7","36652053","36652357","chr5","79805444","79805742","21","43153391"
"chr7","36663413","36663684","chr5","79818080","79818350","4","43154667"
"chr7","36665174","36665484","chr5","79819842","79820153","8","43154668"
"chr7","36669886","36670040","chr5","79825410","79825578","20","43155524"
"chr7","36678234","36678531","chr5","79834058","79834357","11","43155824"
"chr7","36681635","36681750","chr11","115021011","115021136","26","78339376"
"chr7","36685057","36685374","chrX","15697361","15697669","65","20987696"
"chr7","36693522","36693786","chr5","79849035","79849302","9","43155513"
"chr7","36728263","36728565","chr16","22294372","22294673","55","14433891"
"chr7","36736681","36736980","chr5","79890978","79891283","13","43154297"
"chr7","36752545","36752863","chr5","79907447","79907757","15","43154902"
"chr7","36784932","36785211","chr5","79939981","79940268","10","43155049"
"chr7","36792350","36792415","chrX","61644528","61644594","13","24852178"
"chr7","36826724","36827004","chr5","79981772","79982098","50","43155048"
"chr7","36832866","36832997","chr5","79987982","79988120","10","43155116"
"chr7","36841551","36841839","chr5","79996571","79996859","6","43155020"
"chr7","36881047","36881347","chr5","80035938","80036246","16","43154891"
"chr7","36888101","36888401","chr5","80042945","80043247","7","43154844"
"chr7","36908039","36908182","chr5","80062504","80062647","7","43154465"
"chr7","36916754","36917018","chr5","80071224","80071492","7","43154470"
"chr7","36934711","36934828","chr5","80088847","80088964","2","43154136"
"chr7","37032401","37032695","chr5","80186056","80186347","8","43153655"
"chr7","37048529","37048847","chr5","80201746","80202039","38","43153217"
"chr7","37074056","37074154","chr5","80226599","80226687","11","43152543"
"chr7","37189331","37189635","chrX","27894759","27895057","60","9294572"
"chr7","37207979","37208192","chr5","80362010","80362192","40","43154031"
"chr7","37244383","37244690","chr5","80404698","80405005","11","43160315"
"chr7","37275055","37275338","chr5","80441290","80441573","4","43166235"
"chr7","37336231","37336520","chr5","80502044","80502333","14","43165813"
"chr7","37341315","37341614","chr2","172936939","172937233","57","135595624"
"chr7","37362167","37362472","chr5","80522072","80522379","8","43159905"
"chr7","37392372","37392659","chr5","80552288","80552575","7","43159916"
"chr7","37437665","37437957","chr5","80598685","80598977","8","43161020"
"chr7","37443218","37443507","chr5","80604222","80604516","15","43161004"
"chr7","37449976","37450279","chr5","80610969","80611271","4","43160993"
"chr7","37484228","37484530","chr5","80645481","80645783","6","43161253"
"chr7","37514384","37514597","chr5","80675575","80675783","15","43161191"
"chr7","37529466","37529614","chr5","80690584","80690759","29","43161118"
"chr7","37531241","37531540","chr5","80692380","80692685","12","43161139"
"chr7","37595043","37595339","chr5","80756281","80756577","8","43161238"
"chr7","37614480","37614567","chr5","80775575","80775662","3","43161095"
"chr7","37666320","37666634","chr5","80829549","80829863","12","43163229"
"chr7","37684923","37685192","chr5","80848485","80848756","11","43163562"
"chr7","37718707","37719018","chr5","80882774","80883084","16","43164067"
"chr7","37741876","37742063","chr5","80906589","80906776","4","43164713"
"chr7","37769155","37769461","chr5","80933836","80934144","6","43164681"
"chr7","37771002","37771314","chr5","80935692","80936004","10","43164690"
"chr7","37782014","37782320","chr5","80946955","80947242","25","43164941"
"chr7","37891779","37892019","chr5","81051417","81051657","6","43159638"
"chr7","37971263","37971556","chr5","81130160","81130453","7","43158897"
"chr7","37994482","37994543","chr2","59298363","59298422","15","21303881"
"chr7","37994544","37994697","chrX","50723789","50723935","32","12729245"
"chr7","38086769","38087058","chr5","81240811","81241100","5","43154042"
"chr7","38151444","38151747","chr5","81305361","81305670","16","43153917"
"chr7","38186434","38186499","chr1","139311239","139311302","12","101124805"
"chr7","38186713","38186942","chr1","38534403","38534630","51","347690"
"chr7","38189229","38189540","chr5","81342935","81343246","12","43153706"
"chr7","38203863","38204171","chr5","81357540","81357848","5","43153677"
"chr7","38281103","38281447","chr5","81435122","81435467","20","43154019"
"chr7","38334767","38335082","chr5","81488443","81488750","15","43153676"
"chr7","38346681","38346795","chr5","81500278","81500392","1","43153597"
"chr7","38411940","38412230","chr5","81564631","81564917","11","43152691"
"chr7","38416993","38417283","chr5","81570004","81570293","7","43153011"
"chr7","38455549","38455676","chr5","81608025","81608152","2","43152476"
"chr7","38564351","38564662","chr5","81715378","81715667","26","43151027"
"chr7","38571783","38572097","chr5","81722803","81723110","14","43151020"
"chr7","38589683","38589991","chr5","81741653","81741955","12","43151970"
"chr7","38625026","38625328","chr5","81777184","81777483","16","43152158"
"chr7","38732399","38732711","chr5","81871779","81872052","40","43139380"
"chr7","38838941","38839055","chrX","108180286","108180394","32","69341345"
"chr7","38856861","38856993","chr5","82003939","82004070","6","43147078"
"chr7","38880845","38881120","chr5","82028556","82028811","25","43147711"
"chr7","38883677","38884006","chr5","82031450","82031760","27","43147773"
"chr7","38885659","38885733","chr5","20339254","20339327","12","18546405"
"chr7","38885737","38885861","chr4","85142100","85142225","24","46256363"
"chr7","39092076","39092363","chr5","82239335","82239622","10","43147259"
"chr7","39107385","39107504","chr5","82254640","82254759","0","43147255"
"chr7","39114578","39114701","chr5","82261667","82261770","22","43147089"
"chr7","39122379","39122529","chr5","82271353","82271503","5","43148974"
"chr7","39256342","39256633","chr12","92960570","92960879","39","53704228"
"chr7","39302248","39302586","chr5","82457218","82457550","17","43154970"
"chr7","39610442","39610736","chr5","82760352","82760655","29","43149910"
"chr7","39672504","39672622","chr16","39367936","39368055","22","304568"
"chr7","39672658","39672842","chr15","43698564","43698741","42","4025906"
"chr7","39689364","39689664","chr5","82829289","82829589","8","43139925"
"chr7","39734866","39735168","chr5","82876030","82876338","13","43141164"
"chr7","39748463","39748743","chr5","82889641","82889921","7","43141178"
"chr7","39811880","39812183","chr5","82952053","82952352","19","43140173"
"chr7","39961232","39961555","chr15","20546718","20547038","72","19414514"
"chr7","40073671","40073931","chr5","83224515","83224798","35","43150844"
"chr7","40143465","40143761","chr5","83301606","83301902","7","43158141"
"chr7","40207724","40208006","chr5","83365480","83365759","10","43157756"
"chr7","40241015","40241298","chr17","14466996","14467289","57","25774019"
"chr7","40241490","40241800","chr5","83398285","83398585","21","43156795"
"chr7","40259969","40260141","chr7","38863024","38863194","43","1396945"
"chr7","40282214","40282491","chr5","83437675","83437970","30","43155461"
"chr7","40382111","40382450","chr5","83538511","83538850","6","43156400"
"chr7","40432735","40432887","chr5","83595147","83595304","11","43162412"
"chr7","40432934","40433051","chr5","83595335","83595452","4","43162401"
"chr7","40436956","40437247","chr1","34647970","34648266","56","5788986"
"chr7","40518543","40518813","chr5","83684833","83685114","16","43166290"
"chr7","40599681","40599946","chr5","83766217","83766479","12","43166536"
"chr7","40630310","40630629","chr5","83803104","83803423","5","43172794"
"chr7","40862034","40862328","chr5","84044679","84044979","18","43182645"
"chr7","40935174","40935443","chr5","84119457","84119728","7","43184283"
"chr7","40981678","40981972","chr5","84166217","84166513","11","43184539"
"chr7","40998324","40998603","chr2","44235641","44235925","66","3237317"
"chr7","41020890","41021200","chr5","84206534","84206834","16","43185644"
"chr7","41028973","41029258","chr5","84214638","84214920","9","43185665"
"chr7","41059288","41059560","chr5","84245240","84245516","20","43185952"
"chr7","41101464","41101780","chr5","84290448","84290762","22","43188984"
"chr7","41132221","41132519","chr5","84321943","84322252","23","43189722"
"chr7","41225291","41225580","chr5","84418203","84418501","24","43192912"
"chr7","41244079","41244169","chr5","84436720","84436811","5","43192641"
"chr7","41312275","41312594","chr1","134832684","134832997","64","93520409"
"chr7","41408106","41408391","chr5","84606409","84606689","22","43198303"
"chr7","41416173","41416440","chr5","84614443","84614709","11","43198270"
"chr7","41419576","41419842","chr5","84618709","84618975","6","43199133"
"chr7","41501249","41501564","chr5","84702413","84702745","30","43201164"
"chr7","41628749","41628763","chr3","51854696","51854709","2","10225947"
"chr7","41628991","41629276","chr5","84833149","84833430","13","43204158"
"chr7","41844528","41844683","chr6","126703644","126703786","51","84859116"
"chr7","41848254","41848393","chr1","75952215","75952351","36","34103961"
"chr7","41854612","41854748","JH682260","1991","2123","24","41852621"
"chr7","42267947","42268256","chr5","85485721","85486028","17","43217774"
"chr7","42314352","42314507","chr5","85531648","85531804","4","43217296"
"chr7","42366976","42367307","chr5","85584255","85584563","29","43217279"
"chr7","42401277","42401581","chr5","85619359","85619657","22","43218082"
"chr7","42425769","42426067","chr5","85644796","85645101","21","43219027"
"chr7","42439878","42440136","chr5","85658514","85658792","29","43218636"
"chr7","42465765","42465970","chr5","85684501","85684712","13","43218736"
"chr7","42466461","42466747","chr5","85685205","85685493","6","43218744"
"chr7","42494381","42494680","chr5","85713727","85714028","12","43219346"
"chr7","42501258","42501559","chr11","91893491","91893793","49","49392233"
"chr7","42531413","42531736","chr5","85751630","85751955","11","43220217"
"chr7","42534553","42534890","chr5","85754792","85755103","32","43220239"
"chr7","42543299","42543604","chr5","85763493","85763801","6","43220194"
"chr7","42624271","42624566","chr5","85846416","85846703","16","43222145"
"chr7","42627195","42627532","chr12","30018870","30019196","64","12608325"
"chr7","42642255","42642372","chr2","83766108","83766225","17","41123853"
"chr7","42652577","42652825","chr5","85860707","85860956","2","43208130"
"chr7","42682399","42682656","chr5","85890834","85891091","9","43208435"
"chr7","42716431","42716724","chr1","53238362","53238656","68","10521931"
"chr7","42729699","42730003","chr5","85941544","85941847","6","43211845"
"chr7","42748689","42748992","chr5","85961095","85961390","15","43212406"
"chr7","42838444","42838737","chr5","86052131","86052426","8","43213687"
"chr7","42867748","42868045","chr13","46319379","46319675","65","3451631"
"chr7","42949926","42950044","chr5","86161977","86162093","7","43212051"
"chr7","42951782","42952139","chr10","81284866","81285229","99","38333084"
"chr7","43032560","43032826","chr5","86243477","86243759","21","43210917"
"chr7","43109176","43109498","chr5","86319711","86320028","7","43210535"
"chr7","43121526","43121796","chr7","129604619","129604900","65","86483093"
"chr7","43222726","43223032","chr5","86435758","86436028","41","43213032"
"chr7","43325384","43325692","chr5","86538736","86539046","11","43213352"
"chr7","43379515","43379796","chr5","86592369","86592652","10","43212854"
"chr7","43380336","43380628","chrX","112311649","112311943","50","68931313"
"chr7","43495780","43496006","chr5","86710186","86710420","16","43214406"
"chr7","43507247","43507537","chr5","86721669","86721971","23","43214422"
"chr7","43535582","43535892","chr5","86750282","86750592","15","43214700"
"chr7","43601941","43602199","chr5","86818689","86818947","11","43216748"
"chr7","43622796","43623077","chr3","43685543","43685826","63","62747"
"chr7","43632381","43632652","chr5","86849071","86849342","7","43216690"
"chr7","43765816","43766116","chr5","86981220","86981524","19","43215404"
"chr7","43806611","43806891","chr5","87022529","87022809","9","43215918"
"chr7","43923852","43924129","chr11","47053323","47053602","63","3129471"
"chr7","44116139","44116446","chr5","87339522","87339826","21","43223383"
"chr7","44221370","44221664","chr5","87445147","87445440","11","43223777"
"chr7","44539912","44540228","chr5","87752700","87753039","33","43212788"
"chr7","44643791","44643908","chrX","108971246","108971363","13","64327455"
"chr7","44717529","44717821","chr5","87933877","87934169","5","43216348"
"chr7","44745303","44745576","chr5","87961602","87961874","10","43216299"
"chr7","44822194","44822484","chr5","88044049","88044339","7","43221855"
"chr7","44864192","44864476","chr1","9103427","9103709","62","35760765"
"chr7","45014205","45014370","chr5","88233842","88234010","8","43219637"
"chr7","45430746","45431040","chr5","88653304","88653591","17","43222558"
"chr7","45650211","45650370","chr5","88861992","88862151","4","43211781"
"chr7","45706692","45706983","chr5","88919549","88919844","14","43212857"
"chr7","46042574","46042745","chr5","89276414","89276584","9","43233840"
"chr7","46093232","46093515","chr5","89326218","89326481","30","43232986"
"chr7","46111779","46112063","chr5","89344667","89344951","11","43232888"
"chr7","46202243","46202356","chr5","89438278","89438388","16","43236035"
"chr7","46235264","46235568","chr4","151028880","151029183","50","104793616"
"chr7","46338826","46339144","chr5","89529415","89529703","41","43190589"
"chr7","46346064","46346363","chr5","89536408","89536707","11","43190344"
"chr7","46357516","46357797","chr5","89547847","89548125","10","43190331"
"chr7","46368412","46368715","chr5","89558764","89559061","15","43190352"
"chr7","46381760","46382046","chr5","89572028","89572315","7","43190268"
"chr7","46455573","46455726","chr5","89645659","89645812","1","43190086"
"chr7","46484106","46484425","chr5","89674550","89674870","10","43190444"
"chr7","46537032","46537306","chr5","89727148","89727426","8","43190116"
"chr7","46544338","46544525","chr1","11672372","11672556","38","34871966"
"chr7","46593213","46593376","chr5","89783427","89783606","19","43190214"
"chr7","46603533","46603577","chr1","54500597","54500644","12","7897064"
"chr7","46604019","46604107","chr7","33765401","33765487","12","12838618"
"chr7","46647699","46648004","chr2","81805772","81806074","54","35158073"
"chr7","46657206","46657283","chr5","89848028","89848106","3","43190822"
"chr7","46684204","46684510","chr5","89875339","89875626","27","43191135"
"chr7","46710012","46710139","chr5","89903242","89903370","3","43193230"
"chr7","46746087","46746290","chr16","52268985","52269191","46","5522898"
"chr7","46781972","46782272","chr5","89976441","89976731","13","43194469"
"chr7","46805681","46805987","chr5","90000365","90000667","15","43194684"
"chr7","46826333","46826630","chr5","90020978","90021275","8","43194645"
"chr7","46840669","46840953","chr5","90035812","90036100","14","43195143"
"chr7","46853316","46853599","chr5","90048147","90048452","27","43194831"
"chr7","46882402","46882731","chr5","90078360","90078688","4","43195958"
"chr7","46896120","46896423","chr7","44594472","44594770","61","2301648"
"chr7","46914022","46914091","chr5","90097810","90097879","1","43183788"
"chr7","46931708","46931992","chr5","90123993","90124277","14","43192285"
"chr7","46976571","46976876","chr5","90177531","90177855","30","43200960"
"chr7","46979503","46979803","chr5","34921116","34921416","61","12058387"
"chr7","46984332","46984651","chr5","90185269","90185588","8","43200937"
"chr7","46987174","46987295","chr15","99292134","99292258","25","52304960"
"chr7","46989251","46989452","chr5","90192856","90193057","2","43203605"
"chr7","46990400","46990551","chr4","41970846","41970998","42","5019554"
"chr7","47006767","47007058","chr4","16194055","16194352","59","30812712"
"chr7","47008509","47008791","chr5","90209412","90209709","22","43200903"
"chr7","47019459","47019714","chr5","90222086","90222341","6","43202627"
"chr7","47037722","47038014","chr5","90240289","90240581","8","43202567"
"chr7","47045174","47045465","chr5","90247761","90248048","8","43202587"
"chr7","47068390","47068522","chr17","83975209","83975341","28","36906819"
"chr7","47068728","47068837","chr13","35873426","35873534","15","11195302"
"chr7","47069557","47069711","chr5","90272014","90272179","14","43202457"
"chr7","47070052","47070168","chr11","118878074","118878190","20","71808022"
"chr7","47073955","47074263","chr5","90277238","90277535","27","43203283"
"chr7","47078978","47079107","chr4","101465976","101466105","25","54386998"
"chr7","47092588","47092875","chr5","90293205","90293493","6","43200617"
"chr7","47101517","47101825","chr5","90303438","90303749","22","43201921"
"chr7","47104802","47104950","chr10","2464482","2464626","23","44640320"
"chr7","47113294","47113637","chr5","90315541","90315872","22","43202247"
"chr7","47119021","47119290","chr5","90321254","90321541","46","43202233"
"chr7","47125124","47125376","chr1","95315628","95315886","59","48190504"
"chr7","47152251","47152556","chr5","90354650","90354948","13","43202399"
"chr7","47164247","47164548","chr5","90366618","90366919","5","43202371"
"chr7","47168658","47168958","chr5","90371049","90371345","6","43202391"
"chr7","47171161","47171431","chr5","90373547","90373832","19","43202386"
"chr7","47187632","47187917","chr5","90389462","90389757","17","43201830"
"chr7","47201946","47202230","chr5","90403639","90403925","10","43201693"
"chr7","47278427","47278711","chr5","90485159","90485442","8","43206732"
"chr7","47310050","47310342","chr5","90521000","90521304","21","43210950"
"chr7","47339222","47339513","chr5","90550562","90550853","5","43211340"
"chr7","47351173","47351465","chr5","90561799","90562101","16","43210626"
"chr7","47398159","47398438","chr5","90603284","90603558","8","43205125"
"chr7","47463237","47463534","chr5","90666457","90666753","13","43203220"
"chr7","47469153","47469321","chr5","90702274","90702437","10","43233121"
"chr7","47501919","47502102","chr5","90718174","90718360","8","43216255"
"chr7","47509792","47510085","chr5","90695689","90695984","12","43185897"
"chr7","47692669","47692962","chr5","90914003","90914296","2","43221334"
"chr7","47721803","47722107","chr5","90942700","90943001","10","43220897"
"chr7","47756907","47757195","chr5","90978228","90978515","14","43221321"
"chr7","47888053","47888320","chr5","91098874","91099157","32","43210821"
"chr7","47901135","47901432","chr5","91112196","91112493","3","43211061"
"chr7","47938559","47938855","chr10","83020392","83020689","56","35081833"
"chr7","47985069","47985350","chr5","91195045","91195326","8","43209976"
"chr7","47990430","47990715","chr1","146805879","146806164","66","98815449"
"chr7","48047282","48047569","chr5","91257778","91258065","2","43210496"
"chr7","48069288","48069573","chr5","91279413","91279698","3","43210125"
"chr7","48084660","48084923","chr5","91294813","91295071","9","43210153"
"chr7","48102269","48102560","chr5","91312350","91312681","47","43210081"
"chr7","48180053","48180291","chr5","91391408","91391648","9","43211355"
"chr7","48188052","48188351","chr5","91396738","91397016","39","43208686"
"chr7","48204234","48204551","chr5","91417172","91417495","10","43212938"
"chr7","48232438","48232522","chr5","91447059","91447137","8","43214621"
"chr7","48240551","48240621","chr1","202762251","202762322","16","154521700"
"chr7","48308567","48308870","chr5","91526589","91526899","16","43218022"
"chr7","48395174","48395473","chr5","91611883","91612183","9","43216709"
"chr7","48578567","48578882","chr5","91797444","91797755","12","43218877"
"chr7","48663663","48664008","chr5","91885017","91885339","36","43221354"
"chr7","48691160","48691458","chr5","91915952","91916260","29","43224792"
"chr7","48736273","48736568","chr15","39926277","39926571","53","8809996"
"chr7","48816356","48816470","chr6","51203095","51203207","30","2386739"
"chr7","48832260","48832455","chr5","92052351","92052546","4","43220091"
"chr7","48833000","48833063","chr5","92053096","92053151","9","43220096"
"chr7","49099507","49099819","chr5","92317280","92317589","6","43217773"
"chr7","49109478","49109776","chr5","92327272","92327570","9","43217794"
"chr7","49113122","49113461","chr5","92330904","92331239","14","43217782"
"chr7","49173688","49173781","chr5","92391477","92391570","3","43217789"
"chr7","49186059","49186310","chr13","36440880","36441137","60","12745179"
"chr7","49232617","49232955","chr4","35396380","35396711","92","13836237"
"chr7","49249781","49249907","chr5","92468411","92468537","9","43218630"
"chr7","49328964","49329299","chr20","57414591","57414927","80","8085627"
"chr7","49343846","49344167","chr8","75547570","75547888","77","26203724"
"chr7","49357821","49357914","chr1","190655363","190655447","20","141297542"
"chr7","49438843","49439128","chr5","92659541","92659826","3","43220698"
"chr7","49493892","49494160","chr5","92715190","92715467","13","43221298"
"chr7","49500001","49500133","chr3","51746310","51746440","37","2246309"
"chr7","49510937","49511248","chr5","92731895","92732204","6","43220958"
"chr7","49536853","49536984","chr5","92758049","92758179","1","43221196"
"chr7","49537289","49537432","chr5","92758482","92758650","30","43221193"
"chr7","49612675","49612943","chr14","31877808","31878083","74","17734867"
"chr7","49636270","49636424","chr5","92849074","92849228","2","43212804"
"chr7","49636790","49636882","chr5","92849923","92850016","3","43213133"
"chr7","49652035","49652336","chr5","92867201","92867504","15","43215166"
"chr7","49692316","49692613","chr5","92907315","92907617","19","43214999"
"chr7","49761330","49761425","chr5","92972267","92972360","10","43210937"
"chr7","49767911","49768094","chr5","92978812","92978989","14","43210901"
"chr7","49775644","49775929","chr5","92986539","92986825","16","43210895"
"chr7","49809822","49809939","chr5","93020863","93020986","8","43211041"
"chr7","49942112","49942418","chr5","93161515","93161809","22","43219403"
"chr7","50106567","50106673","chr11","117593949","117594046","36","67487382"
"chr7","50187408","50187686","chr5","93411303","93411579","10","43223895"
"chr7","50291117","50291352","chr5","93526231","93526466","3","43235114"
"chr7","50432805","50433079","chr2","77592884","77593158","65","27160079"
"chr7","50505568","50505858","chr5","93739749","93740037","10","43234181"
"chr7","50530938","50531225","chr5","93765058","93765345","9","43234120"
"chr7","50547344","50547667","chr5","93781498","93781822","12","43234154"
"chr7","50558690","50559005","chr11","50330487","50330804","62","228203"
"chr7","50565295","50565590","chr5","93800431","93800737","21","43235136"
"chr7","50732605","50732902","chr5","93970432","93970729","4","43237827"
"chr7","50750579","50750879","chr5","93988287","93988579","21","43237708"
"chr7","50797225","50797524","chr1","153825881","153826185","63","103028656"
"chr7","50811474","50811768","chr5","94052180","94052477","16","43240706"
"chr7","50817710","50817916","chr5","94057088","94057346","60","43239378"
"chr7","50817927","50818131","chr5","94057088","94057346","57","43239161"
"chr7","50820697","50820993","chr5","94061243","94061542","16","43240546"
"chr7","50849946","50850217","chr6","107570307","107570578","60","56720361"
"chr7","50857548","50857829","chr5","94097853","94098133","10","43240305"
"chr7","50868791","50869100","chr11","60702366","60702662","62","9833575"
"chr7","50878687","50878994","chr5","94118944","94119250","3","43240257"
"chr7","50884584","50884863","chr5","94124890","94125169","3","43240306"
"chr7","50885923","50886230","chr5","94126237","94126544","15","43240314"
"chr7","50890628","50890856","chr5","94131267","94131497","8","43240639"
"chr7","50930129","50930407","chr3","590074","590351","52","50340055"
"chr7","50932342","50932649","chr5","94169977","94170284","7","43237635"
"chr7","50934364","50934662","chr5","94171722","94172020","3","43237358"
"chr7","50934679","50934861","chr5","94172038","94172220","5","43237359"
"chr7","50937444","50937573","chr5","94174818","94174947","5","43237374"
"chr7","50937878","50938036","chr5","94175556","94175714","2","43237678"
"chr7","50939204","50939509","chr5","94176842","94177149","9","43237638"
"chr7","50948692","50948992","chr5","94186305","94186600","11","43237613"
"chr7","50972405","50972704","chr5","94210389","94210688","3","43237984"
"chr7","50990703","50990976","chr5","94228816","94229093","12","43238113"
"chr7","50994732","50995014","chr5","94232953","94233225","13","43238221"
"chr7","51014523","51014827","chr5","94252964","94253259","17","43238441"
"chr7","51015032","51015167","chr5","94253464","94253599","2","43238432"
"chr7","51015480","51015660","chr5","94253899","94254078","10","43238419"
"chr7","51029251","51029524","chr5","94267650","94267922","11","43238399"
"chr7","51076426","51076735","chr5","94322004","94322313","5","43245578"
"chr7","51077488","51077788","chr5","94323071","94323374","14","43245583"
"chr7","51086453","51086733","chr5","94331947","94332253","33","43245494"
"chr7","51087225","51087324","chr7","34731918","34732010","24","16355307"
"chr7","51110779","51111026","chr5","94358521","94358785","21","43247742"
"chr7","51126235","51126522","chr5","94374064","94374345","16","43247829"
"chr7","51160248","51160541","chr5","94408667","94408956","7","43248419"
"chr7","51161338","51161646","chr5","94409752","94410064","8","43248414"
"chr7","51184350","51184449","chr15","101521086","101521192","22","50336736"
"chr7","51184451","51184540","chr20","23186974","23187061","21","27997477"
"chr7","51261473","51261769","chr5","94517597","94517890","15","43256124"
"chr7","51268719","51269004","chr5","94524667","94524945","26","43255948"
"chr7","51370672","51370744","chr18","38839209","38839283","16","12531463"
"chr7","51383624","51383932","chr5","94660293","94660601","10","43276669"
"chr7","51403643","51403947","chr5","94678102","94678404","13","43274459"
"chr7","51442610","51442918","chr5","94716695","94717000","8","43274085"
"chr7","51520232","51520516","chr5","94793711","94793992","17","43273479"
"chr7","52036879","52037101","chr5","95315010","95315249","24","43278131"
"chr7","52083477","52083638","chr3","2720911","2721071","32","49362566"
"chr7","52167976","52168281","chr5","95452155","95452460","5","43284179"
"chr7","52185484","52185789","chr5","95471355","95471649","47","43285871"
"chr7","52415332","52415604","chr5","95603736","95604008","4","43188404"
"chr7","52500388","52500700","chr5","95690077","95690377","17","43189689"
"chr7","52711197","52711493","chr5","95903560","95903858","14","43192363"
"chr7","52932472","52932777","chr5","96148102","96148396","21","43215630"
"chr7","53039433","53039537","chr5","96253264","96253368","0","43213831"
"chr7","53102055","53102347","chr5","96317431","96317723","6","43215376"
"chr7","53102863","53102983","chr5","96318212","96318337","9","43215349"
"chr7","53139163","53139278","chr5","96360141","96360256","2","43220978"
"chr7","53143372","53143675","chr5","96364357","96364655","10","43220985"
"chr7","53143686","53143855","chr5","96364766","96364967","36","43221080"
"chr7","53201805","53202110","chr5","96423236","96423545","11","43221431"
"chr7","53233664","53233966","chr5","96454548","96454854","9","43220884"
"chr7","53249675","53249971","chr5","96470689","96470986","3","43221014"
"chr7","53262270","53262539","chr5","96483223","96483478","19","43220953"
"chr7","53366810","53367048","chr5","96586255","96586494","5","43219445"
"chr7","53376357","53376660","chr5","96595001","96595304","5","43218644"
"chr7","53396129","53396420","chr5","96615441","96615741","20","43219312"
"chr7","53445662","53445969","chr3","150225070","150225356","88","96779408"
"chr7","53512375","53512483","chr5","96729737","96729845","2","43217362"
"chr7","53517984","53518292","chr5","96734801","96735108","6","43216817"
"chr7","53537993","53538306","chr5","96755660","96755970","14","43217667"
"chr7","53554225","53554522","chr5","96772151","96772441","20","43217926"
"chr7","53568412","53568702","chr5","96786745","96787030","9","43218333"
"chr7","53690166","53690453","chr5","96899531","96899815","39","43209365"
"chr7","53702332","53702572","chr5","96911664","96911904","7","43209332"
"chr7","53710458","53710742","chr5","96919854","96920138","11","43209396"
"chr7","53736990","53737271","chr5","96946827","96947108","11","43209837"
"chr7","53740127","53740425","chr5","96949945","96950243","7","43209818"
"chr7","53791679","53791797","chr18","42840691","42840807","16","10950988"
"chr7","53791835","53791885","chr12","81503250","81503301","15","27711415"
"chr7","53791886","53791927","chr4","103779745","103779791","10","49987859"
"chr7","53881393","53881605","chr3","128458391","128458597","57","74576998"
"chr7","53884810","53885090","chr5","97097926","97098207","4","43213116"
"chr7","53933367","53933663","chr5","97146371","97146667","6","43213004"
"chr7","53974090","53974249","chr5","97186973","97187133","11","43212883"
"chr7","53977858","53978098","chr5","97190876","97191115","8","43213018"
"chr7","54016309","54016594","chr5","97222120","97222407","21","43205811"
"chr7","54212147","54212251","chr16","17831825","17831919","35","36380322"
"chr7","54220904","54221190","chr5","97422867","97423153","9","43201963"
"chr7","54239505","54239747","chr5","97443496","97443757","29","43203991"
"chr7","54284254","54284544","chr5","97490072","97490360","5","43205818"
"chr7","54318387","54318701","chr5","97524819","97525133","5","43206432"
"chr7","54431446","54431746","chr5","97644096","97644436","47","43212650"
"chr7","54528186","54528461","chr5","97743194","97743469","4","43215008"
"chr7","54570028","54570321","chr1","44701621","44701907","70","9868407"
"chr7","54770046","54770353","chr5","98007080","98007420","45","43237034"
"chr7","54868379","54868473","chr7","111427739","111427830","20","56559360"
"chr7","55030858","55030973","chr5","98261118","98261224","12","43230260"
"chr7","55171449","55171745","chr15","8334434","8334720","68","46837015"
"chr7","55226481","55226691","chr5","98466968","98467175","10","43240487"
"chr7","55279511","55279808","chr5","98524208","98524505","10","43244697"
"chr7","55297345","55297446","chr5","98544753","98544854","2","43247408"
"chr7","55340394","55340708","chr5","98582209","98582523","9","43241815"
"chr7","55387583","55387798","chr5","98634195","98634409","12","43246612"
"chr7","55387832","55387849","chr19","16426252","16426270","3","38961580"
"chr7","55396906","55397198","chr5","98643502","98643808","30","43246596"
"chr7","55568653","55568936","chr5","98806029","98806312","2","43237376"
"chr7","55697108","55697401","chr5","98934039","98934337","10","43236931"
"chr7","55742115","55742436","chr5","98979369","98979691","6","43237254"
"chr7","55747333","55747622","chr5","98984617","98984905","8","43237284"
"chr7","55761155","55761450","chr5","98998393","98998688","5","43237238"
"chr7","55813691","55813974","chr5","99051062","99051343","11","43237371"
"chr7","55847448","55847745","chr5","99084736","99085034","13","43237288"
"chr7","55868116","55868478","chr5","99110066","99110378","58","43241950"
"chr7","55882428","55882583","chr5","99124299","99124454","2","43241871"
"chr7","55894167","55894390","chr5","99135299","99135522","8","43241132"
"chr7","55899316","55899620","chr5","99141994","99142294","11","43242678"
"chr7","55909039","55909359","chr5","99151570","99151893","15","43242531"
"chr7","55950127","55950406","chr5","99192944","99193231","16","43242817"
"chr7","55955453","55955719","chr5","99198268","99198530","13","43242815"
"chr7","56005000","56005112","chrX","16554994","16555104","22","39450006"
"chr7","56043800","56044094","chr5","99288604","99288903","17","43244804"
"chr7","56060458","56060732","chr5","99305258","99305530","14","43244800"
"chr7","56113448","56113699","chr5","99358211","99358462","2","43244763"
"chr7","56129177","56129225","chr5","99373836","99373884","0","43244659"
"chr7","56129520","56129649","chr5","99374178","99374307","3","43244658"
"chr7","56157075","56157366","chr5","99401616","99401907","5","43244541"
"chr7","56174907","56175198","chr5","99417196","99417486","10","43242289"
"chr7","56183531","56183812","chr5","99425539","99425820","11","43242008"
"chr7","56223044","56223335","chr5","99457156","99457442","15","43234112"
"chr7","56231144","56231464","chr5","99464992","99465317","10","43233848"
"chr7","56235242","56235332","chr1","24072214","24072303","14","32163028"
"chr7","56293227","56293529","chr5","99527037","99527338","8","43233810"
"chr7","56302602","56302896","chr5","99536766","99537059","5","43234164"
"chr7","56330629","56330788","chr5","99564541","99564700","5","43233912"
"chr7","56356841","56357142","chr5","99590585","99590886","5","43233744"
"chr7","56375378","56375650","chr5","99609307","99609573","12","43233929"
"chr7","56385332","56385575","chr5","99619263","99619509","12","43233931"
"chr7","56386668","56386962","chr5","99620603","99620884","15","43233935"
"chr7","56394348","56394630","chr5","99627948","99628243","21","43233600"
"chr7","56471519","56471820","chr5","99705934","99706240","14","43234415"
"chr7","56512413","56512674","chr5","99749476","99749771","39","43237063"
"chr7","56535344","56535641","chr5","99773342","99773638","14","43237998"
"chr7","56554728","56554994","chr5","99791274","99791539","7","43236546"
"chr7","56570849","56571144","chr5","99807059","99807353","11","43236210"
"chr7","56580952","56581249","chr5","99815966","99816263","8","43235014"
"chr7","56581254","56581448","chr5","99816268","99816462","6","43235014"
"chr7","56602399","56602588","chr5","99838070","99838265","11","43235671"
"chr7","56669945","56670198","chr5","99897714","99897967","9","43227769"
"chr7","56673383","56673626","chr5","99901172","99901427","16","43227789"
"chr7","56685922","56686108","chr5","99913918","99914104","4","43227996"
"chr7","56692714","56692992","chr5","99921040","99921318","2","43228326"
"chr7","56698248","56698557","chr5","99930971","99931280","8","43232723"
"chr7","56701639","56701897","chr5","99934387","99934642","6","43232748"
"chr7","56728260","56728570","chr5","99961365","99961673","9","43233105"
"chr7","56750739","56750862","chr8","28088438","28088561","20","28662301"
"chr7","56764412","56764708","chr5","99997551","99997861","23","43233139"
"chr7","56765613","56765893","chr5","99998645","99998925","6","43233032"
"chr7","56789303","56789628","chr3","169390027","169390363","60","112600724"
"chr7","56794184","56794484","chr5","100027019","100027319","12","43232835"
"chr7","56853910","56854200","chr5","100085828","100086088","34","43231918"
"chr7","56892357","56892680","chr15","22381822","22382142","62","34510535"
"chr7","56935791","56936015","chr5","100167117","100167341","6","43231326"
"chr7","56951724","56951977","chr5","100183139","100183396","14","43231415"
"chr7","57016112","57016310","chr14","29031872","29032069","53","27984240"
"chr7","57025505","57025775","chr5","100254561","100254831","5","43229056"
"chr7","57039404","57039706","chr5","100270165","100270467","6","43230761"
"chr7","57089786","57090084","chr5","100318932","100319228","7","43229146"
"chr7","57196943","57197232","chr5","100427269","100427564","11","43230326"
"chr7","57298511","57298811","chr10","47522289","47522583","66","9776222"
"chr7","57356294","57356574","chr5","100594798","100595091","21","43238504"
"chr7","57370792","57371079","chr5","100609234","100609521","8","43238442"
"chr7","57377969","57378131","chr4","119074513","119074677","29","61696544"
"chr7","57378181","57378292","chr8","16939496","16939614","21","40438685"
"chr7","57388560","57388769","chr5","100631409","100631630","17","43242849"
"chr7","57393004","57393080","chr5","100636168","100636244","1","43243164"
"chr7","57395139","57395400","chr5","100638299","100638560","9","43243160"
"chr7","57406077","57406378","chr5","100649673","100649937","62","43243596"
"chr7","57430781","57431097","chr5","100674351","100674667","9","43243570"
"chr7","57438321","57438439","chr5","100681882","100682000","1","43243561"
"chr7","57441537","57441841","chr5","100685112","100685410","12","43243575"
"chr7","57453631","57453932","chr5","100696109","100696410","4","43242478"
"chr7","57457959","57458113","chr4","161707226","161707368","36","104249267"
"chr7","57461319","57461494","chr5","100704869","100705037","11","43243550"
"chr7","57461849","57461998","chr11","51430119","51430268","32","6031730"
"chr7","57486012","57486362","chr6","68085166","68085499","72","10599154"
"chr7","57522297","57522615","chr5","100767079","100767393","9","43244782"
"chr7","57558413","57558528","chr5","100803791","100803907","3","43245378"
"chr7","57563280","57563583","chr5","100808650","100808953","5","43245370"
"chr7","57633780","57634064","chr5","100879021","100879305","6","43245241"
"chr7","57644626","57644930","chr5","100889925","100890235","10","43245299"
"chr7","57822584","57822862","chr5","101069691","101069969","5","43247107"
"chr7","57859880","57860174","chr5","101106614","101106908","9","43246734"
"chr7","57860666","57860709","chr7","41004195","41004238","7","16856471"
"chr7","57860735","57860903","chr5","101107470","101107638","2","43246735"
"chr7","57861235","57861301","chr5","101107970","101108036","2","43246735"
"chr7","57876947","57877240","chr5","101123831","101124132","13","43246884"
"chr7","57882010","57882194","chr18","13348248","13348428","39","44533762"
"chr7","57887776","57888024","chr5","101134717","101134964","4","43246941"
"chr7","57901444","57901596","chr5","101147947","101148099","6","43246503"
"chr7","57904139","57904434","chr5","101150645","101150936","5","43246506"
"chr7","57909848","57910113","chr5","101156341","101156627","25","43246493"
"chr7","57910140","57910157","chr3","33889121","33889139","2","24021019"
"chr7","57938008","57938333","chr5","101184656","101184970","17","43246648"
"chr7","57965885","57966149","chr5","101212114","101212393","26","43246229"
"chr7","57979054","57979239","chr5","101225347","101225532","1","43246293"
"chr7","57995057","57995262","chr5","101241341","101241550","7","43246284"
"chr7","57995814","57996035","chr5","101242110","101242332","4","43246296"
"chr7","58006318","58006627","chr5","101252624","101252931","13","43246306"
"chr7","58011481","58011740","chr5","101258118","101258377","7","43246637"
"chr7","58013918","58014214","chr5","101261264","101261560","5","43247346"
"chr7","58017856","58018141","chr5","101265218","101265506","13","43247362"
"chr7","58041475","58041657","chr5","101291322","101291504","3","43249847"
"chr7","58042671","58042963","chr5","101292543","101292835","3","43249872"
"chr7","58048245","58048430","chr5","101298167","101298352","4","43249922"
"chr7","58059178","58059458","chr5","101309622","101309913","23","43250444"
"chr7","58059573","58059754","chr5","101309998","101310180","6","43250425"
"chr7","58063704","58063945","chr5","101314123","101314375","12","43250419"
"chr7","58076014","58076315","chr5","101326350","101326651","6","43250336"
"chr7","58078931","58079183","chr5","101329267","101329512","18","43250336"
"chr7","58098984","58099285","chr5","101349849","101350147","10","43250865"
"chr7","58107625","58107749","chr5","101358447","101358572","3","43250822"
"chr7","58107780","58107823","chr4","77979569","77979605","14","19871789"
"chr7","58107824","58107882","chr1","38920498","38920555","14","19187326"
"chr7","58115645","58115875","chr5","101366787","101367014","6","43251142"
"chr7","58116350","58116637","chr5","101367489","101367776","3","43251139"
"chr7","58123001","58123111","chr5","101374141","101374251","1","43251140"
"chr7","58123869","58123936","chr5","101375058","101375125","3","43251189"
"chr7","58128183","58128469","chr5","101379374","101379660","8","43251191"
"chr7","58135690","58135996","chr5","101387124","101387424","19","43251434"
"chr7","58138247","58138503","chr5","101389675","101389929","13","43251428"
"chr7","58138907","58139200","chr5","101390333","101390637","19","43251426"
"chr7","58140436","58140738","chr5","101391854","101392146","20","43251418"
"chr7","58140739","58140880","chr5","101392148","101392288","4","43251409"
"chr7","58143665","58143924","chr3","39170785","39171040","63","18972880"
"chr7","58149380","58149671","chr5","101400623","101400911","8","43251243"
"chr7","58209969","58210225","chr5","101462775","101463028","13","43252806"
"chr7","58240093","58240418","chr2","88707323","88707620","85","30467230"
"chr7","58240851","58241166","chr5","101496474","101496772","22","43255623"
"chr7","58241983","58242248","chr5","101497608","101497871","8","43255625"
"chr7","58243977","58244142","chr5","101499597","101499762","3","43255620"
"chr7","58248600","58248666","chr5","101504220","101504286","2","43255620"
"chr7","58256598","58256751","chr19","4019639","4019788","48","54236959"
"chr7","58267560","58267870","chr5","101523001","101523302","20","43255441"
"chr7","58321112","58321184","chr1","171246159","171246235","12","112925047"
"chr7","58323013","58323307","chr5","101581235","101581524","16","43258222"
"chr7","58344879","58344991","chr5","101605538","101605646","6","43260659"
"chr7","58396313","58396564","chr5","101656489","101656740","2","43260176"
"chr7","58444088","58444385","chr5","101704750","101705046","18","43260662"
"chr7","58468569","58468716","chr5","101729587","101729734","6","43261018"
"chr7","58485512","58485816","chr5","101746542","101746846","6","43261030"
"chr7","58486753","58487035","chr5","101747779","101748067","11","43261026"
"chr7","58595574","58595877","chr5","101863095","101863398","4","43267521"
"chr7","58618431","58618728","chr5","101890791","101891086","10","43272360"
"chr7","58730830","58731115","chr1","43537388","43537672","57","15193442"
"chr7","58874248","58874538","chr5","102142462","102142741","15","43268214"
"chr7","58882784","58883058","chr20","53384735","53385017","60","5498049"
"chr7","58952852","58953143","chr16","41671981","41672272","50","17280871"
"chr7","59028447","59028750","chr5","101842198","101842501","7","42813751"
"chr7","59041767","59041937","chr9","88967166","88967333","32","29925399"
"chr7","59041966","59042056","chr3","9505959","9506052","20","49536007"
"chr7","59089585","59089869","chr5","102352122","102352370","42","43262537"
"chr7","59146832","59147116","chr5","102419340","102419624","5","43272508"
"chr7","59160462","59160802","chr9","28766766","28767100","98","30393696"
"chr7","59281594","59281885","chr5","102561812","102562104","7","43280218"
"chr7","59334530","59334825","chr5","102625056","102625369","25","43290526"
"chr7","59368643","59368758","chr5","102661473","102661588","2","43292830"
"chr7","59532087","59532404","chr5","102826203","102826511","16","43294116"
"chr7","59542546","59542816","chr5","102836958","102837228","1","43294412"
"chr7","59543281","59543532","chr5","102837693","102837944","3","43294412"
"chr7","59640806","59640949","chr5","102936065","102936208","2","43295259"
"chr7","59640999","59641117","chr5","102936258","102936379","11","43295259"
"chr7","59689473","59689740","chr5","46451590","46451863","70","13237883"
"chr7","59693855","59694156","chr5","102988471","102988777","11","43294616"
"chr7","59812932","59813233","chr5","103107149","103107450","5","43294217"
"chr7","59814946","59815110","chr11","119630615","119630778","35","59815669"
"chr7","59894246","59894545","chr13","26623158","26623457","44","33271088"
"chr7","59911472","59911768","chr5","103200242","103200540","13","43288770"
"chr7","59934491","59934800","chr5","103222520","103222829","7","43288029"
"chr7","59943129","59943410","chr5","103231137","103231418","5","43288008"
"chr7","59950623","59950871","chr20","23179434","23179682","56","36771189"
"chr7","59953340","59953573","chr5","103241316","103241551","9","43287976"
"chr7","59975554","59975838","chr5","103268336","103268620","3","43292782"
"chr7","60010741","60011033","chr5","103302131","103302423","8","43291390"
"chr7","60019898","60020119","chr5","103310420","103310641","8","43290522"
"chr7","60025669","60025960","chr5","103316120","103316411","1","43290451"
"chr7","60035222","60035534","chr4","148799971","148800282","59","88764749"
"chr7","60060064","60060353","chr5","103348765","103349042","16","43288701"
"chr7","60060573","60060857","chr5","103349272","103349558","6","43288699"
"chr7","60091134","60091397","chr5","103379953","103380218","14","43288819"
"chr7","60094221","60094551","chr5","103383034","103383348","31","43288813"
"chr7","60101285","60101409","chr5","103390385","103390494","19","43289100"
"chr7","60146043","60146358","chr5","103436455","103436768","3","43290412"
"chr7","60182883","60183181","chr5","103475889","103476188","7","43293006"
"chr7","60203877","60204178","chr5","103496677","103496978","5","43292800"
"chr7","60221735","60222051","chr5","103513870","103514188","18","43292135"
"chr7","60267985","60268248","chr4","134030031","134030284","59","73762046"
"chr7","60310237","60310525","chr5","103597622","103597910","4","43287385"
"chr7","60310761","60310868","chrX","60141892","60141996","27","168869"
"chr7","60316110","60316268","chr14","63608556","63608715","27","3292446"
"chr7","60331758","60332050","chr16","42502731","42503023","53","17829027"
"chr7","60341937","60342207","chr5","103628904","103629210","40","43286967"
"chr7","60358661","60358981","chr5","103645100","103645425","15","43286439"
"chr7","60362752","60362895","chr5","103649697","103649839","4","43286945"
"chr7","60363193","60363354","chr5","103650142","103650309","11","43286949"
"chr7","60371183","60371294","chr5","103657355","103657469","6","43286172"
"chr7","60371614","60371785","chr5","103657788","103657959","3","43286174"
"chr7","60377529","60377813","chr5","103664332","103664616","3","43286803"
"chr7","60379724","60380012","chr5","103666473","103666761","7","43286749"
"chr7","60398965","60399241","chr5","103685633","103685925","17","43286668"
"chr7","60417728","60418040","chr1","53532509","53532801","98","6885219"
"chr7","60440925","60441190","chr5","103733262","103733521","12","43292337"
"chr7","60444086","60444351","chr5","103733262","103733521","13","43289176"
"chr7","60446467","60446776","chr7","25185886","25186189","54","35260581"
"chr7","60454879","60455154","chr5","103746030","103746305","13","43291151"
"chr7","60461398","60461465","chr3","10761706","10761770","14","49699692"
"chr7","60461765","60462009","chr19","45066162","45066404","52","15395603"
"chr7","60463522","60463720","chr5","103755671","103755870","6","43292149"
"chr7","60467479","60467499","chrX","68595783","68595799","8","8128304"
"chr7","60470896","60471091","chr5","103763913","103764108","6","43293017"
"chr7","60472644","60472931","chr5","103766059","103766366","25","43293415"
"chr7","60478644","60478779","chr5","103772096","103772223","18","43293452"
"chr7","60479400","60479526","chr6","144630022","144630156","22","84150622"
"chr7","60483957","60484265","chr5","103776108","103776419","9","43292151"
"chr7","60492727","60492844","chr5","103784948","103785065","0","43292221"
"chr7","60493069","60493292","chr5","103785612","103785835","7","43292543"
"chr7","60500004","60500139","chr6","38143328","38143467","20","22356676"
"chr7","60516072","60516347","chr11","85208684","85208961","57","24692612"
"chr7","60523206","60523449","chr5","103816499","103816742","5","43293293"
"chr7","60526623","60526810","chr5","103821470","103821690","38","43294847"
"chr7","60536439","60536497","chr2","57418053","57418114","15","3118386"
"chr7","60539009","60539292","chr5","103833410","103833691","8","43294401"
"chr7","60544244","60544538","chr15","23211398","23211693","65","37332846"
"chr7","60556598","60556707","chr13","25820969","25821077","27","34735629"
"chr7","60556994","60557172","chr13","64478944","64479122","60","3921950"
"chr7","60562515","60562795","chrX","118505076","118505357","43","57942561"
"chr7","60567992","60568284","chr20","7471261","7471544","55","53096731"
"chr7","60583703","60583858","chr5","103861176","103861322","11","43277473"
"chr7","60584157","60584169","chr13","107299184","107299196","0","46715027"
"chr7","60588491","60588785","chr5","103872533","103872838","16","43284042"
"chr7","60602472","60602728","chr5","103886787","103887042","12","43284315"
"chr7","60606085","60606391","chr5","103891364","103891674","9","43285279"
"chr7","60606979","60607199","chr5","103892261","103892481","4","43285282"
"chr7","60614316","60614616","chr5","103899595","103899894","8","43285279"
"chr7","60637268","60637282","chr1","1107087","1107097","14","59530181"
"chr7","60637316","60637600","chr11","45323823","45324117","59","15313493"
"chr7","60662150","60662427","chr5","103950371","103950662","22","43288221"
"chr7","60674725","60675018","chr5","103963161","103963454","4","43288436"
"chr7","60699404","60699707","chr5","103989076","103989371","17","43289672"
"chr7","60708714","60708991","chr7","101514437","101514723","39","40805723"
"chr7","60725036","60725329","chr5","104015214","104015501","17","43290178"
"chr7","60860058","60860361","chr5","104152929","104153224","19","43292871"
"chr7","60867842","60868121","chr5","104160707","104160986","6","43292865"
"chr7","60929252","60929535","chr5","104221860","104222147","9","43292608"
"chr7","60942475","60942784","chr5","104235085","104235395","7","43292610"
"chr7","60944665","60944975","chr5","104237291","104237607","12","43292626"
"chr7","60981793","60981867","chr8","68882729","68882794","20","7900936"
"chr7","60981868","60982050","chr7","145704748","145704930","41","84722880"
"chr7","61071794","61072080","chr5","104366931","104367217","3","43295137"
"chr7","61088169","61088291","chr3","100119193","100119323","33","39031024"
"chr7","61088342","61088418","chr5","104384601","104384677","2","43296259"
"chr7","61129706","61130019","chr5","104426544","104426879","41","43296838"
"chr7","61182783","61182915","chr15","3262224","3262356","25","57920559"
"chr7","61213267","61213568","chr5","104512695","104513008","24","43299428"
"chr7","61230726","61231034","chr7","111535507","111535810","50","50304781"
"chr7","61248881","61249175","chr5","104552515","104552808","4","43303634"
"chr7","61309898","61310171","chr5","104610568","104610855","19","43300670"
"chr7","61310203","61310517","chr5","104610870","104611186","10","43300667"
"chr7","61336673","61336948","chr5","104636952","104637228","8","43300279"
"chr7","61345241","61345525","chr5","104645515","104645819","30","43300274"
"chr7","61424339","61424454","chr5","104721915","104722030","3","43297576"
"chr7","61473769","61474090","chr5","104770841","104771143","28","43297072"
"chr7","61573799","61574117","chr5","104869589","104869892","24","43295790"
"chr7","61612065","61612313","chr5","104907587","104907834","7","43295522"
"chr7","61648464","61648600","chr8","69793754","69793897","33","8145290"
"chr7","61728178","61728323","chr5","105024490","105024635","1","43296312"
"chr7","61764035","61764166","chr5","105060343","105060474","2","43296308"
"chr7","61778827","61779116","chr5","105075303","105075592","4","43296476"
"chr7","61904716","61904928","chr5","105201184","105201396","4","43296468"
"chr7","61906714","61907035","chr5","105203192","105203519","14","43296478"
"chr7","62025244","62025520","chr5","105325977","105326272","31","43300733"
"chr7","62050776","62051059","chr5","105360180","105360464","14","43309404"
"chr7","62080615","62080920","chr5","105390069","105390369","12","43309454"
"chr7","62238799","62239108","chr5","105546797","105547109","12","43307998"
"chr7","62293360","62293631","chr14","18432412","18432686","72","43860948"
"chr7","62295672","62295755","chr5","105602848","105602931","1","43307176"
"chr7","62410812","62411107","chr5","105717088","105717380","12","43306276"
"chr7","62506206","62506491","chr5","105813753","105814038","6","43307547"
"chr7","62535153","62535437","chr5","105842787","105843071","5","43307634"
"chr7","62640257","62640540","chr5","105956563","105956846","6","43316306"
"chr7","62777750","62778012","chr5","106095815","106096084","12","43318065"
"chr7","62830003","62830260","chr5","106163601","106163858","7","43333598"
"chr7","62835541","62835839","chr5","106169137","106169435","15","43333596"
"chr7","62853309","62853442","chr1","1286964","1287097","25","61566345"
"chr7","62853445","62853724","chr5","106187036","106187314","9","43333591"
"chr7","62936383","62936733","chr3","74796953","74797268","114","11860570"
"chr7","62964651","62964894","chr5","106299101","106299344","4","43334450"
"chr7","62965054","62965114","chr5","106299527","106299584","8","43334473"
"chr7","62996186","62996488","chr5","106330952","106331258","9","43334766"
"chr7","62996754","62997044","chr5","106331544","106331830","16","43334790"
"chr7","63016297","63016397","chr5","106350802","106350903","4","43334505"
"chr7","63195394","63195654","chr5","106532685","106532947","7","43337291"
"chr7","63195892","63196195","chr5","106533187","106533491","9","43337295"
"chr7","63274828","63275072","chr5","106611356","106611625","28","43336528"
"chr7","63393833","63394102","chr5","106731266","106731536","6","43337433"
"chr7","63473597","63473769","chr5","106811248","106811420","3","43337651"
"chr7","63507353","63507632","chr5","106845004","106845287","15","43337651"
"chr7","63580689","63581002","chr9","95122753","95123061","60","31542064"
"chr7","63701965","63702267","chr5","107035238","107035519","38","43333273"
"chr7","63803682","63803988","chr5","107137044","107137350","8","43333362"
"chr7","63847935","63848244","chr1","14612826","14613129","65","49235109"
"chr7","63857901","63857974","chr5","107186721","107186794","2","43328820"
"chr7","63864920","63865064","chr5","107193789","107193947","21","43328869"
"chr7","64057608","64057882","chr5","107393142","107393416","9","43335534"
"chr7","64107507","64107777","chr5","107442229","107442499","12","43334722"
"chr7","64107814","64107865","chr1","12171232","12171281","10","51936582"
"chr7","64124779","64125070","chr5","107459464","107459739","28","43334685"
"chr7","64148268","64148581","chr5","107482881","107483196","13","43334613"
"chr7","64183062","64183354","chr5","107518254","107518544","5","43335192"
"chr7","64217425","64217559","chr7","113859658","113859789","21","49642233"
"chr7","64224362","64224672","chr5","107568335","107568638","13","43343973"
"chr7","64254598","64254892","chr5","107598448","107598739","13","43343850"
"chr7","64271875","64272182","chr5","107616001","107616308","7","43344126"
"chr7","64296457","64296767","chr10","33247594","33247912","76","31048863"
"chr7","64349118","64349419","chr5","107683759","107684053","17","43334641"
"chr7","64401244","64401458","chr5","107736049","107736263","7","43334805"
"chr7","64414338","64414627","chr15","13747044","13747334","62","50667294"
"chr7","64573053","64573171","chr5","107912711","107912820","18","43339658"
"chr7","64792710","64793003","chr3","33909922","33910216","59","30882788"
"chr7","64808898","64809194","chr5","108151362","108151650","14","43342464"
"chr7","64810551","64810804","chr5","108153015","108153268","2","43342464"
"chr7","64848128","64848386","chr5","108187657","108187945","40","43339529"
"chr7","64988871","64989012","chr13","107856462","107856600","27","42867591"
"chr7","65024704","65024845","chr5","108368951","108369109","24","43344247"
"chr7","65078696","65078774","chr5","108421666","108421749","8","43342970"
"chr7","65099958","65100127","chr8","61473883","61474049","34","3626075"
"chr7","65100134","65100180","chr7","91229681","91229728","8","26129547"
"chr7","65138182","65138436","chr5","108487748","108488004","12","43349566"
"chr7","65249160","65249455","chr5","108598575","108598870","10","43349415"
"chr7","65321488","65321797","chr8","61749821","61750128","64","3571667"
"chr7","65421608","65421882","chr5","108777504","108777797","25","43355896"
"chr7","65612182","65612333","chr5","108966469","108966622","11","43354287"
"chr7","65799731","65800042","chrX","96719817","96720114","74","30920086"
"chr7","65861506","65861699","chr5","109217871","109218071","13","43356365"
"chr7","65957658","65957939","chr5","109314049","109314330","5","43356391"
"chr7","65993717","65993785","chr1","112516638","112516708","22","46522921"
"chr7","66022392","66022660","chr13","117182313","117182589","74","51159921"
"chr7","66047231","66047539","chr5","109401707","109402005","13","43354476"
"chr7","66068171","66068457","chr5","109422542","109422826","8","43354371"
"chr7","66071642","66071905","chr5","109426319","109426582","6","43354677"
"chr7","66095929","66096171","chr5","109450686","109450928","0","43354757"
"chr7","66142587","66142842","chr5","109497147","109497402","11","43354560"
"chr7","66148477","66148767","chr5","109503337","109503630","14","43354860"
"chr7","66158937","66159246","chr5","109513631","109513939","17","43354694"
"chr7","66165787","66166107","chr5","109520592","109520910","9","43354805"
"chr7","66171685","66171849","chr5","109526530","109526691","12","43354845"
"chr7","66202790","66203037","chr5","109560685","109560933","6","43357895"
"chr7","66290298","66290446","chr2","172227852","172227991","28","105937554"
"chr7","66298775","66299080","chr5","109656880","109657184","14","43358105"
"chr7","66300594","66300889","chr2","83637244","83637544","64","17336650"
"chr7","66305383","66305686","chr5","109663476","109663785","16","43358093"
"chr7","66330610","66330801","chr11","110784683","110784879","33","44454073"
"chr7","66331110","66331232","chr10","58193730","58193850","17","8137380"
"chr7","66342863","66343152","chr5","109700370","109700659","9","43357507"
"chr7","66366794","66367117","chr15","9901393","9901710","74","56465401"
"chr7","66400696","66400997","chr5","109766240","109766522","28","43365544"
"chr7","66404654","66404943","chr5","109770169","109770456","16","43365515"
"chr7","66453640","66453760","chr5","109819554","109819674","1","43365914"
"chr7","66453804","66454006","chr5","109819723","109819892","37","43365919"
"chr7","66455289","66455551","chr5","109821189","109821452","6","43365900"
"chr7","66462279","66462604","chr2","96205710","96206020","73","29743431"
"chr7","66488682","66488981","chr5","109854250","109854552","18","43365568"
"chr7","66537256","66537427","chr5","109902447","109902618","3","43365191"
"chr7","66625982","66626149","chr5","109997645","109997812","5","43371663"
"chr7","66626191","66626313","chr5","109997840","109997962","3","43371649"
"chr7","66640204","66640498","chr5","110011844","110012146","15","43371640"
"chr7","66644752","66645058","chr5","110016395","110016678","25","43371643"
"chr7","66706338","66706508","chr5","110067113","110067285","8","43360775"
"chr7","66779272","66779424","chr5","110140490","110140642","3","43361218"
"chr7","66782597","66782682","chr1","24072214","24072303","17","42710383"
"chr7","66791664","66791808","chr5","110152803","110152947","2","43361139"
"chr7","66900568","66900842","chr5","110261166","110261440","7","43360598"
"chr7","67027925","67028003","chr1","21802410","21802483","23","45225515"
"chr7","67045480","67045764","chr5","110406512","110406781","20","43361032"
"chr7","67079254","67079556","chr5","110440016","110440314","10","43360762"
"chr7","67109211","67109476","chr5","110469568","110469832","8","43360357"
"chr7","67126734","67127015","chr17","55074592","55074874","53","12052142"
"chr7","67164433","67164725","chr5","110528510","110528803","14","43364077"
"chr7","67201951","67202251","chr2","185379922","185380225","55","118177971"
"chr7","67269797","67270099","chr5","110636432","110636733","15","43366635"
"chr7","67326754","67327045","chr5","110697949","110698240","14","43371195"
"chr7","67409778","67410019","chr5","110780879","110781120","4","43371101"
"chr7","67425891","67426178","chr5","110797380","110797667","10","43371489"
"chr7","67456972","67457257","chr4","151153255","151153547","54","83696283"
"chr7","67474827","67475126","chr5","110846514","110846813","6","43371687"
"chr7","67678892","67679133","chr5","111047684","111047925","4","43368792"
"chr7","67789699","67790015","chr5","111166697","111167016","11","43376998"
"chr7","67991502","67991790","chr5","111421833","111422132","21","43430331"
"chr7","68078696","68078826","chr20","55950593","55950728","26","12128103"
"chr7","68088055","68088359","chr5","111521807","111522120","15","43433752"
"chr7","68124098","68124391","chrX","46200808","46201119","68","21923290"
"chr7","68277276","68277580","chr5","111713728","111714036","7","43436452"
"chr7","68288203","68288498","chr5","111724454","111724754","13","43436251"
"chr7","68311643","68311954","chr5","111747721","111748030","10","43436078"
"chr7","68323088","68323366","chr5","111759488","111759767","8","43436400"
"chr7","68328886","68329175","chr5","111765325","111765616","21","43436439"
"chr7","68338714","68338985","chr5","111775147","111775418","9","43436433"
"chr7","68343980","68344285","chr5","111780461","111780751","21","43436481"
"chr7","68378049","68378360","chr5","111815365","111815673","16","43437316"
"chr7","68388404","68388696","chr1","31731694","31731981","67","36656710"
"chr7","68429439","68429739","chr5","111863874","111864182","19","43434435"
"chr7","68496682","68496993","chr5","111935673","111935988","16","43438991"
"chr7","68543030","68543333","chr5","111981702","111982005","8","43438672"
"chr7","68722223","68722519","chr5","112138812","112139108","20","43416589"
"chr7","68921831","68922137","chr5","112336846","112337152","10","43415015"
"chr7","68995332","68995613","chr5","112410671","112410952","6","43415339"
"chr7","69025602","69025698","chr6","132462433","132462529","14","63436831"
"chr7","69025798","69025996","chr5","96941662","96941857","37","27915864"
"chr7","69067311","69067592","chr5","112485249","112485537","14","43417938"
"chr7","69081719","69082014","chr5","112499563","112499866","14","43417844"
"chr7","69084591","69084883","chr5","112502425","112502717","11","43417834"
"chr7","69107807","69108116","chr5","112525681","112525990","3","43417874"
"chr7","69131097","69131393","chr5","112551012","112551308","8","43419915"
"chr7","69137068","69137342","chr5","112556890","112557164","2","43419822"
"chr7","69139087","69139392","chr5","112558369","112558673","13","43419282"
"chr7","69158411","69158685","chr5","112574781","112575085","38","43416370"
"chr7","69176977","69177270","chr5","112593242","112593550","18","43416265"
"chr7","69239277","69239602","chr5","112655817","112656134","12","43416540"
"chr7","69261630","69261942","chr5","112677572","112677883","3","43415942"
"chr7","69295806","69296108","chr5","112712035","112712330","17","43416229"
"chr7","69306098","69306364","chr5","112719772","112720041","9","43413674"
"chr7","69321794","69322074","chr5","112735565","112735845","7","43413771"
"chr7","69384634","69384944","chr5","112798758","112799065","17","43414124"
"chr7","69395052","69395358","chr5","112808977","112809282","12","43413925"
"chr7","69406746","69406935","chr5","112821407","112821594","2","43414661"
"chr7","69433025","69433329","chr5","112847544","112847847","9","43414519"
"chr7","69453073","69453353","chr5","112868193","112868473","6","43415120"
"chr7","69488174","69488456","chr5","112902184","112902472","14","43414010"
"chr7","69552394","69552659","chr5","112965340","112965606","5","43412946"
"chr7","69611256","69611560","chr10","2252468","2252768","53","67358788"
"chr7","69648254","69648561","chr5","113067685","113067986","10","43419431"
"chr7","69714607","69714905","chr5","113136233","113136531","7","43421626"
"chr7","69779191","69779476","chr5","113208259","113208543","6","43429068"
"chr7","69786100","69786390","chr5","113215033","113215336","22","43428933"
"chr7","69827561","69827842","chr5","113262282","113262576","17","43434721"
"chr7","69956314","69956534","chr5","113392316","113392571","40","43436002"
"chr7","69995241","69995543","chr5","113431376","113431685","13","43436135"
"chr7","70015527","70015618","chr5","113451844","113451935","1","43436317"
"chr7","70086157","70086472","chr5","113525185","113525500","9","43439028"
"chr7","70114704","70115018","chr5","113553991","113554305","5","43439287"
"chr7","70131994","70132113","chr5","113571435","113571554","3","43439441"
"chr7","70149133","70149445","chr1","190510734","190511037","72","120361601"
"chr7","70159214","70159506","chr5","113598437","113598730","5","43439223"
"chr7","70163803","70163952","chr11","111771025","111771176","30","41607222"
"chr7","70163984","70164100","chr7","44566213","44566330","20","25597771"
"chr7","70173864","70174040","chr5","113614112","113614279","12","43440248"
"chr7","70180716","70180935","chr5","113620645","113620864","8","43439929"
"chr7","70186869","70187201","chr5","113626777","113627079","34","43439908"
"chr7","70195005","70195303","chr5","113634875","113635173","7","43439870"
"chr7","70230671","70230974","chr5","113670576","113670879","6","43439905"
"chr7","70238974","70239178","chr5","113678897","113679098","7","43439923"
"chr7","70321897","70322180","chr5","113765363","113765645","1","43443466"
"chr7","70414108","70414348","chr5","113858528","113858762","11","43444420"
"chr7","70422812","70423102","chr5","113867227","113867568","59","43444415"
"chr7","70426375","70426679","chr5","113870816","113871118","7","43444441"
"chr7","70440218","70440511","chr5","113885470","113885763","10","43445252"
"chr7","70445888","70446193","chr6","76277218","76277524","63","5831330"
"chr7","70471475","70471754","chr5","113918552","113918832","10","43447077"
"chr7","70476899","70477183","chr5","113922262","113922547","12","43445363"
"chr7","70482528","70482670","chr5","113927900","113928042","2","43445372"
"chr7","70482974","70483057","chr5","113928357","113928439","1","43445383"
"chr7","70527400","70527747","chr5","113974670","113975017","7","43447270"
"chr7","70535270","70535568","chr5","113982510","113982803","17","43447240"
"chr7","70612533","70612800","chr5","114060054","114060321","6","43447521"
"chr7","70641018","70641112","chr5","114088841","114088923","15","43447823"
"chr7","70641620","70641792","chr7","121272925","121273079","51","50631305"
"chr7","70665695","70665953","chr5","114113063","114113313","13","43447368"
"chr7","70673344","70673619","chr5","114120418","114120691","8","43447074"
"chr7","70679338","70679613","chr5","114126511","114126786","8","43447173"
"chr7","70683052","70683339","chr5","114130245","114130535","10","43447193"
"chr7","70688741","70689005","chr5","114135952","114136191","29","43447211"
"chr7","70690574","70690875","chr5","114137771","114138072","5","43447197"
"chr7","70710158","70710351","chr5","114158383","114158576","4","43448225"
"chr7","70710661","70710793","chr5","114158890","114159022","0","43448229"
"chr7","70716982","70717266","chr5","114167023","114167312","11","43450041"
"chr7","70717610","70717806","chr5","114167676","114167858","19","43450066"
"chr7","70719748","70720050","chr5","114169803","114170116","15","43450055"
"chr7","70721238","70721393","chr5","114171306","114171461","4","43450068"
"chr7","70740035","70740203","chr4","152516317","152516477","26","81776282"
"chr7","70744607","70744777","chr5","114195698","114195860","12","43451091"
"chr7","70764255","70764545","chr5","114214718","114215009","13","43450463"
"chr7","70785197","70785480","chr7","91794238","91794517","60","21009041"
"chr7","70804180","70804439","chr5","114255201","114255460","5","43451021"
"chr7","70808159","70808447","chr5","114258917","114259205","2","43450758"
"chr7","70843081","70843381","chr5","114294308","114294620","19","43451227"
"chr7","70849763","70850039","chr5","114300969","114301247","7","43451206"
"chr7","70869841","70870088","chr5","114321061","114321326","24","43451220"
"chr7","70905893","70906062","chr5","114357166","114357335","4","43451273"
"chr7","71137407","71137698","chr5","114587058","114587347","14","43449651"
"chr7","71258174","71258398","chr9","14985544","14985772","44","56272630"
"chr7","71464294","71464434","chrX","141462197","141462329","34","69997903"
"chr7","71482613","71482896","chr5","114932155","114932436","9","43449542"
"chr7","71493144","71493435","chr5","114942694","114942992","19","43449550"
"chr7","71564049","71564259","chr5","115014128","115014338","10","43450079"
"chr7","71577596","71577876","chr5","115025817","115026097","9","43448221"
"chr7","71688488","71688759","chr5","115140542","115140829","22","43452054"
"chr7","71722009","71722289","chr5","115174391","115174686","23","43452382"
"chr7","72003879","72004118","chr2","70988234","70988489","56","1015645"
"chr7","72004484","72004507","chr17","72764246","72764267","7","759762"
"chr7","72059835","72060118","chr5","115508863","115509146","13","43449028"
"chr7","72069395","72069747","chr16","25244171","25244506","83","46825224"
"chr7","72102039","72102248","chr5","115555357","115555567","7","43453318"
"chr7","72126090","72126325","chr16","12684488","12684734","54","59441602"
"chr7","72178616","72178870","chr5","115633087","115633342","9","43454471"
"chr7","72272001","72272164","chr5","115726466","115726629","4","43454465"
"chr7","72413034","72413342","chr5","115872880","115873170","28","43459846"
"chr7","72425629","72425903","chr5","115885526","115885800","6","43459897"
"chr7","72452574","72452737","chr5","115912938","115913128","31","43460364"
"chr7","72677147","72677334","chr5","116135378","116135565","15","43458231"
"chr7","72723639","72723929","chr5","116183509","116183829","35","43459870"
"chr7","72756603","72756896","chr4","151042390","151042695","75","78285787"
"chr7","72921509","72921782","chr5","116385930","116386203","6","43464421"
"chr7","72941321","72941623","chr13","45932391","45932692","56","27008930"
"chr7","72957911","72958156","chr5","116423250","116423496","4","43465339"
"chr7","73134354","73134672","chr5","116605435","116605747","16","43471081"
"chr7","73170684","73170973","chr5","116640644","116640932","8","43469960"
"chr7","73377893","73378193","chr5","116847907","116848207","11","43470014"
"chr7","73476308","73476612","chr5","116958155","116958460","9","43481847"
"chr7","73581565","73581818","chr5","117071053","117071306","10","43489488"
"chr7","73646662","73646953","chr5","117129358","117129628","37","43482696"
"chr7","73661149","73661459","chr16","44234942","44235243","65","29426207"
"chr7","73766391","73766674","chr5","117256247","117256533","15","43489856"
"chr7","73782316","73782624","chr5","117272110","117272413","31","43489794"
"chr7","73802124","73802447","chr5","117292001","117292324","8","43489877"
"chr7","73850860","73851131","chr5","117339986","117340290","38","43489126"
"chr7","73964411","73964701","chr5","117455158","117455444","10","43490747"
"chr7","73975177","73975449","chr5","117469122","117469396","8","43493945"
"chr7","74018629","74018753","chr5","117517769","117517893","2","43499140"
"chr7","74126165","74126449","chr5","117633069","117633351","12","43506904"
"chr7","74191617","74191876","chr5","117696962","117697221","4","43505345"
"chr7","74239079","74239381","chr5","117744252","117744549","9","43505173"
"chr7","74251766","74252057","chr5","117756456","117756747","12","43504690"
"chr7","74405074","74405379","chr5","117910317","117910633","15","43505243"
"chr7","74690272","74690584","chr5","118208212","118208524","9","43517940"
"chr7","74707082","74707247","chr5","118224883","118225048","4","43517801"
"chr7","74708188","74708494","chr5","118225997","118226291","18","43517809"
"chr7","74723160","74723290","chr5","118239454","118239584","2","43516294"
"chr7","74723580","74723859","chr5","118240189","118240506","46","43516609"
"chr7","74724752","74724982","chr5","118249245","118249493","36","43524493"
"chr7","74739676","74739972","chr5","118264432","118264725","13","43524756"
"chr7","74804779","74805086","chr5","118331487","118331788","14","43526708"
"chr7","74807907","74808208","chr5","118334613","118334918","10","43526706"
"chr7","74814411","74814724","chr5","118341639","118341953","15","43527228"
"chr7","74865109","74865420","chr5","118395157","118395467","11","43530048"
"chr7","74891364","74891668","chr5","118419069","118419381","15","43527705"
"chr7","74909315","74909586","chr5","118436779","118437050","7","43527464"
"chr7","74945723","74946028","chr5","118474424","118474733","7","43528701"
"chr7","74958231","74958514","chr5","118486993","118487276","9","43528762"
"chr7","74964670","74964812","chr5","118493515","118493657","2","43528845"
"chr7","74973834","74974119","chr5","118502370","118502654","7","43528536"
"chr7","75003790","75004090","chr5","118522055","118522351","10","43518265"
"chr7","75007638","75007776","chr5","118525890","118526026","4","43518252"
"chr7","75008068","75008236","chr5","118526326","118526488","9","43518258"
"chr7","75041587","75041757","chr5","118560332","118560485","19","43518745"
"chr7","75060300","75060485","chr7","33639198","33639379","35","41421102"
"chr7","75060488","75060722","chr2","97043264","97043499","44","21982776"
"chr7","75061483","75061776","chrX","11010016","11010316","51","64051467"
"chr7","75072853","75073188","chr15","69324906","69325208","83","5747947"
"chr7","75104570","75104871","chr9","57648963","57649252","65","17455607"
"chr7","75105889","75106184","chr1","216841044","216841341","53","141735155"
"chr7","75119411","75119701","chr16","41671981","41672272","47","33447430"
"chr7","75120036","75120298","chr20","39321011","39321280","56","35799025"
"chr7","75125062","75125361","chr19","39185632","39185925","58","35939430"
"chr7","75137112","75137251","chr2","62412627","62412763","32","12724485"
"chr7","75138978","75139140","chr14","19220999","19221162","32","55917979"
"chr7","75139199","75139209","chr9","121705261","121705272","1","46566062"
"chr7","75143597","75143611","chr14","44894488","44894502","4","30249109"
"chr7","75143901","75144060","chr14","63608556","63608715","25","11535345"
"chr7","75147786","75147858","chr5","20583889","20583961","13","54563897"
"chr7","75154880","75155164","chr5","118585641","118585925","6","43430761"
"chr7","75177046","75177158","chr5","118607664","118607776","0","43430618"
"chr7","75177462","75177627","chr5","118608073","118608238","4","43430611"
"chr7","75180015","75180173","chr5","118621766","118621926","5","43441751"
"chr7","75187289","75187458","chr5","118628377","118628531","36","43441088"
"chr7","75205557","75205864","chr5","118647284","118647593","6","43441727"
"chr7","75207055","75207348","chr5","118649129","118649420","11","43442074"
"chr7","75209763","75210049","chr5","118652124","118652410","7","43442361"
"chr7","75214997","75215294","chr5","118656888","118657183","4","43441891"
"chr7","75245811","75246124","chr5","118689607","118689915","9","43443796"
"chr7","75292729","75292824","chr5","118736795","118736890","1","43444066"
"chr7","75307290","75307584","chr5","118751157","118751459","11","43443867"
"chr7","75310905","75311204","chr5","118754763","118755068","11","43443858"
"chr7","75325677","75325899","chr5","118770428","118770646","8","43444751"
"chr7","75327009","75327292","chr5","118771757","118772044","7","43444748"
"chr7","75363845","75364140","chr5","118808588","118808885","10","43444743"
"chr7","75375821","75376132","chr5","118820796","118821107","8","43444975"
"chr7","75446774","75447069","chr5","118889786","118890080","11","43443012"
"chr7","75452928","75453201","chr9","86280576","86280846","53","10827648"
"chr7","75484107","75484446","chr5","118926444","118926753","60","43442337"
"chr7","75504323","75504557","chr5","118946323","118946557","2","43442000"
"chr7","75653656","75653827","chr5","119091546","119091713","5","43437890"
"chr7","75704456","75704753","chr5","119142845","119143146","20","43438389"
"chr7","75713993","75714269","chr5","119153907","119154187","12","43439914"
"chr7","75717619","75717922","chr5","119157491","119157798","19","43439872"
"chr7","75741266","75741571","chr5","119181901","119182207","9","43440635"
"chr7","75748031","75748329","chr5","119188679","119188991","22","43440648"
"chr7","75768702","75768959","chr11","91540817","91541068","55","15772115"
"chr7","75784074","75784204","chr12","91890887","91891017","1","16106813"
"chr7","75800562","75800861","chr5","119227750","119228049","12","43427188"
"chr7","75809117","75809363","chr5","119236274","119236526","10","43427157"
"chr7","75831704","75831992","chr5","119257318","119257609","14","43425614"
"chr7","75855322","75855621","chr5","119281123","119281426","36","43425801"
"chr7","75857235","75857498","chr5","119283028","119283291","2","43425793"
"chr7","75858001","75858274","chr5","119283807","119284086","15","43425806"
"chr7","75859804","75860102","chr5","119285665","119285955","13","43425861"
"chr7","75866073","75866369","chr5","119293146","119293442","2","43427073"
"chr7","75874079","75874378","chr5","119301499","119301802","10","43427420"
"chr7","75882612","75882927","chr5","119310057","119310371","17","43427445"
"chr7","75887092","75887380","chr5","119314543","119314831","4","43427451"
"chr7","75889404","75889686","JH682036","357821","358117","67","75531583"
"chr7","75897650","75897941","chr5","119325522","119325815","9","43427872"
"chr7","75903958","75904134","chr5","119332601","119332777","2","43428643"
"chr7","75905843","75906118","chr15","628234","628512","46","75277609"
"chr7","75922798","75923095","chr5","119351944","119352238","5","43429146"
"chr7","75934077","75934215","chr5","119363172","119363304","9","43429095"
"chr7","75936163","75936292","chr1","38100145","38100281","37","37836018"
"chr7","75968945","75969164","chr5","119398262","119398485","6","43429317"
"chr7","76003029","76003296","chr5","119432397","119432664","6","43429368"
"chr7","76006565","76006869","chr5","119435930","119436232","10","43429365"
"chr7","76012343","76012646","chr5","119441717","119442021","11","43429374"
"chr7","76014139","76014432","chr5","119443498","119443791","7","43429359"
"chr7","76040103","76040410","chr5","119469870","119470180","10","43429767"
"chr7","76149859","76150017","chr5","119581558","119581716","2","43431699"
"chr7","76150301","76150430","chr1","13980755","13980888","23","62169546"
"chr7","76192475","76192768","chr20","9392997","9393294","55","66799478"
"chr7","76395504","76395824","chr5","119851083","119851388","23","43455579"
"chr7","76413969","76414268","chr5","119867284","119867580","6","43453315"
"chr7","76421819","76422112","chr5","119875142","119875436","14","43453323"
"chr7","76483538","76483833","chr5","119933492","119933787","7","43449954"
"chr7","76583854","76583991","chr5","120049890","120050014","18","43466036"
"chr7","76633204","76633499","chr5","120100316","120100621","16","43467112"
"chr7","77034094","77034236","chr14","3185257","3185403","37","73848837"
"chr7","77070770","77071082","chr5","120542558","120542870","9","43471788"
"chr7","77098897","77099180","chr5","120570527","120570810","10","43471630"
"chr7","77139974","77140254","chr5","120609960","120610239","8","43469986"
"chr7","77175005","77175287","chr1","9037492","9037774","58","68137513"
"chr7","77206093","77206262","chr3","42631086","42631257","36","34575007"
"chr7","77206302","77206420","chr4","129522431","129522548","21","52316129"
"chr7","77241369","77241667","chr5","120713017","120713300","22","43471648"
"chr7","77270529","77270681","chr3","173904834","173904986","25","96634305"
"chr7","77282059","77282365","chr5","120754146","120754451","7","43472087"
"chr7","77306956","77307249","chr5","120778679","120778972","6","43471723"
"chr7","77409147","77409420","chr5","120881804","120882068","16","43472657"
"chr7","77418616","77418906","chrX","141365274","141365565","58","63946658"
"chr7","77438355","77438628","chr5","120910279","120910558","16","43471924"
"chr7","77664983","77665219","chr5","121138545","121138777","9","43473562"
"chr7","77669994","77670158","chr5","121143546","121143711","9","43473552"
"chr7","77692159","77692450","chr5","121166214","121166505","11","43474055"
"chr7","77718122","77718412","chr5","121192381","121192666","24","43474259"
"chr7","77749613","77749891","chr5","121224539","121224827","22","43474926"
"chr7","77750403","77750677","chr5","121225352","121225630","15","43474949"
"chr7","77754899","77755153","chr5","121229224","121229478","7","43474325"
"chr7","77825563","77825692","chr5","121301027","121301144","17","43475464"
"chr7","77825730","77825870","chr5","121301190","121301329","8","43475460"
"chr7","77897376","77897642","chr14","11758420","11758684","74","66138956"
"chr7","77985755","77985892","chr2","69677821","69677953","30","8307934"
"chr7","78027622","78027921","chr15","20459253","20459553","68","57568369"
"chr7","78152032","78152326","chr14","61811391","61811686","56","16340641"
"chr7","78192732","78193023","chr5","121400257","121400555","13","43207525"
"chr7","78229230","78229517","chr5","121440168","121440455","2","43210938"
"chr7","78234448","78234564","chr5","121445368","121445484","0","43210920"
"chr7","78312441","78312633","chr12","15064730","15064928","45","63247711"
"chr7","78355219","78355509","chr5","121565009","121565299","12","43209790"
"chr7","78479850","78480084","chr5","121697075","121697302","23","43217225"
"chr7","78480402","78480559","chrX","107929411","107929576","34","29449009"
"chr7","78525646","78525930","chr5","121742230","121742522","15","43216584"
"chr7","78529467","78529553","chr5","121746064","121746139","14","43216597"
"chr7","78666522","78666815","chr5","121876848","121877142","11","43210326"
"chr7","78728272","78728363","chr5","121937786","121937877","4","43209514"
"chr7","78860612","78860905","chr5","122068951","122069255","26","43208339"
"chr7","78895018","78895209","chr5","122103228","122103419","3","43208210"
"chr7","79013049","79013324","chr5","122226274","122226555","16","43213225"
"chr7","79038946","79039050","chr5","122250359","122250468","10","43211413"
"chr7","79048187","79048487","chr5","122259616","122259906","26","43211429"
"chr7","79074046","79074360","chr5","122283705","122284019","40","43209659"
"chr7","79163697","79163881","chr20","31885242","31885424","46","47278455"
"chr7","79164143","79164255","chr14","73178581","73178687","22","5985562"
"chr7","79373324","79373402","chr5","122606828","122606900","10","43233504"
"chr7","79383920","79384192","chr5","122616325","122616597","6","43232405"
"chr7","79384702","79385026","chr5","122617109","122617431","6","43232407"
"chr7","79410901","79411185","chr5","122642784","122643068","8","43231883"
"chr7","79445237","79445536","chr5","122668174","122668468","14","43222937"
"chr7","79476250","79476550","chr17","75485485","75485787","61","3990765"
"chr7","79517966","79518252","chr1","159614491","159614771","70","80096525"
"chr7","79551898","79551925","chr6","66953703","66953729","4","12598195"
"chr7","79551967","79552249","chr5","122782837","122783145","34","43230870"
"chr7","79576445","79576719","chr5","122807145","122807419","6","43230700"
"chr7","79781883","79782058","chr5","123012546","123012721","6","43230663"
"chr7","79798049","79798333","chr5","123028990","123029278","13","43230941"
"chr7","79812806","79813106","chr5","123040966","123041268","5","43228160"
"chr7","79831287","79831626","chr5","123059843","123060190","33","43228556"
"chr7","79872136","79872415","chr9","51491182","51491455","60","28380954"
"chr7","79877258","79877537","chr5","123106117","123106396","12","43228859"
"chr7","79916440","79916523","chr8","137894325","137894409","16","57977885"
"chr7","79946408","79946708","chr5","123176625","123176925","10","43230217"
"chr7","80051514","80051738","chr5","123283471","123283695","8","43231957"
"chr7","80234888","80235162","chr5","123475480","123475755","10","43240592"
"chr7","80282237","80282520","chr5","123524102","123524393","15","43241865"
"chr7","80385108","80385386","chr4","107645977","107646239","69","27260869"
"chr7","80511254","80511511","chr5","123764252","123764509","5","43252998"
"chr7","80522220","80522532","chr5","123773844","123774156","11","43251624"
"chr7","80555942","80556101","chr5","123809205","123809366","7","43253263"
"chr7","80577106","80577405","chr5","123830573","123830879","25","43253467"
"chr7","80581200","80581443","chr5","123834656","123834914","48","43253456"
"chr7","80616087","80616406","chr5","123870839","123871160","21","43254752"
"chr7","80628435","80628717","chr5","123887266","123887553","11","43258831"
"chr7","80688373","80688651","chr5","123946800","123947076","8","43258427"
"chr7","80709974","80710258","chr5","123969547","123969831","11","43259573"
"chr7","80879007","80879226","chr5","124137328","124137540","15","43258321"
"chr7","80888835","80889166","chr5","124147137","124147445","28","43258302"
"chr7","80932321","80932645","chrX","21098565","21098892","78","59833756"
"chr7","80944809","80944912","chr5","124205709","124205810","3","43260900"
"chr7","80970362","80970677","chr5","124243474","124243783","29","43273112"
"chr7","81003099","81003215","chr5","124275799","124275915","2","43272700"
"chr7","81003263","81003361","chr5","124275983","124276074","9","43272720"
"chr7","81069019","81069270","chr5","124351325","124351577","13","43282306"
"chr7","81512921","81513228","chr5","124808744","124809059","16","43295823"
"chr7","81531827","81532132","chr5","124829663","124829966","19","43297836"
"chr7","81556091","81556387","chr5","124854079","124854386","18","43297988"
"chr7","81566788","81567050","chr5","124864971","124865228","16","43298183"
"chr7","81586192","81586396","chr12","62423776","62423957","77","19162416"
"chr7","81657051","81657340","chr5","124957607","124957898","9","43300556"
"chr7","81771743","81772015","chr5","125075149","125075410","15","43303406"
"chr7","81795261","81795531","chr13","73086587","73086863","71","8708674"
"chr7","81830565","81830869","chr5","125130719","125131017","11","43300154"
"chr7","81837443","81837734","chrX","38833115","38833403","66","43004328"
"chr7","81886839","81887117","chr5","125184725","125185001","10","43297886"
"chr7","81944673","81944964","chr5","125242300","125242591","10","43297627"
"chr7","81945017","81945042","chr5","125242629","125242657","4","43297612"
"chr7","81970471","81970673","chr1","218043952","218044148","47","136073481"
"chr7","81985823","81985956","chr7","16144170","16144302","28","65841653"
"chr7","81986304","81986475","chr1","29358041","29358212","47","52628263"
"chr7","82037737","82038041","chr5","125337038","125337341","7","43299301"
"chr7","82087791","82088062","chr5","125387614","125387887","10","43299823"
"chr7","82115265","82115382","chr3","154543697","154543812","22","72428432"
"chr7","82115410","82115615","chr14","4073466","4073660","49","78041944"
"chr7","82146796","82147093","chr5","125447058","125447327","50","43300262"
"chr7","82184205","82184484","chr5","125484949","125485228","7","43300744"
"chr7","82194330","82194589","chr5","125495214","125495471","9","43300884"
"chr7","82299598","82299886","chr5","125601623","125601911","11","43302025"
"chr7","82375564","82375825","chr6","155923452","155923703","65","73547888"
"chr7","82494715","82494981","chr5","125799038","125799304","5","43304323"
"chr7","82598579","82598867","chr5","125901011","125901299","7","43302432"
"chr7","82782220","82782534","chr10","51006911","51007211","75","31775309"
"chr7","82834076","82834281","chr6","66221274","66221478","44","16612802"
"chr7","82853927","82854223","chr5","126162478","126162775","9","43308551"
"chr7","82951714","82951998","chr5","126262014","126262299","16","43310300"
"chr7","82964179","82964477","chr5","126274626","126274923","12","43310447"
"chr7","83153337","83153430","chr5","126477776","126477869","0","43324439"
"chr7","83261909","83262068","chr5","126585792","126585955","9","43323883"
"chr7","83289489","83289763","chr5","126613129","126613403","3","43323640"
"chr7","83328413","83328468","chr11","112594298","112594345","17","29265885"
"chr7","83352394","83352677","chr5","126682644","126682897","38","43330250"
"chr7","83362883","83363176","chr16","21320831","21321123","72","62042052"
"chr7","83380451","83380758","chr5","126714349","126714656","11","43333898"
"chr7","83389971","83390269","chr5","126723835","126724106","32","43333864"
"chr7","83418028","83418327","chr5","126751153","126751452","5","43333125"
"chr7","83544145","83544453","chr5","126880368","126880674","11","43336223"
"chr7","83544896","83545132","chr5","126881108","126881344","10","43336212"
"chr7","83566310","83566590","chr5","126906313","126906593","4","43340003"
"chr7","83606912","83607231","chr5","126946515","126946821","38","43339603"
"chr7","83744020","83744205","chr5","127082547","127082744","18","43338527"
"chr7","83767368","83767505","chr7","77886179","77886317","36","5881189"
"chr7","83767710","83768012","chr5","127106806","127107107","17","43339096"
"chr7","83796294","83796456","chr5","127134959","127135124","11","43338665"
"chr7","83981602","83981744","chr5","127324987","127325129","6","43343385"
"chr7","83998891","83999024","chr3","51679299","51679431","28","32319592"
"chr7","84145068","84145146","chr2","161562894","161562971","19","77417826"
"chr7","84158278","84158588","chr5","127515179","127515489","10","43356901"
"chr7","84167944","84168244","chr5","127525471","127525779","22","43357527"
"chr7","84290643","84290935","chr5","127644324","127644624","14","43353681"
"chr7","84320519","84320584","chr5","127675893","127675958","2","43355374"
"chr7","84350180","84350498","chr5","127706539","127706855","15","43356359"
"chr7","84443045","84443205","chr5","127799231","127799391","9","43356186"
"chr7","84540357","84540610","chr5","127896651","127896904","10","43356294"
"chr7","84543761","84544056","chr5","127900375","127900677","23","43356614"
"chr7","84642568","84642865","chr5","128000027","128000311","19","43357459"
"chr7","84722055","84722361","chr5","128080059","128080339","35","43358004"
"chr7","85085814","85086113","chr5","128452436","128452725","17","43366622"
"chr7","85221172","85221472","chr5","128590865","128591166","8","43369693"
"chr7","85292484","85292583","chr19","33801194","33801285","22","51491290"
"chr7","85292646","85292797","chr8","13225069","13225228","31","72067577"
"chr7","85511209","85511336","chr8","36973904","36974031","24","48537305"
"chr7","85511638","85511776","chr2","172227852","172227991","31","86716214"
"chr7","85558006","85558278","chr5","128928853","128929126","34","43370847"
"chr7","85593956","85594254","chr5","128965966","128966265","11","43372010"
"chr7","85627503","85627807","chr5","129001715","129001986","37","43374212"
"chr7","85704376","85704570","chr9","73575378","73575563","42","12128998"
"chr7","85881112","85881414","chr5","129261905","129262211","8","43380793"
"chr7","85894544","85894842","chr5","129275555","129275840","17","43381011"
"chr7","85901375","85901673","chr5","129282387","129282649","42","43381012"
"chr7","85904816","85905093","chr5","129286712","129286989","5","43381896"
"chr7","85908940","85909241","chr5","129291322","129291617","14","43382382"
"chr7","85953724","85953863","chr5","52245321","52245461","36","33708403"
"chr7","85954801","85954864","chr12","72016960","72017018","15","13937841"
"chr7","85963554","85963709","chr12","33089244","33089382","43","52874310"
"chr7","85972560","85972856","chr5","129356223","129356521","8","43383663"
"chr7","86000096","86000261","chr5","129385932","129386100","8","43385836"
"chr7","86006113","86006336","chr5","129392559","129392780","6","43386446"
"chr7","86006924","86007213","chr5","129393363","129393652","1","43386439"
"chr7","86020925","86021220","chr5","129407818","129408109","8","43386893"
"chr7","86037500","86037749","chr5","129426400","129426649","4","43388900"
"chr7","86038583","86038707","chr11","121677984","121678099","33","35639401"
"chr7","86039568","86039890","chr5","129428459","129428782","15","43388891"
"chr7","86041484","86041748","chr5","129430383","129430644","14","43388899"
"chr7","86068464","86068513","chr5","79602608","79602654","11","6465856"
"chr7","86068518","86068675","chr15","38699781","38699937","38","47368737"
"chr7","86072818","86073042","chr4","154939959","154940176","53","68867141"
"chr7","86081006","86081299","chr5","129468661","129468964","16","43387655"
"chr7","86096788","86097090","chr5","129484486","129484788","6","43387698"
"chr7","86107094","86107397","chr5","129496699","129496996","13","43389605"
"chr7","86109547","86109691","chr5","129498941","129499081","12","43389394"
"chr7","86116998","86117293","chr6","51072032","51072325","46","35044966"
"chr7","86119816","86120003","chr5","129516873","129517086","39","43397057"
"chr7","86121752","86121896","chr5","129518516","129518652","13","43396764"
"chr7","86122221","86122384","chr5","129518976","129519137","4","43396755"
"chr7","86124826","86125137","chr5","129521609","129521920","2","43396783"
"chr7","86133590","86133797","chr5","129529373","129529580","6","43395783"
"chr7","86143536","86143660","chr5","129538905","129539029","1","43395369"
"chr7","86154945","86155235","chr5","129550433","129550723","4","43395488"
"chr7","86163423","86163477","chr8","102013401","102013459","14","15849978"
"chr7","86170519","86170810","chr5","129567483","129567774","5","43396964"
"chr7","86174988","86175069","chr15","82301572","82301653","16","3873416"
"chr7","86184215","86184522","chr5","129582961","129583268","12","43398746"
"chr7","86193496","86193794","chr5","129599970","129600267","9","43406474"
"chr7","86198471","86198751","chr5","129602986","129603266","6","43404515"
"chr7","86201264","86201565","chr5","129604363","129604664","5","43403099"
"chr7","86214829","86215134","chr5","129620344","129620640","14","43405515"
"chr7","86217258","86217329","chr5","129622751","129622833","12","43405493"
"chr7","86228716","86229026","chr5","129634387","129634688","15","43405671"
"chr7","86231716","86232001","chr5","129637384","129637668","6","43405668"
"chr7","86242350","86242644","chr5","129648040","129648334","5","43405690"
"chr7","86265225","86265541","chr9","95600829","95601141","71","9335604"
"chr7","86274638","86274940","chr5","129681890","129682191","9","43407252"
"chr7","86281877","86282156","chr5","129690196","129690475","4","43408319"
"chr7","86286637","86286942","chr13","115015896","115016196","64","28729259"
"chr7","86291374","86291630","chr5","129699877","129700133","6","43408503"
"chr7","86295196","86295460","chr5","129703821","129704113","31","43408625"
"chr7","86299027","86299112","chr5","129707674","129707759","0","43408647"
"chr7","86315427","86315725","chr5","129725021","129725319","4","43409594"
"chr7","86315916","86316208","chr5","129725510","129725802","9","43409594"
"chr7","86321890","86322201","chr5","129731617","129731927","5","43409727"
"chr7","86332791","86333128","chr10","20853642","20853971","81","65479149"
"chr7","86340064","86340373","chr5","129749793","129750063","41","43409729"
"chr7","86351903","86352182","chr5","129761621","129761900","4","43409718"
"chr7","86352310","86352474","chr5","129762028","129762192","2","43409718"
"chr7","86354243","86354528","chr5","129763973","129764254","9","43409730"
"chr7","86365483","86365785","chr5","129775046","129775348","9","43409563"
"chr7","86368517","86368824","chr5","129778073","129778377","5","43409556"
"chr7","86372882","86373164","chr5","129782711","129783004","17","43409829"
"chr7","86403728","86404005","chr5","129813884","129814166","10","43410156"
"chr7","86404292","86404581","chr5","129814448","129814757","35","43410156"
"chr7","86431269","86431544","chr5","129842678","129842953","8","43411409"
"chr7","86432397","86432701","chrX","46237730","46238032","63","40194667"
"chr7","86435901","86436191","chr5","129843915","129844220","19","43408014"
"chr7","86441725","86441805","chr5","129849760","129849841","3","43408035"
"chr7","86448770","86449086","chr9","94565208","94565508","64","8116438"
"chr7","86450829","86451065","chr1","197498153","197498380","44","111047324"
"chr7","86453823","86454122","chr5","129862657","129862956","6","43408834"
"chr7","86463877","86464172","chr5","129872785","129873079","6","43408908"
"chr7","86496149","86496504","chr5","129906238","129906537","72","43410089"
"chr7","86502675","86502989","chr5","129912721","129913034","11","43410046"
"chr7","86504918","86505180","chr5","129914961","129915224","7","43410043"
"chr7","86514745","86515044","chr5","129925893","129926195","6","43411148"
"chr7","86522555","86522696","chr12","93529940","93530072","42","7007385"
"chr7","86536866","86537151","chr14","115288216","115288505","62","28751350"
"chr7","86537508","86537640","chr5","129949601","129949733","0","43412093"
"chr7","86582593","86582888","chr5","129994729","129995023","9","43412136"
"chr7","86604737","86605013","chr5","130018752","130019026","9","43414015"
"chr7","86609566","86609811","chr5","130023551","130023796","4","43413985"
"chr7","86645025","86645321","chr5","130059987","130060283","5","43414962"
"chr7","86672071","86672325","chr5","130086788","130087042","9","43414717"
"chr7","86672879","86672961","chr5","130087596","130087680","5","43414717"
"chr7","86759209","86759363","chr1","47596342","47596495","36","39162867"
"chr7","86806478","86806748","chr5","130221933","130222205","9","43415455"
"chr7","86815480","86815767","chr5","130230915","130231205","8","43415435"
"chr7","86826844","86826981","chr17","11296067","11296213","25","75530777"
"chr7","86916480","86916778","chr5","130329469","130329767","9","43412989"
"chr7","86945258","86945411","chr5","130357908","130358049","13","43412650"
"chr7","87057114","87057347","chr5","130472430","130472659","7","43415316"
"chr7","87057460","87057773","chr5","130472776","130473091","11","43415316"
"chr7","87071038","87071109","chr5","130486289","130486354","7","43415251"
"chr7","87115055","87115373","chr5","130530508","130530823","32","43415453"
"chr7","87208155","87208286","chr5","130623214","130623347","6","43415059"
"chr7","87224829","87225132","chr13","22978672","22978968","73","64246157"
"chr7","87254248","87254550","chr5","130670889","130671191","12","43416641"
"chr7","87357976","87358282","chr5","130773793","130774100","7","43415817"
"chr7","87376363","87376664","chr5","130792425","130792726","9","43416062"
"chr7","87402694","87402965","chr5","130818845","130819113","8","43416151"
"chr7","87407198","87407459","chr5","130823080","130823296","50","43415882"
"chr7","87453421","87453717","chr16","6831723","6832025","67","80621698"
"chr7","87522677","87522899","chr5","130949768","130949990","5","43427091"
"chr7","87555443","87555725","chr5","130981767","130982041","12","43426324"
"chr7","87567570","87567886","chr5","130994194","130994511","10","43426624"
"chr7","87581013","87581302","chr5","131007661","131007958","13","43426648"
"chr7","87584128","87584418","chr5","131010471","131010761","3","43426343"
"chr7","87598861","87599158","chr5","131025286","131025583","8","43426425"
"chr7","87618908","87619000","chr2","21428375","21428470","17","66190533"
"chr7","87621994","87622295","chr5","131050236","131050541","11","43428242"
"chr7","87626830","87627130","chr5","131055151","131055451","7","43428321"
"chr7","87630884","87631186","chr5","131059208","131059511","9","43428324"
"chr7","87666525","87666648","chr5","131094243","131094366","2","43427718"
"chr7","87669274","87669610","chr5","131097016","131097354","9","43427742"
"chr7","87676722","87677035","chr5","131104408","131104727","16","43427686"
"chr7","87682174","87682291","chr5","131109868","131109985","3","43427694"
"chr7","87692945","87693063","chrX","106963609","106963713","44","19270664"
"chr7","87707382","87707534","chr5","131135347","131135495","7","43427965"
"chr7","87712061","87712353","chr5","131140011","131140305","5","43427950"
"chr7","87714646","87714960","chr5","131142913","131143228","11","43428267"
"chr7","87738399","87738517","chr5","131162488","131162606","3","43424089"
"chr7","87743245","87743534","chr5","131167308","131167630","39","43424063"
"chr7","87769869","87770106","chr5","131197789","131198038","30","43427920"
"chr7","87796496","87796796","chr5","131224486","131224771","23","43427990"
"chr7","87804054","87804334","chr15","25410201","25410481","52","62393853"
"chr7","87809094","87809265","chr5","131237050","131237221","3","43427956"
"chr7","87887054","87887355","chr5","131315082","131315383","12","43428028"
"chr7","88066075","88066288","chr5","131501263","131501476","9","43435188"
"chr7","88078657","88078954","chr5","131513465","131513763","7","43434808"
"chr7","88091458","88091763","chr5","131526290","131526614","29","43434832"
"chr7","88161945","88162182","chr13","14373709","14373950","62","73788236"
"chr7","88213106","88213405","chr1","179043579","179043882","52","90830473"
"chr7","88233864","88234140","chr5","131669521","131669793","8","43435657"
"chr7","88369299","88369452","chr5","131807300","131807453","4","43438001"
"chr7","88369504","88369519","chr5","131807509","131807524","0","43438005"
"chr7","88582011","88582286","chr5","132029841","132030116","4","43447830"
"chr7","88691668","88691994","chr5","132140797","132141098","35","43449129"
"chr7","88695835","88696121","chr5","132144960","132145246","6","43449125"
"chr7","88806341","88806627","chr7","37827576","37827856","58","50978765"
"chr7","88934314","88934622","chr5","132383760","132384066","10","43449446"
"chr7","88984908","88985206","chr5","132437498","132437796","4","43452590"
"chr7","89006049","89006250","chr5","132458857","132459074","20","43452808"
"chr7","89038749","89038986","chr5","132493498","132493735","2","43454749"
"chr7","89054968","89055125","chr1","9667266","9667402","45","79387702"
"chr7","89077238","89077551","chr5","132533057","132533367","19","43455819"
"chr7","89132590","89132711","chr19","38195203","38195322","36","50937387"
"chr7","89132738","89132857","chrX","46908426","46908546","22","42224312"
"chr7","89183653","89183966","chr13","84452913","84453227","78","4730740"
"chr7","89253230","89253534","chr5","132706934","132707232","13","43453704"
"chr7","89350314","89350584","chr5","132804379","132804649","3","43454065"
"chr7","89393367","89393672","chr5","132842917","132843221","8","43449550"
"chr7","89484571","89484849","chr5","132932228","132932501","13","43447657"
"chr7","89524539","89524699","chr5","132971574","132971734","11","43447035"
"chr7","89571844","89571994","chr5","133026849","133026999","6","43455005"
"chr7","89609234","89609532","chr5","133070892","133071194","13","43461658"
"chr7","89695328","89695608","chr5","133157689","133157961","19","43462361"
"chr7","89696734","89697049","chr5","133159136","133159450","9","43462402"
"chr7","89720619","89720917","chr5","133183050","133183355","16","43462431"
"chr7","89834961","89835279","chr5","133301085","133301403","11","43466124"
"chr7","89921402","89921615","chr5","133392257","133392469","6","43470855"
"chr7","89924986","89925133","chr7","67097863","67098011","28","22827123"
"chr7","89960472","89960786","chr5","133431188","133431491","22","43470716"
"chr7","90036967","90037212","chr5","133507881","133508122","13","43470914"
"chr7","90069071","90069352","chr5","133540020","133540301","4","43470949"
"chr7","90100146","90100258","chr5","133570367","133570479","3","43470221"
"chr7","90101314","90101587","chr5","133571508","133571805","38","43470194"
"chr7","90101591","90101886","chr5","133571809","133572104","7","43470218"
"chr7","90169284","90169441","chr1","94558530","94558684","34","4389246"
"chr7","90169478","90169595","chr12","19701374","19701491","21","70468104"
"chr7","90171642","90171947","chr5","133643365","133643666","10","43471723"
"chr7","90178636","90178945","chr5","133650527","133650798","49","43471891"
"chr7","90226731","90227011","chr5","133698372","133698661","25","43471641"
"chr7","90240446","90240718","chr5","133711768","133712040","7","43471322"
"chr7","90246676","90246951","chr5","133718295","133718570","3","43471619"
"chr7","90259921","90260052","chr5","133731233","133731364","0","43471312"
"chr7","90265750","90265962","chr1","60840859","60841055","47","29424891"
"chr7","90438360","90438656","chr5","133896872","133897160","13","43458512"
"chr7","90589024","90589325","chr14","32977679","32977981","57","57611345"
"chr7","90643110","90643414","chr5","134106416","134106718","30","43463306"
"chr7","90693305","90693579","chr5","134158093","134158367","4","43464788"
"chr7","90712629","90712935","chr5","134180267","134180552","29","43467638"
"chr7","90714686","90714981","chr5","134182297","134182591","5","43467611"
"chr7","90935011","90935309","chr5","134420133","134420431","8","43485122"
"chr7","90946260","90946569","chr5","134431415","134431735","16","43485155"
"chr7","91036719","91036970","chrX","124048280","124048528","61","33011561"
"chr7","91095843","91096142","chr3","178240315","178240614","59","87144472"
"chr7","91159252","91159540","chr5","134646643","134646931","12","43487391"
"chr7","91175541","91175721","chr5","134665831","134666009","4","43490290"
"chr7","91399588","91399865","chr5","134886278","134886563","13","43486690"
"chr7","91510293","91510586","chr5","134995678","134995968","13","43485385"
"chr7","91526236","91526438","chr5","135018669","135018901","34","43492433"
"chr7","91597837","91598126","chr5","135094211","135094500","11","43496374"
"chr7","91613414","91613705","chr5","135109746","135110036","10","43496332"
"chr7","91662277","91662369","chr5","135158660","135158762","11","43496383"
"chr7","91671933","91672235","chr5","135168307","135168609","17","43496374"
"chr7","91678794","91678962","chr5","135175136","135175306","5","43496342"
"chr7","91698171","91698458","chr5","135194317","135194605","7","43496146"
"chr7","91718083","91718213","chr5","135214514","135214644","4","43496431"
"chr7","91761035","91761334","chr5","135261738","135262039","8","43500703"
"chr7","91842294","91842605","chr5","135341795","135342102","13","43499501"
"chr7","91843342","91843652","chr5","135342836","135343147","2","43499494"
"chr7","91878738","91879021","chr5","135377112","135377395","6","43498374"
"chr7","91906445","91906764","chr5","135404728","135405042","15","43498283"
"chr7","91929073","91929382","chr5","135427338","135427642","13","43498265"
"chr7","91938916","91939063","chr5","135437185","135437333","3","43498269"
"chr7","91954310","91954494","chr5","135451278","135451465","6","43496968"
"chr7","91983956","91983968","chr2","87569309","87569319","2","4414647"
"chr7","91983995","91984254","chr5","135481802","135482085","29","43497807"
"chr7","91985864","91986144","chr5","135483697","135483977","12","43497833"
"chr7","92040663","92040942","chr5","135537004","135537283","4","43496341"
"chr7","92050597","92050901","chr5","135546128","135546432","2","43495531"
"chr7","92064762","92065051","chr5","135560309","135560598","10","43495547"
"chr7","92117199","92117374","chr3","173716711","173716883","33","81599512"
"chr7","92117414","92117532","chr7","19596811","19596930","21","72520603"
"chr7","92169101","92169395","chr7","3184681","3184974","55","88984420"
"chr7","92195531","92195825","chr5","135703578","135703874","13","43508047"
"chr7","92211529","92211822","chr5","135719202","135719501","17","43507673"
"chr7","92212602","92212812","chr5","135720273","135720483","6","43507671"
"chr7","92227838","92228133","chr5","135735484","135735779","5","43507646"
"chr7","92234083","92234383","chr5","135741729","135742035","16","43507646"
"chr7","92246519","92246735","chr5","135754494","135754707","10","43507975"
"chr7","92278511","92278805","chr11","37886867","37887156","58","54391644"
"chr7","92289936","92290222","chr5","135799574","135799860","5","43509638"
"chr7","92335787","92335832","chr5","135844728","135844773","1","43508941"
"chr7","92336126","92336324","chr5","135845070","135845265","8","43508944"
"chr7","92351042","92351210","chr5","135860024","135860192","2","43508982"
"chr7","92351245","92351339","chr5","135860227","135860323","5","43508982"
"chr7","92356956","92357174","chr5","135865920","135866138","3","43508964"
"chr7","92359275","92359554","chr5","135868239","135868527","22","43508964"
"chr7","92388892","92389186","chr5","135898033","135898329","16","43509141"
"chr7","92395406","92395711","chr5","135904550","135904858","5","43509144"
"chr7","92404691","92404942","chr5","135913556","135913807","2","43508865"
"chr7","92464109","92464411","chr5","135972672","135972970","7","43508563"
"chr7","92507499","92507801","chr5","136016879","136017181","13","43509380"
"chr7","92558099","92558192","chr2","50054401","50054489","25","42503698"
"chr7","92593846","92594115","chr5","136101170","136101440","13","43507324"
"chr7","92645567","92645884","chr5","136153505","136153825","17","43507938"
"chr7","92668971","92669246","chr5","136177363","136177635","8","43508392"
"chr7","92713697","92713988","chr5","136223037","136223328","5","43509340"
"chr7","92733317","92733616","chr5","136242630","136242926","11","43509313"
"chr7","92743610","92743910","chr5","136252911","136253211","4","43509301"
"chr7","92755245","92755537","chr5","136264491","136264783","11","43509246"
"chr7","92763811","92764135","chr5","136273053","136273367","18","43509242"
"chr7","92908036","92908336","chr5","136418731","136419037","11","43510695"
"chr7","92924684","92925003","chr5","136434356","136434673","9","43509672"
"chr7","92959114","92959284","chr5","136471845","136472034","30","43512731"
"chr7","92959847","92960162","chr5","136473713","136474030","14","43513866"
"chr7","93000451","93000707","chr6","129510290","129510538","68","36509839"
"chr7","93018833","93018975","chr19","14673246","14673394","42","78345587"
"chr7","93018982","93019292","chr5","136531877","136532187","10","43512895"
"chr7","93023508","93023832","chr5","136536351","136536658","27","43512843"
"chr7","93085780","93086075","chr5","136596438","136596743","21","43510658"
"chr7","93097075","93097381","chr5","136607763","136608069","6","43510688"
"chr7","93109597","93109900","chr5","136620299","136620603","6","43510702"
"chr7","93205484","93205587","chr1","18170763","18170860","21","75034721"
"chr7","93208234","93208449","chr1","55250354","55250560","51","37957880"
"chr7","93228687","93228968","chr5","136744231","136744524","21","43515544"
"chr7","93259613","93259893","chr5","136775427","136775721","18","43515814"
"chr7","93295612","93295840","chr5","136812885","136813117","13","43517273"
"chr7","93535420","93535681","chr5","137061196","137061469","22","43525776"
"chr7","93590214","93590224","chr10","17677672","17677682","2","75912542"
"chr7","93590258","93590398","chr7","109373466","109373612","29","15783208"
"chr7","93594609","93594920","chr5","137120365","137120672","17","43525756"
"chr7","93932306","93932609","chr5","137454981","137455284","6","43522675"
"chr7","93945505","93945780","chr12","62907476","62907755","58","31038029"
"chr7","93951854","93951961","chr5","137473738","137473845","5","43521884"
"chr7","93956740","93957028","chr5","137478628","137478915","7","43521888"
"chr7","93999265","93999395","chr5","137520554","137520684","2","43521289"
"chr7","94000929","94001179","chr5","137522208","137522464","11","43521279"
"chr7","94005209","94005341","chr2","82271675","82271805","19","11733534"
"chr7","94028137","94028442","chr5","137550736","137550998","54","43522599"
"chr7","94047589","94047887","chr14","90417803","90418100","58","3629786"
"chr7","94054488","94054701","chr5","137576607","137576820","4","43522119"
"chr7","94073738","94074018","chr8","16394714","16394993","51","77679024"
"chr7","94080676","94080995","chr5","137602713","137603023","17","43522037"
"chr7","94087756","94088061","chr1","31001555","31001842","67","63086201"
"chr7","94119439","94119717","chr5","137641458","137641716","22","43522019"
"chr7","94126518","94126818","chr5","137648562","137648857","17","43522044"
"chr7","94138626","94138918","chr5","137660700","137660997","8","43522074"
"chr7","94139335","94139603","chr5","137661415","137661683","8","43522080"
"chr7","94140631","94140936","chr5","137662709","137663013","4","43522078"
"chr7","94144131","94144225","chr5","137666209","137666302","1","43522078"
"chr7","94149764","94150039","chr12","93137220","93137513","77","1012544"
"chr7","94156148","94156438","chr5","137678219","137678512","13","43522071"
"chr7","94176061","94176368","chr5","137700000","137700306","10","43523939"
"chr7","94190001","94190298","chr5","137713079","137713379","6","43523078"
"chr7","94201326","94201629","chr5","137724390","137724698","10","43523064"
"chr7","94203500","94203602","chr5","137726563","137726670","10","43523063"
"chr7","94218791","94219059","chr5","137741677","137741944","5","43522886"
"chr7","94335496","94335785","chr5","137855223","137855512","9","43519727"
"chr7","94339739","94339980","chr5","137859472","137859714","13","43519733"
"chr7","94370397","94370713","chr5","137890188","137890481","33","43519791"
"chr7","94373637","94373935","chr5","137893751","137894048","12","43520114"
"chr7","94411888","94412174","chr5","137931964","137932257","18","43520076"
"chr7","94480788","94480917","chr5","137999212","137999345","6","43518424"
"chr7","94481632","94481937","chr5","138000045","138000352","15","43518413"
"chr7","94488151","94488356","chr5","138006570","138006775","5","43518419"
"chr7","94524186","94524338","chr5","138042977","138043128","3","43518791"
"chr7","94634266","94634556","chr5","138154338","138154628","9","43520072"
"chr7","94638416","94638699","chr5","138158827","138159111","7","43520411"
"chr7","94714134","94714296","chr5","138235933","138236095","1","43521799"
"chr7","94727653","94727924","chr5","138249447","138249721","11","43521794"
"chr7","94745507","94745813","chr5","138267730","138268044","20","43522223"
"chr7","94803742","94804020","chr5","138334813","138335093","11","43531071"
"chr7","94883261","94883549","chr20","8585923","8586216","63","86297338"
"chr7","94983164","94983422","chr13","46321996","46322262","57","48661168"
"chr7","94996077","94996370","chr5","138522296","138522590","16","43526219"
"chr7","95025064","95025352","chr5","138550631","138550918","2","43525567"
"chr7","95034380","95034649","chr5","138559953","138560222","5","43525573"
"chr7","95136769","95137048","chr5","138666774","138667091","47","43530005"
"chr7","95166776","95167048","chr5","138697489","138697761","9","43530713"
"chr7","95192245","95192542","chr5","138722545","138722839","11","43530300"
"chr7","95204709","95204792","chr5","138735224","138735307","1","43530515"
"chr7","95210196","95210492","chr5","138740836","138741116","31","43530640"
"chr7","95239419","95239706","chr5","138770017","138770304","10","43530598"
"chr7","95246892","95247005","chr1","43080580","43080696","21","52166312"
"chr7","95247032","95247203","chr4","119074513","119074677","28","23827481"
"chr7","95262275","95262582","chr5","138792726","138793033","7","43530451"
"chr7","95330670","95330982","chr5","138860254","138860566","4","43529584"
"chr7","95345686","95345888","chr5","138875614","138875816","7","43529928"
"chr7","95350950","95351115","chr5","138880804","138880973","8","43529854"
"chr7","95351159","95351285","chr5","138880999","138881125","6","43529840"
"chr7","95385559","95385668","chr5","138914695","138914804","4","43529136"
"chr7","95460622","95460911","chr5","138988440","138988729","8","43527818"
"chr7","95462773","95463074","chr5","138990581","138990882","9","43527808"
"chr7","95484942","95485234","chr5","139012701","139012992","4","43527759"
"chr7","95486975","95487308","chr5","139014724","139015053","11","43527749"
"chr7","95488832","95489141","chr5","139016575","139016886","7","43527743"
"chr7","95500001","95500109","chr3","35508590","35508692","24","59991411"
"chr7","95545917","95546133","chr5","139075099","139075313","9","43529182"
"chr7","95711130","95711439","chr5","139242281","139242595","8","43531151"
"chr7","95787631","95787877","chr5","139318653","139318899","2","43531022"
"chr7","95866504","95866681","chr5","139396405","139396581","9","43529901"
"chr7","95866709","95866829","chr5","139396605","139396725","6","43529896"
"chr7","95942810","95943030","chr5","139483061","139483281","8","43540251"
"chr7","96039865","96040142","chr5","139583193","139583470","4","43543328"
"chr7","96046293","96046373","chr1","130442089","130442168","15","34395796"
"chr7","96110475","96110755","chr5","139652097","139652377","10","43541622"
"chr7","96203780","96204089","chr5","139746238","139746548","10","43542458"
"chr7","96213530","96213831","chr5","139755988","139756289","3","43542458"
"chr7","96282679","96282959","chr11","1748666","1748945","55","94534013"
"chr7","96402911","96403154","chr5","139947445","139947688","4","43544534"
"chr7","96413831","96414128","chr5","139960016","139960304","13","43546185"
"chr7","96416877","96417188","chr5","139963079","139963394","14","43546202"
"chr7","96426900","96427065","chr9","108993260","108993425","29","12566360"
"chr7","96448489","96448651","chr5","139994025","139994182","13","43545536"
"chr7","96517566","96517882","chr5","140063949","140064260","19","43546383"
"chr7","96572262","96572515","chr5","140119558","140119810","6","43547296"
"chr7","96591850","96591968","chr5","140139091","140139209","1","43547241"
"chr7","96593045","96593339","chr5","140140288","140140582","8","43547243"
"chr7","96596527","96596813","chr5","140143754","140144039","7","43547227"
"chr7","96601874","96602048","chr5","140149043","140149213","13","43547169"
"chr7","96602453","96602564","chr5","140149637","140149748","3","43547184"
"chr7","96603811","96604108","chr5","140150994","140151291","7","43547183"
"chr7","96606093","96606305","chr5","140153271","140153486","15","43547178"
"chr7","96606545","96606669","chr5","140153727","140153852","7","43547182"
"chr7","96608797","96609074","chr5","140156001","140156283","12","43547204"
"chr7","96615968","96616253","chr5","140163132","140163428","18","43547164"
"chr7","96633587","96633899","chr5","140181187","140181495","14","43547600"
"chr7","96638091","96638351","chr5","140185711","140185985","20","43547620"
"chr7","96640691","96640780","chr5","140188218","140188306","2","43547527"
"chr7","96640865","96641047","chr5","140188363","140188545","4","43547498"
"chr7","96669556","96669839","chr3","12644640","12644921","44","84024916"
"chr7","96674830","96674985","chr2","100069015","100069158","42","3394185"
"chr7","96784482","96784767","chr5","140332659","140332970","31","43548177"
"chr7","96812075","96812403","chr5","140360129","140360451","21","43548054"
"chr7","96814269","96814548","chr9","11986543","11986826","51","84827726"
"chr7","96821568","96821868","chr5","140369109","140369411","12","43547541"
"chr7","96832450","96832750","chr2","65066733","65067031","52","31765717"
"chr7","96838719","96838882","chr5","140386600","140386759","8","43547881"
"chr7","96846716","96847009","chr5","140395258","140395551","8","43548542"
"chr7","96870694","96870984","chr5","140419323","140419613","2","43548629"
"chr7","96888947","96889265","chr5","140437568","140437860","36","43548621"
"chr7","97012257","97012550","chr8","44115676","44115967","51","52896581"
"chr7","97034714","97034838","chrX","18215037","18215161","22","78819677"
"chr7","97046930","97047010","chr16","73575271","73575350","15","23471659"
"chr7","97048914","97049260","chr9","36975857","36976196","18","60073057"
"chr7","97125277","97125557","chr2","172936939","172937233","58","75811662"
"chr7","97145615","97145912","chr5","140481823","140482120","8","43336208"
"chr7","97201093","97201230","chr5","140538188","140538325","3","43337095"
"chr7","97201526","97201693","chr5","140538623","140538790","6","43337097"
"chr7","97205359","97205568","chr5","140542486","140542695","5","43337127"
"chr7","97211521","97211797","chr5","140555376","140555658","34","43343855"
"chr7","97230162","97230453","chr5","140573907","140574195","4","43343745"
"chr7","97246533","97246779","chr5","140593746","140593988","10","43347213"
"chr7","97283798","97284091","chr5","140630688","140630981","8","43346890"
"chr7","97284422","97284717","chr5","140631312","140631607","5","43346890"
"chr7","97311956","97312272","chr1","54547550","54547855","67","42764406"
"chr7","97318317","97318446","chr5","140665288","140665417","3","43346971"
"chr7","97321134","97321404","chr5","140668051","140668319","15","43346917"
"chr7","97333202","97333477","chr5","140679589","140679865","4","43346387"
"chr7","97344814","97345080","chr5","140698053","140698319","7","43353239"
"chr7","97357044","97357371","chr5","140709690","140709999","23","43352646"
"chr7","97357743","97357815","chr5","140710371","140710442","1","43352628"
"chr7","97357910","97358022","chr5","140710531","140710642","16","43352621"
"chr7","97359025","97359334","chr5","140711654","140711957","23","43352629"
"chr7","97362206","97362480","chr5","140714827","140715100","1","43352621"
"chr7","97385844","97386153","chr5","140738855","140739162","8","43353011"
"chr7","97433449","97433703","chr5","140788892","140789146","5","43355443"
"chr7","97479192","97479462","chr5","140834365","140834638","7","43355173"
"chr7","97494105","97494348","chr5","140849254","140849504","14","43355149"
"chr7","97505328","97505616","chr5","140861143","140861440","15","43355815"
"chr7","97529028","97529338","chr5","140887388","140887697","10","43358360"
"chr7","97529695","97529980","chr5","140888054","140888341","13","43358359"
"chr7","97563838","97564110","chr5","140921631","140921903","8","43357793"
"chr7","97568774","97569048","chr15","74288878","74289166","58","23279896"
"chr7","97581755","97581873","chr5","140941369","140941481","11","43359614"
"chr7","97581942","97582210","chr5","140941889","140942157","5","43359947"
"chr7","97610394","97610686","chr5","140970301","140970593","2","43359907"
"chr7","97616925","97617203","chr5","140976743","140977021","18","43359818"
"chr7","97621475","97621786","chr5","140981762","140982073","12","43360287"
"chr7","97628202","97628496","chr5","140988051","140988345","5","43359849"
"chr7","97630703","97631008","chr5","140990810","140991115","4","43360107"
"chr7","97639696","97639968","chr5","140998949","140999221","5","43359253"
"chr7","97644196","97644502","chr5","141003424","141003725","14","43359228"
"chr7","97645885","97646206","chr4","152226280","152226592","59","54580395"
"chr7","97651851","97652172","chr11","119858016","119858340","62","22206165"
"chr7","97653341","97653539","chr20","2647274","2647471","37","95006067"
"chr7","97667276","97667537","chr5","141016557","141016818","3","43349281"
"chr7","97669672","97669956","chr8","122724346","122724631","54","25054674"
"chr7","97672917","97672972","chr7","37971437","37971497","11","59701480"
"chr7","97673831","97674100","chr5","141021674","141021943","11","43347843"
"chr7","97674774","97674969","chr1","185069607","185069800","41","87394833"
"chr7","97691684","97691985","chr5","141039694","141039974","23","43348010"
"chr7","97697626","97697908","chr5","141045645","141045949","32","43348019"
"chr7","97703046","97703353","chr5","141050998","141051336","36","43347952"
"chr7","97708167","97708456","chr5","141056097","141056398","18","43347930"
"chr7","97713385","97713679","chr5","141061674","141061974","14","43348289"
"chr7","97714110","97714410","chr5","141062430","141062735","12","43348320"
"chr7","97718744","97719036","chr5","141067403","141067695","6","43348659"
"chr7","97720550","97720852","chr6","126561981","126562291","66","28841431"
"chr7","97721232","97721535","chr1","42348182","42348485","50","55373050"
"chr7","97733311","97733574","chr3","66373874","66374134","60","31359437"
"chr7","97743910","97744214","chr5","141093465","141093762","13","43349555"
"chr7","97751385","97751605","chr5","141103279","141103501","6","43351894"
"chr7","97751905","97751993","chr5","141103800","141103886","2","43351895"
"chr7","97755736","97756031","chr5","141107618","141107913","13","43351882"
"chr7","97757823","97758128","chr5","141110010","141110324","19","43352187"
"chr7","97785181","97785278","chr5","141136946","141137043","2","43351765"
"chr7","97787544","97787828","chr5","141139348","141139630","17","43351804"
"chr7","97808451","97808757","chr5","141160128","141160445","14","43351677"
"chr7","97814112","97814220","chr5","141165815","141165923","4","43351703"
"chr7","97814448","97814726","chr5","141166151","141166429","3","43351703"
"chr7","97838119","97838459","chr5","74479991","74480312","86","23358128"
"chr7","97848630","97848939","chr5","141200103","141200410","11","43351473"
"chr7","97858329","97858608","chr5","141209553","141209832","1","43351224"
"chr7","97877707","97877997","chr5","141230386","141230671","10","43352679"
"chr7","97911080","97911281","chr5","141266163","141266372","13","43355083"
"chr7","97917469","97917526","chr5","141272584","141272639","3","43355115"
"chr7","97917827","97917983","chr5","141272939","141273096","6","43355112"
"chr7","97926691","97926993","chr5","141281818","141282108","19","43355127"
"chr7","97945722","97946019","chr5","141301177","141301479","10","43355455"
"chr7","97961991","97962295","chr3","51622492","51622797","54","46339499"
"chr7","97968582","97968889","chr5","141325467","141325757","23","43356885"
"chr7","97970653","97970945","chr5","141327514","141327815","21","43356861"
"chr7","97976991","97977167","chr5","141333816","141333992","6","43356825"
"chr7","97982955","97983254","chr5","141339749","141340058","18","43356794"
"chr7","97988405","97988681","chr5","141345198","141345471","8","43356793"
"chr7","98065634","98065945","chr5","141422222","141422532","8","43356588"
"chr7","98096202","98096498","chr6","134251498","134251796","47","36155296"
"chr7","98107808","98108103","chr15","1865582","1865875","51","96242226"
"chr7","98109729","98110041","chr13","41851851","41852159","62","56257878"
"chr7","98117993","98118222","chr6","120061108","120061335","53","21943115"
"chr7","98152646","98152860","chr14","10106660","10106884","66","88045986"
"chr7","98189839","98190091","chr2","75550330","75550579","54","22639509"
"chr7","98239831","98240123","chr2","97022915","97023209","47","1216916"
"chr7","98320630","98320911","chr16","37963756","37964025","61","60356874"
"chr7","98340979","98341281","chr6","116678872","116679173","59","18337893"
"chr7","98403988","98404243","chr11","82356415","82356666","48","16047573"
"chr7","98472735","98472882","chr9","34264768","34264909","32","64207967"
"chr7","98545048","98545341","chr5","141499428","141499732","17","42954380"
"chr7","98589572","98589855","chr5","141543358","141543641","3","42953786"
"chr7","98847756","98848068","chr5","141801808","141802119","14","42954052"
"chr7","98862663","98862792","chr5","141816696","141816825","0","42954033"
"chr7","98874357","98874671","chr5","141828347","141828654","25","42953990"
"chr7","98875501","98875688","chr15","74074805","74075002","49","24800696"
"chr7","98879341","98879648","chr5","141833352","141833677","23","42954011"
"chr7","98886829","98887122","chr5","141840377","141840669","8","42953548"
"chr7","98951437","98951740","chr5","141906084","141906386","11","42954647"
"chr7","98978056","98978358","chr5","141932370","141932669","12","42954314"
"chr7","98981017","98981243","chr5","141935337","141935561","3","42954320"
"chr7","98996243","98996380","chr10","81313446","81313592","30","17682797"
"chr7","99017372","99017656","chr5","141968851","141969135","7","42951479"
"chr7","99023999","99024256","chr5","141975487","141975759","21","42951488"
"chr7","99045364","99045583","chr5","141996645","141996872","14","42951281"
"chr7","99055909","99056222","chr5","142003655","142003961","13","42947746"
"chr7","99067923","99068259","chr10","75779135","75779454","87","23288788"
"chr7","99070428","99070490","chr5","142018031","142018093","0","42947603"
"chr7","99079139","99079386","chr5","142026757","142027003","9","42947618"
"chr7","99087474","99087786","chr5","142035094","142035406","9","42947620"
"chr7","99115725","99116022","chr5","142063295","142063606","20","42947570"
"chr7","99123495","99123793","chr5","142071051","142071354","8","42947556"
"chr7","99124456","99124741","chr5","142072019","142072296","14","42947563"
"chr7","99177321","99177447","chr5","142125446","142125572","4","42948125"
"chr7","99177749","99177914","chr5","142125871","142126035","4","42948122"
"chr7","99182257","99182571","chr5","142130365","142130682","11","42948108"
"chr7","99194114","99194407","chr5","142142231","142142527","5","42948117"
"chr7","99203391","99203762","chr5","142151576","142151941","14","42948185"
"chr7","99227156","99227465","chr5","142175162","142175466","8","42948006"
"chr7","99263263","99263571","chr5","142211204","142211513","11","42947941"
"chr7","99266457","99266622","chr5","142214465","142214630","3","42948008"
"chr7","99273072","99273374","chr8","23731423","23731720","57","75541649"
"chr7","99280342","99280649","chr5","142228274","142228585","14","42947932"
"chr7","99282547","99282841","chr5","142230477","142230771","11","42947930"
"chr7","99283148","99283325","chr5","142231077","142231250","9","42947929"
"chr7","99283368","99283458","chr5","142231293","142231384","1","42947925"
"chr7","99295876","99296162","chr5","142243253","142243537","5","42947377"
"chr7","99296402","99296607","chr5","142243755","142243989","38","42947353"
"chr7","99299413","99299707","chr6","66008518","66008809","59","33290895"
"chr7","99302395","99302711","chr5","142249700","142250017","6","42947305"
"chr7","99303833","99303993","chr7","44069427","44069581","45","55234406"
"chr7","99313613","99313927","chr5","142260583","142260891","13","42946970"
"chr7","99329098","99329415","chr5","142275718","142276035","4","42946620"
"chr7","99375094","99375410","chr5","142320936","142321249","12","42945842"
"chr7","99375448","99375711","chr5","142321288","142321551","7","42945840"
"chr7","99424376","99424666","chr5","142373097","142373389","7","42948721"
"chr7","99451333","99451640","chr5","142399854","142400166","10","42948521"
"chr7","99485853","99486048","chr5","142436236","142436432","7","42950383"
"chr7","99503296","99503516","chr5","142453267","142453484","10","42949971"
"chr7","99531494","99531768","chr6","132233796","132234079","61","32702302"
"chr7","99531870","99532192","chr1","42401263","42401580","66","57130607"
"chr7","99551391","99551673","chr5","142500931","142501219","14","42949540"
"chr7","99578688","99578958","chr5","142528735","142529005","9","42950047"
"chr7","99592084","99592190","chr5","142541365","142541471","1","42949281"
"chr7","99613047","99613348","chr5","142565235","142565540","8","42952188"
"chr7","99647436","99647723","chr5","142603759","142604045","4","42956323"
"chr7","99666331","99666638","chr5","142623010","142623317","5","42956679"
"chr7","99667859","99667979","chr5","142624582","142624708","8","42956723"
"chr7","99668515","99668709","chr5","142625256","142625450","2","42956741"
"chr7","99681173","99681468","chr5","142637298","142637591","4","42956125"
"chr7","99698266","99698581","chr5","142655387","142655699","14","42957121"
"chr7","99709732","99710037","chr9","102340368","102340668","58","2630636"
"chr7","99711069","99711370","chr5","142667057","142667387","44","42955988"
"chr7","99715780","99716047","chr5","143530835","143531096","53","43815055"
"chr7","99726936","99727205","chr5","142682992","142683269","14","42956056"
"chr7","99737539","99737824","chr5","142694289","142694574","9","42956750"
"chr7","99741694","99741996","chr5","142698443","142698769","37","42956749"
"chr7","99748918","99749096","chr16","16639772","16639948","35","83109146"
"chr7","99749979","99750103","chr20","25579643","25579768","20","74170336"
"chr7","99750717","99750887","chr5","142707472","142707642","8","42956755"
"chr7","99756012","99756205","chr5","142713187","142713380","3","42957175"
"chr7","99760627","99760946","chr5","142717742","142718073","39","42957115"
"chr7","99768758","99769044","chr5","142726532","142726826","14","42957774"
"chr7","99770449","99770609","chr7","104612787","104612945","32","4842338"
"chr7","99779224","99779529","chr5","142736979","142737281","11","42957755"
"chr7","99784388","99784677","chr5","142742114","142742403","11","42957726"
"chr7","99786142","99786460","chr1","64360251","64360562","61","35425891"
"chr7","99793365","99793673","chr5","142750941","142751246","9","42957576"
"chr7","99795413","99795704","chr5","142752993","142753284","9","42957580"
"chr7","99801736","99802040","chr5","142759005","142759308","10","42957269"
"chr7","99813129","99813454","chr5","142770673","142770989","17","42957544"
"chr7","99815937","99816094","chr10","27501941","27502094","26","72313996"
"chr7","99816384","99816522","chr4","126174713","126174844","27","26358329"
"chr7","99821554","99821850","chr5","142778984","142779302","24","42957430"
"chr7","99826827","99827126","chr5","142784281","142784581","8","42957454"
"chr7","99827230","99827527","chrX","46852707","46853016","60","52974523"
"chr7","99828291","99828345","chr5","142785728","142785776","7","42957437"
"chr7","99828645","99828753","chr5","142786081","142786185","7","42957436"
"chr7","99831491","99831806","chr3","43023873","43024189","58","56807618"
"chr7","99847536","99847837","chr5","142805302","142805607","9","42957766"
"chr7","99848970","99849137","chr5","142806772","142806939","1","42957802"
"chr7","99872141","99872318","chr5","142829886","142830060","7","42957745"
"chr7","99888313","99888590","chr5","142846026","142846309","13","42957713"
"chr7","99905878","99906172","chr11","49468649","49468943","51","50437229"
"chr7","99912850","99913110","chr5","142869276","142869536","6","42956426"
"chr7","99933020","99933169","chr5","142888527","142888671","8","42955507"
"chr7","99933469","99933626","chr5","142888962","142889105","23","42955493"
"chr7","99939332","99939647","chr5","142894880","142895196","15","42955548"
"chr7","99944447","99944729","chr5","142900323","142900612","17","42955876"
"chr7","99946658","99946958","chr5","142902564","142902859","28","42955906"
"chr7","99951253","99951560","chr16","28819946","28820250","53","71131307"
"chr7","99957854","99958067","chr5","142914542","142914753","6","42956688"
"chr7","99967229","99967543","chr5","42865054","42865349","28","57102175"
"chr7","99971060","99971345","chr5","142928055","142928346","14","42956995"
"chr7","99977601","99977679","chr7","107031510","107031583","19","7053909"
"chr7","99977680","99977837","chr3","75948694","75948847","32","24028986"
"chr7","99979151","99979453","chr5","142935844","142936151","16","42956693"
"chr7","99980087","99980387","chr5","142936784","142937071","18","42956697"
"chr7","99982245","99982552","chr5","142939794","142940101","5","42957549"
"chr7","99986890","99987188","chr5","142943883","142944190","22","42956993"
"chr7","99990364","99990587","chr5","142947419","142947642","7","42957055"
"chr7","99997303","99997593","chr5","142954233","142954523","15","42956930"
"chr7","100005992","100006238","chr5","142963289","142963530","11","42957297"
"chr7","100015197","100015298","chr5","142971209","142971309","4","42956012"
"chr7","100018914","100019187","chr5","142977087","142977360","3","42958173"
"chr7","100036768","100037070","chr5","142994941","142995243","4","42958173"
"chr7","100038974","100039256","chr5","142997147","142997434","19","42958173"
"chr7","100046544","100046840","chr5","143005242","143005538","4","42958698"
"chr7","100051104","100051394","chr5","143009805","143010094","9","42958701"
"chr7","100054637","100054956","chr5","143013245","143013564","8","42958608"
"chr7","100056197","100056480","chr5","143014803","143015082","31","42958606"
"chr7","100062865","100063137","chr5","143021441","143021712","12","42958576"
"chr7","100063263","100063590","chr5","143021838","143022158","15","42958575"
"chr7","100064820","100065133","chr5","143023380","143023686","19","42958560"
"chr7","100070531","100070793","chr5","143029393","143029655","11","42958862"
"chr7","100118313","100118596","chr5","143076958","143077256","25","42958645"
"chr7","100126285","100126584","chr5","143084957","143085255","7","42958672"
"chr7","100132925","100133211","chr5","143091958","143092248","19","42959033"
"chr7","100133386","100133612","chr5","143092411","143092635","34","42959025"
"chr7","100151555","100151870","chr5","143110528","143110840","8","42958973"
"chr7","100152897","100152913","chr1","15674466","15674479","5","84478431"
"chr7","100159171","100159455","chr5","143118266","143118550","17","42959095"
"chr7","100161635","100161927","chr5","143120547","143120841","14","42958912"
"chr7","100193053","100193332","chr11","6443103","6443394","62","93749950"
"chr7","100195022","100195318","chr5","143153604","143153898","10","42958582"
"chr7","100198345","100198645","chr17","87562554","87562860","62","12635791"
"chr7","100227830","100228118","chr5","143186047","143186339","8","42958217"
"chr7","100262824","100263094","chr5","143220929","143221215","25","42958105"
"chr7","100285547","100285820","chr5","143243874","143244151","6","42958327"
"chr7","100293399","100293688","chr6","120271793","120272088","65","19978394"
"chr7","100316009","100316312","chr5","143273316","143273619","6","42957307"
"chr7","100361206","100361496","chr5","143317871","143318167","18","42956665"
"chr7","100366715","100367073","chr1","186432341","186432645","111","86065626"
"chr7","100481631","100481907","chr5","143428259","143428535","3","42946628"
"chr7","100521121","100521429","chr5","143467402","143467711","9","42946281"
"chr7","100526690","100527000","chr5","143472961","143473268","12","42946271"
"chr7","100576770","100576834","chr3","46215046","46215109","16","54361724"
"chr7","100576933","100577092","chr3","34083106","34083268","37","66493827"
"chr7","100584413","100584679","chr5","143530835","143531096","21","42946422"
"chr7","100624813","100625107","chr5","143571955","143572249","1","42947142"
"chr7","100640396","100640518","chr5","143593841","143593963","4","42953445"
"chr7","100661315","100661595","chr5","143614852","143615133","11","42953537"
"chr7","100664842","100664949","chr5","143618439","143618553","24","42953597"
"chr7","100722068","100722381","chr5","143675550","143675846","30","42953482"
"chr7","100899229","100899535","chr5","143848721","143849011","25","42949492"
"chr7","100982059","100982195","chr1","67664535","67664666","22","33317524"
"chr7","100993601","100993909","chr5","143942486","143942784","17","42948885"
"chr7","100998642","100998850","chr5","143947567","143947775","3","42948925"
"chr7","101032864","101033172","chr5","143981384","143981691","3","42948520"
"chr7","101052200","101052441","chr5","144001053","144001322","33","42948853"
"chr7","101077452","101077745","chr5","144026236","144026529","5","42948784"
"chr7","101101731","101101862","chr11","52821800","52821929","16","48279931"
"chr7","101101932","101102218","chrX","41457035","41457309","60","59644897"
"chr7","101120387","101120534","chr1","64229909","64230052","39","36890478"
"chr7","101120858","101121173","chr5","144072343","144072658","7","42951485"
"chr7","101142557","101142836","chr13","101505475","101505752","62","362918"
"chr7","101145320","101145617","chr5","144097226","144097523","11","42951906"
"chr7","101167479","101167797","chr5","144118354","144118672","7","42950875"
"chr7","101181696","101181959","chr5","144131984","144132241","14","42950288"
"chr7","101285762","101286100","chr5","144237694","144238009","35","42951932"
"chr7","101342559","101342728","chr5","144293837","144294008","7","42951278"
"chr7","101346699","101346789","chr5","144297987","144298077","4","42951288"
"chr7","101347070","101347356","chr5","144298359","144298647","6","42951289"
"chr7","101388295","101388583","chr16","16203886","16204175","67","85184409"
"chr7","101409262","101409565","chr5","144341980","144342277","11","42932718"
"chr7","101436212","101436457","chr5","144369719","144369964","5","42933507"
"chr7","101444351","101444629","chr5","144377856","144378132","13","42933505"
"chr7","101473344","101473631","chr5","144406827","144407116","15","42933483"
"chr7","101585415","101585546","chr5","144520586","144520725","22","42935171"
"chr7","101659060","101659356","chr5","144591136","144591431","6","42932076"
"chr7","101804129","101804357","chr5","144724887","144725115","5","42920758"
"chr7","101899561","101899872","chr5","144815593","144815901","24","42916032"
"chr7","101914603","101914904","chr5","144830593","144830894","4","42915990"
"chr7","101958073","101958241","chr5","144874414","144874582","5","42916341"
"chr7","101960132","101960473","chr5","144876692","144877007","35","42916560"
"chr7","102006310","102006529","chr5","144922385","144922611","15","42916075"
"chr7","102030442","102030756","chr5","144951438","144951748","19","42920996"
"chr7","102060884","102061060","chr5","144982455","144982631","8","42921571"
"chr7","102074418","102074634","chr7","138784541","138784755","49","36710123"
"chr7","102190915","102191170","chr5","145108860","145109119","10","42917945"
"chr7","102197735","102198040","chr5","145115493","145115801","12","42917758"
"chr7","102277786","102278082","chr5","145195860","145196163","24","42918074"
"chr7","102348896","102349200","chr5","145267442","145267746","7","42918546"
"chr7","102352725","102352866","chr5","145271284","145271421","21","42918559"
"chr7","102428884","102429184","chr5","145347115","145347416","10","42918231"
"chr7","102435142","102435259","chr5","145353042","145353159","2","42917900"
"chr7","102518886","102519128","chr5","145437734","145437976","5","42918848"
"chr7","102529317","102529615","chr5","145448623","145448921","7","42919306"
"chr7","102615892","102616152","chr5","145534671","145534931","10","42918779"
"chr7","102819363","102819418","chr3","44206791","44206831","20","58612572"
"chr7","102819484","102819763","chr5","145733324","145733603","5","42913840"
"chr7","102956867","102957173","chr5","145867279","145867585","12","42910412"
"chr7","103040657","103040738","chr5","145950908","145951005","17","42910251"
"chr7","103128644","103128948","chr5","146040905","146041209","14","42912261"
"chr7","103274291","103274583","chr5","146189379","146189643","35","42915088"
"chr7","103407121","103407407","chr15","79040659","79040951","68","24366462"
"chr7","103410962","103411191","chr5","146326269","146326499","7","42915307"
"chr7","103445598","103445908","chr5","146361762","146362073","13","42916164"
"chr7","103467093","103467381","chr5","146383157","146383435","22","42916064"
"chr7","103480139","103480436","chr5","146393403","146393715","35","42913264"
"chr7","103490909","103491223","chr5","146404677","146404989","10","42913768"
"chr7","103491593","103491737","chr5","146405359","146405503","5","42913766"
"chr7","103492045","103492212","chr5","146405797","146405936","31","42913752"
"chr7","103517358","103517651","chr5","146431417","146431720","21","42914059"
"chr7","103554791","103555097","chr5","146468368","146468674","4","42913577"
"chr7","103630718","103631025","chr5","146543054","146543360","7","42912336"
"chr7","103659301","103659507","chr5","146572448","146572658","17","42913147"
"chr7","103662924","103663219","chr5","146576049","146576349","13","42913125"
"chr7","103682693","103682991","chr15","7952627","7952915","63","95730066"
"chr7","103838105","103838162","chr1","100928185","100928237","12","2909920"
"chr7","103838561","103838667","chr4","19612557","19612660","28","84226004"
"chr7","103842767","103843065","chr5","146756376","146756672","14","42913609"
"chr7","104144988","104145271","chr5","147054759","147055042","2","42909771"
"chr7","104320474","104320604","chr5","147233501","147233631","17","42913027"
"chr7","104426273","104426590","chr5","147344959","147345276","6","42918686"
"chr7","104590636","104590817","chr5","147514850","147515031","1","42924214"
"chr7","104655781","104655892","chr1","101398759","101398868","20","3257022"
"chr7","104655935","104656078","chr8","21286698","21286843","26","83369237"
"chr7","104676691","104676990","chr5","147599497","147599805","19","42922806"
"chr7","104723561","104723848","chr5","147646199","147646503","25","42922638"
"chr7","104969569","104969856","chr1","92624846","92625115","65","12344723"
"chr7","105013135","105013421","chr5","147933990","147934269","18","42920855"
"chr7","105057162","105057461","chr5","147970732","147971028","15","42913570"
"chr7","105086051","105086350","chr5","148009356","148009657","6","42923305"
"chr7","105087073","105087363","chr5","148010366","148010672","23","42923293"
"chr7","105102861","105103163","chr5","148027154","148027456","4","42924293"
"chr7","105141973","105142265","chr5","148066022","148066295","24","42924049"
"chr7","105146394","105146655","chr16","7473447","7473690","76","97672947"
"chr7","105151168","105151386","chr5","148075213","148075417","18","42924045"
"chr7","105153489","105153804","chr5","148077539","148077825","38","42924050"
"chr7","105182737","105183019","chr5","148107880","148108160","13","42925143"
"chr7","105198318","105198460","chr5","148123449","148123592","6","42925131"
"chr7","105200019","105200183","chr5","148125147","148125321","11","42925128"
"chr7","105217629","105217939","chr5","148142688","148142996","10","42925059"
"chr7","105226243","105226510","chr5","148151877","148152143","8","42925634"
"chr7","105249139","105249437","chr5","148174721","148175030","13","42925582"
"chr7","105254581","105254739","chrX","61049663","61049821","30","44204918"
"chr7","105254769","105254885","chr1","48746228","48746346","19","56508541"
"chr7","105268344","105268468","chr5","148193942","148194066","3","42925598"
"chr7","105268806","105268976","chr5","148194407","148194588","14","42925601"
"chr7","105269315","105269432","chr5","148194921","148195038","2","42925606"
"chr7","105281022","105281295","chr5","148206689","148206977","22","42925667"
"chr7","105281650","105281956","chr5","148207351","148207635","34","42925701"
"chr7","105282862","105283139","chr5","148208540","148208815","7","42925678"
"chr7","105285869","105286153","chr5","148211471","148211756","5","42925602"
"chr7","105287830","105288125","chr5","148213434","148213728","5","42925604"
"chr7","105299342","105299603","chr8","86607933","86608182","61","18691409"
"chr7","105301397","105301693","chr5","148227099","148227385","29","42925702"
"chr7","105303065","105303370","chr5","148228755","148229060","7","42925690"
"chr7","105318698","105318868","chr12","13545297","13545464","31","91773401"
"chr7","105318898","105319028","chr8","137409080","137409200","28","32090182"
"chr7","105332269","105332425","chr5","148257183","148257336","7","42924914"
"chr7","105334437","105334750","chr11","128134834","128135111","87","22800397"
"chr7","105337707","105338009","chr5","148262644","148262948","5","42924937"
"chr7","105362329","105362586","chr5","148287230","148287484","13","42924901"
"chr7","105362657","105362965","chr5","148287567","148287871","31","42924910"
"chr7","105378585","105378853","chr5","148303287","148303589","37","42924702"
"chr7","105398095","105398381","chr5","148322787","148323081","12","42924692"
"chr7","105404542","105404840","chr5","148329228","148329526","7","42924686"
"chr7","105417887","105418039","chr5","148342904","148343056","4","42925017"
"chr7","105429466","105429761","chr5","148355576","148355878","14","42926110"
"chr7","105465874","105466148","chr19","12162251","12162528","59","93303623"
"chr7","105484712","105484996","chr4","71328882","71329172","57","34155830"
"chr7","105494076","105494367","chr5","148419446","148419737","17","42925370"
"chr7","105499349","105499637","chr5","148424731","148425000","22","42925382"
"chr7","105506270","105506573","chr5","148431643","148431934","19","42925373"
"chr7","105526752","105526981","chr1","152007535","152007757","43","46480783"
"chr7","105532456","105532793","chr5","148460782","148461143","32","42928326"
"chr7","105534886","105534989","chr5","148463280","148463383","1","42928394"
"chr7","105535316","105535610","chr5","148463710","148464010","13","42928394"
"chr7","105550790","105551083","chr5","148479158","148479450","7","42928368"
"chr7","105552976","105553285","chr5","148481339","148481649","10","42928363"
"chr7","105561787","105562041","chr5","148490169","148490423","5","42928382"
"chr7","105568799","105569069","chr5","148499332","148499602","6","42930533"
"chr7","105580288","105580576","chr5","148510821","148511115","19","42930533"
"chr7","105583253","105583549","chr5","148513789","148514085","5","42930536"
"chr7","105585538","105585836","chr5","148516082","148516319","70","42930544"
"chr7","105588403","105588615","chr5","148518871","148519081","6","42930468"
"chr7","105593738","105594030","chr5","148524177","148524479","23","42930439"
"chr7","105594146","105594420","chr5","148524594","148524870","10","42930448"
"chr7","105594810","105595125","chr5","148525268","148525578","20","42930458"
"chr7","105602821","105603128","chr5","148533253","148533558","9","42930432"
"chr7","105607026","105607326","chr5","148537465","148537764","13","42930439"
"chr7","105608956","105609123","chr13","7960128","7960302","31","97648828"
"chr7","105610939","105611226","chrX","120356258","120356539","57","14745319"
"chr7","105611554","105611711","chr5","148542011","148542152","19","42930457"
"chr7","105611838","105611977","chr5","148542275","148542409","9","42930437"
"chr7","105652877","105653144","chr5","148582010","148582280","9","42929133"
"chr7","105657138","105657453","chr5","148586285","148586590","15","42929147"
"chr7","105666993","105667298","chr5","148596136","148596431","18","42929143"
"chr7","105668955","105669105","chr19","11481676","11481817","41","94187279"
"chr7","105674187","105674490","chr1","203490003","203490305","63","97815816"
"chr7","105677543","105677842","chr5","148606800","148607112","18","42929257"
"chr7","105687779","105687968","chr5","148617029","148617205","18","42929250"
"chr7","105700682","105700918","chr5","148629953","148630193","5","42929271"
"chr7","105724637","105724939","chr5","148654313","148654614","7","42929676"
"chr7","105761165","105761465","chr5","148691539","148691832","17","42930374"
"chr7","105784370","105784636","chr5","148715122","148715387","12","42930752"
"chr7","105816077","105816364","chr5","148746742","148747029","13","42930665"
"chr7","105898044","105898373","chr5","148828581","148828906","13","42930537"
"chr7","105901094","105901399","chr5","148831330","148831632","18","42930236"
"chr7","105920140","105920288","chr5","148857061","148857206","10","42936921"
"chr7","105920574","105920743","chr5","148857493","148857668","9","42936919"
"chr7","105945389","105945505","chr5","148880489","148880603","5","42935100"
"chr7","105949543","105949832","chr5","148884709","148884998","12","42935166"
"chr7","105972170","105972394","chr5","148902453","148902679","15","42930283"
"chr7","105990577","105990686","chr5","148921341","148921451","3","42930764"
"chr7","106016874","106017041","chr5","148947320","148947493","10","42930446"
"chr7","106174153","106174441","chr5","149108247","149108535","3","42934094"
"chr7","106225492","106225781","chr5","149163527","149163816","4","42938035"
"chr7","106264577","106264871","chr5","149202163","149202459","11","42937586"
"chr7","106271839","106272046","chr11","53010715","53010885","41","53261124"
"chr7","106414552","106414708","chr11","48844804","48844952","41","57569748"
"chr7","106414739","106414857","chrX","108971246","108971363","17","2556507"
"chr7","106438329","106438431","chr3","104398658","104398757","22","2039671"
"chr7","106523033","106523250","chr20","49637070","49637275","54","56885963"
"chr7","106523378","106523490","chr5","149483275","149483388","8","42959897"
"chr7","106683987","106684296","chr5","149638290","149638586","25","42954303"
"chr7","106739354","106739426","chr1","34800369","34800443","14","71938985"
"chr7","106746116","106746273","chrX","242080","242227","35","106504036"
"chr7","106959915","106960223","chr5","149911551","149911859","0","42951636"
"chr7","106967892","106968072","chr5","149919402","149919582","3","42951510"
"chr7","106968528","106968566","chr5","149920038","149920076","0","42951510"
"chr7","107005413","107005551","chr1","1658615","1658747","22","105346798"
"chr7","107196693","107196997","chr5","150154351","150154646","15","42957658"
"chr7","107214006","107214305","chr5","150171370","150171672","18","42957364"
"chr7","107349871","107350049","chr11","6594238","6594411","39","100755633"
"chr7","107350080","107350193","chr8","10039828","10039947","20","97310252"
"chr7","107433089","107433391","chr5","150387660","150387975","30","42954571"
"chr7","107465566","107465871","chr5","150419395","150419709","16","42953829"
"chr7","107467242","107467419","chr5","150421072","150421247","6","42953830"
"chr7","107467626","107467705","chr5","150421483","150421566","6","42953857"
"chr7","107651459","107651761","chr7","41760086","41760391","72","65891373"
"chr7","107671563","107671866","chr5","150619662","150619965","10","42948099"
"chr7","107811802","107812088","chr5","150763117","150763427","48","42951315"
"chr7","107927244","107927521","chr5","150872139","150872421","16","42944895"
"chr7","108177382","108177478","chr2","167865659","167865757","26","59688277"
"chr7","108181523","108181798","chr5","151127561","151127835","11","42946038"
"chr7","108348662","108348918","chr5","151299291","151299537","14","42950629"
"chr7","108361859","108362147","chr5","151313408","151313725","40","42951549"
"chr7","108515143","108515428","chr5","151472912","151473199","16","42957769"
"chr7","108548185","108548513","chr5","151510441","151510765","19","42962256"
"chr7","108835544","108835832","chr5","151805086","151805373","11","42969542"
"chr7","108842805","108842959","chr16","45439753","45439906","37","63403052"
"chr7","108974138","108974430","chr5","151943490","151943782","10","42969352"
"chr7","109099465","109099756","chr20","29034428","29034722","69","80065037"
"chr7","109129294","109129590","chr5","152115464","152115764","23","42986170"
"chr7","109136695","109136822","chr5","152119881","152120008","5","42983186"
"chr7","109139899","109140213","chr5","152123010","152123323","9","42983111"
"chr7","109270526","109270830","chr5","152254439","152254740","9","42983913"
"chr7","109492783","109493085","chr5","152479508","152479810","14","42986725"
"chr7","109520367","109520661","chr11","50111767","50112072","71","59408600"
"chr7","109529141","109529450","chr5","152517296","152517602","13","42988155"
"chr7","109538014","109538312","chr5","152526388","152526686","3","42988374"
"chr7","109574918","109575162","chr5","152564996","152565238","12","42990078"
"chr7","109660484","109660781","chr5","152651551","152651848","9","42991067"
"chr7","109675629","109675764","chr11","113687831","113687962","25","4012202"
"chr7","109675923","109676074","chr5","152667217","152667369","2","42991294"
"chr7","109696236","109696549","chr5","152688122","152688435","12","42991886"
"chr7","109707812","109708119","chr5","152700097","152700416","17","42992285"
"chr7","109709636","109709937","chr5","152702076","152702358","28","42992440"
"chr7","109727871","109728185","chr5","152720333","152720612","42","42992462"
"chr7","109756528","109756863","chr5","152747669","152748004","7","42991141"
"chr7","109893150","109893453","chr5","152884593","152884897","8","42991443"
"chr7","109991139","109991457","chr5","152982866","152983186","15","42991727"
"chr7","109997564","109997854","chr5","152989233","152989521","17","42991669"
"chr7","110153049","110153363","chr5","153151556","153151870","11","42998507"
"chr7","110155416","110155638","chr5","153153513","153153726","19","42998097"
"chr7","110157514","110157805","chr5","153155609","153155903","13","42998095"
"chr7","110157945","110158034","chr7","124228351","124228440","18","14070406"
"chr7","110171300","110171585","chr5","153170358","153170648","7","42999058"
"chr7","110312143","110312430","chr5","153315272","153315559","8","43003129"
"chr7","110444470","110444735","chr5","153453724","153453989","7","43009254"
"chr7","110509435","110509743","chr5","153518285","153518598","15","43008850"
"chr7","110522537","110522822","chr5","153531412","153531697","11","43008875"
"chr7","110569820","110570122","chr5","153578498","153578798","10","43008678"
"chr7","110619280","110619502","chr8","5809101","5809306","68","104810179"
"chr7","110639888","110639953","chr5","153649293","153649358","0","43009405"
"chr7","110640387","110640472","chr5","153649789","153649874","4","43009402"
"chr7","110682720","110683012","chr5","153691618","153691910","7","43008898"
"chr7","110703117","110703370","chr5","153714334","153714544","45","43011217"
"chr7","110742779","110742948","chrX","49524523","49524692","32","61218256"
"chr7","110743291","110743417","chr5","153753147","153753281","14","43009856"
"chr7","110771308","110771432","chr5","153786599","153786723","2","43015291"
"chr7","110858417","110858729","chr5","153871770","153872083","3","43013353"
"chr7","110934225","110934535","chr4","152226280","152226592","65","41292055"
"chr7","111009184","111009478","chr5","154029832","154030129","10","43020648"
"chr7","111010455","111010679","chr5","154031119","154031341","8","43020664"
"chr7","111060200","111060368","chr5","154081729","154081888","12","43021529"
"chr7","111067690","111068006","chr5","154089198","154089512","16","43021508"
"chr7","111108594","111108881","chr5","154127720","154128007","8","43019126"
"chr7","111142002","111142206","chr5","154161449","154161653","3","43019447"
"chr7","111184330","111184590","chr5","154204517","154204777","3","43020187"
"chr7","111187102","111187415","chr4","152226280","152226592","56","41039178"
"chr7","111199749","111200055","chr5","154222069","154222377","11","43022320"
"chr7","111203324","111203631","chr2","156021378","156021680","65","44818054"
"chr7","111205519","111205638","chr5","154225170","154225289","4","43019651"
"chr7","111217914","111218193","chr15","85088216","85088484","75","26129698"
"chr7","111223413","111223532","chr5","154246006","154246125","2","43022593"
"chr7","111229484","111229781","chr5","154252704","154252997","9","43023220"
"chr7","111237459","111237696","chr15","5787628","5787863","46","105449831"
"chr7","111244829","111245124","chr5","154269009","154269305","13","43024180"
"chr7","111252157","111252301","chr5","154277045","154277189","2","43024888"
"chr7","111252611","111252776","chr5","154277498","154277661","6","43024887"
"chr7","111255484","111255853","chr13","16852127","16852474","93","94403357"
"chr7","111269592","111269869","chr5","154292282","154292559","4","43022690"
"chr7","111276081","111276373","chr11","123142937","123143237","52","11866856"
"chr7","111286624","111286920","chr5","154309654","154309965","20","43023030"
"chr7","111294166","111294495","chr2","167003436","167003758","72","55709270"
"chr7","111347651","111347872","chr5","154373487","154373703","7","43025836"
"chr7","111354368","111354468","chrX","19157099","19157207","19","92197269"
"chr7","111356513","111356643","chr7","161032610","161032742","33","49676097"
"chr7","111357424","111357730","chr4","43768849","43769156","61","67588575"
"chr7","111386852","111387080","chr5","154412500","154412727","8","43025648"
"chr7","111388221","111388523","chr16","41646409","41646710","64","69741812"
"chr7","111403200","111403409","chr1","208497238","208497433","54","97094038"
"chr7","111405508","111405810","chr5","154431991","154432284","19","43026483"
"chr7","111406087","111406229","chr5","154432561","154432708","11","43026474"
"chr7","111406232","111406298","chr4","35877984","35878045","14","75528248"
"chr7","111410150","111410272","chr4","65813127","65813256","33","45597023"
"chr7","111422163","111422459","chrX","46046489","46046783","63","65375674"
"chr7","111428042","111428353","chr5","154451589","154451901","23","43023547"
"chr7","111448345","111448625","chr5","154476041","154476343","33","43027696"
"chr7","111452435","111452710","chr5","154472280","154472555","8","43019845"
"chr7","111466689","111466997","chr5","154494621","154494904","45","43027932"
"chr7","111482427","111482684","chr5","154510344","154510623","33","43027917"
"chr7","111488703","111488745","chr13","69093673","69093711","14","42395030"
"chr7","111488800","111489056","chr5","154516724","154516990","16","43027924"
"chr7","111511917","111511933","chr6","72760333","72760347","3","38751584"
"chr7","111511984","111512252","chr5","154540845","154541136","32","43028861"
"chr7","111521342","111521620","chr5","154550539","154550819","14","43029197"
"chr7","111534123","111534380","chr1","49638195","49638449","59","61895928"
"chr7","111558400","111558601","chr5","154586802","154587000","7","43028402"
"chr7","111600856","111601166","chr5","154629457","154629750","25","43028601"
"chr7","111651550","111651837","chr5","154678649","154678952","18","43027099"
"chr7","111691964","111692278","chr5","154719498","154719805","14","43027534"
"chr7","111706971","111707218","chr5","154733747","154733977","26","43026776"
"chr7","111729448","111729761","chr5","154756182","154756492","17","43026734"
"chr7","111765113","111765467","chr5","154792297","154792655","20","43027184"
"chr7","111797552","111797867","chr5","154825526","154825799","49","43027974"
"chr7","111800443","111800721","chr5","154828432","154828712","8","43027989"
"chr7","111814584","111814892","chr9","32668102","32668409","52","79146482"
"chr7","111821786","111822053","chr5","154847643","154847910","5","43025857"
"chr7","111871101","111871391","chr5","154896679","154896973","10","43025578"
"chr7","111892360","111892558","chr5","154919535","154919733","2","43027175"
"chr7","112028472","112028566","chr6","133011443","133011533","17","20982971"
"chr7","112238804","112239096","chr5","155275638","155275926","18","43036834"
"chr7","112268249","112268552","chr5","155305401","155305703","15","43037152"
"chr7","112273760","112274074","chr5","155310874","155311192","8","43037114"
"chr7","112279595","112279903","chr5","155316639","155316947","7","43037044"
"chr7","112340935","112341265","chr5","155381789","155382143","31","43040854"
"chr7","112427896","112428200","chr5","155513540","155513844","4","43085644"
"chr7","112495134","112495445","chr5","155583809","155584120","8","43088675"
"chr7","112544458","112544741","chr5","155634003","155634286","4","43089545"
"chr7","112882177","112882470","chr5","155970614","155970910","6","43088437"
"chr7","112896881","112897189","chr5","155985057","155985355","18","43088176"
"chr7","112941187","112941497","chr5","156032016","156032325","6","43090829"
"chr7","112980285","112980626","chr5","156070236","156070567","20","43089951"
"chr7","113116464","113116715","chr5","156204769","156205024","8","43088305"
"chr7","113131433","113131551","chr5","156219749","156219867","0","43088316"
"chr7","113300268","113300551","chr5","156389808","156390091","12","43089540"
"chr7","113408839","113409128","chr5","156499572","156499862","8","43090733"
"chr7","113418187","113418407","chr5","156508555","156508790","21","43090368"
"chr7","113632034","113632150","chr5","156722584","156722700","6","43090550"
"chr7","113762408","113762723","chr5","156854370","156854685","8","43091962"
"chr7","113846118","113846407","chr5","156940306","156940597","11","43094188"
"chr7","113865412","113865700","chr5","156959048","156959333","15","43093636"
"chr7","114042428","114042719","chr5","157146836","157147143","34","43104408"
"chr7","114082320","114082605","chr5","157189292","157189572","15","43106972"
"chr7","114127740","114127993","chr5","157236455","157236706","9","43108715"
"chr7","114248536","114248824","chr5","157351770","157352059","10","43103234"
"chr7","114259992","114260291","chr5","157363283","157363584","15","43103291"
"chr7","114298903","114299114","chr5","157394376","157394587","5","43095473"
"chr7","114337026","114337333","chr5","157429837","157430144","5","43092811"
"chr7","114377409","114377715","chr5","157473696","157474002","4","43096287"
"chr7","114468034","114468062","chr14","91253588","91253617","4","23214446"
"chr7","114468127","114468407","chr7","88399041","88399321","55","26069086"
"chr7","114564115","114564414","chr5","157669135","157669434","9","43105020"
"chr7","114625885","114626175","chr5","157729527","157729817","8","43103642"
"chr7","114654314","114654396","chr5","157758211","157758300","9","43103897"
"chr7","114704347","114704647","chr5","157807670","157807970","4","43103323"
"chr7","114731811","114731901","chr5","157834887","157834973","4","43103076"
"chr7","114805548","114805822","chr5","157908470","157908744","6","43102922"
"chr7","114810838","114811107","chr5","157913773","157914059","26","43102935"
"chr7","114812188","114812482","chr5","157915166","157915460","4","43102978"
"chr7","114857642","114857940","chr5","157960027","157960325","6","43102385"
"chr7","114921390","114921688","chr5","158025587","158025888","10","43104197"
"chr7","114928037","114928350","chr5","158030832","158031149","16","43102795"
"chr7","114970328","114970599","chr5","158072869","158073140","8","43102541"
"chr7","114997734","114998003","chr5","158103296","158103593","33","43105562"
"chr7","115006015","115006326","chr5","158112426","158112737","8","43106411"
"chr7","115040411","115040593","chr3","42298682","42298860","41","72741729"
"chr7","115040915","115040969","chr1","21501026","21501077","12","93539889"
"chr7","115054140","115054214","chr6","8905671","8905741","15","106148469"
"chr7","115056814","115056956","chr5","158162072","158162213","7","43105258"
"chr7","115057234","115057388","chr5","158162491","158162641","8","43105257"
"chr7","115063940","115064249","chr5","158169178","158169446","48","43105238"
"chr7","115069045","115069356","chr5","158174121","158174418","19","43105076"
"chr7","115070508","115070813","chr5","158175543","158175846","11","43105035"
"chr7","115084656","115084940","chr5","158189130","158189437","29","43104474"
"chr7","115098804","115099003","chr13","9478636","9478844","45","105620168"
"chr7","115104875","115105159","chr5","158207626","158207930","33","43102751"
"chr7","115108030","115108331","chr3","72193809","72194121","64","42914221"
"chr7","115108545","115108823","chr5","158211309","158211593","14","43102764"
"chr7","115147959","115148266","chr18","38235496","38235800","61","76912463"
"chr7","115160976","115161267","chr5","158263391","158263682","6","43102415"
"chr7","115198401","115198558","chr5","158299062","158299220","3","43100661"
"chr7","115198604","115198725","chr5","158299253","158299374","2","43100649"
"chr7","115203379","115203676","chr5","158308131","158308418","23","43104752"
"chr7","115222538","115222689","chr1","34052300","34052451","28","81170238"
"chr7","115223053","115223186","chr2","172227852","172227991","29","57004799"
"chr7","115226676","115226963","chr17","11480634","11480920","53","103746042"
"chr7","115233715","115233861","chr5","158348181","158348328","5","43114466"
"chr7","115248848","115249172","chr5","158364552","158364876","4","43115704"
"chr7","115251242","115251373","chr6","167269323","167269454","22","52018081"
"chr7","115257343","115257655","chr5","158373018","158373336","13","43115675"
"chr7","115293502","115293803","chr5","158409422","158409723","13","43115920"
"chr7","115307048","115307190","chr5","158423070","158423206","12","43116022"
"chr7","115335201","115335489","chr5","158451592","158451880","7","43116391"
"chr7","115345885","115346204","chr5","158462335","158462652","24","43116450"
"chr7","115367247","115367309","chr5","158483467","158483529","2","43116220"
"chr7","115400764","115400932","chr1","114596902","114597067","42","803862"
"chr7","115405103","115405220","chr5","158521309","158521426","1","43116206"
"chr7","115445608","115445802","chr16","51676093","51676284","43","63769515"
"chr7","115445836","115445948","chr13","40661290","40661406","23","74784546"
"chr7","115451646","115451922","chr5","158568000","158568276","10","43116354"
"chr7","115452680","115452986","chr11","30468161","30468469","54","84984519"
"chr7","115473975","115474275","chr5","158593440","158593741","7","43119465"
"chr7","115494935","115495010","chr5","158614399","158614472","6","43119464"
"chr7","115510035","115510323","chr5","158629859","158630147","9","43119824"
"chr7","115519623","115519915","chr5","158639825","158640139","28","43120202"
"chr7","115525499","115525706","chr5","158646034","158646248","23","43120535"
"chr7","115562661","115562961","chr5","158684203","158684493","21","43121542"
"chr7","115580172","115580433","chr5","158702061","158702350","36","43121889"
"chr7","115601058","115601366","chr16","31900810","31901113","62","83700248"
"chr7","115608801","115609109","chr5","50326113","50326424","56","65282688"
"chr7","115625560","115625866","chr5","158736542","158736859","17","43110982"
"chr7","115634611","115634675","chr5","158745627","158745680","12","43111016"
"chr7","115641988","115642243","chr5","158752966","158753222","5","43110978"
"chr7","115670226","115670452","chr5","158781209","158781448","19","43110983"
"chr7","115675060","115675385","chr5","158786548","158786865","15","43111488"
"chr7","115685715","115685847","chr5","158799585","158799717","4","43113870"
"chr7","115685922","115686128","chr5","158799792","158800006","15","43113870"
"chr7","115707626","115707962","chr5","158821270","158821596","14","43113644"
"chr7","115742464","115742746","chr5","158857158","158857461","25","43114694"
"chr7","115765473","115765786","chr5","158881094","158881408","14","43115621"
"chr7","115776558","115776853","chr5","158890157","158890461","21","43113599"
"chr7","115781690","115781998","chr5","158895467","158895761","22","43113777"
"chr7","115788771","115789075","chr5","158902887","158903190","5","43114116"
"chr7","115791845","115792146","chr5","158905953","158906254","8","43114108"
"chr7","115807213","115807500","chr5","158921246","158921535","5","43114033"
"chr7","115820972","115821334","chr5","158935074","158935422","20","43114102"
"chr7","115849131","115849464","chr5","158961628","158961968","16","43112497"
"chr7","115850188","115850450","chr5","158962682","158962956","17","43112494"
"chr7","115853780","115854071","chr5","158966275","158966567","8","43112495"
"chr7","115856491","115856802","chr5","158968982","158969289","13","43112491"
"chr7","115881478","115881765","chr5","158994830","158995114","12","43113352"
"chr7","115915615","115915903","chr5","159029099","159029391","10","43113484"
"chr7","115927153","115927411","chr5","159040620","159040879","2","43113467"
"chr7","115931556","115931819","chr5","159045021","159045282","12","43113465"
"chr7","115972447","115972747","chr11","125705007","125705304","54","9732560"
"chr7","115985257","115985445","chr10","13014839","13015026","49","102970418"
"chr7","116024301","116024622","chr5","159126734","159127047","15","43102433"
"chr7","116100321","116100631","chr2","78493440","78493742","70","37606881"
"chr7","116133487","116133761","chr5","159241703","159241992","23","43108216"
"chr7","116146004","116146300","chr5","159254305","159254593","17","43108301"
"chr7","116168610","116168909","chr7","117495092","117495393","59","1326482"
"chr7","116175209","116175508","chr5","159278871","159279169","7","43103662"
"chr7","116208294","116208578","chr5","159312835","159313119","9","43104541"
"chr7","116246217","116246444","chr11","47134079","47134301","47","69112138"
"chr7","116256427","116256709","chr5","159360491","159360779","9","43104064"
"chr7","116283142","116283428","chr5","130981767","130982041","82","14698625"
"chr7","116303997","116304294","chr5","159407990","159408287","4","43103993"
"chr7","116315481","116315784","chr5","159419538","159419841","2","43104057"
"chr7","116394944","116395249","chr5","159498937","159499237","13","43103993"
"chr7","116413761","116414039","chr5","159516955","159517234","9","43103194"
"chr7","116523756","116524069","chr5","159630804","159631117","7","43107048"
"chr7","116538852","116539142","chr5","159650481","159650753","24","43111629"
"chr7","116556675","116556973","chr5","159668268","159668576","19","43111593"
"chr7","116748866","116749171","chr5","159906157","159906469","14","43157291"
"chr7","116864526","116864811","chr5","160021910","160022193","12","43157384"
"chr7","117068658","117068969","chr5","160229011","160229334","23","43160353"
"chr7","117111775","117112005","chr5","160270345","160270575","12","43158570"
"chr7","117213873","117214189","chr5","160367963","160368272","17","43154090"
"chr7","117247751","117248037","chr5","160401939","160402224","15","43154188"
"chr7","117553690","117553983","chr5","160722508","160722801","14","43168818"
"chr7","117617717","117618000","chr5","160785017","160785296","13","43167300"
"chr7","117628223","117628450","chr5","160795252","160795489","30","43167029"
"chr7","117664063","117664375","chr5","160831045","160831358","10","43166982"
"chr7","117778960","117779249","chr5","160948275","160948562","12","43169315"
"chr7","117793639","117793934","chr5","160963608","160963900","8","43169969"
"chr7","117848117","117848424","chr5","161018965","161019264","20","43170848"
"chr7","117878409","117878711","chr5","161056148","161056452","12","43177739"
"chr7","117891810","117892103","chr7","24667258","24667557","68","93224552"
"chr7","117909668","117909976","chr5","161092155","161092442","42","43182487"
"chr7","118030492","118030793","chr5","161213356","161213651","12","43182864"
"chr7","118050051","118050337","chr5","161232811","161233101","16","43182760"
"chr7","118066088","118066366","chr5","161250623","161250901","13","43184535"
"chr7","118071398","118071692","chr5","161255945","161256239","20","43184547"
"chr7","118093559","118093848","chr5","161278030","161278319","17","43184471"
"chr7","118120936","118121086","chr16","8801720","8801866","31","109319216"
"chr7","118137649","118137948","chr5","161318600","161318905","10","43180951"
"chr7","118159602","118159900","chr5","161340712","161341010","10","43181110"
"chr7","118190276","118190489","chr5","161370592","161370818","24","43180316"
"chr7","118190554","118190851","chr5","161370871","161371189","31","43180317"
"chr7","118191159","118191350","chr1","201832759","201832936","63","83641600"
"chr7","118276455","118276733","chr20","19095504","19095784","64","99180951"
"chr7","118302299","118302612","chr5","161489270","161489563","24","43186971"
"chr7","118525399","118525680","chr5","161709361","161709642","5","43183962"
"chr7","118613879","118614172","chr5","161801911","161802220","27","43188032"
"chr7","118710635","118710921","chrX","105819753","105820054","65","12890882"
"chr7","118743755","118743871","chr4","118708544","118708660","27","35211"
"chr7","118835369","118835673","chr18","26903287","26903585","57","91932082"
"chr7","118865312","118865556","chr5","162057587","162057819","26","43192275"
"chr7","119147372","119147665","chr5","162332609","162332902","27","43185237"
"chr7","119149126","119149338","chr5","162334358","162334567","5","43185232"
"chr7","119237662","119237815","chr5","162424517","162424659","14","43186855"
"chr7","119237845","119237961","chr5","162424705","162424824","7","43186860"
"chr7","119255970","119256215","chr5","162442506","162442752","7","43186536"
"chr7","119257414","119257714","chr13","41851851","41852159","68","77405563"
"chr7","119269409","119269679","chr5","162455916","162456222","42","43186507"
"chr7","119269719","119269734","chr3","151749823","151749838","2","32480104"
"chr7","119320723","119321014","chr5","162507905","162508194","10","43187182"
"chr7","119349308","119349354","chr14","53899566","53899618","13","65449742"
"chr7","119349850","119349930","chr5","162537024","162537104","1","43187174"
"chr7","119361114","119361425","chr5","162548285","162548597","7","43187171"
"chr7","119409395","119409690","chr5","162597162","162597459","8","43187767"
"chr7","119437268","119437548","chr5","162625203","162625483","6","43187935"
"chr7","119447703","119447921","chr5","162635666","162635884","5","43187963"
"chr7","119473714","119474026","chr5","162660645","162660955","12","43186931"
"chr7","119489652","119489944","chr5","162676877","162677176","21","43187225"
"chr7","119541194","119541506","chr5","162728944","162729258","8","43187750"
"chr7","119548749","119549038","chr5","162737716","162738028","42","43188967"
"chr7","119550217","119550490","chr5","162739217","162739490","14","43189000"
"chr7","119601645","119601925","chr5","162795289","162795570","7","43193644"
"chr7","119610290","119610560","chr5","162803950","162804222","8","43193660"
"chr7","119658615","119658909","chr5","162852462","162852756","10","43193847"
"chr7","119664739","119664917","chr5","162858583","162858763","4","43193844"
"chr7","119677773","119678085","chr5","162871624","162871924","22","43193851"
"chr7","119691240","119691522","chr5","162885037","162885320","8","43193797"
"chr7","119804447","119804731","chr5","163002823","163003107","10","43198376"
"chr7","119805488","119805773","chr5","163003865","163004174","30","43198377"
"chr7","119846848","119847164","chr4","30245827","30246127","74","89601021"
"chr7","119878558","119878652","chr16","44077886","44077976","19","75800672"
"chr7","119878678","119878777","chr20","17554524","17554621","28","102324154"
"chr7","119979370","119979535","chr5","163176966","163177131","3","43197596"
"chr7","120036662","120036721","chr5","163233609","163233669","2","43196947"
"chr7","120070800","120071122","chr5","163268469","163268776","21","43197669"
"chr7","120111908","120112198","chr14","30949481","30949760","59","89162427"
"chr7","120181225","120181439","chr16","47294707","47294918","49","72886518"
"chr7","120194450","120194728","chr5","163394362","163394640","3","43199912"
"chr7","120335130","120335422","chr5","163530862","163531154","8","43195732"
"chr7","120340948","120341185","chr5","163536732","163536969","4","43195784"
"chr7","120382152","120382457","chr5","163577591","163577894","11","43195439"
"chr7","120475598","120475897","chr5","163673485","163673799","21","43197887"
"chr7","120491919","120492230","chr5","163688277","163688585","8","43196358"
"chr7","120510682","120510745","chr5","163707124","163707187","2","43196442"
"chr7","120510853","120511150","chr5","163707295","163707590","16","43196442"
"chr7","120517760","120518058","chr5","163714198","163714496","6","43196438"
"chr7","120579646","120579961","chr5","163777245","163777559","11","43197599"
"chr7","120588464","120588657","chr5","163785948","163786143","10","43197484"
"chr7","120597939","120598056","chr5","163795714","163795831","3","43197775"
"chr7","120621406","120621577","chr5","163819089","163819269","21","43197683"
"chr7","120656130","120656459","chr5","163858587","163858911","20","43202457"
"chr7","120669995","120670309","chr5","163872331","163872631","25","43202336"
"chr7","120681533","120681706","chr5","163883513","163883687","6","43201980"
"chr7","120814312","120814611","chr5","159278871","159279169","60","38464559"
"chr7","120880081","120880366","chr5","164083658","164083955","21","43203577"
"chr7","121113969","121114165","chr9","92336855","92337051","40","28777114"
"chr7","121129579","121129807","chr5","164341920","164342137","14","43212341"
"chr7","121306659","121306836","chr5","164506961","164507139","5","43200302"
"chr7","121306880","121307005","chr5","164507181","164507295","14","43200301"
"chr7","121439257","121439574","chr5","164635872","164636176","24","43196615"
"chr7","121534971","121535228","chr5","164727662","164727919","8","43192691"
"chr7","121574865","121575146","chr5","164767605","164767886","7","43192740"
"chr7","121606406","121606714","chr5","164799068","164799380","17","43192662"
"chr7","121690928","121691226","chr5","164885996","164886294","6","43195068"
"chr7","121696714","121697035","chr5","164891807","164892116","19","43195093"
"chr7","121756490","121756724","chr5","164952285","164952519","7","43195795"
"chr7","121757100","121757162","chr5","164952895","164952957","1","43195795"
"chr7","121795060","121795232","chr5","164992854","164993026","6","43197794"
"chr7","121802649","121802913","chr5","165000502","165000766","4","43197853"
"chr7","121803296","121803325","chr5","165001149","165001178","1","43197853"
"chr7","121803408","121803683","chr5","165001261","165001541","15","43197853"
"chr7","121908453","121908750","chr5","165106952","165107214","41","43198499"
"chr7","121911500","121911825","chr5","165110025","165110348","16","43198525"
"chr7","121946776","121947083","chr5","165145406","165145713","8","43198630"
"chr7","121964948","121965163","chr5","165163560","165163777","8","43198612"
"chr7","121968816","121969036","chr5","165167426","165167635","16","43198610"
"chr7","122003130","122003438","chr5","165204381","165204690","10","43201251"
"chr7","122032272","122032576","chr5","165233086","165233365","29","43200814"
"chr7","122054048","122054356","chr5","165256048","165256357","5","43202000"
"chr7","122083198","122083496","chr5","165286031","165286332","16","43202833"
"chr7","122109031","122109343","chr5","165311842","165312154","8","43202811"
"chr7","122217344","122217642","chr5","165412830","165413132","17","43195486"
"chr7","122223139","122223453","chr5","165418407","165418727","12","43195268"
"chr7","122225920","122226198","chr5","165421194","165421463","10","43195274"
"chr7","122322480","122322780","chr5","165518327","165518626","11","43195847"
"chr7","122331334","122331580","chr5","165527020","165527265","13","43195686"
"chr7","122347994","122348150","chr5","165543741","165543899","8","43195747"
"chr7","122374259","122374553","chr5","165569652","165569942","9","43195393"
"chr7","122414581","122414870","chr5","165604363","165604673","38","43189782"
"chr7","122499902","122499981","chrX","122790606","122790686","13","290704"
"chr7","122518772","122518899","chr5","165707979","165708106","4","43189207"
"chr7","122521189","122521498","chr5","165710400","165710660","64","43189211"
"chr7","122666401","122666683","chr1","183741032","183741319","57","61074631"
"chr7","122733122","122733412","chr5","165917505","165917797","9","43184383"
"chr7","122750666","122750999","chr5","165933880","165934160","64","43183214"
"chr7","122806389","122806673","chr8","10034943","10035230","57","112771446"
"chr7","122829429","122829712","chr5","166008560","166008853","17","43179131"
"chr7","122867570","122867876","chr5","166044336","166044643","8","43176766"
"chr7","122883030","122883339","chr5","166059760","166060072","18","43176730"
"chr7","122884906","122885211","chr1","203490003","203490305","53","80605097"
"chr7","122973870","122974171","chr5","166151001","166151306","8","43177131"
"chr7","123024797","123025086","chr5","166202655","166202945","10","43177858"
"chr7","123136786","123136946","chr5","166310705","166310872","11","43173919"
"chr7","123202611","123202791","chr5","166377538","166377723","12","43174927"
"chr7","123303855","123303949","chr3","39184229","39184319","28","84119626"
"chr7","123304988","123305295","chr1","29968074","29968383","57","93336914"
"chr7","123305504","123305783","chr1","201826404","201826692","50","78520900"
"chr7","123315310","123315526","chr18","16392466","16392684","40","106922844"
"chr7","123315648","123315738","chr6","158945098","158945190","17","35629450"
"chr7","123332522","123332809","chr3","104066726","104067014","56","19265796"
"chr7","123349235","123349535","chr8","133712728","133713029","53","10363493"
"chr7","123463297","123463588","chr5","166632005","166632283","20","43168708"
"chr7","123469932","123470241","chr5","166638879","166639188","15","43168947"
"chr7","123486082","123486338","chr5","166655203","166655459","8","43169121"
"chr7","123516165","123516318","chr5","166689091","166689259","24","43172926"
"chr7","123529526","123529833","chr5","166702622","166702930","14","43173096"
"chr7","123564447","123564731","chr5","166737174","166737458","5","43172727"
"chr7","123568869","123569072","chr1","72337582","72337777","45","51231287"
"chr7","123617887","123618033","chr5","166798957","166799102","6","43181070"
"chr7","123618342","123618520","chr5","166799408","166799586","5","43181066"
"chr7","123719862","123720169","chr5","166910204","166910486","35","43190342"
"chr7","123726050","123726348","chr5","166916278","166916574","20","43190228"
"chr7","123777148","123777446","chr5","166967463","166967757","18","43190315"
"chr7","123779340","123779650","chr5","166970219","166970528","15","43190879"
"chr7","123806099","123806233","chr5","166997761","166997895","1","43191662"
"chr7","123806505","123806706","chrX","107339105","107339290","52","16467400"
"chr7","123851411","123851621","chr5","167045761","167045970","10","43194350"
"chr7","124064033","124064289","chr5","167265167","167265450","34","43201134"
"chr7","124093726","124093887","chr5","167292681","167292836","10","43198955"
"chr7","124094008","124094131","chr5","167292973","167293102","8","43198965"
"chr7","124432314","124432613","chr5","167632320","167632614","13","43200006"
"chr7","124581079","124581153","chr2","182769148","182769221","16","58188069"
"chr7","124581156","124581220","chr1","203526304","203526368","17","78945148"
"chr7","124653694","124653963","chr5","167835882","167836151","8","43182188"
"chr7","124717354","124717626","chr5","167901311","167901582","12","43183957"
"chr7","124765403","124765575","chr5","167954308","167954467","15","43188905"
"chr7","124797849","124798108","chr5","167983015","167983256","26","43185166"
"chr7","124883828","124884111","chr4","151008304","151008592","59","26124476"
"chr7","124920165","124920461","chr5","168114453","168114748","9","43194288"
"chr7","124933307","124933613","chr5","168127865","168128174","16","43194558"
"chr7","125026075","125026392","chr4","24310887","24311194","19","100715188"
"chr7","125031957","125032228","chr5","168220804","168221074","11","43188847"
"chr7","125231497","125231799","chr5","168421822","168422124","3","43190325"
"chr7","125315271","125315562","chr5","168511963","168512248","17","43196692"
"chr7","125388883","125389173","chr5","168583867","168584151","15","43194984"
"chr7","125442697","125442822","chr5","168637925","168638050","1","43195228"
"chr7","125476171","125476317","chr19","41979439","41979569","38","83496732"
"chr7","125502901","125503198","chr5","168699373","168699669","14","43196472"
"chr7","125516373","125516484","chr14","9939495","9939604","19","115576878"
"chr7","125516485","125516542","chrX","1977920","1977980","14","123538565"
"chr7","125516564","125516796","chr5","168712555","168712798","18","43195991"
"chr7","125534369","125534658","chr5","168728981","168729270","11","43194612"
"chr7","125655863","125656174","chr9","33169470","33169773","67","92486393"
"chr7","125671209","125671484","chr5","168864574","168864859","25","43193365"
"chr7","125726506","125726787","chr1","158417696","158417976","57","32691190"
"chr7","126269486","126269791","chr5","169474582","169474900","21","43205096"
"chr7","126278210","126278515","chr5","169483520","169483822","18","43205310"
"chr7","126352027","126352257","chr5","169558226","169558448","23","43206199"
"chr7","126382869","126383159","chr5","169589025","169589315","6","43206156"
"chr7","126386468","126386771","chr5","169592624","169592918","18","43206156"
"chr7","126462884","126463171","chr5","169666806","169667113","25","43203922"
"chr7","126472405","126472716","chr5","169676440","169676749","17","43204035"
"chr7","126535459","126535741","chr5","169739571","169739853","4","43204112"
"chr7","126542821","126542947","chr5","169747173","169747299","1","43204352"
"chr7","126590199","126590297","chr7","10912904","10913003","12","115677295"
"chr7","126631882","126632176","chr5","169837457","169837750","13","43205575"
"chr7","126674431","126674683","chr5","169880192","169880460","24","43205761"
"chr7","126742115","126742410","chr5","169949253","169949556","21","43207138"
"chr7","126750294","126750576","chr5","169957644","169957947","30","43207350"
"chr7","126759586","126759848","chr5","169966960","169967254","40","43207374"
"chr7","126762668","126762787","chr5","169970075","169970194","2","43207407"
"chr7","126762827","126762976","chr5","169970220","169970371","7","43207393"
"chr7","126787643","126787770","chr13","84094452","84094583","24","42693191"
"chr7","126796979","126797265","chr5","170004169","170004459","17","43207190"
"chr7","126911499","126911798","chr5","170118490","170118793","8","43206991"
"chr7","126928473","126928741","chr5","170135904","170136172","14","43207431"
"chr7","127006480","127006764","chr5","170212933","170213217","6","43206453"
"chr7","127174063","127174351","chr5","170382501","170382784","18","43208438"
"chr7","127208703","127208967","chr5","170417021","170417289","13","43208318"
"chr7","127277203","127277489","chr5","170488224","170488508","6","43211021"
"chr7","127483220","127483609","chr19","12878349","12878677","125","114604871"
"chr7","127557199","127557497","chr5","170774695","170774986","15","43217496"
"chr7","127572903","127573220","chr5","170790826","170791142","11","43217923"
"chr7","127638988","127639244","chr2","78855951","78856210","48","48783037"
"chr7","127689302","127689619","chr5","170910451","170910768","8","43221149"
"chr7","127728320","127728642","chr5","170949202","170949522","8","43220882"
"chr7","127745875","127746142","chr5","170966736","170967003","9","43220861"
"chr7","127779852","127780151","chr5","171000302","171000601","6","43220450"
"chr7","127798043","127798206","chr5","171018546","171018716","12","43220503"
"chr7","127868224","127868529","chr5","171088845","171089154","34","43220621"
"chr7","127918323","127918369","chr6","172279857","172279902","11","44361534"
"chr7","127980600","127980898","chr5","171201798","171202099","12","43221198"
"chr7","128025564","128025843","chr5","171247342","171247619","12","43221778"
"chr7","128051371","128051603","chr5","171272928","171273160","12","43221557"
"chr7","128060415","128060706","chr5","171282533","171282832","17","43222118"
"chr7","128083415","128083715","chr5","171308181","171308481","6","43224766"
"chr7","128098974","128099167","chr5","171323679","171323872","9","43224705"
"chr7","128103403","128103704","chr5","171328143","171328457","22","43224740"
"chr7","128108142","128108411","chr18","1629064","1629340","64","126479078"
"chr7","128109366","128109672","chr5","171333369","171333675","9","43224003"
"chr7","128113479","128113787","chr5","171337448","171337751","9","43223969"
"chr7","128170951","128171294","chr5","171394728","171395067","9","43223777"
"chr7","128203051","128203348","chr5","171426085","171426390","18","43223034"
"chr7","128223488","128223768","chr1","28342146","28342426","62","99881342"
"chr7","128246083","128246367","chr5","171468704","171468998","19","43222621"
"chr7","128313003","128313141","chr5","171535907","171536045","9","43222904"
"chr7","128321267","128321560","chr5","171543675","171543968","4","43222408"
"chr7","128369722","128370001","chr7","18328545","18328829","48","110041177"
"chr7","128404652","128404963","chr5","171628880","171629193","6","43224228"
"chr7","128414430","128414670","chr1","115103627","115103865","53","13310803"
"chr7","128431334","128431476","chr5","171657930","171658076","6","43226596"
"chr7","128437626","128437966","chrX","45850992","45851303","77","82586634"
"chr7","128452514","128452733","chr16","39415339","39415546","57","89037175"
"chr7","128521004","128521304","chr5","171745823","171746125","6","43224819"
"chr7","128521379","128521688","chr5","171746201","171746525","25","43224822"
"chr7","128529990","128530273","chr16","8394631","8394917","65","120135359"
"chr7","128537114","128537405","chr5","171762200","171762490","11","43225086"
"chr7","128544091","128544260","chr11","38369515","38369683","35","90174576"
"chr7","128549408","128549721","chr5","171774653","171774959","13","43225245"
"chr7","128568569","128568845","chr5","171794145","171794403","33","43225576"
"chr7","128584609","128584799","chr5","171810205","171810401","9","43225596"
"chr7","128585372","128585497","chr5","171810975","171811098","5","43225603"
"chr7","128588166","128588322","chr5","171813783","171813939","7","43225617"
"chr7","128595126","128595435","chr5","171820500","171820810","7","43225374"
"chr7","128595886","128596169","chr5","171821261","171821527","28","43225375"
"chr7","128606260","128606432","chr15","81749718","81749886","45","46856542"
"chr7","128655450","128655768","chr5","171880941","171881255","18","43225491"
"chr7","128663942","128664054","chr6","126703454","126703568","16","1960488"
"chr7","128664361","128664563","chr7","95935627","95935823","45","32728734"
"chr7","128671613","128671907","chr5","171897222","171897526","23","43225609"
"chr7","128691331","128691649","chr5","171916966","171917285","15","43225635"
"chr7","128704469","128704776","chr5","171930513","171930806","29","43226044"
"chr7","128718131","128718413","chr5","171943767","171944048","9","43225636"
"chr7","128731058","128731338","chr5","171956816","171957096","6","43225758"
"chr7","128777334","128777627","chr5","172002952","172003224","26","43225618"
"chr7","128777682","128777935","chr5","172003278","172003520","51","43225596"
"chr7","128810987","128811303","chr4","152226280","152226592","56","23415293"
"chr7","128830163","128830460","chr7","49571405","49571710","62","79258758"
"chr7","128838361","128838407","chr3","42487122","42487169","14","86351239"
"chr7","128891814","128892099","chr5","172029874","172030159","9","43138060"
"chr7","128912068","128912207","chr5","172050292","172050431","1","43138224"
"chr7","128914710","128914968","chr5","172052975","172053231","7","43138265"
"chr7","128940151","128940460","chr5","172078386","172078697","26","43138235"
"chr7","128943143","128943437","chr5","172081381","172081674","5","43138238"
"chr7","128957509","128957789","chr5","172095859","172096138","9","43138350"
"chr7","128963374","128963684","chr5","172101723","172102001","47","43138349"
"chr7","128994527","128994613","chr5","172130754","172130835","5","43136227"
"chr7","129006461","129006748","chr5","172143067","172143371","26","43136606"
"chr7","129038677","129038978","chr5","172178942","172179241","12","43140265"
"chr7","129059668","129059972","chr5","172199982","172200286","3","43140314"
"chr7","129067577","129067756","chr5","172207585","172207770","11","43140008"
"chr7","129068110","129068244","chr5","172208106","172208240","2","43139996"
"chr7","129068450","129068739","chr5","172208446","172208736","7","43139996"
"chr7","129086698","129087013","chr5","172226455","172226770","7","43139757"
"chr7","129095462","129095602","chr3","36805916","36806054","29","92289546"
"chr7","129111494","129111784","chr5","172251637","172251928","1","43140143"
"chr7","129117321","129117565","chr5","172257635","172257879","9","43140314"
"chr7","129127641","129127951","chr5","172267973","172268253","36","43140332"
"chr7","129133422","129133433","chr3","39984846","39984857","1","89148576"
"chr7","129133476","129133755","chr5","172273654","172273979","52","43140178"
"chr7","129147108","129147390","chr5","172288921","172289203","3","43141813"
"chr7","129149328","129149623","chr5","172291149","172291431","19","43141821"
"chr7","129160620","129160918","chr5","172301914","172302208","13","43141294"
"chr7","129202181","129202433","chr5","172342926","172343176","9","43140745"
"chr7","129205901","129206205","chrX","118224558","118224863","67","10981343"
"chr7","129239556","129239700","chr5","172380319","172380463","3","43140763"
"chr7","129270883","129271160","chr5","172411390","172411667","15","43140507"
"chr7","129344195","129344492","chr5","172485371","172485668","13","43141176"
"chr7","129347535","129347655","chr5","172489020","172489140","2","43141485"
"chr7","129354476","129354767","chr5","172495942","172496230","16","43141466"
"chr7","129376989","129377277","chr5","172518698","172518985","27","43141709"
"chr7","129399306","129399433","chr2","47509577","47509704","19","81889729"
"chr7","129416148","129416327","chr5","172558063","172558242","4","43141915"
"chr7","129425204","129425510","chr5","172566835","172567147","12","43141631"
"chr7","129444548","129444832","chr5","172587347","172587650","29","43142799"
"chr7","129460323","129460591","chr5","172603890","172604172","22","43143567"
"chr7","129465351","129465632","chr5","172609049","172609330","4","43143698"
"chr7","129470597","129470906","chr5","172614260","172614554","23","43143663"
"chr7","129506877","129507177","chr5","172650350","172650649","12","43143473"
"chr7","129509485","129509563","chr5","172653684","172653763","5","43144199"
"chr7","129523075","129523377","chr19","43767952","43768237","69","85755123"
"chr7","129527650","129527796","chr19","40644193","40644342","27","88883457"
"chr7","129538810","129539106","chr5","172683662","172683969","15","43144852"
"chr7","129546767","129547058","chr5","172691051","172691342","10","43144284"
"chr7","129587433","129587655","chr5","172731944","172732166","10","43144511"
"chr7","129592711","129593007","chr5","172738419","172738715","12","43145708"
"chr7","129599473","129599753","chr5","172745208","172745491","6","43145735"
"chr7","129609518","129609795","chr5","172755168","172755452","10","43145650"
"chr7","129620004","129620306","chr5","172765884","172766187","16","43145880"
"chr7","129620671","129620955","chr5","172766552","172766825","23","43145881"
"chr7","129647736","129648018","chr5","172794346","172794631","11","43146610"
"chr7","129661757","129662061","chr5","172808008","172808307","22","43146251"
"chr7","129663187","129663496","chr2","44882107","44882408","62","84781080"
"chr7","129665431","129665685","chr5","172811379","172811633","5","43145948"
"chr7","129676554","129676846","chr5","172822537","172822828","7","43145983"
"chr7","129690162","129690466","chr5","172836100","172836392","20","43145938"
"chr7","129709029","129709341","chr5","172855762","172856075","13","43146733"
"chr7","129710703","129711005","chr5","172857282","172857584","10","43146579"
"chr7","129720685","129720972","chr5","172867282","172867572","20","43146597"
"chr7","129753384","129753671","chr5","172901402","172901676","23","43148018"
"chr7","129772389","129772690","chr5","172930060","172930350","14","43157671"
"chr7","129789715","129790012","chr5","172938105","172938392","23","43148390"
"chr7","129835642","129835946","chr5","172984707","172985011","5","43149065"
"chr7","129844930","129845177","chr5","172995295","172995542","5","43150365"
"chr7","129862277","129862546","chr5","173013580","173013853","10","43151303"
"chr7","129883132","129883340","chr5","173034290","173034498","2","43151158"
"chr7","129967175","129967460","chr4","35694824","35695104","47","94272351"
"chr7","129974766","129975033","chr5","173125164","173125444","24","43150398"
"chr7","129984362","129984656","chr5","173134798","173135089","11","43150436"
"chr7","130020115","130020361","chr5","173171707","173171937","27","43151592"
"chr7","130044994","130045263","chr5","173197344","173197618","22","43152350"
"chr7","130127570","130127875","chr5","173276317","173276603","43","43148747"
"chr7","130140339","130140648","chr5","173296847","173297157","7","43156508"
"chr7","130243553","130243859","chr5","173401545","173401854","13","43157992"
"chr7","130308358","130308639","chr5","173464621","173464902","5","43156263"
"chr7","130320396","130320707","chr5","173476491","173476801","12","43156095"
"chr7","130321564","130321821","chr19","8855297","8855567","60","121466267"
"chr7","130337514","130337815","chr3","153174547","153174843","60","22837033"
"chr7","130339473","130339760","chr5","173495208","173495495","6","43155735"
"chr7","130346369","130346658","chr5","173502134","173502424","5","43155765"
"chr7","130392061","130392360","chr5","173548924","173549213","22","43156863"
"chr7","130393214","130393511","chr8","70539683","70539976","52","59853531"
"chr7","130395347","130395621","chr5","173549744","173550016","6","43154397"
"chr7","130438845","130438898","chr3","130292448","130292499","14","146397"
"chr7","130449318","130449523","chr5","173602032","173602273","39","43152714"
"chr7","130449751","130449816","chr5","173602729","173602794","3","43152978"
"chr7","130453227","130453541","chr8","61522372","61522671","64","68930855"
"chr7","130453967","130454266","chr5","173606950","173607249","7","43152983"
"chr7","130456661","130456684","chr13","36025545","36025568","0","94431116"
"chr7","130456720","130456846","chr7","123622375","123622499","26","6834345"
"chr7","130467977","130468146","chr5","173617858","173618025","4","43149881"
"chr7","130500060","130500355","chr13","26875713","26876000","52","103624347"
"chr7","130510112","130510419","chr5","173660398","173660700","18","43150286"
"chr7","130515976","130516113","chr9","19939067","19939204","21","110576909"
"chr7","130517035","130517286","chr5","173667653","173667919","26","43150618"
"chr7","130525284","130525523","chr4","154580360","154580587","50","24055076"
"chr7","130550246","130550551","chr5","173693412","173693717","11","43143166"
"chr7","130555003","130555137","chr5","173697894","173698009","23","43142891"
"chr7","130555426","130555602","chr5","173698311","173698474","17","43142885"
"chr7","130595940","130596251","chr5","173738282","173738585","17","43142342"
"chr7","130642283","130642585","chr5","173786372","173786674","6","43144089"
"chr7","130642708","130642990","chr5","173786804","173787070","19","43144096"
"chr7","130655884","130656190","chr5","173799888","173800188","19","43144004"
"chr7","130704705","130705000","chr5","173849923","173850220","8","43145218"
"chr7","130723197","130723493","chr5","173868422","173868720","9","43145225"
"chr7","130734128","130734397","chr5","173879353","173879622","6","43145225"
"chr7","130779517","130779829","chr5","173926910","173927219","17","43147393"
"chr7","130787098","130787414","chr5","173933438","173933754","9","43146340"
"chr7","130837550","130837853","chr5","173980023","173980327","8","43142473"
"chr7","130872703","130872979","chr5","174016995","174017277","20","43144292"
"chr7","130890377","130890683","chr5","174029455","174029757","16","43139078"
"chr7","130891065","130891239","chr5","174030607","174030784","10","43139542"
"chr7","130899071","130899389","chr11","12914812","12915114","65","117984259"
"chr7","130904837","130904996","chr5","174044377","174044552","18","43139540"
"chr7","130921955","130922255","chr5","174061526","174061821","7","43139571"
"chr7","130942480","130942722","chr8","65980765","65980995","68","64961715"
"chr7","130946003","130946311","chr5","174086532","174086845","15","43140529"
"chr7","131005903","131006203","chr4","41957309","41957607","52","89048594"
"chr7","131111511","131111812","chr5","174254017","174254322","11","43142506"
"chr7","131116811","131117144","chr5","174259542","174259862","18","43142731"
"chr7","131131661","131131973","chr5","174274421","174274736","12","43142760"
"chr7","131143925","131144225","chr5","174286446","174286743","12","43142521"
"chr7","131148093","131148194","chr7","87812943","87813034","28","43335150"
"chr7","131148831","131149127","chr5","174292650","174292946","8","43143819"
"chr7","131162182","131162291","chr5","174306130","174306245","7","43143948"
"chr7","131162591","131162737","chr5","174306543","174306688","5","43143952"
"chr7","131164170","131164486","chr5","174308121","174308428","15","43143951"
"chr7","131174360","131174465","chr5","174318221","174318326","2","43143861"
"chr7","131177743","131178027","chr5","174321606","174321890","7","43143863"
"chr7","131183792","131184062","chr5","174326732","174327002","6","43142940"
"chr7","131190093","131190406","chr5","174334692","174335005","9","43144599"
"chr7","131203614","131203912","chr5","174347273","174347570","7","43143659"
"chr7","131208076","131208361","chr5","174351594","174351877","10","43143518"
"chr7","131216353","131216662","chr5","174360212","174360521","7","43143859"
"chr7","131233073","131233240","chr5","174376971","174377137","9","43143898"
"chr7","131234109","131234259","chr10","37603835","37603978","34","93630274"
"chr7","131248468","131248745","chr5","174393869","174394154","28","43145401"
"chr7","131283683","131283955","chr5","174429251","174429503","26","43145568"
"chr7","131308882","131309168","chr5","174454581","174454871","16","43145699"
"chr7","131373591","131373909","chr5","174518085","174518409","17","43144494"
"chr7","131398830","131399128","chr5","174542550","174542862","31","43143720"
"chr7","131402720","131402840","chr5","44376152","44376269","23","87026568"
"chr7","131462595","131462898","chr5","174604760","174605063","5","43142165"
"chr7","131498119","131498411","chr5","174638191","174638483","4","43140072"
"chr7","131530114","131530397","chr5","174668984","174669270","14","43138870"
"chr7","131555303","131555578","chr5","174693336","174693626","25","43138033"
"chr7","131647901","131648239","chr5","174785690","174786008","46","43137789"
"chr7","131734113","131734246","chr5","174873620","174873752","6","43139507"
"chr7","131751762","131751863","chr6","165327290","165327396","20","33575528"
"chr7","131751898","131752045","chr11","121092295","121092441","24","10659603"
"chr7","131834428","131834568","chr2","87101974","87102112","27","44732454"
"chr7","131847025","131847317","chr10","13494827","13495124","53","118352198"
"chr7","131875321","131875617","chr2","97022915","97023209","60","34852406"
"chr7","131916147","131916480","chr5","175067661","175067970","30","43151514"
"chr7","131973153","131973367","chr5","175124814","175125028","5","43151661"
"chr7","131977686","131977959","chr5","175129622","175129943","55","43151936"
"chr7","131992382","131992659","chr5","175145061","175145338","2","43152679"
"chr7","131992690","131992987","chr5","175145369","175145673","17","43152679"
"chr7","132052735","132053015","chr5","175210958","175211224","21","43158223"
"chr7","132070929","132071214","chr7","75918098","75918380","50","56152831"
"chr7","132104627","132104834","chr5","175261561","175261792","39","43156934"
"chr7","132131606","132131810","chr5","175288620","175288855","38","43157014"
"chr7","132173684","132173950","chr5","175331880","175332147","15","43158196"
"chr7","132178067","132178360","chr20","60646430","60646715","64","71531637"
"chr7","132258522","132258813","chr1","159670885","159671182","54","27412363"
"chr7","132341178","132341237","chr10","16885873","16885925","14","115455305"
"chr7","132354268","132354551","chr5","175497286","175497566","19","43143018"
"chr7","132366720","132366754","chr15","93717620","93717656","3","38649100"
"chr7","132372278","132372548","chr10","80978550","80978820","65","51393728"
"chr7","132375207","132375440","chr5","175511462","175511712","19","43136255"
"chr7","132414867","132414991","chr5","175562003","175562127","4","43147136"
"chr7","132425792","132426091","chr5","175573096","175573397","15","43147304"
"chr7","132453148","132453429","chr8","10034943","10035230","53","122418205"
"chr7","132469238","132469354","chr5","175612265","175612381","5","43143027"
"chr7","132561832","132562131","chr9","105122823","105123124","59","27439009"
"chr7","132562164","132562176","chr3","75913162","75913174","1","56649002"
"chr7","132562615","132562882","chr5","175711059","175711321","7","43148444"
"chr7","132602471","132602786","chr5","175756722","175757033","15","43154251"
"chr7","132605837","132606120","chr5","175760104","175760377","21","43154267"
"chr7","132627246","132627535","chr5","175781504","175781793","7","43154258"
"chr7","132631395","132631685","chr5","175785750","175786040","9","43154355"
"chr7","132651702","132652006","chr5","175807998","175808304","11","43156296"
"chr7","132654163","132654238","chr11","62999686","62999757","10","69654477"
"chr7","132656786","132657092","chr5","175813119","175813425","5","43156333"
"chr7","132754722","132755065","chr5","175915614","175915954","15","43160892"
"chr7","132826621","132826897","chr5","175983811","175984087","7","43157190"
"chr7","132908771","132909076","chr5","176067054","176067359","14","43158283"
"chr7","133051005","133051302","chr5","176210417","176210714","12","43159412"
"chr7","133062339","133062627","chr5","176221690","176221993","30","43159351"
"chr7","133153205","133153462","chr5","176315209","176315466","7","43162004"
"chr7","133331177","133331468","chr7","122518704","122518988","71","10812473"
"chr7","133451468","133451660","chr5","176623038","176623222","12","43171570"
"chr7","133451701","133451810","chr5","176623263","176623373","3","43171562"
"chr7","133464393","133464514","chr5","176635950","176636071","7","43171557"
"chr7","133464796","133464963","chr5","176636353","176636518","13","43171557"
"chr7","133552392","133552680","chr5","176725918","176726240","41","43173526"
"chr7","133582311","133582605","chr8","61369925","61370225","55","72212386"
"chr7","133588248","133588532","chr14","113839339","113839619","49","19748909"
"chr7","133631482","133631781","chr3","51390605","51390903","54","82240877"
"chr7","133653854","133653958","chr10","73878296","73878397","17","59775558"
"chr7","133724787","133725077","chr3","128288889","128289178","61","5435898"
"chr7","133819205","133819511","chr5","176843174","176843486","16","43023969"
"chr7","133823421","133823710","chr5","176847401","176847694","13","43023980"
"chr7","133830213","133830478","chr5","176854786","176855043","16","43024573"
"chr7","133840561","133840702","chr8","90737045","90737184","26","43103516"
"chr7","133862296","133862681","chr6","66186762","66187102","110","67675534"
"chr7","133883321","133883623","chr5","176912811","176913105","14","43029490"
"chr7","133890390","133890688","chr5","176919314","176919611","6","43028924"
"chr7","133951600","133951894","chr5","176988560","176988855","23","43036960"
"chr7","133952926","133953090","chr3","173526190","173526356","35","39573264"
"chr7","133953172","133953272","chr5","176990116","176990216","1","43036944"
"chr7","133953342","133953538","chr5","176990272","176990460","17","43036930"
"chr7","133978120","133978432","chr5","177015965","177016275","10","43037845"
"chr7","134013562","134013680","chr5","177057869","177057990","7","43044307"
"chr7","134013992","134014167","chr5","177058300","177058472","11","43044308"
"chr7","134017865","134018148","chr5","177062179","177062470","14","43044314"
"chr7","134083076","134083404","chr5","177131239","177131542","27","43048163"
"chr7","134100161","134100463","chr5","177150592","177150894","8","43050431"
"chr7","134139540","134139799","chr14","107640563","107640819","63","26498977"
"chr7","134174296","134174580","chr5","177231624","177231930","33","43057328"
"chr7","134218555","134218840","chr5","177276958","177277242","8","43058403"
"chr7","134434272","134434571","chr5","177487412","177487711","8","43053140"
"chr7","134497676","134498000","chr5","177548082","177548408","10","43050406"
"chr7","134508746","134508955","chr5","177559357","177559566","10","43050611"
"chr7","134514872","134515158","chr5","177562887","177563177","14","43048015"
"chr7","134517519","134517797","chr5","177565010","177565277","15","43047491"
"chr7","134538874","134539058","chr5","177587779","177587959","6","43048905"
"chr7","134539096","134539207","chr5","177587988","177588099","2","43048892"
"chr7","134626025","134626316","chr5","177679397","177679689","13","43053372"
"chr7","134764364","134764412","chr5","177826038","177826086","2","43061674"
"chr7","134767839","134768122","chr5","177829473","177829781","41","43061634"
"chr7","135047482","135047745","chr7","37492038","37492301","64","97555444"
"chr7","135530244","135530523","chr5","178594995","178595274","13","43064751"
"chr7","135545975","135546117","chr16","20631316","20631450","28","114914659"
"chr7","135562664","135562952","chr5","178628990","178629278","6","43066326"
"chr7","135587637","135587907","chr2","44400493","44400771","50","91187144"
"chr7","135663778","135664067","chr5","178729835","178730125","20","43066057"
"chr7","135705691","135705958","chr5","178764633","178764904","21","43058942"
"chr8","2490266","2490581","chr12","86523736","86524041","64","84033470"
"chr8","11009915","11010222","chr8","10752758","10753065","12","257157"
"chr8","17956604","17956930","chr8","17794346","17794663","13","162258"
"chr8","39583586","39583879","chr8","39864540","39864832","4","280954"
"chr8","63176568","63176867","chr8","63264549","63264848","3","87981"
"chr8","93454205","93454491","chr8","93868455","93868740","20","414250"
"chr8","102891517","102891813","chr4","41823338","41823634","61","61068179"
"chr8","22450","22745","chr15","38278754","38279047","58","38256304"
"chr8","99129","99272","chr7","159089698","159089835","21","158990569"
"chr8","99580","99750","chr7","16093772","16093938","28","15994192"
"chr8","161408","161708","chr8","212762","213071","13","51354"
"chr8","170460","170760","chr10","17133650","17133957","51","16963190"
"chr8","171285","171587","chr8","229335","229640","14","58050"
"chr8","178797","178891","chr14","10540730","10540819","23","10361933"
"chr8","241735","241890","chr7","15293356","15293511","34","15051621"
"chr8","241894","242218","chr7","43258928","43259239","75","43017034"
"chr8","248316","248613","chr8","306914","307211","1","58598"
"chr8","272458","272780","chr8","331071","331374","25","58613"
"chr8","276663","276841","chr8","335266","335444","2","58603"
"chr8","321962","322275","chr8","384935","385246","12","62973"
"chr8","376227","376323","chr20","71122952","71123047","21","70746725"
"chr8","392724","393022","chr8","454495","454795","11","61771"
"chr8","396550","396834","chr8","458312","458596","18","61762"
"chr8","473763","473827","chr20","31886007","31886070","17","31412244"
"chr8","483057","483348","chr8","543033","543334","22","59976"
"chr8","507833","508132","chr8","571302","571605","20","63469"
"chr8","516775","517075","chr8","580221","580517","17","63446"
"chr8","527186","527471","chr8","590465","590740","13","63279"
"chr8","530539","530814","chr8","593811","594086","8","63272"
"chr8","589600","589728","chr3","161255144","161255276","33","160665544"
"chr8","612340","612606","chr8","674230","674496","5","61890"
"chr8","701495","701800","chr8","768014","768311","13","66519"
"chr8","704695","704994","chr8","771141","771438","19","66446"
"chr8","723435","723688","chr1","18247772","18248040","69","17524337"
"chr8","765120","765277","chr20","67379204","67379355","33","66614084"
"chr8","765309","765421","chr2","90239622","90239739","20","89474313"
"chr8","783041","783351","chr8","849754","850068","18","66713"
"chr8","800562","800801","chr8","869088","869325","16","68526"
"chr8","802547","802814","chr8","871070","871338","5","68523"
"chr8","873485","873771","chr8","946460","946739","13","72975"
"chr8","1031371","1031546","chr8","1104294","1104469","2","72923"
"chr8","1076256","1076564","chr8","1150305","1150598","28","74049"
"chr8","1112795","1113082","chrX","120356258","120356539","64","119243463"
"chr8","1239247","1239528","chr8","1329767","1330029","26","90520"
"chr8","1276547","1276793","chr8","1371629","1371876","8","95082"
"chr8","1346008","1346301","chr8","1451207","1451500","6","105199"
"chr8","1353483","1353780","chr8","1458873","1459157","18","105390"
"chr8","1383693","1383843","chr1","120540781","120540932","32","119157088"
"chr8","1390901","1391053","chr8","1494345","1494480","21","103444"
"chr8","1403631","1403922","chr8","1507139","1507430","10","103508"
"chr8","1471910","1472210","chr8","1575488","1575788","8","103578"
"chr8","1504844","1505144","chr8","1611461","1611761","4","106617"
"chr8","1515413","1515703","chr17","3242791","3243076","70","1727378"
"chr8","1537956","1538267","chr8","1644209","1644520","7","106253"
"chr8","1562134","1562442","chr8","1669822","1670124","16","107688"
"chr8","1594801","1595116","chr8","1701617","1701948","28","106816"
"chr8","1597238","1597532","chr8","1704331","1704620","12","107093"
"chr8","1630696","1630987","chr8","1738167","1738451","17","107471"
"chr8","1646483","1646576","chr3","48157715","48157805","18","46511232"
"chr8","1652973","1653299","chr8","1760732","1761056","12","107759"
"chr8","1730658","1730960","chr8","1840349","1840658","20","109691"
"chr8","1750178","1750312","chr16","43968335","43968464","32","42218157"
"chr8","1771061","1771103","chr12","80492486","80492530","7","78721425"
"chr8","1771099","1771156","chr4","33622647","33622698","20","31851548"
"chr8","1844946","1845184","chr8","1954924","1955163","8","109978"
"chr8","1877329","1877481","chr8","1994044","1994194","10","116715"
"chr8","1909279","1909386","chr19","10022587","10022700","27","8113308"
"chr8","1947469","1947583","chr8","2062939","2063052","4","115470"
"chr8","1947905","1948062","chrX","37802494","37802650","37","35854589"
"chr8","1948087","1948175","chr11","109019421","109019507","17","107071334"
"chr8","1959597","1959732","chr1","11405759","11405892","17","9446162"
"chr8","1971520","1971800","chr8","2085984","2086283","31","114464"
"chr8","1994090","1994367","chr11","393071","393353","71","1601019"
"chr8","2052273","2052543","chr8","2162285","2162559","8","110012"
"chr8","2117532","2117804","chr8","2230996","2231300","39","113464"
"chr8","2138860","2139135","chr8","2252250","2252526","14","113390"
"chr8","2248196","2248319","chrX","61671031","61671155","23","59422835"
"chr8","2248613","2248926","chr8","2361592","2361905","9","112979"
"chr8","2251018","2251265","chr8","2364787","2365052","20","113769"
"chr8","2251714","2251992","chr8","2365300","2365576","6","113586"
"chr8","2258541","2258831","chr8","2371951","2372227","28","113410"
"chr8","2441475","2441766","chr8","2555583","2555891","29","114108"
"chr8","2463929","2464220","chr8","2577641","2577932","6","113712"
"chr8","2488503","2488773","chr1","64061117","64061384","77","61572614"
"chr8","2607064","2607356","chr8","2724189","2724478","20","117125"
"chr8","2614318","2614592","chr8","2731459","2731733","9","117141"
"chr8","2765715","2766031","chr8","2887926","2888242","12","122211"
"chr8","2776346","2776647","chr8","2898294","2898596","4","121948"
"chr8","2803748","2804053","chr7","125147857","125148143","72","122344109"
"chr8","2809986","2810112","chr8","2948906","2949031","7","138920"
"chr8","2832588","2832868","chr8","2971499","2971780","8","138911"
"chr8","2862584","2862868","chr8","3001366","3001650","10","138782"
"chr8","2913108","2913394","chr8","3055307","3055595","11","142199"
"chr8","2943085","2943383","chr8","3084014","3084312","5","140929"
"chr8","2960157","2960442","chr8","121703606","121703883","60","118743449"
"chr8","2965901","2966214","chr8","3104476","3104788","6","138575"
"chr8","2973219","2973542","chr8","3111749","3112069","9","138530"
"chr8","3035744","3036043","chr8","3173114","3173413","5","137370"
"chr8","3081116","3081365","chr8","3224469","3224743","36","143353"
"chr8","3165057","3165346","chr8","3309144","3309432","21","144087"
"chr8","3223704","3223996","chr8","3366488","3366776","11","142784"
"chr8","3457501","3457796","chr8","3610789","3611085","15","153288"
"chr8","3461045","3461371","chr19","16169764","16170075","84","12708719"
"chr8","3525632","3525931","chr8","3682044","3682343","12","156412"
"chr8","3572311","3572583","chr8","3730353","3730629","15","158042"
"chr8","3610883","3611165","chr8","3769487","3769769","12","158604"
"chr8","3714738","3715010","chr8","3872949","3873228","13","158211"
"chr8","3753530","3753834","chrX","93380356","93380658","64","89626826"
"chr8","3807829","3808079","chr8","3956890","3957139","11","149061"
"chr8","3980749","3980875","JH679691","544438","544564","6","3436311"
"chr8","3987351","3987646","JH679691","551092","551391","14","3436259"
"chr8","4000281","4000568","JH679691","563931","564218","14","3436350"
"chr8","4034466","4034765","JH679691","599589","599887","9","3434877"
"chr8","4068674","4068966","JH679691","639073","639375","23","3429601"
"chr8","4165244","4165437","JH679691","738181","738389","23","3427063"
"chr8","4224234","4224508","chr8","4041973","4042248","10","182261"
"chr8","4277163","4277438","chr8","4099425","4099700","13","177738"
"chr8","4389449","4389785","chr8","4212794","4213100","52","176655"
"chr8","4399929","4400164","chr8","4223083","4223318","4","176846"
"chr8","4445634","4445927","chr8","4269171","4269463","7","176463"
"chr8","4499701","4499990","chr8","4323106","4323399","13","176595"
"chr8","4550495","4550773","chr8","4373761","4374042","9","176734"
"chr8","4573398","4573472","chr8","4395773","4395847","7","177625"
"chr8","4574581","4574737","chr2","185392597","185392750","30","180818016"
"chr8","4574767","4574882","chr13","43060085","43060200","17","38485318"
"chr8","4661210","4661512","chr8","4483710","4484011","12","177500"
"chr8","4767033","4767361","chr8","4590645","4590973","12","176388"
"chr8","4771720","4771776","chr8","4595353","4595404","5","176367"
"chr8","4790203","4790481","chr8","4614453","4614726","10","175750"
"chr8","4806907","4807211","chr8","4631473","4631776","14","175434"
"chr8","4845279","4845587","chr8","4669441","4669749","10","175838"
"chr8","4852634","4852898","chr8","4677008","4677303","50","175626"
"chr8","4872210","4872502","chr8","4696616","4696908","7","175594"
"chr8","4921771","4922071","chr8","4745212","4745512","4","176559"
"chr8","4940791","4941071","chr8","4781732","4782023","21","159059"
"chr8","5029912","5030216","chr8","4870889","4871192","8","159023"
"chr8","5133928","5134216","chr8","4974722","4975011","8","159206"
"chr8","5148907","5149173","chr8","4990032","4990298","10","158875"
"chr8","5167523","5167628","chr8","5008877","5008982","3","158646"
"chr8","5168004","5168177","chr8","5009358","5009533","5","158646"
"chr8","5179506","5179803","chr8","5020543","5020840","13","158963"
"chr8","5207734","5207957","chr8","5047990","5048213","4","159744"
"chr8","5225956","5226239","chr8","5066065","5066359","27","159891"
"chr8","5271085","5271402","chr8","5113644","5113954","29","157441"
"chr8","5410509","5410779","chr8","5253705","5253974","6","156804"
"chr8","5437506","5437742","chr8","5278737","5278976","12","158769"
"chr8","5440650","5440944","chr8","5281880","5282174","19","158770"
"chr8","5455298","5455522","chr8","5298121","5298345","9","157177"
"chr8","5588956","5589173","chr8","5435277","5435492","20","153679"
"chr8","5600352","5600453","chr20","29290541","29290642","15","23690189"
"chr8","5810358","5810432","chr8","5663671","5663745","1","146687"
"chr8","5826158","5826448","chr8","5679464","5679759","16","146694"
"chr8","5869251","5869562","chr8","5722846","5723154","25","146405"
"chr8","5883424","5883710","chr8","5739049","5739354","25","144375"
"chr8","5899080","5899353","chr8","5755585","5755866","14","143495"
"chr8","5900405","5900709","chr8","5757030","5757316","24","143375"
"chr8","5912897","5913185","chr8","7291201","7291483","24","1378304"
"chr8","5945168","5945370","chr8","5809101","5809306","12","136067"
"chr8","5995460","5995674","chr8","5859395","5859612","7","136065"
"chr8","6043175","6043461","chr8","5911989","5912282","15","131186"
"chr8","6075820","6076087","chr8","5947758","5948004","41","128062"
"chr8","6091076","6091385","chr8","5962950","5963259","9","128126"
"chr8","6155250","6155494","chr8","6033021","6033261","13","122229"
"chr8","6168169","6168465","chr8","6046572","6046865","23","121597"
"chr8","6174368","6174485","chr8","6062597","6062712","7","111771"
"chr8","6177855","6178151","chr8","6046572","6046865","25","131283"
"chr8","6192253","6192570","chr8","6066138","6066425","62","126115"
"chr8","6203012","6203180","chr8","6076879","6077039","10","126133"
"chr8","6203488","6203608","chr8","6077357","6077476","3","126131"
"chr8","6232800","6232875","chr8","6107068","6107149","8","125732"
"chr8","6233819","6234083","chr1","153740302","153740573","58","147506483"
"chr8","6316260","6316569","chr8","6190620","6190921","16","125640"
"chr8","6322175","6322299","chr8","6196534","6196658","4","125641"
"chr8","6322587","6322776","chr8","6196949","6197137","6","125638"
"chr8","6336550","6336848","chr8","6210880","6211181","13","125670"
"chr8","6373948","6374182","chr8","6247992","6248225","10","125956"
"chr8","6375127","6375455","chr11","31478862","31479178","63","25103735"
"chr8","6405112","6405426","chr8","6280483","6280791","27","124629"
"chr8","6409740","6410038","chr8","6285149","6285436","20","124591"
"chr8","6433127","6433194","chr6","167327168","167327237","15","160894041"
"chr8","6459931","6460154","chr8","6336977","6337200","5","122954"
"chr8","6494199","6494466","chr8","6371498","6371770","16","122701"
"chr8","6537389","6537665","chr8","6415214","6415492","13","122175"
"chr8","6553980","6554261","chr8","6431015","6431296","15","122965"
"chr8","6560483","6560721","chr8","6437606","6437802","48","122877"
"chr8","6565598","6565692","chr8","6442812","6442909","6","122786"
"chr8","6566200","6566368","chr8","6443411","6443577","7","122789"
"chr8","6588938","6589248","chr8","6466096","6466406","17","122842"
"chr8","6650007","6650332","chr8","6528592","6528906","17","121415"
"chr8","6666255","6666567","chr16","59899228","59899527","66","53232973"
"chr8","6675408","6675581","chr10","71101618","71101789","40","64426210"
"chr8","6685263","6685557","chr7","37314940","37315240","53","30629677"
"chr8","6816447","6816729","chr8","6548835","6549117","10","267612"
"chr8","6821242","6821524","chr8","6548835","6549117","11","272407"
"chr8","6829797","6830004","chr3","173325146","173325338","40","166495349"
"chr8","6830005","6830054","chr1","54500597","54500644","7","47670592"
"chr8","6908553","6908712","chr8","6653047","6653206","1","255506"
"chr8","6959534","6959845","chr8","6602051","6602343","34","357483"
"chr8","6973991","6974257","chr3","151919462","151919729","63","144945471"
"chr8","6984361","6984435","chr3","46215046","46215109","28","39230685"
"chr8","6987781","6987858","chr5","100636168","100636244","13","93648387"
"chr8","7128308","7128625","chr8","6937511","6937830","11","190797"
"chr8","7140082","7140393","chr4","152226280","152226592","67","145086198"
"chr8","7171724","7172020","chr8","6984649","6984944","7","187075"
"chr8","7189261","7189402","chr7","123622555","123622695","21","116433294"
"chr8","7189980","7190132","chr7","94503336","94503491","36","87313356"
"chr8","7191811","7191916","chr1","14729430","14729534","23","7537619"
"chr8","7197082","7197422","chr8","7011328","7011628","48","185754"
"chr8","7197565","7197889","chr8","7011771","7012093","9","185794"
"chr8","7207053","7207309","chr8","7021181","7021447","17","185872"
"chr8","7221460","7221620","chr1","210690398","210690555","26","203468938"
"chr8","7232285","7232427","chr8","7046763","7046905","5","185522"
"chr8","7232716","7232862","chr8","7047185","7047346","20","185531"
"chr8","7234995","7235293","chr8","7049446","7049745","15","185549"
"chr8","7251368","7251483","chr9","37866413","37866529","21","30615045"
"chr8","7255579","7255874","chr8","7069951","7070237","34","185628"
"chr8","7284550","7284644","chr13","37333110","37333203","22","30048560"
"chr8","7284988","7285127","chr8","7100920","7101059","5","184068"
"chr8","7285128","7285386","chr8","7101060","7101324","17","184068"
"chr8","7285387","7285553","chr8","7101325","7101484","12","184062"
"chr8","7319138","7319457","chr8","7139132","7139424","44","180006"
"chr8","7324975","7325269","chr8","7144995","7145304","25","179980"
"chr8","7344326","7344632","chr8","7164905","7165209","9","179421"
"chr8","7353575","7353863","chr8","7174200","7174484","19","179375"
"chr8","7361766","7362020","chr8","7182417","7182677","14","179349"
"chr8","7378017","7378315","chr1","54009018","54009323","65","46631001"
"chr8","7380411","7380688","chr8","7201806","7202082","10","178605"
"chr8","7395336","7395506","chr19","27304874","27305037","35","19909538"
"chr8","7395832","7395948","chr4","152229174","152229290","20","144833342"
"chr8","7417400","7417598","chr8","7238607","7238805","11","178793"
"chr8","7443427","7443723","chr8","7264869","7265165","7","178558"
"chr8","7469751","7470033","chr8","7291201","7291483","5","178550"
"chr8","7507286","7507577","chr8","7329653","7329949","16","177633"
"chr8","7510805","7511106","chr8","7333639","7333940","9","177166"
"chr8","7590339","7590629","chr8","7413003","7413293","14","177336"
"chr8","7591410","7591720","chr8","7414072","7414380","10","177338"
"chr8","7611512","7611821","chr8","7434150","7434461","24","177362"
"chr8","7621875","7622073","chr8","7444543","7444740","5","177332"
"chr8","7623879","7624189","chr8","7446378","7446687","10","177501"
"chr8","7627691","7627881","chr3","173325146","173325338","45","165697455"
"chr8","7658381","7658534","chr1","130150311","130150462","30","122491930"
"chr8","7692103","7692254","chr2","43194047","43194197","33","35501944"
"chr8","7696651","7696931","chr8","7519006","7519278","16","177645"
"chr8","7704235","7704530","chr8","7526597","7526894","14","177638"
"chr8","7708091","7708403","chr7","46240539","46240847","52","38532448"
"chr8","7731471","7731766","chr8","7552060","7552353","14","179411"
"chr8","7739990","7740058","chr8","7560585","7560653","0","179405"
"chr8","7746101","7746440","chr8","7566732","7567064","15","179369"
"chr8","7763910","7763987","chr12","63014671","63014741","17","55250761"
"chr8","7767401","7767575","chr8","7588491","7588684","33","178910"
"chr8","7767884","7768032","chr8","7588966","7589114","1","178918"
"chr8","7803908","7804211","chr8","7624220","7624530","17","179688"
"chr8","7831607","7831908","chr14","101406625","101406922","61","93575018"
"chr8","7863083","7863384","chr8","7682798","7683098","16","180285"
"chr8","7873603","7873905","chr8","7693399","7693701","4","180204"
"chr8","7884467","7884761","chr8","7704227","7704522","7","180240"
"chr8","7885900","7886090","chr8","7705656","7705833","16","180244"
"chr8","7886401","7886538","chr8","7706144","7706285","7","180257"
"chr8","7891167","7891451","chr8","7710631","7710915","6","180536"
"chr8","7924877","7925010","chr8","7744642","7744765","14","180235"
"chr8","7927722","7927930","chr8","7747492","7747728","31","180230"
"chr8","7930673","7930817","chr7","129357088","129357233","32","121426415"
"chr8","7930859","7931051","chr11","6667351","6667535","37","1263508"
"chr8","7936889","7937193","chr8","7756989","7757310","24","179900"
"chr8","8006282","8006588","chr8","7826838","7827144","6","179444"
"chr8","8014969","8015286","chr10","12189247","12189557","71","4174278"
"chr8","8043422","8043633","chr7","58729599","58729780","58","50686177"
"chr8","8043721","8043734","chr7","131301405","131301416","3","123257684"
"chr8","8043783","8043917","chr12","23460257","23460388","25","15416474"
"chr8","8045501","8045806","chr8","7866637","7866925","19","178864"
"chr8","8066177","8066449","chr3","42202000","42202261","56","34135823"
"chr8","8106837","8107008","chr8","7932406","7932588","19","174431"
"chr8","8107198","8107315","chr8","7932772","7932889","4","174426"
"chr8","8111646","8111918","chr8","7937258","7937526","7","174388"
"chr8","8117717","8117863","chr6","148154766","148154916","29","140037049"
"chr8","8127808","8128109","chr8","7953263","7953546","24","174545"
"chr8","8137328","8137469","chr7","103195334","103195476","29","95058006"
"chr8","8147546","8147795","chr8","7971275","7971525","9","176271"
"chr8","8198545","8198660","chr8","8021977","8022092","3","176568"
"chr8","8199063","8199264","chr8","8022404","8022634","36","176659"
"chr8","8275438","8275600","chr8","8098939","8099101","2","176499"
"chr8","8342659","8342806","chr8","8166010","8166157","3","176649"
"chr8","8391368","8391509","chr8","8215025","8215167","3","176343"
"chr8","8391664","8391810","chr8","8215329","8215474","3","176335"
"chr8","8433823","8434111","chr8","8254220","8254538","37","179603"
"chr8","8457770","8458063","chr8","8277876","8278169","11","179894"
"chr8","8460081","8460376","chr8","8280187","8280482","10","179894"
"chr8","8479535","8479782","chr8","8299487","8299740","12","180048"
"chr8","8486112","8486267","chr1","202426861","202427019","31","193940749"
"chr8","8510717","8511029","chr8","8329862","8330178","10","180855"
"chr8","8543360","8543537","chr8","8366731","8366906","4","176629"
"chr8","8556955","8557226","chr8","8379878","8380148","2","177077"
"chr8","8558535","8558737","chr8","8381451","8381667","17","177084"
"chr8","8630057","8630364","chr8","8454666","8455007","48","175391"
"chr8","8640847","8641067","chr8","8465504","8465724","11","175343"
"chr8","8641132","8641439","chr17","88507291","88507595","65","79866159"
"chr8","8647768","8648067","chr8","8473649","8473947","11","174119"
"chr8","8671822","8671923","chr8","8498004","8498102","3","173818"
"chr8","8673383","8673496","chr8","8499563","8499676","1","173820"
"chr8","8684228","8684524","chr8","8510394","8510691","11","173834"
"chr8","8685590","8685890","chr8","8511758","8512049","37","173832"
"chr8","8719365","8719659","chr7","43492685","43492975","58","34773320"
"chr8","8768435","8768732","chr3","51926732","51927030","54","43158297"
"chr8","8776928","8777091","chr6","31409990","31410151","28","22633062"
"chr8","8777128","8777257","chr16","4463309","4463439","28","4313819"
"chr8","8781474","8781768","chr8","8609186","8609479","7","172288"
"chr8","8940126","8940273","chr8","8767288","8767411","26","172838"
"chr8","8965483","8965581","chr9","42532907","42533005","18","33567424"
"chr8","8980113","8980422","chr8","8807213","8807526","11","172900"
"chr8","9007352","9007651","chr15","12435717","12436012","76","3428365"
"chr8","9012044","9012174","chr6","65110840","65110974","25","56098796"
"chr8","9026564","9026864","chr13","31401821","31402103","77","22375257"
"chr8","9042587","9042876","chr8","8870148","8870437","4","172439"
"chr8","9046330","9046620","chr8","8873902","8874192","4","172428"
"chr8","9074242","9074549","chr8","8898530","8898825","21","175712"
"chr8","9123930","9124220","chr8","8953956","8954255","25","169974"
"chr8","9127128","9127357","chr8","8957119","8957348","6","170009"
"chr8","9189647","9189973","chr8","9019785","9020107","10","169862"
"chr8","9207799","9207963","chr19","1299084","1299243","31","7908715"
"chr8","9211649","9211805","chr20","35587620","35587774","25","26375971"
"chr8","9217721","9218020","chr8","9047471","9047762","11","170250"
"chr8","9218021","9218160","chr5","46483676","46483812","27","37265655"
"chr8","9245117","9245393","chr12","20754332","20754612","59","11509215"
"chr8","9253576","9253872","chr8","9085924","9086220","9","167652"
"chr8","9257835","9258113","chr8","9090140","9090417","12","167695"
"chr8","9262513","9262647","chr10","32559799","32559934","29","23297286"
"chr8","9262954","9263115","chr7","23333641","23333802","38","14070687"
"chr8","9263527","9263852","chr10","12189247","12189557","69","2925720"
"chr8","9266154","9266464","chr8","9098966","9099275","16","167188"
"chr8","9274899","9275201","chr8","9107496","9107794","16","167403"
"chr8","9288744","9289039","chr8","9121116","9121414","11","167628"
"chr8","9291778","9292037","chr8","9124136","9124397","10","167642"
"chr8","9334597","9334920","chr11","50330487","50330804","68","40995890"
"chr8","9354818","9355103","chr8","9187843","9188124","14","166975"
"chr8","9356836","9357050","chr14","33242830","33243041","42","23885994"
"chr8","9368532","9368815","chr7","121200714","121201002","57","111832182"
"chr8","9375281","9375600","chr8","9208535","9208855","11","166746"
"chr8","9378022","9378241","chr8","9211336","9211555","10","166686"
"chr8","9479416","9479689","chr8","9314843","9315145","34","164573"
"chr8","9524571","9524841","chr8","9359062","9359328","9","165509"
"chr8","9530736","9531020","chr8","9365258","9365545","16","165478"
"chr8","9556506","9556801","chr8","9391527","9391820","11","164979"
"chr8","9562342","9562647","chr8","9397340","9397646","8","165002"
"chr8","9566524","9566819","chr8","9401544","9401838","14","164980"
"chr8","9580457","9580775","chr8","9415239","9415553","8","165218"
"chr8","9625410","9625702","chr8","9460139","9460431","8","165271"
"chr8","9640821","9641100","chr8","9476275","9476557","12","164546"
"chr8","9652382","9652670","chr8","9487903","9488209","25","164479"
"chr8","9661832","9661982","chr16","26063166","26063307","36","16401334"
"chr8","9662114","9662227","chrX","44430331","44430445","26","34768217"
"chr8","9685725","9686025","chr8","9520533","9520828","9","165192"
"chr8","9707330","9707623","chr8","9542603","9542891","6","164727"
"chr8","9749879","9750186","chr9","62110246","62110555","54","52360367"
"chr8","9774445","9774610","chr8","9612958","9613122","5","161487"
"chr8","9803065","9803353","chr8","9642987","9643275","8","160078"
"chr8","9806732","9806919","chr8","9646699","9646887","8","160033"
"chr8","9811306","9811584","chr8","9651404","9651680","11","159902"
"chr8","9820431","9820744","chr12","27863620","27863927","59","18043189"
"chr8","9825392","9825688","chr8","9666939","9667235","24","158453"
"chr8","9835381","9835691","chr8","9676710","9677020","6","158671"
"chr8","9841098","9841404","chr8","9683072","9683368","18","158026"
"chr8","9863936","9864218","chr8","9707342","9707624","6","156594"
"chr8","9887443","9887549","chr1","198465701","198465806","23","188578258"
"chr8","9887720","9887752","chr12","18336921","18336957","8","8449201"
"chr8","9887792","9887825","chr3","39652310","39652342","5","29764518"
"chr8","9889705","9889997","chr8","9736320","9736606","23","153385"
"chr8","9908818","9908989","chr8","9756503","9756674","6","152315"
"chr8","9909294","9909426","chr8","9756973","9757105","4","152321"
"chr8","9933509","9933820","chr19","28718617","28718918","62","18785108"
"chr8","9944373","9944690","chr8","9792862","9793179","10","151511"
"chr8","9963309","9963601","chr8","9812845","9813156","35","150464"
"chr8","9967318","9967593","chr8","9816826","9817127","42","150492"
"chr8","9971110","9971405","chr8","9820372","9820672","16","150738"
"chr8","9976789","9977069","chr8","9826396","9826677","8","150393"
"chr8","9983096","9983386","chr8","9833095","9833385","4","150001"
"chr8","9988893","9989186","chr8","9838947","9839240","5","149946"
"chr8","9996266","9996483","chr8","9845973","9846189","5","150293"
"chr8","10000001","10000146","chr10","27946051","27946189","27","17946050"
"chr8","10018132","10018356","chr8","9868203","9868427","6","149929"
"chr8","10053688","10053849","chr8","9904201","9904340","25","149487"
"chr8","10059855","10060151","chr8","9910350","9910643","20","149505"
"chr8","10070805","10071107","chr8","9921645","9921950","14","149160"
"chr8","10085605","10085753","chr8","9936696","9936849","10","148909"
"chr8","10087451","10087572","chr2","130838047","130838167","26","120750596"
"chr8","10088306","10088478","chr13","99761862","99762027","43","89673556"
"chr8","10121846","10121998","chr5","43753044","43753195","33","33631198"
"chr8","10122040","10122155","chrX","7460633","7460751","18","2661407"
"chr8","10132691","10132822","chr8","9987973","9988104","2","144718"
"chr8","10142303","10142577","chr8","9997625","9997899","2","144678"
"chr8","10142608","10142743","chr8","9997930","9998065","5","144678"
"chr8","10156231","10156515","chr1","27434081","27434370","54","17277850"
"chr8","10167455","10167750","chr4","8483558","8483859","75","1683897"
"chr8","10175341","10175654","chr4","152226280","152226592","53","142050939"
"chr8","10186249","10186547","chr13","36379149","36379449","51","26192900"
"chr8","10198237","10198519","chr2","21520160","21520441","62","11321923"
"chr8","10232478","10232740","chr6","172279903","172280171","57","162047425"
"chr8","10274550","10274885","chr8","10014139","10014430","58","260411"
"chr8","10288366","10288645","chr8","10028050","10028329","2","260316"
"chr8","10295260","10295546","chr8","10034943","10035230","3","260317"
"chr8","10332217","10332398","chr8","10069323","10069506","9","262894"
"chr8","10334282","10334579","chr8","10071366","10071668","20","262916"
"chr8","10335434","10335767","chr8","10072551","10072884","9","262883"
"chr8","10364556","10364821","chr8","10101153","10101417","8","263403"
"chr8","10375856","10376156","chr8","10112421","10112720","8","263435"
"chr8","10432525","10432812","chr8","10168976","10169260","9","263549"
"chr8","10435138","10435429","chr8","10171604","10171882","22","263534"
"chr8","10441445","10441759","chr8","10178126","10178441","8","263319"
"chr8","10447946","10448254","chr8","10184547","10184857","11","263399"
"chr8","10480967","10481290","chr8","10217410","10217734","10","263557"
"chr8","10491343","10491653","chr8","10227772","10228082","6","263571"
"chr8","10496843","10496988","chr8","10233300","10233446","5","263543"
"chr8","10497361","10497528","chr8","10233822","10233989","8","263539"
"chr8","10503888","10504188","chr8","10240353","10240661","46","263535"
"chr8","10517462","10517772","chr8","10253941","10254256","16","263521"
"chr8","10536141","10536370","chr8","10272589","10272817","8","263552"
"chr8","10538776","10539085","chr8","10275227","10275533","10","263549"
"chr8","10589374","10589603","chr2","33057930","33058156","43","22468556"
"chr8","10597193","10597477","chr8","10333113","10333408","20","264080"
"chr8","10623810","10624031","chr19","35111438","35111666","56","24487628"
"chr8","10632217","10632451","chr4","109393051","109393299","60","98760834"
"chr8","10634775","10635105","chr8","10367473","10367777","40","267302"
"chr8","10636999","10637298","chr8","10369679","10369978","4","267320"
"chr8","10646630","10646936","chr8","10382228","10382538","13","264402"
"chr8","10651821","10652122","chr8","10387427","10387730","15","264394"
"chr8","10653846","10654147","chr8","10389300","10389601","9","264546"
"chr8","10658499","10658802","chr8","10393929","10394234","9","264570"
"chr8","10690521","10690811","chr8","10427101","10427392","5","263420"
"chr8","10700488","10700746","chr8","10437452","10437706","9","263036"
"chr8","10717939","10718231","chr8","10455125","10455417","10","262814"
"chr8","10802075","10802263","chr20","27084615","27084805","42","16282540"
"chr8","10803813","10803943","chr13","65376615","65376748","31","54572802"
"chr8","10824991","10825265","chr8","10564040","10564314","3","260951"
"chr8","10830477","10830765","chr8","10569726","10570015","3","260751"
"chr8","10846696","10846986","chr8","10585923","10586213","4","260773"
"chr8","10856863","10857040","chr2","78396898","78397056","44","67540035"
"chr8","10869635","10869922","chr4","69077877","69078163","55","58208242"
"chr8","10873246","10873507","chr8","10612088","10612322","40","261158"
"chr8","10900492","10900801","chr8","10641252","10641556","25","259240"
"chr8","10910644","10910955","chr8","10651334","10651643","6","259310"
"chr8","10922731","10923043","chr8","10664378","10664691","9","258353"
"chr8","10935207","10935498","chr8","10677505","10677797","7","257702"
"chr8","10984992","10985265","chr8","10727759","10728032","4","257233"
"chr8","10992436","10992710","chr8","10735325","10735584","19","257111"
"chr8","10995492","10995709","chr8","10738359","10738575","10","257133"
"chr8","10996220","10996292","chr14","58785506","58785573","14","47789286"
"chr8","11005461","11005577","chr8","10748290","10748406","2","257171"
"chr8","11012481","11012790","chr8","10755213","10755522","11","257268"
"chr8","11050816","11051130","chr8","10793529","10793846","13","257287"
"chr8","11054454","11054747","chr8","10797175","10797464","10","257279"
"chr8","11058952","11059234","chr8","10801709","10801991","9","257243"
"chr8","11102460","11102698","chr8","10845545","10845785","9","256915"
"chr8","11108650","11108955","chr8","10852024","10852338","13","256626"
"chr8","11109150","11109454","chr14","108304405","108304714","58","97195255"
"chr8","11110319","11110604","chr8","10853689","10853974","3","256630"
"chr8","11127139","11127446","chr6","91228537","91228843","15","80101398"
"chr8","11164596","11164918","chr8","10910825","10911146","11","253771"
"chr8","11171447","11171738","chr6","91221013","91221307","21","80049566"
"chr8","11184815","11185173","chr8","10932000","10932382","40","252815"
"chr8","11205671","11205961","chr8","10952175","10952453","23","253496"
"chr8","11209993","11210286","chr8","10956506","10956799","5","253487"
"chr8","11214380","11214504","chr11","28200285","28200407","20","16985905"
"chr8","11217073","11217387","chr8","10964573","10964885","19","252500"
"chr8","11219488","11219847","chr8","10971856","10972238","36","247632"
"chr8","11228392","11228694","chr8","10981131","10981432","14","247261"
"chr8","11231348","11231653","chr8","10984130","10984442","12","247218"
"chr8","11239306","11239615","chr8","10992079","10992385","10","247227"
"chr8","11240383","11240537","chr8","10993160","10993310","10","247223"
"chr8","11258566","11258884","chr8","11011106","11011424","3","247460"
"chr8","11260169","11260480","chr8","11012707","11013017","14","247462"
"chr8","11273692","11273900","chr8","11026129","11026343","16","247563"
"chr8","11298577","11298889","chr8","11050730","11051032","17","247847"
"chr8","11321312","11321605","chr8","11073988","11074272","16","247324"
"chr8","11356501","11356733","chr8","11109845","11110079","12","246656"
"chr8","11358771","11359063","chr1","56326851","56327136","63","44968080"
"chr8","11360710","11361016","chr8","11113993","11114306","19","246717"
"chr8","11412109","11412443","chr2","81861651","81861964","92","70449542"
"chr8","11424505","11424810","chr8","11177789","11178094","14","246716"
"chr8","11433762","11433880","chr20","50499608","50499727","19","39065846"
"chr8","11475773","11476090","chr8","11227525","11227870","45","248248"
"chr8","11524138","11524448","chr8","11276709","11277017","14","247429"
"chr8","11553609","11553898","chr1","63128997","63129278","58","51575388"
"chr8","11585809","11586023","chr11","120702341","120702559","51","109116532"
"chr8","11594618","11594921","chr8","11343942","11344241","14","250676"
"chr8","11648917","11649074","chr8","11400706","11400863","3","248211"
"chr8","11649493","11649582","chr1","41105462","41105554","22","29455969"
"chr8","11714644","11714863","chr12","34801634","34801856","44","23086990"
"chr8","11817137","11817287","chr8","11574527","11574677","10","242610"
"chr8","11940117","11940354","chr8","11702136","11702373","9","237981"
"chr8","12105535","12105750","chr8","11875625","11875847","19","229910"
"chr8","12107061","12107148","chr8","11877000","11877087","3","230061"
"chr8","12371352","12371696","chr8","12145213","12145527","42","226139"
"chr8","12420452","12420588","chr8","12194457","12194570","28","225995"
"chr8","12424777","12425075","chr8","12199272","12199564","18","225505"
"chr8","12483876","12484106","chr8","12257072","12257302","8","226804"
"chr8","12504454","12504775","chrX","93493250","93493547","78","80988796"
"chr8","12556734","12556869","chr8","12326089","12326224","9","230645"
"chr8","12604690","12604993","chr18","13133678","13133976","61","528988"
"chr8","12607841","12608054","chr8","12378076","12378289","1","229765"
"chr8","12729134","12729419","chr4","112784516","112784799","64","100055382"
"chr8","12797354","12797476","chr2","87140260","87140382","18","74342906"
"chr8","12797508","12797672","chr1","135158414","135158570","38","122360906"
"chr8","12897125","12897443","chr8","12674375","12674697","12","222750"
"chr8","12927652","12927858","chr9","25989257","25989459","47","13061605"
"chr8","13002081","13002376","chr2","93797717","93798021","69","80795636"
"chr8","13014535","13014858","chr8","12793478","12793801","14","221057"
"chr8","13114150","13114459","chr8","12904096","12904388","22","210054"
"chr8","13152297","13152586","chr8","12940730","12941021","11","211567"
"chr8","13152706","13152811","chr8","12941123","12941246","22","211583"
"chr8","13200293","13200559","chr8","12988979","12989245","1","211314"
"chr8","13218150","13218447","chr8","13006618","13006911","14","211532"
"chr8","13226331","13226642","chr8","13014867","13015147","42","211464"
"chr8","13235311","13235594","chr8","13023809","13024088","15","211502"
"chr8","13247478","13247744","chr8","13036035","13036301","8","211443"
"chr8","13253440","13253738","chr8","13041964","13042265","16","211476"
"chr8","13253768","13253857","chr8","13042290","13042383","9","211478"
"chr8","13267113","13267424","chr8","13055106","13055405","27","212007"
"chr8","13276901","13277127","chr8","13064928","13065153","11","211973"
"chr8","13404193","13404506","chr8","13191044","13191356","9","213149"
"chr8","13435612","13435725","chr3","54881654","54881759","21","41446042"
"chr8","13435755","13435935","chr8","13225069","13225228","33","210686"
"chr8","13444553","13444858","chr16","69494471","69494773","68","56049918"
"chr8","13469115","13469314","chr8","13257456","13257656","9","211659"
"chr8","13489893","13490093","chr8","13280879","13281077","10","209014"
"chr8","13554639","13554911","chr8","13346464","13346737","12","208175"
"chr8","13568092","13568380","chr2","81423981","81424267","66","67855889"
"chr8","13572109","13572262","chr8","13363869","13364034","19","208240"
"chr8","13572290","13572363","chr8","13364060","13364133","4","208230"
"chr8","13572379","13572480","chr8","13364149","13364250","3","208230"
"chr8","13586449","13586750","chr8","13377766","13378066","15","208683"
"chr8","13683590","13683865","chr8","13481948","13482222","6","201642"
"chr8","13688901","13689078","chr8","13487289","13487460","18","201612"
"chr8","13689105","13689208","chr8","13487494","13487600","17","201611"
"chr8","13707362","13707665","chr8","13505426","13505715","25","201936"
"chr8","13734373","13734524","chr8","13532259","13532410","7","202114"
"chr8","13788200","13788373","chr13","47285224","47285397","29","33497024"
"chr8","13788413","13788529","chr7","46204039","46204155","17","32415626"
"chr8","13845809","13846090","chr8","13643984","13644270","35","201825"
"chr8","13914817","13915105","chr8","13716676","13716952","56","198141"
"chr8","13929163","13929440","chr20","41590829","41591107","52","27661666"
"chr8","13994691","13994995","chr8","13798402","13798703","13","196289"
"chr8","14010767","14011039","chr8","13814537","13814812","11","196230"
"chr8","14057980","14058282","chr8","13862027","13862343","33","195953"
"chr8","14186184","14186485","chr8","13996993","13997295","18","189191"
"chr8","14213636","14213921","chr8","14024253","14024538","11","189383"
"chr8","14239476","14239609","chr8","14050521","14050654","3","188955"
"chr8","14289409","14289722","chr8","14101507","14101816","18","187902"
"chr8","14318327","14318618","chr8","14130744","14131013","32","187583"
"chr8","14524702","14524992","chr8","14346247","14346536","9","178455"
"chr8","14535499","14535779","chr1","54800363","54800645","62","40264864"
"chr8","14606071","14606399","chr8","14428754","14429078","17","177317"
"chr8","14717767","14717995","chr8","14541081","14541308","14","176686"
"chr8","14773451","14773733","chr8","14595137","14595419","4","178314"
"chr8","14831305","14831618","chr8","14652507","14652820","10","178798"
"chr8","14846125","14846430","chr8","14668148","14668449","23","177977"
"chr8","14915624","14915949","chr8","14740564","14740889","9","175060"
"chr8","14928837","14929166","chr8","14754050","14754368","22","174787"
"chr8","14940099","14940384","chr8","14765359","14765645","8","174740"
"chr8","14944878","14945114","chr8","14770126","14770370","11","174752"
"chr8","14953209","14953527","chr13","54706419","54706732","66","39753210"
"chr8","14960751","14961058","chr7","111283263","111283566","57","96322512"
"chr8","14997911","14998037","chr8","14821354","14821482","7","176557"
"chr8","14998888","14999185","chr8","14822319","14822625","21","176569"
"chr8","15050531","15050598","chr4","118012815","118012880","12","102962284"
"chr8","15050827","15051065","chr6","65041124","65041348","69","49990297"
"chr8","15099045","15099335","chr8","14926437","14926726","9","172608"
"chr8","15105361","15105677","chr8","14931715","14932036","19","173646"
"chr8","15111343","15111634","chr8","14939472","14939754","20","171871"
"chr8","15134040","15134336","chr8","14962592","14962888","6","171448"
"chr8","15151709","15152008","chr3","39028401","39028699","40","23876692"
"chr8","15161048","15161342","chr8","14989232","14989523","12","171816"
"chr8","15257623","15257856","chr8","15084031","15084262","13","173592"
"chr8","15258216","15258396","chr8","15084634","15084808","10","173582"
"chr8","15258841","15259170","chr20","56529053","56529373","66","41270212"
"chr8","15275219","15275532","chr8","15102433","15102744","15","172786"
"chr8","15297585","15297705","chr8","15125070","15125186","6","172515"
"chr8","15325688","15325977","chr8","15153076","15153365","7","172612"
"chr8","15396562","15396837","chr8","15225060","15225335","7","171502"
"chr8","15413814","15414115","chr8","15242313","15242616","6","171501"
"chr8","15420119","15420383","chr8","15248689","15248961","10","171430"
"chr8","15434224","15434530","chr8","15262689","15263000","17","171535"
"chr8","15446877","15447161","chr8","15277650","15277934","15","169227"
"chr8","15471901","15472178","chr8","15303523","15303800","10","168378"
"chr8","15508269","15508357","chr8","15340325","15340413","2","167944"
"chr8","15519124","15519404","chr8","15352535","15352839","28","166589"
"chr8","15544149","15544471","chr8","15377899","15378210","25","166250"
"chr8","15550958","15551264","chr8","15385550","15385854","8","165408"
"chr8","15560596","15560666","chr8","15394935","15395005","7","165661"
"chr8","15563125","15563338","chr8","15397470","15397687","15","165655"
"chr8","15590914","15591066","chr8","15426169","15426321","2","164745"
"chr8","15617534","15617832","chr8","15453001","15453299","10","164533"
"chr8","15623141","15623475","chr11","31441061","31441365","80","15817920"
"chr8","15637607","15637779","chr8","15472471","15472643","4","165136"
"chr8","15689991","15690299","chr8","15525953","15526263","12","164038"
"chr8","15700556","15700846","chr8","15536786","15537081","32","163770"
"chr8","15704640","15704907","chr8","15540855","15541122","16","163785"
"chr8","15714321","15714625","chr8","15550654","15550957","12","163667"
"chr8","15745857","15746036","chr8","15582456","15582635","6","163401"
"chr8","15752256","15752541","chr8","15588836","15589123","17","163420"
"chr8","15875931","15876242","chr8","15713162","15713473","18","162769"
"chr8","15895409","15895714","chr8","15732450","15732782","36","162959"
"chr8","15902472","15902766","chr8","15740129","15740421","13","162343"
"chr8","15905533","15905823","chr8","15743017","15743307","10","162516"
"chr8","15909248","15909350","chr8","15746712","15746814","0","162536"
"chr8","15916389","15916603","chr20","49670256","49670467","44","33753867"
"chr8","15917708","15917963","chr8","15755148","15755420","24","162560"
"chr8","16044362","16044673","chr8","15890244","15890555","8","154118"
"chr8","16138123","16138208","chr8","15987521","15987606","2","150602"
"chr8","16138572","16138781","chr8","15987973","15988179","6","150599"
"chr8","16156618","16156928","chr8","16006525","16006834","9","150093"
"chr8","16218757","16218916","chr8","16069728","16069888","5","149029"
"chr8","16219532","16219807","chr8","16070513","16070792","16","149019"
"chr8","16252057","16252340","chr15","94351902","94352190","60","78099845"
"chr8","16252604","16252896","chr8","87191709","87191998","53","70939105"
"chr8","16291911","16292175","chr8","16097498","16097760","16","194413"
"chr8","16294925","16295060","chr8","4114371","4114505","21","12180554"
"chr8","16338041","16338345","chr8","16149729","16150034","13","188312"
"chr8","16419003","16419307","chr8","16230659","16230964","3","188344"
"chr8","16427968","16428252","chr8","16236648","16236932","7","191320"
"chr8","16585007","16585308","chr8","16393199","16393498","10","191808"
"chr8","16586520","16586797","chr8","16394714","16394993","11","191806"
"chr8","16588052","16588193","chr8","16396246","16396387","4","191806"
"chr8","16671526","16671628","chr8","16480840","16480937","6","190686"
"chr8","16674480","16674775","chr8","16483809","16484104","8","190671"
"chr8","16676658","16676959","chr8","16486288","16486589","9","190370"
"chr8","16696334","16696369","chr8","136517848","136517884","11","119821514"
"chr8","16696714","16696870","chr8","16505639","16505795","5","191075"
"chr8","16708757","16709061","chr8","16518282","16518587","13","190475"
"chr8","16711405","16711528","chr4","17500554","17500677","22","789149"
"chr8","16753977","16754140","chr9","86631758","86631910","34","69877781"
"chr8","16773461","16773759","chr8","16583644","16583938","16","189817"
"chr8","16783696","16783814","chr8","16593777","16593894","4","189919"
"chr8","16792987","16793301","chr8","16602125","16602451","22","190862"
"chr8","16855704","16855973","chr8","16665108","16665378","12","190596"
"chr8","16914187","16914304","chr8","16731015","16731132","4","183172"
"chr8","16957433","16957705","chr8","16774415","16774683","17","183018"
"chr8","16962813","16963135","chr8","16779718","16780044","10","183095"
"chr8","16963977","16964264","chr8","16780886","16781173","7","183091"
"chr8","16965956","16966260","chr8","16782867","16783171","5","183089"
"chr8","16982978","16983272","chr8","16800143","16800437","8","182835"
"chr8","17044555","17044866","chr8","16862666","16862976","13","181889"
"chr8","17047885","17048182","chr8","16866064","16866328","38","181821"
"chr8","17090635","17090917","chr8","16908570","16908877","31","182065"
"chr8","17124081","17124361","chr8","16942426","16942698","20","181655"
"chr8","17125910","17126196","chr8","16944224","16944539","38","181686"
"chr8","17140220","17140507","chr18","39793326","39793610","58","22653106"
"chr8","17155873","17156173","chr8","16974798","16975104","16","181075"
"chr8","17164840","17164994","chr1","112152519","112152676","30","94987679"
"chr8","17181532","17181838","chr8","17000093","17000387","28","181439"
"chr8","17196339","17196643","chr8","17014783","17015087","8","181556"
"chr8","17237496","17237652","chr15","45614473","45614630","28","28376977"
"chr8","17302823","17303095","chr8","17117973","17118245","10","184850"
"chr8","17393332","17393637","chr8","17217287","17217593","20","176045"
"chr8","17395748","17396034","chr8","17219737","17220029","22","176011"
"chr8","17408014","17408308","chr8","17231989","17232269","30","176025"
"chr8","17428714","17428995","chr3","129245083","129245365","60","111816369"
"chr8","17430265","17430561","chr8","17257159","17257456","5","173106"
"chr8","17437555","17437854","chr8","17264426","17264725","9","173129"
"chr8","17440699","17440996","chr8","17267572","17267869","11","173127"
"chr8","17465435","17465740","chr11","43122250","43122544","69","25656815"
"chr8","17471583","17471761","chr8","17298687","17298876","22","172896"
"chr8","17475611","17475890","chr16","54204330","54204617","59","36728719"
"chr8","17477997","17478162","chr8","17305162","17305334","12","172835"
"chr8","17493625","17493902","chr8","17319156","17319433","5","174469"
"chr8","17553475","17553772","chr8","17380507","17380804","8","172968"
"chr8","17640436","17640726","chr8","17468457","17468747","12","171979"
"chr8","17663067","17663337","chr8","17493149","17493417","17","169918"
"chr8","17679757","17680041","chr1","124158164","124158443","59","106478407"
"chr8","17684316","17684637","chr8","17513774","17514092","11","170542"
"chr8","17688487","17688794","chr8","17517847","17518142","21","170640"
"chr8","17724160","17724444","chr8","17555991","17556289","34","168169"
"chr8","17731541","17731703","chr8","17563125","17563289","8","168416"
"chr8","17734184","17734482","chr8","17565785","17566088","23","168399"
"chr8","17739702","17740001","chr8","17575115","17575414","10","164587"
"chr8","17743368","17743675","chr20","38966161","38966469","61","21222793"
"chr8","17744955","17745274","chr8","17580672","17580980","23","164283"
"chr8","17747163","17747510","chr8","17582899","17583248","25","164264"
"chr8","17758657","17758950","chr7","40104725","40105017","61","22346068"
"chr8","17768608","17768920","chr8","17604235","17604535","23","164373"
"chr8","17771056","17771364","chr8","17606638","17606938","22","164418"
"chr8","17777123","17777331","chr8","17612825","17613053","26","164298"
"chr8","17798002","17798306","chr8","17633462","17633775","16","164540"
"chr8","17819877","17820154","chr8","17655750","17656027","11","164127"
"chr8","17822213","17822517","chr8","17655750","17656027","41","166463"
"chr8","17867225","17867294","chr8","17702901","17702972","4","164324"
"chr8","17884710","17885031","chr8","17720292","17720607","17","164418"
"chr8","17886543","17886835","chr8","17722098","17722390","9","164445"
"chr8","17905213","17905505","chr8","17740293","17740589","14","164920"
"chr8","17906850","17907157","chr8","17741932","17742240","23","164918"
"chr8","17922493","17922802","chr8","17759198","17759506","11","163295"
"chr8","17946247","17946547","chr8","17783971","17784271","10","162276"
"chr8","17954829","17955134","chr8","17792531","17792835","7","162298"
"chr8","17976082","17976364","chr8","17813933","17814208","19","162149"
"chr8","17977653","17977939","chr8","17815500","17815786","5","162153"
"chr8","17989570","17989872","chr8","17827254","17827550","34","162316"
"chr8","17997846","17998098","chr8","17836642","17836894","4","161204"
"chr8","18004944","18005248","chr11","50004656","50004962","57","31999712"
"chr8","18018480","18018779","chr8","17860492","17860787","13","157988"
"chr8","18038872","18039130","chr8","17880911","17881169","7","157961"
"chr8","18070443","18070567","chr2","144463462","144463586","17","126393019"
"chr8","18080821","18080935","chr8","17924589","17924707","9","156232"
"chr8","18114958","18115252","chr8","17961089","17961383","4","153869"
"chr8","18193026","18193298","chr8","18033459","18033730","10","159567"
"chr8","18213397","18213725","chr8","18053684","18053993","31","159713"
"chr8","18220515","18220746","chr8","18060751","18061026","49","159764"
"chr8","18240843","18241132","chr8","18081454","18081773","50","159389"
"chr8","18254142","18254321","chr8","18094739","18094899","28","159403"
"chr8","18267030","18267328","chr8","18108006","18108301","8","159024"
"chr8","18309319","18309484","chr1","39513747","39513909","34","21204428"
"chr8","18382273","18382586","chr8","18217871","18218183","16","164402"
"chr8","18391215","18391520","chr8","18226890","18227177","29","164325"
"chr8","18392012","18392159","chr11","121092295","121092441","25","102700283"
"chr8","18399507","18399802","chr10","69021821","69022111","53","50622314"
"chr8","18404590","18404854","chr20","9889995","9890260","64","8514595"
"chr8","18421650","18421952","chr8","18257992","18258296","8","163658"
"chr8","18439429","18439590","chr8","18275752","18275913","3","163677"
"chr8","18439883","18439978","chr8","18276517","18276611","6","163366"
"chr8","18444479","18444762","chr8","18281316","18281599","12","163163"
"chr8","18445806","18446112","chr8","18282643","18282931","23","163163"
"chr8","18458415","18458680","chr8","18294903","18295168","4","163512"
"chr8","18459381","18459667","chr8","18295868","18296156","10","163513"
"chr8","18459710","18459726","chr7","123424192","123424208","1","104964482"
"chr8","18530702","18530877","chr8","18367122","18367274","26","163580"
"chr8","18531179","18531312","chr8","18367577","18367710","4","163602"
"chr8","18551759","18552015","chr8","18387525","18387784","6","164234"
"chr8","18567906","18568121","chr8","18404496","18404718","21","163410"
"chr8","18645704","18646011","chr8","18482487","18482796","31","163217"
"chr8","18665968","18666235","chr8","18501896","18502161","5","164072"
"chr8","18697022","18697138","chr16","64895361","64895478","19","46198339"
"chr8","18725577","18725844","chr8","18560445","18560710","10","165132"
"chr8","18767193","18767503","chr8","18603981","18604291","14","163212"
"chr8","18891721","18891899","chr3","43728306","43728478","30","24836585"
"chr8","18920469","18920766","chr8","18756525","18756815","13","163944"
"chr8","18995573","18995858","chr8","18833170","18833455","12","162403"
"chr8","19011697","19012015","chr8","18849315","18849637","14","162382"
"chr8","19175123","19175399","chr8","19014542","19014819","7","160581"
"chr8","19180363","19180672","chrX","35852804","35853105","79","16672441"
"chr8","19221672","19221701","chr11","49282861","49282891","4","30061189"
"chr8","19249616","19249766","chr8","19089983","19090132","8","159633"
"chr8","19250065","19250158","chr8","19090442","19090552","19","159623"
"chr8","19417305","19417597","chr4","154722913","154723205","56","135305608"
"chr8","19459987","19460284","chr8","19309067","19309361","12","150920"
"chr8","19534712","19534852","chr8","19383216","19383356","2","151496"
"chr8","19575149","19575426","chr8","19423990","19424273","8","151159"
"chr8","19705256","19705557","chr8","19553182","19553483","9","152074"
"chr8","19732629","19732954","chr8","19580797","19581088","49","151832"
"chr8","19839620","19839930","chr8","19688449","19688749","21","151171"
"chr8","19875597","19875848","chr8","19722829","19723061","25","152768"
"chr8","19880622","19880933","chr8","19727826","19728137","15","152796"
"chr8","19904069","19904378","chr8","19751499","19751803","17","152570"
"chr8","19935102","19935242","chr10","2130477","2130608","24","17804625"
"chr8","19953148","19953459","chr8","19803028","19803338","5","150120"
"chr8","19973597","19973932","chr6","129733574","129733894","73","109759977"
"chr8","19975743","19976050","chr8","19826264","19826571","7","149479"
"chr8","19977679","19977895","chr8","19828200","19828416","7","149479"
"chr8","20032931","20033216","chr1","37432610","37432885","57","17399679"
"chr8","20048071","20048375","chr8","19898838","19899146","7","149233"
"chr8","20067092","20067382","chr8","19918328","19918618","4","148764"
"chr8","20085430","20085745","chr8","19936555","19936870","8","148875"
"chr8","20089091","20089398","chr8","19940460","19940762","14","148631"
"chr8","20093051","20093297","chr8","19944447","19944725","36","148604"
"chr8","20131807","20131876","chr16","72852292","72852355","17","52720485"
"chr8","20136876","20137069","chr17","24384825","24385008","37","4247949"
"chr8","20144856","20145167","chr8","19998460","19998768","13","146396"
"chr8","20145776","20146079","chr8","19999361","19999664","9","146415"
"chr8","20146854","20147186","chr3","51992589","51992910","79","31845735"
"chr8","20147469","20147614","chr8","20000891","20001036","5","146578"
"chr8","20160519","20160821","chr8","20014349","20014651","11","146170"
"chr8","20163378","20163685","chr8","20017558","20017864","18","145820"
"chr8","20166527","20166687","chr2","78396898","78397056","31","58230371"
"chr8","20182630","20182921","chr8","20036948","20037239","6","145682"
"chr8","20229437","20229739","chr8","20083949","20084238","18","145488"
"chr8","20241741","20242062","chr8","20096227","20096540","14","145514"
"chr8","20257269","20257563","chr8","20112101","20112394","7","145168"
"chr8","20260911","20261079","chr8","20115756","20115916","11","145155"
"chr8","20272187","20272503","chr8","20126627","20126923","29","145560"
"chr8","20284792","20285046","chr8","20139605","20139859","1","145187"
"chr8","20287365","20287658","chr8","20142181","20142474","4","145184"
"chr8","20288871","20289006","chr8","20143689","20143824","2","145182"
"chr8","20303887","20304181","chr8","20159137","20159444","20","144750"
"chr8","20305090","20305377","chr8","20160196","20160483","7","144894"
"chr8","20307128","20307438","chr8","20162241","20162546","16","144887"
"chr8","20312891","20313165","chr19","30394583","30394839","77","10081692"
"chr8","20318485","20318767","chr8","20173946","20174228","10","144539"
"chr8","20325907","20326212","chr8","20181372","20181688","18","144535"
"chr8","20330001","20330216","chr8","20185168","20185379","14","144833"
"chr8","20330954","20331088","chr8","20187189","20187325","8","143765"
"chr8","20342146","20342460","chr8","20198406","20198709","11","143740"
"chr8","20350959","20351102","chr1","9667266","9667402","28","10683693"
"chr8","20355951","20356252","chr8","20211417","20211718","9","144534"
"chr8","20369082","20369267","chr1","206823091","206823266","44","186454009"
"chr8","20370879","20371008","chr1","179353901","179354033","25","158983022"
"chr8","20371570","20371870","chr8","20226753","20227051","14","144817"
"chr8","20373545","20373833","chr8","117824355","117824648","72","97450810"
"chr8","20374605","20374884","chr8","20229761","20230044","10","144844"
"chr8","20387325","20387620","chr2","82698487","82698779","51","62311162"
"chr8","20392132","20392417","chr8","20247557","20247842","7","144575"
"chr8","20398606","20398924","chr8","20253398","20253708","15","145208"
"chr8","20402293","20402488","chr8","20257594","20257789","4","144699"
"chr8","20411422","20411584","chr8","20267694","20267856","1","143728"
"chr8","20424788","20425066","chr8","20283935","20284206","11","140853"
"chr8","20428247","20428541","chr8","20287362","20287656","3","140885"
"chr8","20439627","20439933","chr8","20300239","20300534","16","139388"
"chr8","20460043","20460346","chr8","20321771","20322074","10","138272"
"chr8","20461723","20462025","chr8","20323467","20323773","20","138256"
"chr8","20466189","20466484","chr8","20327958","20328258","14","138231"
"chr8","20507902","20508179","chr1","34325150","34325429","53","13817248"
"chr8","20515259","20515581","chr8","20378869","20379187","23","136390"
"chr8","20529391","20529548","chr8","20393446","20393603","6","135945"
"chr8","20529549","20529852","chr1","121621202","121621501","50","101091653"
"chr8","20529853","20529864","chr8","20393902","20393913","0","135951"
"chr8","20546592","20546895","chr8","20408595","20408896","7","137997"
"chr8","20547192","20547485","chr8","20409519","20409812","2","137673"
"chr8","20554676","20554958","chr11","51334949","51335233","49","30780273"
"chr8","20580530","20580837","chr8","20446364","20446653","22","134166"
"chr8","20689622","20690011","chr20","51003043","51003395","124","30313421"
"chr8","20796560","20796820","chr8","20667126","20667385","5","129434"
"chr8","20825788","20826060","chr8","20696572","20696844","6","129216"
"chr8","20858158","20858471","chr9","51416320","51416632","56","30558162"
"chr8","20861930","20862136","chr8","20733319","20733526","7","128611"
"chr8","20865047","20865351","chr8","20736448","20736743","15","128599"
"chr8","20922050","20922166","chr8","20793567","20793683","2","128483"
"chr8","20922201","20922369","chr8","20793719","20793886","9","128482"
"chr8","20964273","20964544","chr8","20836479","20836750","17","127794"
"chr8","21000002","21000236","chr9","94815349","94815573","47","73815347"
"chr8","21005857","21006143","chr12","94430450","94430741","61","73424593"
"chr8","21019493","21019785","chr8","20889986","20890298","36","129507"
"chr8","21021994","21022298","chr8","20892643","20892951","14","129351"
"chr8","21047108","21047400","chr8","20918233","20918527","6","128875"
"chr8","21049035","21049289","chr8","20920436","20920692","10","128599"
"chr8","21056938","21057223","chr8","20928333","20928600","35","128605"
"chr8","21062233","21062350","chr8","20933913","20934030","8","128320"
"chr8","21065974","21066248","chr8","20937535","20937804","10","128439"
"chr8","21109621","21109888","chr8","20982422","20982688","9","127199"
"chr8","21110669","21110963","chr8","20983495","20983787","37","127174"
"chr8","21147055","21147357","chr8","21020940","21021242","10","126115"
"chr8","21160762","21161048","chr8","21034197","21034482","13","126565"
"chr8","21166172","21166479","chr8","21039646","21039945","20","126526"
"chr8","21178859","21179129","chr8","21053449","21053719","9","125410"
"chr8","21202469","21202741","chr8","21077227","21077546","54","125242"
"chr8","21202769","21202783","chrX","44510769","44510781","2","23308000"
"chr8","21221301","21221559","chr8","21219742","21220038","41","1559"
"chr8","21229192","21229204","chr9","54643528","54643539","4","33414336"
"chr8","21229238","21229297","chr1","125154489","125154542","13","103925251"
"chr8","21230910","21231175","chr8","21210513","21210782","20","20397"
"chr8","21237604","21237701","chr8","21204109","21204213","13","33495"
"chr8","21246646","21246792","chr2","88215582","88215712","34","66968936"
"chr8","21256239","21256541","chr8","21181687","21181987","12","74552"
"chr8","21286562","21286848","chr8","21149765","21150055","18","136797"
"chr8","21314126","21314268","chr8","21121390","21121532","1","192736"
"chr8","21314571","21314822","chr18","37714444","37714685","66","16399873"
"chr8","21357989","21358281","chr11","26866496","26866788","55","5508507"
"chr8","21397064","21397342","chr8","21278965","21279272","36","118099"
"chr8","21404466","21404614","chr8","21286698","21286843","5","117768"
"chr8","21412152","21412320","chr1","125409055","125409223","29","103996903"
"chr8","21443108","21443274","chr8","21326341","21326507","5","116767"
"chr8","21443568","21443703","chr8","21326804","21326937","6","116764"
"chr8","21493963","21494135","chr1","184282893","184283059","39","162788930"
"chr8","21508824","21509131","chr8","21399661","21399969","11","109163"
"chr8","21581933","21582013","chr1","64323043","64323121","8","42741110"
"chr8","21591970","21592249","chr9","55711881","55712168","62","34119911"
"chr8","21610564","21610874","chr8","21494023","21494329","17","116541"
"chr8","21619465","21619760","chr8","21502879","21503173","6","116586"
"chr8","21631347","21631617","chr8","21514537","21514814","15","116810"
"chr8","21651890","21652204","chr8","21535367","21535681","6","116523"
"chr8","21678945","21679212","chr8","21562482","21562749","3","116463"
"chr8","21688272","21688562","chr8","21571809","21572099","5","116463"
"chr8","21773287","21773594","chr8","21656855","21657155","15","116432"
"chr8","21827144","21827308","chr3","2024698","2024867","29","19802446"
"chr8","21842891","21843229","chr8","21726484","21726802","34","116407"
"chr8","21847779","21848071","chr2","93653797","93654091","62","71806018"
"chr8","21855007","21855248","chr6","101193819","101194038","62","79338812"
"chr8","21859559","21859868","chr8","21743742","21744047","11","115817"
"chr8","21870722","21871022","chr8","21761578","21761886","20","109144"
"chr8","21880534","21880834","chr8","21767094","21767386","13","113440"
"chr8","21883665","21883968","chr8","21770208","21770502","27","113457"
"chr8","21889505","21889690","chr8","21776597","21776779","10","112908"
"chr8","21900171","21900464","chr3","145709968","145710262","60","123809797"
"chr8","21906503","21906796","chr8","21793090","21793379","12","113413"
"chr8","21926126","21926260","chr9","56558849","56558984","24","34632723"
"chr8","21948316","21948527","chr8","21833120","21833329","6","115196"
"chr8","21948670","21948748","chr8","21833473","21833549","5","115197"
"chr8","22062795","22063098","chr8","21948019","21948325","10","114776"
"chr8","22090830","22091083","chr8","21975511","21975754","14","115319"
"chr8","22108984","22109273","chr8","21993604","21993878","35","115380"
"chr8","22145253","22145553","chr8","22030154","22030454","11","115099"
"chr8","22285748","22286044","chr8","22170165","22170465","8","115583"
"chr8","22429498","22429802","chr8","22316662","22316959","14","112836"
"chr8","22492571","22492680","chr1","101398759","101398868","26","78906188"
"chr8","22492981","22493280","chr8","22379818","22380106","23","113163"
"chr8","22495619","22495905","chr8","22382402","22382683","15","113217"
"chr8","22583864","22584151","chr8","22465650","22465937","8","118214"
"chr8","22587895","22588203","chr8","22469635","22469940","11","118260"
"chr8","22664260","22664429","chr8","94391703","94391869","38","71727443"
"chr8","22664473","22664764","chr8","22557679","22557970","10","106794"
"chr8","22723893","22724195","chr8","22618364","22618666","8","105529"
"chr8","22764529","22764686","chr8","22657413","22657570","10","107116"
"chr8","22764808","22764926","chr8","22657692","22657835","26","107116"
"chr8","22822359","22822644","chr8","22714550","22714835","7","107809"
"chr8","22991260","22991514","chr8","22884970","22885224","5","106290"
"chr8","23065457","23065652","chr8","22964680","22964874","5","100777"
"chr8","23071011","23071265","chr8","22970365","22970611","21","100646"
"chr8","23094851","23095163","chr8","22994669","22994982","11","100182"
"chr8","23137547","23137612","chr2","99491640","99491706","14","76354093"
"chr8","23167230","23167542","chr8","23070619","23070917","23","96611"
"chr8","23171443","23171744","chr15","56527536","56527835","51","33356093"
"chr8","23215934","23216235","chr8","23119479","23119784","17","96455"
"chr8","23271721","23271951","chr8","23179469","23179692","12","92252"
"chr8","23276513","23276762","chr8","23187527","23187777","3","88986"
"chr8","23279563","23279720","chr8","23190556","23190720","12","89007"
"chr8","23283596","23283894","chr13","45932391","45932692","54","22648795"
"chr8","23288694","23288969","chr8","23199697","23199972","7","88997"
"chr8","23289976","23290194","chr8","23200981","23201199","11","88995"
"chr8","23293101","23293425","chr8","23204159","23204501","28","88942"
"chr8","23294135","23294434","chr8","23205211","23205511","2","88924"
"chr8","23296664","23296838","chr8","23207754","23207921","16","88910"
"chr8","23303187","23303478","chr8","23214042","23214338","16","89145"
"chr8","23304830","23305142","chr8","23215660","23215961","28","89170"
"chr8","23312713","23313022","chr8","23223551","23223826","40","89162"
"chr8","23317060","23317333","chr20","70780938","70781202","55","47463878"
"chr8","23317596","23317624","chr15","105498487","105498517","7","82180891"
"chr8","23318282","23318594","chr8","23228952","23229243","34","89330"
"chr8","23335011","23335198","chr15","99521189","99521367","67","76186178"
"chr8","23335294","23335415","chr15","75913917","75914037","20","52578623"
"chr8","23347637","23347953","chr8","23259446","23259706","63","88191"
"chr8","23352409","23352420","chr2","143187638","143187649","2","119835229"
"chr8","23352447","23352728","chr8","23262122","23262422","23","90325"
"chr8","23353489","23353648","chr19","14673246","14673394","42","8680243"
"chr8","23362096","23362406","chr2","38828793","38829094","59","15466697"
"chr8","23390125","23390425","chr8","23301393","23301693","8","88732"
"chr8","23420372","23420667","chr8","23332831","23333115","17","87541"
"chr8","23425614","23425745","chr8","23338076","23338207","4","87538"
"chr8","23433535","23433744","chr3","13173386","13173598","41","10260149"
"chr8","23458519","23458840","chr8","23374553","23374868","39","83966"
"chr8","23458950","23459082","chr8","23374982","23375114","4","83968"
"chr8","23465769","23466062","chr8","23382151","23382454","19","83618"
"chr8","23480024","23480274","chr7","70203776","70204017","67","46723752"
"chr8","23480878","23481045","chr8","23396232","23396399","5","84646"
"chr8","23499691","23499898","chr11","104330267","104330475","41","80830576"
"chr8","23505903","23506193","chr8","23421464","23421754","9","84439"
"chr8","23511736","23511952","chr8","23427615","23427836","8","84121"
"chr8","23532071","23532346","chr8","23447822","23448094","9","84249"
"chr8","23540903","23541043","chr8","23456623","23456763","2","84280"
"chr8","23541076","23541406","chr8","23456796","23457068","68","84280"
"chr8","23545098","23545376","chr4","125268567","125268840","69","101723469"
"chr8","23546720","23547000","chr8","23462437","23462717","10","84283"
"chr8","23565621","23565935","chr8","23481740","23482053","7","83881"
"chr8","23572235","23572483","chr8","23487838","23488095","15","84397"
"chr8","23587629","23587920","chr8","23503109","23503406","16","84520"
"chr8","23606456","23606759","chr8","23522003","23522306","5","84453"
"chr8","23608437","23608621","chr8","23523985","23524168","3","84452"
"chr8","23615288","23615468","chr8","23531107","23531280","17","84181"
"chr8","23615770","23615930","chr8","23531587","23531747","2","84183"
"chr8","23626650","23626939","chr8","23542475","23542764","6","84175"
"chr8","23636953","23637240","chr8","23552774","23553059","11","84179"
"chr8","23667519","23667727","chr8","23583041","23583249","1","84478"
"chr8","23670612","23670916","chr8","23586121","23586439","21","84491"
"chr8","23671427","23671602","chr8","23586950","23587124","2","84477"
"chr8","23671913","23672017","chr8","23587435","23587540","3","84478"
"chr8","23687999","23688296","chr8","23603228","23603538","20","84771"
"chr8","23709407","23709684","chr8","23624594","23624877","18","84813"
"chr8","23718658","23718953","chr8","23634028","23634323","8","84630"
"chr8","23742190","23742425","chr8","23657786","23658020","6","84404"
"chr8","23760676","23760986","chr8","23676331","23676615","33","84345"
"chr8","23773615","23773725","chr8","23689222","23689332","2","84393"
"chr8","23774119","23774284","chr8","23689737","23689906","6","84382"
"chr8","23809176","23809472","chr8","23726673","23726967","18","82503"
"chr8","23810971","23811251","chr8","23728471","23728751","7","82500"
"chr8","23813928","23814225","chr8","23731423","23731720","5","82505"
"chr8","23846501","23846803","chr14","67963217","67963525","69","44116716"
"chr8","23849491","23849783","chr8","23772838","23773141","14","76653"
"chr8","23874890","23875095","chr8","23797918","23798123","4","76972"
"chr8","23954165","23954352","chr11","26919789","26919975","38","2965624"
"chr8","23967319","23967620","chr8","23888819","23889119","9","78500"
"chr8","23968091","23968416","chr8","23889592","23889909","23","78499"
"chr8","23976015","23976271","chr8","23897485","23897741","9","78530"
"chr8","24008951","24009248","chr8","23930409","23930706","13","78542"
"chr8","24081522","24081821","chr8","24004539","24004828","17","76983"
"chr8","24093464","24093772","chr10","70554484","70554792","52","46461020"
"chr8","24109663","24109953","chr7","40104725","40105017","52","15995062"
"chr8","24115697","24115978","chr8","24036619","24036917","19","79078"
"chr8","24164512","24164645","chr6","168856261","168856393","26","144691749"
"chr8","24175340","24175623","chr8","24096403","24096714","36","78937"
"chr8","24185426","24185550","chr13","117431604","117431728","18","93246178"
"chr8","24199814","24200104","chr8","24122963","24123253","17","76851"
"chr8","24216117","24216410","chr8","24140703","24141003","14","75414"
"chr8","24239170","24239475","chr8","24164025","24164329","10","75145"
"chr8","24248574","24248888","chr8","24173277","24173598","12","75297"
"chr8","24250750","24251058","chr8","24175462","24175771","9","75288"
"chr8","24254109","24254418","chr8","24181146","24181455","7","72963"
"chr8","24268662","24268963","chr8","24193094","24193406","33","75568"
"chr8","24272851","24273163","chr8","24197295","24197608","14","75556"
"chr8","24301925","24302208","chr8","24227403","24227686","7","74522"
"chr8","24303696","24304000","chr8","24229372","24229676","4","74324"
"chr8","24304054","24304345","chr8","24229728","24230015","11","74326"
"chr8","24304480","24304649","chr8","24230146","24230303","16","74334"
"chr8","24350041","24350350","chr8","24278067","24278367","13","71974"
"chr8","24351724","24352012","chr8","24279659","24279948","10","72065"
"chr8","24366786","24367051","chr8","24300570","24300835","6","66216"
"chr8","24368651","24368922","chr8","24302434","24302745","46","66217"
"chr8","24369797","24370081","chr8","24303900","24304185","5","65897"
"chr8","24377356","24377659","chr8","24311330","24311634","9","66026"
"chr8","24382162","24382441","chr8","24316117","24316396","8","66045"
"chr8","24383990","24384285","chr8","24317935","24318231","7","66055"
"chr8","24398153","24398436","chr8","24332057","24332335","21","66096"
"chr8","24400466","24400670","chr8","24334354","24334564","15","66112"
"chr8","24408492","24408793","chr8","24343003","24343311","14","65489"
"chr8","24423105","24423406","chr8","24343003","24343311","14","80102"
"chr8","24440755","24441051","chr8","24360662","24360958","6","80093"
"chr8","24489730","24490006","chr8","94443526","94443804","69","69953796"
"chr8","24490346","24490572","chr3","153372936","153373170","51","128882590"
"chr8","24492539","24492820","chr8","24411919","24412231","43","80620"
"chr8","24500705","24500936","chr8","24419652","24419880","8","81053"
"chr8","24500938","24500999","chr8","24419882","24419943","1","81056"
"chr8","24523558","24523854","chr8","24442474","24442776","17","81084"
"chr8","24533387","24533671","chr8","24452677","24452961","12","80710"
"chr8","24534346","24534642","chr8","24453621","24453913","9","80725"
"chr8","24546041","24546348","chr8","24465840","24466148","13","80201"
"chr8","24546777","24547079","chr8","24466577","24466900","30","80200"
"chr8","24548764","24548933","chr8","24468915","24469099","24","79849"
"chr8","24558468","24558756","chr8","24489383","24489671","7","69085"
"chr8","24559808","24560097","chr8","24490722","24491011","6","69086"
"chr8","24564343","24564631","chr8","24480870","24481167","18","83473"
"chr8","24570234","24570311","chr12","69601772","69601849","12","45031538"
"chr8","24580779","24581080","chr8","24498749","24499059","18","82030"
"chr8","24582785","24583073","chr8","24500457","24500745","8","82328"
"chr8","24589899","24590203","chr8","24507240","24507544","9","82659"
"chr8","24606997","24607266","chr8","24525108","24525388","17","81889"
"chr8","24618873","24619174","chr8","24537561","24537859","19","81312"
"chr8","24646314","24646590","chr8","24565289","24565560","22","81025"
"chr8","24648380","24648514","chr8","24567352","24567486","2","81028"
"chr8","24668720","24668974","chr8","24587880","24588134","3","80840"
"chr8","24687692","24687875","chr8","24607222","24607408","18","80470"
"chr8","24725690","24725950","chr8","24646094","24646352","17","79596"
"chr8","24746530","24746632","chr8","24666907","24667014","6","79623"
"chr8","24759053","24759345","chr8","24679450","24679730","23","79603"
"chr8","24760623","24760920","chr8","24680999","24681295","9","79624"
"chr8","24772740","24773035","chr8","24693133","24693432","13","79607"
"chr8","24828063","24828161","chr8","24749442","24749540","3","78621"
"chr8","24833003","24833311","chr8","24754356","24754664","6","78647"
"chr8","24856764","24857052","chr8","24776981","24777272","9","79783"
"chr8","24894635","24894940","chr8","24814774","24815076","11","79861"
"chr8","24935753","24936059","chr8","24857431","24857734","9","78322"
"chr8","24946359","24946670","chr8","24867797","24868106","12","78562"
"chr8","24995378","24995683","chr8","24917586","24917896","49","77792"
"chr8","25040569","25040869","chrX","20996419","20996724","68","4044150"
"chr8","25114236","25114517","chr8","25045046","25045326","10","69190"
"chr8","25139900","25140189","chr8","25071944","25072233","10","67956"
"chr8","25145826","25146109","chr8","25077807","25078113","27","68019"
"chr8","25211204","25211506","chr8","25148002","25148298","16","63202"
"chr8","25233486","25233790","chr8","25168482","25168786","14","65004"
"chr8","25260024","25260292","chr13","68899793","68900053","71","43639769"
"chr8","25264075","25264372","chr8","25205580","25205883","14","58495"
"chr8","25285776","25286057","chr8","25228671","25228952","6","57105"
"chr8","25444799","25445087","chr8","25386361","25386641","16","58438"
"chr8","25453913","25454213","chr20","67505224","67505529","72","42051311"
"chr8","25454554","25454668","chrX","44430331","44430445","23","18975777"
"chr8","25458477","25458779","chr8","62577856","62578148","60","37119379"
"chr8","25567424","25567711","chr8","25510664","25510951","6","56760"
"chr8","25617465","25617779","chr8","25560907","25561223","10","56558"
"chr8","25627917","25628052","chr8","25571388","25571521","6","56529"
"chr8","25640726","25640924","chr4","124417723","124417916","39","98776997"
"chr8","25641257","25641379","chr8","25586649","25586766","9","54608"
"chr8","25674209","25674520","chr8","25618859","25619170","10","55350"
"chr8","25706724","25707014","chr8","25650716","25651006","2","56008"
"chr8","25712190","25712495","chr8","25656208","25656509","18","55982"
"chr8","25729544","25729806","chr8","25673121","25673383","10","56423"
"chr8","25748875","25749176","chr8","25691674","25691977","9","57201"
"chr8","25750715","25751025","chr4","36126419","36126732","58","10375704"
"chr8","25762826","25763142","chr8","25705749","25706061","11","57077"
"chr8","25795920","25796212","chr8","25738091","25738350","40","57829"
"chr8","25798170","25798376","chr8","25740303","25740509","4","57867"
"chr8","25825073","25825353","chr8","25763873","25764153","7","61200"
"chr8","25837905","25838230","chr8","25776565","25776891","11","61340"
"chr8","25839667","25839972","chr8","25778294","25778594","13","61373"
"chr8","25864412","25864681","chr8","25802644","25802918","13","61768"
"chr8","25874484","25874774","chr8","25812876","25813166","6","61608"
"chr8","25879742","25880017","chr8","25818122","25818392","14","61620"
"chr8","25889092","25889381","chr8","25827455","25827746","12","61637"
"chr8","25900345","25900460","chr8","25838988","25839103","4","61357"
"chr8","25917155","25917435","chr8","25855282","25855559","8","61873"
"chr8","25919910","25920199","chr8","25857989","25858277","24","61921"
"chr8","25933726","25934018","chr12","34100446","34100737","71","8166720"
"chr8","25951111","25951409","chr8","25891133","25891431","3","59978"
"chr8","25957635","25957935","chr8","25897656","25897956","7","59979"
"chr8","25959812","25960128","chr8","25899831","25900144","14","59981"
"chr8","25983623","25983926","chr8","25926398","25926701","15","57225"
"chr8","26035362","26035668","chr8","25979505","25979823","25","55857"
"chr8","26046908","26047104","chrX","86421463","86421664","57","60374555"
"chr8","26048560","26048873","chr8","25992658","25992971","11","55902"
"chr8","26093615","26093917","chr7","80572798","80573099","52","54479183"
"chr8","26163526","26163810","chr8","26106410","26106720","32","57116"
"chr8","26169629","26169926","chr8","26112524","26112814","23","57105"
"chr8","26171370","26171472","chr8","26114244","26114346","2","57126"
"chr8","26185981","26186162","chr8","26129330","26129503","12","56651"
"chr8","26201262","26201553","chr8","26144616","26144907","5","56646"
"chr8","26208077","26208364","chr8","26151306","26151592","8","56771"
"chr8","26241850","26242149","chr8","26184802","26185110","13","57048"
"chr8","26298954","26299257","chr8","26245883","26246184","9","53071"
"chr8","26299447","26299561","chr8","26246372","26246486","3","53075"
"chr8","26300016","26300304","chr11","113023863","113024155","55","86723847"
"chr8","26304708","26304996","chr8","26251614","26251903","6","53094"
"chr8","26341351","26341660","chr8","26287628","26287937","8","53723"
"chr8","26355103","26355394","chr8","26301546","26301834","8","53557"
"chr8","26359038","26359338","chr8","26305491","26305806","26","53547"
"chr8","26389278","26389514","chr8","26335387","26335646","36","53891"
"chr8","26415500","26415785","chr8","26361621","26361912","6","53879"
"chr8","26435935","26436224","chr8","26382751","26383040","5","53184"
"chr8","26473838","26474126","chr8","26419726","26420013","5","54112"
"chr8","26477907","26478217","chr8","26423847","26424135","27","54060"
"chr8","26478771","26479049","chr8","26424714","26424994","5","54057"
"chr8","26483869","26484029","chr8","26425979","26426141","8","57890"
"chr8","26502040","26502343","chr8","26445619","26445921","14","56421"
"chr8","26502344","26502503","chr8","97998535","97998684","38","71496191"
"chr8","26519811","26520096","chr7","106849754","106850038","68","80329943"
"chr8","26529825","26530107","chr8","26472914","26473210","27","56911"
"chr8","26542043","26542342","chr8","26485205","26485499","14","56838"
"chr8","26569785","26570056","chr8","26513860","26514140","18","55925"
"chr8","26578423","26578727","chr8","26522322","26522627","13","56101"
"chr8","26582103","26582406","chr8","26525981","26526264","30","56122"
"chr8","26609643","26609958","chr8","26553440","26553739","19","56203"
"chr8","26612813","26613114","chr8","26556601","26556902","13","56212"
"chr8","26624267","26624548","chr8","26568015","26568291","9","56252"
"chr8","26639036","26639234","chr8","26582832","26583028","8","56204"
"chr8","26652359","26652545","chr14","18597829","18598011","48","8054530"
"chr8","26684149","26684352","chr8","26628700","26628903","1","55449"
"chr8","26690946","26691084","chr11","24630167","24630300","33","2060779"
"chr8","26691185","26691502","chr8","26635415","26635712","35","55770"
"chr8","26694808","26695103","chr8","26638936","26639240","18","55872"
"chr8","26712015","26712302","chr8","26662884","26663171","22","49131"
"chr8","26713576","26713874","chr8","26664449","26664745","7","49127"
"chr8","26720859","26721155","chr8","26659849","26660144","17","61010"
"chr8","26721884","26722186","chr8","26660873","26661179","19","61011"
"chr8","26731316","26731612","chr8","26674738","26675034","4","56578"
"chr8","26732929","26733249","chr8","26676350","26676666","11","56579"
"chr8","26734265","26734475","chr8","26677683","26677893","4","56582"
"chr8","26747729","26748030","chr16","44745004","44745304","49","17997275"
"chr8","26748970","26749272","chr8","26692347","26692649","9","56623"
"chr8","26750236","26750532","chr8","26693658","26693950","14","56578"
"chr8","26752401","26752674","chr8","26695794","26696113","52","56607"
"chr8","26768749","26769090","chr8","26712267","26712608","11","56482"
"chr8","26771492","26771794","chr8","26715010","26715311","11","56482"
"chr8","26775047","26775324","chr8","26717146","26717422","5","57901"
"chr8","26777275","26777575","chr8","26721730","26722041","17","55545"
"chr8","26781351","26781639","chr8","26725837","26726126","3","55514"
"chr8","26803551","26803815","chr1","201826404","201826692","61","175022853"
"chr8","26806202","26806341","chr19","48515310","48515450","23","21709108"
"chr8","26806653","26806815","chr8","26751164","26751326","5","55489"
"chr8","26837594","26837698","chr8","26782066","26782170","5","55528"
"chr8","26847156","26847461","chr8","26791628","26791933","9","55528"
"chr8","26896387","26896663","chr8","26840882","26841156","5","55505"
"chr8","26910760","26911073","chr8","26855460","26855786","18","55300"
"chr8","26911161","26911471","chr8","26855858","26856168","8","55303"
"chr8","26912391","26912680","chr8","26857087","26857388","18","55304"
"chr8","26913457","26913762","chr8","26858460","26858765","7","54997"
"chr8","26918477","26918775","chr8","26863444","26863742","6","55033"
"chr8","26920924","26921222","chr8","26865894","26866194","12","55030"
"chr8","26922083","26922349","chr8","26867062","26867329","4","55021"
"chr8","26926784","26927065","chr8","26872129","26872413","8","54655"
"chr8","26947306","26947566","chr8","26891314","26891575","8","55992"
"chr8","26954978","26955280","chr8","26899020","26899325","10","55958"
"chr8","26967426","26967453","chr12","102985328","102985354","4","76017902"
"chr8","26967501","26967644","chr10","32296896","32297033","30","5329395"
"chr8","26973623","26973776","chr3","41431924","41432076","36","14458301"
"chr8","26974933","26975059","chr14","114574017","114574143","27","87599084"
"chr8","26978572","26978693","chr8","26922727","26922848","4","55845"
"chr8","26987690","26987994","chr8","26932142","26932448","10","55548"
"chr8","26993236","26993538","chrX","96318063","96318367","60","69324827"
"chr8","26997365","26997654","chr8","26942502","26942792","6","54863"
"chr8","27017299","27017597","chr8","26962788","26963090","8","54511"
"chr8","27019294","27019420","chr8","26964798","26964923","16","54496"
"chr8","27034282","27034498","chr8","26984569","26984785","3","49713"
"chr8","27039684","27039970","chr8","26989790","26990076","7","49894"
"chr8","27060093","27060398","chr8","27009875","27010180","3","50218"
"chr8","27091669","27091846","chr8","27047534","27047703","11","44135"
"chr8","27092157","27092221","chr1","2084406","2084473","11","25007751"
"chr8","27116875","27117162","chr8","27073227","27073513","6","43648"
"chr8","27132668","27132945","chr8","27089210","27089487","4","43458"
"chr8","27184684","27184817","chr8","27140656","27140773","22","44028"
"chr8","27192544","27192823","chr8","27148293","27148583","20","44251"
"chr8","27208545","27208817","chr8","27164697","27164969","9","43848"
"chr8","27248789","27249060","chr8","27204512","27204791","20","44277"
"chr8","27325466","27325790","chr8","27275242","27275567","10","50224"
"chr8","27335270","27335556","chr8","27285029","27285315","2","50241"
"chr8","27338765","27339061","chr8","27288534","27288830","4","50231"
"chr8","27346204","27346504","chr8","27295963","27296263","3","50241"
"chr8","27347460","27347773","chr8","27297066","27297380","5","50394"
"chr8","27355046","27355206","chr8","27304320","27304484","6","50726"
"chr8","27399484","27399790","chr8","27349031","27349335","11","50453"
"chr8","27402489","27402654","chr8","27352041","27352214","11","50448"
"chr8","27405730","27406025","chr8","27352581","27352883","16","53149"
"chr8","27406317","27406599","chr9","5765156","5765435","53","21641161"
"chr8","27409156","27409455","chr5","227545","227838","59","27181611"
"chr8","27417947","27418254","chr8","27363914","27364213","21","54033"
"chr8","27418709","27419007","chr8","27364670","27364968","8","54039"
"chr8","27467778","27468063","chr8","27413298","27413582","11","54480"
"chr8","27492841","27493133","chr8","75940983","75941285","52","48448142"
"chr8","27500048","27500363","chr8","27445228","27445543","11","54820"
"chr8","27515522","27515812","chr8","27460668","27460970","21","54854"
"chr8","27527695","27527723","chr4","12505515","12505541","5","15022180"
"chr8","27527804","27528081","chr8","27472430","27472723","23","55374"
"chr8","27539606","27539896","chr8","27484247","27484537","4","55359"
"chr8","27546868","27547048","chr8","27491721","27491901","7","55147"
"chr8","27548190","27548493","chr8","27493130","27493419","22","55060"
"chr8","27549207","27549510","chr8","27494134","27494437","8","55073"
"chr8","27557112","27557377","chr8","27502062","27502357","39","55050"
"chr8","27569954","27570247","chr8","27515023","27515325","18","54931"
"chr8","27598215","27598325","chr8","27546892","27547002","2","51323"
"chr8","27611282","27611408","chr8","27561285","27561419","11","49997"
"chr8","27611717","27611862","chr8","27561727","27561872","4","49990"
"chr8","27637835","27638119","chr11","115620230","115620512","51","87982395"
"chr8","27657070","27657354","chr8","27607485","27607768","9","49585"
"chr8","27673408","27673736","chr8","27623609","27623947","20","49799"
"chr8","27695260","27695584","chr8","27648456","27648753","30","46804"
"chr8","27747103","27747411","chr8","27699942","27700256","14","47161"
"chr8","27773280","27773598","chr8","27725751","27726060","22","47529"
"chr8","27846609","27846765","chr11","65960052","65960209","26","38113443"
"chr8","27846814","27846914","chr1","186720234","186720326","26","158873420"
"chr8","27858153","27858443","chr8","27810803","27811093","11","47350"
"chr8","27997240","27997559","chr11","119286245","119286555","63","91289005"
"chr8","28000208","28000500","chr8","27951401","27951689","9","48807"
"chr8","28021385","28021448","chr3","40058589","40058650","11","12037204"
"chr8","28065114","28065433","chr8","28025852","28026158","33","39262"
"chr8","28082788","28083092","chr8","28034626","28034890","44","48162"
"chr8","28090511","28090818","chr8","28042327","28042636","11","48184"
"chr8","28122353","28122638","chr8","28075196","28075480","13","47157"
"chr8","28135743","28135866","chr8","28088438","28088561","1","47305"
"chr8","28143859","28144120","chr8","28098099","28098360","3","45760"
"chr8","28180884","28181168","chr8","28134873","28135157","4","46011"
"chr8","28189805","28190161","chr11","121986442","121986807","102","93796637"
"chr8","28191963","28192286","chr8","28146099","28146417","10","45864"
"chr8","28195745","28195894","chr1","41265863","41266016","37","13070118"
"chr8","28215504","28215649","chr8","28171863","28172008","3","43641"
"chr8","28220220","28220507","chr1","142210652","142210936","57","113990432"
"chr8","28230017","28230316","chr8","28185764","28186059","13","44253"
"chr8","28236396","28236709","chr8","28192141","28192457","17","44255"
"chr8","28237146","28237462","chr8","28192894","28193200","26","44252"
"chr8","28237538","28237756","chr9","6030499","6030716","40","22207039"
"chr8","28240098","28240352","chr8","28202453","28202740","41","37645"
"chr8","28246158","28246452","chr8","28197516","28197810","6","48642"
"chr8","28247676","28247950","chr8","28199474","28199774","34","48202"
"chr8","28250750","28251004","chr8","28202453","28202740","41","48297"
"chr8","28264279","28264520","chr8","28217740","28217980","15","46539"
"chr8","28283059","28283335","chr8","28238859","28239132","7","44200"
"chr8","28291542","28291842","chr8","28247311","28247611","5","44231"
"chr8","28294321","28294614","chr3","151890679","151890975","60","123596358"
"chr8","28304467","28304773","chr8","28260177","28260471","32","44290"
"chr8","28307378","28307622","chr8","28263010","28263254","3","44368"
"chr8","28308392","28308689","chr8","28264009","28264311","38","44383"
"chr8","28314916","28315220","chr8","28270473","28270775","11","44443"
"chr8","28315700","28315997","chr8","29083676","29083969","57","767976"
"chr8","28334067","28334375","chr8","28289835","28290131","34","44232"
"chr8","28338246","28338538","chr8","28294011","28294304","6","44235"
"chr8","28359641","28359924","chr8","28315845","28316128","6","43796"
"chr8","28369117","28369389","chr8","28325272","28325538","14","43845"
"chr8","28370213","28370388","chr8","28326334","28326529","26","43879"
"chr8","28376827","28376928","chr8","28333149","28333249","5","43678"
"chr8","28407390","28407516","chr8","28365067","28365193","6","42323"
"chr8","28436704","28437011","chr8","28395632","28395939","4","41072"
"chr8","28452878","28452997","chr8","28413214","28413333","3","39664"
"chr8","28457280","28457413","chr7","39965559","39965691","21","11508279"
"chr8","28458345","28458636","chr8","28418628","28418917","13","39717"
"chr8","28462729","28463029","chr8","28423041","28423338","5","39688"
"chr8","28476978","28477280","chr8","28437013","28437299","18","39965"
"chr8","28506971","28507234","chr8","28466976","28467282","47","39995"
"chr8","28518154","28518453","chr8","28477911","28478206","27","40243"
"chr8","28518708","28518940","chr12","21517806","21518032","55","7000902"
"chr8","28522999","28523305","chr8","28482912","28483204","22","40087"
"chr8","28536000","28536264","chr8","28496956","28497220","5","39044"
"chr8","28541090","28541263","chr3","78048927","78049100","29","49507837"
"chr8","28541265","28541313","chr17","7373932","7373980","9","21167333"
"chr8","28544846","28545095","chr8","28505675","28505915","11","39171"
"chr8","28550539","28550782","chr8","28510324","28510569","12","40215"
"chr8","28556283","28556566","chr8","40649059","40649343","58","12092776"
"chr8","28570021","28570249","chr8","28530439","28530667","2","39582"
"chr8","28572025","28572310","chr8","28532445","28532730","7","39580"
"chr8","28583023","28583175","chr8","28543454","28543606","0","39569"
"chr8","28599850","28600149","chr8","28560094","28560389","8","39756"
"chr8","28634909","28635119","chr8","28595379","28595589","2","39530"
"chr8","28693512","28693831","chr8","28655699","28656001","25","37813"
"chr8","28694875","28695169","chr8","28657057","28657348","18","37818"
"chr8","28698358","28698648","chr8","28660438","28660727","8","37920"
"chr8","28703481","28703766","chr8","28665432","28665717","4","38049"
"chr8","28731971","28732272","chr8","28692287","28692590","12","39684"
"chr8","28743127","28743440","chr8","28703454","28703769","11","39673"
"chr8","28746941","28747244","chr8","28707301","28707605","9","39640"
"chr8","28752877","28753113","chr8","28713223","28713455","11","39654"
"chr8","28753405","28753485","chr8","28713741","28713828","8","39664"
"chr8","28759010","28759313","chr8","28719064","28719360","12","39946"
"chr8","28764638","28764985","chr8","28725322","28725642","47","39316"
"chr8","28768034","28768320","chr8","28729011","28729310","19","39023"
"chr8","28788882","28789187","chr8","28751137","28751438","34","37745"
"chr8","28790025","28790333","chr8","28764109","28764414","13","25916"
"chr8","28799836","28800097","chr8","28766991","28767250","8","32845"
"chr8","28801742","28802038","chr8","28761203","28761502","11","40539"
"chr8","28805011","28805288","chr8","28772001","28772315","58","33010"
"chr8","28808650","28808958","chr8","28775399","28775699","21","33251"
"chr8","28811988","28812252","chr8","28778735","28778998","11","33253"
"chr8","28813963","28814284","chr16","64222938","64223235","79","35408975"
"chr8","28821166","28821262","chr8","28787933","28788030","3","33233"
"chr8","28822705","28822975","chr8","28789457","28789727","6","33248"
"chr8","28839146","28839429","chr8","28807714","28807997","4","31432"
"chr8","28853570","28853854","chr8","28821287","28821571","10","32283"
"chr8","28856490","28856539","chr8","28824525","28824574","1","31965"
"chr8","28856540","28856739","chr8","28824575","28824774","8","31965"
"chr8","28856892","28857001","chr7","14737550","14737658","16","14119342"
"chr8","28858043","28858332","chr8","28826535","28826824","20","31508"
"chr8","28864379","28864677","chr8","28832901","28833199","9","31478"
"chr8","28866165","28866315","chr14","21762308","21762466","35","7103857"
"chr8","28868053","28868332","chr9","90524786","90525060","53","61656733"
"chr8","28869866","28870149","chr8","28839115","28839399","13","30751"
"chr8","28883102","28883336","chr8","28853518","28853750","11","29584"
"chr8","28884213","28884278","chr8","28854634","28854699","1","29579"
"chr8","28886203","28886431","chr8","28856625","28856853","2","29578"
"chr8","28890579","28890852","chr10","18395621","18395895","67","10494958"
"chr8","28891831","28891926","chr8","28861470","28861565","0","30361"
"chr8","28892304","28892495","chr8","28861918","28862111","10","30386"
"chr8","28893021","28893164","chr8","28862636","28862783","6","30385"
"chr8","28893638","28893805","chr8","28863257","28863419","11","30381"
"chr8","28894747","28895034","chr8","28864358","28864620","35","30389"
"chr8","28900457","28900750","chr8","28870027","28870322","12","30430"
"chr8","28902109","28902192","chr8","28871592","28871678","6","30517"
"chr8","28904798","28905078","chr8","28874269","28874550","8","30529"
"chr8","28927119","28927409","chr8","28896537","28896827","7","30582"
"chr8","28932492","28932627","chr8","28901803","28901938","2","30689"
"chr8","28932935","28933082","chr8","28902234","28902382","4","30701"
"chr8","28970636","28970788","chr8","28943290","28943461","21","27346"
"chr8","28974356","28974617","chr8","28947030","28947285","16","27326"
"chr8","29000559","29000766","chr8","28974213","28974420","6","26346"
"chr8","29003999","29004300","chr8","28977661","28977963","5","26338"
"chr8","29026965","29027260","chr8","29000610","29000896","41","26355"
"chr8","29028421","29028498","chr7","130508232","130508298","20","101479811"
"chr8","29028613","29028734","chr1","139358754","139358864","39","110330141"
"chr8","29028735","29029044","chr8","29002082","29002391","4","26653"
"chr8","29029045","29029179","chr9","32433523","32433656","25","3404478"
"chr8","29031300","29031558","chr6","74912287","74912557","73","45880987"
"chr8","29031950","29032252","chr18","18003303","18003606","61","11028647"
"chr8","29041163","29041350","chr8","29014731","29014918","2","26432"
"chr8","29044142","29044325","chr8","102179722","102179903","33","73135580"
"chr8","29047271","29047449","chr8","29021019","29021179","20","26252"
"chr8","29049679","29049957","chr8","29023419","29023707","12","26260"
"chr8","29050950","29051257","chr8","29024690","29024997","23","26260"
"chr8","29057982","29058223","chr8","29033181","29033422","9","24801"
"chr8","29059837","29060131","chr8","29035049","29035343","6","24788"
"chr8","29063054","29063349","chr4","154095025","154095315","59","125031971"
"chr8","29066389","29066709","chr8","29041923","29042213","39","24466"
"chr8","29071045","29071171","chr7","158140842","158140967","32","129069797"
"chr8","29071172","29071450","chr8","29046344","29046604","32","24828"
"chr8","29072983","29073131","chr16","18819593","18819742","28","10253390"
"chr8","29078377","29078501","chr1","128286221","128286345","30","99207844"
"chr8","29078591","29078738","chr7","144409615","144409761","30","115331024"
"chr8","29081711","29082022","chr8","29057018","29057325","11","24693"
"chr8","29084031","29084153","chr8","29059338","29059460","4","24693"
"chr8","29092105","29092379","chr8","29067433","29067702","16","24672"
"chr8","29100473","29100758","chr8","29076075","29076403","50","24398"
"chr8","29103525","29103801","chr8","29079173","29079449","5","24352"
"chr8","29108028","29108312","chr8","29083676","29083969","18","24352"
"chr8","29121299","29121603","chr8","29097220","29097529","19","24079"
"chr8","29126057","29126285","chr8","29101973","29102200","16","24084"
"chr8","29202434","29202743","chr8","29179158","29179468","10","23276"
"chr8","29203251","29203553","chr8","29179981","29180286","10","23270"
"chr8","29214737","29214942","chr8","29191464","29191669","7","23273"
"chr8","29228616","29228908","chr8","29205650","29205958","26","22966"
"chr8","29243365","29243685","chr5","19358931","19359234","73","9884434"
"chr8","29263169","29263464","chr8","29239672","29239967","6","23497"
"chr8","29300430","29300727","chr8","29276827","29277120","9","23603"
"chr8","29321667","29321911","chr11","53218855","53219097","49","23897188"
"chr8","29322573","29322841","chr8","29301665","29301924","13","20908"
"chr8","29349920","29350207","chr8","29330551","29330859","38","19369"
"chr8","29352729","29353028","chr8","29333228","29333501","34","19501"
"chr8","29369728","29370034","chr8","29349761","29350067","9","19967"
"chr8","29373364","29373516","chr8","29353386","29353537","3","19978"
"chr8","29437595","29437861","chr8","29419994","29420260","9","17601"
"chr8","29550773","29551083","chr8","29542651","29542960","8","8122"
"chr8","29551873","29552189","chr8","29543746","29544062","2","8127"
"chr8","29579884","29580174","chr8","29572072","29572358","17","7812"
"chr8","29625679","29625777","chr8","29620060","29620158","2","5619"
"chr8","29645702","29645992","chr8","29643373","29643663","10","2329"
"chr8","29755921","29756220","chr8","29753746","29754045","11","2175"
"chr8","29774910","29775085","chr8","29772752","29772925","8","2158"
"chr8","29783382","29783485","chr8","29781196","29781299","2","2186"
"chr8","29799665","29799947","chr8","29797819","29798103","7","1846"
"chr8","29917603","29917729","chr1","79644992","79645112","23","49727389"
"chr8","29917849","29918022","chr7","16958421","16958590","33","12959428"
"chr8","30028973","30029262","chr8","30034034","30034323","6","5061"
"chr8","30058094","30058381","chr8","30062450","30062738","4","4356"
"chr8","30090065","30090359","chr8","30093922","30094214","13","3857"
"chr8","30192270","30192562","chr8","30196877","30197169","5","4607"
"chr8","30209800","30210071","chr8","30216212","30216495","29","6412"
"chr8","30249167","30249387","chr8","30255736","30255957","6","6569"
"chr8","30318894","30319153","chr8","30325453","30325711","9","6559"
"chr8","30320057","30320363","chr8","30326606","30326914","5","6549"
"chr8","30322177","30322459","chr8","30328715","30328983","18","6538"
"chr8","30352863","30353168","chr8","30358091","30358396","10","5228"
"chr8","30372083","30372372","chr8","30376877","30377139","31","4794"
"chr8","30413349","30413639","chr8","30417633","30417923","14","4284"
"chr8","30416903","30417187","chr8","30421201","30421480","12","4298"
"chr8","30419711","30420008","chr8","30423682","30423994","23","3971"
"chr8","30452676","30452924","chr8","30456211","30456462","10","3535"
"chr8","30477357","30477672","chr8","30480896","30481210","12","3539"
"chr8","30497446","30497739","chr13","47081690","47081987","56","16584244"
"chr8","30503903","30504208","chr8","30506315","30506592","42","2412"
"chr8","30510691","30510896","chr8","30513090","30513295","6","2399"
"chr8","30527043","30527223","chr16","42030742","42030915","36","11503699"
"chr8","30527589","30527613","chr7","39022236","39022257","6","8494647"
"chr8","30527754","30527765","chr11","121004518","121004530","4","90476764"
"chr8","30537707","30537984","chr8","30540281","30540559","12","2574"
"chr8","30541865","30541955","chr8","30544544","30544634","1","2679"
"chr8","30550860","30551161","chr8","51376076","51376380","57","20825216"
"chr8","30568772","30569078","chr8","30571582","30571888","5","2810"
"chr8","30576173","30576351","chr8","30578907","30579085","5","2734"
"chr8","30577701","30578005","chr3","153060925","153061233","59","122483224"
"chr8","30596841","30597141","chr8","30600526","30600822","12","3685"
"chr8","30597997","30598160","chr8","30601665","30601828","2","3668"
"chr8","30611927","30612158","chr8","30616241","30616476","10","4314"
"chr8","30631718","30632030","chr8","30636762","30637072","23","5044"
"chr8","30646597","30646893","chr12","62192263","62192556","59","31545666"
"chr8","30667938","30668248","chr8","30672676","30672962","27","4738"
"chr8","30681635","30681945","chr8","30687134","30687442","11","5499"
"chr8","30708975","30709140","chr10","16513501","16513652","44","14195474"
"chr8","30709242","30709540","chr8","30714294","30714593","6","5052"
"chr8","30770004","30770302","chr8","30770102","30770397","8","98"
"chr8","30823469","30823752","chr8","30822220","30822515","16","1249"
"chr8","30880537","30880810","chr8","30879782","30880055","8","755"
"chr8","30884915","30885213","chr8","30884094","30884398","26","821"
"chr8","30920349","30920480","chr8","30920006","30920139","6","343"
"chr8","30958642","30958954","chr8","30967258","30967567","12","8616"
"chr8","30976126","30976441","chr8","30984691","30985004","6","8565"
"chr8","31002714","31002791","chr8","31012391","31012468","1","9677"
"chr8","31003233","31003532","chr8","31012932","31013224","10","9699"
"chr8","31022692","31022968","chr8","31032740","31033012","15","10048"
"chr8","31049076","31049317","chr8","31058883","31059161","48","9807"
"chr8","31058129","31058428","chr8","31067929","31068215","16","9800"
"chr8","31103080","31103327","chr11","32412820","32413049","61","1309740"
"chr8","31135838","31136110","chr13","26649155","26649437","76","4486683"
"chr8","31138476","31138762","chr8","31151867","31152153","6","13391"
"chr8","31154747","31154986","chr8","31168985","31169227","9","14238"
"chr8","31159494","31159782","chr8","31174576","31174864","6","15082"
"chr8","31165487","31165668","chr8","31180234","31180431","23","14747"
"chr8","31172640","31172921","chr8","31187332","31187615","5","14692"
"chr8","31191591","31191908","chr8","31206195","31206478","46","14604"
"chr8","31205477","31205795","chr8","31220973","31221282","20","15496"
"chr8","31356994","31357099","chr1","4794675","4794778","28","26562319"
"chr8","31438907","31439194","chr8","31450232","31450523","11","11325"
"chr8","31468059","31468335","chr8","31479986","31480262","9","11927"
"chr8","31487885","31488181","chr7","125986589","125986881","57","94498704"
"chr8","31492523","31492801","chr8","31504558","31504835","6","12035"
"chr8","31506591","31506895","chr8","31518265","31518569","14","11674"
"chr8","31509546","31509823","chr8","31521173","31521450","4","11627"
"chr8","31513445","31513750","chr8","31525116","31525418","12","11671"
"chr8","31533062","31533341","chr1","159614491","159614771","48","128081429"
"chr8","31534406","31534526","chr3","88304905","88305026","21","56770499"
"chr8","31535790","31536000","chr20","32220718","32220934","48","684928"
"chr8","31536697","31536857","chr12","21427990","21428136","45","10108707"
"chr8","31536955","31537057","chr20","49308511","49308611","17","17771556"
"chr8","31548119","31548411","chr8","31561061","31561354","11","12942"
"chr8","31548531","31548667","chr8","31561479","31561615","5","12948"
"chr8","31548953","31549147","chr8","31561921","31562107","41","12968"
"chr8","31551915","31552224","chr8","31564931","31565247","18","13016"
"chr8","31552838","31553130","chr8","31565854","31566146","4","13016"
"chr8","31553805","31554089","chr8","31566827","31567109","13","13022"
"chr8","31558300","31558459","chr11","131720798","131720962","33","100162498"
"chr8","31565921","31566225","chr8","31573042","31573341","19","7121"
"chr8","31585342","31585606","chr9","92149138","92149403","48","60563796"
"chr8","31585617","31585881","chr6","128257699","128257955","53","96672082"
"chr8","31611568","31611870","chr8","31625549","31625851","6","13981"
"chr8","31617366","31617646","chr12","81034852","81035117","59","49417486"
"chr8","31639020","31639345","chr8","31656555","31656875","16","17535"
"chr8","31651548","31651842","chr8","31669067","31669352","12","17519"
"chr8","31651968","31652270","chrX","142271458","142271746","71","110619490"
"chr8","31653533","31653818","chr8","31671019","31671285","27","17486"
"chr8","31654112","31654375","chr8","31671901","31672164","9","17789"
"chr8","31659436","31659749","chr8","31679191","31679507","6","19755"
"chr8","31671819","31672096","chr8","31682273","31682546","13","10454"
"chr8","31681710","31681878","chr5","58207677","58207845","52","26525967"
"chr8","31700093","31700406","chr8","31720455","31720761","13","20362"
"chr8","31706352","31706640","chr8","31726685","31726972","16","20333"
"chr8","31706721","31706898","chrX","141086494","141086671","33","109379773"
"chr8","31707027","31707154","chr14","18970034","18970159","21","12736993"
"chr8","31733696","31733997","chr8","31755670","31755962","13","21974"
"chr8","31769425","31769730","chr8","31791323","31791617","15","21898"
"chr8","31803427","31803675","chr8","31825080","31825346","22","21653"
"chr8","31821249","31821382","chr19","34615879","34616013","16","2794630"
"chr8","31849838","31850124","chr8","31871476","31871762","4","21638"
"chr8","31850597","31850896","chr8","31872233","31872532","9","21636"
"chr8","31872969","31873129","chr8","31894589","31894750","1","21620"
"chr8","31875147","31875460","chr8","31896824","31897082","61","21677"
"chr8","31961163","31961299","chr7","59602142","59602276","24","27640979"
"chr8","31961334","31961445","chr8","31992587","31992698","4","31253"
"chr8","32014115","32014316","chr8","32044121","32044322","12","30006"
"chr8","32044105","32044396","chr8","32078614","32078902","9","34509"
"chr8","32191848","32192129","chr8","32226297","32226600","23","34449"
"chr8","32201369","32201613","chr3","55039918","55040169","58","22838549"
"chr8","32307433","32307733","chr8","32347401","32347701","6","39968"
"chr8","32415186","32415475","chr8","32454939","32455215","18","39753"
"chr8","32437444","32437749","chr8","32477230","32477528","13","39786"
"chr8","32463460","32463627","chr13","25945969","25946132","32","6517491"
"chr8","32463671","32463786","chr2","86076916","86077027","19","53613245"
"chr8","32601644","32601935","chr8","32645044","32645336","7","43400"
"chr8","32661922","32662197","chr8","32709397","32709689","26","47475"
"chr8","32709758","32709880","chr4","118775455","118775575","36","86065697"
"chr8","32709924","32709973","chr1","142467968","142468017","14","109758044"
"chr8","32734550","32734851","chr8","32782391","32782694","7","47841"
"chr8","32799256","32799561","chr8","32849844","32850136","17","50588"
"chr8","32819712","32819909","chr8","32870745","32870942","4","51033"
"chr8","32820868","32820973","chr8","32871832","32871935","4","50964"
"chr8","32821304","32821343","chr8","32872276","32872318","6","50972"
"chr8","32872370","32872640","chr8","32942920","32943178","30","70550"
"chr8","32909303","32909608","chr8","32979846","32980151","8","70543"
"chr8","32914818","32915108","chr8","32985344","32985634","8","70526"
"chr8","32926438","32926722","chr8","32997058","32997342","11","70620"
"chr8","32979983","32980165","chr8","33045710","33045859","35","65727"
"chr8","33052519","33052821","chr8","33124440","33124742","8","71921"
"chr8","33072368","33072443","chr2","34288520","34288595","11","1216152"
"chr8","33072634","33072859","chr6","166590697","166590925","56","133518063"
"chr8","33093151","33093371","chr8","33165219","33165440","8","72068"
"chr8","33158354","33158642","chr8","33237249","33237537","5","78895"
"chr8","33230450","33230747","chr8","33307941","33308234","17","77491"
"chr8","33252002","33252292","chr8","33329375","33329665","3","77373"
"chr8","33326553","33326847","chr8","33403034","33403313","26","76481"
"chr8","33470119","33470422","chr14","12553038","12553339","62","20917081"
"chr8","33513318","33513629","chr8","33598192","33598490","20","84874"
"chr8","33518554","33518836","chr8","33603417","33603729","39","84863"
"chr8","33588944","33589254","chr8","33675719","33676030","11","86775"
"chr8","33616009","33616300","chr8","33702808","33703101","15","86799"
"chr8","33637130","33637441","chr8","33724217","33724532","14","87087"
"chr8","33650497","33650783","chr8","33737609","33737873","29","87112"
"chr8","33665037","33665329","chr8","33752143","33752437","15","87106"
"chr8","33718894","33719193","chr8","33805214","33805505","24","86320"
"chr8","33777265","33777486","chr8","33866020","33866252","26","88755"
"chr8","33816059","33816362","chr8","33904884","33905184","17","88825"
"chr8","33824598","33824910","chr8","33913056","33913365","19","88458"
"chr8","33852881","33853214","chr8","33942429","33942743","26","89548"
"chr8","33905713","33905819","chrX","43701261","43701368","23","9795548"
"chr8","33905907","33906122","chr13","1886616","1886829","57","32019291"
"chr8","33910848","33911099","chr6","164840820","164841075","58","130929972"
"chr8","34015540","34015570","chr19","28289403","28289434","6","5726137"
"chr8","34101876","34102184","chr8","34204435","34204747","14","102559"
"chr8","34115977","34116285","chr8","34219082","34219390","12","103105"
"chr8","34116658","34116833","chr8","34219762","34219926","14","103104"
"chr8","34133678","34133965","chr8","34236801","34237088","2","103123"
"chr8","34176378","34176699","chr8","34280314","34280637","17","103936"
"chr8","34189338","34189653","chr8","34291243","34291539","27","101905"
"chr8","34191697","34191992","chr8","34293601","34293896","4","101904"
"chr8","34202210","34202409","chr8","34304036","34304235","10","101826"
"chr8","34226391","34226700","chr8","34328200","34328477","35","101809"
"chr8","34279893","34280193","chr8","34381115","34381416","2","101222"
"chr8","34283797","34284094","chr8","34385020","34385324","13","101223"
"chr8","34311143","34311290","chr8","34412323","34412489","26","101180"
"chr8","34312294","34312620","chr8","34413491","34413801","33","101197"
"chr8","34372573","34372839","chr8","34472909","34473175","6","100336"
"chr8","34404791","34405085","chr8","34504997","34505291","9","100206"
"chr8","34419056","34419206","chr8","34519052","34519202","8","99996"
"chr8","34460922","34461205","chr8","34560980","34561295","40","100058"
"chr8","34463647","34463906","chr8","34563571","34563830","1","99924"
"chr8","34557920","34558235","chr8","34667395","34667711","8","109475"
"chr8","34559196","34559293","chr8","34668644","34668743","2","109448"
"chr8","34569845","34570155","chr8","34678835","34679139","14","108990"
"chr8","34590755","34591052","chr8","34699525","34699847","35","108770"
"chr8","34593660","34593961","chr8","34702638","34702932","12","108978"
"chr8","34599385","34599684","chr8","34708338","34708637","4","108953"
"chr8","34665768","34666067","chr8","34777212","34777529","21","111444"
"chr8","34736640","34736947","chr8","34846884","34847183","17","110244"
"chr8","34751282","34751620","chr8","34861988","34862292","38","110706"
"chr8","34815197","34815509","chr8","34925579","34925891","5","110382"
"chr8","34873294","34873584","chr8","34984467","34984758","9","111173"
"chr8","34907579","34907887","chr8","35018429","35018750","25","110850"
"chr8","35082609","35082798","chr8","35202964","35203152","6","120355"
"chr8","35096720","35097025","chr8","35217458","35217768","12","120738"
"chr8","35134070","35134380","chr8","35254277","35254603","28","120207"
"chr8","35208885","35209044","chr3","160740675","160740837","37","125531790"
"chr8","35209852","35209985","chr1","118805415","118805544","28","83595563"
"chr8","35256785","35256916","chr7","39566754","39566887","23","4309969"
"chr8","35382807","35383028","chr6","128187740","128187954","44","92804933"
"chr8","35400540","35400655","chr8","35517046","35517159","5","116506"
"chr8","35404432","35404710","chr8","35520941","35521219","4","116509"
"chr8","35432522","35432673","chr8","35548870","35549021","5","116348"
"chr8","35438822","35438948","chr5","71717508","71717631","19","36278686"
"chr8","35477245","35477550","chr8","35596290","35596594","7","119045"
"chr8","35491300","35491612","chr8","35610264","35610574","5","118964"
"chr8","35544450","35544584","chr8","35662586","35662719","7","118136"
"chr8","35544689","35544860","chr8","35662749","35662943","29","118060"
"chr8","35555813","35555916","chr8","35674114","35674214","6","118301"
"chr8","35555964","35556080","chr8","40465749","40465862","21","4909785"
"chr8","35556083","35556296","chr1","18045383","18045586","48","17510700"
"chr8","35575109","35575274","chr8","35693731","35693900","8","118622"
"chr8","35587715","35587872","chr7","53483520","53483679","22","17895805"
"chr8","35595967","35596267","chr8","35714958","35715257","13","118991"
"chr8","35624792","35625106","chr8","35744192","35744506","4","119400"
"chr8","35686686","35686883","chr8","35807144","35807347","15","120458"
"chr8","35704343","35704644","chr8","35824795","35825095","6","120452"
"chr8","35712155","35712444","chr8","35832525","35832815","7","120370"
"chr8","35718745","35718877","chr8","35839195","35839336","13","120450"
"chr8","35740700","35740988","chr8","35861154","35861439","9","120454"
"chr8","35742517","35742816","chr8","35863006","35863308","9","120489"
"chr8","35759680","35759971","chr8","35880574","35880865","4","120894"
"chr8","35774720","35775013","chr8","35895674","35895960","12","120954"
"chr8","35805795","35806093","chr8","35927542","35927840","3","121747"
"chr8","35807795","35808075","chr8","35929561","35929841","2","121766"
"chr8","35854141","35854439","chr8","35980255","35980549","12","126114"
"chr8","35888157","35888464","chr20","12145142","12145455","64","23743015"
"chr8","35907404","35907695","chr8","36041346","36041638","7","133942"
"chr8","35911582","35911720","chr8","36032718","36032852","8","121136"
"chr8","35912032","35912192","chr8","36033170","36033335","14","121138"
"chr8","35920185","35920418","chr20","15821074","15821305","45","20099111"
"chr8","35924638","35924933","chr8","36053272","36053567","8","128634"
"chr8","35928302","35928605","chr7","52404382","52404685","65","16476080"
"chr8","35947315","35947596","chr7","92244360","92244641","4","56297045"
"chr8","35948958","35949265","chr8","36080002","36080310","12","131044"
"chr8","35971182","35971483","chr8","36103802","36104087","40","132620"
"chr8","35976447","35976739","chr8","36109328","36109619","8","132881"
"chr8","35982973","35983282","chrX","21261944","21262250","65","14721029"
"chr8","36005792","36005909","chr1","16081694","16081810","20","19924098"
"chr8","36006907","36007030","chr13","99845123","99845240","32","63838216"
"chr8","36013427","36013726","chr8","36154332","36154626","12","140905"
"chr8","36014316","36014620","chr8","36155215","36155520","5","140899"
"chr8","36014791","36015045","chr8","36155691","36155944","3","140900"
"chr8","36015855","36016160","chr8","36156758","36157073","17","140903"
"chr8","36017067","36017367","chr8","36157975","36158269","24","140908"
"chr8","36024002","36024307","chr8","36164599","36164902","6","140597"
"chr8","36028157","36028453","chr8","36168821","36169117","6","140664"
"chr8","36032621","36032931","chr7","25185886","25186189","54","10846735"
"chr8","36039445","36039740","chr8","36180589","36180880","14","141144"
"chr8","36043773","36044061","chr8","36184906","36185200","13","141133"
"chr8","36052121","36052424","chr8","36194348","36194651","5","142227"
"chr8","36060202","36060495","chr8","36202451","36202735","14","142249"
"chr8","36069010","36069303","chr8","36210505","36210799","13","141495"
"chr8","36070122","36070428","chr8","36211616","36211914","16","141494"
"chr8","36077474","36077583","chr8","36219641","36219751","3","142167"
"chr8","36077883","36078046","chr8","36220053","36220233","20","142170"
"chr8","36080487","36080739","chr8","36222532","36222783","10","142045"
"chr8","36082401","36082649","chr7","157978797","157979048","55","121896396"
"chr8","36130253","36130407","chr8","63049295","63049453","35","26919042"
"chr8","36132723","36133018","chr8","36276179","36276480","13","143456"
"chr8","36134360","36134588","chr8","36277815","36278042","8","143455"
"chr8","36135586","36135848","chr8","36279181","36279444","7","143595"
"chr8","36136195","36136463","chr8","36279791","36280058","3","143596"
"chr8","36148800","36149116","chr8","36292808","36293123","8","144008"
"chr8","36149117","36149206","chr8","36293127","36293209","8","144010"
"chr8","36151672","36151977","chr8","36295667","36295967","28","143995"
"chr8","36151979","36152275","chr8","36295667","36295967","14","143688"
"chr8","36154866","36155006","chr8","36298858","36298990","14","143992"
"chr8","36156035","36156187","chr6","85995278","85995428","38","49839243"
"chr8","36161435","36161739","chr8","36305435","36305739","7","144000"
"chr8","36186102","36186438","chr4","20062475","20062773","85","16123627"
"chr8","36188871","36189156","chr8","36335512","36335797","9","146641"
"chr8","36207119","36207416","chr8","36354184","36354464","20","147065"
"chr8","36224804","36224872","chr8","36376018","36376078","9","151214"
"chr8","36234128","36234438","chr8","36385261","36385573","5","151133"
"chr8","36238859","36239010","chr8","36390059","36390210","0","151200"
"chr8","36248221","36248519","chr8","36405962","36406257","9","157741"
"chr8","36267282","36267324","chr12","80492486","80492530","4","44225204"
"chr8","36271664","36271956","chr8","36424325","36424634","22","152661"
"chr8","36303039","36303328","chr8","36461549","36461868","34","158510"
"chr8","36306357","36306666","chr8","36457862","36458168","9","151505"
"chr8","36324342","36324632","chr8","36476755","36477043","9","152413"
"chr8","36324835","36324993","chr8","36477246","36477404","5","152411"
"chr8","36325281","36325440","chr8","36477715","36477851","25","152434"
"chr8","36326320","36326628","chr8","36478731","36479041","6","152411"
"chr8","36341751","36342018","chr8","36494480","36494747","6","152729"
"chr8","36363550","36363845","chr8","36517724","36518011","11","154174"
"chr8","36366175","36366394","chr8","36520340","36520572","17","154165"
"chr8","36373518","36373811","chr8","36527700","36527988","14","154182"
"chr8","36390100","36390396","chr8","36543985","36544286","15","153885"
"chr8","36404924","36405080","chr3","45835796","45835967","47","9430872"
"chr8","36449224","36449331","chr8","36604925","36605032","3","155701"
"chr8","36458853","36459143","chr8","36614581","36614868","21","155728"
"chr8","36462115","36462319","chr8","69577131","69577335","43","33115016"
"chr8","36464868","36465023","chr8","36620670","36620825","4","155802"
"chr8","36471129","36471434","chr8","36626824","36627132","11","155695"
"chr8","36478079","36478348","chr8","36633775","36634044","7","155696"
"chr8","36479635","36479934","chr8","36635345","36635637","13","155710"
"chr8","36496712","36496870","chr11","121092295","121092441","47","84595583"
"chr8","36509440","36509582","chr7","79500699","79500837","25","42991259"
"chr8","36509895","36510037","chr3","52525873","52526017","27","16015978"
"chr8","36513838","36514113","chr8","36671125","36671403","8","157287"
"chr8","36516583","36516868","chr2","79398227","79398517","68","42881644"
"chr8","36522612","36522701","chr8","36680928","36681017","4","158316"
"chr8","36531360","36531632","chr8","36691238","36691519","15","159878"
"chr8","36545772","36546067","chr8","36712506","36712804","7","166734"
"chr8","36555279","36555457","chr8","36717295","36717473","2","162016"
"chr8","36578630","36578928","chr8","36740861","36741157","17","162231"
"chr8","36588471","36588789","chr8","36750697","36751004","27","162226"
"chr8","36594868","36595149","chr8","36757078","36757379","34","162210"
"chr8","36613827","36613950","chr14","46331215","46331337","20","9717388"
"chr8","36651622","36651900","chr8","36820193","36820466","13","168571"
"chr8","36664895","36665189","chr8","36826906","36827200","7","162011"
"chr8","36667896","36668175","chr8","36829874","36830153","5","161978"
"chr8","36684731","36685043","chr8","36847297","36847607","8","162566"
"chr8","36693732","36694021","chr8","36856604","36856893","7","162872"
"chr8","36699418","36699733","chr8","36862216","36862531","7","162798"
"chr8","36700738","36701083","chr8","36863525","36863872","26","162787"
"chr8","36730534","36730712","chr8","36894236","36894416","9","163702"
"chr8","36730759","36730873","chr8","36894459","36894573","1","163700"
"chr8","36736493","36736804","chr8","36900117","36900434","12","163624"
"chr8","36736809","36737102","chr14","64863152","64863451","56","28126343"
"chr8","36740237","36740343","chr8","36903919","36904027","3","163682"
"chr8","36798224","36798536","chr8","36959469","36959766","17","161245"
"chr8","36812533","36812660","chr8","36973904","36974031","1","161371"
"chr8","36820535","36820825","chr8","36981716","36982006","9","161181"
"chr8","36829786","36829925","chr7","45136653","45136789","31","8306867"
"chr8","36830239","36830405","chr14","4496033","4496201","31","32334206"
"chr8","36836904","36837190","chr8","36997733","36998028","21","160829"
"chr8","36850766","36851072","chr20","55623731","55624042","56","18772965"
"chr8","36874285","36874567","chr8","37035249","37035528","7","160964"
"chr8","36887623","36887931","chr8","37050083","37050394","8","162460"
"chr8","36897215","36897497","chr8","37059735","37060014","11","162520"
"chr8","36906503","36906698","chr8","37070599","37070764","38","164096"
"chr8","36906999","36907140","chr8","37071063","37071204","6","164064"
"chr8","36925320","36925583","chr8","37090007","37090270","5","164687"
"chr8","36927737","36928038","chr8","37092450","37092745","14","164713"
"chr8","36970620","36970851","chr8","37135455","37135688","5","164835"
"chr8","36972082","36972148","chr11","51755099","51755165","15","14783017"
"chr8","36972149","36972277","chr8","37137005","37137129","10","164856"
"chr8","36975020","36975310","chr8","37139867","37140165","14","164847"
"chr8","36975718","36975960","chr8","37140581","37140827","16","164863"
"chr8","36991639","36991792","chr8","37155757","37155916","6","164118"
"chr8","37005039","37005172","chr8","37167919","37168052","0","162880"
"chr8","37005468","37005644","chr8","37168347","37168520","7","162879"
"chr8","37013003","37013281","chr4","42693302","42693595","61","5680299"
"chr8","37014107","37014298","chr8","37177026","37177217","5","162919"
"chr8","37070067","37070375","chr8","37231703","37232026","21","161636"
"chr8","37116779","37116993","chr8","37278513","37278727","3","161734"
"chr8","37176442","37176727","chr8","37338967","37339241","15","162525"
"chr8","37283221","37283532","chr8","37458757","37459076","12","175536"
"chr8","37540726","37541006","chr8","37726690","37726970","6","185964"
"chr8","37680093","37680424","chr8","37871307","37871644","20","191214"
"chr8","37682888","37683181","chr8","37880363","37880653","11","197475"
"chr8","37765804","37766099","chr8","37967451","37967746","7","201647"
"chr8","37915419","37915711","chr8","38130514","38130811","12","215095"
"chr8","37937693","37937867","chr8","38153235","38153409","5","215542"
"chr8","37954328","37954451","chr8","38170451","38170574","0","216123"
"chr8","38008299","38008566","chr9","54388853","54389111","57","16380554"
"chr8","38047922","38048221","chr8","38266357","38266656","5","218435"
"chr8","38053731","38054018","chr8","38272064","38272350","8","218333"
"chr8","38101493","38101806","chr8","38322607","38322880","63","221114"
"chr8","38128998","38129286","chr8","38351000","38351281","17","222002"
"chr8","38153958","38154219","chr8","38376023","38376289","9","222065"
"chr8","38160606","38160904","chr8","38382673","38382971","2","222067"
"chr8","38260160","38260466","chr8","38483400","38483695","24","223240"
"chr8","38262584","38262873","chr8","38485806","38486096","5","223222"
"chr8","38376011","38376258","chr8","38605175","38605422","5","229164"
"chr8","38408365","38408678","chr8","38638483","38638798","8","230118"
"chr8","38552008","38552361","chr4","126014462","126014811","89","87462454"
"chr8","38626881","38627024","chr8","38860670","38860815","5","233789"
"chr8","38631881","38632195","chr8","38865620","38865929","17","233739"
"chr8","38653644","38653944","chr8","38907361","38907657","13","253717"
"chr8","38656362","38656521","chr8","38910106","38910264","4","253744"
"chr8","38663535","38663820","chr8","38917234","38917519","7","253699"
"chr8","38711313","38711649","chr8","38965411","38965731","24","254098"
"chr8","38726690","38726982","chr8","38980711","38981004","6","254021"
"chr8","38810916","38811137","chr8","39065455","39065676","3","254539"
"chr8","38882094","38882301","chr8","39138356","39138561","5","256262"
"chr8","38890407","38890714","chr8","39146228","39146535","8","255821"
"chr8","38924967","38925221","chr8","39180575","39180825","23","255608"
"chr8","38984279","38984584","chr8","39241025","39241330","8","256746"
"chr8","38987227","38987523","chr8","39243968","39244258","12","256741"
"chr8","38990862","38991154","chr8","39247593","39247887","15","256731"
"chr8","39002215","39002452","chr8","39258947","39259184","3","256732"
"chr8","39003669","39003973","chr8","39260402","39260701","16","256733"
"chr8","39011988","39012290","chr8","39269074","39269376","4","257086"
"chr8","39038902","39039194","chr8","39296077","39296364","18","257175"
"chr8","39041039","39041347","chr8","39298933","39299222","32","257894"
"chr8","39069085","39069396","chr8","39334189","39334486","26","265104"
"chr8","39074099","39074420","chr8","39339195","39339515","9","265096"
"chr8","39084366","39084661","chr8","39352727","39353021","5","268361"
"chr8","39102301","39102448","chr2","97453761","97453897","43","58351460"
"chr8","39102476","39102595","chr4","18071771","18071888","22","21030705"
"chr8","39154598","39154703","chr8","39423530","39423643","9","268932"
"chr8","39155415","39155432","chr8","39424351","39424368","2","268936"
"chr8","39155725","39155910","chr8","39424661","39424848","5","268936"
"chr8","39165198","39165508","chr8","39434098","39434361","54","268900"
"chr8","39168384","39168659","chr8","39437217","39437491","8","268833"
"chr8","39178583","39178728","chr8","39447381","39447524","3","268798"
"chr8","39179841","39180036","chr3","35200247","35200440","48","3979594"
"chr8","39180383","39180454","chr16","6916307","6916376","14","32264076"
"chr8","39196390","39196703","chr9","88204588","88204905","63","49008198"
"chr8","39273302","39273567","chr8","39545187","39545453","8","271885"
"chr8","39350680","39350995","chr8","39622447","39622762","3","271767"
"chr8","39383984","39384275","chr8","39667313","39667604","3","283329"
"chr8","39426149","39426281","chr18","62221602","62221733","12","22795453"
"chr8","39450472","39450573","chr15","104286070","104286168","25","64835598"
"chr8","39476518","39476814","chr20","53352637","53352940","43","13876119"
"chr8","39496668","39496938","chr8","39782785","39783061","6","286117"
"chr8","39507688","39507988","chr14","52879118","52879412","46","13371430"
"chr8","39509245","39509420","chr8","39794313","39794488","0","285068"
"chr8","39514752","39515000","chr7","156871585","156871829","57","117356833"
"chr8","39530775","39531066","chr8","39815908","39816199","12","285133"
"chr8","39532067","39532305","chr8","39818434","39818667","7","286367"
"chr8","39533950","39534163","chr8","39820325","39820538","4","286375"
"chr8","39539221","39539505","chr8","39824341","39824625","3","285120"
"chr8","39540253","39540493","chr8","39825375","39825615","4","285122"
"chr8","39544538","39544806","chr8","39829696","39829964","4","285158"
"chr8","39550806","39551095","chr8","39836910","39837211","15","286104"
"chr8","39552532","39552878","chr8","39838644","39838964","43","286112"
"chr8","39553658","39553782","chr16","32480562","32480684","26","7073096"
"chr8","39560775","39560913","chr8","39847250","39847404","17","286475"
"chr8","39583151","39583225","chr8","39864104","39864178","3","280953"
"chr8","39589796","39590063","chr8","39870738","39871005","7","280942"
"chr8","39592915","39593191","chr8","39873370","39873646","6","280455"
"chr8","39612102","39612396","chr8","39892510","39892802","10","280408"
"chr8","39662095","39662374","chr3","67205723","67206001","64","27543628"
"chr8","39668317","39668474","chr2","100069015","100069158","36","60400698"
"chr8","39710752","39711079","chr1","205089423","205089747","63","165378671"
"chr8","39763528","39763700","chr8","40044965","40045139","4","281437"
"chr8","39778983","39779267","chr8","40059984","40060276","11","281001"
"chr8","39844447","39844621","chr8","40125287","40125462","3","280840"
"chr8","39897100","39897400","chr8","40177160","40177470","18","280060"
"chr8","39909052","39909185","chr8","40191767","40191900","2","282715"
"chr8","39954498","39954779","chr8","40237659","40237939","7","283161"
"chr8","39973316","39973517","chr8","40256467","40256673","15","283151"
"chr8","40007011","40007298","chr8","40289763","40290050","9","282752"
"chr8","40057878","40058186","chr8","40341723","40342022","13","283845"
"chr8","40066581","40066846","chr8","40350569","40350864","32","283988"
"chr8","40068654","40068855","chr8","40356767","40356969","7","288113"
"chr8","40075852","40076154","chr8","40360248","40360550","9","284396"
"chr8","40076577","40076745","chr8","40360974","40361142","3","284397"
"chr8","40088091","40088252","chr8","40372817","40372978","7","284726"
"chr8","40095198","40095496","chr8","40379938","40380244","18","284740"
"chr8","40113505","40113809","chr8","40395658","40395944","23","282153"
"chr8","40118542","40118821","chr8","40401044","40401333","16","282502"
"chr8","40125258","40125558","chr8","40407861","40408175","24","282603"
"chr8","40131700","40131999","chr8","40414239","40414541","7","282539"
"chr8","40133042","40133332","chr8","40415598","40415890","5","282556"
"chr8","40150862","40151150","chr8","40433465","40433767","20","282603"
"chr8","40152503","40152824","chr8","40435393","40435703","17","282890"
"chr8","40156335","40156599","chr8","40439223","40439486","8","282888"
"chr8","40178729","40179059","chr8","40461437","40461759","15","282708"
"chr8","40182507","40182683","chr8","40465522","40465694","6","283015"
"chr8","40182731","40182880","chr15","34671188","34671344","35","5511543"
"chr8","40188783","40189086","chr8","40471769","40472065","12","282986"
"chr8","40203401","40203707","chr8","40486576","40486890","17","283175"
"chr8","40207547","40207869","chr8","40490718","40491040","5","283171"
"chr8","40235270","40235399","chr8","40517434","40517563","2","282164"
"chr8","40236950","40237248","chr1","23009025","23009318","59","17227925"
"chr8","40240029","40240334","chr8","40522020","40522328","12","281991"
"chr8","40243456","40243586","chr3","42843614","42843751","24","2600158"
"chr8","40244208","40244250","chr9","40557511","40557551","9","313303"
"chr8","40250793","40251049","chr8","40536415","40536671","4","285622"
"chr8","40254986","40255242","chr8","40536415","40536671","4","281429"
"chr8","40256467","40256762","chr3","86243869","86244159","54","45987402"
"chr8","40271287","40271585","chr8","40555698","40555997","8","284411"
"chr8","40278291","40278623","chr8","40562829","40563161","6","284538"
"chr8","40307447","40307713","chr8","40591554","40591820","1","284107"
"chr8","40315800","40315979","chr14","62644580","62644753","32","22328780"
"chr8","40316000","40316143","chr8","40600095","40600237","3","284095"
"chr8","40333295","40333583","chr8","40618090","40618385","15","284795"
"chr8","40340072","40340389","chr2","113084935","113085229","71","72744863"
"chr8","40353197","40353494","chr19","36240985","36241284","51","4112212"
"chr8","40360088","40360385","chr8","40649059","40649343","14","288971"
"chr8","40381619","40381919","chr8","40670437","40670724","26","288818"
"chr8","40385582","40385873","chr8","40675554","40675833","18","289972"
"chr8","40387971","40388235","chr8","40677700","40677955","18","289729"
"chr8","40395041","40395294","chr8","40684731","40684984","1","289690"
"chr8","40405299","40405500","chr8","40695160","40695361","2","289861"
"chr8","40461400","40461712","chr13","41851851","41852159","55","1390451"
"chr8","40472366","40472639","chr8","40762249","40762522","4","289883"
"chr8","40480111","40480377","chr8","40769815","40770081","7","289704"
"chr8","40488175","40488460","chr8","40781506","40781792","10","293331"
"chr8","40497385","40497680","chr8","40792342","40792637","5","294957"
"chr8","40498531","40498862","chr8","40793489","40793820","4","294958"
"chr8","40510572","40510746","chr8","40804523","40804676","21","293951"
"chr8","40536192","40536513","chr6","147342156","147342471","71","106805964"
"chr8","40544900","40545184","chr8","40838676","40838960","4","293776"
"chr8","40551077","40551389","chr8","40844811","40845124","4","293734"
"chr8","40577929","40578233","chr8","40869606","40869910","5","291677"
"chr8","40580857","40581084","chr8","40872577","40872796","16","291720"
"chr8","40591891","40592188","chr8","40883442","40883739","3","291551"
"chr8","40619066","40619291","chr8","40909602","40909823","8","290536"
"chr8","40632522","40632784","chr8","40922710","40922978","8","290188"
"chr8","40636385","40636565","chr8","40926565","40926744","6","290180"
"chr8","40655756","40655865","chr8","40946125","40946234","3","290369"
"chr8","40675798","40676083","chr8","40966246","40966535","12","290448"
"chr8","40679585","40679813","chr8","40970446","40970671","5","290861"
"chr8","40699233","40699527","chr8","40989597","40989891","5","290364"
"chr8","40709537","40709706","chr3","179821962","179822137","43","139112425"
"chr8","40746403","40746704","chr8","41046500","41046801","6","300097"
"chr8","40769604","40769762","chr13","20669368","20669523","34","20100236"
"chr8","40774976","40775288","chr8","41074858","41075165","7","299882"
"chr8","40793948","40794246","chr8","41094517","41094814","7","300569"
"chr8","40795988","40796299","chr8","41096557","41096849","27","300569"
"chr8","40803108","40803419","chr8","41103645","41103932","45","300537"
"chr8","40815283","40815453","chrX","49524523","49524692","31","8709240"
"chr8","40818604","40818882","chr4","18158014","18158306","64","22660590"
"chr8","40828799","40828934","chr8","41131283","41131419","6","302484"
"chr8","40836758","40837039","chr8","41139242","41139523","8","302484"
"chr8","40843035","40843319","chr8","41145507","41145772","26","302472"
"chr8","40856329","40856579","chr8","41158252","41158502","4","301923"
"chr8","40856771","40857044","chr8","41158694","41158965","5","301923"
"chr8","40857073","40857366","chr8","41159017","41159313","5","301944"
"chr8","40858772","40859084","chr8","41160716","41161028","9","301944"
"chr8","40868145","40868441","chr8","41169945","41170238","9","301800"
"chr8","40870651","40870893","chr8","41172451","41172692","6","301800"
"chr8","40878870","40879157","chr14","55839880","55840167","44","14961010"
"chr8","40883868","40884059","chr8","41185842","41186033","4","301974"
"chr8","40884332","40884426","chr8","41186290","41186390","7","301958"
"chr8","40884792","40885105","chr8","41186735","41187029","23","301943"
"chr8","40892135","40892409","chr8","41193661","41193935","3","301526"
"chr8","40894934","40895225","chr12","39387550","39387851","63","1507384"
"chr8","40902470","40902774","chr8","41203976","41204278","12","301506"
"chr8","40966234","40966525","chr16","41671981","41672272","50","705747"
"chr8","40966839","40967127","chr5","89558764","89559061","62","48591925"
"chr8","40975226","40975529","chr8","41275039","41275345","10","299813"
"chr8","40988627","40988920","chr8","41288144","41288438","10","299517"
"chr8","40992030","40992331","chr8","41291929","41292209","27","299899"
"chr8","40994775","40995068","chr8","41294656","41294949","7","299881"
"chr8","40995116","40995414","chr8","41294995","41295301","13","299879"
"chr8","41001693","41001966","chr8","41301625","41301901","9","299932"
"chr8","41013315","41013610","chr8","41312760","41313055","6","299445"
"chr8","41016926","41017220","chr8","41316332","41316627","7","299406"
"chr8","41032131","41032287","chr8","41331992","41332149","2","299861"
"chr8","41035862","41035992","chr8","41335865","41335995","3","300003"
"chr8","41051510","41051769","chr8","41347949","41348208","2","296439"
"chr8","41064648","41064893","chr8","41361174","41361415","8","296526"
"chr8","41109898","41110185","chr8","41406310","41406597","7","296412"
"chr8","41150116","41150251","chr2","184466521","184466652","25","143316405"
"chr8","41158143","41158244","chr8","41459762","41459839","26","301619"
"chr8","41163313","41163603","chr8","41465942","41466231","9","302629"
"chr8","41168354","41168448","chr8","41470967","41471058","4","302613"
"chr8","41168943","41169078","chr8","41471553","41471686","16","302610"
"chr8","41173700","41173984","chr8","41476317","41476600","6","302617"
"chr8","41183629","41183923","chr8","41486730","41487022","5","303101"
"chr8","41184320","41184618","chr8","41487423","41487721","5","303103"
"chr8","41189673","41189959","chr8","41492204","41492490","4","302531"
"chr8","41201475","41201786","chr8","41503557","41503867","9","302082"
"chr8","41268708","41268994","chr4","146703157","146703443","18","105434449"
"chr8","42731822","42731963","chr19","28213603","28213739","28","14518219"
"chr8","42732306","42732586","chr9","43284458","43284740","57","552152"
"chr8","42742276","42742570","chrX","91137982","91138266","66","48395706"
"chr8","42742614","42742689","chr2","98666597","98666670","21","55923983"
"chr8","42783904","42784191","chr3","104163879","104164177","51","61379975"
"chr8","42801667","42801853","chr15","6610933","6611119","49","36190734"
"chr8","42801854","42801897","chr14","6765227","6765269","6","36036627"
"chr8","42805130","42805294","chrX","1573064","1573227","32","41232066"
"chr8","42818974","42819286","chr3","104214338","104214647","40","61395364"
"chr8","42842301","42842610","chr4","152226280","152226592","56","109383979"
"chr8","42924571","42924840","chr8","43075261","43075530","5","150690"
"chr8","43054847","43054971","chrX","112289100","112289207","41","69234253"
"chr8","43054959","43055083","chrX","112289100","112289207","41","69234141"
"chr8","43055071","43055195","chrX","112289100","112289207","41","69234029"
"chr8","43055183","43055307","chrX","112289100","112289207","41","69233917"
"chr8","43055295","43055419","chrX","112289100","112289207","41","69233805"
"chr8","43055407","43055531","chrX","112289100","112289207","41","69233693"
"chr8","43055519","43055643","chrX","112289100","112289207","41","69233581"
"chr8","43055631","43055755","chrX","112289100","112289207","41","69233469"
"chr8","43055743","43055867","chrX","112289100","112289207","41","69233357"
"chr8","43055855","43055979","chrX","112289100","112289207","41","69233245"
"chr8","43055967","43056091","chrX","112289100","112289207","41","69233133"
"chr8","43056079","43056203","chrX","112289100","112289207","41","69233021"
"chr8","43056191","43056315","chrX","112289100","112289207","41","69232909"
"chr8","43056291","43056427","chr14","17621878","17622000","51","25434413"
"chr8","43056403","43056539","chr14","17621878","17622000","51","25434525"
"chr8","43056515","43056651","chr14","17621878","17622000","51","25434637"
"chr8","43056627","43056763","chr14","17621878","17622000","51","25434749"
"chr8","43056739","43056875","chr14","17621878","17622000","51","25434861"
"chr8","43056851","43056987","chr14","17621878","17622000","51","25434973"
"chr8","43056963","43057099","chr14","17621878","17622000","51","25435085"
"chr8","43057075","43057211","chr14","17621878","17622000","51","25435197"
"chr8","43057187","43057323","chr14","17621878","17622000","51","25435309"
"chr8","43057299","43057435","chr14","17621878","17622000","51","25435421"
"chr8","43057411","43057547","chr14","17621878","17622000","51","25435533"
"chr8","43057523","43057659","chr14","17621878","17622000","51","25435645"
"chr8","43057635","43057771","chr14","17621878","17622000","51","25435757"
"chr8","43057747","43057883","chr14","17621878","17622000","51","25435869"
"chr8","43057859","43057995","chr14","17621878","17622000","51","25435981"
"chr8","43057971","43058107","chr14","17621878","17622000","51","25436093"
"chr8","43058083","43058219","chr14","17621878","17622000","51","25436205"
"chr8","43058195","43058331","chr14","17621878","17622000","51","25436317"
"chr8","43058307","43058443","chr14","17621878","17622000","51","25436429"
"chr8","43058419","43058555","chr14","17621878","17622000","51","25436541"
"chr8","43058531","43058667","chr14","17621878","17622000","51","25436653"
"chr8","43058643","43058779","chr14","17621878","17622000","51","25436765"
"chr8","43058755","43058891","chr14","17621878","17622000","51","25436877"
"chr8","43058867","43059003","chr14","17621878","17622000","51","25436989"
"chr8","43058979","43059115","chr14","17621878","17622000","51","25437101"
"chr8","43059091","43059227","chr14","17621878","17622000","51","25437213"
"chr8","43059203","43059339","chr14","17621878","17622000","51","25437325"
"chr8","43059315","43059451","chr14","17621878","17622000","51","25437437"
"chr8","43059427","43059504","chr16","19730035","19730108","21","23329392"
"chr8","43074729","43074922","chr8","43197943","43198147","15","123214"
"chr8","43090498","43090660","chr19","40207484","40207647","30","2883014"
"chr8","43097519","43097793","chr8","43223643","43223916","10","126124"
"chr8","43112376","43112684","chr8","43238752","43239058","10","126376"
"chr8","43142854","43142961","chr8","43269283","43269396","6","126429"
"chr8","43232588","43232749","chr3","55562504","55562665","24","12329916"
"chr8","43247978","43248232","chr13","127283657","127283932","50","84035679"
"chr8","43279841","43280122","chr13","127306159","127306437","52","84026318"
"chr8","43280299","43280546","chr13","54555612","54555863","66","11275313"
"chr8","43287520","43287811","chr1","12935740","12936040","63","30351780"
"chr8","43289606","43289913","chr14","91743596","91743889","68","48453990"
"chr8","43294162","43294458","chr7","6547566","6547862","57","36746596"
"chr8","43327572","43327662","chr2","83866811","83866895","29","40539239"
"chr8","43330036","43330388","chr1","13739534","13739874","88","29590502"
"chr8","43341974","43342278","chr15","68769718","68770027","59","25427744"
"chr8","43355255","43355497","chr13","54989850","54990095","53","11634595"
"chr8","43371823","43372118","chr14","67225330","67225616","58","23853507"
"chr8","43397475","43397755","chr1","159614491","159614771","45","116217016"
"chr8","43402530","43402824","chr4","153852084","153852380","56","110449554"
"chr8","43414799","43415094","chr10","64899915","64900203","58","21485116"
"chr8","43463129","43463441","chr2","81861651","81861964","74","38398522"
"chr8","43464523","43464713","chr3","173726907","173727084","45","130262384"
"chr8","43464996","43465132","chr19","35937081","35937215","20","7527915"
"chr8","43473247","43473556","chr6","71945525","71945829","65","28472278"
"chr8","43602216","43602498","chr8","43450855","43451143","9","151361"
"chr8","43662016","43662188","chr8","43510732","43510904","9","151284"
"chr8","43751119","43751262","chr13","10389947","10390076","39","33361172"
"chr8","43773559","43773860","chr8","43630095","43630396","3","143464"
"chr8","43788696","43788945","chr19","16500965","16501209","52","27287731"
"chr8","43794267","43794558","chr8","43649924","43650209","13","144343"
"chr8","43803900","43804199","chr8","43659518","43659817","11","144382"
"chr8","43819608","43819735","chr19","18096174","18096305","23","25723434"
"chr8","43819829","43819910","chr19","10089466","10089547","22","33730363"
"chr8","43828804","43828881","chr8","43683995","43684083","12","144809"
"chr8","43849777","43850070","chr8","43707101","43707394","2","142676"
"chr8","43859326","43859423","chr8","43716763","43716859","5","142563"
"chr8","43886883","43886979","chr13","41576482","41576572","20","2310401"
"chr8","43887268","43887308","chr4","14956334","14956369","5","28930934"
"chr8","43909442","43909687","chr15","103882403","103882639","47","59972961"
"chr8","43912919","43912989","chr2","153122576","153122645","21","109209657"
"chr8","43916913","43917030","chr4","34702119","34702235","19","9214794"
"chr8","43951942","43952238","chr8","43806014","43806310","5","145928"
"chr8","43954518","43954810","chr8","43808612","43808904","7","145906"
"chr8","43959639","43959951","chr8","43813798","43814115","7","145841"
"chr8","43967069","43967342","chr8","43820971","43821246","4","146098"
"chr8","43974210","43974472","chr8","43828082","43828376","36","146128"
"chr8","43974995","43975265","chr20","39915393","39915665","60","4059602"
"chr8","43990653","43990860","chr8","43845233","43845439","8","145420"
"chr8","43993762","43994076","chr8","43848326","43848641","11","145436"
"chr8","44019255","44019542","chr13","45180158","45180456","69","1160903"
"chr8","44022668","44022965","chr8","43877749","43878046","4","144919"
"chr8","44040455","44040744","chr8","43895703","43895990","10","144752"
"chr8","44055260","44055510","chr8","43903749","43903990","12","151511"
"chr8","44070802","44071087","chr8","43919159","43919445","6","151643"
"chr8","44076629","44076849","chr16","68351182","68351379","61","24274553"
"chr8","44077021","44077146","chr7","161219639","161219762","27","117142618"
"chr8","44107758","44107917","chr8","43951038","43951171","27","156720"
"chr8","44110541","44110843","chr8","43953822","43954125","13","156719"
"chr8","44110898","44111185","chr8","43954191","43954487","26","156707"
"chr8","44115836","44116146","chr8","43958846","43959155","22","156990"
"chr8","44137488","44137747","chr8","43981961","43982231","16","155527"
"chr8","44159332","44159613","chr8","44006296","44006576","6","153036"
"chr8","44166425","44166555","chr9","102149913","102150048","25","57983488"
"chr8","44166571","44166702","chr8","44012995","44013126","4","153576"
"chr8","44175133","44175424","chr8","44019972","44020259","13","155161"
"chr8","44176734","44176894","chr2","187026390","187026555","47","142849656"
"chr8","44183638","44183940","chr8","44034777","44035076","9","148861"
"chr8","44186883","44187173","chr8","44038241","44038530","7","148642"
"chr8","44193218","44193514","chr8","44044803","44045099","5","148415"
"chr8","44196958","44197223","chr8","44048778","44049041","4","148180"
"chr8","44199395","44199702","chr8","44051514","44051819","6","147881"
"chr8","44211527","44211819","chr8","44063219","44063515","9","148308"
"chr8","44213078","44213371","chr8","44064768","44065060","7","148310"
"chr8","44214954","44215122","chr8","44066619","44066786","2","148335"
"chr8","44226047","44226328","chr8","44077605","44077887","5","148442"
"chr8","44227221","44227499","chr8","44078785","44079066","9","148436"
"chr8","44243379","44243480","chr8","44095941","44096042","3","147438"
"chr8","44248519","44248803","chr8","44101216","44101497","12","147303"
"chr8","44271239","44271532","chr8","44115676","44115967","8","155563"
"chr8","44280992","44281270","chr8","44125970","44126269","27","155022"
"chr8","44282395","44282685","chr8","44127394","44127684","8","155001"
"chr8","44285406","44285726","chr8","44130442","44130764","9","154964"
"chr8","44297376","44297539","chr8","44142664","44142827","4","154712"
"chr8","44301337","44301646","chr8","44146620","44146933","10","154717"
"chr8","44306828","44307029","chr8","44152117","44152320","19","154711"
"chr8","44310967","44311186","chr8","44155185","44155397","12","155782"
"chr8","44322986","44323033","chr14","32319368","32319418","8","12003618"
"chr8","44475873","44476174","chr5","142954233","142954523","66","98478360"
"chr8","44522272","44522546","chr4","34718339","34718612","65","9803933"
"chr8","44528549","44528562","chr19","35698098","35698111","1","8830451"
"chr8","44528853","44529116","chr8","44398861","44399121","9","129992"
"chr8","44539093","44539350","chr8","44409093","44409347","15","130000"
"chr8","44541683","44541988","chr11","12914812","12915114","58","31626871"
"chr8","44565631","44565890","chr8","44435821","44436114","38","129810"
"chr8","44692330","44692607","chr8","44561201","44561477","6","131129"
"chr8","44729608","44729769","chr8","44602169","44602338","11","127439"
"chr8","44825493","44825701","chr5","51275884","51276081","44","6450391"
"chr8","44835584","44835860","chr8","44707669","44707944","8","127915"
"chr8","44936624","44936756","chr7","79392918","79393055","21","34456294"
"chr8","44981756","44981854","chr12","93470248","93470345","19","48488492"
"chr8","45007796","45008102","chr8","44882248","44882554","12","125548"
"chr8","45017956","45018235","chr8","44892421","44892700","2","125535"
"chr8","45040320","45040605","chr8","44917833","44918118","6","122487"
"chr8","45169666","45169953","chr8","45053715","45054001","6","115951"
"chr8","45286768","45287051","chr8","45172495","45172777","18","114273"
"chr8","45388327","45388605","chr6","172279903","172280171","61","126891576"
"chr8","45463504","45463618","chr8","45359070","45359184","8","104434"
"chr8","45467230","45467539","chr8","45362856","45363164","16","104374"
"chr8","45479868","45480173","chr8","45375502","45375807","11","104366"
"chr8","45501284","45501574","chr8","45398057","45398369","30","103227"
"chr8","45585033","45585197","chr8","45483841","45484007","5","101192"
"chr8","45592383","45592663","chr8","45491570","45491827","31","100813"
"chr8","45776457","45776759","chr1","93835864","93836145","70","48059407"
"chr8","46090256","46090562","chr8","46023445","46023748","14","66811"
"chr8","46116133","46116402","chr8","46049348","46049621","9","66785"
"chr8","46229688","46230000","chr8","46160274","46160568","28","69414"
"chr8","46230083","46230094","chr1","205258045","205258056","1","159027962"
"chr8","46365644","46365939","chr8","46298564","46298859","3","67080"
"chr8","46578089","46578204","chr8","46510074","46510191","6","68015"
"chr8","46578252","46578416","chr8","46510228","46510392","5","68024"
"chr8","46602658","46602973","chr8","46535677","46535968","33","66981"
"chr8","46717214","46717519","chr8","46654394","46654695","15","62820"
"chr8","46811565","46811767","chr8","46758182","46758361","27","53383"
"chr8","46813570","46813679","chr8","46760080","46760188","5","53490"
"chr8","46869422","46869695","chr8","46823740","46824010","9","45682"
"chr8","47118693","47118864","chr8","47058314","47058485","12","60379"
"chr8","47134566","47134858","chr8","47074036","47074340","19","60530"
"chr8","47156360","47156667","chr8","47096140","47096470","26","60220"
"chr8","47277337","47277559","chr8","47205983","47206204","9","71354"
"chr8","47319983","47320237","chr8","47269515","47269769","7","50468"
"chr8","47568812","47569105","chr3","125030767","125031037","67","77461955"
"chr8","47721213","47721519","chr8","47638670","47638976","6","82543"
"chr8","47737448","47737688","chr8","47655064","47655304","3","82384"
"chr8","47854736","47855039","chr8","47765516","47765819","6","89220"
"chr8","47931817","47932114","chr8","47843492","47843791","4","88325"
"chr8","47933838","47934157","chr8","47845515","47845825","16","88323"
"chr8","47942631","47942924","chr8","47854311","47854604","8","88320"
"chr8","47946477","47946638","chr6","65110840","65110974","43","17164363"
"chr8","47951967","47952270","chr8","47863403","47863705","6","88564"
"chr8","47967431","47967603","chr8","47878893","47879037","33","88538"
"chr8","47971325","47971646","chr8","47882686","47882975","40","88639"
"chr8","47988441","47988723","chr8","47900090","47900381","12","88351"
"chr8","48001188","48001506","chr14","18988612","18988922","64","29012576"
"chr8","48045764","48045843","chr8","47954404","47954481","2","91360"
"chr8","48070617","48070872","chr8","47980057","47980312","2","90560"
"chr8","48086205","48086462","chr14","55239859","55240116","60","7153654"
"chr8","48166805","48167086","chr8","48069963","48070220","39","96842"
"chr8","48185535","48185837","chr8","48091857","48092162","11","93678"
"chr8","48208738","48208917","chr8","48115151","48115330","4","93587"
"chr8","48312099","48312407","chr8","48222017","48222324","8","90082"
"chr8","48345079","48345366","chr8","48254437","48254724","2","90642"
"chr8","48361639","48361805","chr8","48271007","48271163","14","90632"
"chr8","48395960","48396252","chr8","48304939","48305220","23","91021"
"chr8","48398594","48398901","chr8","48307563","48307875","10","91031"
"chr8","48446005","48446239","chr8","48354374","48354608","7","91631"
"chr8","48446248","48446519","chr19","7078669","7078933","65","41367579"
"chr8","48533237","48533538","chr8","48442928","48443229","4","90309"
"chr8","48558099","48558398","chr8","48468162","48468461","5","89937"
"chr8","48566400","48566690","chr8","48476799","48477096","14","89601"
"chr8","48580126","48580456","chr8","48495510","48495801","42","84616"
"chr8","48603183","48603351","chr8","48518198","48518367","9","84985"
"chr8","48624626","48624932","chr8","48539990","48540289","19","84636"
"chr8","48642376","48642710","chr8","48558371","48558682","31","84005"
"chr8","48646267","48646405","chr8","48562111","48562249","2","84156"
"chr8","48683186","48683356","chr8","48600098","48600268","4","83088"
"chr8","48687212","48687521","chr5","73197726","73198038","57","24510514"
"chr8","48694277","48694315","chr6","126647358","126647394","7","77953081"
"chr8","48737592","48737882","chr8","48653310","48653599","10","84282"
"chr8","48747303","48747461","chr6","42781902","42782062","35","5965401"
"chr8","48800959","48801261","chr8","48720040","48720342","9","80919"
"chr8","48802281","48802520","chr8","48721392","48721610","31","80889"
"chr8","48804467","48804763","chr8","48723567","48723854","15","80900"
"chr8","48819515","48819819","chr2","44266982","44267288","56","4552533"
"chr8","48824805","48825122","chr8","48743613","48743927","10","81192"
"chr8","48826040","48826330","chr8","48744836","48745126","4","81204"
"chr8","48856027","48856329","chr8","48773706","48774007","16","82321"
"chr8","48873949","48874122","chr8","48794026","48794199","3","79923"
"chr8","48881601","48881893","chr8","48801633","48801925","9","79968"
"chr8","48899198","48899339","chr8","101084883","101085015","40","52185685"
"chr8","48910431","48910733","chr1","13689301","13689610","60","35221130"
"chr8","49045890","49046194","chr8","48980848","48981144","16","65042"
"chr8","49084248","49084527","chr8","49019451","49019752","28","64797"
"chr8","49170786","49171068","chr8","49111249","49111531","5","59537"
"chr8","49261765","49262054","chr8","49204290","49204583","17","57475"
"chr8","49421991","49422277","chr8","49389541","49389831","10","32450"
"chr8","49438010","49438290","chr8","49405543","49405827","15","32467"
"chr8","49471076","49471358","chr8","49437898","49438180","6","33178"
"chr8","49511261","49511565","chr8","49478046","49478380","44","33215"
"chr8","49604693","49604946","chr8","49577524","49577803","32","27169"
"chr8","49636313","49636426","chr7","39858779","39858887","26","9777534"
"chr8","49669521","49669700","chr8","49642607","49642787","6","26914"
"chr8","49678653","49678822","chr8","49651694","49651861","9","26959"
"chr8","49678853","49678866","chr5","75853875","75853888","1","26175022"
"chr8","49678895","49678994","chr8","13364149","13364250","19","36314746"
"chr8","49687916","49688055","chr19","34130811","34130947","22","15557105"
"chr8","49729336","49729608","chr8","49702468","49702775","41","26868"
"chr8","49744572","49744873","chr8","49727423","49727724","9","17149"
"chr8","49812505","49812792","chr10","7769229","7769523","58","42043276"
"chr8","49895737","49896042","chr8","49881214","49881521","7","14523"
"chr8","49950744","49951044","chr8","49937906","49938205","7","12838"
"chr8","49971165","49971460","chr8","49958074","49958372","6","13091"
"chr8","49972849","49973069","chr8","49959774","49959974","23","13075"
"chr8","49985091","49985387","chr8","49972446","49972743","7","12645"
"chr8","49992386","49992555","chr1","129765548","129765713","31","79773162"
"chr8","49992583","49992700","chr13","37660379","37660493","20","12332204"
"chr8","50001877","50002179","chr8","49988548","49988835","23","13329"
"chr8","50005476","50005768","chr8","49993663","49993959","17","11813"
"chr8","50008912","50009204","chr8","49997114","49997404","20","11798"
"chr8","50012774","50013087","chr8","50000982","50001297","11","11792"
"chr8","50028837","50028913","chr8","50017004","50017080","3","11833"
"chr8","50029225","50029403","chr8","50017391","50017569","9","11834"
"chr8","50047634","50047751","chr8","50036080","50036197","3","11554"
"chr8","50063888","50064191","chr8","50051310","50051613","9","12578"
"chr8","50072276","50072408","chr9","34281861","34281999","26","15790415"
"chr8","50072437","50072643","chr8","50060140","50060346","7","12297"
"chr8","50072667","50072779","chr20","11000730","11000841","27","39071937"
"chr8","50072790","50073090","chr8","50060492","50060792","6","12298"
"chr8","50074755","50075048","chr8","50064410","50064703","9","10345"
"chr8","50075936","50076015","chrX","60068044","60068118","23","9992108"
"chr8","50099253","50099368","chr8","50088794","50088908","4","10459"
"chr8","50112742","50112943","chr8","96074546","96074762","73","45961804"
"chr8","50113621","50113915","chr8","50105241","50105530","15","8380"
"chr8","50119254","50119389","chr10","81587137","81587272","26","31467883"
"chr8","50133026","50133229","chr8","50126854","50127053","9","6172"
"chr8","50152647","50152905","chr8","50146609","50146867","7","6038"
"chr8","50157422","50157699","chr8","50151263","50151539","7","6159"
"chr8","50160423","50160611","chr8","50154254","50154442","3","6169"
"chr8","50160978","50161091","chr8","50154809","50154919","4","6169"
"chr8","50180705","50180993","chr8","50174579","50174869","14","6126"
"chr8","50182433","50182750","chr8","50176311","50176601","37","6122"
"chr8","50184730","50184985","chr8","50178587","50178841","6","6143"
"chr8","50196020","50196355","chr8","11011106","11011424","81","39184914"
"chr8","50229946","50230244","chr8","50225014","50225311","10","4932"
"chr8","50231086","50231393","chr8","50226148","50226455","7","4938"
"chr8","50233782","50234031","chr8","50229946","50230190","13","3836"
"chr8","50251070","50251300","chr8","50245685","50245905","15","5385"
"chr8","50259197","50259496","chr8","50254127","50254426","11","5070"
"chr8","50265068","50265347","chr8","50260030","50260309","3","5038"
"chr8","50273421","50273715","chr8","50268347","50268641","4","5074"
"chr8","50287746","50287868","chr8","50282984","50283106","3","4762"
"chr8","50318993","50319319","chr8","50307873","50308198","15","11120"
"chr8","50324135","50324312","chr4","145587958","145588132","33","95263823"
"chr8","50333316","50333613","chr8","50318458","50318755","9","14858"
"chr8","50336680","50336939","chr8","50321835","50322094","3","14845"
"chr8","50353444","50353726","chr8","50337558","50337840","9","15886"
"chr8","50375444","50375732","chr8","50360504","50360793","7","14940"
"chr8","50400763","50401020","chr8","50386255","50386540","36","14508"
"chr8","50413926","50414217","chr8","50400536","50400832","19","13390"
"chr8","50416890","50417200","chr8","50403783","50404088","24","13107"
"chr8","50440343","50440584","chr8","50428527","50428753","25","11816"
"chr8","50491270","50491599","chr8","50480340","50480669","13","10930"
"chr8","50497361","50497544","chr8","50487326","50487513","9","10035"
"chr8","50535233","50535393","chr8","50525232","50525405","25","10001"
"chr8","50560087","50560372","chr8","50550022","50550340","41","10065"
"chr8","50606215","50606521","chr8","50592909","50593215","4","13306"
"chr8","50664707","50664973","chr8","50651033","50651305","14","13674"
"chr8","50713587","50713879","chr8","50699658","50699950","9","13929"
"chr8","50717970","50718101","chr8","50706442","50706573","4","11528"
"chr8","50718197","50718383","chr8","50706657","50706839","12","11540"
"chr8","50731694","50732004","chr8","50720438","50720758","15","11256"
"chr8","50813079","50813291","chr8","50800838","50801050","1","12241"
"chr8","50904772","50905085","chr13","10652277","10652585","52","40252495"
"chr8","51063641","51063920","chr8","51055794","51056073","8","7847"
"chr8","51075501","51075784","chr8","51067657","51067940","7","7844"
"chr8","51115921","51116224","chr8","51108636","51108939","7","7285"
"chr8","51197513","51197605","chr10","31887697","31887792","16","19309816"
"chr8","51317204","51317481","chr8","51308254","51308556","34","8950"
"chr8","51365718","51366019","chr8","51356919","51357220","8","8799"
"chr8","51385276","51385575","chr8","51376076","51376380","11","9200"
"chr8","51494137","51494424","chr8","51485068","51485355","14","9069"
"chr8","51499561","51499862","chr8","51490453","51490750","11","9108"
"chr8","51528457","51528595","chr8","51519234","51519370","6","9223"
"chr8","51528915","51529058","chr8","51519688","51519831","8","9227"
"chr8","51545395","51545671","chr8","51535786","51536061","7","9609"
"chr8","51752050","51752360","chr8","51740919","51741226","8","11131"
"chr8","51761278","51761321","chrX","18540009","18540054","10","33221269"
"chr8","51775182","51775460","chr8","51764468","51764773","34","10714"
"chr8","51779011","51779305","chr8","51768313","51768608","14","10698"
"chr8","51790401","51790545","chr8","51779738","51779884","4","10663"
"chr8","51790717","51791018","chr8","51780056","51780357","7","10661"
"chr8","51802919","51803071","chr19","14673246","14673394","36","37129673"
"chr8","51814117","51814244","chr8","51803815","51803942","5","10302"
"chr8","51814549","51814718","chr8","51804249","51804420","6","10300"
"chr8","51817296","51817588","chr16","49553965","49554260","62","2263331"
"chr8","51823034","51823351","chr8","51812311","51812627","6","10723"
"chr8","51824074","51824339","chr8","51813351","51813614","7","10723"
"chr8","51849316","51849572","chr4","17078666","17078918","52","34770650"
"chr8","51862064","51862354","chr8","51853986","51854268","20","8078"
"chr8","51868019","51868330","chr8","51859683","51859997","15","8336"
"chr8","51877868","51878013","chr8","51870981","51871126","2","6887"
"chr8","51886945","51887242","chr8","51880554","51880839","19","6391"
"chr8","51897383","51897662","chr8","51891050","51891368","45","6333"
"chr8","51899514","51899779","chr8","51893202","51893494","31","6312"
"chr8","51906144","51906362","chr8","51899858","51900078","10","6286"
"chr8","51907205","51907492","chr8","51900857","51901166","26","6348"
"chr8","51910383","51910699","chr8","51904081","51904383","28","6302"
"chr8","51912320","51912451","chr8","51905892","51906023","2","6428"
"chr8","51929286","51929343","chr8","51923982","51924039","1","5304"
"chr8","51929344","51929594","chr8","51924040","51924291","8","5304"
"chr8","51930825","51931127","chr8","51925517","51925816","11","5308"
"chr8","51934818","51934992","chr8","51929494","51929668","4","5324"
"chr8","51935291","51935438","chr8","51929968","51930115","3","5323"
"chr8","51935965","51936085","chr6","32938721","32938840","17","18997244"
"chr8","51936588","51936785","chr1","28689260","28689443","46","23247328"
"chr8","51938106","51938391","chr8","51932779","51933064","6","5327"
"chr8","51944205","51944487","chr8","51939227","51939509","3","4978"
"chr8","51971254","51971333","chr1","109584082","109584169","23","57612828"
"chr8","52012142","52012424","chr2","148920479","148920767","52","96908337"
"chr8","52030329","52030643","chr8","52025601","52025901","18","4728"
"chr8","52069223","52069526","chr8","52065072","52065378","13","4151"
"chr8","52078848","52079157","chr8","52074709","52075029","18","4139"
"chr8","52095362","52095634","chr4","125712839","125713116","68","73617477"
"chr8","52107481","52107751","chr11","28443478","28443763","72","23664003"
"chr8","52138381","52138683","chr4","152226280","152226592","48","100087899"
"chr8","52154123","52154402","chr8","52152155","52152449","20","1968"
"chr8","52162017","52162318","chr8","52160063","52160353","14","1954"
"chr8","52163811","52164117","chr8","52162254","52162559","10","1557"
"chr8","52173460","52173729","chr8","52174619","52174928","48","1159"
"chr8","52208762","52209066","chr8","52207669","52207973","3","1093"
"chr8","52411155","52411437","chr8","52403541","52403822","10","7614"
"chr8","52456613","52456781","chr8","52449691","52449864","11","6922"
"chr8","52495334","52495474","chr8","52493967","52494111","4","1367"
"chr8","52521596","52521910","chr8","52522335","52522654","13","739"
"chr8","52873346","52873614","chr8","52877200","52877469","8","3854"
"chr8","52908155","52908391","chr8","52911952","52912188","5","3797"
"chr8","53003210","53003496","chr8","53007865","53008152","7","4655"
"chr8","53160998","53161073","chr18","38839209","38839283","14","14321789"
"chr8","53230492","53230664","chr5","126585792","126585955","38","73355300"
"chr8","53259583","53259888","chr8","53282173","53282461","20","22590"
"chr8","53319723","53320010","chr8","53347808","53348091","15","28085"
"chr8","53357376","53357598","chr8","53378015","53378238","5","20639"
"chr8","53358765","53359057","chr8","53379405","53379702","21","20640"
"chr8","53379328","53379633","chr8","53400394","53400691","20","21066"
"chr8","53386809","53387094","chr8","53407902","53408187","5","21093"
"chr8","53388850","53389150","chr2","149220987","149221284","68","95832137"
"chr8","53410757","53410926","chrX","121706745","121706913","66","68295988"
"chr8","53787719","53787858","chr1","12337297","12337429","25","41450422"
"chr8","53894960","53895269","chr7","128069361","128069670","58","74174401"
"chr8","53924487","53924780","chr8","53961553","53961854","18","37066"
"chr8","53957603","53957896","chr8","53994975","53995267","11","37372"
"chr8","54101008","54101142","chr8","54139210","54139342","4","38202"
"chr8","54120701","54120971","chr8","54158728","54159000","9","38027"
"chr8","54176935","54177120","chr8","54215090","54215274","15","38155"
"chr8","54229795","54230055","chr8","54268958","54269230","23","39163"
"chr8","54263488","54263785","chr8","54304122","54304435","23","40634"
"chr8","54291074","54291304","chr8","54331504","54331727","12","40430"
"chr8","54363821","54363933","chr8","54406194","54406306","3","42373"
"chr8","54370166","54370434","chr8","54412542","54412796","20","42376"
"chr8","54394569","54394708","chr8","54437995","54438137","5","43426"
"chr8","54413321","54413582","chr8","54457248","54457528","32","43927"
"chr8","54413583","54413645","chr14","112743107","112743165","15","58329524"
"chr8","54463782","54464059","chr8","54503586","54503865","10","39804"
"chr8","54478412","54478722","chr8","54518163","54518474","6","39751"
"chr8","54540972","54541254","chr8","54591606","54591897","30","50634"
"chr8","54587461","54587759","chr8","54638897","54639195","11","51436"
"chr8","54593974","54594259","chr8","54646325","54646610","7","52351"
"chr8","54664381","54664685","chr8","54718372","54718674","8","53991"
"chr8","54667019","54667246","chr1","137920216","137920442","47","83253197"
"chr8","54668216","54668511","chr11","8822956","8823241","68","45845260"
"chr8","54707903","54708195","chr8","54763371","54763659","13","55468"
"chr8","54775433","54775744","chr8","54832103","54832405","16","56670"
"chr8","54782445","54782766","chr8","54839087","54839409","16","56642"
"chr8","54987044","54987255","chr8","55044320","55044532","7","57276"
"chr8","55052933","55053238","chr8","55112004","55112309","10","59071"
"chr8","55099778","55100092","chr20","39705042","39705349","72","15394736"
"chr8","55158606","55158909","chr8","55216063","55216359","18","57457"
"chr8","55283038","55283118","chr8","132999920","133000000","18","77716882"
"chr8","55307966","55308241","chr14","113839339","113839619","48","58531373"
"chr8","55314688","55314987","chr8","55374699","55374993","16","60011"
"chr8","55321446","55321745","chr8","55381466","55381765","7","60020"
"chr8","55348514","55348809","chr8","55408321","55408586","39","59807"
"chr8","55505765","55506025","chr8","55550555","55550851","46","44790"
"chr8","55520884","55521174","chr8","55565920","55566230","26","45036"
"chr8","55606498","55606775","chr8","55651652","55651929","5","45154"
"chr8","55898329","55898607","chr8","55942053","55942327","15","43724"
"chr8","55940019","55940183","chr8","55986221","55986385","1","46202"
"chr8","56130601","56130811","chr8","56177500","56177710","3","46899"
"chr8","56258587","56258894","chr8","56307213","56307519","13","48626"
"chr8","56311140","56311450","chr8","56359608","56359915","19","48468"
"chr8","56316108","56316422","chr8","56364589","56364883","34","48481"
"chr8","56323269","56323575","chr8","56371713","56372021","14","48444"
"chr8","56333240","56333490","chr8","56381389","56381677","42","48149"
"chr8","56346255","56346571","chr8","56394072","56394391","11","47817"
"chr8","56370412","56370738","chr13","22262744","22263068","72","34107668"
"chr8","56391368","56391539","chr8","56444060","56444232","7","52692"
"chr8","56392194","56392495","chr8","56444873","56445172","10","52679"
"chr8","56394105","56394262","chr7","123462367","123462524","30","67068262"
"chr8","56394484","56394617","chr1","38009038","38009171","19","18385446"
"chr8","56397366","56397665","chr8","56449782","56450077","15","52416"
"chr8","56398924","56399194","chr8","56451319","56451588","9","52395"
"chr8","56401938","56402054","chr9","88436818","88436931","27","32034880"
"chr8","56403815","56404007","chr13","54640464","54640655","43","1763351"
"chr8","56423975","56424249","chr8","56476373","56476653","12","52398"
"chr8","56435807","56435938","chr8","56488711","56488842","3","52904"
"chr8","56450877","56450994","chr5","4050628","4050743","13","52400249"
"chr8","56452102","56452265","chr8","56504747","56504903","9","52645"
"chr8","56452559","56452702","chr8","56505200","56505343","2","52641"
"chr8","56467447","56467567","chr8","56519803","56519935","13","52356"
"chr8","56470306","56470611","chr8","56522680","56522987","7","52374"
"chr8","56502740","56502878","chr4","119142322","119142454","26","62639582"
"chr8","56508966","56509228","chr8","56559958","56560226","8","50992"
"chr8","56546624","56546828","chr8","56599185","56599389","6","52561"
"chr8","56550374","56550678","chr8","56602922","56603223","11","52548"
"chr8","56567579","56567863","chr8","56620578","56620862","4","52999"
"chr8","56579660","56579943","chr8","56632940","56633222","10","53280"
"chr8","56580628","56580938","chr8","56633907","56634216","4","53279"
"chr8","56584800","56585092","chr3","138963569","138963848","52","82378769"
"chr8","56615227","56615486","chr8","56667878","56668147","15","52651"
"chr8","56643484","56643794","chr8","56696579","56696896","18","53095"
"chr8","56675018","56675290","chr11","51283011","51283289","55","5392007"
"chr8","56703985","56704309","chr11","24444787","24445092","88","32259198"
"chr8","56722638","56722958","chr8","56776973","56777293","7","54335"
"chr8","56747608","56747903","chr8","56802563","56802862","12","54955"
"chr8","56774388","56774660","chr8","56829352","56829624","5","54964"
"chr8","56779542","56779835","chr8","56834546","56834834","12","55004"
"chr8","56812985","56813295","chr8","56866262","56866566","19","53277"
"chr8","56839641","56839930","chr8","56893233","56893524","9","53592"
"chr8","56843505","56843622","chr8","56897121","56897244","9","53616"
"chr8","56846553","56846849","chr8","56900176","56900454","21","53623"
"chr8","56878648","56878912","chr15","10312358","10312633","68","46566290"
"chr8","56879291","56879595","chr8","56933233","56933542","24","53942"
"chr8","56881697","56882009","chr8","56935645","56935957","7","53948"
"chr8","56886888","56887067","chr8","56941307","56941482","14","54419"
"chr8","56898060","56898222","chr14","4160553","4160723","38","52737507"
"chr8","56899168","56899459","chr8","56953655","56953947","4","54487"
"chr8","56910720","56911012","chr8","56965207","56965505","14","54487"
"chr8","56917928","56918194","chr10","80978550","80978820","59","24060622"
"chr8","56948395","56948529","chr5","140362320","140362459","24","83413925"
"chr8","56972882","56973179","chr8","57027352","57027649","5","54470"
"chr8","56977146","56977447","chr16","59760836","59761134","64","2783690"
"chr8","56980322","56980605","chr8","57034783","57035066","2","54461"
"chr8","56988890","56989262","chr8","57043341","57043621","95","54451"
"chr8","57053134","57053387","chr8","57105988","57106234","15","52854"
"chr8","57080972","57081280","chr8","57133626","57133940","14","52654"
"chr8","57130743","57131032","chr8","57184116","57184405","6","53373"
"chr8","57133805","57134092","chr8","57187177","57187491","39","53372"
"chr8","57157297","57157562","chr13","2454265","2454527","75","54703032"
"chr8","57284401","57284702","chr8","57339636","57339937","6","55235"
"chr8","57319442","57319719","chr8","57375304","57375586","9","55862"
"chr8","57384919","57385215","chr8","57441574","57441870","8","56655"
"chr8","57417604","57417724","chr14","47889034","47889156","19","9528570"
"chr8","57431405","57431675","chr6","159084355","159084620","61","101652950"
"chr8","57591230","57591508","chr8","57648248","57648535","15","57018"
"chr8","57641327","57641608","chr8","57698592","57698850","30","57265"
"chr8","57653840","57654145","chr8","57711351","57711652","12","57511"
"chr8","57691880","57692210","chr8","57751238","57751567","9","59358"
"chr8","57697753","57697853","chr8","57757424","57757524","3","59671"
"chr8","57907886","57907987","chr8","57966087","57966180","10","58201"
"chr8","57908025","57908172","chr8","57966220","57966371","5","58195"
"chr8","57942238","57942536","chr8","57998300","57998593","14","56062"
"chr8","58041908","58042219","chr8","58108064","58108373","14","66156"
"chr8","58203779","58204086","chr8","58267021","58267313","23","63242"
"chr8","58217833","58218107","chr8","58281032","58281301","8","63199"
"chr8","58240201","58240531","chr8","58304509","58304811","31","64308"
"chr8","58353791","58354056","chr8","58418376","58418643","5","64585"
"chr8","58400133","58400437","chr8","58464402","58464702","8","64269"
"chr8","58425047","58425353","chr8","58489154","58489462","7","64107"
"chr8","58431084","58431378","chr8","58494766","58495058","7","63682"
"chr8","58562858","58563148","chr2","71578113","71578407","66","13015255"
"chr8","58666325","58666624","chr8","58739905","58740203","9","73580"
"chr8","58672381","58672728","chr10","75779135","75779454","84","17106754"
"chr8","58813229","58813552","chr8","58875597","58875902","23","62368"
"chr8","58824092","58824387","chr8","58887087","58887384","8","62995"
"chr8","58841717","58842034","chr8","58904840","58905144","19","63123"
"chr8","58861442","58861732","chr8","58924310","58924600","12","62868"
"chr8","58900138","58900415","chr8","58962988","58963265","7","62850"
"chr8","58925938","58926225","chr8","58988864","58989130","26","62926"
"chr8","58953735","58954012","chr8","59016673","59016953","10","62938"
"chr8","58976239","58976545","chr4","152226280","152226592","58","93250041"
"chr8","58994901","58995025","chr8","59057827","59057951","4","62926"
"chr8","58995474","58995603","chr8","59058399","59058528","3","62925"
"chr8","59013883","59014190","chr8","59077163","59077480","19","63280"
"chr8","59019414","59019696","chr8","59082722","59083004","13","63308"
"chr8","59020217","59020529","chr8","59083545","59083857","3","63328"
"chr8","59020705","59021006","chr8","59084029","59084330","5","63324"
"chr8","59021590","59021882","chr8","59084912","59085204","8","63322"
"chr8","59032985","59033289","chr8","59096600","59096904","7","63615"
"chr8","59035962","59036249","chr8","59099770","59100064","12","63808"
"chr8","59060755","59061024","chr8","59124943","59125212","7","64188"
"chr8","59064259","59064530","chr8","59128440","59128722","23","64181"
"chr8","59071494","59071609","chr8","59136641","59136750","13","65147"
"chr8","59071658","59071938","chr8","59136781","59137036","31","65123"
"chr8","59071939","59072120","chr8","59137062","59137241","6","65123"
"chr8","59147476","59147748","chr8","59212899","59213178","18","65423"
"chr8","59149903","59150021","chr8","59215335","59215453","2","65432"
"chr8","59158507","59158791","chr8","59224215","59224499","3","65708"
"chr8","59229851","59230135","chr8","59297012","59297296","2","67161"
"chr8","59402752","59403069","chr14","99480715","99481017","59","40077963"
"chr8","59512662","59512981","chr8","59579678","59579988","15","67016"
"chr8","59803963","59804270","chr8","59869101","59869404","20","65138"
"chr8","59878631","59878900","chr8","59943358","59943630","9","64727"
"chr8","59880862","59880992","chr8","59945566","59945696","3","64704"
"chr8","59881614","59881886","chr5","21082678","21082954","63","38798936"
"chr8","59886790","59886992","chr8","59951570","59951772","6","64780"
"chr8","59964386","59964693","chr8","60029337","60029643","7","64951"
"chr8","60044745","60044993","chr8","60108704","60108954","7","63959"
"chr8","60116267","60116565","chr8","60180128","60180402","30","63861"
"chr8","60346499","60346803","chr15","92728954","92729252","52","32382455"
"chr8","60406817","60407030","chr8","60471798","60472003","12","64981"
"chr8","60450685","60450972","chr3","51259643","51259924","66","9191042"
"chr8","60584944","60585254","chr8","60651374","60651680","10","66430"
"chr8","60609325","60609618","chr8","60675721","60676014","8","66396"
"chr8","60620661","60620948","chr8","60687057","60687344","6","66396"
"chr8","60769024","60769320","chr8","60841047","60841343","6","72023"
"chr8","61062901","61062998","chr8","61137598","61137692","4","74697"
"chr8","61072519","61072695","chr8","61147177","61147353","6","74658"
"chr8","61075532","61075836","chr8","61150189","61150492","6","74657"
"chr8","61083166","61083449","chr8","61157809","61158090","15","74643"
"chr8","61208762","61209059","chr8","61283188","61283488","7","74426"
"chr8","61238852","61239150","chr8","61314329","61314627","8","75477"
"chr8","61286472","61286774","chr8","61361100","61361399","16","74628"
"chr8","61295318","61295615","chr8","61369925","61370225","12","74607"
"chr8","61325367","61325698","chr8","61400465","61400769","32","75098"
"chr8","61348897","61349197","chr8","61423665","61423965","5","74768"
"chr8","61382685","61382960","chr8","61458504","61458783","9","75819"
"chr8","61394758","61395068","chr8","61470546","61470840","26","75788"
"chr8","61398102","61398268","chr8","61473883","61474049","4","75781"
"chr8","61398410","61398533","chr8","61474191","61474314","6","75781"
"chr8","61417474","61417784","chr8","61494759","61495072","8","77285"
"chr8","61431632","61431921","chr8","61508941","61509230","9","77309"
"chr8","61444178","61444473","chr8","61521648","61521944","6","77470"
"chr8","61444894","61445196","chr8","61522372","61522671","11","77478"
"chr8","61463411","61463691","chr1","123253251","123253544","56","61789840"
"chr8","61479062","61479179","chr3","154543697","154543812","20","93064635"
"chr8","61479206","61479218","chr9","54643528","54643539","2","6835678"
"chr8","61479506","61479667","chr19","3686267","3686435","44","57793239"
"chr8","61480318","61480620","chr8","61554700","61554982","27","74382"
"chr8","61493076","61493134","chr8","61563407","61563465","1","70331"
"chr8","61493411","61493634","chr8","61563744","61563967","1","70333"
"chr8","61501792","61501958","chr8","61571572","61571744","12","69780"
"chr8","61505557","61505721","chr8","61571572","61571744","14","66015"
"chr8","61505804","61505844","chr7","38900972","38901010","11","22604832"
"chr8","61505888","61506014","chr8","95618055","95618178","23","34112167"
"chr8","61533058","61533318","chr8","61602577","61602845","9","69519"
"chr8","61536095","61536396","chr8","61605601","61605902","6","69506"
"chr8","61557830","61558005","chr8","61627646","61627821","3","69816"
"chr8","61558314","61558369","chr8","61628122","61628177","1","69808"
"chr8","61562406","61562694","chr8","61632584","61632858","23","70178"
"chr8","61564313","61564628","chr8","61634481","61634794","15","70168"
"chr8","61567397","61567590","chr3","130680152","130680300","64","69112755"
"chr8","61567595","61567638","chr1","145010738","145010780","11","83443143"
"chr8","61570429","61570715","chr8","61640858","61641144","8","70429"
"chr8","61602210","61602257","chr4","66269962","66270003","11","4667752"
"chr8","61602262","61602357","chr1","28195903","28195995","22","33406359"
"chr8","61605731","61605843","chr8","61676052","61676168","5","70321"
"chr8","61614583","61614900","chr8","61684965","61685274","18","70382"
"chr8","61681447","61681750","chr8","61749821","61750128","25","68374"
"chr8","61703301","61703597","chr8","61771462","61771755","6","68161"
"chr8","61716544","61716765","chr8","61784349","61784588","22","67805"
"chr8","61724227","61724413","chr8","61797952","61798138","6","73725"
"chr8","61741030","61741339","chr8","61814860","61815169","8","73830"
"chr8","61751256","61751516","chr8","61825081","61825339","7","73825"
"chr8","61760252","61760532","chr8","61833748","61834066","42","73496"
"chr8","61833779","61834071","chr8","61906248","61906534","16","72469"
"chr8","61863362","61863625","chr8","61935504","61935800","39","72142"
"chr8","61866950","61867261","chr8","61938663","61938963","16","71713"
"chr8","61896239","61896522","chr8","61967590","61967869","8","71351"
"chr8","61990915","61991245","chr8","62061638","62061948","37","70723"
"chr8","62091581","62091873","chr8","62162155","62162454","17","70574"
"chr8","62216146","62216450","chr8","62293240","62293544","4","77094"
"chr8","62255024","62255331","chr8","62332733","62333040","7","77709"
"chr8","62257715","62257777","chr10","30838686","30838748","10","31419029"
"chr8","62268145","62268339","chr6","144295782","144295969","45","82027637"
"chr8","62294954","62295069","chr8","62372797","62372912","8","77843"
"chr8","62295097","62295258","chr8","62372946","62373112","20","77849"
"chr8","62324506","62324839","chr8","62398730","62399062","13","74224"
"chr8","62326087","62326395","chr8","62400318","62400625","15","74231"
"chr8","62338529","62338579","chr8","62412681","62412731","1","74152"
"chr8","62338613","62338757","chr15","38916384","38916530","19","23422229"
"chr8","62339171","62339447","chr8","62413298","62413569","10","74127"
"chr8","62349508","62349655","chr8","62423560","62423723","19","74052"
"chr8","62349836","62350131","chr8","62423905","62424199","5","74069"
"chr8","62352190","62352399","chr7","159229227","159229428","51","96877037"
"chr8","62355141","62355255","chr8","62427896","62428002","10","72755"
"chr8","62357285","62357605","chr8","62430070","62430390","9","72785"
"chr8","62365780","62366076","chr8","62438511","62438804","11","72731"
"chr8","62376316","62376436","chr2","47509577","47509704","23","14866739"
"chr8","62385544","62385747","chr8","62458569","62458790","20","73025"
"chr8","62409328","62409607","chr8","62482204","62482483","7","72876"
"chr8","62419936","62420249","chr8","62492766","62493074","16","72830"
"chr8","62421169","62421461","chr8","62493989","62494281","12","72820"
"chr8","62424628","62424923","chr8","62497166","62497466","10","72538"
"chr8","62425273","62425436","chr19","11568381","11568541","30","50856892"
"chr8","62431774","62431958","chr8","62503663","62503829","25","71889"
"chr8","62436783","62437091","chr8","62508655","62508956","14","71872"
"chr8","62448831","62448981","chr8","62520675","62520826","3","71844"
"chr8","62454065","62454341","chr8","62525800","62526077","5","71735"
"chr8","62458578","62458891","chr1","196698286","196698586","78","134239708"
"chr8","62462217","62462532","chr8","62533782","62534092","9","71565"
"chr8","62465571","62465864","chr8","62537009","62537302","3","71438"
"chr8","62467698","62468004","chr8","62539126","62539432","5","71428"
"chr8","62479449","62479725","chr8","62550976","62551252","5","71527"
"chr8","62505860","62506154","chr8","62577856","62578148","6","71996"
"chr8","62516744","62517032","chr8","62588593","62588893","18","71849"
"chr8","62517491","62517772","chr8","62589345","62589626","7","71854"
"chr8","62524190","62524491","chr8","62596043","62596344","7","71853"
"chr8","62526401","62526602","chr8","62598246","62598447","4","71845"
"chr8","62527792","62528068","chr8","62599630","62599906","7","71838"
"chr8","62530647","62530950","chr8","62602489","62602792","9","71842"
"chr8","62573061","62573410","chr8","62645113","62645467","17","72052"
"chr8","62583986","62584278","chr8","62657353","62657645","8","73367"
"chr8","62595946","62596238","chr8","62669702","62669967","34","73756"
"chr8","62596984","62597115","chr8","62670710","62670841","3","73726"
"chr8","62597440","62597641","chr8","62671147","62671372","27","73707"
"chr8","62600101","62600371","chr8","62673835","62674107","13","73734"
"chr8","62617995","62618137","chr13","53517750","53517886","22","9100245"
"chr8","62625243","62625426","chr8","62699338","62699511","14","74095"
"chr8","62627085","62627386","chr8","62701172","62701467","14","74087"
"chr8","62634640","62634917","chr8","62708865","62709142","5","74225"
"chr8","62635247","62635460","chr8","62709470","62709679","9","74223"
"chr8","62644426","62644592","chr8","62718639","62718815","14","74213"
"chr8","62655819","62655829","chr19","11568062","11568072","1","51087757"
"chr8","62655868","62656159","chr8","62730095","62730404","26","74227"
"chr8","62672178","62672356","chr8","62749026","62749205","6","76848"
"chr8","62673766","62674037","chr11","122124868","122125153","65","59451102"
"chr8","62675191","62675380","chr8","62752007","62752196","3","76816"
"chr8","62689289","62689598","chr8","62765526","62765834","10","76237"
"chr8","62692124","62692438","chr8","62768351","62768664","6","76227"
"chr8","62705762","62706011","chr8","62782353","62782602","6","76591"
"chr8","62707583","62707664","chr8","137894325","137894409","12","75186742"
"chr8","62713554","62713855","chr8","68808553","68808854","41","6094999"
"chr8","62716627","62716930","chr11","127321019","127321317","59","64604392"
"chr8","62720664","62720970","chr8","62796904","62797200","21","76240"
"chr8","62728589","62728875","chr8","62805356","62805642","1","76767"
"chr8","62736379","62736688","chr8","62813153","62813467","11","76774"
"chr8","62743337","62743607","chr8","62819934","62820204","6","76597"
"chr8","62749259","62749554","chr8","62826146","62826446","9","76887"
"chr8","62761291","62761556","chr8","62837998","62838259","12","76707"
"chr8","62773551","62773932","chr8","62850872","62851243","19","77321"
"chr8","62788499","62788801","chr8","62865769","62866073","20","77270"
"chr8","62791666","62791937","chr8","62872709","62872983","5","81043"
"chr8","62791980","62792064","chr8","62873048","62873132","2","81068"
"chr8","62802392","62802698","chr8","62883470","62883780","14","81078"
"chr8","62804630","62804732","chr8","62887775","62887872","9","83145"
"chr8","62807536","62807628","chr18","53780293","53780384","21","9027243"
"chr8","62814121","62814382","chr14","82185384","82185642","45","19371263"
"chr8","62819139","62819477","chr8","62901617","62901958","13","82478"
"chr8","62825384","62825482","chr8","62908302","62908400","1","82918"
"chr8","62825783","62825901","chr3","149311516","149311626","33","86485733"
"chr8","62832114","62832411","chr8","62915362","62915663","10","83248"
"chr8","62841609","62841905","chr8","62926919","62927215","3","85310"
"chr8","62857491","62857774","chr8","62942278","62942558","14","84787"
"chr8","62858718","62859005","chr8","62943498","62943783","11","84780"
"chr8","62860853","62861027","chr8","62945608","62945782","0","84755"
"chr8","62861313","62861454","chr8","62946069","62946210","2","84756"
"chr8","62862276","62862563","chr8","62947377","62947664","4","85101"
"chr8","62863070","62863158","chr8","62948171","62948259","0","85101"
"chr8","62863639","62863787","chr8","62948738","62948886","1","85099"
"chr8","62887075","62887223","chr8","62972566","62972713","5","85491"
"chr8","62887522","62887574","chr8","62973018","62973070","0","85496"
"chr8","62889345","62889641","chr8","62974756","62975052","0","85411"
"chr8","62896911","62897209","chr8","62982620","62982910","13","85709"
"chr8","62903818","62903949","chr19","35937081","35937215","16","26966737"
"chr8","62904208","62904493","chr8","62990052","62990334","10","85844"
"chr8","62906908","62907200","chr8","62992740","62993034","7","85832"
"chr8","62910842","62911158","chr8","62996634","62996950","7","85792"
"chr8","62941902","62942218","chr8","63027293","63027590","24","85391"
"chr8","62948124","62948286","chr8","63033521","63033687","8","85397"
"chr8","62964169","62964331","chr8","63049295","63049453","7","85126"
"chr8","62971710","62972008","chr8","63056775","63057076","10","85065"
"chr8","63006854","63007172","chr8","63092179","63092511","20","85325"
"chr8","63010350","63010650","chr8","63095707","63096007","6","85357"
"chr8","63042851","63043149","chr8","63128012","63128317","13","85161"
"chr8","63071036","63071304","chr8","63156413","63156672","11","85377"
"chr8","63083641","63083915","chr8","63169638","63169912","7","85997"
"chr8","63105533","63105814","chr15","37516439","37516725","53","25589094"
"chr8","63119021","63119327","chr8","63206372","63206673","15","87351"
"chr8","63151511","63151807","chr8","63238594","63238885","11","87083"
"chr8","63159683","63159835","chr8","63246781","63246934","14","87098"
"chr8","63161880","63162200","chr8","63248968","63249293","16","87088"
"chr8","63164133","63164414","chr8","63251224","63251505","8","87091"
"chr8","63196282","63196573","chr8","63280857","63281156","15","84575"
"chr8","63220540","63220835","chr8","63309243","63309539","7","88703"
"chr8","63238207","63238459","chr8","63327855","63328105","4","89648"
"chr8","63239098","63239373","chr8","63328729","63328998","7","89631"
"chr8","63245665","63245942","chr8","63335035","63335312","11","89370"
"chr8","63268715","63268814","chr1","166392872","166392973","23","103124157"
"chr8","63270534","63270711","chr8","63361944","63362121","6","91410"
"chr8","63280007","63280319","chr8","63371717","63372038","18","91710"
"chr8","63291565","63291849","chr8","63382126","63382410","1","90561"
"chr8","63305085","63305361","chr8","63395611","63395887","10","90526"
"chr8","63327594","63327902","chr8","63418442","63418753","8","90848"
"chr8","63328778","63329073","chr13","115090995","115091287","56","51762217"
"chr8","63360122","63360427","chr8","63451555","63451860","2","91433"
"chr8","63402934","63403236","chr8","63494192","63494491","10","91258"
"chr8","63472425","63472763","chr8","63563051","63563390","16","90626"
"chr8","63482278","63482562","chr8","63572793","63573080","10","90515"
"chr8","63504489","63504794","chr8","63595114","63595421","5","90625"
"chr8","63524332","63524630","chr2","136787021","136787319","55","73262689"
"chr8","63527680","63527833","chr11","12585160","12585317","32","50942520"
"chr8","63528297","63528422","chr1","93642332","93642456","20","30114035"
"chr8","63532044","63532258","chr8","63624441","63624655","6","92397"
"chr8","63543169","63543487","chr8","63635565","63635869","18","92396"
"chr8","63566739","63566869","chr1","196381119","196381250","28","132814380"
"chr8","63576859","63577176","chr8","63669566","63669885","8","92707"
"chr8","63604293","63604594","chr8","63699130","63699397","43","94837"
"chr8","63620954","63621252","chr8","63715745","63716044","6","94791"
"chr8","63629807","63630036","chr8","63724618","63724847","1","94811"
"chr8","63637294","63637584","chr8","63732101","63732397","10","94807"
"chr8","63649688","63649824","chr4","65813127","65813256","26","2163439"
"chr8","63653188","63653488","chr8","63748046","63748346","11","94858"
"chr8","63659739","63660019","chr8","63754494","63754817","53","94755"
"chr8","63679237","63679487","chr8","63773769","63774018","7","94532"
"chr8","63679527","63679645","chr7","38242393","38242509","25","25437134"
"chr8","63691360","63691663","chr8","63785686","63785984","8","94326"
"chr8","63727367","63727669","chr8","63821611","63821915","5","94244"
"chr8","63733781","63734084","chr8","63828005","63828308","7","94224"
"chr8","63762055","63762352","chr14","7121772","7122064","60","56640283"
"chr8","63796945","63797037","chr8","63890106","63890198","1","93161"
"chr8","63970478","63970556","chr1","93795970","93796048","9","29825492"
"chr8","63991062","63991321","chr8","64083411","64083671","8","92349"
"chr8","64043202","64043497","chr8","64135917","64136212","7","92715"
"chr8","64122854","64123140","chr8","64216103","64216403","25","93249"
"chr8","64141996","64142341","chr8","64235860","64236216","21","93864"
"chr8","64147111","64147409","chr8","64241002","64241301","12","93891"
"chr8","64192585","64192880","chr8","64286370","64286658","17","93785"
"chr8","64193794","64194079","chr8","64287571","64287856","17","93777"
"chr8","64195365","64195684","chr8","64289147","64289466","7","93782"
"chr8","64267236","64267543","chr1","110109221","110109515","23","45841985"
"chr8","64268036","64268325","chr4","155208816","155209103","54","90940780"
"chr8","64340311","64340621","chr8","64430702","64431002","20","90391"
"chr8","64350097","64350385","chr8","64440444","64440732","19","90347"
"chr8","64375377","64375657","chr8","64465512","64465807","22","90135"
"chr8","64426980","64427266","chr16","21320831","21321123","60","43106149"
"chr8","64427642","64427948","chr8","64517740","64518020","34","90098"
"chr8","64433325","64433509","chr8","64522702","64522890","6","89377"
"chr8","64439370","64439604","chr16","48598989","48599215","55","15840381"
"chr8","64439893","64440020","chr7","108133492","108133611","30","43693599"
"chr8","64487085","64487379","chr8","64572669","64572963","7","85584"
"chr8","64488374","64488536","chr8","64573960","64574132","14","85586"
"chr8","64498773","64499083","chr8","64585691","64586006","15","86918"
"chr8","64510006","64510166","chr8","64597003","64597162","6","86997"
"chr8","64589763","64589863","chr8","64680760","64680860","2","90997"
"chr8","64593915","64594056","chr11","95527470","95527604","30","30933555"
"chr8","64603399","64603633","chr8","64694456","64694672","29","91057"
"chr8","64607484","64607597","chr8","64697278","64697386","6","89794"
"chr8","64611693","64611838","chr1","34291842","34291992","32","30319851"
"chr8","64611865","64611992","chr2","17944016","17944136","26","46667849"
"chr8","64613819","64614091","chr8","64704202","64704486","17","90383"
"chr8","64683182","64683503","chr8","64773386","64773707","8","90204"
"chr8","64746897","64747195","chr8","64837172","64837476","24","90275"
"chr8","64754507","64754773","chr8","64844793","64845062","13","90286"
"chr8","64760018","64760351","chr8","64850188","64850498","34","90170"
"chr8","64762041","64762342","chr8","64852185","64852478","17","90144"
"chr8","64802436","64802732","chr8","64892027","64892278","50","89591"
"chr8","64804399","64804684","chr1","5100267","5100553","75","59704132"
"chr8","64915322","64915636","chr8","65007395","65007724","21","92073"
"chr8","65097019","65097307","chr7","144153535","144153826","54","79056516"
"chr8","65133460","65133749","chr8","65258422","65258719","16","124962"
"chr8","65152043","65152337","chr8","65277614","65277916","13","125571"
"chr8","65189984","65190286","chr8","65315526","65315835","12","125542"
"chr8","65211236","65211380","chr8","65337625","65337769","4","126389"
"chr8","65211766","65211858","chr8","65338155","65338253","9","126389"
"chr8","65219150","65219458","chr8","65345529","65345827","22","126379"
"chr8","65229433","65229754","chr8","65355754","65356126","56","126321"
"chr8","65231476","65231604","chr6","125381720","125381850","29","60150244"
"chr8","65231739","65231890","chr16","59304817","59304973","44","5926922"
"chr8","65266650","65266961","chr8","65393326","65393633","11","126676"
"chr8","65272387","65272680","chr8","65399043","65399326","22","126656"
"chr8","65384242","65384533","chr8","65510359","65510658","15","126117"
"chr8","65385942","65386237","chr8","65512060","65512355","5","126118"
"chr8","65393709","65393844","chr3","158234444","158234568","32","92840735"
"chr8","65393894","65394025","chr15","24520797","24520929","20","40873097"
"chr8","65406053","65406154","chr8","65532299","65532400","3","126246"
"chr8","65407314","65407608","chr8","65533566","65533862","10","126252"
"chr8","65409067","65409330","chr8","65535320","65535585","6","126253"
"chr8","65410176","65410461","chr8","65536734","65537022","7","126558"
"chr8","65474507","65474820","chr8","65601326","65601639","8","126819"
"chr8","65475761","65475887","chr8","65602573","65602703","12","126812"
"chr8","65488534","65488841","chr8","65615804","65616095","22","127270"
"chr8","65494984","65495295","chr8","65622237","65622542","19","127253"
"chr8","65523407","65523712","chr8","65651633","65651938","9","128226"
"chr8","65529571","65529879","chr8","65657794","65658098","21","128223"
"chr8","65539117","65539384","chr8","65667018","65667284","12","127901"
"chr8","65568109","65568396","chr8","65695746","65696033","8","127637"
"chr8","65570815","65570913","chr7","129979248","129979346","17","64408433"
"chr8","65595639","65595826","chr20","31014904","31015091","43","34580735"
"chr8","65604460","65604723","chr8","65732126","65732389","4","127666"
"chr8","65631314","65631412","chr12","63991766","63991859","14","1639548"
"chr8","65638306","65638633","chr8","65769245","65769565","20","130939"
"chr8","65658725","65659037","chr8","65799677","65799989","7","140952"
"chr8","65659364","65659678","chr13","41851851","41852159","71","23807513"
"chr8","65666499","65666720","chr12","33755162","33755386","44","31911337"
"chr8","65668311","65668374","chr8","65814087","65814150","0","145776"
"chr8","65668676","65668838","chr8","65814452","65814623","20","145776"
"chr8","65669143","65669447","chr8","65814920","65815223","12","145777"
"chr8","65671672","65671928","chr8","65803763","65804018","7","132091"
"chr8","65687555","65687854","chr8","65829401","65829697","18","141846"
"chr8","65694649","65694942","chr8","65837383","65837677","12","142734"
"chr8","65698452","65698781","chr8","65841658","65841967","30","143206"
"chr8","65708190","65708277","chr10","14171537","14171622","27","51536653"
"chr8","65709952","65710259","chr8","65855357","65855664","14","145405"
"chr8","65728946","65729244","chr8","65877705","65878021","27","148759"
"chr8","65740572","65740878","chr4","125870759","125871067","53","60130187"
"chr8","65743800","65743861","chr15","41846727","41846787","13","23897073"
"chr8","65747399","65747699","chr8","65894622","65894920","11","147223"
"chr8","65753407","65753711","chr8","65902099","65902392","18","148692"
"chr8","65757347","65757475","chr8","65906625","65906753","2","149278"
"chr8","65757520","65757692","chr19","5286481","5286652","35","60471039"
"chr8","65759572","65759772","chr8","65909528","65909719","16","149956"
"chr8","65770785","65770995","chr11","130089781","130089993","37","64318996"
"chr8","65773234","65773310","chr4","125685233","125685314","16","59911999"
"chr8","65783452","65783743","chr8","65936230","65936521","14","152778"
"chr8","65790159","65790445","chr5","142943883","142944190","67","77153724"
"chr8","65793206","65793505","chr8","62577856","62578148","56","3215350"
"chr8","65799481","65799791","chr8","65956108","65956417","14","156627"
"chr8","65800084","65800201","chr8","65956700","65956815","4","156616"
"chr8","65800628","65800904","chr8","65957234","65957545","39","156606"
"chr8","65822931","65823239","chr8","65979819","65980126","10","156888"
"chr8","65823882","65824111","chr8","65980765","65980995","6","156883"
"chr8","65825145","65825449","chr8","65982335","65982645","10","157190"
"chr8","65825455","65825750","chr8","65982651","65982944","11","157196"
"chr8","65828743","65829065","chr16","44956627","44956945","60","20872116"
"chr8","65837747","65838043","chr8","65992166","65992464","8","154419"
"chr8","65845238","65845329","chr8","65999335","65999426","1","154097"
"chr8","65846000","65846303","chr8","66000096","66000397","12","154096"
"chr8","65878319","65878609","chr8","66032653","66032943","6","154334"
"chr8","65878841","65878934","chr8","66033173","66033266","1","154332"
"chr8","65888495","65888792","chr8","66043287","66043584","6","154792"
"chr8","65904424","65904492","chr16","20766175","20766243","12","45138249"
"chr8","65917762","65918055","chr8","66072674","66072967","8","154912"
"chr8","65994448","65994757","chr8","66148742","66149044","16","154294"
"chr8","66004513","66004770","chr8","66158798","66159052","8","154285"
"chr8","66010981","66011202","chr8","66165175","66165395","5","154194"
"chr8","66013856","66014082","chr2","41641895","41642119","58","24371961"
"chr8","66031421","66031708","chr8","66185895","66186182","3","154474"
"chr8","66045565","66045875","chr8","66199585","66199893","11","154020"
"chr8","66051083","66051369","chr8","66204891","66205171","13","153808"
"chr8","66064109","66064386","chr8","66217828","66218125","29","153719"
"chr8","66066536","66066684","chr1","128804331","128804470","32","62737795"
"chr8","66070665","66070923","chr8","66224496","66224766","19","153831"
"chr8","66092869","66092922","chr8","66246265","66246318","0","153396"
"chr8","66093224","66093378","chr8","66246623","66246778","5","153399"
"chr8","66099218","66099386","chr8","66252626","66252795","7","153408"
"chr8","66108510","66108796","chr8","66261949","66262235","12","153439"
"chr8","66110457","66110758","chr8","66263892","66264193","2","153435"
"chr8","66126577","66126871","chr8","66280085","66280379","7","153508"
"chr8","66156636","66156918","chr8","66311079","66311364","15","154443"
"chr8","66157571","66157838","chr11","30460676","30460942","60","35696895"
"chr8","66170177","66170468","chr8","66324780","66325074","10","154603"
"chr8","66176314","66176478","chr8","66330925","66331088","3","154611"
"chr8","66192951","66193246","chr8","66347538","66347829","14","154587"
"chr8","66196606","66196900","chr8","66351141","66351435","5","154535"
"chr8","66197438","66197725","chr8","66351951","66352254","30","154513"
"chr8","66215174","66215456","chr8","66369383","66369665","3","154209"
"chr8","66229792","66229934","chr8","66383940","66384101","29","154148"
"chr8","66230245","66230273","chr12","102985328","102985354","3","36755083"
"chr8","66235499","66235793","chr8","66389087","66389396","27","153588"
"chr8","66236336","66236648","chr8","66389947","66390254","12","153611"
"chr8","66239169","66239468","chr8","66392778","66393078","10","153609"
"chr8","66242762","66243028","chr8","66396380","66396646","8","153618"
"chr8","66246093","66246375","chr8","66399314","66399606","13","153221"
"chr8","66247589","66247890","chr9","20638742","20639036","62","45608847"
"chr8","66248058","66248232","chr8","66401395","66401568","3","153337"
"chr8","66248267","66248384","chr20","2974370","2974476","41","63273897"
"chr8","66260076","66260391","chr3","153060925","153061233","67","86800849"
"chr8","66262211","66262511","chr8","66415486","66415759","33","153275"
"chr8","66263240","66263531","chrX","7838611","7838897","70","58424629"
"chr8","66266655","66266964","chr8","66419918","66420226","6","153263"
"chr8","66281168","66281454","chr8","66434341","66434627","2","153173"
"chr8","66287121","66287383","chr8","66440618","66440906","29","153497"
"chr8","66292702","66293001","chr8","66446231","66446530","10","153529"
"chr8","66293528","66293687","chr8","66447052","66447203","12","153524"
"chr8","66295019","66295313","chr8","66448526","66448854","41","153507"
"chr8","66297417","66297689","chr8","66449995","66450266","4","152578"
"chr8","66300843","66301139","chr8","66453434","66453731","11","152591"
"chr8","66316729","66316905","chr8","66469331","66469507","3","152602"
"chr8","66316929","66317171","chr8","66469531","66469772","4","152602"
"chr8","66325843","66326147","chr8","66478465","66478767","5","152622"
"chr8","66361614","66361927","chr8","66514770","66515081","14","153156"
"chr8","66370915","66371233","chr8","66524397","66524685","37","153482"
"chr8","66377688","66377971","chr8","66531100","66531387","11","153412"
"chr8","66381274","66381578","chr8","66535511","66535815","12","154237"
"chr8","66399883","66400168","chr8","66552693","66552976","11","152810"
"chr8","66413223","66413528","chr8","66565515","66565826","11","152292"
"chr8","66480486","66480599","chr16","43678400","43678506","38","22802086"
"chr8","66546154","66546447","chr8","66701947","66702227","17","155793"
"chr8","66659239","66659534","chr8","66815806","66816106","13","156567"
"chr8","66700017","66700276","chr8","66855407","66855666","9","155390"
"chr8","66706882","66707177","chr8","66862148","66862443","3","155266"
"chr8","66725758","66726094","chr8","66883230","66883565","17","157472"
"chr8","66780394","66780684","chr8","66938794","66939084","8","158400"
"chr8","66817575","66817882","chr8","66975774","66976070","19","158199"
"chr8","66832862","66833176","chr8","66990300","66990621","15","157438"
"chr8","66912097","66912383","chr8","67070802","67071088","7","158705"
"chr8","66912627","66912908","chr8","67071332","67071611","10","158705"
"chr8","66971023","66971322","chr8","67129463","67129764","6","158440"
"chr8","66986831","66987133","chr20","39705042","39705349","63","27281789"
"chr8","67076186","67076472","chr8","67237597","67237880","9","161411"
"chr8","67126817","67127068","chr8","67288416","67288676","13","161599"
"chr8","67223948","67223999","chr8","67389688","67389744","7","165740"
"chr8","67254934","67255229","chr8","67420735","67421028","8","165801"
"chr8","67270616","67270915","chr8","67436220","67436519","3","165604"
"chr8","67322525","67322633","chr8","67488177","67488285","2","165652"
"chr8","67393768","67394059","chr8","67561149","67561441","19","167381"
"chr8","67396877","67397163","chr8","67564257","67564543","4","167380"
"chr8","67404230","67404515","chr8","67571372","67571670","18","167142"
"chr8","67507538","67507835","chr8","67675691","67675991","6","168153"
"chr8","67530274","67530553","chr11","100927137","100927404","74","33396863"
"chr8","67632239","67632527","chr1","113923965","113924259","54","46291726"
"chr8","67707161","67707443","chr8","67883175","67883468","15","176014"
"chr8","67710405","67710642","chr8","67886441","67886678","4","176036"
"chr8","67823391","67823690","chr8","67992326","67992625","7","168935"
"chr8","67858886","67859176","chr8","68028726","68029016","5","169840"
"chr8","67912443","67912671","chr8","68090542","68090774","9","178099"
"chr8","67947776","67948101","chr8","68125926","68126224","32","178150"
"chr8","67951864","67951969","chr8","68129995","68130096","6","178131"
"chr8","68165195","68165478","chr8","68335125","68335404","7","169930"
"chr8","68194215","68194525","chr8","68364157","68364458","17","169942"
"chr8","68230366","68230647","chr8","68399099","68399385","8","168733"
"chr8","68291319","68291634","chr8","68464472","68464785","9","173153"
"chr8","68383325","68383630","chr8","68556942","68557250","16","173617"
"chr8","68443003","68443310","chr8","68621286","68621597","10","178283"
"chr8","68455669","68455950","chr8","68633838","68634119","5","178169"
"chr8","68457436","68457739","chr14","37404413","37404717","63","31053023"
"chr8","68469212","68469488","chr8","68647342","68647624","13","178130"
"chr8","68476346","68476574","chr8","68654468","68654696","5","178122"
"chr8","68487471","68487781","chr8","68665663","68665954","26","178192"
"chr8","68488785","68489070","chr8","68666951","68667243","12","178166"
"chr8","68503446","68503599","chr8","68681919","68682072","1","178473"
"chr8","68519948","68520263","chr12","59052232","59052538","66","9467716"
"chr8","68548973","68549306","chr8","68726833","68727168","11","177860"
"chr8","68553825","68554133","chr8","68731731","68732018","35","177906"
"chr8","68556462","68556766","chr8","68734343","68734646","9","177881"
"chr8","68557992","68558302","chr8","68735872","68736181","8","177880"
"chr8","68559322","68559595","chr8","68738919","68739191","11","179597"
"chr8","68569825","68570123","chr8","68750000","68750304","14","180175"
"chr8","68609981","68610116","chr15","99199241","99199381","31","30589260"
"chr8","68626640","68626755","chr8","68807993","68808108","3","181353"
"chr8","68627032","68627176","chr8","68808401","68808543","13","181369"
"chr8","68627186","68627484","chr8","68808553","68808854","28","181367"
"chr8","68630333","68630631","chr8","68811707","68811994","17","181374"
"chr8","68634810","68634986","chr8","68816156","68816329","6","181346"
"chr8","68635304","68635429","chr8","68816642","68816767","2","181338"
"chr8","68639775","68639897","chr8","68821040","68821159","7","181265"
"chr8","68648371","68648672","chr8","68829900","68830201","9","181529"
"chr8","68654351","68654643","chr17","3242791","3243076","56","65411560"
"chr8","68655441","68655613","chr8","68837000","68837161","16","181559"
"chr8","68662375","68662494","chr8","68843438","68843559","5","181063"
"chr8","68667705","68667744","chr8","68849079","68849121","4","181374"
"chr8","68667812","68667957","chr1","128205615","128205752","34","59537803"
"chr8","68669753","68670050","chr3","2797380","2797675","46","65872373"
"chr8","68688914","68689222","chr8","68870628","68870940","7","181714"
"chr8","68701767","68701803","chr6","83048189","83048225","6","14346422"
"chr8","68701804","68702056","chr8","68882795","68883049","15","180991"
"chr8","68713516","68713790","chr8","68894766","68895040","6","181250"
"chr8","68773376","68773656","chr8","68953392","68953673","7","180016"
"chr8","68788715","68788845","chr16","849038","849168","20","67939677"
"chr8","68802744","68803051","chr8","68977991","68978300","24","175247"
"chr8","68808109","68808418","chr8","68983371","68983679","6","175262"
"chr8","68858245","68858551","chr8","69037686","69037972","25","179441"
"chr8","68911128","68911424","chr8","69105718","69106016","9","194590"
"chr8","68924434","68924581","chr8","69119052","69119200","3","194618"
"chr8","68955270","68955572","chr3","124325532","124325829","67","55370262"
"chr8","68992499","68992795","chr8","69187398","69187694","4","194899"
"chr8","68999014","68999177","chr1","161952873","161953016","43","92953859"
"chr8","68999181","68999280","chr7","10912904","10913003","15","58086277"
"chr8","69001015","69001303","chr8","69198073","69198361","6","197058"
"chr8","69004756","69005061","chr8","69202085","69202390","8","197329"
"chr8","69016504","69016722","chr8","69213847","69214065","12","197343"
"chr8","69017587","69017868","chr8","69214930","69215219","16","197343"
"chr8","69019728","69020015","chr8","69217082","69217369","4","197354"
"chr8","69034980","69035265","chr8","69232368","69232655","16","197388"
"chr8","69067530","69067609","chr19","43396302","43396381","17","25671228"
"chr8","69074394","69074694","chr8","69272627","69272934","13","198233"
"chr8","69138372","69138400","chr1","24029915","24029937","9","45108457"
"chr8","69221200","69221507","chr8","69417631","69417933","13","196431"
"chr8","69240822","69240971","chr8","69437517","69437668","6","196695"
"chr8","69252152","69252359","chr8","69448452","69448659","4","196300"
"chr8","69265595","69265889","chr8","69462041","69462341","22","196446"
"chr8","69274642","69274898","chr8","69469672","69469927","6","195030"
"chr8","69333243","69333533","chr8","69528204","69528494","7","194961"
"chr8","69333917","69334228","chr8","69528874","69529191","13","194957"
"chr8","69337616","69337898","chr8","69532602","69532886","9","194986"
"chr8","69338558","69338851","chr8","69533570","69533852","20","195012"
"chr8","69342885","69342990","chr8","69537794","69537899","0","194909"
"chr8","69364981","69365274","chr8","69559744","69560037","3","194763"
"chr8","69366634","69366924","chr8","69561406","69561719","29","194772"
"chr8","69371465","69371762","chr8","69566447","69566741","16","194982"
"chr8","69382553","69382758","chr8","69577131","69577335","5","194578"
"chr8","69384019","69384186","chr8","69578599","69578766","10","194580"
"chr8","69385980","69386273","chr8","69580871","69581144","28","194891"
"chr8","69386773","69387030","chr8","69581731","69581962","30","194958"
"chr8","69387692","69387765","chr8","69582624","69582697","4","194932"
"chr8","69390024","69390299","chr8","69585291","69585554","17","195267"
"chr8","69395397","69395555","JH681628","2255","2402","44","69393142"
"chr8","69409584","69409814","chr8","69604833","69605063","5","195249"
"chr8","69411799","69412090","chr8","69606960","69607251","5","195161"
"chr8","69449280","69449580","chr8","69646885","69647164","31","197605"
"chr8","69453540","69453836","chr8","69649903","69650199","5","196363"
"chr8","69463089","69463338","chr8","69659063","69659312","2","195974"
"chr8","69471366","69471654","chr8","69667565","69667847","10","196199"
"chr8","69473064","69473332","chr8","69669255","69669519","13","196191"
"chr8","69479537","69479629","chr8","69675716","69675804","6","196179"
"chr8","69481875","69482155","chr8","69677724","69678003","3","195849"
"chr8","69485743","69486029","chr8","69681578","69681864","6","195835"
"chr8","69488089","69488397","chr8","69683937","69684248","7","195848"
"chr8","69501161","69501457","chr8","69697037","69697333","5","195876"
"chr8","69520046","69520346","chr7","78138816","78139099","69","8618770"
"chr8","69526298","69526401","JH679796","3334","3438","18","69522964"
"chr8","69531974","69532275","chr7","33399973","33400275","47","36132001"
"chr8","69532783","69532909","chr8","69729701","69729827","0","196918"
"chr8","69543564","69543853","chr16","44745004","44745304","56","24798560"
"chr8","69548457","69548757","chr8","69744916","69745215","9","196459"
"chr8","69549587","69549720","chr3","51679299","51679431","34","17870288"
"chr8","69566822","69567097","chr8","69763961","69764237","12","197139"
"chr8","69570381","69570625","chr8","69767530","69767774","9","197149"
"chr8","69584242","69584406","chr8","69781457","69781621","4","197215"
"chr8","69586600","69586798","chr8","69783852","69784042","10","197252"
"chr8","69593845","69594046","chr8","69790767","69790968","9","196922"
"chr8","69594315","69594449","chr8","69791239","69791372","3","196924"
"chr8","69596817","69596960","chr8","69793754","69793897","1","196937"
"chr8","69600327","69600609","chr8","69796855","69797136","5","196528"
"chr8","69615102","69615345","chr8","69811759","69811998","18","196657"
"chr8","69615914","69616201","chr8","69812522","69812809","7","196608"
"chr8","69625720","69626018","chr8","69822625","69822961","42","196905"
"chr8","69627793","69628096","chr8","69824787","69825089","16","196994"
"chr8","69643552","69643773","chr8","69841669","69841898","11","198117"
"chr8","69654529","69654731","chr8","69852622","69852823","2","198093"
"chr8","69654780","69655067","chr8","69852872","69853159","7","198092"
"chr8","69659721","69660027","chr8","69857809","69858115","7","198088"
"chr8","69665125","69665416","chr8","69863210","69863511","16","198085"
"chr8","69665620","69665919","chr8","69863715","69864005","14","198095"
"chr8","69687440","69687737","chr8","69884318","69884618","8","196878"
"chr8","69722214","69722505","chr8","69917455","69917745","5","195241"
"chr8","69724560","69724866","chr8","69919799","69920101","6","195239"
"chr8","69734084","69734378","chr8","69929725","69930019","11","195641"
"chr8","69771327","69771598","chr8","69964212","69964483","4","192885"
"chr8","69775667","69775952","chr8","69968551","69968835","10","192884"
"chr8","69802879","69803054","chr19","35013642","35013813","32","34789237"
"chr8","69825709","69825803","chr1","91105563","91105650","34","21279854"
"chr8","69843674","69843959","chr8","70037278","70037560","13","193604"
"chr8","69910491","69910798","chr8","70104465","70104774","16","193974"
"chr8","70057760","70057829","chr8","70256696","70256774","11","198936"
"chr8","70058130","70058371","chr8","70257077","70257316","10","198947"
"chr8","70115968","70116102","chr1","1658615","1658747","21","68457353"
"chr8","70202725","70202895","chr16","51202968","51203133","24","18999757"
"chr8","70202926","70203055","chr6","106705441","106705566","29","36502515"
"chr8","70219366","70219679","chr11","50004656","50004962","52","20214710"
"chr8","70221578","70221863","chr7","88399041","88399321","70","18177463"
"chr8","70297642","70297906","chr8","70504078","70504342","8","206436"
"chr8","70332611","70332903","chr8","70539683","70539976","14","207072"
"chr8","70341049","70341075","chrX","104539781","104539805","4","34198732"
"chr8","70341109","70341391","chr8","70548483","70548767","9","207374"
"chr8","70450668","70450907","chr8","70661439","70661698","28","210771"
"chr8","70453640","70453812","chrX","113108488","113108658","39","42654848"
"chr8","70453841","70453889","chr15","24800921","24800973","10","45652920"
"chr8","70487876","70488059","chr8","70698901","70699072","17","211025"
"chr8","70496057","70496215","chr9","66741274","66741427","31","3754783"
"chr8","70555783","70555937","chr8","70767021","70767175","13","211238"
"chr8","70591789","70592068","chr8","70805984","70806282","30","214195"
"chr8","70631338","70631436","chr3","129256538","129256634","22","58625200"
"chr8","70631465","70631619","chr4","114306341","114306495","43","43674876"
"chr8","70888365","70888658","chr8","71104023","71104312","12","215658"
"chr8","70944350","70944648","chr8","71160225","71160527","19","215875"
"chr8","70969962","70970243","chr8","71186363","71186644","8","216401"
"chr8","71011402","71011620","chr8","71228261","71228477","8","216859"
"chr8","71030840","71031127","chr1","216841044","216841341","59","145810204"
"chr8","71041926","71042188","chr8","71258726","71258991","10","216800"
"chr8","71050980","71051293","chr8","71267877","71268189","12","216897"
"chr8","71090262","71090416","chr4","43031533","43031689","31","28058729"
"chr8","71090714","71090877","chr11","75216333","75216491","32","4125619"
"chr8","71137349","71137555","chr8","71354217","71354423","7","216868"
"chr8","71211449","71211723","chr8","71417738","71418012","11","206289"
"chr8","71217973","71218204","chr8","71424259","71424489","8","206286"
"chr8","71247144","71247433","chr8","71453948","71454237","6","206804"
"chr8","71247756","71248049","chr8","71454558","71454852","23","206802"
"chr8","71378752","71379049","chr7","16856353","16856641","93","54522399"
"chr8","71409085","71409257","chr2","48363661","48363833","32","23045424"
"chr8","71409283","71409318","chr3","131721151","131721185","8","60311868"
"chr8","71479685","71479989","chr8","71683909","71684214","11","204224"
"chr8","71504429","71504539","chr8","71705519","71705629","5","201090"
"chr8","71530754","71531055","chr8","71731644","71731955","15","200890"
"chr8","71695070","71695373","chr8","71909644","71909947","8","214574"
"chr8","71723373","71723694","chr8","71939525","71939828","26","216152"
"chr8","71918133","71918423","chr8","72139367","72139657","3","221234"
"chr8","72092632","72092929","chr8","72312620","72312917","8","219988"
"chr8","72164791","72164906","chr8","72383409","72383524","1","218618"
"chr8","72244405","72244710","chr8","72467288","72467586","18","222883"
"chr8","72266328","72266340","chr19","5264116","5264128","1","67002212"
"chr8","72266481","72266750","chr8","72489272","72489541","4","222791"
"chr8","72281301","72281611","chr11","111939219","111939508","70","39657918"
"chr8","72286508","72286810","chr8","72509568","72509873","13","223060"
"chr8","72291642","72291929","chr8","72514399","72514688","8","222757"
"chr8","72298096","72298388","chr8","72520858","72521139","21","222762"
"chr8","72323922","72324145","chr8","72547074","72547297","3","223152"
"chr8","72347416","72347717","chr1","212279754","212280053","71","139932338"
"chr8","72402293","72402520","chr8","72623969","72624196","3","221676"
"chr8","72451961","72452155","chr8","72674212","72674378","33","222251"
"chr8","72452451","72452567","chr8","72674676","72674787","9","222225"
"chr8","72479643","72479937","chr8","72702829","72703125","11","223186"
"chr8","72543656","72543956","chr8","72766735","72767035","10","223079"
"chr8","72568102","72568303","chr8","72785409","72785613","9","217307"
"chr8","72610899","72611102","chr11","120672710","120672913","80","48061811"
"chr8","72618307","72618590","chr8","72846155","72846438","5","227848"
"chr8","72660774","72661067","chr16","61802628","61802913","55","10858146"
"chr8","72694307","72694580","chr8","72922651","72922922","12","228344"
"chr8","72897951","72898242","chr8","73122509","73122810","17","224558"
"chr8","72899727","72900030","chr16","32714688","32714980","61","40185039"
"chr8","72902881","72903061","chr8","73128073","73128253","8","225192"
"chr8","73094508","73094796","chr8","73320566","73320854","10","226058"
"chr8","73352637","73352893","chr8","73581808","73582064","5","229171"
"chr8","73400837","73401079","chr2","173020329","173020570","49","99619492"
"chr8","73505934","73506077","chr7","115637234","115637369","35","42131300"
"chr8","73514847","73515040","chrX","49524523","49524692","47","23990324"
"chr8","73515081","73515145","chr11","94134998","94135064","16","20619917"
"chr8","73543554","73543818","chr8","73770256","73770522","15","226702"
"chr8","73742074","73742383","chr8","73966570","73966879","2","224496"
"chr8","73755225","73755513","chr8","73979747","73980036","7","224522"
"chr8","74042522","74042801","chr8","74275375","74275650","6","232853"
"chr8","74133540","74133623","chr8","74369844","74369927","0","236304"
"chr8","74139524","74139795","chr1","26153930","26154211","62","47985594"
"chr8","74248598","74248840","chr8","74477183","74477425","3","228585"
"chr8","74290634","74290750","chr8","74519354","74519470","0","228720"
"chr8","74313729","74314043","chr7","49571405","49571710","72","24742324"
"chr8","74378907","74379073","chr8","74608815","74608981","4","229908"
"chr8","74403007","74403235","chr8","74634035","74634260","6","231028"
"chr8","74512223","74512509","chr8","74753337","74753622","8","241114"
"chr8","74632300","74632469","chr8","74878991","74879160","3","246691"
"chr8","74906565","74906860","chr8","75160266","75160518","50","253701"
"chr8","74972610","74972779","chr2","20344456","20344618","42","54628154"
"chr8","75097621","75097930","chr8","75355997","75356306","11","258376"
"chr8","75128637","75128939","chr8","75387427","75387732","13","258790"
"chr8","75130780","75130917","chr1","113173705","113173839","26","38042925"
"chr8","75130919","75131221","chr8","75389661","75389962","10","258742"
"chr8","75141432","75141653","chr9","6030499","6030716","39","69110933"
"chr8","75156949","75157216","chr8","75415607","75415873","11","258658"
"chr8","75194398","75194696","chr8","75455442","75455750","22","261044"
"chr8","75211496","75211779","chr9","105708090","105708375","51","30496594"
"chr8","75212790","75213089","chr8","75473771","75474070","6","260981"
"chr8","75253168","75253478","chr8","75516977","75517286","17","263809"
"chr8","75261264","75261602","chr8","75525073","75525428","26","263809"
"chr8","75268249","75268550","chr8","75532065","75532366","12","263816"
"chr8","75281836","75282154","chr8","75547570","75547888","11","265734"
"chr8","75319722","75320013","chr8","75586215","75586505","5","266493"
"chr8","75335529","75335762","chr8","75602303","75602536","4","266774"
"chr8","75340196","75340409","chrX","59016753","59016932","66","16323443"
"chr8","75340646","75340753","chr8","75607358","75607464","5","266712"
"chr8","75357181","75357470","chr8","75623879","75624179","16","266698"
"chr8","75367583","75367884","chr8","75635312","75635617","10","267729"
"chr8","75380717","75380994","chr8","75648441","75648718","6","267724"
"chr8","75414450","75414741","chr8","75682572","75682866","6","268122"
"chr8","75432035","75432329","chr8","75699860","75700156","7","267825"
"chr8","75437072","75437240","chr8","75704395","75704563","4","267323"
"chr8","75438531","75438831","chr8","75705896","75706195","9","267365"
"chr8","75469414","75469725","chr8","75736526","75736837","8","267112"
"chr8","75474492","75474803","chr8","75741617","75741928","9","267125"
"chr8","75485950","75486253","chr8","75753372","75753672","7","267422"
"chr8","75507171","75507439","chr8","75775043","75775309","6","267872"
"chr8","75515145","75515465","chr2","156321606","156321914","66","80806461"
"chr8","75541143","75541437","chr8","75808806","75809096","13","267663"
"chr8","75576821","75576972","chr8","75844675","75844825","5","267854"
"chr8","75577155","75577297","chr8","75845008","75845150","3","267853"
"chr8","75599378","75599529","chr8","75867115","75867266","5","267737"
"chr8","75603647","75603948","chr8","75871710","75872011","6","268063"
"chr8","75623393","75623705","chr8","75894517","75894819","21","271124"
"chr8","75633119","75633420","chr3","51655727","51656029","62","23977392"
"chr8","75635622","75635922","chr8","75906833","75907150","25","271211"
"chr8","75640658","75640944","chr6","123155809","123156096","5","47515151"
"chr8","75646758","75647055","chr8","75918994","75919290","3","272236"
"chr8","75647824","75647920","chr8","75920059","75920156","1","272235"
"chr8","75651088","75651212","chr8","75923622","75923746","2","272534"
"chr8","75660953","75661249","chr8","75934379","75934675","6","273426"
"chr8","75662142","75662447","chr8","75935560","75935868","10","273418"
"chr8","75666896","75667030","chr8","75939776","75939913","8","272880"
"chr8","75668103","75668405","chr8","75940983","75941285","12","272880"
"chr8","75675288","75675403","chr8","75948177","75948293","4","272889"
"chr8","75683310","75683441","chr8","75955910","75956031","11","272600"
"chr8","75684154","75684431","chr8","75956750","75957023","11","272596"
"chr8","75694695","75694879","chr8","75969451","75969645","17","274756"
"chr8","75703376","75703537","chr11","30557931","30558081","47","45145445"
"chr8","75703576","75703818","chr8","75976208","75976450","12","272632"
"chr8","75703898","75703978","chr8","75976530","75976609","4","272632"
"chr8","75705314","75705411","chr6","61113512","61113607","23","14591802"
"chr8","75709029","75709321","chr8","75982980","75983310","42","273951"
"chr8","75710383","75710683","chr8","75984355","75984655","6","273972"
"chr8","75712177","75712327","chr20","4219731","4219879","34","71492446"
"chr8","75727282","75727580","chr8","76002227","76002525","4","274945"
"chr8","75728801","75728931","chr20","25579643","25579768","20","50149158"
"chr8","75742001","75742304","chr8","76016755","76017068","17","274754"
"chr8","75745633","75745895","chr8","76020416","76020679","6","274783"
"chr8","75751011","75751315","chr2","44882107","44882408","55","30868904"
"chr8","75751827","75752132","chr8","76027254","76027553","20","275427"
"chr8","75763157","75763423","chr13","23887456","23887734","57","51875701"
"chr8","75765347","75765617","chr8","76040779","76041071","31","275432"
"chr8","75772246","75772544","chr2","125585968","125586259","69","49813722"
"chr8","75790496","75790781","chr3","15045435","15045718","51","60745061"
"chr8","75792341","75792643","chr10","50389396","50389695","58","25402945"
"chr8","75794211","75794476","chr8","76070506","76070772","9","276295"
"chr8","75797300","75797539","chr8","76073651","76073909","29","276351"
"chr8","75798471","75798769","chr8","76074793","76075137","50","276322"
"chr8","75799079","75799402","chr14","106152261","106152570","93","30353182"
"chr8","75812063","75812361","chr8","76087884","76088178","14","275821"
"chr8","75830900","75831143","chr8","76106199","76106441","7","275299"
"chr8","75842544","75842841","chr9","57648963","57649252","50","18193581"
"chr8","75850466","75850792","chr8","76126151","76126461","30","275685"
"chr8","75867980","75868232","chr8","76143525","76143779","5","275545"
"chr8","75873815","75873994","chr11","109515429","109515628","47","33641614"
"chr8","75881224","75881511","chr8","76157268","76157555","6","276044"
"chr8","75891929","75892210","chr8","76168265","76168546","6","276336"
"chr8","75892926","75893164","chr8","76169266","76169504","7","276340"
"chr8","75945454","75945762","chr8","76222208","76222512","9","276754"
"chr8","75950829","75951118","chr8","76227620","76227916","12","276791"
"chr8","75962676","75962790","chr8","76239728","76239840","2","277052"
"chr8","75969372","75969673","chr8","76246446","76246747","5","277074"
"chr8","76022598","76022877","chr8","76302628","76302907","12","280030"
"chr8","76026159","76026437","chr8","76306151","76306451","30","279992"
"chr8","76056451","76056739","chr8","76336640","76336928","6","280189"
"chr8","76060554","76060807","chr8","76340791","76341052","12","280237"
"chr8","76080453","76080754","chr8","76360615","76360920","15","280162"
"chr8","76085486","76085788","chr8","76366459","76366762","9","280973"
"chr8","76092075","76092382","chr8","76388281","76388586","19","296206"
"chr8","76098368","76098492","chrX","99038782","99038902","27","22940414"
"chr8","76130091","76130387","chr10","17860646","17860944","52","58269445"
"chr8","76147511","76147795","chr8","76445212","76445496","23","297701"
"chr8","76161459","76161768","chr8","76458913","76459215","16","297454"
"chr8","76184705","76185014","chr8","76482290","76482584","25","297585"
"chr8","76214361","76214660","chr8","76512257","76512556","10","297896"
"chr8","76225254","76225361","chr8","90799978","90800083","23","14574724"
"chr8","76263356","76263505","chr8","76561848","76561998","8","298492"
"chr8","76277942","76278117","chr6","58082549","58082722","35","18195393"
"chr8","76281874","76282160","chr8","76580351","76580621","21","298477"
"chr8","76315074","76315359","chr8","76613221","76613504","13","298147"
"chr8","76324234","76324546","chr8","76622400","76622719","13","298166"
"chr8","76333526","76333832","chr8","76631686","76631984","19","298160"
"chr8","76336554","76336822","chr8","76634351","76634619","2","297797"
"chr8","76359307","76359596","chr8","76656750","76657049","29","297443"
"chr8","76414524","76414820","chr8","76714754","76715049","2","300230"
"chr8","76426507","76426818","chr8","76727030","76727310","36","300523"
"chr8","76459926","76460214","chr8","76760267","76760556","13","300341"
"chr8","76509986","76510292","chr8","76810012","76810318","7","300026"
"chr8","76521595","76521907","chr8","76821603","76821926","17","300008"
"chr8","76571187","76571469","chr8","76871137","76871422","11","299950"
"chr8","76634863","76635165","chr8","76950871","76951173","5","316008"
"chr8","76642581","76642865","chr8","76958446","76958732","9","315865"
"chr8","76749100","76749391","chr8","77068197","77068492","15","319097"
"chr8","76749838","76750051","chr8","77068935","77069147","5","319097"
"chr8","76750053","76750234","chrX","45599837","45600005","48","31150216"
"chr8","76772439","76772734","chr8","77091366","77091634","33","318927"
"chr8","76785426","76785738","chr8","77104311","77104618","17","318885"
"chr8","76808233","76808537","chr8","77127463","77127767","14","319230"
"chr8","76909076","76909317","chr8","77230181","77230423","17","321105"
"chr8","77013635","77013931","chr8","77335979","77336281","11","322344"
"chr8","77072493","77072786","chr8","77401579","77401872","7","329086"
"chr8","77092342","77092644","chr6","134251498","134251796","71","57159156"
"chr8","77096791","77097104","chr8","77426142","77426442","21","329351"
"chr8","77115808","77116098","chr8","77445132","77445436","20","329324"
"chr8","77147258","77147537","chr14","50543810","50544098","69","26603448"
"chr8","77272073","77272273","chr11","84077895","84078087","49","6805822"
"chr8","77272299","77272404","chr8","121460596","121460701","21","44188297"
"chr8","77313407","77313699","chr1","150091720","150092021","60","72778313"
"chr8","77528212","77528514","chr8","77865652","77865954","10","337440"
"chr8","77997747","77998034","chr8","78332711","78332998","8","334964"
"chr8","78040922","78041192","chr8","78376827","78377097","7","335905"
"chr8","78044129","78044352","chr19","39756551","39756765","56","38287578"
"chr8","78137595","78137879","chr8","78463450","78463734","4","325855"
"chr8","78234608","78234906","chr8","78555166","78555464","11","320558"
"chr8","78248788","78248928","chr9","66904602","66904734","32","11344186"
"chr8","78280810","78281031","chr8","78604871","78605092","8","324061"
"chr8","78451449","78451680","chr8","78777591","78777773","52","326142"
"chr8","78538988","78539286","chr8","78869987","78870284","13","330999"
"chr8","78773600","78773899","chr8","79104791","79105087","10","331191"
"chr8","78843914","78844288","chr8","79191262","79191658","36","347348"
"chr8","78915006","78915138","chr8","79262685","79262817","3","347679"
"chr8","78972697","78972998","chr8","79321227","79321517","23","348530"
"chr8","79196726","79196886","chr3","42774674","42774835","34","36422052"
"chr8","79196952","79197033","chr1","37419481","37419562","15","41777471"
"chr8","79210812","79211111","chr8","79583981","79584290","17","373169"
"chr8","79417639","79417920","chr4","83219681","83219966","55","3802042"
"chr8","79445861","79446143","chr8","79820278","79820562","9","374417"
"chr8","79491117","79491395","chr8","79863351","79863629","5","372234"
"chr8","79552454","79552744","chr8","79928050","79928358","25","375596"
"chr8","79553612","79553925","chr8","79929296","79929607","19","375684"
"chr8","79728196","79728487","chr8","80106716","80107005","13","378520"
"chr8","79738481","79738712","chr8","80116430","80116660","8","377949"
"chr8","79825044","79825347","chr8","80202865","80203176","23","377821"
"chr8","79856404","79856583","chr8","80232794","80232975","4","376390"
"chr8","79881154","79881461","chr1","44986574","44986884","66","34894580"
"chr8","79927664","79927975","chr8","80300523","80300786","56","372859"
"chr8","79937754","79938044","chr8","80309981","80310273","11","372227"
"chr8","80170676","80170972","chr8","80546048","80546340","12","375372"
"chr8","80194493","80194777","chr1","109215125","109215406","59","29020632"
"chr8","80405403","80405495","chr8","80793317","80793409","1","387914"
"chr8","80406721","80406984","chr8","80794643","80794904","12","387922"
"chr8","80531016","80531319","chr8","80921001","80921304","8","389985"
"chr8","80539178","80539471","chr8","80929105","80929407","16","389927"
"chr8","80584506","80584821","chr8","80974590","80974897","21","390084"
"chr8","80585033","80585340","chr8","80975111","80975420","11","390078"
"chr8","80597759","80598057","chr8","80987779","80988077","8","390020"
"chr8","80604952","80605249","chr8","80995051","80995372","39","390099"
"chr8","80610036","80610238","chr8","81000080","81000283","7","390044"
"chr8","80610282","80610393","chr11","52337891","52338000","16","28272391"
"chr8","80613014","80613322","chr8","81003049","81003343","23","390035"
"chr8","80621276","80621587","chr8","81011290","81011600","15","390014"
"chr8","80624928","80625211","chr8","81014949","81015229","11","390021"
"chr8","80629122","80629394","chr8","81019140","81019414","13","390018"
"chr8","80640804","80641081","chr8","81030782","81031058","8","389978"
"chr8","80669246","80669469","chr8","81059481","81059702","9","390235"
"chr8","80732852","80733148","chr8","81123330","81123595","35","390478"
"chr8","80761403","80761686","chr8","81152259","81152553","21","390856"
"chr8","80762806","80763111","chr8","81153677","81153982","11","390871"
"chr8","80771411","80771693","chr8","81162261","81162545","8","390850"
"chr8","80809580","80809872","chr8","81200122","81200409","9","390542"
"chr8","80822175","80822243","chr2","50587367","50587427","17","30234808"
"chr8","80827928","80828213","chr2","49656591","49656881","47","31171337"
"chr8","80850048","80850271","chr8","81241327","81241547","10","391279"
"chr8","80869644","80869946","chr8","81260688","81261020","34","391044"
"chr8","80882328","80882509","chr8","81273397","81273558","23","391069"
"chr8","80882600","80882898","chr8","81273649","81273947","14","391049"
"chr8","80889861","80890177","chr8","81280787","81281113","20","390926"
"chr8","80893694","80894022","chr2","64126410","64126724","72","16767284"
"chr8","80922593","80922901","chr8","81313525","81313848","22","390932"
"chr8","80934778","80935093","chr8","81326610","81326901","48","391832"
"chr8","80965919","80966224","chr8","81374450","81374754","10","408531"
"chr8","80972170","80972489","chr8","81380708","81381026","14","408538"
"chr8","80993265","80993432","chr8","81401853","81402017","5","408588"
"chr8","81016557","81016788","chr8","81425239","81425481","18","408682"
"chr8","81069325","81069401","chr8","81477546","81477622","1","408221"
"chr8","81080754","81081042","chr8","81488978","81489266","18","408224"
"chr8","81154719","81155006","chr8","81563583","81563877","11","408864"
"chr8","81159951","81160257","chr10","85181699","85182000","63","4021748"
"chr8","81176959","81177258","chr8","81585688","81585988","7","408729"
"chr8","81177467","81177763","chr8","81586190","81586492","10","408723"
"chr8","81191925","81192263","chr8","81600681","81600972","56","408756"
"chr8","81207619","81207727","chr8","81616389","81616497","3","408770"
"chr8","81207932","81208113","chr8","81616702","81616883","0","408770"
"chr8","81209393","81209702","chr8","81618138","81618447","6","408745"
"chr8","81219399","81219711","chr8","81627803","81628099","25","408404"
"chr8","81219750","81220042","chr8","81628155","81628449","15","408405"
"chr8","81226046","81226327","chr8","81634197","81634509","38","408151"
"chr8","81226358","81226374","chr1","135011633","135011647","2","53785275"
"chr8","81236104","81236404","chr8","81644576","81644876","9","408472"
"chr8","81241283","81241594","chr8","81650052","81650363","1","408769"
"chr8","81256565","81256747","chr8","81665640","81665822","9","409075"
"chr8","81263455","81263698","chr1","28493060","28493300","53","52770395"
"chr8","81263726","81263739","chr1","65474345","65474358","1","15789381"
"chr8","81263749","81264047","chr8","81672887","81673184","10","409138"
"chr8","81275363","81275684","chr8","81685186","81685513","18","409823"
"chr8","81287560","81287851","chr8","81697376","81697667","7","409816"
"chr8","81331533","81331828","chr8","81741261","81741559","5","409728"
"chr8","81336067","81336375","chr8","81745820","81746128","1","409753"
"chr8","81337342","81337636","chr8","81747087","81747381","7","409745"
"chr8","81388456","81388601","chr8","81797451","81797600","9","408995"
"chr8","81388648","81388754","chr8","81797639","81797745","4","408991"
"chr8","81413333","81413619","chr8","81822165","81822452","12","408832"
"chr8","81420956","81421229","chr8","81829911","81830192","11","408955"
"chr8","81444727","81444896","chrX","37752435","37752603","30","43692292"
"chr8","81444940","81444980","chr11","6535407","6535442","11","74909533"
"chr8","81456469","81456756","chr8","81865032","81865318","7","408563"
"chr8","81467757","81468023","chr8","81876287","81876563","14","408530"
"chr8","81493428","81493620","chr8","81902554","81902746","4","409126"
"chr8","81506624","81506927","chr8","81915870","81916173","3","409246"
"chr8","81518568","81518717","chr8","81927875","81928020","6","409307"
"chr8","81519550","81519834","chr8","81928848","81929132","5","409298"
"chr8","81532164","81532475","chr8","81941675","81941991","9","409511"
"chr8","81537971","81538263","chr8","81947707","81948000","10","409736"
"chr8","81538664","81538829","chr19","4066487","4066651","32","77472177"
"chr8","81539146","81539292","chr3","39206512","39206646","35","42332634"
"chr8","81545570","81545903","chr8","81954997","81955340","22","409427"
"chr8","81570982","81571315","chr8","81980898","81981234","8","409916"
"chr8","81613244","81613542","chr8","82023158","82023457","12","409914"
"chr8","81618870","81618983","chr2","135364689","135364804","20","53745819"
"chr8","81625712","81625995","chr8","82036393","82036676","9","410681"
"chr8","81633561","81633846","chr8","82044580","82044865","5","411019"
"chr8","81645887","81646174","chr8","82056970","82057257","5","411083"
"chr8","81648688","81648900","chr8","82059774","82059986","7","411086"
"chr8","81661143","81661435","chr8","82072540","82072833","8","411397"
"chr8","81677616","81677918","chr8","82089189","82089491","8","411573"
"chr8","81682322","81682636","chr8","82094408","82094719","7","412086"
"chr8","81683767","81683963","chr8","82095862","82096058","2","412095"
"chr8","81684502","81684798","chr8","82096896","82097200","13","412394"
"chr8","81694093","81694386","chr8","82107154","82107449","8","413061"
"chr8","81713173","81713484","chr8","82126238","82126549","9","413065"
"chr8","81716286","81716575","chr8","82129385","82129673","8","413099"
"chr8","81724518","81724820","chr8","82137629","82137929","4","413111"
"chr8","81733259","81733374","chr8","82146991","82147106","3","413732"
"chr8","81748018","81748130","chr8","82162235","82162347","1","414217"
"chr8","81748494","81748683","chr8","82162715","82162901","7","414221"
"chr8","81765994","81766273","chr8","82180628","82180903","11","414634"
"chr8","81767555","81767855","chr8","82182689","82182980","17","415134"
"chr8","81781318","81781620","chr8","82199101","82199402","6","417783"
"chr8","81848233","81848381","chr8","82269100","82269241","11","420867"
"chr8","81848660","81848807","chr8","82269520","82269667","0","420860"
"chr8","81873981","81874251","chr8","82295080","82295349","6","421099"
"chr8","81894682","81894983","chr8","82315488","82315789","3","420806"
"chr8","81962085","81962383","chr8","82382427","82382729","8","420342"
"chr8","82032792","82033075","chr8","82455491","82455769","12","422699"
"chr8","82105703","82105992","chr1","121637797","121638093","60","39532094"
"chr8","82142336","82142596","chr8","82577898","82578181","33","435562"
"chr8","82277223","82277511","chr13","23887456","23887734","60","58389767"
"chr8","82292159","82292459","chr8","82730653","82730956","24","438494"
"chr8","82415259","82415576","chr8","82855965","82856279","8","440706"
"chr8","82460279","82460556","chr8","82899797","82900075","7","439518"
"chr8","82579543","82579857","chr8","83015694","83016006","5","436151"
"chr8","82711708","82712000","chr8","83156868","83157160","4","445160"
"chr8","82713560","82713837","chr8","83158679","83158993","41","445119"
"chr8","82728511","82728835","chr8","83173637","83173900","73","445126"
"chr8","82740479","82740678","chr8","83184941","83185110","35","444462"
"chr8","82740750","82740816","chr3","144473238","144473291","29","61732488"
"chr8","82741136","82741269","chr8","83185568","83185700","3","444432"
"chr8","82912721","82912988","chr8","83364955","83365221","12","452234"
"chr8","82915350","82915637","chr8","83367416","83367689","21","452066"
"chr8","82985982","82986292","chr8","83438022","83438331","8","452040"
"chr8","82986426","82986653","chr8","83438605","83438801","34","452179"
"chr8","83053345","83053609","chr8","83506469","83506733","12","453124"
"chr8","83056770","83057068","chr8","83509903","83510199","10","453133"
"chr8","83114032","83114326","chr8","83566637","83566931","9","452605"
"chr8","83140586","83140873","chr8","83593854","83594141","4","453268"
"chr8","83179537","83179832","chr2","167664248","167664541","51","84484711"
"chr8","83189111","83189395","chr1","110265403","110265689","61","27076292"
"chr8","83189435","83189448","chr13","67486160","67486172","2","15703275"
"chr8","83254274","83254557","chr8","83709865","83710143","15","455591"
"chr8","83265609","83265914","chr8","83721163","83721495","44","455554"
"chr8","83310436","83310670","chr8","83768550","83768803","30","458114"
"chr8","83369646","83369809","chr8","83825852","83826015","6","456206"
"chr8","83370068","83370339","chr8","83826272","83826570","29","456204"
"chr8","83440340","83440463","chrX","41760475","41760598","18","41679865"
"chr8","83462908","83463199","chr8","83924612","83924899","12","461704"
"chr8","83487301","83487613","chr8","83947386","83947694","12","460085"
"chr8","83496762","83496856","chr8","83956831","83956928","7","460069"
"chr8","83708162","83708471","chr4","148799971","148800282","68","65091809"
"chr8","83728807","83729105","chr8","84180957","84181268","23","452150"
"chr8","83729722","83730035","chr8","84181889","84182204","16","452167"
"chr8","83849816","83850021","chr8","84302155","84302359","6","452339"
"chr8","83870519","83870824","chr2","20072974","20073277","71","63797545"
"chr8","84700331","84700619","chr13","9734300","9734583","55","74966031"
"chr8","84811614","84811901","chr8","85243766","85244037","20","432152"
"chr8","84817001","84817268","chr8","85249173","85249451","17","432172"
"chr8","84871666","84871878","chr7","17162812","17163026","54","67708854"
"chr8","84875902","84876206","chr8","85308083","85308385","5","432181"
"chr8","84952172","84952476","chr8","85383612","85383912","8","431440"
"chr8","84953537","84953825","chr8","85385372","85385660","10","431835"
"chr8","85014214","85014477","chr8","85446214","85446484","16","432000"
"chr8","85023920","85024261","chr8","85455629","85455971","6","431709"
"chr8","85027908","85027955","chr8","85459627","85459674","0","431719"
"chr8","85028435","85028684","chr8","85460154","85460403","2","431719"
"chr8","85043602","85043896","chr8","85475291","85475565","26","431689"
"chr8","85052119","85052399","chr3","150571515","150571797","50","65519396"
"chr8","85134268","85134561","chr8","85568222","85568508","14","433954"
"chr8","85181994","85182285","chr8","85617066","85617358","8","435072"
"chr8","85262998","85263259","chr8","85700081","85700343","13","437083"
"chr8","85271119","85271399","chr10","53486040","53486302","77","31785079"
"chr8","85273278","85273445","chr11","50271411","50271572","30","35001867"
"chr8","85325897","85326155","chr8","85765138","85765399","8","439241"
"chr8","85326192","85326210","chr8","85765436","85765454","0","439244"
"chr8","85495614","85495908","chr8","85939162","85939457","7","443548"
"chr8","85511513","85511806","chr8","85955281","85955574","8","443768"
"chr8","85546521","85546835","chr8","85990341","85990657","9","443820"
"chr8","85641051","85641374","chrX","44566163","44566473","75","41074888"
"chr8","85661443","85661708","chr8","86117787","86118052","5","456344"
"chr8","85669166","85669298","chr9","119390480","119390614","17","33721314"
"chr8","85696727","85696862","chr8","86149721","86149874","23","452994"
"chr8","85737289","85737584","chr8","86190647","86190942","4","453358"
"chr8","85744600","85744906","chr8","86198021","86198328","10","453421"
"chr8","85839803","85840094","chr8","86293507","86293821","32","453704"
"chr8","85940905","85941152","chr8","86394709","86394963","20","453804"
"chr8","85969276","85969416","chr8","86423351","86423491","4","454075"
"chr8","86014446","86014752","chr8","86465531","86465833","14","451085"
"chr8","86015602","86015763","chr12","78635801","78635964","27","7379801"
"chr8","86016057","86016190","chr8","86467212","86467345","3","451155"
"chr8","86055950","86056294","chr8","86511467","86511809","32","455517"
"chr8","86058407","86058737","chr8","86513894","86514218","20","455487"
"chr8","86084969","86085183","chr4","66505792","66506005","49","19579177"
"chr8","86152552","86152803","chr8","86607933","86608182","7","455381"
"chr8","86213321","86213611","chr8","86670882","86671174","7","457561"
"chr8","86250203","86250467","chr8","86707128","86707399","14","456925"
"chr8","86257618","86257906","chr8","86714269","86714555","8","456651"
"chr8","86297463","86297702","chr8","86753999","86754251","17","456536"
"chr8","86337532","86337821","chr8","86793978","86794258","21","456446"
"chr8","86377698","86378015","chr8","86840690","86840998","15","462992"
"chr8","86378280","86378399","chr8","86841264","86841383","1","462984"
"chr8","86378460","86378642","chr8","86841411","86841573","22","462951"
"chr8","86689144","86689446","chr8","87167611","87167920","11","478467"
"chr8","86697976","86698237","chr8","87178168","87178424","10","480192"
"chr8","86711512","86711800","chr8","87191709","87191998","4","480197"
"chr8","86803464","86803784","chr8","87286027","87286341","13","482563"
"chr8","86865934","86866226","chr8","87348700","87348992","9","482766"
"chr8","86917294","86917357","chr6","173299911","173299974","14","86382617"
"chr8","86918060","86918204","chr1","142371098","142371243","29","55453038"
"chr8","86938552","86938867","chr8","87421887","87422162","46","483335"
"chr8","86951989","86952248","chr8","87435400","87435663","28","483411"
"chr8","87010819","87011122","chr8","87494293","87494584","18","483474"
"chr8","87019482","87019792","chr8","87502938","87503255","11","483456"
"chr8","87035399","87035674","chr8","87519257","87519534","9","483858"
"chr8","87039927","87040212","chr8","87523782","87524066","12","483855"
"chr8","87064813","87065100","chr8","87548997","87549285","4","484184"
"chr8","87065781","87065964","chr8","87549662","87549846","18","483881"
"chr8","87066943","87067061","chr8","87550818","87550934","7","483875"
"chr8","87074256","87074540","chrX","10987622","10987909","53","76086634"
"chr8","87153983","87154101","chr8","87640317","87640435","1","486334"
"chr8","87154146","87154300","chr2","152196356","152196504","38","65042210"
"chr8","87154438","87154453","chr2","93134899","93134914","2","5980461"
"chr8","87163061","87163199","chr8","87648871","87649005","7","485810"
"chr8","87173262","87173584","chr8","87658767","87659084","10","485505"
"chr8","87214480","87214763","chr16","41671981","41672272","70","45542499"
"chr8","87263328","87263626","chr8","87744684","87744953","32","481356"
"chr8","87267775","87267907","chr8","87749148","87749280","3","481373"
"chr8","87270191","87270244","chr8","87751563","87751616","1","481372"
"chr8","87271104","87271402","chr8","87752476","87752777","11","481372"
"chr8","87273383","87273725","chr16","25211732","25212053","84","62061651"
"chr8","87285609","87285923","chr8","87767141","87767474","31","481532"
"chr8","87350914","87351238","chr8","87832761","87833091","16","481847"
"chr8","87404850","87404998","chr8","87890009","87890157","2","485159"
"chr8","87447529","87447827","chr8","87932726","87933024","3","485197"
"chr8","87457116","87457412","chr8","87942308","87942610","46","485192"
"chr8","87495913","87496205","chr8","87981130","87981423","7","485217"
"chr8","87608036","87608317","chr8","88092619","88092900","8","484583"
"chr8","87641358","87641673","chr8","88126155","88126466","9","484797"
"chr8","87671460","87671709","chr8","88155875","88156124","8","484415"
"chr8","87704455","87704734","chr8","88188670","88188949","10","484215"
"chr8","87790527","87790841","chr8","88269967","88270251","40","479440"
"chr8","87993322","87993609","chr8","88469713","88470000","6","476391"
"chr8","88103906","88104204","chr8","88583171","88583441","35","479265"
"chr8","88250891","88251197","chr8","88733093","88733390","16","482202"
"chr8","88253319","88253543","chr8","88735492","88735714","5","482173"
"chr8","88263174","88263408","chr1","109834396","109834628","53","21571222"
"chr8","88293420","88293738","chr8","88776142","88776444","21","482722"
"chr8","88376696","88376994","chr8","88859084","88859381","15","482388"
"chr8","88395722","88395825","chr8","88878821","88878924","2","483099"
"chr8","88395927","88396056","chr8","88879027","88879156","2","483100"
"chr8","88519202","88519497","chr8","89003906","89004246","51","484704"
"chr8","88525493","88525762","chr8","89010234","89010548","52","484741"
"chr8","88541716","88542017","chr8","89026893","89027136","63","485177"
"chr8","88583871","88584168","chr8","89068705","89069002","6","484834"
"chr8","88591942","88592245","chr8","89077201","89077508","17","485259"
"chr8","88594812","88595005","chr8","101766934","101767121","53","13172122"
"chr8","88605278","88605577","chr8","89090196","89090492","13","484918"
"chr8","88612414","88612706","chr8","89097686","89097980","10","485272"
"chr8","88633360","88633479","chr8","89118635","89118754","5","485275"
"chr8","88651523","88651673","chr14","118945688","118945833","44","30294165"
"chr8","88651711","88651940","chr7","155505038","155505252","57","66853327"
"chr8","88652301","88652598","chr8","89138079","89138371","10","485778"
"chr8","88680620","88680901","chr8","89166625","89166907","9","486005"
"chr8","88695660","88695917","chr8","89181690","89181947","6","486030"
"chr8","88696308","88696595","chr8","89182347","89182634","2","486039"
"chr8","88710013","88710298","chr8","89196314","89196600","6","486301"
"chr8","88719840","88720143","chr8","89206095","89206398","5","486255"
"chr8","88731122","88731408","chr8","89217102","89217383","9","485980"
"chr8","88760489","88760775","chr11","30923500","30923797","59","57836989"
"chr8","88775746","88775916","chr15","102217712","102217880","33","13441966"
"chr8","88801524","88801726","chr8","89288039","89288230","46","486515"
"chr8","88801804","88801943","chr10","59994419","59994557","23","28807385"
"chr8","88809211","88809388","chr8","89295656","89295833","2","486445"
"chr8","88843206","88843520","chr8","89323047","89323360","8","479841"
"chr8","88847811","88848108","chr8","89327638","89327933","9","479827"
"chr8","88872971","88873220","chr8","89352830","89353109","35","479859"
"chr8","88906790","88906886","chr8","89386985","89387082","1","480195"
"chr8","88924289","88924589","chr8","89405193","89405485","17","480904"
"chr8","88930054","88930372","chr6","10077569","10077926","89","78852485"
"chr8","88956707","88956927","chr8","89440068","89440289","4","483361"
"chr8","88957726","88957974","chr8","89441069","89441357","42","483343"
"chr8","88969849","88970149","chr8","89453102","89453403","5","483253"
"chr8","88988979","88989277","chr8","89472029","89472326","10","483050"
"chr8","88996237","88996560","chr8","89479673","89480006","16","483436"
"chr8","89004036","89004309","chr8","89487490","89487763","4","483454"
"chr8","89091262","89091552","chr8","89571841","89572135","11","480579"
"chr8","89166876","89166894","chr7","129936514","129936530","5","40769638"
"chr8","89167029","89167072","chr6","57058687","57058726","9","32108342"
"chr8","89167712","89167853","chr6","144818898","144819036","25","55651186"
"chr8","89182797","89183080","chr8","89664230","89664509","10","481433"
"chr8","89183643","89183907","chr8","89665073","89665337","4","481430"
"chr8","89196044","89196333","chr8","89677483","89677771","10","481439"
"chr8","89200678","89200971","chr8","89681693","89681987","3","481015"
"chr8","89239854","89240156","chr8","89720984","89721290","9","481130"
"chr8","89319928","89320094","chr8","89790664","89790839","13","470736"
"chr8","89333415","89333695","chr8","89804424","89804653","56","471009"
"chr8","89356459","89356763","chr8","89827039","89827345","10","470580"
"chr8","89363414","89363692","chr8","89834190","89834470","9","470776"
"chr8","89401506","89401801","chr8","89872545","89872851","13","471039"
"chr8","89415564","89415856","chr8","89886915","89887205","13","471351"
"chr8","89435796","89436099","chr8","89907125","89907426","6","471329"
"chr8","89442232","89442509","chr8","89914044","89914321","6","471812"
"chr8","89456080","89456389","chr8","89927730","89928039","9","471650"
"chr8","89460768","89460909","chr8","89932374","89932526","11","471606"
"chr8","89460920","89461032","chrX","27378968","27379079","29","62081952"
"chr8","89461345","89461479","chr8","89932813","89932954","8","471468"
"chr8","89476919","89477103","chr8","89948671","89948855","1","471752"
"chr8","89479460","89479736","chrX","120356258","120356539","57","30876798"
"chr8","89486925","89487227","chr8","89958635","89958937","6","471710"
"chr8","89489781","89490066","chr8","89961504","89961790","4","471723"
"chr8","89494336","89494628","chr8","89966060","89966353","8","471724"
"chr8","89505022","89505149","chr8","89977415","89977543","8","472393"
"chr8","89524218","89524515","chr8","89997676","89997976","9","473458"
"chr8","89525830","89526113","chr8","89999263","89999569","26","473433"
"chr8","89536877","89537163","chr7","125147857","125148143","58","35610980"
"chr8","89548934","89549244","chr8","90023543","90023849","6","474609"
"chr8","89551222","89551537","chr8","90025836","90026150","10","474614"
"chr8","89553200","89553493","chr8","90027822","90028115","2","474622"
"chr8","89555421","89555710","chr3","37704416","37704712","53","51851005"
"chr8","89565650","89565953","chr10","22710228","22710529","57","66855422"
"chr8","89567559","89567839","chr8","90036005","90036287","7","468446"
"chr8","89572932","89573230","chr8","90041395","90041696","7","468463"
"chr8","89576046","89576327","chr8","90044380","90044632","40","468334"
"chr8","89578904","89579170","chr8","90047302","90047568","3","468398"
"chr8","89581181","89581477","chr8","90049588","90049888","11","468407"
"chr8","89583926","89584136","chr4","123832208","123832428","47","34248282"
"chr8","89584783","89585081","chr8","90051754","90052052","9","466971"
"chr8","89590834","89591131","chr8","90059662","90059962","6","468828"
"chr8","89596489","89596756","chr6","165384009","165384283","49","75787520"
"chr8","89616953","89617156","chr5","51275884","51276081","44","38341069"
"chr8","89628241","89628502","chr4","107227417","107227688","66","17599176"
"chr8","89650252","89650348","chr8","90119610","90119706","1","469358"
"chr8","89656192","89656277","chr8","90127387","90127472","4","471195"
"chr8","89667321","89667412","chr8","90138658","90138749","5","471337"
"chr8","89670814","89671117","chr8","90142904","90143204","9","472090"
"chr8","89673022","89673327","chr2","78493440","78493742","65","11179582"
"chr8","89673434","89673647","chr8","90145440","90145653","6","472006"
"chr8","89680884","89681174","chr8","90153227","90153517","10","472343"
"chr8","89686308","89686514","chr3","112768504","112768705","60","23082196"
"chr8","89686540","89686688","chr8","90159146","90159292","8","472606"
"chr8","89700926","89701188","chr8","90174697","90174982","28","473771"
"chr8","89715992","89716271","chr8","90190281","90190559","6","474289"
"chr8","89721056","89721317","chr8","90195509","90195803","35","474453"
"chr8","89724622","89724876","chr8","90199405","90199659","6","474783"
"chr8","89728920","89729007","chr8","90203688","90203791","16","474768"
"chr8","89734218","89734431","chr20","49637070","49637275","45","40097148"
"chr8","89738296","89738586","chr8","90211467","90211764","16","473171"
"chr8","89762806","89763091","chr8","90238303","90238590","6","475497"
"chr8","89764553","89764854","chr8","90240050","90240354","14","475497"
"chr8","89778463","89778607","chrX","38715324","38715467","29","51063139"
"chr8","89795733","89795881","chrX","47847853","47848003","37","41947880"
"chr8","89797637","89797929","chr8","90276847","90277138","3","479210"
"chr8","89826256","89826558","chr8","90306410","90306711","6","480154"
"chr8","89853626","89853913","chr8","90333143","90333430","5","479517"
"chr8","89870644","89870947","chr13","60733163","60733461","66","29137481"
"chr8","89887179","89887329","chr8","90366070","90366201","22","478891"
"chr8","89927291","89927601","chr8","90404517","90404835","15","477226"
"chr8","89932699","89932777","chr8","90409954","90410032","2","477255"
"chr8","89938800","89939068","chr3","33889164","33889417","64","56049636"
"chr8","89939487","89939536","chr5","74229524","74229567","11","15709963"
"chr8","89943429","89943701","chr8","90420671","90420942","3","477242"
"chr8","89946771","89946877","chr8","90424021","90424120","9","477250"
"chr8","89965003","89965258","chr8","90442588","90442843","2","477585"
"chr8","89973211","89973489","chr8","90450918","90451193","12","477707"
"chr8","89982935","89983240","chr8","90460682","90460983","10","477747"
"chr8","89994420","89994686","chr8","90471915","90472181","7","477495"
"chr8","90005544","90005812","chr8","90483212","90483477","7","477668"
"chr8","90006148","90006345","chr8","90483812","90484008","3","477664"
"chr8","90006824","90006939","chr8","90484476","90484586","5","477652"
"chr8","90015334","90015615","chr8","90492954","90493235","11","477620"
"chr8","90025278","90025557","chr8","90504101","90504380","5","478823"
"chr8","90027568","90027765","chr8","90506404","90506601","5","478836"
"chr8","90050627","90050932","chr8","90529959","90530261","10","479332"
"chr8","90057035","90057336","chr8","90535073","90535379","16","478038"
"chr8","90072592","90072770","chr8","90551744","90551922","6","479152"
"chr8","90073067","90073198","chr8","90552219","90552354","8","479152"
"chr8","90094336","90094638","chr8","90573450","90573757","13","479114"
"chr8","90101610","90101833","chr8","90580685","90580907","4","479075"
"chr8","90105409","90105694","chr8","90584486","90584771","6","479077"
"chr8","90108403","90108694","chr8","90587488","90587774","9","479085"
"chr8","90124835","90125123","chr8","90603581","90603863","12","478746"
"chr8","90129555","90129839","chr8","90608345","90608629","11","478790"
"chr8","90131090","90131302","chr8","90609881","90610093","8","478791"
"chr8","90132741","90133027","chr8","90611504","90611813","24","478763"
"chr8","90134001","90134218","chr8","90612786","90613032","34","478785"
"chr8","90149913","90150208","chr8","90628703","90629006","15","478790"
"chr8","90153970","90154262","chr8","90632775","90633054","20","478805"
"chr8","90179567","90179853","chr8","90656818","90657109","36","477251"
"chr8","90214213","90214517","chr8","90692248","90692536","20","478035"
"chr8","90238459","90238779","chr8","90716651","90716971","7","478192"
"chr8","90244390","90244611","chr8","90725354","90725568","11","480964"
"chr8","90246608","90246906","chr8","90727577","90727874","7","480969"
"chr8","90249574","90249891","chr8","90730477","90730794","11","480903"
"chr8","90256279","90256423","chr8","90737045","90737184","9","480766"
"chr8","90257653","90257791","chr8","90738428","90738564","7","480775"
"chr8","90317306","90317418","chr8","90799978","90800083","8","482672"
"chr8","90495704","90495825","chr3","82010722","82010844","20","8484982"
"chr8","90603095","90603401","chr8","91086550","91086856","4","483455"
"chr8","90707394","90707689","chr8","91190958","91191252","13","483564"
"chr8","90709480","90709811","chr8","91193059","91193396","13","483579"
"chr8","90753880","90754149","chr8","91237269","91237538","5","483389"
"chr8","90772924","90773165","chr8","91255459","91255700","3","482535"
"chr8","90832027","90832153","chr9","21976139","21976266","23","68855888"
"chr8","90832191","90832345","chr1","146862849","146862999","32","56030658"
"chr8","90927736","90928017","chr16","65971615","65971908","62","24956121"
"chr8","90928799","90929092","chr8","91409623","91409931","23","480824"
"chr8","90960014","90960189","chr8","91440599","91440767","14","480585"
"chr8","90960217","90960326","chr8","91440797","91440904","6","480580"
"chr8","91024822","91025141","chr8","91505136","91505438","25","480314"
"chr8","91053892","91054216","chr8","91535169","91535477","24","481277"
"chr8","91069899","91070217","chr8","91551206","91551499","34","481307"
"chr8","91080197","91080490","chr8","91561936","91562227","8","481739"
"chr8","91161404","91161584","chr8","91643873","91644055","14","482469"
"chr8","91173482","91173772","chr19","4649855","4650147","73","86523627"
"chr8","91230369","91230586","chr19","51147108","51147319","54","40083261"
"chr8","91277173","91277484","chr8","91760279","91760590","5","483106"
"chr8","91327376","91327687","chr8","91811020","91811327","16","483644"
"chr8","91390476","91390783","chr8","91874656","91874963","10","484180"
"chr8","91397315","91397617","chr8","91881484","91881786","4","484169"
"chr8","91434335","91434511","chr8","91918098","91918264","15","483763"
"chr8","91439359","91439646","chr8","91923111","91923396","12","483752"
"chr8","91449950","91450238","chr8","91933713","91934004","7","483763"
"chr8","91495271","91495559","chr8","91979731","91980000","27","484460"
"chr8","91499181","91499482","chr8","91983865","91984138","59","484684"
"chr8","91506954","91507242","chr8","91991395","91991687","5","484441"
"chr8","91513667","91513991","chr8","91997382","91997706","11","483715"
"chr8","91586870","91587167","chr8","92071768","92072067","12","484898"
"chr8","91594201","91594315","chr8","92085378","92085492","0","491177"
"chr8","91597700","91597848","chr6","12418900","12419048","26","79178800"
"chr8","91612172","91612454","chr8","92103349","92103631","3","491177"
"chr8","91615140","91615390","chr8","92106315","92106565","0","491175"
"chr8","91621823","91622115","chr8","92113014","92113306","6","491191"
"chr8","91723948","91724160","chr8","90483812","90484008","54","1240136"
"chr8","91752223","91752501","chr10","12968245","12968520","61","78783978"
"chr8","91798496","91798607","chr7","148664648","148664755","20","56866152"
"chr8","92007687","92007972","chr8","92378542","92378826","6","370855"
"chr8","92019071","92019376","chr8","92389906","92390216","12","370835"
"chr8","92070172","92070472","chr8","92446293","92446620","31","376121"
"chr8","92096964","92097263","chr8","92473477","92473776","3","376513"
"chr8","92180942","92181006","chr8","92567790","92567854","1","386848"
"chr8","92246337","92246641","chr8","92632580","92632878","18","386243"
"chr8","92334432","92334635","chr11","123136014","123136217","53","30801582"
"chr8","92356986","92357274","chr8","92740424","92740719","16","383438"
"chr8","92407163","92407450","chr8","92790612","92790899","5","383449"
"chr8","92410218","92410544","chr8","92793676","92793967","49","383458"
"chr8","92432320","92432628","chr8","92817356","92817653","19","385036"
"chr8","92458237","92458533","chr8","92843500","92843796","12","385263"
"chr8","92475517","92475815","chr8","92860751","92861049","13","385234"
"chr8","92485195","92485493","chr8","92870425","92870723","10","385230"
"chr8","92487079","92487359","chr8","92872320","92872602","8","385241"
"chr8","92488148","92488457","chr8","92873420","92873700","39","385272"
"chr8","92488667","92488929","chr8","92873910","92874181","13","385243"
"chr8","92494031","92494324","chr8","92879276","92879569","8","385245"
"chr8","92499693","92499947","chr8","92883765","92884019","6","384072"
"chr8","92504503","92504823","chr8","92888526","92888828","21","384023"
"chr8","92504972","92505146","chr8","92888995","92889169","2","384023"
"chr8","92505304","92505541","chr8","92889327","92889563","8","384023"
"chr8","92510557","92510622","chr6","150788522","150788579","17","58277965"
"chr8","92513492","92513596","chr8","92896223","92896335","11","382731"
"chr8","92514636","92514760","chr8","92897400","92897530","9","382764"
"chr8","92515860","92516021","chr8","92898616","92898776","9","382756"
"chr8","92518951","92519264","chr8","92903288","92903595","15","384337"
"chr8","92523062","92523352","chr8","92907358","92907647","6","384296"
"chr8","92529004","92529182","chr8","92913552","92913717","22","384548"
"chr8","92529649","92529931","chr8","92914165","92914463","24","384516"
"chr8","92534816","92535113","chr8","92919907","92920204","15","385091"
"chr8","92548821","92549129","chr8","92935646","92935954","7","386825"
"chr8","92550311","92550618","chr8","92937151","92937459","23","386840"
"chr8","92550626","92550922","chr8","92937468","92937778","20","386842"
"chr8","92556990","92557166","chr5","159139975","159140150","31","66582985"
"chr8","92566666","92566828","chr8","92951340","92951502","2","384674"
"chr8","92569040","92569340","chr8","92953607","92953907","8","384567"
"chr8","92569707","92570017","chr8","92954266","92954577","9","384559"
"chr8","92574266","92574488","chr8","13064928","13065153","46","79509338"
"chr8","92577109","92577423","chr8","92961562","92961876","10","384453"
"chr8","92585873","92586050","chr8","92970703","92970880","2","384830"
"chr8","92591050","92591348","chr8","92975872","92976151","39","384822"
"chr8","92591850","92592129","chr8","92976632","92976921","17","384782"
"chr8","92592200","92592504","chr13","92870661","92870964","58","278461"
"chr8","92592869","92592997","chr8","92977630","92977758","3","384761"
"chr8","92593308","92593473","chr8","92978067","92978241","15","384759"
"chr8","92609345","92609655","chr8","92994623","92994907","31","385278"
"chr8","92612295","92612575","chr8","92997551","92997830","7","385256"
"chr8","92614346","92614489","chr1","25816259","25816404","27","66798087"
"chr8","92614490","92614783","chr8","93000054","93000347","7","385564"
"chr8","92614784","92614959","chr8","93000355","93000524","12","385571"
"chr8","92618393","92618672","chr8","93003984","93004263","5","385591"
"chr8","92626266","92626553","chr4","33245653","33245929","72","59380613"
"chr8","92629093","92629374","chr15","13558721","13559012","55","79070372"
"chr8","92633438","92633715","chr8","93019601","93019873","10","386163"
"chr8","92635814","92636122","chr2","183797251","183797561","52","91161437"
"chr8","92637310","92637593","chr8","93023577","93023862","11","386267"
"chr8","92638263","92638442","chr2","43232993","43233164","45","49405270"
"chr8","92652842","92653128","chr7","30149330","30149627","69","62503512"
"chr8","92655801","92656120","chr8","93042453","93042768","16","386652"
"chr8","92657685","92657848","chr8","93044321","93044500","18","386636"
"chr8","92658153","92658272","chr8","93045118","93045238","5","386965"
"chr8","92658300","92658606","chr8","93045266","93045571","11","386966"
"chr8","92660891","92661032","chr8","93047826","93047966","4","386935"
"chr8","92663587","92663869","chr8","93051777","93052059","6","388190"
"chr8","92663899","92664063","chr8","93052092","93052263","13","388193"
"chr8","92667546","92667856","chr8","93056231","93056541","8","388685"
"chr8","92677920","92678161","chr8","93067706","93067973","33","389786"
"chr8","92681545","92681716","chr8","93072221","93072383","12","390676"
"chr8","92682023","92682177","chr8","93072698","93072851","4","390675"
"chr8","92682607","92682893","chr8","93073599","93073884","8","390992"
"chr8","92685708","92685911","chr8","93077102","93077303","8","391394"
"chr8","92694111","92694275","chr8","93092661","93092825","2","398550"
"chr8","92695283","92695367","chr8","93093840","93093924","1","398557"
"chr8","92703132","92703296","chr8","93100313","93100477","13","397181"
"chr8","92703919","92703931","chr13","107299184","107299196","0","14595265"
"chr8","92711125","92711397","chr8","93108291","93108592","37","397166"
"chr8","92713516","92713709","chr8","93111062","93111239","23","397546"
"chr8","92714001","92714142","chr1","113173705","113173839","27","20459704"
"chr8","92714716","92714971","chr20","66629646","66629906","53","26085070"
"chr8","92726560","92726736","chr8","93121560","93121736","2","395000"
"chr8","92728819","92729088","chr8","93125105","93125383","23","396286"
"chr8","92730673","92730988","chr8","93126956","93127264","7","396283"
"chr8","92736095","92736388","chr8","93132286","93132570","19","396191"
"chr8","92776587","92776883","chr8","93173286","93173572","24","396699"
"chr8","92781429","92781738","chr8","93178134","93178438","17","396705"
"chr8","92783371","92783660","chr6","50494463","50494746","55","42288908"
"chr8","92796431","92796709","chr8","93192766","93193050","22","396335"
"chr8","92798277","92798435","chr8","93200432","93200589","4","402155"
"chr8","92802220","92802532","chr8","93196984","93197301","18","394764"
"chr8","92808549","92808850","chr8","93206455","93206763","16","397906"
"chr8","92809674","92809839","chr8","93198028","93198193","6","388354"
"chr8","92817102","92817370","chr8","93215500","93215768","13","398398"
"chr8","92821436","92821743","chr8","93226324","93226633","10","404888"
"chr8","92829884","92830194","chr8","93222883","93223194","4","392999"
"chr8","92831329","92831608","chr8","93231617","93231895","6","400288"
"chr8","92860609","92860899","chr8","93263783","93264074","11","403174"
"chr8","92870868","92871174","chr8","93274324","93274631","12","403456"
"chr8","92887989","92888282","chr8","93292710","93293004","7","404721"
"chr8","92889346","92889663","chr4","152226280","152226592","66","59336934"
"chr8","92894575","92894886","chr8","93298887","93299197","7","404312"
"chr8","92898410","92898725","chr8","93303004","93303313","14","404594"
"chr8","92932862","92933106","chr8","93336970","93337214","14","404108"
"chr8","92936891","92937197","chr8","93340981","93341288","7","404090"
"chr8","92938998","92939286","chr8","93344528","93344843","37","405530"
"chr8","92946724","92947040","chr8","93352260","93352573","11","405536"
"chr8","92962329","92962643","chr8","93367774","93368083","17","405445"
"chr8","92967655","92967945","chr15","40728892","40729179","63","52238763"
"chr8","92971534","92971847","chr8","93376901","93377216","7","405367"
"chr8","92972687","92972980","chr8","93378004","93378291","16","405317"
"chr8","92973228","92973536","chr8","93378522","93378853","40","405294"
"chr8","92988199","92988313","chrX","6554585","6554688","26","86433614"
"chr8","92988344","92988525","chr16","26150901","26151077","38","66837443"
"chr8","92988737","92988984","chr11","128017936","128018179","66","35029199"
"chr8","92990708","92990880","chr8","93396864","93397034","7","406156"
"chr8","92992661","92992962","chr1","130713307","130713605","59","37720646"
"chr8","93005177","93005316","chr7","53192193","53192325","36","39812984"
"chr8","93006632","93006922","chr8","93413111","93413405","11","406479"
"chr8","93007324","93007382","chr8","93413808","93413870","8","406484"
"chr8","93007691","93007828","chr8","93414180","93414317","1","406489"
"chr8","93023120","93023417","chr8","93429398","93429695","10","406278"
"chr8","93027417","93027607","chr8","93433689","93433873","13","406272"
"chr8","93032717","93032984","chr8","93439062","93439351","24","406345"
"chr8","93033873","93034185","chr8","93440212","93440515","17","406339"
"chr8","93040784","93041083","chr8","93447069","93447353","23","406285"
"chr8","93043580","93043895","chr4","102524848","102525163","59","9481268"
"chr8","93049999","93050294","chr16","44745004","44745304","60","48304995"
"chr8","93054433","93054736","chr8","93460301","93460611","14","405868"
"chr8","93059229","93059512","chr8","93465351","93465625","13","406122"
"chr8","93059828","93060125","chr8","93465941","93466238","5","406113"
"chr8","93066672","93066952","chr8","93473107","93473388","8","406435"
"chr8","93077686","93077862","chr8","93484129","93484313","11","406443"
"chr8","93080265","93080551","chr8","93486841","93487119","15","406576"
"chr8","93094839","93095098","chr8","93500944","93501203","5","406105"
"chr8","93155830","93155995","chr14","63608556","63608715","24","29547274"
"chr8","93156053","93156175","chr2","87140260","87140382","15","6015793"
"chr8","93157883","93158203","chr8","93563960","93564262","23","406077"
"chr8","93163574","93163872","chr8","93569616","93569922","17","406042"
"chr8","93183314","93183612","chr8","93588442","93588740","6","405128"
"chr8","93216408","93216703","chr8","93621672","93621970","12","405264"
"chr8","93216774","93216942","chr8","93622041","93622223","23","405267"
"chr8","93217864","93217972","chr8","93623607","93623715","2","405743"
"chr8","93217981","93218050","chr1","94918345","94918416","18","1700364"
"chr8","93222076","93222356","chr8","93628151","93628459","30","406075"
"chr8","93225875","93226041","chr8","93631994","93632161","5","406119"
"chr8","93292695","93292990","chr8","93699755","93700050","7","407060"
"chr8","93314437","93314755","chr8","93720880","93721198","11","406443"
"chr8","93491522","93491794","chr8","93905905","93906177","4","414383"
"chr8","93508223","93508507","chr8","93923218","93923502","6","414995"
"chr8","93542226","93542534","chr8","93956871","93957179","7","414645"
"chr8","93547089","93547390","chr8","93961768","93962070","3","414679"
"chr8","93548063","93548339","chr8","93962744","93963021","6","414681"
"chr8","93550936","93551200","chr8","93965617","93965888","10","414681"
"chr8","93555353","93555615","chr8","93970177","93970434","11","414824"
"chr8","93564654","93564950","chr8","93979286","93979582","3","414632"
"chr8","93569050","93569352","chr8","93983529","93983833","7","414479"
"chr8","93570549","93570745","chr8","93985030","93985226","6","414481"
"chr8","93571101","93571177","chr8","93985582","93985658","2","414481"
"chr8","93589470","93589759","chr8","94004630","94004908","18","415160"
"chr8","93643078","93643351","chr8","94059375","94059677","37","416297"
"chr8","93666897","93667145","chr8","94082626","94082874","2","415729"
"chr8","93686502","93686824","chr8","94104676","94104968","33","418174"
"chr8","93686870","93687158","chr8","94105009","94105287","17","418139"
"chr8","93693366","93693594","chr8","94111196","94111433","13","417830"
"chr8","93699256","93699357","chr15","51691816","51691919","18","42007440"
"chr8","93699897","93700185","chr2","147630797","147631078","56","53930900"
"chr8","93710644","93710930","chr8","94129051","94129365","34","418407"
"chr8","93711974","93712182","chr8","94130399","94130607","3","418425"
"chr8","93713992","93714273","chr8","94132697","94132974","6","418705"
"chr8","93719862","93720000","chr8","94138574","94138715","7","418712"
"chr8","93720276","93720444","chr8","94138991","94139158","3","418715"
"chr8","93725603","93725908","chr8","94144656","94144959","11","419053"
"chr8","93728292","93728573","chr8","94147622","94147919","22","419330"
"chr8","93744230","93744534","chr2","97022915","97023209","63","3278685"
"chr8","93750285","93750574","chr8","94170501","94170788","13","420216"
"chr8","93751812","93752132","chr8","94172033","94172340","40","420221"
"chr8","93768909","93769025","chr20","629915","630029","25","93138994"
"chr8","93784379","93784681","chr8","94207102","94207404","8","422723"
"chr8","93801207","93801467","chr8","94223875","94224138","7","422668"
"chr8","93870991","93871302","chr8","94293049","94293360","8","422058"
"chr8","93877838","93878154","chr8","94299805","94300121","10","421967"
"chr8","93893466","93893767","chr8","94315039","94315332","18","421573"
"chr8","93899426","93899720","chr8","94320927","94321220","5","421501"
"chr8","93908747","93909028","chr8","94330282","94330563","7","421535"
"chr8","93943305","93943610","chr8","94358179","94358484","8","414874"
"chr8","93946353","93946676","chr5","52798229","52798554","80","41148124"
"chr8","93955246","93955533","chr8","94370131","94370418","5","414885"
"chr8","93976811","93976983","chr8","94391703","94391869","8","414892"
"chr8","93977280","93977416","chr8","94392172","94392308","4","414892"
"chr8","93978114","93978400","chr8","94393001","94393292","11","414887"
"chr8","93989883","93990158","chr8","94404705","94404985","6","414822"
"chr8","93995550","93995851","chr8","94410159","94410458","7","414609"
"chr8","94001598","94001908","chr8","94415376","94415686","15","413778"
"chr8","94019561","94019854","chr1","124579632","124579923","68","30560071"
"chr8","94030173","94030450","chr8","94443526","94443804","10","413353"
"chr8","94037618","94037924","chr8","94450985","94451287","17","413367"
"chr8","94056412","94056667","chr8","94470173","94470428","5","413761"
"chr8","94068694","94068979","chr8","94484731","94485016","5","416037"
"chr8","94167963","94168129","chr8","94583423","94583589","4","415460"
"chr8","94197567","94197800","chr8","94620429","94620662","13","422862"
"chr8","94231517","94231812","chr8","94653135","94653429","4","421618"
"chr8","94253546","94253863","chr8","94674849","94675167","10","421303"
"chr8","94306792","94307091","chr8","94731850","94732146","15","425058"
"chr8","94386849","94387136","chr8","94815267","94815569","20","428418"
"chr8","94393924","94394222","chr8","94822352","94822650","3","428428"
"chr8","94441317","94441545","chr3","10694186","10694412","8","83747131"
"chr8","94449774","94449922","chr1","16831217","16831357","34","77618557"
"chr8","94449998","94450301","chr8","94863231","94863529","12","413233"
"chr8","94450345","94450627","chr8","94863573","94863848","18","413228"
"chr8","94476997","94477320","chr8","94885946","94886266","13","408949"
"chr8","94493494","94493774","chr8","94909549","94909828","6","416055"
"chr8","94508435","94508730","chr8","94924465","94924762","7","416030"
"chr8","94514385","94514677","chr8","94930720","94931012","6","416335"
"chr8","94527142","94527442","chr8","94943243","94943544","12","416101"
"chr8","94537359","94537491","chr8","94953550","94953682","2","416191"
"chr8","94582001","94582259","chr5","99198268","99198530","64","4616267"
"chr8","94626329","94626605","chr8","95042034","95042310","4","415705"
"chr8","94652179","94652465","chr8","95067831","95068114","15","415652"
"chr8","94661146","94661432","chr8","95076811","95077097","9","415665"
"chr8","94675989","94676301","chr8","95091052","95091364","2","415063"
"chr8","94694099","94694410","chr8","95110204","95110523","11","416105"
"chr8","94702448","94702736","chr8","95118592","95118885","14","416144"
"chr8","94723944","94724230","chr14","77748738","77749030","61","16975206"
"chr8","94740088","94740210","chr8","95162107","95162229","1","422019"
"chr8","94742301","94742574","chr8","95164362","95164638","11","422061"
"chr8","94745559","94745837","chr8","95167937","95168211","8","422378"
"chr8","94750506","94750696","chr8","95173156","95173342","8","422650"
"chr8","94766944","94767247","chr8","95189713","95190015","5","422769"
"chr8","94786014","94786290","chr8","95208650","95208928","10","422636"
"chr8","94793840","94794167","chr8","95216480","95216791","18","422640"
"chr8","94798884","94799183","chr8","95221521","95221824","10","422637"
"chr8","94801638","94801887","chr8","95224283","95224542","13","422645"
"chr8","94809691","94810004","chr8","95234171","95234491","12","424480"
"chr8","94820779","94820935","chr19","8561853","8561997","42","86258926"
"chr8","94824664","94824962","chr8","95252558","95252866","18","427894"
"chr8","94852950","94853051","chr1","21838633","21838735","24","73014317"
"chr8","94857351","94857625","chr8","95285910","95286185","16","428559"
"chr8","94863166","94863436","chr8","95291743","95292006","12","428577"
"chr8","94867369","94867680","chr8","95295918","95296226","9","428549"
"chr8","94911518","94911833","chr8","95346761","95347073","12","435243"
"chr8","94912826","94913118","chr8","95348068","95348360","3","435242"
"chr8","94920503","94920815","chr8","95355742","95356053","5","435239"
"chr8","94936952","94937120","chr8","95372824","95372992","4","435872"
"chr8","94948107","94948393","chr8","95383934","95384220","12","435827"
"chr8","95012023","95012325","chr8","95445798","95446099","9","433775"
"chr8","95014712","95014986","chr8","95448483","95448753","7","433771"
"chr8","95018975","95019280","chr8","95452688","95452993","5","433713"
"chr8","95020747","95021011","chr8","95454469","95454736","7","433722"
"chr8","95032578","95032870","chr8","95465703","95465995","3","433125"
"chr8","95048290","95048521","chr8","95484101","95484325","9","435811"
"chr8","95054970","95055071","chr3","38092595","38092692","29","56962375"
"chr8","95077697","95077993","chr8","95507443","95507743","11","429746"
"chr8","95078144","95078436","chr8","95507890","95508184","7","429746"
"chr8","95117200","95117513","chr8","95546778","95547091","7","429578"
"chr8","95123305","95123607","chr8","95552857","95553159","8","429552"
"chr8","95136415","95136567","chr8","95565736","95565891","3","429321"
"chr8","95163711","95163988","chr8","95593187","95593472","9","429476"
"chr8","95165354","95165619","chr8","95594758","95595046","28","429404"
"chr8","95167125","95167301","chr8","95596545","95596720","7","429420"
"chr8","95181198","95181503","chr3","153060925","153061233","54","57879727"
"chr8","95186858","95187163","chr3","153060925","153061233","54","57874067"
"chr8","95194279","95194578","chrX","3136679","3136979","61","92057600"
"chr8","95202118","95202407","chr15","99175708","99175995","55","3973590"
"chr8","95206154","95206443","chr8","95629939","95630231","7","423785"
"chr8","95232325","95232495","chr8","95654408","95654560","21","422083"
"chr8","95248316","95248599","chr8","95670732","95671015","5","422416"
"chr8","95255873","95256094","chr8","95678203","95678424","5","422330"
"chr8","95272255","95272530","chr8","95694574","95694848","10","422319"
"chr8","95291227","95291516","chr8","95713590","95713878","8","422363"
"chr8","95313998","95314113","chr8","95736458","95736573","5","422460"
"chr8","95347832","95348011","chr8","95775083","95775274","13","427251"
"chr8","95348239","95348296","chr8","95775502","95775559","0","427263"
"chr8","95350612","95350763","chr8","95777875","95778026","1","427263"
"chr8","95357211","95357515","chr13","116770396","116770699","64","21413185"
"chr8","95407290","95407603","chr8","95834643","95834953","5","427353"
"chr8","95435890","95436185","chr8","95863064","95863359","2","427174"
"chr8","95450192","95450428","chr8","95877669","95877893","20","427477"
"chr8","95460997","95461293","chr8","95888420","95888724","17","427423"
"chr8","95494661","95494969","chr8","95918243","95918552","7","423582"
"chr8","95507048","95507355","chr8","95930569","95930869","14","423521"
"chr8","95522777","95522908","chr8","95946480","95946600","12","423703"
"chr8","95532821","95532956","chr8","95956569","95956704","3","423748"
"chr8","95535852","95536017","chr8","95959599","95959773","11","423747"
"chr8","95548586","95548896","chr8","95973740","95974034","27","425154"
"chr8","95548900","95549242","chr8","95974050","95974372","38","425150"
"chr8","95568002","95568105","chr8","95992860","95992965","9","424858"
"chr8","95586280","95586590","chr8","96011454","96011764","10","425174"
"chr8","95586986","95587282","chr1","202328262","202328552","45","106741276"
"chr8","95593626","95593931","chr4","36126419","36126732","55","59467207"
"chr8","95596015","95596315","chr8","96020201","96020515","30","424186"
"chr8","95599140","95599410","chr6","65483851","65484133","58","30115289"
"chr8","95602642","95602725","chr8","96027204","96027287","2","424562"
"chr8","95605391","95605694","chr8","47765516","47765819","54","47839875"
"chr8","95628385","95628665","chr15","95380211","95380490","54","248174"
"chr8","95632159","95632328","chr8","96055428","96055594","8","423269"
"chr8","95636608","95636917","chr8","96059151","96059460","10","422543"
"chr8","95646746","95647053","chr8","96069891","96070190","15","423145"
"chr8","95658624","95658867","chr8","96074546","96074762","29","415922"
"chr8","95668781","95668892","chr8","96085052","96085163","3","416271"
"chr8","95669267","95669295","chr14","61667389","61667418","6","34001878"
"chr8","95669296","95669449","chr7","135930852","135930999","28","40261556"
"chr8","95675503","95675804","chr8","96091775","96092059","26","416272"
"chr8","95680723","95681054","chr7","126153184","126153502","72","30472461"
"chr8","95699122","95699313","chr8","96115254","96115464","28","416132"
"chr8","95705069","95705301","chr8","96121225","96121460","8","416156"
"chr8","95723058","95723341","chr8","96140052","96140339","10","416994"
"chr8","95736767","95737059","chr8","96153729","96154021","10","416962"
"chr8","95742339","95742642","chr15","7588580","7588890","67","88153759"
"chr8","95744374","95744667","chr8","96161339","96161636","10","416965"
"chr8","95764978","95765268","chr8","96182978","96183268","11","418000"
"chr8","95792178","95792388","chr8","96209385","96209597","4","417207"
"chr8","95822849","95823131","chr8","96240426","96240708","1","417577"
"chr8","95824025","95824274","chr8","96241606","96241856","7","417581"
"chr8","95829925","95830087","chr8","96247464","96247627","5","417539"
"chr8","95842592","95842876","chr6","74294843","74295131","51","21547749"
"chr8","95848535","95848826","chr8","96266334","96266630","9","417799"
"chr8","95850072","95850361","chr8","96267559","96267848","6","417487"
"chr8","95854577","95854755","chr8","96272072","96272250","10","417495"
"chr8","95858098","95858389","chr8","96275603","96275894","3","417505"
"chr8","95865664","95865971","chr8","96282757","96283037","34","417093"
"chr8","95871297","95871549","chr8","96288409","96288661","7","417112"
"chr8","95876304","95876595","chr8","96293418","96293709","5","417114"
"chr8","95877500","95877814","chr8","96294610","96294927","16","417110"
"chr8","95886717","95887002","chr8","96303660","96303943","5","416943"
"chr8","95894758","95894927","chr8","96310286","96310455","5","415528"
"chr8","95894928","95895248","chr8","96310456","96310784","19","415528"
"chr8","95895249","95895376","chr19","22224132","22224245","34","73671117"
"chr8","95897085","95897211","chr8","2948906","2949031","21","92948179"
"chr8","95911908","95911926","chr5","19104531","19104548","3","76807377"
"chr8","95912230","95912423","chr8","96327701","96327897","14","415471"
"chr8","95923169","95923466","chr8","96338485","96338789","12","415316"
"chr8","95925401","95925561","chr3","87540253","87540414","39","8385148"
"chr8","95925589","95925602","chr7","46789151","46789165","3","49136438"
"chr8","95931263","95931551","chr8","96346134","96346430","14","414871"
"chr8","95943647","95943982","chr8","34777212","34777529","80","61166435"
"chr8","95949665","95949783","chr8","96364975","96365107","15","415310"
"chr8","95949784","95949851","chr1","202541422","202541489","9","106591638"
"chr8","95964268","95964573","chr8","96373732","96374037","7","409464"
"chr8","95966420","95966694","chr1","121994182","121994464","57","26027762"
"chr8","95971763","95972061","chr9","118375917","118376218","66","22404154"
"chr8","95988026","95988310","chr8","96397422","96397716","16","409396"
"chr8","96072406","96072719","chr8","96482881","96483188","19","410475"
"chr8","96093975","96094256","chr7","89468182","89468470","80","6625793"
"chr8","96168152","96168461","chr8","96579592","96579901","8","411440"
"chr8","96190930","96191024","chr8","96602377","96602485","14","411447"
"chr8","96199649","96199862","chr2","155800670","155800868","59","59601021"
"chr8","96219082","96219376","chr8","96630746","96631043","11","411664"
"chr8","96235862","96235968","chrX","90918797","90918904","17","5317065"
"chr8","96236683","96236989","chr8","96647497","96647805","8","410814"
"chr8","96275958","96276184","chr8","96688952","96689179","14","412994"
"chr8","96280918","96281226","chr8","96693938","96694237","19","413020"
"chr8","96281428","96281742","chr8","96694477","96694791","13","413049"
"chr8","96287858","96288023","chr8","96700897","96701061","5","413039"
"chr8","96294266","96294579","chr8","96707439","96707738","22","413173"
"chr8","96326296","96326388","chr11","110032530","110032623","16","13706234"
"chr8","96329914","96330081","chr3","160740675","160740837","36","64410761"
"chr8","96359056","96359354","chr8","96770625","96770934","19","411569"
"chr8","96366255","96366548","chr8","96777681","96777981","10","411426"
"chr8","96368360","96368584","chr8","96779480","96779704","8","411120"
"chr8","96373602","96373878","chr8","96784713","96785010","24","411111"
"chr8","96381756","96382076","chr8","96792342","96792653","15","410586"
"chr8","96416391","96416692","chr16","23564878","23565178","52","72851513"
"chr8","96429861","96430164","chr3","75035578","75035867","64","21394283"
"chr8","96543897","96544205","chr8","96954019","96954326","8","410122"
"chr8","96695314","96695612","chr11","28795229","28795528","60","67900085"
"chr8","96763340","96763644","chr8","97174128","97174430","6","410788"
"chr8","96937925","96938074","chr10","73205193","73205337","29","23732732"
"chr8","96948423","96948587","chr16","4628208","4628361","34","92320215"
"chr8","96961203","96961530","chr8","97369473","97369803","12","408270"
"chr8","97061598","97061869","chr8","97469024","97469295","5","407426"
"chr8","97066017","97066318","chr8","97474069","97474371","8","408052"
"chr8","97066569","97066881","chr8","97474618","97474921","15","408049"
"chr8","97069338","97069673","chr8","97477288","97477621","6","407950"
"chr8","97115492","97115701","chr3","79946207","79946409","44","17169285"
"chr8","97194980","97195263","chr8","97605031","97605315","5","410051"
"chr8","97199517","97199801","chr8","97609882","97610164","8","410365"
"chr8","97200578","97200744","chr3","160740675","160740837","31","63540097"
"chr8","97200752","97200818","chrX","62991691","62991756","15","34209061"
"chr8","97204114","97204416","chr8","97614504","97614806","9","410390"
"chr8","97209806","97210098","chr8","97620409","97620687","21","410603"
"chr8","97229846","97230141","chr8","97639862","97640154","8","410016"
"chr8","97235999","97236230","chr8","97647479","97647710","12","411480"
"chr8","97246138","97246445","chr11","117703249","117703555","52","20457111"
"chr8","97259859","97260118","chr4","103392528","103392783","57","6132669"
"chr8","97265922","97266203","chr8","97673494","97673772","9","407572"
"chr8","97266800","97267039","chr8","97674394","97674633","8","407594"
"chr8","97267306","97267594","chr8","97674900","97675188","8","407594"
"chr8","97277152","97277428","chr8","97684894","97685179","18","407742"
"chr8","97277524","97277816","chr8","97685275","97685566","8","407751"
"chr8","97290429","97290742","chr8","97700912","97701227","23","410483"
"chr8","97291146","97291428","chr8","97701651","97701933","5","410505"
"chr8","97295143","97295350","chr8","97704042","97704254","11","408899"
"chr8","97302574","97302716","chr8","97712048","97712190","3","409474"
"chr8","97303020","97303240","chr8","97712490","97712685","30","409470"
"chr8","97306640","97306940","chr8","97716076","97716376","8","409436"
"chr8","97320020","97320314","chr8","97729469","97729763","5","409449"
"chr8","97323046","97323220","chr8","97732492","97732666","3","409446"
"chr8","97335427","97335633","chr8","97744248","97744454","5","408821"
"chr8","97335744","97336051","chr8","97744891","97745191","21","409147"
"chr8","97337094","97337390","chr8","97746225","97746524","8","409131"
"chr8","97343062","97343323","chr8","97753257","97753519","6","410195"
"chr8","97343581","97343624","chr8","97753789","97753835","3","410208"
"chr8","97343686","97343968","chr8","97753897","97754176","5","410211"
"chr8","97361667","97361958","chr1","215635461","215635762","61","118273794"
"chr8","97368417","97368686","chr8","97784644","97784913","4","416227"
"chr8","97375747","97375872","chr8","97794660","97794781","6","418913"
"chr8","97385625","97385898","chr8","97804749","97805013","13","419124"
"chr8","97385947","97386085","chr8","97805063","97805200","4","419116"
"chr8","97391495","97391787","chr8","97812276","97812574","10","420781"
"chr8","97397603","97397919","chrX","96318063","96318367","64","1079540"
"chr8","97404542","97404843","chr8","97825832","97826134","9","421290"
"chr8","97413352","97413628","chr8","97834881","97835162","12","421529"
"chr8","97424267","97424413","chr11","103384632","103384781","34","5960365"
"chr8","97435400","97435691","chr8","97854566","97854867","16","419166"
"chr8","97438361","97438602","chr8","97857871","97858115","9","419510"
"chr8","97455189","97455497","chr8","97874716","97875021","14","419527"
"chr8","97471685","97471957","chr8","97892270","97892567","31","420585"
"chr8","97487264","97487570","chr8","97909704","97910004","19","422440"
"chr8","97491266","97491439","chr4","33972900","33973074","39","63518366"
"chr8","97507409","97507544","chr20","50266909","50267045","32","47240500"
"chr8","97507566","97507699","chr8","97929798","97929916","17","422232"
"chr8","97508035","97508160","chr5","74299748","74299872","22","23208287"
"chr8","97509916","97510215","chr8","97932110","97932408","12","422194"
"chr8","97514122","97514420","chr8","97936559","97936854","9","422437"
"chr8","97517344","97517568","chr18","16392466","16392684","38","81124878"
"chr8","97528775","97529052","chr8","97951450","97951727","3","422675"
"chr8","97529053","97529349","chr8","97951728","97952035","16","422675"
"chr8","97548142","97548444","chr8","97971171","97971482","14","423029"
"chr8","97553617","97553892","chr8","97975528","97975804","8","421911"
"chr8","97570469","97570761","chr8","97992334","97992632","11","421865"
"chr8","97576654","97576803","chr8","97998535","97998684","3","421881"
"chr8","97576843","97576965","chr8","97998728","97998850","3","421885"
"chr8","97579778","97580072","chr8","98001665","98001958","4","421887"
"chr8","97588075","97588362","chr8","98009861","98010152","7","421786"
"chr8","97610534","97610641","chr8","98032236","98032355","14","421702"
"chr8","97610642","97610949","chr8","98032356","98032656","12","421714"
"chr8","97610950","97611098","chr8","98032657","98032805","2","421707"
"chr8","97626838","97627181","chr8","98044349","98044693","6","417511"
"chr8","97654748","97655053","chr8","98072616","98072924","6","417868"
"chr8","97671272","97671415","chr7","95692149","95692288","32","1979123"
"chr8","97672433","97672566","chr8","98090651","98090785","4","418218"
"chr8","97684083","97684191","chr9","85815916","85816024","18","11868167"
"chr8","97713887","97714000","chr1","202200771","202200886","22","104486884"
"chr8","97723333","97723636","chr8","98142473","98142775","8","419140"
"chr8","97748586","97748896","chr8","98172060","98172361","16","423474"
"chr8","97764144","97764326","chr8","98188906","98189101","15","424762"
"chr8","97765335","97765557","chr8","98190106","98190332","12","424771"
"chr8","97766659","97766973","chr8","98191435","98191751","7","424776"
"chr8","97777483","97777772","chr8","98201978","98202267","6","424495"
"chr8","97811573","97811654","chr8","98236642","98236723","1","425069"
"chr8","97812036","97812347","chr8","98237125","98237436","3","425089"
"chr8","97823063","97823370","chr8","98248173","98248488","16","425110"
"chr8","97826476","97826681","chr8","98251744","98251949","2","425268"
"chr8","97827906","97828217","chr8","98253181","98253489","10","425275"
"chr8","97830540","97830829","chr8","98255820","98256120","17","425280"
"chr8","97838327","97838623","chr13","24028680","24028977","44","73809647"
"chr8","97868893","97869189","chr8","98293210","98293512","13","424317"
"chr8","97919692","97919989","chr8","98344500","98344799","12","424808"
"chr8","97929099","97929410","chr8","98353322","98353631","10","424223"
"chr8","97936600","97936747","chr8","98360887","98361035","5","424287"
"chr8","97945445","97945662","chr2","77969409","77969619","43","19976036"
"chr8","97952973","97953283","chr8","98377232","98377542","10","424259"
"chr8","97987377","97987528","chr8","98411902","98412053","4","424525"
"chr8","97987708","97987850","chr8","98412233","98412375","3","424525"
"chr8","98023022","98023331","chr8","98447258","98447567","4","424236"
"chr8","98095067","98095353","chr13","45257087","45257355","60","52837980"
"chr8","98145329","98145629","chr2","96612096","96612391","45","1533233"
"chr8","98212641","98212939","chr10","69727386","69727686","55","28485255"
"chr8","98218550","98218823","chr14","92090917","92091206","60","6127633"
"chr8","98274257","98274549","chr8","98545286","98545580","14","271029"
"chr8","98331194","98331503","chr15","102857337","102857650","57","4526143"
"chr8","98410793","98411071","chr8","98680429","98680708","8","269636"
"chr8","98413471","98413783","chr8","98683111","98683452","33","269640"
"chr8","98439966","98440268","chr8","98708140","98708441","9","268174"
"chr8","98533425","98533741","chr8","98799678","98799984","19","266253"
"chr8","98547458","98547743","chr8","98813736","98814022","4","266278"
"chr8","98583986","98584281","chr8","10034943","10035230","57","88549043"
"chr8","98597598","98597902","chr16","18564791","18565102","61","80032807"
"chr8","98605293","98605593","chr8","98851717","98852016","8","246424"
"chr8","98626466","98626777","chr8","98872211","98872525","13","245745"
"chr8","98666846","98667153","chr8","98912910","98913217","7","246064"
"chr8","98669834","98670092","chr1","158728931","158729190","54","60059097"
"chr8","98673052","98673276","chr18","16392466","16392684","46","82280586"
"chr8","98674206","98674524","chr8","98918917","98919221","16","244711"
"chr8","98786095","98786359","chr18","16208325","16208588","66","82577770"
"chr8","98786391","98786406","chr1","194167384","194167399","2","95380993"
"chr8","98805850","98805992","chr8","99058688","99058829","4","252838"
"chr8","98835496","98835830","chr8","99087527","99087856","11","252031"
"chr8","98851330","98851637","chr8","99103280","99103582","13","251950"
"chr8","98860050","98860359","chr8","99112000","99112294","21","251950"
"chr8","98896503","98896803","chr8","99148408","99148709","2","251905"
"chr8","98935881","98936182","chr8","99187281","99187582","9","251400"
"chr8","98940358","98940625","chr8","99191807","99192074","4","251449"
"chr8","98973207","98973491","chr9","56456050","56456320","61","42517157"
"chr8","98984496","98984791","chr8","99238870","99239168","9","254374"
"chr8","99038929","99039235","chr8","99293745","99294031","29","254816"
"chr8","99059635","99059964","chr8","99314491","99314801","20","254856"
"chr8","99063352","99063657","chr8","99317803","99318108","3","254451"
"chr8","99131147","99131453","chr8","99389363","99389672","9","258216"
"chr8","99135204","99135410","chr8","99393173","99393379","8","257969"
"chr8","99135587","99135690","chr8","99393556","99393659","3","257969"
"chr8","99135705","99135750","chr8","99393688","99393733","0","257983"
"chr8","99201174","99201479","chr8","99459988","99460293","5","258814"
"chr8","99260992","99261389","chr15","69212529","69212890","119","30048463"
"chr8","99274653","99274923","chr8","99533152","99533424","13","258499"
"chr8","99278655","99278916","chr8","99537155","99537416","8","258500"
"chr8","99288649","99288953","chr8","99546913","99547218","11","258264"
"chr8","99297326","99297612","chr8","99555905","99556216","32","258579"
"chr8","99312111","99312409","chr8","99570654","99570950","9","258543"
"chr8","99342364","99342643","chr8","99600531","99600817","15","258167"
"chr8","99361342","99361643","chr8","99619603","99619906","9","258261"
"chr8","99443203","99443508","chr8","99697643","99697949","5","254440"
"chr8","99463025","99463309","chr8","99717455","99717751","25","254430"
"chr8","99477814","99478076","chr8","99732515","99732777","8","254701"
"chr8","99541087","99541371","chr8","99796157","99796454","17","255070"
"chr8","99603380","99603563","chr1","206823091","206823266","44","107219711"
"chr8","99604432","99604563","chr14","63718834","63718964","27","35885598"
"chr8","99632353","99632661","chr8","99887236","99887543","9","254883"
"chr8","99660202","99660511","chr20","39705042","39705349","63","59955160"
"chr8","99690462","99690766","chr8","99951436","99951734","14","260974"
"chr8","99873795","99874082","chr8","100135410","100135697","6","261615"
"chr8","99937810","99938101","chr8","100201173","100201464","9","263363"
"chr8","100258398","100258668","chr8","100504762","100505049","22","246364"
"chr8","100265302","100265613","chr8","100511657","100511943","37","246355"
"chr8","100271847","100272013","chr14","55315919","55316083","34","44955928"
"chr8","100272043","100272076","chr16","7020380","7020417","7","93251663"
"chr8","100330045","100330398","chr8","100576298","100576648","14","246253"
"chr8","100344459","100344757","chr8","100590660","100590958","8","246201"
"chr8","100351595","100351896","chr8","100597701","100598002","3","246106"
"chr8","100356178","100356408","chr8","100602287","100602517","8","246109"
"chr8","100373558","100373828","chr8","100619968","100620238","7","246410"
"chr8","100405216","100405491","chr8","100650204","100650508","37","244988"
"chr8","100499568","100499792","chr8","100745660","100745888","9","246092"
"chr8","100528380","100528667","chr8","100774076","100774363","10","245696"
"chr8","100602257","100602546","chr8","100849515","100849799","11","247258"
"chr8","100631770","100632076","chr8","100894625","100894920","17","262855"
"chr8","100680317","100680604","chr8","100944377","100944660","9","264060"
"chr8","100712981","100713271","chr8","100985698","100985988","1","272717"
"chr8","100713300","100713472","chr8","100986017","100986191","4","272717"
"chr8","100715759","100715898","chr11","23711887","23712024","30","77003872"
"chr8","100825277","100825583","chr8","101083452","101083763","19","258175"
"chr8","100826798","100826921","chr8","101084883","101085015","13","258085"
"chr8","100826954","100827098","chr8","101085036","101085173","11","258082"
"chr8","100895074","100895376","chr8","101156036","101156329","19","260962"
"chr8","100909023","100909328","chr8","101170160","101170464","8","261137"
"chr8","100919174","100919478","chr1","197434272","197434562","63","96515098"
"chr8","100940474","100940724","chr8","101200525","101200766","16","260051"
"chr8","100976443","100976741","chr8","101236824","101237123","10","260381"
"chr8","100999126","100999432","chr8","101259747","101260053","8","260621"
"chr8","101000185","101000462","chr8","101260813","101261088","7","260628"
"chr8","101005987","101006114","chr5","142976863","142976984","27","41970876"
"chr8","101097963","101098096","chr8","101357508","101357641","3","259545"
"chr8","101334350","101334661","chr8","101586920","101587231","9","252570"
"chr8","101391793","101392087","chr8","101643583","101643878","11","251790"
"chr8","101398941","101399030","chr8","101650660","101650749","1","251719"
"chr8","101399328","101399508","chr8","101651055","101651230","9","251727"
"chr8","101408700","101409002","chr8","101660263","101660565","2","251563"
"chr8","101416673","101416878","chr8","101668247","101668452","2","251574"
"chr8","101432558","101432867","chr8","101684198","101684481","29","251640"
"chr8","101443365","101443451","chr11","120833490","120833564","26","19390125"
"chr8","101462287","101462594","chr8","101713538","101713839","13","251251"
"chr8","101488837","101489143","chr8","101740050","101740356","7","251213"
"chr8","101507798","101508099","chr8","101758964","101759246","26","251166"
"chr8","101515654","101515844","chr8","101766934","101767121","6","251280"
"chr8","101695180","101695349","chr8","101951777","101951946","11","256597"
"chr8","101740518","101740797","chr8","101996827","101997143","54","256309"
"chr8","101757417","101757475","chr8","102013401","102013459","0","255984"
"chr8","101792120","101792444","chr8","102046632","102046964","22","254512"
"chr8","101924368","101924691","chr4","152226280","152226592","61","50301912"
"chr8","101933354","101933635","chr15","11732175","11732456","56","90201179"
"chr8","102015626","102015813","chr8","102270697","102270884","2","255071"
"chr8","102106953","102107262","chr8","102365604","102365913","15","258651"
"chr8","102113024","102113307","chr1","95246773","95247060","56","6866251"
"chr8","102254694","102254993","chr8","102512890","102513191","11","258196"
"chr8","102273166","102273437","chr8","102531391","102531666","12","258225"
"chr8","102390633","102390930","chr8","102658723","102659018","6","268090"
"chr8","102416797","102417041","chr8","102684887","102685131","4","268090"
"chr8","102430463","102430745","chr8","102698573","102698848","13","268110"
"chr8","102493806","102494079","chr8","102761672","102761946","8","267866"
"chr8","102696813","102697098","chr8","102963073","102963359","10","266260"
"chr8","102752342","102752623","chr8","103018914","103019195","7","266572"
"chr8","102783380","102783664","chr5","52742476","52742758","50","50040904"
"chr8","100499568","100499792","chr8","100745660","100745888","9","246092"
"chr8","100528380","100528667","chr8","100774076","100774363","10","245696"
"chr8","100602257","100602546","chr8","100849515","100849799","11","247258"
"chr8","100631770","100632076","chr8","100894625","100894920","17","262855"
"chr8","100680317","100680604","chr8","100944377","100944660","9","264060"
"chr8","100712981","100713271","chr8","100985698","100985988","1","272717"
"chr8","100713300","100713472","chr8","100986017","100986191","4","272717"
"chr8","100715759","100715898","chr11","23711887","23712024","30","77003872"
"chr8","100825277","100825583","chr8","101083452","101083763","19","258175"
"chr8","100826798","100826921","chr8","101084883","101085015","13","258085"
"chr8","100826954","100827098","chr8","101085036","101085173","11","258082"
"chr8","100895074","100895376","chr8","101156036","101156329","19","260962"
"chr8","100909023","100909328","chr8","101170160","101170464","8","261137"
"chr8","100919174","100919478","chr1","197434272","197434562","63","96515098"
"chr8","100940474","100940724","chr8","101200525","101200766","16","260051"
"chr8","100976443","100976741","chr8","101236824","101237123","10","260381"
"chr8","100999126","100999432","chr8","101259747","101260053","8","260621"
"chr8","101000185","101000462","chr8","101260813","101261088","7","260628"
"chr8","101005987","101006114","chr5","142976863","142976984","27","41970876"
"chr8","101097963","101098096","chr8","101357508","101357641","3","259545"
"chr8","101334350","101334661","chr8","101586920","101587231","9","252570"
"chr8","101391793","101392087","chr8","101643583","101643878","11","251790"
"chr8","101398941","101399030","chr8","101650660","101650749","1","251719"
"chr8","101399328","101399508","chr8","101651055","101651230","9","251727"
"chr8","101408700","101409002","chr8","101660263","101660565","2","251563"
"chr8","101416673","101416878","chr8","101668247","101668452","2","251574"
"chr8","101432558","101432867","chr8","101684198","101684481","29","251640"
"chr8","101443365","101443451","chr11","120833490","120833564","26","19390125"
"chr8","101462287","101462594","chr8","101713538","101713839","13","251251"
"chr8","101488837","101489143","chr8","101740050","101740356","7","251213"
"chr8","101507798","101508099","chr8","101758964","101759246","26","251166"
"chr8","101515654","101515844","chr8","101766934","101767121","6","251280"
"chr8","101695180","101695349","chr8","101951777","101951946","11","256597"
"chr8","101740518","101740797","chr8","101996827","101997143","54","256309"
"chr8","101757417","101757475","chr8","102013401","102013459","0","255984"
"chr8","101792120","101792444","chr8","102046632","102046964","22","254512"
"chr8","101924368","101924691","chr4","152226280","152226592","61","50301912"
"chr8","101933354","101933635","chr15","11732175","11732456","56","90201179"
"chr8","102015626","102015813","chr8","102270697","102270884","2","255071"
"chr8","102106953","102107262","chr8","102365604","102365913","15","258651"
"chr8","102113024","102113307","chr1","95246773","95247060","56","6866251"
"chr8","102254694","102254993","chr8","102512890","102513191","11","258196"
"chr8","102273166","102273437","chr8","102531391","102531666","12","258225"
"chr8","102390633","102390930","chr8","102658723","102659018","6","268090"
"chr8","102416797","102417041","chr8","102684887","102685131","4","268090"
"chr8","102430463","102430745","chr8","102698573","102698848","13","268110"
"chr8","102493806","102494079","chr8","102761672","102761946","8","267866"
"chr8","102696813","102697098","chr8","102963073","102963359","10","266260"
"chr8","102752342","102752623","chr8","103018914","103019195","7","266572"
"chr8","102783380","102783664","chr5","52742476","52742758","50","50040904"
"chr8","102833606","102833934","chr8","103094487","103094791","27","260881"
"chr8","102847571","102847866","chr8","103108596","103108896","8","261025"
"chr8","102878235","102878521","chr8","103141476","103141780","30","263241"
"chr8","102892523","102892823","chr8","103155657","103155957","4","263134"
"chr8","102892857","102893151","chr8","103155991","103156294","12","263134"
"chr8","102893152","102893202","chrX","2863827","2863872","12","100029325"
"chr8","102934464","102934601","chr8","103200641","103200778","3","266177"
"chr8","102940287","102940585","chr6","61525292","61525590","53","41414995"
"chr8","102952718","102953030","chr8","103218557","103218870","9","265839"
"chr8","102969554","102969857","chr8","103235368","103235662","19","265814"
"chr8","102981265","102981554","chr8","103247159","103247440","10","265894"
"chr8","102986332","102986515","chr13","23170672","23170848","43","79815660"
"chr8","102996212","102996537","chr8","103261890","103262190","36","265678"
"chr8","103008004","103008320","chr8","103274145","103274471","13","266141"
"chr8","103011255","103011560","chr8","103277354","103277675","25","266099"
"chr8","103031969","103032258","chr8","103297706","103298000","10","265737"
"chr8","103048190","103048502","chr8","103313944","103314252","9","265754"
"chr8","103048506","103048610","chr8","103314256","103314360","0","265750"
"chr8","103049241","103049545","chr8","103314991","103315281","20","265750"
"chr8","103065397","103065734","chr8","103330906","103331251","17","265509"
"chr8","103085250","103085422","chr8","103350803","103350975","2","265553"
"chr8","103088520","103088659","chr8","40191767","40191900","24","62896753"
"chr8","103088672","103088749","chr4","2021281","2021358","15","101067391"
"chr8","103095674","103095931","chr8","103361204","103361465","9","265530"
"chr8","103104037","103104176","chr8","103369572","103369711","2","265535"
"chr8","103115663","103115960","chr8","103381178","103381437","43","265515"
"chr8","103130161","103130462","chr8","103395146","103395440","12","264985"
"chr8","103150887","103151213","chr8","103415093","103415415","10","264206"
"chr8","103168058","103168199","chr8","103433004","103433145","1","264946"
"chr8","103220739","103220950","chr8","103486051","103486253","18","265312"
"chr8","103225383","103225501","chr8","103490349","103490472","10","264966"
"chr8","103225549","103225666","chr8","103490510","103490618","17","264961"
"chr8","103229593","103229886","chr8","103495215","103495508","4","265622"
"chr8","103235474","103235764","chr8","103501115","103501411","15","265641"
"chr8","103244240","103244536","chr8","103509917","103510207","11","265677"
"chr8","103535413","103535717","chr8","103807396","103807718","24","271983"
"chr8","103595083","103595325","chr8","103868850","103869094","4","273767"
"chr8","103798152","103798448","chr8","104073890","104074187","15","275738"
"chr8","103840949","103841224","chr8","104116524","104116796","10","275575"
"chr8","103944687","103944981","chr8","104229873","104230166","1","285186"
"chr8","103947823","103948089","chr8","104232973","104233239","1","285150"
"chr8","103968150","103968414","chr8","104253315","104253579","3","285165"
"chr8","103991009","103991074","chr1","31252960","31253021","11","72738049"
"chr8","104028530","104028646","chr8","104314004","104314120","4","285474"
"chr8","104053121","104053397","chr8","104338574","104338869","24","285453"
"chr8","104062199","104062499","chr8","104347748","104348030","30","285549"
"chr8","104070497","104070734","chr8","104356162","104356407","17","285665"
"chr8","104119981","104120197","chr8","104409390","104409609","8","289409"
"chr8","104238512","104238820","chr8","104531340","104531627","28","292828"
"chr8","104259301","104259601","chr8","104552237","104552537","5","292936"
"chr8","104297234","104297525","chr8","104590747","104591046","19","293513"
"chr8","104327148","104327345","chr8","104617999","104618196","3","290851"
"chr8","104328824","104329109","chr8","104619678","104619974","27","290854"
"chr8","104366267","104366391","chr8","104657812","104657936","5","291545"
"chr8","104387265","104387581","chr8","104679249","104679539","32","291984"
"chr8","104493951","104494282","chr8","104789856","104790145","45","295905"
"chr8","104530925","104531146","chr8","104826987","104827208","7","296062"
"chr8","104600538","104600846","chr8","104896689","104896995","6","296151"
"chr8","104621797","104622082","chr1","63128997","63129278","61","41492800"
"chr8","104623558","104623841","chr11","119655342","119655613","66","15031784"
"chr8","104671707","104672021","chr8","104957276","104957566","30","285569"
"chr8","104795097","104795403","chr8","105079400","105079696","20","284303"
"chr8","104881225","104881524","chr8","105167287","105167583","8","286062"
"chr8","104939278","104939582","chr8","105224743","105225045","10","285465"
"chr8","104984063","104984350","chr8","105267498","105267786","9","283435"
"chr8","105203285","105203407","chr8","105474289","105474411","2","271004"
"chr8","105318647","105318942","chr8","105588758","105589054","35","270111"
"chr8","105344003","105344300","chr8","105613090","105613389","15","269087"
"chr8","105356819","105356982","chr8","105625865","105626037","14","269046"
"chr8","105477142","105477296","chr8","105745500","105745654","6","268358"
"chr8","105592021","105592307","chr8","105875623","105875934","33","283602"
"chr8","105743708","105743993","chr8","106032454","106032739","10","288746"
"chr8","105810301","105810579","chr8","106091844","106092128","17","281543"
"chr8","105909184","105909435","chr8","106184590","106184834","17","275406"
"chr8","105966403","105966703","chr8","106243752","106244043","21","277349"
"chr8","105974006","105974298","chr8","10034943","10035230","64","95939063"
"chr8","106131135","106131416","chr8","106406318","106406606","13","275183"
"chr8","106226539","106226710","chr8","106513418","106513589","2","286879"
"chr8","106277523","106277835","chrX","41341410","41341721","63","64936113"
"chr8","106281297","106281598","chr8","106570635","106570937","9","289338"
"chr8","106349372","106349672","chr5","168114453","168114748","67","61765081"
"chr8","106648280","106648560","chr8","106927555","106927832","12","279275"
"chr8","106650581","106650847","chr8","106929853","106930119","5","279272"
"chr8","106715325","106715614","chr8","106981832","106982121","18","266507"
"chr8","106731675","106731991","chr8","106998500","106998809","21","266825"
"chr8","106845002","106845303","chr8","107110358","107110669","13","265356"
"chr8","106846524","106846703","chr8","107111900","107112105","29","265376"
"chr8","106894845","106895122","chr8","107159151","107159428","12","264306"
"chr8","106919628","106919947","chr8","107183851","107184173","12","264223"
"chr8","106925358","106925674","chrX","27894759","27895057","63","79030599"
"chr8","106996845","106996973","chr6","74611017","74611130","33","32385828"
"chr8","106997253","106997270","chr8","107255451","107255468","0","258198"
"chr8","107110747","107110937","chr8","107370605","107370794","3","259858"
"chr8","107121105","107121415","chr8","107380906","107381180","40","259801"
"chr8","107182904","107183206","chr1","33010955","33011254","63","74171949"
"chr8","107203874","107204177","chr8","107460667","107460963","21","256793"
"chr8","107225521","107225797","chr8","107483529","107483807","8","258008"
"chr8","107273560","107273847","chr8","107530466","107530769","22","256906"
"chr8","107337533","107337825","chr10","14896883","14897176","64","92440650"
"chr8","107444451","107444733","chr6","109764005","109764287","10","2319554"
"chr8","107501640","107501915","chr8","107749606","107749881","9","247966"
"chr8","107781974","107782230","chr8","108042218","108042462","17","260244"
"chr8","107858427","107858541","chr8","108134278","108134391","4","275851"
"chr8","107858581","107858749","chr8","108134412","108134580","2","275831"
"chr8","107905184","107905510","chr8","108181902","108182232","16","276718"
"chr8","108006396","108006648","chr8","108283312","108283573","32","276916"
"chr8","108025797","108026105","chr8","108302432","108302734","28","276635"
"chr8","108055334","108055639","chr8","108333194","108333503","13","277860"
"chr8","108164463","108164750","chr8","108442306","108442589","9","277843"
"chr8","108234368","108234677","chr13","41851851","41852159","66","66382517"
"chr8","108411308","108411524","chr1","42198229","42198429","53","66213079"
"chr8","108420847","108421132","chr8","108729436","108729720","9","308589"
"chr8","108505444","108505713","chr8","108816058","108816327","6","310614"
"chr8","108517357","108517649","chr8","108828040","108828332","5","310683"
"chr8","108557117","108557231","chr8","108870246","108870360","2","313129"
"chr8","108557277","108557417","chr8","108870406","108870543","10","313129"
"chr8","108622282","108622446","chr8","108934010","108934174","3","311728"
"chr8","108646040","108646353","chr8","108958068","108958374","14","312028"
"chr8","108691571","108691851","chr4","107633121","107633396","73","1058450"
"chr8","108762889","108763153","chr8","109078094","109078358","7","315205"
"chr8","108802051","108802357","chr8","109119311","109119619","18","317260"
"chr8","108904966","108905247","chr8","109223190","109223470","9","318224"
"chr8","108972943","108973222","chr8","109290802","109291087","14","317859"
"chr8","109059799","109060087","chr8","109380472","109380721","49","320673"
"chr8","109060299","109060402","chr10","31887697","31887792","23","77172602"
"chr8","109074544","109074839","chr8","109391380","109391675","7","316836"
"chr8","109191556","109191872","chr8","109507697","109507991","38","316141"
"chr8","109203533","109203648","chr3","1771777","1771897","32","107431756"
"chr8","109211583","109211907","chr8","109527693","109528003","16","316110"
"chr8","109246302","109246589","chr8","109562321","109562594","22","316019"
"chr8","109264808","109265111","chr8","109578517","109578830","22","313709"
"chr8","109320175","109320458","chr8","109631542","109631802","42","311367"
"chr8","109346583","109346888","chr8","109659627","109659932","13","313044"
"chr8","109374789","109375081","chr8","109689557","109689849","5","314768"
"chr8","109419183","109419434","chr8","109730264","109730512","9","311081"
"chr8","109458851","109459132","chr8","109766950","109767255","36","308099"
"chr8","109523538","109523799","chr8","109835379","109835664","35","311841"
"chr8","109523863","109523884","chr10","72619805","72619825","4","36904058"
"chr8","109651589","109651859","chr8","109964051","109964319","8","312462"
"chr8","109805419","109805689","chr8","110112774","110113043","8","307355"
"chr8","109889922","109890059","chr8","110201739","110201876","3","311817"
"chr8","109985065","109985366","chr5","141067403","141067695","71","31082338"
"chr8","110105120","110105432","chr8","110418817","110419125","18","313697"
"chr8","110119156","110119457","chr8","110432752","110433053","9","313596"
"chr8","110134255","110134542","chr8","110446977","110447266","13","312722"
"chr8","110174604","110174888","chr5","46662459","46662740","67","63512145"
"chr8","110190797","110191115","chr8","110505280","110505586","21","314483"
"chr8","110245049","110245337","chr8","110557373","110557660","9","312324"
"chr8","110276327","110276603","chr8","110588412","110588709","26","312085"
"chr8","110541452","110541695","chr8","110850780","110851022","8","309328"
"chr8","110856060","110856333","chr8","111161841","111162114","15","305781"
"chr8","110861100","110861286","chr8","111166883","111167061","10","305783"
"chr8","110861317","110861434","chr8","111167084","111167201","0","305767"
"chr8","110928871","110929099","chr8","111234233","111234461","9","305362"
"chr8","110940339","110940651","chr8","111245721","111246049","29","305382"
"chr8","111126738","111127025","chr8","111439663","111439950","11","312925"
"chr8","111213030","111213305","chr8","111526568","111526864","26","313538"
"chr8","111217739","111218016","chr1","28978297","28978584","59","82239442"
"chr8","111279035","111279315","chr8","111591714","111591987","15","312679"
"chr8","111298073","111298360","chr8","111610840","111611118","13","312767"
"chr8","111333401","111333690","chr10","60237300","60237576","61","51096101"
"chr8","111377575","111377870","chr8","111690619","111690914","6","313044"
"chr8","111394463","111394770","chr8","111707808","111708120","10","313345"
"chr8","111397887","111398161","chr8","111711223","111711497","6","313336"
"chr8","111413299","111413595","chr8","111726682","111726978","5","313383"
"chr8","111419271","111419579","chr8","111732654","111732958","8","313383"
"chr8","111448849","111449158","chr8","111761848","111762125","34","312999"
"chr8","111523098","111523362","chr7","114673764","114674035","58","3150666"
"chr8","111530697","111530946","chr8","111841881","111842131","3","311184"
"chr8","111533763","111534072","chr8","111844929","111845245","18","311166"
"chr8","111682734","111683019","chr7","81793524","81793815","58","29889210"
"chr8","111707736","111708023","chr8","112032554","112032840","8","324818"
"chr8","111807510","111807830","chr8","112137001","112137317","8","329491"
"chr8","111843397","111843564","chr8","112174575","112174735","12","331178"
"chr8","112188652","112188779","chr8","112529380","112529505","2","340728"
"chr8","112282404","112282708","chr8","112625140","112625427","33","342736"
"chr8","112308588","112308895","chr8","112651339","112651631","25","342751"
"chr8","112309045","112309350","chr8","112651781","112652092","15","342736"
"chr8","112341346","112341605","chr8","112683927","112684182","6","342581"
"chr8","112359828","112360110","chr8","112702352","112702635","5","342524"
"chr8","112383470","112383789","chr8","112726310","112726633","9","342840"
"chr8","112411937","112412209","chr8","112755139","112755411","8","343202"
"chr8","112502024","112502234","chr8","112846848","112847058","4","344824"
"chr8","112538197","112538509","chr8","112883001","112883314","12","344804"
"chr8","112611590","112611840","chr8","112956392","112956642","5","344802"
"chr8","112612470","112612760","chr8","112957201","112957491","8","344731"
"chr8","112621548","112621818","chr8","112966333","112966603","7","344785"
"chr8","112626100","112626384","chr8","112970892","112971175","6","344792"
"chr8","112632746","112633032","chr8","112977489","112977775","9","344743"
"chr8","112651484","112651650","chr2","101076807","101076972","32","11574677"
"chr8","112676184","112676317","chr8","113021074","113021211","9","344890"
"chr8","112690256","112690559","chr8","113035538","113035813","38","345282"
"chr8","112768477","112768761","chr8","113113986","113114277","46","345509"
"chr8","112775462","112775779","chr8","113120975","113121289","11","345513"
"chr8","112840276","112840431","chr8","113184879","113185034","2","344603"
"chr8","112880214","112880508","chr8","113224633","113224935","21","344419"
"chr8","112931865","112932167","chr8","113276804","113277102","10","344939"
"chr8","112970353","112970634","chr8","113318605","113318886","9","348252"
"chr8","112971502","112971766","chr8","113319754","113320018","10","348252"
"chr8","113035651","113035949","chr2","71091810","71092095","65","41943841"
"chr8","113054312","113054474","chr8","113403582","113403748","9","349270"
"chr8","113090361","113090659","chr8","113440471","113440769","3","350110"
"chr8","113212713","113212955","chr15","103882403","103882639","48","9330310"
"chr8","113212958","113212988","chr8","113563649","113563679","0","350691"
"chr8","113292562","113292831","chr8","113645734","113646024","25","353172"
"chr8","113296295","113296460","chr9","6234636","6234799","40","107061659"
"chr8","113296466","113296508","chr4","128007844","128007885","9","14711378"
"chr8","113298042","113298349","chr8","113651286","113651578","28","353244"
"chr8","113343607","113343811","chr8","113696807","113697011","0","353200"
"chr8","113427289","113427595","chr8","113784640","113784946","21","357351"
"chr8","113457355","113457659","chr8","113817110","113817415","13","359755"
"chr8","113684112","113684228","chr8","114045098","114045222","11","360986"
"chr8","113766833","113766847","chr5","75853875","75853888","2","37912958"
"chr8","113766882","113767162","chr2","86558370","86558650","52","27208512"
"chr8","113814839","113815144","chr8","114178109","114178422","15","363270"
"chr8","113972880","113973168","chr8","114350724","114351012","5","377844"
"chr8","114014951","114015200","chr8","114393640","114393889","7","378689"
"chr8","114028060","114028341","chr8","114407293","114407576","8","379233"
"chr8","114042410","114042561","chr3","147115246","147115386","29","33072836"
"chr8","114048591","114048847","chr8","114429592","114429872","35","381001"
"chr8","114055142","114055314","chr8","114436082","114436250","13","380940"
"chr8","114055354","114055479","chr8","114436296","114436421","3","380942"
"chr8","114066850","114067140","chr8","114447661","114447936","22","380811"
"chr8","114098918","114099077","chr17","6251477","6251640","32","107847441"
"chr8","114161868","114162158","chr8","114542274","114542564","10","380406"
"chr8","114169499","114169776","chr8","114549862","114550139","1","380363"
"chr8","114239159","114239447","chr8","114619965","114620250","7","380806"
"chr8","114270188","114270492","chrX","48691061","48691366","49","65579127"
"chr8","114274314","114274557","chr20","49548475","49548699","49","64725839"
"chr8","114284327","114284625","chr8","114662696","114662990","17","378369"
"chr8","114287729","114288032","chr8","114667413","114667711","10","379684"
"chr8","114353407","114353719","chr8","114735478","114735792","8","382071"
"chr8","114357136","114357298","chr8","114739214","114739377","6","382078"
"chr8","114384724","114385011","chr8","114766522","114766805","13","381798"
"chr8","114385204","114385498","chr8","114766994","114767293","14","381790"
"chr8","114406770","114407070","chr8","114786853","114787154","9","380083"
"chr8","114421578","114421906","chr9","110725444","110725766","65","3696134"
"chr8","114447693","114447953","chr8","114830672","114830926","9","382979"
"chr8","114453034","114453346","chr8","114835907","114836219","7","382873"
"chr8","114464482","114464779","chr8","114845825","114846127","11","381343"
"chr8","114484538","114484586","chr1","65445802","65445850","9","49038736"
"chr8","114484587","114484735","chr11","15549356","15549502","37","98935231"
"chr8","114508338","114508484","chr8","114899598","114899743","1","391260"
"chr8","114542307","114542592","chr8","114920188","114920473","6","377881"
"chr8","114550500","114550771","chr8","114928292","114928582","46","377792"
"chr8","114553380","114553506","chrX","108033144","108033267","22","6520236"
"chr8","114587170","114587444","chr8","114967075","114967355","23","379905"
"chr8","114590650","114590661","chr7","12534577","12534588","1","102056073"
"chr8","114590975","114591131","chr9","102282987","102283142","27","12307988"
"chr8","114621114","114621438","chr8","115002093","115002415","8","380979"
"chr8","114689227","114689238","chr1","109427498","109427509","2","5261729"
"chr8","114689296","114689544","chr12","91811988","91812233","59","22877308"
"chr8","114698412","114698724","chr8","115080482","115080788","20","382070"
"chr8","114782004","114782220","chr8","115161271","115161487","6","379267"
"chr8","114791786","114792074","chr8","115170859","115171147","2","379073"
"chr8","114802036","114802345","chr8","115180813","115181122","4","378777"
"chr8","114820880","114821166","chr8","115199625","115199911","6","378745"
"chr8","114826679","114826997","chr8","115205424","115205743","15","378745"
"chr8","114899708","114900015","chr8","115277822","115278127","13","378114"
"chr8","114900808","114900943","chr8","115278922","115279057","3","378114"
"chr8","114901050","114901207","chr8","115279164","115279320","4","378114"
"chr8","114941820","114942131","chr8","115342268","115342573","13","400448"
"chr8","115016019","115016281","chr8","115415084","115415346","3","399065"
"chr8","115025791","115026088","chr8","115425190","115425490","5","399399"
"chr8","115029464","115029763","chr8","115428859","115429157","15","399395"
"chr8","115030710","115031006","chr8","115430104","115430401","6","399394"
"chr8","115089802","115090108","chr8","115487783","115488091","9","397981"
"chr8","115248003","115248175","chr1","56272835","56272998","43","58975168"
"chr8","115248387","115248530","chr10","31505962","31506101","37","83742425"
"chr8","115309786","115310087","chr8","115709009","115709308","18","399223"
"chr8","115335332","115335660","chr6","54244616","54244948","79","61090716"
"chr8","115404364","115404673","chr8","115803274","115803584","8","398910"
"chr8","115423546","115423811","chr8","115822513","115822797","45","398967"
"chr8","115545307","115545584","chr8","115944010","115944287","3","398703"
"chr8","115653111","115653290","chr8","116058677","116058855","10","405566"
"chr8","115661128","115661455","chr15","2396311","2396618","87","113264817"
"chr8","115779294","115779593","chr8","116190849","116191147","7","411555"
"chr8","115890455","115890756","chr7","50096881","50097176","68","65793574"
"chr8","115912224","115912243","chr19","4940563","4940583","2","110971661"
"chr8","115912295","115912442","chr1","110359669","110359814","33","5552626"
"chr8","115959038","115959361","chr8","116368990","116369312","12","409952"
"chr8","116097758","116098056","chr8","116506898","116507200","17","409140"
"chr8","116102156","116102437","chr8","116511300","116511581","5","409144"
"chr8","116135697","116135856","chr8","116544957","116545116","2","409260"
"chr8","116206255","116206308","chr8","116616220","116616273","1","409965"
"chr8","116250066","116250361","chr8","116659850","116660153","16","409784"
"chr8","116268351","116268659","chr6","30421128","30421439","55","85847223"
"chr8","116279444","116279708","chr8","116693611","116693875","3","414167"
"chr8","116342264","116342478","chr8","116757762","116757976","5","415498"
"chr8","116345140","116345441","chr16","50838419","50838715","74","65506721"
"chr8","116481010","116481267","chr8","116894415","116894672","6","413405"
"chr8","116522522","116522710","chr8","116937484","116937672","3","414962"
"chr8","116733723","116733995","chr8","117158432","117158704","4","424709"
"chr8","116871363","116871668","chr8","117299451","117299756","6","428088"
"chr8","116890312","116890575","chr8","117318967","117319233","9","428655"
"chr8","116902765","116903062","chr8","117331441","117331736","12","428676"
"chr8","116920166","116920462","chr8","117347167","117347460","8","427001"
"chr8","117046589","117046924","chr8","117481304","117481639","7","434715"
"chr8","117123378","117123651","chr8","117551596","117551879","17","428218"
"chr8","117135733","117135982","chr8","117564509","117564758","8","428776"
"chr8","117174697","117174994","chr11","40722892","40723184","52","76451805"
"chr8","117238552","117238681","chr8","117672689","117672818","5","434137"
"chr8","117242837","117243144","chr13","102913751","102914038","54","14329086"
"chr8","117268922","117269226","chr8","117702771","117703075","3","433849"
"chr8","117349779","117349941","chr17","18445768","18445934","28","98904011"
"chr8","117366837","117367141","chr8","117801542","117801838","20","434705"
"chr8","117380214","117380519","chr17","77730330","77730626","64","39649884"
"chr8","117389774","117390061","chr8","117824355","117824648","16","434581"
"chr8","117408948","117409255","chr8","117843725","117844032","5","434777"
"chr8","117529801","117530121","chr8","117965775","117966094","3","435974"
"chr8","117569985","117570277","chr8","118007074","118007374","14","437089"
"chr8","117573133","117573395","chr8","118010251","118010543","33","437118"
"chr8","117573502","117573518","chr1","194167384","194167399","2","76593882"
"chr8","117577995","117578294","chr8","118015139","118015446","17","437144"
"chr8","117581209","117581516","chr8","118018398","118018695","22","437189"
"chr8","117603447","117603749","chr8","118040188","118040491","7","436741"
"chr8","117646942","117647228","chr8","118082387","118082672","12","435445"
"chr8","117654108","117654295","chr8","118089521","118089708","6","435413"
"chr8","117663563","117663714","chr8","118098953","118099081","25","435390"
"chr8","117669607","117669892","chr6","136233438","136233732","57","18563831"
"chr8","117697387","117697669","chr6","33670284","33670570","58","84027103"
"chr8","117713124","117713433","chr3","13581455","13581762","60","104131669"
"chr8","117715346","117715635","chr8","118145109","118145394","8","429763"
"chr8","117752961","117753258","chr8","118181491","118181790","16","428530"
"chr8","117798928","117799014","chr2","77635839","77635921","26","40163089"
"chr8","117807650","117808017","chr1","101981559","101981900","104","15826091"
"chr8","117808043","117808167","chr16","54245402","54245527","18","63562641"
"chr8","117873063","117873346","chr8","118306116","118306438","44","433053"
"chr8","117893444","117893753","chr8","118327366","118327670","8","433922"
"chr8","117901193","117901476","chr8","118334826","118335105","10","433633"
"chr8","117913777","117913938","chr8","118347227","118347388","6","433450"
"chr8","117940312","117940650","chr8","118373771","118374101","22","433459"
"chr8","117952574","117952712","chr8","118389475","118389613","3","436901"
"chr8","117953004","117953175","chr8","118389917","118390087","7","436913"
"chr8","117955939","117956214","chr20","22322039","22322303","57","95633900"
"chr8","117973750","117974034","chr2","47470757","47471039","59","70502993"
"chr8","117979667","117979935","chr8","118411568","118411836","4","431901"
"chr8","117984330","117984625","chr8","118416566","118416861","5","432236"
"chr8","117987800","117988101","chr8","118420016","118420317","9","432216"
"chr8","118021331","118021618","chr2","97022915","97023209","52","20998416"
"chr8","118036478","118036613","chr3","172625691","172625826","20","54589213"
"chr8","118036920","118037098","chr10","87423992","87424165","27","30612928"
"chr8","118050495","118050775","chr8","118478605","118478886","6","428110"
"chr8","118083420","118083720","chr8","118511617","118511923","15","428197"
"chr8","118092863","118093161","chr8","118521028","118521326","8","428165"
"chr8","118116549","118116826","chr8","118544948","118545225","6","428399"
"chr8","118122704","118123002","chr8","118551140","118551431","30","428436"
"chr8","118131808","118132112","chr1","27053019","27053327","51","91078789"
"chr8","118139529","118139844","chr8","118567780","118568069","41","428251"
"chr8","118181588","118181888","chr8","118610889","118611193","14","429301"
"chr8","118189774","118189946","chr8","118619136","118619267","43","429362"
"chr8","118197656","118197953","chr8","118627000","118627297","7","429344"
"chr8","118212740","118213030","chr8","118642766","118643058","8","430026"
"chr8","118272809","118273110","chr8","118703387","118703688","10","430578"
"chr8","118307562","118307844","chr8","118737783","118738064","7","430221"
"chr8","118379188","118379481","chr8","118809951","118810244","11","430763"
"chr8","118429228","118429346","chr20","10136157","10136277","17","108293071"
"chr8","118435010","118435284","chr13","118908380","118908653","53","473370"
"chr8","118540162","118540406","chr8","118980402","118980644","9","440240"
"chr8","118583161","118583217","chr11","73012763","73012819","14","45570398"
"chr8","118584311","118584609","chr1","47261926","47262223","66","71322385"
"chr8","118623619","118623861","chr8","119069989","119070231","5","446370"
"chr8","118839274","118839562","chr8","119286591","119286883","19","447317"
"chr8","118852530","118852804","chr8","119300003","119300299","32","447473"
"chr8","118955947","118956255","chr8","119406400","119406709","12","450453"
"chr8","118977234","118977512","chr8","119426889","119427167","10","449655"
"chr8","118979727","118979991","chr8","119429379","119429643","5","449652"
"chr8","118983841","118983998","chr8","119433496","119433656","8","449655"
"chr8","119009228","119009533","chr8","119457704","119458005","13","448476"
"chr8","119025759","119025830","chr10","14543738","14543811","16","104482021"
"chr8","119026467","119026545","chr8","119474702","119474780","2","448235"
"chr8","119026770","119026907","chr8","119475005","119475142","0","448235"
"chr8","119038834","119039005","chr8","119485128","119485282","22","446294"
"chr8","119039285","119039427","chr8","119485578","119485723","4","446293"
"chr8","119067574","119067855","chr8","119513901","119514178","5","446327"
"chr8","119075420","119075719","chr8","119521714","119522013","6","446294"
"chr8","119197984","119198281","chr8","119645778","119646094","27","447794"
"chr8","119235319","119235635","chr2","47621686","47621991","67","71613633"
"chr8","119239941","119240234","chr8","119685574","119685868","8","445633"
"chr8","119268435","119268746","chr8","119713995","119714310","11","445560"
"chr8","119274743","119274892","chr8","119720335","119720470","19","445592"
"chr8","119275187","119275348","chr8","119720767","119720927","6","445580"
"chr8","119281491","119281771","chr14","50502244","50502523","52","68779247"
"chr8","119306080","119306316","chr8","119751705","119751941","15","445625"
"chr8","119316442","119316703","chr8","119761970","119762231","5","445528"
"chr8","119319435","119319739","chr8","119764773","119765075","13","445338"
"chr8","119348213","119348517","chr8","119793530","119793834","9","445317"
"chr8","119355859","119356167","chr8","119800879","119801183","18","445020"
"chr8","119383526","119383823","chr8","119829554","119829852","7","446028"
"chr8","119406365","119406543","chr8","119852658","119852833","7","446293"
"chr8","119438389","119438686","chr8","119885112","119885409","6","446723"
"chr8","119447485","119447638","chr8","119894229","119894387","8","446744"
"chr8","119533874","119534038","chr8","119980449","119980615","4","446575"
"chr8","119544229","119544537","chr5","42819599","42819906","65","76724630"
"chr8","119554355","119554619","chr10","26059826","26060100","53","93494529"
"chr8","119555373","119555599","chr8","119992633","119992857","14","437260"
"chr8","119555727","119555929","chr3","116063608","116063788","64","3492119"
"chr8","119622887","119623179","chr8","120072408","120072703","11","449521"
"chr8","119633106","119633262","chr8","120082628","120082784","4","449522"
"chr8","119657065","119657376","chr8","120106482","120106761","36","449417"
"chr8","119657408","119657694","chr8","120106823","120107107","12","449415"
"chr8","119682111","119682406","chr8","120129575","120129872","7","447464"
"chr8","119696560","119696856","chr8","120144309","120144620","23","447749"
"chr8","119807357","119807641","chr8","120255582","120255868","8","448225"
"chr8","119808883","119809162","chr8","120257093","120257360","19","448210"
"chr8","119832303","119832606","chr1","14767405","14767708","56","105064898"
"chr8","119835900","119836080","chr8","120284423","120284603","1","448523"
"chr8","119852968","119853265","chr8","120301740","120302036","13","448772"
"chr8","119873323","119873631","chr8","120321893","120322201","6","448570"
"chr8","119884636","119884932","chr8","120333046","120333340","6","448410"
"chr8","119903574","119903878","chr8","120347143","120347442","9","443569"
"chr8","119904418","119904713","chr8","120348040","120348333","8","443622"
"chr8","119904865","119905162","chr8","120348450","120348763","26","443585"
"chr8","119905789","119906080","chr8","120349393","120349684","6","443604"
"chr8","119924426","119924613","chr8","120373941","120374120","13","449515"
"chr8","119945404","119945710","chr8","120394478","120394775","25","449074"
"chr8","119950938","119951096","chr11","100471771","100471937","30","19479167"
"chr8","119972458","119972702","chr8","120422549","120422789","12","450091"
"chr8","119974919","119975197","chr8","120424998","120425276","9","450079"
"chr8","119990203","119990476","chr8","120443082","120443355","8","452879"
"chr8","120000261","120000580","chr8","120453230","120453549","4","452969"
"chr8","120008367","120008497","chr8","120460750","120460880","1","452383"
"chr8","120029992","120030240","chr8","120482257","120482505","3","452265"
"chr8","120032081","120032300","chr8","120483797","120484016","4","451716"
"chr8","120032390","120032677","chr8","120484126","120484391","26","451736"
"chr8","120032979","120033095","chr8","120484693","120484809","2","451714"
"chr8","120041382","120041572","chr8","120493277","120493487","26","451895"
"chr8","120052327","120052462","chr11","31168241","31168378","26","88884086"
"chr8","120056699","120057008","chr8","120507878","120508182","14","451179"
"chr8","120070226","120070537","chr8","120524386","120524693","18","454160"
"chr8","120077450","120077768","chr8","120531146","120531462","12","453696"
"chr8","120104474","120104761","chr6","14042630","14042915","58","106061844"
"chr8","120122101","120122329","chr8","120575575","120575803","4","453474"
"chr8","120143449","120143748","chr8","120597293","120597600","11","453844"
"chr8","120159992","120160298","chr8","120614229","120614534","6","454237"
"chr8","120208303","120208580","chr8","120658934","120659212","5","450631"
"chr8","120223995","120224311","chr8","120676789","120677100","17","452794"
"chr8","120236350","120236622","chr8","120689129","120689400","29","452779"
"chr8","120239198","120239256","chr7","24495022","24495084","17","95744176"
"chr8","120239428","120239546","chr11","95054991","95055105","24","25184437"
"chr8","120311714","120312009","chr8","120763417","120763712","8","451703"
"chr8","120565081","120565379","chr8","121019968","121020256","18","454887"
"chr8","120634577","120634884","chr8","121083915","121084223","7","449338"
"chr8","120642896","120642986","chr8","121092212","121092302","2","449316"
"chr8","120717972","120718264","chr8","121166277","121166568","7","448305"
"chr8","120804803","120804909","chr8","121257219","121257325","5","452416"
"chr8","120804951","120805123","chr8","121257363","121257531","13","452412"
"chr8","120809662","120809957","chr8","121260617","121260911","12","450955"
"chr8","120850584","120850864","chr8","121303990","121304302","42","453406"
"chr8","120852752","120852889","chr8","121307065","121307215","35","454313"
"chr8","120853114","120853210","chr18","38839111","38839208","17","82014003"
"chr8","120853926","120854077","chr8","121307065","121307215","6","453139"
"chr8","120855453","120855794","chr8","121308630","121308942","37","453177"
"chr8","120867098","120867396","chr8","121320230","121320508","33","453132"
"chr8","120953088","120953164","chr4","104181246","104181321","15","16771842"
"chr8","120975662","120975944","chr8","121416437","121416695","31","440775"
"chr8","121011488","121011784","chr8","121452359","121452655","22","440871"
"chr8","121011788","121012093","chr8","121452359","121452655","14","440571"
"chr8","121019291","121019591","chr20","3119953","3120233","71","117899338"
"chr8","121040444","121040755","chr8","121481795","121482092","22","441351"
"chr8","121094623","121094895","chr8","121538836","121539103","14","444213"
"chr8","121108674","121108986","chr8","121553170","121553485","17","444496"
"chr8","121118324","121118642","chr8","121563946","121564266","9","445622"
"chr8","121128440","121128749","chr8","121573899","121574202","23","445459"
"chr8","121157347","121157600","chr8","121603038","121603291","4","445691"
"chr8","121166314","121166631","chr8","121612007","121612321","17","445693"
"chr8","121168061","121168271","chr4","152814446","152814659","39","31646385"
"chr8","121191750","121192059","chr8","121637557","121637851","22","445807"
"chr8","121245691","121245855","chr17","1851229","1851393","36","119394462"
"chr8","121248634","121248782","chr10","28208998","28209143","29","93039636"
"chr8","121251818","121252103","chr8","121703606","121703883","13","451788"
"chr8","121471489","121471635","chr8","121923331","121923479","6","451842"
"chr8","121472166","121472329","chr8","121924008","121924161","16","451842"
"chr8","121514364","121514686","chr8","121967517","121967828","20","453153"
"chr8","121515334","121515642","chr8","121968484","121968794","25","453150"
"chr8","121517706","121517989","chr8","121971076","121971359","13","453370"
"chr8","121763875","121764161","chr8","122223119","122223405","9","459244"
"chr8","121777739","121778031","chr8","122237204","122237488","19","459465"
"chr8","121790611","121790738","chr8","81666522","81666649","29","40124089"
"chr8","121792269","121792556","chr8","122251061","122251351","8","458792"
"chr8","121844384","121844476","chr8","122302764","122302854","3","458380"
"chr8","121965347","121965487","chr8","122423393","122423533","1","458046"
"chr8","121998092","121998388","chr8","122456826","122457120","7","458734"
"chr8","122070299","122070611","chr8","122530104","122530416","9","459805"
"chr8","122112970","122113275","chr8","122576994","122577294","13","464024"
"chr8","122154888","122154990","chr8","122618786","122618888","4","463898"
"chr8","122166392","122166701","chr8","122630735","122631046","9","464343"
"chr8","122195278","122195564","chr4","1495409","1495709","63","120699869"
"chr8","122201342","122201639","chr8","122662719","122663016","14","461377"
"chr8","122243795","122244091","chr8","122705742","122706035","11","461947"
"chr8","122251562","122251769","chr8","122713353","122713561","6","461791"
"chr8","122262206","122262456","chr8","122724099","122724339","18","461893"
"chr8","122262463","122262748","chr8","122724346","122724631","5","461883"
"chr8","122264902","122265212","chr8","122726771","122727078","14","461869"
"chr8","122267031","122267346","chr8","122728882","122729190","13","461851"
"chr8","122267884","122268191","chr8","122729692","122730000","11","461808"
"chr8","122270728","122270781","chr8","122732540","122732593","0","461812"
"chr8","122270862","122271184","chr7","27874078","27874393","64","94396784"
"chr8","122278895","122279171","chr8","122740981","122741309","61","462086"
"chr8","122297179","122297435","chr8","122758835","122759114","28","461656"
"chr8","122302449","122302554","chr8","122764026","122764131","2","461577"
"chr8","122318267","122318557","chr8","122781374","122781666","10","463107"
"chr8","122319785","122320005","chr8","122782907","122783128","8","463122"
"chr8","122323341","122323622","chr8","122786787","122787068","11","463446"
"chr8","122331110","122331331","chr5","94131267","94131497","67","28199843"
"chr8","122341142","122341435","chr8","122798589","122798882","9","457447"
"chr8","122349208","122349292","chr8","122812971","122813055","2","463763"
"chr8","122364797","122365035","chr8","122828716","122829001","50","463919"
"chr8","122366088","122366256","chr16","69490163","69490326","41","52875925"
"chr8","122370305","122370420","chr8","122834250","122834347","19","463945"
"chr8","122379602","122379881","chr8","122843528","122843810","5","463926"
"chr8","122423013","122423223","chr8","122887864","122888074","6","464851"
"chr8","122426998","122427287","chr8","122892156","122892445","8","465158"
"chr8","122474870","122475167","chr8","122940249","122940546","5","465379"
"chr8","122484382","122484665","chr2","81149346","81149628","51","41335036"
"chr8","122508071","122508199","chr8","122973465","122973585","15","465394"
"chr8","122544153","122544410","chr14","28361285","28361548","63","94182868"
"chr8","122556922","122557173","chr8","123018863","123019113","7","461941"
"chr8","122570910","122571170","chr8","123032830","123033090","4","461920"
"chr8","122571237","122571428","chr20","23005231","23005404","69","99566006"
"chr8","122571459","122571578","chr10","71787480","71787597","18","50783979"
"chr8","122586470","122586762","chr8","123048524","123048824","13","462054"
"chr8","122620211","122620376","chr10","13063054","13063208","45","109557157"
"chr8","122901685","122901986","chr8","123366805","123367106","11","465120"
"chr8","123420928","123421234","chr8","123887176","123887484","8","466248"
"chr8","123442727","123442999","chr8","123909278","123909551","5","466551"
"chr8","123531781","123531925","chr8","123992332","123992478","6","460551"
"chr8","123668007","123668314","chr8","124126357","124126666","36","458350"
"chr8","123913098","123913235","chr8","124374848","124374981","6","461750"
"chr8","124039806","124040094","chr8","124505813","124506101","1","466007"
"chr8","124097772","124098073","chr8","124559424","124559727","13","461652"
"chr8","124107603","124107892","chr8","124569250","124569531","17","461647"
"chr8","124127073","124127386","chr19","29301646","29301959","83","94825427"
"chr8","124149338","124149638","chr8","124612419","124612718","8","463081"
"chr8","124189482","124189752","chr8","124652210","124652481","5","462728"
"chr8","124263321","124263624","chr2","173219206","173219502","69","48955885"
"chr8","124283057","124283176","chr8","124748564","124748684","2","465507"
"chr8","124284833","124285117","chr8","124750328","124750617","9","465495"
"chr8","124294757","124294866","chr8","124760066","124760175","10","465309"
"chr8","124295244","124295464","chr11","45961583","45961780","69","78333661"
"chr8","124303270","124303529","chr8","124768533","124768792","3","465263"
"chr8","124327820","124328100","chr16","31898834","31899110","55","92428986"
"chr8","124336413","124336697","chr8","124802689","124802973","2","466276"
"chr8","124342336","124342490","chr8","124808752","124808907","1","466416"
"chr8","124368384","124368488","chr8","124834899","124835003","1","466515"
"chr8","124385283","124385432","chr8","124851825","124851974","1","466542"
"chr8","124389238","124389478","chr8","124855201","124855439","21","465963"
"chr8","124427534","124427840","chr8","124893722","124894027","14","466188"
"chr8","124427862","124428021","chr3","34083106","34083268","34","90344756"
"chr8","124430185","124430477","chr8","124896325","124896617","10","466140"
"chr8","124436949","124437226","chrX","17348181","17348454","62","107088768"
"chr8","124439353","124439504","chr8","124905462","124905613","4","466109"
"chr8","124445259","124445559","chr8","124911422","124911723","6","466163"
"chr8","124454218","124454489","chr12","84650921","84651196","69","39803297"
"chr8","124454958","124455111","chr4","55851011","55851159","30","68603947"
"chr8","124457714","124457873","chr7","53483520","53483679","27","70974194"
"chr8","124463794","124464076","chr8","124929438","124929718","6","465644"
"chr8","124467333","124467505","chr8","124932813","124932984","8","465480"
"chr8","124467626","124467749","chr8","124933105","124933231","8","465479"
"chr8","124478471","124478761","chr8","124943974","124944264","5","465503"
"chr8","124485408","124485562","chr2","100069015","100069158","46","24416393"
"chr8","124486659","124486964","chr8","124951948","124952247","10","465289"
"chr8","124496873","124497181","chr8","124963076","124963383","7","466203"
"chr8","124508514","124508806","chr8","124974867","124975168","14","466353"
"chr8","124511509","124511782","chr8","124977856","124978147","24","466347"
"chr8","124526502","124526701","chr8","124992369","124992568","9","465867"
"chr8","124528243","124528471","chr8","124994095","124994323","9","465852"
"chr8","124531024","124531308","chr8","124996550","124996849","18","465526"
"chr8","124532830","124533117","chr8","124998368","124998655","10","465538"
"chr8","124542454","124542737","chr8","125008022","125008303","7","465568"
"chr8","124544039","124544163","chr11","82993111","82993234","24","41550928"
"chr8","124545949","124546086","chr9","40093373","40093504","28","84452576"
"chr8","124548915","124549225","chr8","125014314","125014624","8","465399"
"chr8","124549993","124550286","chr8","125015397","125015690","9","465404"
"chr8","124562095","124562272","chr8","125027417","125027577","20","465322"
"chr8","124562575","124562637","chr8","125027882","125027944","1","465307"
"chr8","124562773","124562939","chr7","19517713","19517888","35","105045060"
"chr8","124564651","124564829","chr15","23153963","23154137","37","101410688"
"chr8","124564861","124564997","chr10","14563682","14563817","24","110001179"
"chr8","124565824","124566112","chr8","125030882","125031170","6","465058"
"chr8","124608436","124608737","chr1","46891057","46891351","72","77717379"
"chr8","124609989","124610110","chr8","125073999","125074105","18","464010"
"chr8","124614168","124614467","chr8","125078198","125078500","14","464030"
"chr8","124615639","124615926","chr8","125079674","125079956","13","464035"
"chr8","124620594","124620887","chr8","125084660","125084954","10","464066"
"chr8","124623485","124623793","chr8","125086388","125086691","13","462903"
"chr8","124626251","124626533","chr8","125089188","125089467","10","462937"
"chr8","124628244","124628504","chr8","125091177","125091437","10","462933"
"chr8","124634551","124634834","chr8","125097471","125097754","3","462920"
"chr8","124638463","124638760","chr8","125101374","125101671","3","462911"
"chr8","124639491","124639795","chr8","125102402","125102705","13","462911"
"chr8","124643191","124643443","chr8","125106149","125106402","5","462958"
"chr8","124645928","124646218","chr8","125108902","125109193","7","462974"
"chr8","124669509","124669809","chr5","34124845","34125142","55","90544664"
"chr8","124687978","124688282","chr8","125151477","125151784","17","463499"
"chr8","124691940","124692238","chr8","125155439","125155738","11","463499"
"chr8","124692696","124692808","chr8","125156196","125156308","2","463500"
"chr8","124693213","124693413","chr8","125156713","125156912","4","463500"
"chr8","124699418","124699710","chr8","125162928","125163221","6","463510"
"chr8","124700580","124700869","chr8","125164103","125164395","25","463523"
"chr8","124701882","124702197","chr8","125165409","125165714","13","463527"
"chr8","124735135","124735444","chr8","125198178","125198488","9","463043"
"chr8","124741512","124741646","chr8","125204859","125204990","10","463347"
"chr8","124781865","124782139","chr8","125245266","125245509","37","463401"
"chr8","124787942","124788230","chr8","125251314","125251595","12","463372"
"chr8","124790109","124790418","chr8","125253476","125253776","25","463367"
"chr8","124859107","124859290","chr8","125322596","125322792","18","463489"
"chr8","124859316","124859346","chr8","125322822","125322852","0","463506"
"chr8","124902517","124902838","chr8","125365886","125366211","10","463369"
"chr8","124904759","124905065","chr8","125368059","125368364","4","463300"
"chr8","124916727","124917024","chr8","125380012","125380310","12","463285"
"chr8","124947580","124947851","chr8","125409380","125409651","4","461800"
"chr8","124959767","124960072","chr8","125421351","125421656","4","461584"
"chr8","124968221","124968516","chr8","125430908","125431191","19","462687"
"chr8","124982095","124982400","chr11","101134463","101134737","80","23847632"
"chr8","125012891","125013200","chr3","57637602","57637902","25","67375289"
"chr8","125041153","125041475","chr8","125504627","125504933","21","463474"
"chr8","125048292","125048417","chr8","125511892","125512018","6","463600"
"chr8","125147478","125147770","chr8","125614844","125615136","7","467366"
"chr8","125168815","125169013","chr8","125637325","125637526","7","468510"
"chr8","125169403","125169486","chr8","125637908","125637995","8","468505"
"chr8","125184445","125184737","chr8","125652380","125652678","16","467935"
"chr8","125215077","125215366","chr8","125682540","125682831","10","467463"
"chr8","125227172","125227455","chr8","125693722","125694033","34","466550"
"chr8","125227493","125227520","chr2","77628416","77628441","6","47599077"
"chr8","125260472","125260768","chr8","125728570","125728865","15","468098"
"chr8","125394857","125395105","chr8","125862859","125863125","28","468002"
"chr8","125442749","125443060","chr8","125909428","125909740","6","466679"
"chr8","125542962","125543251","chr8","126011328","126011629","24","468366"
"chr8","125578421","125578710","chr8","126046445","126046730","13","468024"
"chr8","125595252","125595555","chr8","126062706","126062997","24","467454"
"chr8","125660971","125661275","chr8","126132414","126132702","25","471443"
"chr8","125696153","125696394","chr8","126168262","126168528","32","472109"
"chr8","125753376","125753578","chr8","126233901","126234123","24","480525"
"chr8","125920830","125921055","chr8","126398846","126399053","25","478016"
"chr8","125955713","125956000","chr8","126434814","126435102","8","479101"
"chr8","125960886","125961171","chr8","126440006","126440320","37","479120"
"chr8","126067172","126067298","chr8","126548001","126548127","13","480829"
"chr8","126143203","126143522","chr8","126623132","126623446","28","479929"
"chr8","126264522","126264824","chr8","126746196","126746498","7","481674"
"chr8","126301876","126302187","chr8","126784688","126784977","30","482812"
"chr8","126536642","126536828","chr8","127019364","127019537","18","482722"
"chr8","126538330","126538616","chr8","127021056","127021335","13","482726"
"chr8","126686379","126686672","chr8","127171614","127171916","23","485235"
"chr8","126826974","126827197","chr15","57545834","57546067","59","69281140"
"chr8","126832001","126832174","chr7","16974276","16974454","37","109857725"
"chr8","126849699","126849869","chr8","127335489","127335660","7","485790"
"chr8","126906465","126906634","chr6","102665153","102665322","37","24241312"
"chr8","127040903","127041216","chr8","127532585","127532900","8","491682"
"chr8","127092056","127092334","chr8","127581742","127582026","11","489686"
"chr8","127139432","127139712","chr8","127628513","127628821","34","489081"
"chr8","127151392","127151693","chr8","127639831","127640130","10","488439"
"chr8","127192127","127192392","chr8","127681069","127681337","12","488942"
"chr8","127317814","127318083","chr8","127808654","127808923","4","490840"
"chr8","127359642","127359752","chr8","127849102","127849203","11","489460"
"chr8","127359803","127359993","chr18","50030408","50030603","38","77329395"
"chr8","127576054","127576364","chr8","128070756","128071067","13","494702"
"chr8","127702035","127702267","chr8","128203879","128204103","16","501844"
"chr8","127742209","127742469","chr8","128243911","128244202","41","501702"
"chr8","127780390","127780667","chr8","128282560","128282838","24","502170"
"chr8","127824204","127824492","chr8","128327052","128327338","13","502848"
"chr8","127863084","127863387","chr8","128364682","128364985","13","501598"
"chr8","127869581","127869713","chr8","128372425","128372560","6","502844"
"chr8","127968455","127968733","chr8","128472908","128473200","17","504453"
"chr8","127975941","127976143","chr8","128480363","128480565","2","504422"
"chr8","128019809","128019894","chr8","128523882","128523971","9","504073"
"chr8","128033697","128034002","chrX","142116490","142116801","54","14082793"
"chr8","128090325","128090610","chr8","128593269","128593566","24","502944"
"chr8","128096391","128096690","chr8","128599404","128599715","19","503013"
"chr8","128131244","128131541","chr8","128634640","128634937","5","503396"
"chr8","128154929","128155227","chr8","128656659","128656963","12","501730"
"chr8","128156886","128157164","chr8","128658614","128658884","17","501728"
"chr8","128159202","128159531","chr16","41607684","41607989","93","86551518"
"chr8","128203318","128203612","chr8","128704471","128704766","11","501153"
"chr8","128216861","128217016","chr8","94138574","94138715","40","34078287"
"chr8","128342137","128342419","chr8","128841007","128841284","10","498870"
"chr8","128376782","128377069","chr8","128877636","128877924","9","500854"
"chr8","128414382","128414492","chr8","128917367","128917477","2","502985"
"chr8","128414569","128414734","chr8","128917557","128917719","5","502988"
"chr8","128423848","128424132","chr8","128926837","128927121","21","502989"
"chr8","128458724","128459035","chr13","41851851","41852159","59","86606873"
"chr8","128469091","128469379","chr8","128973444","128973754","35","504353"
"chr8","128501082","128501401","chr8","129005556","129005875","7","504474"
"chr8","128575068","128575367","chr8","129081921","129082215","11","506853"
"chr8","128610049","128610366","chr8","129114198","129114515","8","504149"
"chr8","128669854","128670161","chr20","27160084","27160391","63","101509770"
"chr8","128817923","128818219","chr8","129325228","129325524","5","507305"
"chr8","128885074","128885376","chr8","129392899","129393210","17","507825"
"chr8","128901651","128901956","chr8","129409944","129410240","18","508293"
"chr8","129061215","129061537","chr8","129567693","129568015","9","506478"
"chr8","129063567","129063831","chr8","129569933","129570199","10","506366"
"chr8","129063832","129063903","chr19","33768959","33769027","14","95294873"
"chr8","129111409","129111614","chr8","129617590","129617796","5","506181"
"chr8","129127563","129127871","chr8","129633825","129634133","5","506262"
"chr8","129137276","129137548","chr8","129643527","129643799","9","506251"
"chr8","129147818","129148115","chr8","129654359","129654654","13","506541"
"chr8","129151368","129151532","chr8","129658042","129658207","5","506674"
"chr8","129173801","129174012","chr8","129680462","129680673","2","506661"
"chr8","129198315","129198425","chr3","55484975","55485076","41","73713340"
"chr8","129204249","129204561","chr8","129709450","129709762","3","505201"
"chr8","129225468","129225751","chr2","172475033","172475314","47","43249565"
"chr8","129237825","129238119","chr8","129743542","129743838","10","505717"
"chr8","129252850","129252970","chr5","103784948","103785065","18","25467902"
"chr8","129253018","129253188","chr1","125409055","125409223","28","3843963"
"chr8","129255633","129255923","chr8","129761307","129761597","11","505674"
"chr8","129266334","129266634","chr8","129772041","129772335","12","505707"
"chr8","129272795","129272847","chr6","118717922","118717975","16","10554873"
"chr8","129339567","129339788","chr11","130089781","130089993","44","750214"
"chr8","129371897","129372192","chr8","129880254","129880549","13","508357"
"chr8","129639970","129640258","chr8","130153351","130153639","8","513381"
"chr8","129714848","129715068","chr8","130228717","130228937","3","513869"
"chr8","129778961","129779252","chr8","130294315","130294599","21","515354"
"chr8","129901662","129901906","chr8","130417667","130417951","46","516005"
"chr8","129954808","129955067","chr8","130466261","130466521","10","511453"
"chr8","129989004","129989278","chr8","130501397","130501671","10","512393"
"chr8","130119343","130119644","chr8","130630915","130631215","14","511572"
"chr8","130219166","130219470","chr8","130729913","130730209","22","510747"
"chr8","130297471","130297632","chr8","130809679","130809839","7","512208"
"chr8","130418719","130419015","chr8","130933422","130933714","14","514703"
"chr8","130420601","130420879","chr8","130935277","130935554","9","514676"
"chr8","130578351","130578637","chr8","131093705","131093990","9","515354"
"chr8","130666487","130666775","chr18","41830229","41830520","60","88836258"
"chr8","130691098","130691407","chr8","131210204","131210499","25","519106"
"chr8","130716613","130716783","chr8","131236523","131236693","6","519910"
"chr8","130830462","130830725","chr8","131360191","131360452","5","529729"
"chr8","130862673","130862847","chr8","131393365","131393540","11","530692"
"chr8","130862879","130862998","chr8","131393572","131393691","6","530693"
"chr8","130916991","130917299","chr8","131445446","131445749","14","528455"
"chr8","130950266","130950380","chr8","131478690","131478785","19","528424"
"chr8","130957704","130957999","chr8","131486155","131486450","7","528451"
"chr8","130985901","130986197","chr5","142637298","142637591","58","11651397"
"chr8","131222016","131222274","chr8","131753906","131754180","34","531890"
"chr8","131313092","131313385","chr8","131837413","131837695","24","524321"
"chr8","131562290","131562563","chr8","132096808","132097115","40","534518"
"chr8","131701772","131702052","chr7","88708970","88709254","61","42992802"
"chr8","131802926","131803201","chr8","132348139","132348415","5","545213"
"chr8","132002305","132002598","chr8","10034943","10035230","58","121967362"
"chr8","132303320","132303620","chr8","132850978","132851277","9","547658"
"chr8","132476821","132477109","chr8","133023964","133024252","7","547143"
"chr8","132522842","132523159","chr8","133071394","133071706","21","548552"
"chr8","132555427","132555581","chr2","67925671","67925816","29","64629756"
"chr8","132938750","132938999","chr8","133489549","133489798","6","550799"
"chr8","133042372","133042663","chr8","133594017","133594306","11","551645"
"chr8","133104837","133105140","chr8","133655053","133655356","5","550216"
"chr8","133158297","133158474","chr8","133708143","133708321","4","549846"
"chr8","133162854","133163149","chr8","133712728","133713029","11","549874"
"chr8","133299587","133299881","chr8","133852122","133852439","25","552535"
"chr8","133308944","133309245","chr8","133861737","133862039","6","552793"
"chr8","133329824","133330119","chr20","48973208","48973499","66","84356616"
"chr8","133846954","133847194","chr8","134419647","134419887","7","572693"
"chr8","133852363","133852606","chr8","134431530","134431773","12","579167"
"chr8","134252797","134252961","chr8","134847035","134847202","8","594238"
"chr8","134419979","134420164","chr8","135012573","135012763","9","592594"
"chr8","134437576","134437828","chr8","135031885","135032141","12","594309"
"chr8","134460314","134460614","chr8","135054335","135054626","17","594021"
"chr8","134529441","134529728","chr8","135126833","135127120","14","597392"
"chr8","134541354","134541652","chr8","135138906","135139204","6","597552"
"chr8","134543473","134543770","chr8","135141005","135141295","17","597532"
"chr8","134557773","134558080","chr8","135155187","135155490","9","597414"
"chr8","134569010","134569303","chr8","135166267","135166565","10","597257"
"chr8","134570920","134571226","chr8","135168191","135168495","7","597271"
"chr8","134640251","134640545","chr8","135238377","135238622","56","598126"
"chr8","134641032","134641341","chr8","135239105","135239412","18","598073"
"chr8","134660997","134661285","chr8","135259910","135260194","8","598913"
"chr8","134667454","134667758","chr8","135266324","135266610","27","598870"
"chr8","134682600","134682853","chr8","135279357","135279609","8","596757"
"chr8","134703334","134703399","chr20","10976550","10976613","12","123726784"
"chr8","134703926","134704203","chr8","135301329","135301605","10","597403"
"chr8","134713094","134713390","chr8","135310348","135310636","17","597254"
"chr8","134722486","134722765","chr8","135321825","135322128","28","599339"
"chr8","134732800","134733085","chr8","135331933","135332242","31","599133"
"chr8","134744122","134744293","chr8","135344246","135344418","5","600124"
"chr8","134744565","134744727","chr8","135344690","135344860","17","600125"
"chr8","134778227","134778432","chr8","135379519","135379724","3","601292"
"chr8","134797391","134797544","chr8","135399317","135399470","3","601926"
"chr8","134797862","134798000","chr8","135399790","135399929","7","601928"
"chr8","134801967","134802256","chr8","135403852","135404150","22","601885"
"chr8","134808978","134809278","chr8","135411114","135411414","5","602136"
"chr8","134832936","134833244","chr8","135435735","135436041","12","602799"
"chr8","134854575","134854774","chr8","135457240","135457439","6","602665"
"chr8","134858255","134858398","chr8","135460885","135461034","10","602630"
"chr8","134858536","134858744","chr8","135461167","135461377","7","602631"
"chr8","134860489","134860775","chr8","135463103","135463391","10","602614"
"chr8","134867488","134867760","chr8","135469492","135469747","23","602004"
"chr8","134868523","134868829","chr8","135470530","135470844","15","602007"
"chr8","134876304","134876602","chr8","135480589","135480885","10","604285"
"chr8","134878499","134878792","chr13","115090995","115091287","66","19787504"
"chr8","134885527","134885593","chr8","135489871","135489938","3","604344"
"chr8","134886037","134886243","chr1","30228392","30228598","28","104657645"
"chr8","134890639","134890794","chr13","93024819","93024980","28","41865820"
"chr8","134891488","134891584","chr1","83183109","83183207","20","51708379"
"chr8","134894368","134894536","chrX","16632915","16633082","28","118261453"
"chr8","134911071","134911366","chr8","135518705","135519000","4","607634"
"chr8","134928943","134929158","chr8","135537390","135537604","7","608447"
"chr8","134945760","134946048","chr8","135553872","135554160","36","608112"
"chr8","134951725","134951882","chr8","135559561","135559718","1","607836"
"chr8","134964017","134964316","chr8","135571434","135571733","5","607417"
"chr8","134969539","134969775","chr8","135576965","135577201","0","607426"
"chr8","134973234","134973509","chr8","135580658","135580933","5","607424"
"chr8","134980030","134980297","chr10","29047313","29047589","53","105932717"
"chr8","134992454","134992701","chr8","135599320","135599574","8","606866"
"chr8","134992777","134993090","chr8","135599650","135599963","12","606873"
"chr8","134999766","135000000","chr3","36736557","36736796","57","98263209"
"chr8","135001011","135001229","chr8","135608105","135608318","14","607094"
"chr8","135004859","135005160","chr8","135612171","135612476","8","607312"
"chr8","135009921","135010195","chr8","135616915","135617187","10","606994"
"chr8","135017939","135018265","chr8","135625286","135625570","54","607347"
"chr8","135025126","135025409","chr8","135632532","135632798","24","607406"
"chr8","135025837","135026150","chr8","135633225","135633530","19","607388"
"chr8","135050221","135050461","chr17","75333338","75333591","62","59716883"
"chr8","135055456","135055744","chr8","135663983","135664271","8","608527"
"chr8","135122568","135122858","chr8","135733186","135733473","10","610618"
"chr8","135136443","135136723","chr8","135747130","135747409","5","610687"
"chr8","135137241","135137511","chr8","135747913","135748183","7","610672"
"chr8","135155183","135155468","chr8","135766138","135766431","16","610955"
"chr8","135179445","135179637","chr8","135790315","135790507","2","610870"
"chr8","135179728","135180029","chr8","135790598","135790893","21","610870"
"chr8","135191689","135191996","chr8","135802615","135802920","10","610926"
"chr8","135207803","135208042","chr8","135818623","135818866","9","610820"
"chr8","135208883","135209023","chr8","135820004","135820139","7","611121"
"chr8","135224570","135224802","chr8","135835795","135836028","7","611225"
"chr8","135225094","135225175","chr8","135836320","135836401","3","611226"
"chr8","135230510","135230818","chr13","69917529","69917839","59","65312981"
"chr8","135233172","135233474","chr19","9461037","9461337","62","125772135"
"chr8","135235625","135235938","chr8","135847411","135847714","20","611786"
"chr8","135237104","135237375","chr8","135848885","135849154","9","611781"
"chr8","135239113","135239406","chr8","135850903","135851198","11","611790"
"chr8","135252284","135252561","chr2","39670273","39670565","58","95582011"
"chr8","135277768","135278059","chr8","135890208","135890498","9","612440"
"chr8","135284661","135284959","chr8","135897184","135897482","7","612523"
"chr8","135289606","135289879","chr6","119851088","119851363","59","15438518"
"chr8","135306481","135306770","chr8","135920289","135920580","11","613808"
"chr8","135311882","135312192","chr8","135925697","135926006","22","613815"
"chr8","135343808","135344133","chr8","135957776","135958101","8","613968"
"chr8","135347601","135347904","chr8","135961540","135961831","17","613939"
"chr8","135348659","135348839","chr8","135962588","135962771","5","613929"
"chr8","135408722","135409015","chr8","136022691","136022984","10","613969"
"chr8","135422882","135423210","chr8","136036519","136036846","10","613637"
"chr8","135424347","135424646","chr8","136037980","136038279","9","613633"
"chr8","135427712","135427929","chr7","123708653","123708877","32","11719059"
"chr8","135429022","135429323","chr1","43125388","43125692","55","92303634"
"chr8","135429700","135430009","chr8","136042941","136043227","31","613241"
"chr8","135478293","135478467","chr8","136093675","136093850","7","615382"
"chr8","135481245","135481394","chr8","136096613","136096770","10","615368"
"chr8","135486093","135486389","chr8","136101503","136101800","8","615410"
"chr8","135486591","135486896","chr8","136102008","136102311","21","615417"
"chr8","135488214","135488515","chr8","136103645","136103950","17","615431"
"chr8","135505939","135506217","chr8","136121879","136122149","16","615940"
"chr8","135537572","135537855","chr8","136153664","136153956","14","616092"
"chr8","135539059","135539370","chr8","136155161","136155474","11","616102"
"chr8","135554662","135554937","chr8","136170558","136170832","4","615896"
"chr8","135573332","135573628","chr11","125705007","125705304","57","9868325"
"chr8","135580932","135581271","chr8","136197977","136198305","14","617045"
"chr8","135626079","135626366","chr8","136244482","136244784","27","618403"
"chr8","135635575","135635859","chr15","11552015","11552306","58","124083560"
"chr8","136075415","136075640","chr15","84808777","84809005","45","51266638"
"chr8","136082870","136083150","chr8","136696846","136697099","33","613976"
"chr8","136307301","136307614","chr8","136921807","136922110","21","614506"
"chr8","136573643","136573935","chr15","20591601","20591894","62","115982042"
"chr8","136647924","136648230","chr3","66448263","66448568","66","70199661"
"chr8","136680389","136680690","chr8","137284071","137284371","9","603682"
"chr8","136725239","136725534","chr8","137337118","137337414","13","611879"
"chr8","136800973","136801267","chr1","201751445","201751736","56","64950472"
"chr8","136817436","136817580","chr8","137429484","137429627","4","612048"
"chr8","136849981","136850294","chr8","137459754","137460066","4","609773"
"chr8","136854010","136854182","chr8","137464014","137464186","5","610004"
"chr8","136902467","136902760","chr8","137511950","137512248","20","609483"
"chr8","136959787","136960011","chr8","137571677","137571903","8","611890"
"chr8","136964415","136964699","chr8","137580364","137580629","21","615949"
"chr8","137066493","137066611","chrX","108130012","108130129","19","28936481"
"chr8","137066638","137066823","chr19","3220819","3220991","38","133845819"
"chr8","137096413","137096435","chr1","107296320","107296342","3","29800093"
"chr8","137096477","137096737","chr8","137720743","137720999","10","624266"
"chr8","137260040","137260336","chr8","137878706","137878996","18","618666"
"chr8","137267276","137267566","chr16","3695771","3696066","57","133571505"
"chr8","137272464","137272678","chr8","137895067","137895281","5","622603"
"chr8","137273306","137273527","chr8","137895874","137896111","19","622568"
"chr8","137274215","137274323","chr3","35508590","35508692","29","101765625"
"chr8","137274631","137274651","chr9","57412133","57412152","7","79862498"
"chr8","137282718","137282802","chr8","137894325","137894409","3","611607"
"chr8","137296186","137296263","chr8","137915734","137915811","1","619548"
"chr8","137297265","137297370","chr8","137916810","137916916","3","619545"
"chr8","137325836","137326008","chr8","137943501","137943673","6","617665"
"chr8","137344741","137344961","chr8","137967411","137967642","18","622670"
"chr8","137368450","137368752","chr8","137992409","137992703","14","623959"
"chr8","137368964","137369098","chr8","137993228","137993362","7","624264"
"chr8","137369376","137369677","chr7","32290173","32290475","68","105079203"
"chr8","137375757","137376065","chr8","138000543","138000852","9","624786"
"chr8","137408694","137408841","chr8","138033324","138033471","4","624630"
"chr8","137408869","137408946","chr8","138033506","138033576","13","624637"
"chr8","137421991","137422198","chr13","59869851","59870056","46","77552140"
"chr8","137457667","137457974","chr8","138083698","138084006","14","626031"
"chr8","137461042","137461338","chr8","138086765","138087073","35","625723"
"chr8","137510758","137511039","chr8","138136938","138137226","9","626180"
"chr8","137526724","137526903","chr8","138152878","138153075","30","626154"
"chr8","137537383","137537417","chr4","14956334","14956369","5","122581049"
"chr8","137537707","137537851","chr8","138172347","138172491","9","634640"
"chr8","137538148","137538284","chr8","138172788","138172924","0","634640"
"chr8","137579666","137579972","chr8","138213609","138213912","6","633943"
"chr8","137580681","137580993","chr8","138214627","138214947","12","633946"
"chr8","137589612","137589872","chr8","138226321","138226581","5","636709"
"chr8","137609170","137609471","chr8","138245431","138245727","13","636261"
"chr8","137616354","137616650","chr14","31817216","31817510","51","105799138"
"chr8","137631202","137631402","chr1","85928615","85928821","42","51702587"
"chr8","137637961","137638119","chr8","138274632","138274792","5","636671"
"chr8","137676597","137676889","chr1","46474018","46474315","74","91202579"
"chr8","137721521","137721817","chr8","138355899","138356201","11","634378"
"chr8","137743029","137743315","chr8","138376897","138377184","12","633868"
"chr8","137751590","137751891","chr8","138385577","138385884","12","633987"
"chr8","137767548","137767860","chr8","138402163","138402475","5","634615"
"chr8","137776053","137776071","chr1","28172824","28172841","6","109603229"
"chr8","137776687","137776861","chr8","138411912","138412085","9","635225"
"chr8","137850167","137850313","chr8","138486868","138487014","2","636701"
"chr8","137850620","137850798","chr8","138487311","138487489","8","636691"
"chr8","137851220","137851526","chr8","138487937","138488242","5","636717"
"chr8","137857537","137857711","chr8","138495069","138495260","22","637532"
"chr8","137931265","137931560","chr8","138562899","138563193","10","631634"
"chr8","137968075","137968388","chr8","138601033","138601343","10","632958"
"chr8","137971437","137971747","chr8","138604714","138605010","21","633277"
"chr8","137974854","137975149","chr8","138608427","138608733","18","633573"
"chr8","137975949","137976197","chr8","138609879","138610127","4","633930"
"chr8","137976729","137976777","chr3","44875179","44875224","10","93101550"
"chr8","137981032","137981180","chr6","96720045","96720196","34","41260987"
"chr8","137982791","137983102","chr8","138612337","138612646","24","629546"
"chr8","137986529","137986649","chr8","138616741","138616864","6","630212"
"chr8","137986941","137986983","chr8","138617153","138617188","7","630212"
"chr8","137993552","137993834","chr10","14113633","14113909","56","123879919"
"chr8","138003224","138003393","chr8","138639376","138639545","1","636152"
"chr8","138003693","138003830","chr8","138639847","138639985","1","636154"
"chr8","138018502","138018776","chr8","138654572","138654846","9","636070"
"chr8","138019139","138019239","chr8","138655210","138655309","3","636071"
"chr8","138101791","138102044","chr8","138744044","138744297","4","642253"
"chr8","138104169","138104466","chr8","138746624","138746946","41","642455"
"chr8","138110698","138111006","chr8","138753225","138753538","10","642527"
"chr8","138112449","138112777","chr8","138754987","138755316","11","642538"
"chr8","138118599","138118685","chr8","36293127","36293209","20","101825472"
"chr8","138165350","138165647","chr16","56130340","56130646","56","82035010"
"chr8","138207322","138207623","chr17","75415215","75415528","57","62792107"
"chr8","138209017","138209316","chr4","109728565","109728868","51","28480452"
"chr8","138210584","138210711","chr14","68169781","68169906","27","70040803"
"chr8","138211788","138212069","chr1","21874946","21875223","54","116336842"
"chr8","138212329","138212513","chr1","163823073","163823253","51","25610744"
"chr8","138214861","138215132","chrX","106775145","106775419","57","31439716"
"chr8","138221669","138221989","chr9","1895748","1896057","63","136325921"
"chr8","138242029","138242090","chr8","125367999","125368058","16","12874030"
"chr8","138251242","138251538","chr6","51072032","51072325","49","87179210"
"chr8","138252643","138252902","chr5","1959362","1959603","56","136293281"
"chr8","138287066","138287378","chr6","141182891","141183203","60","2895825"
"chr8","138303768","138304049","chr1","137861151","137861445","61","442617"
"chr8","138306860","138306998","chr19","3445798","3445938","26","134861062"
"chr8","138332000","138332318","chr13","84452913","84453227","53","53879087"
"chr8","138334317","138334544","chr8","118294670","118294909","62","20039647"
"chr8","138344741","138345010","chr10","82949030","82949297","54","55395711"
"chr8","138365283","138365604","chr2","173183939","173184255","64","34818656"
"chr8","138372835","138373148","chr5","19358931","19359234","67","119013904"
"chr8","138377900","138378069","chrX","50683957","50684124","31","87693943"
"chr8","138379833","138380123","chrX","62886100","62886390","53","75493733"
"chr8","138393196","138393515","chr1","12679207","12679521","67","125713989"
"chr8","138405227","138405393","chr10","14462717","14462877","32","123942510"
"chr8","138405592","138405727","chr9","12193942","12194077","34","126211650"
"chr8","138409497","138409671","chr16","42650878","42651052","31","95758619"
"chr8","138418783","138419091","chrX","15697361","15697669","62","122721422"
"chr8","138421217","138421512","chr11","123646307","123646605","57","14774910"
"chr8","138439302","138439604","chr8","138791914","138792219","7","352612"
"chr8","138459194","138459391","chr8","138812005","138812202","5","352811"
"chr8","138495871","138496039","chr4","151430093","151430261","28","12934222"
"chr8","138508570","138508730","chr11","31324081","31324242","39","107184489"
"chr8","138508759","138508894","chr3","124145377","124145502","31","14363382"
"chr8","138551861","138552000","chr8","138917052","138917191","2","365191"
"chr8","138552305","138552441","chr8","138917497","138917632","1","365192"
"chr8","138576278","138576492","chr8","138935173","138935387","3","358895"
"chr8","138585560","138585845","chr8","138946814","138947100","4","361254"
"chr8","138628985","138629133","chr10","30781278","30781412","28","107847707"
"chr8","138629433","138629607","chrX","25068013","25068183","42","113561420"
"chr8","138650273","138650413","chr8","139006721","139006853","9","356448"
"chr8","138682714","138682976","chr8","139040385","139040644","13","357671"
"chr8","138688376","138688660","chr8","139046051","139046336","17","357675"
"chr8","138697566","138697836","chr8","139055655","139055925","1","358089"
"chr8","138699547","138699840","chr8","139057439","139057732","4","357892"
"chr8","138702252","138702540","chr8","139059858","139060164","19","357606"
"chr8","138705866","138706014","chr8","139063494","139063642","3","357628"
"chr8","138706314","138706488","chr8","139063944","139064118","1","357630"
"chr8","138708767","138709042","chr8","139066406","139066677","34","357639"
"chr8","138754295","138754587","chr8","139112338","139112629","9","358043"
"chr8","138777112","138777249","chr8","139136317","139136457","6","359205"
"chr8","138777546","138777716","chr8","139136750","139136920","4","359204"
"chr8","138779132","138779409","chr8","139138560","139138846","12","359428"
"chr8","138786206","138786509","chr8","139145348","139145639","21","359142"
"chr8","138791908","138792187","chr8","139151751","139152030","3","359843"
"chr8","138800805","138800895","chr8","139162147","139162238","2","361342"
"chr8","138810588","138810804","chr13","64022072","64022284","44","74788516"
"chr8","138813879","138814010","chr5","101312723","101312844","36","37501156"
"chr8","138818439","138818566","chr8","139179834","139179969","14","361395"
"chr8","138828127","138828384","chr8","139188658","139188910","10","360531"
"chr8","138831623","138831791","chr8","139192647","139192823","8","361024"
"chr8","138836871","138837080","chr8","139197836","139198048","6","360965"
"chr8","138844749","138845035","chr8","139208040","139208326","4","363291"
"chr8","138856163","138856448","chr8","139220541","139220826","2","364378"
"chr8","138868776","138869086","chr8","139235267","139235576","5","366491"
"chr8","138876378","138876674","chr8","139242865","139243161","9","366487"
"chr8","138879080","138879382","chr8","139251719","139252017","10","372639"
"chr8","138880347","138880650","chr8","139253017","139253322","4","372670"
"chr8","138888179","138888445","chr8","139248223","139248465","28","360044"
"chr8","138933571","138933729","chr3","43918917","43919071","32","95014654"
"chr8","138946369","138946485","chr3","2768409","2768528","22","136177960"
"chr8","138946762","138946953","chr7","30026174","30026363","45","108920588"
"chr8","138947296","138947605","chr8","139318523","139318828","9","371227"
"chr8","138951409","138951713","chr8","139322625","139322885","46","371216"
"chr8","138966007","138966300","chr8","139338629","139338922","5","372622"
"chr8","138967839","138968005","chr3","42058449","42058616","39","96909390"
"chr8","138976863","138977148","chr8","139347037","139347322","8","370174"
"chr8","138977175","138977459","chr8","139347348","139347642","15","370173"
"chr8","138982910","138983223","chr8","139353025","139353333","7","370115"
"chr8","138985201","138985485","chr8","139355332","139355618","7","370131"
"chr8","138999727","138999837","chr1","124207873","124207985","25","14791854"
"chr8","139013127","139013411","chr8","139384183","139384459","12","371056"
"chr8","139051503","139051756","chr8","139422696","139422949","16","371193"
"chr8","139058023","139058183","chr5","43543601","43543745","43","95514422"
"chr8","139062332","139062594","chr8","139433213","139433475","4","370881"
"chr8","139089120","139089407","chr5","121650793","121651081","4","17438327"
"chr8","139113706","139113984","chr8","139483980","139484254","7","370274"
"chr8","139116333","139116606","chr8","139486606","139486879","6","370273"
"chr8","139119239","139119384","chr8","139489533","139489678","5","370294"
"chr8","139215000","139215141","chr8","139593158","139593307","12","378158"
"chr8","139243642","139243938","chr1","163551503","163551805","63","24307861"
"chr8","139267019","139267288","chr8","139619980","139620245","6","352961"
"chr8","139281839","139281962","chr7","160072024","160072150","39","20790185"
"chr8","139292893","139293191","chr1","29634469","29634766","60","109658424"
"chr9","17825647","17825930","chr9","17524822","17525105","11","300825"
"chr9","57671558","57671865","chr9","56047264","56047548","34","1624294"
"chr9","4587513","4587811","chr2","85365270","85365563","54","80777757"
"chr9","16383856","16384153","chr14","109615954","109616245","70","93232098"
"chr9","17694466","17694759","chr9","17392162","17392453","6","302304"
"chr9","56360732","56361029","chr9","54716088","54716385","8","1644644"
"chr9","76021663","76021945","chr9","74683745","74684010","24","1337918"
"chr9","111804358","111804656","chr9","110607036","110607336","6","1197322"
"chr9","1475","1599","chr2","47161","47285","4","45686"
"chr9","2157","2321","chr2","46434","46586","14","44277"
"chr9","4581","4832","chr2","43938","44184","13","39357"
"chr9","4969","5108","chr2","43662","43801","9","38693"
"chr9","100388","100688","chr9","45533","45834","10","54855"
"chr9","100728","100780","chr3","55484623","55484674","16","55383895"
"chr9","103657","103900","chr9","48814","49057","8","54843"
"chr9","109379","109412","chr9","54518","54551","0","54861"
"chr9","109732","109896","chr9","54872","55031","11","54860"
"chr9","110496","110506","chr19","28248347","28248357","0","28137851"
"chr9","111985","112333","chr9","57133","57480","8","54852"
"chr9","132498","132760","chr9","77059","77321","7","55439"
"chr9","159010","159301","chr1","29634469","29634766","49","29475459"
"chr9","170096","170370","chr9","113983","114257","2","56113"
"chr9","181104","181403","chr9","128336","128632","5","52768"
"chr9","183622","183785","chr9","66700561","66700724","28","66516939"
"chr9","210686","210977","chr9","158559","158852","5","52127"
"chr9","216443","216715","chr6","109764005","109764287","55","109547562"
"chr9","221487","221592","chr14","52892496","52892602","30","52671009"
"chr9","221895","222070","chr1","188751467","188751638","41","188529572"
"chr9","222206","222372","chr9","169910","170075","4","52296"
"chr9","262288","262581","chr9","210783","211076","7","51505"
"chr9","312869","313170","chr9","261197","261499","6","51672"
"chr9","337696","337814","chr4","32764855","32764970","19","32427159"
"chr9","341153","341484","chr13","124555152","124555461","73","124213999"
"chr9","345990","346279","chr9","294773","295061","21","51217"
"chr9","351046","351205","chr9","299849","300008","9","51197"
"chr9","351227","351364","chr16","28973221","28973364","21","28621994"
"chr9","355498","355636","chr3","49977557","49977698","35","49622059"
"chr9","418777","419112","chr9","369599","369930","15","49178"
"chr9","440231","440518","chr9","391066","391348","19","49165"
"chr9","476202","476490","chr9","425810","426094","21","50392"
"chr9","478842","479072","chr9","428425","428667","19","50417"
"chr9","487473","487786","chr6","106255013","106255325","30","105767540"
"chr9","508395","508639","JH682372","419","662","14","507976"
"chr9","543282","543568","chr9","532668","532951","29","10614"
"chr9","554857","555154","chrX","34424789","34425087","28","33869932"
"chr9","573563","573726","chr6","106295104","106295270","16","105721541"
"chr9","695928","696075","chr9","801634","801780","3","105706"
"chr9","696438","696520","chr9","802143","802226","3","105705"
"chr9","697281","697400","chr15","48366372","48366486","25","47669091"
"chr9","718553","718711","chr9","825692","825849","7","107139"
"chr9","759497","759675","chr9","870098","870261","24","110601"
"chr9","819611","819885","chr9","933224","933498","8","113613"
"chr9","844473","844747","chr4","103585966","103586236","62","102741493"
"chr9","865471","865696","chr5","45415168","45415387","57","44549697"
"chr9","869462","869744","chr9","983658","983982","50","114196"
"chr9","877622","877914","chr9","991832","992123","13","114210"
"chr9","883441","883741","chr9","997598","997892","7","114157"
"chr9","890041","890305","chr20","1582910","1583171","77","692869"
"chr9","894937","895208","chr9","1009364","1009635","9","114427"
"chr9","903266","903567","chr9","1018180","1018481","7","114914"
"chr9","910867","911049","chr9","1025973","1026154","9","115106"
"chr9","922997","923268","chr9","1040378","1040649","5","117381"
"chr9","940367","940608","chr3","52171158","52171411","53","51230791"
"chr9","974352","974623","chr9","1094551","1094822","3","120199"
"chr9","978633","978733","chr1","64356404","64356510","29","63377771"
"chr9","1089158","1089406","chr9","1208264","1208512","0","119106"
"chr9","1156905","1156992","chr14","44363486","44363564","19","43206581"
"chr9","1156993","1157131","chr1","34449352","34449486","24","33292359"
"chr9","1232034","1232297","chr9","1350669","1350958","32","118635"
"chr9","1257701","1258016","chr9","1378113","1378428","7","120412"
"chr9","1314214","1314499","chr9","1435076","1435365","16","120862"
"chr9","1395802","1396109","chr9","1519213","1519525","12","123411"
"chr9","1413867","1414153","chr9","1538117","1538403","6","124250"
"chr9","1425730","1425852","chr2","59731765","59731884","36","58306035"
"chr9","1425904","1425967","chr9","124894157","124894220","17","123468253"
"chr9","1433258","1433514","chr9","1558104","1558353","21","124846"
"chr9","1510630","1510934","chr9","1637833","1638139","20","127203"
"chr9","1531400","1531615","chr9","1659004","1659220","15","127604"
"chr9","1534023","1534325","chr9","1661691","1661996","8","127668"
"chr9","1546271","1546563","chr9","1674569","1674863","12","128298"
"chr9","1653748","1654025","chr9","1782757","1783033","6","129009"
"chr9","1684833","1685136","chr9","1812656","1812965","12","127823"
"chr9","1714755","1714994","chr9","1847452","1847691","5","132697"
"chr9","1715157","1715212","chr5","118497961","118498012","13","116782804"
"chr9","1763537","1763828","chr9","1895748","1896057","26","132211"
"chr9","1796003","1796321","chr9","1926938","1927249","19","130935"
"chr9","1797347","1797609","chr9","1928254","1928513","9","130907"
"chr9","1816839","1816932","chr9","1944385","1944478","3","127546"
"chr9","1818225","1818500","chr6","53390309","53390595","70","51572084"
"chr9","1836015","1836301","chr10","18918672","18918950","63","17082657"
"chr9","1844505","1844809","chr9","1971759","1972059","17","127254"
"chr9","1846249","1846382","chr9","1974419","1974550","5","128170"
"chr9","1867074","1867394","chr6","67137582","67137897","88","65270508"
"chr9","1884298","1884467","chr9","2014566","2014735","8","130268"
"chr9","1987092","1987281","chr19","44394983","44395172","40","42407891"
"chr9","2008078","2008385","chr9","2132036","2132344","7","123958"
"chr9","2065641","2065938","chr9","2188740","2189037","8","123099"
"chr9","2078720","2079033","chr9","2200702","2201015","8","121982"
"chr9","2092477","2092601","chr1","30366952","30367085","26","28274475"
"chr9","2092765","2093036","chr9","2213883","2214154","10","121118"
"chr9","2101653","2101914","chr9","2221439","2221704","16","119786"
"chr9","2111351","2111523","chr9","2231379","2231554","9","120028"
"chr9","2137228","2137366","chr9","2258026","2258154","25","120798"
"chr9","2146699","2146926","chr9","2268392","2268619","9","121693"
"chr9","2172022","2172225","chr9","2292742","2292945","5","120720"
"chr9","2177436","2177682","chr9","2298064","2298306","17","120628"
"chr9","2206469","2206778","chr6","74229117","74229416","66","72022648"
"chr9","2230782","2231008","chr9","2350151","2350377","5","119369"
"chr9","2253115","2253405","chr9","2371633","2371923","9","118518"
"chr9","2643618","2643905","chr9","2746565","2746858","16","102947"
"chr9","2695335","2695519","chr9","2792185","2792384","21","96850"
"chr9","2696442","2696539","chr8","81797639","81797745","32","79101197"
"chr9","2745050","2745324","chr9","2835775","2836038","26","90725"
"chr9","2750360","2750667","chr9","2840142","2840449","5","89782"
"chr9","2769672","2769851","chr9","2858676","2858849","11","89004"
"chr9","2774887","2775223","chr9","2863382","2863675","50","88495"
"chr9","2874612","2874800","chr9","2964846","2965034","5","90234"
"chr9","3013304","3013414","chr9","3097940","3098050","1","84636"
"chr9","3013768","3013953","chr9","3098404","3098589","3","84636"
"chr9","3014379","3014656","chr9","3099015","3099292","8","84636"
"chr9","3024956","3025252","chr9","3109814","3110112","12","84858"
"chr9","3036249","3036552","chr9","3119809","3120086","39","83560"
"chr9","3123556","3123871","chr9","3204032","3204341","18","80476"
"chr9","3177710","3177888","chr9","3262015","3262192","8","84305"
"chr9","3194988","3195131","chr9","3280344","3280481","23","85356"
"chr9","3196367","3196502","chr9","3280344","3280481","6","83977"
"chr9","3198356","3198430","chr5","97094538","97094621","31","93896182"
"chr9","3208747","3209009","chr9","3292187","3292456","12","83440"
"chr9","3223854","3223957","chr10","46313222","46313327","28","43089368"
"chr9","3263472","3263757","chr9","3337490","3337775","12","74018"
"chr9","3265995","3266294","chr9","3339410","3339673","46","73415"
"chr9","3365321","3365491","chr9","3443083","3443254","6","77762"
"chr9","3395954","3396274","chr9","3471256","3471558","27","75302"
"chr9","3402479","3402782","chr9","3476948","3477240","23","74469"
"chr9","3422095","3422247","chrX","16522438","16522587","32","13100343"
"chr9","3565707","3566007","chr9","3628642","3628938","11","62935"
"chr9","3608204","3608334","chr9","3670613","3670743","1","62409"
"chr9","3608510","3608756","chr9","3670943","3671189","9","62433"
"chr9","3608760","3608892","chr9","3671193","3671325","4","62433"
"chr9","3755271","3755548","chr9","3808309","3808586","4","53038"
"chr9","3802977","3803072","chr9","3856933","3857021","11","53956"
"chr9","3933583","3933875","chr9","3983774","3984065","5","50191"
"chr9","3947681","3947810","chr9","3997556","3997676","12","49875"
"chr9","3947887","3948038","chr9","3997790","3997923","25","49903"
"chr9","3952659","3952951","chr9","4002560","4002840","20","49901"
"chr9","3956442","3956708","chr9","4006146","4006412","10","49704"
"chr9","3974418","3974694","chr9","4023368","4023662","46","48950"
"chr9","3974732","3974927","chr17","30863147","30863340","44","26888415"
"chr9","3997347","3997526","chr9","4046051","4046232","5","48704"
"chr9","3997830","3997978","chr9","4046537","4046685","7","48707"
"chr9","4009991","4010285","chr9","4058777","4059071","7","48786"
"chr9","4010322","4010490","chr1","115396634","115396806","36","111386312"
"chr9","4012434","4012753","chr9","4060869","4061189","13","48435"
"chr9","4031324","4031634","chr9","4078778","4079076","24","47454"
"chr9","4063659","4063947","chr9","4108945","4109237","11","45286"
"chr9","4073614","4073678","chr7","87347138","87347200","13","83273524"
"chr9","4140898","4141163","chr9","4187987","4188251","7","47089"
"chr9","4207580","4207856","chr9","4252147","4252424","8","44567"
"chr9","4309525","4309827","chr9","4353853","4354168","23","44328"
"chr9","4374711","4374908","chr9","4414925","4415122","5","40214"
"chr9","4388310","4388358","chr12","86304221","86304265","15","81915911"
"chr9","4394497","4394799","chr9","4433423","4433727","8","38926"
"chr9","4532201","4532520","chr9","4566891","4567199","20","34690"
"chr9","4552509","4552797","chr9","4587346","4587633","12","34837"
"chr9","4560665","4560962","chr9","4595617","4595961","57","34952"
"chr9","4626131","4626397","chr9","4656968","4657234","4","30837"
"chr9","4629855","4630139","chr9","4660661","4660947","14","30806"
"chr9","4641993","4642291","chr8","61522372","61522671","56","56880379"
"chr9","4844967","4845204","chr7","123708653","123708877","54","118863686"
"chr9","4859329","4859627","chr9","4890437","4890735","17","31108"
"chr9","4874982","4875266","chr9","4904350","4904662","40","29368"
"chr9","4922321","4922615","chr10","86922334","86922627","60","82000013"
"chr9","5062562","5062872","chr9","5087619","5087929","2","25057"
"chr9","5106880","5107123","chr9","5141215","5141459","14","34335"
"chr9","5269462","5269686","chr16","18888259","18888474","52","13618797"
"chr9","5335707","5335996","chr9","5368800","5369089","8","33093"
"chr9","5437376","5437459","chr9","5513482","5513564","6","76106"
"chr9","5453842","5454107","chr9","5529777","5530042","12","75935"
"chr9","5502252","5502556","chr9","5577881","5578185","8","75629"
"chr9","5505138","5505407","chr9","5580719","5580988","14","75581"
"chr9","5509588","5509886","chr9","5585346","5585646","10","75758"
"chr9","5616982","5617124","chr6","144818898","144819036","24","139201916"
"chr9","5638633","5638960","chr7","38750002","38750303","86","33111369"
"chr9","5649969","5650285","chr9","5731084","5731400","10","81115"
"chr9","5669140","5669442","chr9","5750814","5751112","8","81674"
"chr9","5682920","5683199","chr9","5765156","5765435","12","82236"
"chr9","5683231","5683243","chr1","12914116","12914128","10","7230885"
"chr9","5683275","5683286","chr1","109427498","109427509","2","103744223"
"chr9","5712962","5713094","chr9","5796686","5796818","4","83724"
"chr9","5715670","5715935","chr16","29298629","29298894","53","23582959"
"chr9","5721361","5721674","chr9","5804717","5805002","45","83356"
"chr9","5731491","5731565","chr9","5814802","5814876","7","83311"
"chr9","5733073","5733172","chr9","5816411","5816509","6","83338"
"chr9","5734169","5734384","chr9","5817508","5817723","4","83339"
"chr9","5736003","5736307","chr9","5819340","5819652","18","83337"
"chr9","5761480","5761766","chr9","5844519","5844827","25","83039"
"chr9","5771581","5771895","chr9","5854954","5855265","13","83373"
"chr9","5785838","5786169","chr9","5869328","5869662","9","83490"
"chr9","5838459","5838760","chr15","74219376","74219673","46","68380917"
"chr9","5840005","5840099","chr3","81173316","81173418","27","75333311"
"chr9","5846327","5846457","chr9","5930062","5930191","3","83735"
"chr9","5846749","5846867","chr9","5930478","5930598","9","83729"
"chr9","5885019","5885303","chr4","119713035","119713321","58","113828016"
"chr9","5890038","5890328","chr9","5974369","5974659","2","84331"
"chr9","5890329","5890561","chr9","5974660","5974892","3","84331"
"chr9","5899027","5899326","chr9","5983421","5983709","20","84394"
"chr9","5911029","5911278","chr9","5997216","5997480","17","86187"
"chr9","5912457","5912703","chr9","5998656","5998903","3","86199"
"chr9","5917441","5917725","chr9","6003615","6003903","6","86174"
"chr9","5927300","5927598","chr9","6013402","6013696","21","86102"
"chr9","5934569","5934832","chr9","6020634","6020899","11","86065"
"chr9","5936043","5936338","chr9","6022023","6022318","10","85980"
"chr9","5940103","5940357","chr15","23361820","23362081","65","17421717"
"chr9","5941769","5941928","chr19","3704035","3704196","28","2237734"
"chr9","5941956","5942045","chr7","107121290","107121378","20","101179334"
"chr9","5942072","5942396","chr13","45575878","45576186","59","39633806"
"chr9","5947341","5947646","chrX","46852707","46853016","41","40905366"
"chr9","5948560","5948875","chr9","6031562","6031855","32","83002"
"chr9","5950726","5951009","chr4","122595128","122595418","58","116644402"
"chr9","5952101","5952414","chrX","142116490","142116801","59","136164389"
"chr9","5956120","5956413","chr9","6038492","6038785","10","82372"
"chr9","5957556","5957851","chr9","6040935","6041224","15","83379"
"chr9","5963115","5963401","chr9","6046471","6046766","19","83356"
"chr9","6040446","6040729","chr18","4414869","4415145","60","1625577"
"chr9","6042417","6042727","chr9","6127015","6127325","12","84598"
"chr9","6044643","6044896","chr1","22100125","22100373","55","16055482"
"chr9","6047669","6047826","chr9","6132048","6132200","11","84379"
"chr9","6055361","6055508","chr2","172227852","172227991","31","166172491"
"chr9","6057303","6057596","chr9","6141828","6142120","14","84525"
"chr9","6057697","6057874","chr10","71163370","71163544","37","65105673"
"chr9","6062502","6062608","chr14","68723559","68723662","15","62661057"
"chr9","6084486","6084867","chr9","6169294","6169669","15","84808"
"chr9","6105962","6106252","chr9","6192560","6192858","19","86598"
"chr9","6109035","6109320","chr9","6195621","6195912","21","86586"
"chr9","6148307","6148470","chr9","6234636","6234799","3","86329"
"chr9","6185589","6185870","chr9","6271600","6271881","3","86011"
"chr9","6189776","6190062","chr9","6275777","6276067","9","86001"
"chr9","6192675","6192863","chr9","6278666","6278837","26","85991"
"chr9","6198768","6199063","chr9","6284727","6285018","15","85959"
"chr9","6209067","6209363","chr9","6295438","6295743","23","86371"
"chr9","6227033","6227316","chr9","6318933","6319216","3","91900"
"chr9","6250895","6251192","chr9","6343893","6344192","9","92998"
"chr9","6255804","6256104","chr9","6349196","6349482","23","93392"
"chr9","6260058","6260363","chrX","46188798","46189102","52","39928740"
"chr9","6267095","6267244","chr3","40685620","40685768","25","34418525"
"chr9","6267273","6267308","chr11","111118673","111118709","9","104851400"
"chr9","6276598","6276898","chr9","6370613","6370913","9","94015"
"chr9","6279869","6280168","chr9","6373837","6374134","7","93968"
"chr9","6295304","6295553","chr9","6391173","6391425","18","95869"
"chr9","6303863","6304149","chr9","6398719","6399006","10","94856"
"chr9","6321039","6321307","chr9","6416209","6416496","33","95170"
"chr9","6343359","6343672","chr9","6439441","6439753","5","96082"
"chr9","6356798","6357088","chr9","6453188","6453478","12","96390"
"chr9","6358924","6359212","chr9","6455313","6455606","10","96389"
"chr9","6386748","6387089","chr9","6483487","6483790","48","96739"
"chr9","6392752","6393043","chr9","6489340","6489639","20","96588"
"chr9","6435745","6436053","chr9","6531380","6531693","10","95635"
"chr9","6436814","6437065","chr9","6532161","6532430","24","95347"
"chr9","6441749","6441972","chr9","6540338","6540557","13","98589"
"chr9","6541309","6541572","chr9","6636528","6636802","16","95219"
"chr9","6544007","6544310","chr6","61041618","61041916","61","54497611"
"chr9","6605937","6606207","chr9","6701404","6701674","11","95467"
"chr9","6649699","6649962","chr9","6744884","6745153","21","95185"
"chr9","6668810","6669096","chr9","6764801","6765087","16","95991"
"chr9","6733088","6733238","chr9","6824064","6824220","11","90976"
"chr9","6741260","6741440","chr9","6832246","6832429","11","90986"
"chr9","6795365","6795671","chr9","6886908","6887194","31","91543"
"chr9","6838824","6839119","chr9","6931521","6931816","11","92697"
"chr9","6886899","6887199","chr9","6980496","6980789","10","93597"
"chr9","6911952","6912259","chr9","7005408","7005709","13","93456"
"chr9","6943650","6943948","chr9","7036456","7036749","11","92806"
"chr9","6968998","6969287","chr9","7057357","7057644","11","88359"
"chr9","7015046","7015278","chr9","7102469","7102693","22","87423"
"chr9","7046685","7046938","chr9","7134399","7134661","17","87714"
"chr9","7052568","7052858","chr9","7140651","7140940","10","88083"
"chr9","7113750","7113891","chr9","7207340","7207480","8","93590"
"chr9","7114199","7114365","chr9","7207788","7207968","21","93589"
"chr9","7123665","7123879","chr9","7217298","7217518","11","93633"
"chr9","7149319","7149419","chr9","7242850","7242948","5","93531"
"chr9","7211445","7211743","chr9","7303460","7303755","13","92015"
"chr9","7270194","7270401","chr1","163740830","163741033","49","156470636"
"chr9","7320707","7320987","chr9","7411358","7411639","10","90651"
"chr9","7343991","7344269","chr7","46064389","46064660","53","38720398"
"chr9","7344900","7345145","chr9","7435478","7435718","14","90578"
"chr9","7379144","7379374","chr9","7470578","7470807","5","91434"
"chr9","7405692","7405815","chr9","7497732","7497853","3","92040"
"chr9","7423996","7424303","chr4","5663901","5664209","49","1760095"
"chr9","7444788","7445070","chr9","7536848","7537130","6","92060"
"chr9","7457695","7457923","chr9","7550163","7550396","12","92468"
"chr9","7495404","7495694","chr9","7587773","7588077","21","92369"
"chr9","7502830","7503127","chr9","7595301","7595599","17","92471"
"chr9","7509480","7509632","chr9","7602509","7602668","9","93029"
"chr9","7509682","7509799","chr9","7602709","7602824","13","93027"
"chr9","7511829","7511953","chr8","2948906","2949031","23","4562923"
"chr9","7527866","7528195","chr9","7620314","7620640","14","92448"
"chr9","7568631","7568926","chr14","48090741","48091035","39","40522110"
"chr9","7596339","7596561","chr9","7682009","7682230","3","85670"
"chr9","7613551","7613842","chr9","7699687","7699987","21","86136"
"chr9","7617792","7618073","chr9","7703879","7704161","17","86087"
"chr9","7632066","7632386","chr9","7718015","7718329","9","85949"
"chr9","7718130","7718424","chr9","7804580","7804874","7","86450"
"chr9","7746028","7746315","chr9","7833005","7833292","10","86977"
"chr9","7748634","7748877","chr9","7835657","7835900","6","87023"
"chr9","7774623","7774947","chr9","7862459","7862774","20","87836"
"chr9","7780677","7780917","chr9","7868498","7868738","8","87821"
"chr9","7782290","7782582","chr9","7870118","7870411","5","87828"
"chr9","7811898","7812111","chr1","93016186","93016399","55","85204288"
"chr9","7812112","7812167","chr4","37841097","37841146","12","30028985"
"chr9","7826641","7826932","chr9","7915713","7916008","13","89072"
"chr9","7833609","7833944","chr9","7922756","7923070","32","89147"
"chr9","7841339","7841461","chr9","7929984","7930104","3","88645"
"chr9","7855067","7855166","chr9","7943648","7943747","1","88581"
"chr9","7869957","7870118","chr9","7958497","7958659","2","88540"
"chr9","7884280","7884414","chr9","7973215","7973349","5","88935"
"chr9","7884683","7884694","chr17","51702049","51702059","2","43817366"
"chr9","7884999","7885156","chr9","7973932","7974089","4","88933"
"chr9","7889123","7889409","chr9","7978061","7978379","39","88938"
"chr9","7896868","7897169","chr9","7985842","7986149","22","88974"
"chr9","7908058","7908369","chr3","51622492","51622797","46","43714434"
"chr9","7929687","7929992","chr9","8020737","8021048","12","91050"
"chr9","7934674","7934966","chr9","8026028","8026326","11","91354"
"chr9","7956227","7956343","chr7","18037878","18038002","26","10081651"
"chr9","7978348","7978637","chr9","8070237","8070526","5","91889"
"chr9","7981419","7981724","chr9","8073309","8073594","41","91890"
"chr9","7994982","7995287","chr9","8087203","8087495","30","92221"
"chr9","8008006","8008304","chr9","8099022","8099318","11","91016"
"chr9","8034866","8035154","chr9","8126105","8126394","5","91239"
"chr9","8047358","8047661","chr9","8139706","8140010","7","92348"
"chr9","8057215","8057509","chr8","61522372","61522671","60","53465157"
"chr9","8066611","8066857","chr9","8158617","8158881","28","92006"
"chr9","8076352","8076651","chr2","99905203","99905497","55","91828851"
"chr9","8132485","8132742","chr9","8225472","8225729","11","92987"
"chr9","8149575","8149871","chr9","8241563","8241860","11","91988"
"chr9","8154893","8155065","chr9","8246900","8247072","5","92007"
"chr9","8156244","8156557","chr9","8248255","8248569","18","92011"
"chr9","8165128","8165415","chr9","8256741","8257032","19","91613"
"chr9","8175824","8176119","chr9","8269023","8269315","19","93199"
"chr9","8182441","8182676","chr19","35111438","35111666","66","26928997"
"chr9","8190617","8190889","chr9","8280913","8281187","6","90296"
"chr9","8201966","8202263","chr9","8292188","8292484","8","90222"
"chr9","8215173","8215463","chr9","8305197","8305479","18","90024"
"chr9","8220483","8220668","chr9","8310487","8310671","4","90004"
"chr9","8226725","8227034","chr9","8316735","8317045","14","90010"
"chr9","8247563","8247732","chr9","108993260","108993425","36","100745697"
"chr9","8250010","8250314","chr9","8335454","8335765","11","85444"
"chr9","8254160","8254447","chr9","8346873","8347167","16","92713"
"chr9","8290262","8290546","chr8","26423847","26424135","52","18133585"
"chr9","8307794","8308062","chr9","8402660","8402928","8","94866"
"chr9","8318884","8319175","chr9","8414620","8414908","12","95736"
"chr9","8345509","8345796","chrX","56633610","56633899","61","48288101"
"chr9","8421625","8421934","chr9","8514000","8514298","27","92375"
"chr9","8449802","8450074","chr9","8542176","8542448","6","92374"
"chr9","8451439","8451550","chr9","8543805","8543914","5","92366"
"chr9","8457693","8457981","chr9","8550386","8550674","8","92693"
"chr9","8466925","8467217","chr9","8559644","8559936","25","92719"
"chr9","8469124","8469437","chr9","8561836","8562163","25","92712"
"chr9","8472753","8473037","chr9","8565037","8565318","6","92284"
"chr9","8473855","8474058","chr9","8566134","8566357","29","92279"
"chr9","8483874","8484158","chr9","8576234","8576515","11","92360"
"chr9","8511294","8511454","chr3","38149447","38149607","24","29638153"
"chr9","8512127","8512192","chrX","63538907","63538972","11","55026780"
"chr9","8535327","8535628","chr9","8628340","8628635","12","93013"
"chr9","8548800","8548972","chr9","8641726","8641898","6","92926"
"chr9","8563173","8563418","chr9","8656125","8656370","6","92952"
"chr9","8599086","8599384","chr9","8693291","8693593","36","94205"
"chr9","8630231","8630500","chr9","8723687","8723948","15","93456"
"chr9","8658896","8659187","chr9","8748582","8748873","10","89686"
"chr9","8671245","8671518","chr9","8759994","8760267","6","88749"
"chr9","8698589","8698800","chr9","8787052","8787260","12","88463"
"chr9","8707556","8707866","chr9","8796225","8796523","23","88669"
"chr9","8752066","8752367","chr9","8837528","8837823","14","85462"
"chr9","8775731","8776022","chr7","121370394","121370686","57","112594663"
"chr9","8780800","8781080","chr9","8866419","8866699","10","85619"
"chr9","8789285","8789590","chr9","8877054","8877363","16","87769"
"chr9","8808806","8809101","chr9","8896487","8896792","27","87681"
"chr9","8963310","8963620","chr9","9050519","9050841","24","87209"
"chr9","8974683","8974968","chr9","9061993","9062286","15","87310"
"chr9","8975628","8975844","chr9","9062954","9063177","17","87326"
"chr9","8978696","8979006","chr9","9066338","9066648","14","87642"
"chr9","9002598","9002829","chr9","9089974","9090205","7","87376"
"chr9","9015119","9015389","chr9","9105476","9105744","11","90357"
"chr9","9049394","9049543","chr13","99896250","99896399","26","90846856"
"chr9","9049581","9049701","chr1","217135837","217135960","19","208086256"
"chr9","9075425","9075604","chr9","9163698","9163876","8","88273"
"chr9","9111211","9111481","chr9","9198660","9198962","34","87449"
"chr9","9148433","9148738","chr9","9238028","9238334","7","89595"
"chr9","9180922","9181139","chr9","9270687","9270910","15","89765"
"chr9","9206860","9207156","chr9","9297430","9297731","17","90570"
"chr9","9536775","9536932","chr9","23733254","23733414","39","14196479"
"chr9","9587165","9587322","chr11","109049811","109049964","37","99462646"
"chr9","9664396","9664701","chr9","9762290","9762596","20","97894"
"chr9","9750954","9751247","chr9","9847895","9848188","18","96941"
"chr9","10012554","10012778","chr11","82387520","82387742","47","72374966"
"chr9","10166879","10166962","chr9","10269904","10269987","1","103025"
"chr9","10177602","10177726","chr9","10280201","10280325","6","102599"
"chr9","10232597","10232902","chr9","10334776","10335086","16","102179"
"chr9","10262534","10262741","chr18","49894942","49895141","56","39632408"
"chr9","10262830","10262953","chr1","194324432","194324553","22","184061602"
"chr9","10294692","10294809","chr10","30484458","30484572","26","20189766"
"chr9","10349873","10350198","chr9","10455530","10455829","36","105657"
"chr9","10353560","10353818","chr9","10459165","10459422","8","105605"
"chr9","10384292","10384436","chr9","10490113","10490257","11","105821"
"chr9","10693802","10693875","chr1","4000729","4000797","20","6693073"
"chr9","10695566","10695682","chr9","10804465","10804584","7","108899"
"chr9","10695815","10696026","chr9","10804689","10804873","41","108874"
"chr9","10738474","10738765","chr9","10847081","10847413","47","108607"
"chr9","10752290","10752598","chr2","78493440","78493742","59","67741150"
"chr9","10778453","10778745","chr9","10888863","10889152","13","110410"
"chr9","10862223","10862253","chr8","113563649","113563679","3","102701426"
"chr9","10923425","10923711","chr5","142637298","142637591","58","131713873"
"chr9","10949452","10949752","chr9","11067015","11067315","9","117563"
"chr9","10994958","10995233","chr9","11112457","11112732","8","117499"
"chr9","11037403","11037711","chr9","11155083","11155391","11","117680"
"chr9","11041646","11041938","chr9","11159319","11159618","16","117673"
"chr9","11114105","11114419","chr9","11232067","11232388","23","117962"
"chr9","11166792","11167076","chr14","13575721","13576006","66","2408929"
"chr9","11206752","11207049","chr9","11325136","11325456","45","118384"
"chr9","11341587","11341858","chr9","11460422","11460693","7","118835"
"chr9","11427757","11427966","chr17","51643","51852","39","11376114"
"chr9","11436955","11437224","chr9","11557848","11558117","7","120893"
"chr9","11487720","11487885","chr9","11608530","11608695","4","120810"
"chr9","11535888","11536153","chr9","11656972","11657237","3","121084"
"chr9","11596871","11597167","chr9","11718216","11718512","7","121345"
"chr9","11637059","11637330","chr9","11758760","11759031","8","121701"
"chr9","11666044","11666341","chr9","11787636","11787925","13","121592"
"chr9","11681809","11682117","chr9","11802590","11802879","30","120781"
"chr9","11696297","11696575","chr9","11817340","11817618","10","121043"
"chr9","11707589","11707884","chr9","11832027","11832322","10","124438"
"chr9","11714988","11715290","chr9","11838098","11838400","2","123110"
"chr9","11727096","11727398","chr13","41851851","41852159","56","30124755"
"chr9","11736838","11737006","chr9","11862494","11862680","19","125656"
"chr9","11744026","11744157","chr16","46922751","46922880","29","35178725"
"chr9","11747269","11747585","chr9","11873162","11873471","18","125893"
"chr9","11750732","11750962","chr4","7539481","7539702","49","4211251"
"chr9","11751336","11751401","chr3","10761706","10761770","11","989630"
"chr9","11757078","11757245","chr9","11882725","11882893","4","125647"
"chr9","11759396","11759565","chr9","11885043","11885208","10","125647"
"chr9","11761231","11761540","chr2","78367656","78367958","59","66606425"
"chr9","11767171","11767450","chr9","11895229","11895510","12","128058"
"chr9","11778146","11778443","chr9","11906818","11907114","12","128672"
"chr9","11779532","11779846","chrX","46852707","46853016","57","35073175"
"chr9","11818058","11818213","chr9","11946521","11946663","17","128463"
"chr9","11823888","11824158","chr9","11952308","11952579","12","128420"
"chr9","11837070","11837242","chr14","6757447","6757620","36","5079623"
"chr9","11837268","11837394","chr19","39183462","39183587","26","27346194"
"chr9","11839190","11839437","chr9","11967517","11967763","8","128327"
"chr9","11843059","11843358","chr9","11971678","11971974","17","128619"
"chr9","11858734","11858783","chr6","164706104","164706155","9","152847370"
"chr9","11861901","11862192","chr9","11990059","11990315","41","128158"
"chr9","11874765","11875060","chr9","12003340","12003637","12","128575"
"chr9","11879197","11879504","chr9","12007413","12007730","17","128216"
"chr9","11898906","11899187","chr9","12031911","12032192","7","133005"
"chr9","11905631","11905921","chr9","12043651","12043950","13","138020"
"chr9","11928759","11929040","chr9","12054965","12055256","16","126206"
"chr9","11935082","11935256","chr9","12069687","12069870","24","134605"
"chr9","11970097","11970335","chr2","87577946","87578180","57","75607849"
"chr9","11980710","11980916","chr18","4086710","4086922","38","7894000"
"chr9","11983514","11983777","chr9","12126711","12126972","10","143197"
"chr9","12013206","12013473","chr9","12159225","12159500","16","146019"
"chr9","12048975","12049110","chr9","12193942","12194077","1","144967"
"chr9","12061958","12061999","chr1","145010738","145010780","9","132948780"
"chr9","12062005","12062216","chr19","16616632","16616852","49","4554627"
"chr9","12063543","12063822","chr9","12209812","12210090","9","146269"
"chr9","12068231","12068365","chr9","12215727","12215861","0","147496"
"chr9","12068659","12068832","chr9","12216162","12216326","9","147503"
"chr9","12074656","12074946","chr9","12221407","12221703","17","146751"
"chr9","12075586","12075868","chr9","12222343","12222623","15","146757"
"chr9","12076749","12077038","chr9","12223487","12223776","5","146738"
"chr9","12082171","12082414","chr9","12229229","12229474","10","147058"
"chr9","12083133","12083375","chr7","159958702","159958946","45","147875569"
"chr9","12083883","12084138","chr4","82742703","82742961","57","70658820"
"chr9","12087975","12088258","chr9","12234653","12234936","10","146678"
"chr9","12103119","12103437","chr9","12249795","12250116","17","146676"
"chr9","12109031","12109173","chr9","12255824","12255956","15","146793"
"chr9","12109475","12109609","chr9","12256335","12256470","3","146860"
"chr9","12110575","12110900","chr9","12257428","12257748","9","146853"
"chr9","12112463","12112639","chr9","12259306","12259481","3","146843"
"chr9","12113056","12113186","chr9","12259898","12260026","8","146842"
"chr9","12127998","12128240","chr9","12275387","12275678","57","147389"
"chr9","12128744","12129048","chr9","12276151","12276451","30","147407"
"chr9","12139631","12139807","chr9","12287657","12287832","15","148026"
"chr9","12140099","12140239","chr9","12288124","12288263","4","148025"
"chr9","12142815","12143080","chr9","12291151","12291417","16","148336"
"chr9","12145628","12145940","chr7","25185886","25186189","59","13040258"
"chr9","12151056","12151176","chr9","12299113","12299237","7","148057"
"chr9","12151349","12151649","chr9","12299407","12299682","49","148058"
"chr9","12156136","12156452","chr7","156365921","156366231","59","144209785"
"chr9","12165432","12165726","chr9","12313121","12313418","13","147689"
"chr9","12174265","12174600","chr9","12322795","12323132","7","148530"
"chr9","12177795","12178093","chr9","12333388","12333688","13","155593"
"chr9","12214168","12214288","chr9","12363891","12364014","7","149723"
"chr9","12226510","12226754","chr9","12376136","12376380","9","149626"
"chr9","12238029","12238313","chr9","12387218","12387494","16","149189"
"chr9","12238852","12239034","chrX","65802503","65802701","65","53563651"
"chr9","12258541","12258833","chr9","12408757","12409054","13","150216"
"chr9","12262724","12263049","chr9","12412947","12413272","6","150223"
"chr9","12289952","12290176","chr9","12441445","12441668","9","151493"
"chr9","12294798","12294974","chr7","37755730","37755904","35","25460932"
"chr9","12295238","12295381","chr2","88023778","88023922","23","75728540"
"chr9","12295948","12296239","chr4","69077877","69078163","54","56781929"
"chr9","12300167","12300365","chr9","12451441","12451638","2","151274"
"chr9","12306591","12306867","chr9","12457905","12458174","16","151314"
"chr9","12367929","12368231","chr9","12519402","12519715","21","151473"
"chr9","12369109","12369170","chr17","70839894","70839958","15","58470785"
"chr9","12369166","12369251","chr3","14185302","14185394","23","1816136"
"chr9","12388144","12388509","chr9","12531314","12531682","12","143170"
"chr9","12415328","12415506","chr20","26120114","26120281","53","13704786"
"chr9","12425445","12425619","chr6","144629551","144629726","26","132204106"
"chr9","12440677","12440750","chr9","12582873","12582946","2","142196"
"chr9","12450442","12450694","chr9","12592642","12592886","19","142200"
"chr9","12454630","12454948","chr9","12596850","12597170","13","142220"
"chr9","12490153","12490451","chr9","12631095","12631393","3","140942"
"chr9","12504260","12504538","chr9","12645170","12645448","6","140910"
"chr9","12516686","12516992","chr9","12658641","12658947","12","141955"
"chr9","12544252","12544558","chr9","12687018","12687315","22","142766"
"chr9","12557942","12558230","chr9","12700662","12700948","8","142720"
"chr9","12559791","12560102","chr9","12702514","12702821","25","142723"
"chr9","12561977","12562288","chr9","12704695","12705012","17","142718"
"chr9","12570126","12570414","chr9","12713135","12713415","15","143009"
"chr9","12593203","12593472","chr9","12730354","12730627","19","137151"
"chr9","12596994","12597273","chr9","12736459","12736739","7","139465"
"chr9","12612042","12612215","chr16","42521296","42521469","34","29909254"
"chr9","12632290","12632601","chr9","12773778","12774089","11","141488"
"chr9","12636814","12637117","chr14","9646354","9646643","62","2990460"
"chr9","12655458","12655772","chr9","12796773","12797079","15","141315"
"chr9","12669382","12669683","chr9","12810663","12810970","16","141281"
"chr9","12689214","12689569","chr9","12831849","12832183","39","142635"
"chr9","12699774","12699947","chr9","12842712","12842888","6","142938"
"chr9","12699997","12700106","chr9","12842941","12843050","2","142944"
"chr9","12704990","12705202","chr9","12847913","12848126","2","142923"
"chr9","12753220","12753553","chr9","12895552","12895880","26","142332"
"chr9","12780233","12780521","chr9","12922930","12923218","13","142697"
"chr9","12788304","12788455","chr14","9934083","9934225","34","2854221"
"chr9","12789947","12790087","chr11","115740001","115740141","28","102950054"
"chr9","12807156","12807464","chr9","12944812","12945117","9","137656"
"chr9","12853454","12853747","chr9","12996764","12997056","21","143310"
"chr9","12871606","12871859","chr9","56456050","56456320","55","43584444"
"chr9","12884697","12885017","chr13","10587798","10588105","64","2296899"
"chr9","12907270","12907569","chr9","13045804","13046087","25","138534"
"chr9","12907649","12907952","chr9","13046167","13046470","9","138518"
"chr9","12931049","12931269","chr3","150233840","150234062","50","137302791"
"chr9","12979723","12979887","chr9","13119395","13119567","14","139672"
"chr9","12982726","12982959","chr9","13122403","13122655","25","139677"
"chr9","13043000","13043301","chr9","13182383","13182684","9","139383"
"chr9","13068055","13068222","chr1","28468412","28468583","28","15400357"
"chr9","13091854","13092144","chr4","105042710","105042998","59","91950856"
"chr9","13106541","13106710","chr5","74011542","74011709","32","60905001"
"chr9","13114201","13114490","chr9","13270083","13270372","10","155882"
"chr9","13140024","13140189","chr9","13308246","13308414","7","168222"
"chr9","13150847","13151165","chr9","13319547","13319854","24","168700"
"chr9","13155062","13155376","chrX","50920590","50920893","56","37765528"
"chr9","13166911","13167203","chr6","134251498","134251796","49","121084587"
"chr9","13171117","13171275","chr9","13339359","13339517","3","168242"
"chr9","13172485","13172566","chr9","13340700","13340780","4","168215"
"chr9","13172714","13172871","chr9","13340928","13341085","2","168214"
"chr9","13215590","13215848","chr9","13380253","13380519","10","164663"
"chr9","13218328","13218607","chr9","13383014","13383291","10","164686"
"chr9","13223399","13223695","chr9","13388120","13388416","10","164721"
"chr9","13224397","13224682","chr9","13389116","13389398","10","164719"
"chr9","13224908","13225111","chrX","6899431","6899632","45","6325477"
"chr9","13225395","13225528","chr1","18863826","18863959","22","5638431"
"chr9","13227080","13227324","chr9","13391803","13392089","48","164723"
"chr9","13231661","13231949","chr9","13396436","13396724","2","164775"
"chr9","13235509","13235749","chr9","13399236","13399479","8","163727"
"chr9","13236699","13236986","chr9","13400428","13400715","11","163729"
"chr9","13239478","13239769","chr9","13403221","13403513","6","163743"
"chr9","13249850","13250154","chr9","13415030","13415337","13","165180"
"chr9","13250175","13250327","chr9","13415367","13415498","29","165192"
"chr9","13251763","13252023","chr9","13416929","13417189","7","165166"
"chr9","13262359","13262644","chr9","13426796","13427090","18","164437"
"chr9","13263833","13264095","chr9","13428238","13428499","5","164405"
"chr9","13282957","13283072","chr9","13453218","13453333","7","170261"
"chr9","13283109","13283259","chr9","13453378","13453516","27","170269"
"chr9","13283775","13283961","chr7","19543158","19543338","43","6259383"
"chr9","13287577","13287855","chr10","82949030","82949297","52","69661453"
"chr9","13289074","13289362","chr1","6604482","6604774","51","6684592"
"chr9","13292108","13292280","chr9","13463995","13464177","12","171887"
"chr9","13314260","13314570","chr9","13478603","13478918","17","164343"
"chr9","13317956","13318262","chr9","13482185","13482480","25","164229"
"chr9","13326785","13326909","chr7","106492413","106492535","16","93165628"
"chr9","13330441","13330611","chr11","52884536","52884701","43","39554095"
"chr9","13354245","13354383","chr7","111340573","111340711","26","97986328"
"chr9","13355198","13355416","chr9","13514322","13514537","11","159124"
"chr9","13392838","13392971","chr9","13551568","13551701","4","158730"
"chr9","13393275","13393457","chr9","13552005","13552179","19","158730"
"chr9","13408389","13408652","chr9","13570759","13571022","8","162370"
"chr9","13412840","13413108","chr3","156696259","156696523","58","143283419"
"chr9","13420271","13420563","chr9","13582416","13582708","8","162145"
"chr9","13438284","13438428","chr3","32907294","32907438","30","19469010"
"chr9","13438456","13438565","chr2","60640918","60641027","18","47202462"
"chr9","13445508","13445598","chr9","13607586","13607676","0","162078"
"chr9","13522325","13522629","chr1","63861722","63862025","55","50339397"
"chr9","13538151","13538340","chr9","13700445","13700628","12","162294"
"chr9","13575204","13575499","chr9","13737709","13738004","7","162505"
"chr9","13591104","13591308","chr9","13753605","13753808","8","162501"
"chr9","13593886","13594113","chr15","75133308","75133523","48","61539422"
"chr9","13615504","13615611","chr9","13779839","13779951","9","164335"
"chr9","13626160","13626301","chr9","13790525","13790666","5","164365"
"chr9","13626501","13626748","chr16","45310219","45310474","54","31683718"
"chr9","13659972","13660255","chr9","13824375","13824658","8","164403"
"chr9","13686837","13687119","chr9","13851468","13851747","15","164631"
"chr9","13697595","13697894","chr9","13862773","13863073","8","165178"
"chr9","13748849","13749074","chr9","13914159","13914373","19","165310"
"chr9","13776800","13777108","chr16","64601251","64601554","57","50824451"
"chr9","13779637","13779910","chr9","13945085","13945391","35","165448"
"chr9","13786030","13786285","chr9","13951217","13951473","9","165187"
"chr9","13787501","13787792","chr9","13952677","13952958","19","165176"
"chr9","13799073","13799382","chr9","13964238","13964545","14","165165"
"chr9","13804299","13804597","chr9","13969491","13969785","11","165192"
"chr9","13856969","13857073","chr7","32728549","32728652","23","18871580"
"chr9","13857152","13857318","chr3","2923866","2924027","35","10933286"
"chr9","13867450","13867547","chr9","14031705","14031802","2","164255"
"chr9","13889593","13889776","chr9","14054280","14054463","7","164687"
"chr9","13891828","13892132","chr9","14056522","14056822","15","164694"
"chr9","13892931","13893225","chr9","14057578","14057872","10","164647"
"chr9","13907111","13907420","chr9","14071779","14072090","7","164668"
"chr9","13917344","13917543","chr9","14081959","14082168","14","164615"
"chr9","13946358","13946645","chr9","14109912","14110217","25","163554"
"chr9","13993633","13993884","chr9","14157148","14157404","13","163515"
"chr9","13995484","13995736","chr5","74006173","74006422","67","60010689"
"chr9","14110558","14110860","chr9","14274220","14274510","19","163662"
"chr9","14152386","14152696","chr9","14315855","14316165","12","163469"
"chr9","14206921","14207215","chr9","14371195","14371496","15","164274"
"chr9","14213711","14214013","chr9","14378021","14378323","9","164310"
"chr9","14227492","14227786","chr9","14391798","14392092","10","164306"
"chr9","14228871","14229175","chr9","14393178","14393482","16","164307"
"chr9","14232914","14233213","chr9","14397197","14397511","24","164283"
"chr9","14234472","14234602","chr9","14398772","14398902","4","164300"
"chr9","14234900","14235056","chr9","14399210","14399366","3","164310"
"chr9","14248886","14249196","chr9","14413141","14413451","8","164255"
"chr9","14307425","14307713","chr9","14471509","14471797","13","164084"
"chr9","14339672","14339980","chr9","14503560","14503853","23","163888"
"chr9","14343140","14343349","chr9","14507053","14507266","12","163913"
"chr9","14392008","14392301","chr9","14555651","14555944","4","163643"
"chr9","14397282","14397626","chr9","14561659","14561980","53","164377"
"chr9","14403024","14403194","chr3","173526190","173526356","35","159123166"
"chr9","14403222","14403329","chr1","56086271","56086376","19","41683049"
"chr9","14491652","14491943","chr9","14655930","14656211","17","164278"
"chr9","14504677","14504883","chr9","14668752","14668954","29","164075"
"chr9","14506600","14506737","chr19","3078766","3078908","36","11427834"
"chr9","14521676","14521980","chr9","14685434","14685726","24","163758"
"chr9","14536295","14536579","chr19","8462124","8462391","57","6074171"
"chr9","14539709","14540006","chr9","14703869","14704175","17","164160"
"chr9","14642715","14643019","chr9","14804665","14804971","12","161950"
"chr9","14655916","14656214","chr9","14817696","14817994","14","161780"
"chr9","14662395","14662700","chr9","14824217","14824521","21","161822"
"chr9","14663955","14664243","chr9","14825780","14826065","15","161825"
"chr9","14682909","14683201","chr9","14845108","14845409","22","162199"
"chr9","14687506","14687728","chr9","14850025","14850246","16","162519"
"chr9","14699905","14700161","chr9","14862416","14862672","10","162511"
"chr9","14701056","14701358","chr9","14863566","14863864","10","162510"
"chr9","14774801","14774936","chr2","115709690","115709830","26","100934889"
"chr9","14775227","14775281","chr13","26369991","26370042","20","11594764"
"chr9","14775398","14775505","chrX","43701261","43701368","23","28925863"
"chr9","14811493","14811659","chr1","34676353","34676517","37","19864860"
"chr9","14811712","14811807","chr15","6139004","6139107","22","8672708"
"chr9","14816176","14816466","chr9","14981405","14981682","18","165229"
"chr9","14819985","14820276","chr13","125779468","125779755","46","110959483"
"chr9","14842103","14842407","chr11","51357004","51357309","58","36514901"
"chr9","14847073","14847375","chr9","15012318","15012626","19","165245"
"chr9","14850015","14850312","chr9","15015241","15015541","7","165226"
"chr9","14886189","14886508","chr4","32776636","32776941","59","17890447"
"chr9","14899860","14899949","chr9","15064973","15065062","1","165113"
"chr9","14912002","14912249","chr9","15077201","15077465","23","165199"
"chr9","14922511","14922781","chr9","15087724","15087992","6","165213"
"chr9","14928936","14929204","chr9","15094086","15094358","12","165150"
"chr9","14931381","14931525","chr9","15096527","15096671","4","165146"
"chr9","14939170","14939438","chr9","15104313","15104578","7","165143"
"chr9","14951548","14951839","chr9","15116517","15116821","39","164969"
"chr9","14971777","14972080","chr9","15136991","15137302","15","165214"
"chr9","14973277","14973317","chr3","44827294","44827332","9","29854017"
"chr9","14973318","14973399","chr9","85194339","85194418","16","70221021"
"chr9","14992159","14992258","chr9","15160083","15160182","3","167924"
"chr9","15005524","15005820","chr9","15171601","15171896","7","166077"
"chr9","15038433","15038713","chr9","15206426","15206703","9","167993"
"chr9","15070864","15071165","chr9","15242456","15242747","19","171592"
"chr9","15078337","15078568","chr2","146724965","146725192","56","131646628"
"chr9","15086390","15086692","chr13","24239685","24239986","71","9153295"
"chr9","15116609","15116880","chr9","15285262","15285529","12","168653"
"chr9","15118479","15118756","chr9","15287122","15287397","4","168643"
"chr9","15152257","15152543","chr9","15319698","15319981","17","167441"
"chr9","15154576","15154872","chr9","15321720","15322015","16","167144"
"chr9","15159299","15159599","chr9","15326300","15326606","15","167001"
"chr9","15170541","15170845","chr9","15337497","15337798","15","166956"
"chr9","15175359","15175637","chr9","15344458","15344735","9","169099"
"chr9","15176267","15176530","chr9","15341868","15342141","15","165601"
"chr9","15177702","15178004","chr9","15343608","15343909","13","165906"
"chr9","15193237","15193464","chr9","15360360","15360584","9","167123"
"chr9","15208147","15208455","chr9","15375973","15376278","9","167826"
"chr9","15209123","15209423","chr9","15376936","15377233","14","167813"
"chr9","15221927","15222237","chr9","15390406","15390708","16","168479"
"chr9","15230213","15230507","chr9","15398833","15399121","12","168620"
"chr9","15239589","15239912","chr9","15408156","15408469","20","168567"
"chr9","15250888","15250989","chr9","15419449","15419550","0","168561"
"chr9","15252622","15252882","chr9","15421190","15421453","32","168568"
"chr9","15258520","15258751","chr9","15427057","15427290","14","168537"
"chr9","15295445","15295736","chr9","15464042","15464337","8","168597"
"chr9","15297431","15297689","chr14","7881124","7881383","72","7416307"
"chr9","15302935","15303247","chr9","15467102","15467414","9","164167"
"chr9","15318181","15318467","chr9","15487330","15487618","12","169149"
"chr9","15320347","15320465","chr9","15480323","15480442","3","159976"
"chr9","15323765","15323899","chr9","15483742","15483877","7","159977"
"chr9","15342076","15342176","chr9","15506135","15506233","4","164059"
"chr9","15342251","15342455","chr9","15506374","15506571","11","164123"
"chr9","15350658","15350868","chr9","15515103","15515330","25","164445"
"chr9","15355379","15355619","chr8","76427874","76428118","51","61072495"
"chr9","15355831","15356106","chr9","15520009","15520284","8","164178"
"chr9","15357065","15357354","chr9","15521242","15521531","9","164177"
"chr9","15358354","15358651","chr9","15522528","15522824","15","164174"
"chr9","15360085","15360390","chr9","15524264","15524575","17","164179"
"chr9","15364765","15365059","chr9","15528942","15529235","12","164177"
"chr9","15378176","15378422","chr9","15543216","15543462","7","165040"
"chr9","15388996","15389240","chr9","15554070","15554314","3","165074"
"chr9","15391398","15391674","chr9","15556456","15556727","12","165058"
"chr9","15394231","15394540","chr9","15559511","15559793","38","165280"
"chr9","15400096","15400393","chr9","15565263","15565547","29","165167"
"chr9","15410909","15411215","chr9","15573958","15574263","9","163049"
"chr9","15434983","15435285","chr9","15601563","15601836","43","166580"
"chr9","15450817","15451040","chr9","15617393","15617616","6","166576"
"chr9","15462650","15462952","chr9","15629256","15629559","11","166606"
"chr9","15481332","15481589","chr9","15647985","15648243","6","166653"
"chr9","15495803","15496130","chr5","82349149","82349472","69","66853346"
"chr9","15531396","15531706","chr1","61821426","61821735","58","46290030"
"chr9","15540043","15540307","chr9","15703990","15704254","5","163947"
"chr9","15603626","15603935","chr9","15767924","15768225","17","164298"
"chr9","15623673","15623962","chr9","15788010","15788299","11","164337"
"chr9","15631406","15631706","chr9","15795755","15796046","15","164349"
"chr9","15645215","15645534","chr5","10232928","10233228","71","5412287"
"chr9","15647582","15647900","chr9","15811639","15811952","30","164057"
"chr9","15651396","15651722","chr9","15815434","15815754","30","164038"
"chr9","15658681","15658973","chr9","15822721","15822995","20","164040"
"chr9","15714031","15714321","chr9","15877989","15878285","11","163958"
"chr9","15732634","15732719","chr9","15896707","15896792","2","164073"
"chr9","15829746","15829925","chr9","15993348","15993520","12","163602"
"chr9","15934460","15934726","chr9","16096299","16096565","8","161839"
"chr9","15966508","15966630","chr9","16128469","16128591","5","161961"
"chr9","15982162","15982473","chr9","16148184","16148495","3","166022"
"chr9","15984541","15984841","chr9","16150540","16150840","1","165999"
"chr9","15995047","15995349","chr9","16161076","16161371","17","166029"
"chr9","15996265","15996547","chr9","16162286","16162567","12","166021"
"chr9","16034589","16034878","chr9","16200832","16201117","13","166243"
"chr9","16109042","16109319","chr11","121352926","121353191","59","105243884"
"chr9","16111391","16111704","chr17","1036977","1037286","68","15074414"
"chr9","16136734","16137057","chrX","40470164","40470492","68","24333430"
"chr9","16187769","16187880","chr9","16355219","16355325","8","167450"
"chr9","16188239","16188264","chr7","24994090","24994113","7","8805851"
"chr9","16188271","16188434","chr7","122093266","122093425","31","105904995"
"chr9","16241690","16241800","chr2","69271792","69271900","19","53030102"
"chr9","16243901","16244037","chr9","16412160","16412295","2","168259"
"chr9","16244331","16244555","chr9","16412591","16412819","23","168260"
"chr9","16257224","16257510","chr9","16425347","16425633","10","168123"
"chr9","16267797","16267915","chr9","16435217","16435335","5","167420"
"chr9","16275287","16275580","chr9","16442640","16442937","12","167353"
"chr9","16286763","16287063","chr9","16454152","16454452","18","167389"
"chr9","16290349","16290645","chr9","16457724","16458022","12","167375"
"chr9","16298880","16299195","chr9","16466240","16466549","14","167360"
"chr9","16300158","16300463","chr9","16467507","16467809","17","167349"
"chr9","16305123","16305172","chr9","16472801","16472840","12","167678"
"chr9","16305227","16305373","chr9","16472905","16473051","6","167678"
"chr9","16334957","16334988","chrX","50039567","50039601","6","33704610"
"chr9","16335355","16335659","chr12","31297336","31297638","58","14961981"
"chr9","16336795","16337044","chr9","16506300","16506552","9","169505"
"chr9","16341398","16341676","chr9","16510586","16510854","14","169188"
"chr9","16342263","16342545","chr9","16511441","16511723","10","169178"
"chr9","16345147","16345452","chr9","16514334","16514641","5","169187"
"chr9","16357126","16357245","chr17","99629","99750","19","16257497"
"chr9","16359540","16359853","chr1","22047855","22048155","87","5688315"
"chr9","16374326","16374631","chr9","16542694","16543002","7","168368"
"chr9","16389852","16390009","chr1","13980322","13980494","49","2409530"
"chr9","16390121","16390245","chr4","17500554","17500677","17","1110433"
"chr9","16399859","16400163","chr9","16568509","16568813","11","168650"
"chr9","16421548","16421848","chr9","16589858","16590150","15","168310"
"chr9","16421914","16422204","chr9","16590208","16590501","10","168294"
"chr9","16433293","16433377","chr9","16601180","16601266","3","167887"
"chr9","16434047","16434319","chr9","16601849","16602109","15","167802"
"chr9","16444835","16445105","chr9","16612828","16613094","13","167993"
"chr9","16474656","16474808","chr10","30604467","30604615","30","14129811"
"chr9","16474809","16474875","chr19","211655","211716","14","16263154"
"chr9","16488967","16489251","chr9","16653307","16653601","21","164340"
"chr9","16502208","16502377","chr15","39862747","39862912","32","23360539"
"chr9","16510382","16510525","chr15","18200968","18201098","29","1690586"
"chr9","16526439","16526593","chr9","16691156","16691299","16","164717"
"chr9","16530820","16530947","chr3","40607497","40607621","28","24076677"
"chr9","16531159","16531221","chr9","16695242","16695304","0","164083"
"chr9","16531528","16531650","chr9","16695611","16695732","2","164083"
"chr9","16532910","16533196","chr9","56456050","56456320","64","39923140"
"chr9","16545745","16546034","chr8","29083676","29083969","68","12537931"
"chr9","16571476","16571795","chr9","16735904","16736223","5","164428"
"chr9","16575914","16576041","chr9","16740337","16740466","18","164423"
"chr9","16578470","16578784","chr9","16742906","16743184","57","164436"
"chr9","16593905","16594084","chr9","16757364","16757543","3","163459"
"chr9","16598739","16599043","chr8","26857087","26857388","52","10258348"
"chr9","16618727","16619024","chr9","16782095","16782387","17","163368"
"chr9","16673710","16673906","chr9","16837836","16838032","6","164126"
"chr9","16703201","16703486","chr9","16867310","16867600","27","164109"
"chr9","16707441","16707753","chr9","16871543","16871855","12","164102"
"chr9","16712135","16712438","chr9","43144312","43144611","55","26432177"
"chr9","16725305","16725605","chr8","30770102","30770397","46","14044797"
"chr9","16726741","16727016","chr3","125030767","125031037","48","108304026"
"chr9","16727068","16727086","chrX","56676311","56676329","3","39949243"
"chr9","16761880","16762125","chr11","129743548","129743801","59","112981668"
"chr9","16765242","16765530","chr1","54800363","54800645","58","38035121"
"chr9","16799579","16799879","chr2","167799189","167799489","65","150999610"
"chr9","16842582","16842867","chr10","78169284","78169571","47","61326702"
"chr9","16890605","16890889","chr13","91817329","91817619","57","74926724"
"chr9","16902937","16903209","chr5","78114223","78114503","49","61211286"
"chr9","16921618","16921905","chr14","7153919","7154206","59","9767699"
"chr9","16924901","16925181","chr11","95571991","95572273","69","78647090"
"chr9","16973064","16973372","chr9","110733855","110734154","65","93760791"
"chr9","17017494","17017802","chr5","142565235","142565540","57","125547741"
"chr9","17039958","17040203","chr9","92153506","92153751","50","75113548"
"chr9","17050112","17050417","chr11","50004656","50004962","53","32954544"
"chr9","17201580","17201865","chr9","16879053","16879358","38","322527"
"chr9","17207877","17208199","chr9","16885266","16885587","29","322611"
"chr9","17209327","17209623","chr9","16886727","16887026","9","322600"
"chr9","17231263","17231555","chr9","16909344","16909637","14","321919"
"chr9","17246987","17247277","chr9","16930301","16930595","16","316686"
"chr9","17323534","17323676","chr9","17008373","17008515","1","315161"
"chr9","17334692","17334943","chr1","5325347","5325595","60","12009345"
"chr9","17350778","17350835","chr3","2024892","2024946","10","15325886"
"chr9","17365967","17366273","chr9","17049714","17050029","20","316253"
"chr9","17368104","17368397","chr9","17053365","17053657","8","314739"
"chr9","17376087","17376162","chr4","43955090","43955165","15","26579003"
"chr9","17376343","17376566","chr9","17061464","17061689","6","314879"
"chr9","17405182","17405500","chr11","110514989","110515295","61","93109807"
"chr9","17437285","17437569","chr9","17121621","17121906","9","315664"
"chr9","17439237","17439418","chr7","18856915","18857091","35","1417678"
"chr9","17448935","17449235","chr9","17133272","17133574","22","315663"
"chr9","17457180","17457478","chr9","17141523","17141826","17","315657"
"chr9","17489924","17490216","chr9","17174742","17175035","11","315182"
"chr9","17491500","17491790","chr9","17176435","17176728","13","315065"
"chr9","17530462","17530747","chr9","17217467","17217753","5","312995"
"chr9","17546458","17546749","chr9","17232807","17233101","11","313651"
"chr9","17553323","17553606","chr9","17239593","17239876","6","313730"
"chr9","17605309","17605582","chr8","120257093","120257360","59","102651784"
"chr9","17631143","17631484","chr9","17327933","17328248","44","303210"
"chr9","17681473","17681710","chr9","17379172","17379399","20","302301"
"chr9","17690576","17690876","chr9","17388278","17388567","26","302298"
"chr9","17715765","17716065","chr9","17414092","17414412","36","301673"
"chr9","17726027","17726219","chr9","17425521","17425713","5","300506"
"chr9","17755576","17755860","chr9","17454563","17454858","17","301013"
"chr9","17790289","17790461","chr11","38369515","38369683","34","20579226"
"chr9","17795405","17795684","chr9","17494234","17494513","8","301171"
"chr9","17835964","17836314","chr9","17535127","17535477","10","300837"
"chr9","17922011","17922325","chr4","32874553","32874866","69","14952542"
"chr9","17922864","17922996","chr1","41160156","41160285","19","23237292"
"chr9","17967732","17967832","chr1","166392872","166392973","26","148425140"
"chr9","17969498","17969747","chr2","163399495","163399760","71","145429997"
"chr9","17978120","17978395","chr9","17678011","17678282","11","300109"
"chr9","17983471","17983648","chr1","115534135","115534304","43","97550664"
"chr9","18031359","18031677","chr9","17727496","17727782","41","303863"
"chr9","18120165","18120431","chr9","17816442","17816708","2","303723"
"chr9","18131848","18132163","chr9","17828324","17828641","8","303524"
"chr9","18154445","18154741","chr9","17850913","17851208","18","303532"
"chr9","18161694","18161996","chr9","17857764","17858067","12","303930"
"chr9","18168562","18168857","chr1","130713307","130713605","50","112544745"
"chr9","18212197","18212437","chr9","17908203","17908446","17","303994"
"chr9","18214034","18214335","chr9","17910063","17910365","13","303971"
"chr9","18255376","18255648","chr9","17956914","17957182","12","298462"
"chr9","18256350","18256651","chr9","17957886","17958187","9","298464"
"chr9","18259988","18260275","chr2","77300343","77300631","70","59040355"
"chr9","18276093","18276373","chr9","17977557","17977838","7","298536"
"chr9","18286303","18286600","chr9","17987482","17987782","14","298821"
"chr9","18290486","18290768","chr9","17991671","17991924","31","298815"
"chr9","18312371","18312653","chr9","18014417","18014697","6","297954"
"chr9","18316927","18317251","chr9","18018965","18019286","10","297962"
"chr9","18323824","18324116","chr9","18025880","18026175","12","297944"
"chr9","18364912","18365210","chr9","18066432","18066718","22","298480"
"chr9","18367768","18368056","chr9","18069648","18069937","14","298120"
"chr9","18373853","18374149","chr9","18075766","18076070","18","298087"
"chr9","18379035","18379321","chr9","18080918","18081219","28","298117"
"chr9","18391796","18392092","chr9","18093473","18093762","11","298323"
"chr9","18394606","18394922","chr9","18096306","18096634","19","298300"
"chr9","18395466","18395551","chr9","18097190","18097275","2","298276"
"chr9","18399407","18399693","chr9","18101054","18101345","11","298353"
"chr9","18420350","18420618","chr1","16014612","16014884","55","2405738"
"chr9","18425820","18426113","chr9","18129301","18129588","12","296519"
"chr9","18436552","18436847","chr9","18136327","18136622","5","300225"
"chr9","18439283","18439562","chr9","18139058","18139336","5","300225"
"chr9","18471901","18472057","chr9","18170883","18171050","18","301018"
"chr9","18538080","18538391","chr9","18242383","18242694","10","295697"
"chr9","18561986","18562299","chr9","18265854","18266164","17","296132"
"chr9","18566843","18567057","chr9","18270790","18271006","5","296053"
"chr9","18581726","18581873","chr3","37409703","37409849","24","18827977"
"chr9","18600488","18600726","chr9","18304601","18304841","7","295887"
"chr9","18623590","18623875","chr9","18328188","18328503","40","295402"
"chr9","18631634","18631924","chr9","18335805","18336097","6","295829"
"chr9","18636927","18637230","chr9","18340237","18340534","13","296690"
"chr9","18638308","18638611","chr9","18341612","18341918","11","296696"
"chr9","18650817","18651114","chr9","18354206","18354505","6","296611"
"chr9","18674298","18674574","chr9","18377823","18378102","11","296475"
"chr9","18684468","18684757","chr9","18388422","18388735","26","296046"
"chr9","18692704","18692756","chr9","18396679","18396725","7","296025"
"chr9","18725067","18725357","chr9","18429250","18429549","19","295817"
"chr9","18740852","18741007","chr2","42911742","42911897","29","24170890"
"chr9","18753779","18753814","chr9","18461779","18461814","0","292000"
"chr9","18754958","18755122","chr7","15386126","15386293","30","3368832"
"chr9","18755148","18755265","chr16","49012802","49012919","21","30257654"
"chr9","18765435","18765679","chr11","82387520","82387742","76","63622085"
"chr9","18793877","18794169","chr2","78490384","78490672","59","59696507"
"chr9","18849715","18849802","chr9","18561366","18561453","5","288349"
"chr9","18916834","18917125","chr9","18630448","18630753","20","286386"
"chr9","18982613","18982911","chr9","18700330","18700626","10","282283"
"chr9","19079342","19079641","chr9","18792117","18792451","44","287225"
"chr9","19108098","19108390","chr9","18820872","18821164","3","287226"
"chr9","19114694","19114993","chr9","18827470","18827773","10","287224"
"chr9","19158843","19159144","chr9","18872274","18872581","17","286569"
"chr9","19192010","19192287","chr9","18904368","18904647","11","287642"
"chr9","19357780","19358074","chr9","19074080","19074374","6","283700"
"chr9","19381881","19382142","chr9","19098165","19098426","3","283716"
"chr9","19386162","19386446","chr9","19102385","19102669","6","283777"
"chr9","19421922","19422204","chr9","19141075","19141363","18","280847"
"chr9","19435731","19436025","chr9","19156821","19157115","9","278910"
"chr9","19461854","19462022","chr9","19180778","19180956","26","281076"
"chr9","19462053","19462178","chr9","19180981","19181108","6","281072"
"chr9","19527138","19527275","chr9","19244348","19244483","3","282790"
"chr9","19609244","19609554","chr8","5962950","5963259","62","13646294"
"chr9","19613196","19613319","chr9","19323839","19323962","1","289357"
"chr9","19649331","19649596","chr9","19360248","19360514","17","289083"
"chr9","19658498","19658795","chr9","19369753","19370060","21","288745"
"chr9","19695831","19696170","chr9","19407416","19407754","14","288415"
"chr9","19697210","19697422","chr9","19408825","19409041","18","288385"
"chr9","19698848","19698967","chr10","20791325","20791449","33","1092477"
"chr9","19700046","19700267","chr9","19411593","19411829","19","288453"
"chr9","19700343","19700477","chr2","102233046","102233180","29","82532703"
"chr9","19701435","19701742","chr9","19413005","19413312","19","288430"
"chr9","19704490","19704698","chr9","19416044","19416271","25","288446"
"chr9","19706871","19707152","chr9","19418441","19418725","11","288430"
"chr9","19747535","19747827","chr6","76499334","76499608","75","56751799"
"chr9","19750985","19751067","chr9","19462165","19462247","3","288820"
"chr9","19755647","19755975","chr9","19467574","19467893","22","288073"
"chr9","19771810","19772127","chr9","19483773","19484092","18","288037"
"chr9","19821385","19821595","chr1","93016186","93016399","40","73194801"
"chr9","19824621","19824892","chr14","443577","443855","60","19381044"
"chr9","19907759","19907818","chr5","75501214","75501274","11","55593455"
"chr9","19991892","19992176","chr9","19704542","19704826","8","287350"
"chr9","20054329","20054528","chr11","6376125","6376322","48","13678204"
"chr9","20060663","20060984","chr6","169559105","169559409","72","149498442"
"chr9","20067318","20067409","chr9","19780943","19781034","2","286375"
"chr9","20070910","20071198","chr9","19784518","19784810","12","286392"
"chr9","20098288","20098631","chr9","19810952","19811278","35","287336"
"chr9","20122704","20123022","chr4","112775843","112776154","61","92653139"
"chr9","20124935","20125246","chr9","19836426","19836716","25","288509"
"chr9","20141516","20141830","chr9","19853205","19853506","28","288311"
"chr9","20162511","20162855","chr9","19874584","19874928","7","287927"
"chr9","20180548","20180853","chr9","19892846","19893153","10","287702"
"chr9","20200398","20200702","chr9","19912750","19913057","20","287648"
"chr9","20201429","20201720","chr3","44067077","44067369","51","23865648"
"chr9","20220800","20221138","chr9","19933381","19933702","27","287419"
"chr9","20226486","20226617","chr9","19939067","19939204","11","287419"
"chr9","20395445","20395749","chr9","20105984","20106293","12","289461"
"chr9","20442141","20442431","chr9","20153956","20154246","14","288185"
"chr9","20445296","20445595","chr9","20157438","20157728","21","287858"
"chr9","20531325","20531610","chr9","20246131","20246425","20","285194"
"chr9","20634354","20634644","chr9","20351739","20352028","8","282615"
"chr9","20656354","20656648","chr9","20373741","20374031","8","282613"
"chr9","20657678","20657964","chr5","78616003","78616301","53","57958325"
"chr9","20660288","20660451","chr9","20377689","20377836","20","282599"
"chr9","20721987","20722240","chr9","20436950","20437200","6","285037"
"chr9","20727742","20728039","chr9","20446787","20447093","15","280955"
"chr9","20761264","20761573","chr9","20480266","20480575","9","280998"
"chr9","20802756","20803051","chr9","20522216","20522510","13","280540"
"chr9","20806180","20806477","chr9","20525620","20525921","10","280560"
"chr9","20856959","20857233","chr9","20577901","20578185","18","279058"
"chr9","20865821","20866120","chr9","20587053","20587357","14","278768"
"chr9","20894704","20894997","chr9","20614548","20614850","16","280156"
"chr9","20895895","20896184","chr9","20615744","20616035","10","280151"
"chr9","20899476","20899772","chr15","39926277","39926571","55","19026801"
"chr9","20914464","20914689","chr9","20635856","20636081","1","278608"
"chr9","20917356","20917654","chr9","20638742","20639036","10","278614"
"chr9","21000956","21001249","chr9","20725458","20725750","8","275498"
"chr9","21014024","21014290","chr9","20738605","20738871","6","275419"
"chr9","21041054","21041372","chr9","20765865","20766184","6","275189"
"chr9","21054083","21054354","chr9","20778912","20779200","29","275171"
"chr9","21057997","21058277","chr9","20782805","20783085","11","275192"
"chr9","21067022","21067151","chr15","69495745","69495869","25","48428723"
"chr9","21070769","21070965","chr9","20797326","20797522","9","273443"
"chr9","21123627","21123926","chr9","20851892","20852190","19","271735"
"chr9","21133846","21134022","chr9","20862302","20862479","1","271544"
"chr9","21134317","21134452","chr9","20862773","20862910","4","271544"
"chr9","21139656","21139818","chr9","20868136","20868298","2","271520"
"chr9","21149071","21149367","chr1","138961578","138961868","69","117812507"
"chr9","21154406","21154706","chr9","20883600","20883900","8","270806"
"chr9","21182411","21182556","chr9","20911989","20912135","7","270422"
"chr9","21186538","21186806","chr9","20918595","20918861","11","267943"
"chr9","21188741","21188892","chr9","20921099","20921250","3","267642"
"chr9","21203089","21203397","chr9","20934441","20934749","10","268648"
"chr9","21204045","21204235","chr9","20935405","20935576","22","268640"
"chr9","21205618","21205929","chr9","20936941","20937253","11","268677"
"chr9","21206359","21206655","chr9","20937698","20937994","4","268661"
"chr9","21206794","21207103","chr9","20938133","20938442","22","268661"
"chr9","21214569","21214847","chr9","20948581","20948859","10","265988"
"chr9","21231655","21231954","chr9","20962777","20963046","35","268878"
"chr9","21232712","21233004","chr14","9165630","9165925","54","12067082"
"chr9","21235928","21236214","chr9","20967337","20967623","4","268591"
"chr9","21238779","21239085","chr9","20970484","20970790","6","268295"
"chr9","21243520","21243807","chr9","20975477","20975788","35","268043"
"chr9","21246205","21246502","chr9","20978162","20978457","5","268043"
"chr9","21250277","21250395","chr15","23137791","23137894","36","1887514"
"chr9","21259009","21259209","chr9","20989570","20989758","17","269439"
"chr9","21261768","21262077","chr9","20992405","20992712","11","269363"
"chr9","21266891","21267179","chr9","20997906","20998194","7","268985"
"chr9","21281877","21282173","chr9","21015649","21015948","9","266228"
"chr9","21287595","21287901","chr9","21023523","21023828","9","264072"
"chr9","21290500","21290796","chr9","21026903","21027150","63","263597"
"chr9","21341471","21341679","chr9","21080222","21080430","5","261249"
"chr9","21341979","21342065","chr9","21080729","21080815","1","261250"
"chr9","21343099","21343252","chr9","21081967","21082124","6","261132"
"chr9","21343553","21343697","chr9","21082430","21082572","8","261123"
"chr9","21345101","21345398","chr3","45108063","45108369","81","23762962"
"chr9","21345405","21345547","chr9","21084352","21084500","8","261053"
"chr9","21364742","21365032","chr9","21106774","21107064","5","257968"
"chr9","21374388","21374545","chr9","21117894","21118051","4","256494"
"chr9","21374896","21375016","chr9","21118387","21118507","1","256509"
"chr9","21385738","21386023","chr9","21130462","21130743","9","255276"
"chr9","21389197","21389532","chr9","21138307","21138642","9","250890"
"chr9","21393406","21393661","chr9","21142449","21142711","11","250957"
"chr9","21402049","21402347","chr9","21151111","21151408","13","250938"
"chr9","21403311","21403609","chr4","132354492","132354788","59","110951181"
"chr9","21405836","21405918","chr2","1109449","1109533","23","20296387"
"chr9","21408066","21408360","chr9","21157060","21157354","6","251006"
"chr9","21412575","21412855","chr9","21161262","21161542","4","251313"
"chr9","21451208","21451483","chr9","21200558","21200858","30","250650"
"chr9","21461327","21461605","chr9","21211037","21211315","5","250290"
"chr9","21472684","21472817","chr9","21222727","21222860","2","249957"
"chr9","21472818","21473096","chr9","21222861","21223139","8","249957"
"chr9","21473097","21473291","chr9","21223140","21223334","1","249957"
"chr9","21514206","21514514","chr9","21263545","21263844","16","250661"
"chr9","21534475","21534812","chr9","21283548","21283882","10","250927"
"chr9","21541731","21541863","chr3","104055274","104055407","29","82513543"
"chr9","21591356","21591656","chr9","21340824","21341124","1","250532"
"chr9","21591687","21591994","chr13","125438196","125438509","78","103846509"
"chr9","21597238","21597529","chr9","21347141","21347428","11","250097"
"chr9","21655042","21655352","chr9","21405049","21405361","6","249993"
"chr9","21661776","21661853","chr7","75547640","75547719","15","53885864"
"chr9","21670242","21670532","chr9","21419903","21420167","33","250339"
"chr9","21717413","21717721","chr9","21466866","21467173","5","250547"
"chr9","21723518","21723823","chr9","21472964","21473269","9","250554"
"chr9","21741178","21741255","chr9","21490694","21490771","2","250484"
"chr9","21751951","21752200","chr9","21501185","21501433","7","250766"
"chr9","21755636","21755931","chr9","21504861","21505151","11","250775"
"chr9","21897551","21897836","chr9","21649728","21650012","9","247823"
"chr9","21900285","21900588","chr9","21652352","21652651","10","247933"
"chr9","21910415","21910713","chr9","21664145","21664475","40","246270"
"chr9","21913846","21913893","chr4","7549914","7549964","10","14363932"
"chr9","21915766","21916030","chrX","93687784","93688055","57","71772018"
"chr9","21931881","21932187","chr9","21685009","21685308","13","246872"
"chr9","21962504","21962796","chr9","21718365","21718667","15","244139"
"chr9","21969674","21969967","chr9","21725548","21725839","10","244126"
"chr9","21986385","21986693","chr9","21742512","21742817","13","243873"
"chr9","21989132","21989306","chr9","21745253","21745427","4","243879"
"chr9","22002127","22002181","chr15","35316596","35316647","10","13314469"
"chr9","22002187","22002327","chr1","205275609","205275743","35","183273422"
"chr9","22007848","22008019","chr1","130122588","130122730","48","108114740"
"chr9","22017694","22017997","chr9","21773586","21773894","9","244108"
"chr9","22037942","22038215","chr9","21794051","21794324","6","243891"
"chr9","22043286","22043440","chr9","21799352","21799529","25","243934"
"chr9","22050513","22050818","chr9","21806268","21806576","10","244245"
"chr9","22061901","22062027","chr9","21818080","21818206","3","243821"
"chr9","22062780","22062970","chr9","21818957","21819147","6","243823"
"chr9","22074488","22074786","chr9","21830960","21831258","5","243528"
"chr9","22078030","22078150","chr9","21834508","21834628","0","243522"
"chr9","22134837","22135136","chr9","21891975","21892275","10","242862"
"chr9","22147504","22147811","chr9","21905264","21905574","7","242240"
"chr9","22189825","22190121","chr9","21947607","21947907","6","242218"
"chr9","22217997","22218309","chr9","21973643","21973954","7","244354"
"chr9","22219311","22219464","chr4","43080170","43080307","42","20860859"
"chr9","22236552","22236843","chr9","21992473","21992764","4","244079"
"chr9","22239635","22239917","chr9","21995559","21995842","6","244076"
"chr9","22248602","22248688","chr19","49799274","49799362","21","27550672"
"chr9","22248726","22248843","chr6","162438658","162438779","19","140189932"
"chr9","22250170","22250459","chr9","22006105","22006399","12","244065"
"chr9","22253425","22253547","chr9","22009371","22009490","5","244054"
"chr9","22255275","22255571","chr9","22011230","22011517","14","244045"
"chr9","22264155","22264351","chr6","16199787","16199985","35","6064368"
"chr9","22275292","22275414","chr9","22031124","22031243","5","244168"
"chr9","22324321","22324622","chr9","22083183","22083480","7","241138"
"chr9","22350234","22350544","chr9","22109295","22109600","12","240939"
"chr9","22417635","22417837","chr9","22179590","22179780","20","238045"
"chr9","22437151","22437412","chr9","22199067","22199317","16","238084"
"chr9","22448787","22449084","chr6","126229725","126230021","56","103780938"
"chr9","22456109","22456386","chr9","22216729","22217006","5","239380"
"chr9","22483204","22483510","chr5","169227","169528","56","22313977"
"chr9","22483964","22484284","chr9","22244679","22244997","8","239285"
"chr9","22522830","22523126","chr9","22283634","22283929","8","239196"
"chr9","22524533","22524828","chr9","22285331","22285635","15","239202"
"chr9","22563284","22563596","chr9","22323480","22323790","16","239804"
"chr9","22607990","22608292","chr9","22369067","22369356","23","238923"
"chr9","22633560","22633842","chr9","22394534","22394816","10","239026"
"chr9","22671650","22671722","chr14","72789791","72789860","16","50118141"
"chr9","22676230","22676512","chr9","22437142","22437424","12","239088"
"chr9","22693812","22694095","chr9","22454562","22454871","33","239250"
"chr9","22704007","22704327","chr9","22464720","22465040","10","239287"
"chr9","22716375","22716710","chr9","22476251","22476564","25","240124"
"chr9","22730561","22730851","chr9","22490363","22490660","17","240198"
"chr9","22769855","22770145","chr9","22531174","22531468","13","238681"
"chr9","22781518","22781833","chr9","22542798","22543104","14","238720"
"chr9","22790559","22790848","chr9","22551848","22552134","15","238711"
"chr9","22803287","22803392","chr16","45798027","45798132","19","22994740"
"chr9","22829851","22830155","chr9","22591253","22591557","8","238598"
"chr9","22836024","22836148","chr9","22597354","22597466","13","238670"
"chr9","22836288","22836481","chr9","22597503","22597699","19","238785"
"chr9","22842595","22842899","chr2","78493440","78493742","56","55650845"
"chr9","22847295","22847434","chr18","38073324","38073462","25","15226029"
"chr9","22850916","22851224","chr20","50911750","50912066","64","28060834"
"chr9","22899002","22899159","chr3","178210714","178210870","29","155311712"
"chr9","22899192","22899295","chr15","6139004","6139107","17","16760188"
"chr9","22900797","22901081","chr9","22662774","22663065","13","238023"
"chr9","22919196","22919498","chr9","22681397","22681702","8","237799"
"chr9","22927845","22928124","chr7","14286956","14287238","51","8640889"
"chr9","22942591","22942876","chr9","22704844","22705135","13","237747"
"chr9","22952053","22952348","chr9","22714407","22714703","8","237646"
"chr9","22954976","22955271","chr7","49571405","49571710","58","26616429"
"chr9","22960249","22960374","chr18","17236866","17236992","25","5723383"
"chr9","22981314","22981611","chr9","22743938","22744240","12","237376"
"chr9","22991453","22991756","chr9","22754140","22754441","21","237313"
"chr9","22996054","22996176","chr5","50976098","50976200","38","27980044"
"chr9","22997802","22998107","chr9","22760475","22760785","20","237327"
"chr9","23002940","23003221","chr9","22765585","22765879","17","237355"
"chr9","23011903","23012113","chr9","22774406","22774614","4","237497"
"chr9","23015796","23016089","chr9","22778302","22778595","8","237494"
"chr9","23018734","23018877","chr9","22781238","22781381","8","237496"
"chr9","23042703","23042985","chr9","22811742","22812041","24","230961"
"chr9","23047964","23048263","chr9","22817057","22817361","21","230907"
"chr9","23072148","23072470","chr9","22841304","22841626","16","230844"
"chr9","23079618","23079923","chr9","22848763","22849068","5","230855"
"chr9","23087541","23087665","chr14","8709367","8709489","25","14378174"
"chr9","23092895","23093205","chr9","22861904","22862211","13","230991"
"chr9","23102815","23103121","chr9","22871357","22871672","14","231458"
"chr9","23105796","23106079","chr9","22874337","22874615","13","231459"
"chr9","23139532","23139668","chr9","22908770","22908906","2","230762"
"chr9","23158151","23158452","chrX","10593693","10594000","57","12564458"
"chr9","23162428","23162610","chr8","127019364","127019537","41","103856936"
"chr9","23169499","23169771","chr9","22938947","22939219","8","230552"
"chr9","23170720","23171017","chr9","22940168","22940471","13","230552"
"chr9","23174149","23174277","chr9","22944225","22944349","6","229924"
"chr9","23175014","23175297","chr9","22945100","22945390","13","229914"
"chr9","23180394","23180701","chr9","22950770","22951081","7","229624"
"chr9","23181830","23182125","chr6","65554530","65554821","50","42372700"
"chr9","23186219","23186354","chr9","22957192","22957327","5","229027"
"chr9","23186654","23186817","chr9","22957627","22957790","4","229027"
"chr9","23187496","23187712","chr7","76975807","76976022","43","53788311"
"chr9","23192687","23192962","chr9","22963850","22964126","13","228837"
"chr9","23199971","23200268","chr9","22971853","22972158","29","228118"
"chr9","23202993","23203151","chr9","22974874","22975030","15","228119"
"chr9","23208298","23208618","chr9","22980195","22980517","12","228103"
"chr9","23215207","23215358","chr19","2871066","2871219","28","20344141"
"chr9","23261181","23261463","chr6","168310873","168311167","63","145049692"
"chr9","23278075","23278382","chr9","23054889","23055159","48","223186"
"chr9","23281467","23281754","chr9","23058251","23058527","13","223216"
"chr9","23289954","23290270","chr9","23066644","23066958","8","223310"
"chr9","23296047","23296292","chr9","23072735","23072977","8","223312"
"chr9","23296513","23296571","chr1","6641003","6641065","13","16655510"
"chr9","23306081","23306337","chr9","23082749","23083006","3","223332"
"chr9","23310549","23310847","chr9","23087364","23087663","6","223185"
"chr9","23365538","23365854","chr9","23141640","23141958","17","223898"
"chr9","23405741","23406032","chr9","23186471","23186758","12","219270"
"chr9","23451639","23451948","chr9","23236243","23236555","22","215396"
"chr9","23452846","23453088","chr9","23237448","23237693","20","215398"
"chr9","23504323","23504466","chr10","72116415","72116555","25","48612092"
"chr9","23574661","23574951","chr9","23360940","23361230","3","213721"
"chr9","23587352","23587611","chr9","31305843","31306101","61","7718491"
"chr9","23588262","23588583","chr7","158585944","158586255","59","134997682"
"chr9","23606214","23606484","chr10","6013804","6014082","53","17592410"
"chr9","23635345","23635627","chr9","23421460","23421742","9","213885"
"chr9","23672303","23672562","chr9","23456157","23456449","39","216146"
"chr9","23695034","23695285","chr9","23478899","23479149","11","216135"
"chr9","23720598","23720743","chr9","23502861","23503004","3","217737"
"chr9","23777674","23777958","chr9","23559981","23560265","14","217693"
"chr9","23778618","23778904","chr9","23560925","23561212","12","217693"
"chr9","23780684","23780981","chr9","23562965","23563308","54","217719"
"chr9","23801395","23801703","chr9","23583522","23583822","15","217873"
"chr9","23806660","23806982","chr14","107286960","107287259","94","83480300"
"chr9","23812770","23812989","chr9","23594795","23594998","24","217975"
"chr9","23815079","23815370","chr9","23597175","23597458","43","217904"
"chr9","23824701","23824988","chr9","23607930","23608221","13","216771"
"chr9","23831006","23831161","chr9","23614371","23614519","11","216635"
"chr9","23831473","23831605","chr9","23614834","23614966","3","216639"
"chr9","23844320","23844484","chr9","23627713","23627873","10","216607"
"chr9","23853274","23853569","chr9","23635030","23635325","9","218244"
"chr9","23882143","23882353","chr9","23664345","23664555","8","217798"
"chr9","23924092","23924388","chr9","23706745","23707041","11","217347"
"chr9","23927709","23928037","chr9","23710363","23710690","3","217346"
"chr9","23945241","23945447","chr4","125919367","125919579","44","101974126"
"chr9","23950203","23950395","chr9","23733254","23733414","34","216949"
"chr9","23952431","23952734","chr9","23735474","23735777","10","216957"
"chr9","23956690","23956876","chr9","23739682","23739869","10","217008"
"chr9","23960412","23960666","chr9","23743376","23743633","10","217036"
"chr9","23963568","23963729","chr9","23746535","23746694","8","217033"
"chr9","23965199","23965438","chr9","23748157","23748389","15","217042"
"chr9","23973231","23973519","chr9","23758067","23758353","6","215164"
"chr9","23983987","23984275","chr9","23768742","23769031","14","215245"
"chr9","23989998","23990154","chr9","23774662","23774815","8","215336"
"chr9","23994421","23994642","chr18","16392466","16392684","37","7601955"
"chr9","23996704","23996994","chr9","23781452","23781742","6","215252"
"chr9","24002429","24002722","chr9","23787176","23787466","7","215253"
"chr9","24043243","24043549","chr9","23828274","23828579","20","214969"
"chr9","24046408","24046720","chr9","23831424","23831734","18","214984"
"chr9","24048316","24048563","chr15","22573263","22573509","70","1475053"
"chr9","24051276","24051439","chr9","23836330","23836500","8","214946"
"chr9","24065675","24065966","chr7","18328545","18328829","57","5737130"
"chr9","24097270","24097581","chr9","23882260","23882571","10","215010"
"chr9","24119282","24119580","chr9","23903842","23904146","11","215440"
"chr9","24142762","24143065","chr9","23926779","23927082","8","215983"
"chr9","24169120","24169410","chr9","23953171","23953461","8","215949"
"chr9","24187474","24187786","chr9","23970581","23970895","9","216893"
"chr9","24194885","24195182","chr9","23977998","23978294","9","216887"
"chr9","24203505","24203804","chr9","23986582","23986885","12","216923"
"chr9","24228554","24228635","chr1","64423569","64423653","14","40195015"
"chr9","24228981","24229275","chr9","24012114","24012407","7","216867"
"chr9","24259361","24259630","chr9","24042513","24042770","17","216848"
"chr9","24264730","24265021","chr9","24047877","24048168","6","216853"
"chr9","24269876","24270186","chr9","24053040","24053349","12","216836"
"chr9","24295776","24296035","chr9","24078928","24079196","20","216848"
"chr9","24312878","24313172","chr9","24099768","24100056","9","213110"
"chr9","24324335","24324607","chr9","24111413","24111688","15","212922"
"chr9","24328792","24329068","chr9","24115854","24116129","2","212938"
"chr9","24329189","24329304","chr9","24116250","24116371","7","212939"
"chr9","24372444","24372737","chr9","24160354","24160647","8","212090"
"chr9","24386741","24386981","chr9","24174658","24174898","2","212083"
"chr9","24413994","24414271","chr20","70780938","70781202","71","46366944"
"chr9","24421345","24421648","chr9","24209727","24210034","6","211618"
"chr9","24422106","24422397","chr9","24210492","24210780","7","211614"
"chr9","24424671","24424964","chr9","24213044","24213337","4","211627"
"chr9","24437719","24437919","chr9","24226277","24226482","7","211442"
"chr9","24439787","24439965","chr9","24228336","24228493","24","211451"
"chr9","24440279","24440404","chr9","24228801","24228926","2","211478"
"chr9","24462068","24462363","chr2","99905203","99905497","67","75443135"
"chr9","24466973","24467131","chr19","14673246","14673394","37","9793727"
"chr9","24474587","24474789","chr6","64865093","64865307","55","40390506"
"chr9","24474954","24474998","chr5","324650","324693","10","24150304"
"chr9","24477620","24477916","chr9","24268058","24268367","26","209562"
"chr9","24479269","24479577","chr9","24270269","24270573","9","209000"
"chr9","24482609","24482864","chr9","24273562","24273808","26","209047"
"chr9","24489010","24489310","chr9","24279823","24280105","33","209187"
"chr9","24491390","24491591","chr9","24282205","24282408","7","209185"
"chr9","24504924","24505229","chr9","24295638","24295939","23","209286"
"chr9","24507354","24507668","chr16","67834515","67834817","63","43327161"
"chr9","24520729","24521001","chr9","24310391","24310665","21","210338"
"chr9","24538988","24539271","chr9","24328753","24329036","4","210235"
"chr9","24547500","24547804","chr9","24338504","24338808","12","208996"
"chr9","24572734","24572890","chr9","24362244","24362400","4","210490"
"chr9","24583563","24583666","chr7","61455135","61455237","20","36871572"
"chr9","24618878","24619186","chr9","24409102","24409406","28","209776"
"chr9","24625830","24626125","chr9","24416039","24416334","4","209791"
"chr9","24631659","24631717","chr9","24422056","24422111","3","209603"
"chr9","24665794","24666088","chr10","59638263","59638558","54","34972469"
"chr9","24671809","24672118","chr9","24464369","24464678","6","207440"
"chr9","24674030","24674311","chr9","24466591","24466872","10","207439"
"chr9","24689788","24690102","chr9","24482679","24482996","11","207109"
"chr9","24712016","24712239","chr9","24504596","24504819","10","207420"
"chr9","24722296","24722582","chr9","24515073","24515359","7","207223"
"chr9","24743196","24743488","chr9","24534642","24534935","7","208554"
"chr9","24744437","24744721","chr9","24535891","24536177","15","208546"
"chr9","24765463","24765802","chr9","24557265","24557575","37","208198"
"chr9","24770464","24770760","chr9","24562300","24562586","14","208164"
"chr9","24779456","24779759","chr9","24571087","24571389","7","208369"
"chr9","24807650","24807915","chr9","24597563","24597823","7","210087"
"chr9","24819108","24819390","chr9","24608891","24609173","1","210217"
"chr9","24820786","24821090","chr9","24610580","24610884","11","210206"
"chr9","24837077","24837171","chr9","24626873","24626976","14","210204"
"chr9","24837797","24837842","chr9","24627603","24627649","6","210194"
"chr9","24838138","24838321","chr9","24627955","24628139","11","210183"
"chr9","24868233","24868513","chr9","24657902","24658181","8","210331"
"chr9","24909620","24909914","chr9","24700121","24700415","10","209499"
"chr9","24914338","24914619","chr9","24704844","24705127","9","209494"
"chr9","24973845","24974185","chr9","24772510","24772844","14","201335"
"chr9","24991530","24991833","chr9","24790492","24790795","9","201038"
"chr9","24999090","24999401","chr9","24798012","24798323","3","201078"
"chr9","25335721","25336011","chr9","25152283","25152559","24","183438"
"chr9","25338273","25338382","chr8","71705519","71705629","20","46367246"
"chr9","25338406","25338451","chr11","42201229","42201273","12","16862823"
"chr9","25340756","25341040","chr9","25157305","25157591","13","183451"
"chr9","25349103","25349241","chr16","69692929","69693065","27","44343826"
"chr9","25383217","25383516","chr9","25198308","25198605","13","184909"
"chr9","25467741","25468047","chr9","25283309","25283610","13","184432"
"chr9","25503497","25503805","chr3","153174547","153174843","61","127671050"
"chr9","25518872","25519244","chr7","160210008","160210357","114","134691136"
"chr9","25540306","25540588","chr9","25359888","25360179","16","180418"
"chr9","25541668","25541846","chr9","25361262","25361440","4","180406"
"chr9","25551994","25552147","chr9","25370632","25370785","9","181362"
"chr9","25564090","25564401","chr9","25384662","25384973","8","179428"
"chr9","25589990","25590291","chr9","25410570","25410868","13","179420"
"chr9","25592037","25592306","chr9","25412615","25412885","14","179422"
"chr9","25630327","25630625","chr9","25437883","25438199","26","192444"
"chr9","25701662","25701977","chr9","25512865","25513180","4","188797"
"chr9","25717447","25717746","chr9","25528587","25528884","8","188860"
"chr9","25805980","25806211","chr9","25621278","25621514","11","184702"
"chr9","25811705","25811936","chr9","25621278","25621514","11","190427"
"chr9","25888311","25888615","chr9","25693298","25693599","4","195013"
"chr9","25898406","25898687","chr9","25703393","25703674","5","195013"
"chr9","25919973","25920199","chr9","25723591","25723817","17","196382"
"chr9","26002124","26002431","chr9","25805999","25806307","12","196125"
"chr9","26007616","26007909","chr9","25811169","25811459","15","196447"
"chr9","26012318","26012472","chr9","25817596","25817746","6","194722"
"chr9","26012798","26012935","chr9","25818068","25818202","6","194730"
"chr9","26049522","26049828","chr9","25860016","25860320","24","189506"
"chr9","26072338","26072637","chr9","25883945","25884244","9","188393"
"chr9","26127333","26127607","chr9","25939544","25939852","40","187789"
"chr9","26131591","26131654","chr19","211655","211716","15","25919936"
"chr9","26131655","26131794","chr5","58019117","58019243","32","31887462"
"chr9","26132067","26132182","chr9","25944413","25944529","4","187654"
"chr9","26135088","26135215","chr13","42185173","42185300","22","16050085"
"chr9","26141363","26141504","chr9","25953719","25953864","6","187644"
"chr9","26164659","26164787","chr1","41160156","41160285","20","14995497"
"chr9","26176809","26177012","chr9","25989257","25989459","5","187552"
"chr9","26183675","26183956","chr9","25996151","25996453","29","187524"
"chr9","26201074","26201293","chr9","26015358","26015576","12","185716"
"chr9","26203650","26203752","chr9","26017916","26018018","1","185734"
"chr9","26208491","26208779","chr9","26022895","26023182","8","185596"
"chr9","26212017","26212313","chr7","17505052","17505345","51","8706965"
"chr9","26222058","26222344","chr9","26036768","26037059","22","185290"
"chr9","26223267","26223374","chr9","26037966","26038073","2","185301"
"chr9","26225467","26225754","chr8","10034943","10035230","57","16190524"
"chr9","26226568","26226748","chr9","26040940","26041120","5","185628"
"chr9","26238365","26238662","chr9","26052498","26052818","29","185867"
"chr9","26289175","26289285","chr9","26103194","26103306","4","185981"
"chr9","26302863","26303144","chr9","26117483","26117764","5","185380"
"chr9","26306713","26307023","chr9","26121333","26121627","28","185380"
"chr9","26316932","26317234","chr9","26131836","26132138","5","185096"
"chr9","26317752","26317915","chr7","117936452","117936611","31","91618700"
"chr9","26329047","26329126","chr9","26143868","26143947","1","185179"
"chr9","26342184","26342245","chr3","51603396","51603455","8","25261212"
"chr9","26361175","26361478","chr9","26171818","26172114","16","189357"
"chr9","26364525","26364810","chr9","26175125","26175413","7","189400"
"chr9","26404061","26404325","chr13","69989116","69989363","61","43585055"
"chr9","26408752","26409038","chr9","26219434","26219720","8","189318"
"chr9","26422014","26422322","chr9","26232741","26233039","13","189273"
"chr9","26425120","26425189","chr9","26235363","26235432","3","189757"
"chr9","26425483","26425660","chr9","26235726","26235902","3","189757"
"chr9","26430986","26431079","chr9","26241159","26241253","2","189827"
"chr9","26436234","26436547","chr9","26246400","26246707","17","189834"
"chr9","26442165","26442462","chr9","26252280","26252577","14","189885"
"chr9","26466791","26467068","chr9","26275081","26275391","38","191710"
"chr9","26482169","26482484","chr9","26292327","26292642","19","189842"
"chr9","26491993","26492295","chr9","26301810","26302114","10","190183"
"chr9","26492351","26492508","chr9","26302174","26302354","31","190177"
"chr9","26496345","26496634","chr9","26306371","26306650","18","189974"
"chr9","26509675","26509789","chr9","26308943","26309055","8","200732"
"chr9","26510144","26510468","chr9","26308010","26308335","14","202134"
"chr9","26514702","26514968","chr3","151478650","151478916","69","124963948"
"chr9","26524788","26524847","chr9","26325629","26325688","3","199159"
"chr9","26554373","26554614","chr5","78734228","78734466","62","52179855"
"chr9","26563978","26564091","chr9","26363156","26363269","2","200822"
"chr9","26586094","26586219","chr9","26387106","26387230","3","198988"
"chr9","26646945","26647012","chr9","26449285","26449354","5","197660"
"chr9","26654961","26655253","chr9","26457218","26457511","10","197743"
"chr9","26665105","26665380","chr1","24644238","24644521","68","2020867"
"chr9","26679604","26679891","chr9","26482211","26482499","15","197393"
"chr9","26684931","26685215","chr9","26487689","26487971","11","197242"
"chr9","26693847","26694127","chr9","26496279","26496559","2","197568"
"chr9","26704719","26704930","chr9","26507121","26507342","15","197598"
"chr9","26704954","26705266","chr9","26507366","26507683","19","197588"
"chr9","26706918","26707217","chr9","26509653","26509967","19","197265"
"chr9","26717881","26718120","chr9","26520267","26520507","6","197614"
"chr9","26722091","26722209","chr15","36677028","36677150","23","9954937"
"chr9","26722898","26723071","chr9","26523246","26523416","6","199652"
"chr9","26733702","26734004","chr9","26528635","26528939","6","205067"
"chr9","26761881","26762078","chr9","26559577","26559750","34","202304"
"chr9","26762275","26762378","chr9","26559798","26559901","1","202477"
"chr9","26766926","26767142","chr6","65041124","65041348","53","38274198"
"chr9","26767735","26767990","chr13","11325593","11325829","63","15442142"
"chr9","26783003","26783287","chr9","26580845","26581128","3","202158"
"chr9","26783720","26784025","chr7","23399828","23400136","53","3383892"
"chr9","26806346","26806576","chr9","26605108","26605338","4","201238"
"chr9","26812852","26813124","chr9","26611648","26611908","25","201204"
"chr9","26818446","26818655","chr1","54425917","54426121","63","27607471"
"chr9","26824417","26824712","chr9","26623510","26623823","24","200907"
"chr9","26834446","26834720","chr9","26633496","26633769","3","200950"
"chr9","26869199","26869279","chr8","74369844","74369927","15","47500645"
"chr9","26893170","26893456","chr12","99500507","99500800","58","72607337"
"chr9","26928641","26928927","chr9","26729461","26729747","6","199180"
"chr9","26931312","26931506","chr9","26732160","26732347","14","199152"
"chr9","26940794","26941105","chr9","26741776","26742069","23","199018"
"chr9","26967819","26968024","chr1","26922470","26922675","54","45349"
"chr9","26994463","26994580","chr9","26794122","26794240","4","200341"
"chr9","27020069","27020372","chr9","26820846","26821150","5","199223"
"chr9","27060244","27060418","chr9","26861410","26861584","4","198834"
"chr9","27090219","27090500","chrX","7312938","7313223","69","19777281"
"chr9","27091769","27091902","chr9","26892311","26892444","1","199458"
"chr9","27099789","27100083","chr9","26900208","26900508","11","199581"
"chr9","27108221","27108396","chr9","26908631","26908778","31","199590"
"chr9","27108415","27108693","chr3","104066726","104067014","57","76958311"
"chr9","27137349","27137469","chr9","26937961","26938081","2","199388"
"chr9","27149909","27150209","chr9","26950410","26950714","16","199499"
"chr9","27216092","27216400","chr9","27057073","27057385","20","159019"
"chr9","27222352","27222626","chr9","27063572","27063841","11","158780"
"chr9","27231147","27231453","chr2","78493440","78493742","59","51262293"
"chr9","27272885","27273029","chr6","38143328","38143467","25","10870443"
"chr9","27289368","27289668","chr9","27130683","27130983","4","158685"
"chr9","27399735","27399977","chr9","27240872","27241113","8","158863"
"chr9","27415393","27415682","chr9","27256496","27256785","6","158897"
"chr9","27439335","27439632","chr3","45924434","45924731","61","18485099"
"chr9","27456346","27456631","chr9","27298942","27299227","8","157404"
"chr9","27480964","27481213","chr9","27321155","27321376","36","159809"
"chr9","27485645","27485924","chr9","27325766","27326058","19","159879"
"chr9","27511660","27511814","chr9","27356679","27356828","7","154981"
"chr9","27567211","27567457","chr9","27412149","27412422","38","155062"
"chr9","27578320","27578501","chr9","27423111","27423295","8","155209"
"chr9","27611091","27611402","chr9","27454163","27454470","13","156928"
"chr9","27619498","27619728","chr9","27462950","27463175","9","156548"
"chr9","27627768","27628050","chr9","27471248","27471533","10","156520"
"chr9","27662213","27662394","chr9","89380074","89380251","33","61717861"
"chr9","27662437","27662558","chr6","144035879","144035999","22","116373442"
"chr9","27677486","27677792","chr9","27519891","27520197","1","157595"
"chr9","27701220","27701372","chr9","54920627","54920788","44","27219407"
"chr9","27723583","27723898","chr9","27566332","27566636","21","157251"
"chr9","27779702","27779851","chr9","27623075","27623224","2","156627"
"chr9","27790016","27790332","chr9","27633395","27633683","36","156621"
"chr9","27801327","27801463","chr9","27646081","27646215","5","155246"
"chr9","27802397","27802703","chr9","27647151","27647458","12","155246"
"chr9","27832113","27832393","chr9","27676846","27677126","7","155267"
"chr9","27836556","27836764","chr7","90828972","90829173","46","62992416"
"chr9","27837770","27838045","chr9","27680847","27681122","9","156923"
"chr9","27839001","27839125","chr1","79644992","79645112","24","51805991"
"chr9","27840314","27840609","chr9","27683370","27683669","8","156944"
"chr9","27849656","27849941","chr9","27692743","27693043","31","156913"
"chr9","27861049","27861121","chr1","202762251","202762322","13","174901202"
"chr9","27862322","27862596","chr1","63128997","63129278","49","35266675"
"chr9","27880645","27880809","chr1","139933203","139933372","25","112052558"
"chr9","27885634","27885925","chr9","27729837","27730123","17","155797"
"chr9","27896997","27897228","chr9","27741377","27741605","7","155620"
"chr9","27916845","27917131","chr9","27765445","27765716","30","151400"
"chr9","27920355","27920555","chr9","27768861","27769070","17","151494"
"chr9","27937723","27938023","chr9","27785503","27785804","7","152220"
"chr9","27947824","27948114","chr9","27795334","27795622","9","152490"
"chr9","27955744","27956048","chr9","27803354","27803655","5","152390"
"chr9","28042447","28042733","chr4","114468841","114469122","59","86426394"
"chr9","28054065","28054358","chr9","27905922","27906217","12","148143"
"chr9","28083069","28083349","chr14","733079","733357","63","27349990"
"chr9","28090667","28090936","chr11","25373394","25373661","73","2717273"
"chr9","28105463","28105794","chr4","113000059","113000390","52","84894596"
"chr9","28130778","28130957","chr20","51080323","51080502","47","22949545"
"chr9","28131088","28131188","chr18","852448","852546","23","27278640"
"chr9","28163619","28163898","chr9","27996474","27996753","6","167145"
"chr9","28167446","28167745","chr9","28000307","28000612","12","167139"
"chr9","28205735","28206052","chr9","28038158","28038473","17","167577"
"chr9","28209302","28209551","chr10","49008839","49009096","60","20799537"
"chr9","28231589","28231873","chr9","28064630","28064912","7","166959"
"chr9","28261167","28261468","chr9","28094060","28094357","16","167107"
"chr9","28270179","28270404","chr9","28102895","28103119","7","167284"
"chr9","28270470","28270741","chr9","28103186","28103457","1","167284"
"chr9","28272444","28272753","chr9","80146497","80146802","51","51874053"
"chr9","28293443","28293744","chr9","28125231","28125532","8","168212"
"chr9","28295728","28296013","chr9","28127526","28127814","18","168202"
"chr9","28297599","28297755","chr1","29939988","29940142","29","1642389"
"chr9","28302215","28302373","chr9","28133846","28134005","4","168369"
"chr9","28308806","28309096","chr9","28140343","28140633","5","168463"
"chr9","28318455","28318666","chr9","28149081","28149294","13","169374"
"chr9","28320245","28320499","chr9","28150871","28151126","12","169374"
"chr9","28322549","28322705","chr9","28153354","28153519","11","169195"
"chr9","28323003","28323136","chr9","28153817","28153950","3","169186"
"chr9","28323907","28324203","chr9","28154712","28155008","7","169195"
"chr9","28325580","28325885","chr9","28156386","28156692","10","169194"
"chr9","28328638","28328955","chr9","28159446","28159763","11","169192"
"chr9","28336121","28336406","chr9","28167348","28167676","46","168773"
"chr9","28358034","28358264","chr9","28189292","28189524","9","168742"
"chr9","28363072","28363360","chr9","28194228","28194527","16","168844"
"chr9","28371469","28371659","chr9","28202938","28203128","4","168531"
"chr9","28380347","28380432","chr7","123379466","123379550","16","94999119"
"chr9","28381556","28381812","chr9","28213396","28213649","8","168160"
"chr9","28382376","28382646","chr9","28214223","28214491","12","168153"
"chr9","28391371","28391654","chr9","28222905","28223180","15","168466"
"chr9","28438409","28438717","chr9","28271320","28271633","17","167089"
"chr9","28440322","28440588","chr9","28273221","28273487","8","167101"
"chr9","28444161","28444467","chr9","28277061","28277367","4","167100"
"chr9","28448649","28448924","chr9","28281583","28281858","6","167066"
"chr9","28453874","28454059","chr9","28286742","28286928","6","167132"
"chr9","28454492","28454577","chr9","28287339","28287433","10","167153"
"chr9","28458072","28458351","chr9","28290932","28291212","5","167140"
"chr9","28463599","28463894","chr9","28295955","28296254","12","167644"
"chr9","28470587","28470873","chr9","28302913","28303199","6","167674"
"chr9","28481095","28481231","chr9","28312690","28312826","1","168405"
"chr9","28481595","28481610","chr9","28313212","28313227","1","168383"
"chr9","28502390","28502701","chr9","28334570","28334903","33","167820"
"chr9","28512997","28513317","chr9","28344113","28344430","13","168884"
"chr9","28565198","28565510","chr9","28397023","28397317","31","168175"
"chr9","28568716","28569013","chr9","28401713","28402011","4","167003"
"chr9","28570409","28570531","chr1","56897920","56898046","20","28327511"
"chr9","28571073","28571224","chr3","148580967","148581112","39","120009894"
"chr9","28594782","28595082","chr9","28427633","28427931","6","167149"
"chr9","28595811","28596106","chr9","28428676","28428962","14","167135"
"chr9","28609419","28609580","chrX","44611948","44612115","28","16002529"
"chr9","28616849","28617149","chr9","28448894","28449190","16","167955"
"chr9","28629819","28630131","chr9","28461391","28461705","11","168428"
"chr9","28641374","28641682","chr9","28473093","28473410","25","168281"
"chr9","28649443","28649640","chr13","53892039","53892240","52","25242596"
"chr9","28667337","28667660","chr9","28500001","28500325","11","167336"
"chr9","28671251","28671530","chr9","28503899","28504178","11","167352"
"chr9","28674763","28675032","chr9","28507414","28507678","16","167349"
"chr9","28829212","28829462","chr9","28664097","28664347","4","165115"
"chr9","28835957","28836123","chr9","28670816","28670983","6","165141"
"chr9","28916890","28917186","chr9","28750047","28750344","2","166843"
"chr9","28933213","28933515","chr9","28766766","28767100","51","166447"
"chr9","28941891","28942162","chr9","28775422","28775704","36","166469"
"chr9","28980104","28980398","chr9","28811391","28811687","11","168713"
"chr9","28981878","28982187","chr1","21225824","21226139","58","7756054"
"chr9","28989839","28990030","chr9","28821476","28821662","14","168363"
"chr9","28995072","28995353","chr9","28827442","28827723","9","167630"
"chr9","28997728","28998041","chr9","28830116","28830424","15","167612"
"chr9","29005034","29005346","chr9","28837423","28837715","33","167611"
"chr9","29006731","29007006","chr9","28839055","28839330","7","167676"
"chr9","29018305","29018592","chr9","28856077","28856344","29","162228"
"chr9","29081944","29082108","chr9","28908927","28909087","6","173017"
"chr9","29086414","29086575","chr9","28913348","28913513","7","173066"
"chr9","29089898","29090025","chr11","82993111","82993234","25","53903213"
"chr9","29090220","29090353","chr7","38981938","38982066","26","9891718"
"chr9","29093118","29093390","chr9","28920093","28920366","6","173025"
"chr9","29140029","29140269","chr9","28964400","28964640","1","175629"
"chr9","29143157","29143445","chr9","28967529","28967817","2","175628"
"chr9","29159022","29159320","chr9","28983380","28983685","18","175642"
"chr9","29167809","29167947","chr9","28992547","28992690","5","175262"
"chr9","29170736","29171028","chr9","28995481","28995773","9","175255"
"chr9","29185733","29186039","chr9","29010046","29010353","6","175687"
"chr9","29193891","29194160","chr9","29018167","29018437","9","175724"
"chr9","29198255","29198561","chr9","29022539","29022823","29","175716"
"chr9","29207777","29208073","chr9","29031944","29032236","18","175833"
"chr9","29243477","29243790","chr9","29074591","29074903","8","168886"
"chr9","29265951","29266260","chr11","52684611","52684917","56","23418660"
"chr9","29280012","29280130","chr9","29110331","29110449","5","169681"
"chr9","29281655","29281958","chr9","29111977","29112272","10","169678"
"chr9","29286823","29286995","chr9","29117478","29117658","13","169345"
"chr9","29287172","29287456","chr3","160403085","160403367","59","131115913"
"chr9","29318032","29318324","chr9","29149056","29149350","13","168976"
"chr9","29326548","29326857","chr9","29157490","29157799","12","169058"
"chr9","29350695","29350964","chr9","29182952","29183255","46","167743"
"chr9","29367881","29368167","chr9","29200112","29200398","7","167769"
"chr9","29394422","29394704","chr17","55074592","55074874","53","25680170"
"chr9","29395466","29395778","chr11","59968503","59968814","60","30573037"
"chr9","29426535","29426848","chr2","50876226","50876534","62","21449691"
"chr9","29443437","29443732","chr1","28987025","28987315","53","456412"
"chr9","29457589","29457758","chr13","7960128","7960302","28","21497461"
"chr9","29467067","29467392","chr9","29299417","29299742","8","167650"
"chr9","29468824","29468999","chr9","29301195","29301347","29","167629"
"chr9","29476414","29476700","chr9","29308837","29309121","14","167577"
"chr9","29502162","29502455","chr9","29334505","29334798","8","167657"
"chr9","29504117","29504292","chr9","29336461","29336633","9","167656"
"chr9","29510046","29510315","chr9","29342366","29342644","21","167680"
"chr9","29558390","29558507","chr19","15059253","15059370","14","14499137"
"chr9","29558668","29558692","chr13","9281110","9281133","7","20277558"
"chr9","29585108","29585171","chr9","29417099","29417162","3","168009"
"chr9","29633504","29633746","chr9","29461176","29461418","6","172328"
"chr9","29677610","29677764","chr9","29505610","29505764","6","172000"
"chr9","29767505","29767634","chr9","29592099","29592228","1","175406"
"chr9","29772573","29772883","chr9","29597190","29597490","26","175383"
"chr9","29778706","29779017","chr9","29604589","29604900","7","174117"
"chr9","29845257","29845538","chr9","29667090","29667402","39","178167"
"chr9","29849098","29849398","chr9","29670904","29671203","10","178194"
"chr9","29849566","29849880","chr9","29671375","29671685","7","178191"
"chr9","29856627","29856923","chr9","29678298","29678592","12","178329"
"chr9","29859462","29859570","chr9","29681138","29681246","3","178324"
"chr9","29861409","29861711","chr9","29683035","29683337","15","178374"
"chr9","29906199","29906392","chr9","29728048","29728231","11","178151"
"chr9","29906713","29906844","chr9","29728544","29728679","14","178169"
"chr9","29907497","29907565","chr9","29729329","29729400","4","178168"
"chr9","29915980","29916297","chr9","29737673","29737990","3","178307"
"chr9","29925429","29925682","chr9","29747134","29747385","9","178295"
"chr9","29925694","29925987","chr9","29747397","29747693","11","178297"
"chr9","29929442","29929715","chr10","57902667","57902942","60","27973225"
"chr9","29938338","29938469","chr9","29760426","29760551","14","177912"
"chr9","29958119","29958404","chr9","29784592","29784874","6","173527"
"chr9","29982771","29983035","chr9","29806749","29807017","16","176022"
"chr9","29984292","29984431","chr9","29808277","29808416","2","176015"
"chr9","29984961","29985257","chr9","29808947","29809250","22","176014"
"chr9","29987205","29987520","chrX","35438679","35439005","15","5451474"
"chr9","30017494","30017632","chr12","32953036","32953170","26","2935542"
"chr9","30027952","30028239","chr9","13017322","13017629","27","17010630"
"chr9","30030674","30030974","chr9","13019350","13019651","6","17011324"
"chr9","30059999","30060285","chr9","30149284","30149570","8","89285"
"chr9","30083170","30083331","chr9","30181633","30181794","1","98463"
"chr9","30099598","30099828","chr9","30196269","30196499","9","96671"
"chr9","30112780","30113096","chr9","30212359","30212668","33","99579"
"chr9","30122582","30122713","chr9","30222164","30222296","3","99582"
"chr9","30128437","30128728","chr9","30228060","30228351","7","99623"
"chr9","30129333","30129660","chrX","17125928","17126236","62","13003405"
"chr9","30138862","30139161","chr11","53445690","53445987","67","23306828"
"chr9","30145503","30145784","chr9","30245182","30245485","30","99679"
"chr9","30180274","30180580","chr9","30278615","30278914","13","98341"
"chr9","30237979","30238265","chr9","30335894","30336181","4","97915"
"chr9","30262361","30262634","chr9","30359798","30360073","9","97437"
"chr9","30388885","30388968","chr2","51576839","51576920","15","21187954"
"chr9","30404766","30405059","chr9","30506708","30507004","10","101942"
"chr9","30502910","30503208","chr9","30605601","30605894","13","102691"
"chr9","30528679","30528911","chr13","41754920","41755154","44","11226241"
"chr9","30547580","30547870","chr9","30650449","30650732","9","102869"
"chr9","30664454","30664759","chr9","30771209","30771479","38","106755"
"chr9","30666381","30666672","chr9","30774955","30775240","17","108574"
"chr9","30668469","30668754","chr9","30777216","30777498","8","108747"
"chr9","30720538","30720870","chr9","30829189","30829493","32","108651"
"chr9","30783070","30783366","chr9","30891184","30891475","14","108114"
"chr9","30857663","30857973","chr1","190306663","190306963","57","159449000"
"chr9","31044742","31045018","chr9","31150540","31150815","5","105798"
"chr9","31068845","31069155","chr9","31174725","31175035","6","105880"
"chr9","31087431","31087532","chr11","121179079","121179166","36","90091648"
"chr9","31092837","31093122","chr9","31198856","31199140","6","106019"
"chr9","31099575","31099801","chr9","31207243","31207461","12","107668"
"chr9","31106865","31107162","chr2","128870206","128870499","50","97763341"
"chr9","31196143","31196440","chr9","31304485","31304782","11","108342"
"chr9","31197492","31197750","chr9","31305843","31306101","4","108351"
"chr9","31199431","31199668","chr9","31307520","31307754","9","108089"
"chr9","31202087","31202372","chr9","31310180","31310461","10","108093"
"chr9","31211130","31211415","chr9","31319201","31319486","11","108071"
"chr9","31219969","31220253","chr9","31327253","31327537","7","107284"
"chr9","31222636","31222941","chr3","74896192","74896496","68","43673556"
"chr9","31226583","31226859","chr9","31333901","31334180","18","107318"
"chr9","31234525","31234839","chr9","31341846","31342161","13","107321"
"chr9","31241669","31241968","chr9","31349270","31349569","11","107601"
"chr9","31242582","31242893","chr9","31350187","31350495","10","107605"
"chr9","31258846","31259139","chr9","31366410","31366702","4","107564"
"chr9","31277044","31277348","chr9","31374924","31375227","6","97880"
"chr9","31278425","31278587","chr9","31376307","31376485","17","97882"
"chr9","31287379","31287671","chr9","31404515","31404817","15","117136"
"chr9","31288022","31288323","chr7","48358705","48358988","75","17070683"
"chr9","31291936","31292228","chr9","31396165","31396458","9","104229"
"chr9","31296808","31297114","chr9","31409084","31409391","8","112276"
"chr9","31298553","31298864","chr9","31411143","31411449","18","112590"
"chr9","31309767","31310070","chr4","152226280","152226592","52","120916513"
"chr9","31310764","31310926","chr5","73422543","73422715","43","42111779"
"chr9","31328885","31329192","chr9","31442407","31442716","7","113522"
"chr9","31331707","31331966","chr9","31444691","31444950","6","112984"
"chr9","31339820","31340109","chr2","47911084","47911382","61","16571264"
"chr9","31340187","31340394","chr9","31452096","31452302","4","111909"
"chr9","31361809","31362077","chr9","31473625","31473866","34","111816"
"chr9","31377347","31377646","chr9","31489145","31489444","7","111798"
"chr9","31389984","31390109","chr9","43471821","43471943","21","12081837"
"chr9","31395902","31396132","chr9","31508196","31508428","4","112294"
"chr9","31396436","31396512","chr4","115015478","115015551","17","83619042"
"chr9","31418968","31419216","chr9","31531610","31531858","6","112642"
"chr9","31425294","31425587","chr9","31537611","31537903","8","112317"
"chr9","31442343","31442631","chr4","119713035","119713321","51","88270692"
"chr9","31455965","31456249","chr11","121001535","121001825","53","89545570"
"chr9","31466897","31467193","chr9","31578582","31578882","18","111685"
"chr9","31488929","31489218","chr16","11864729","11865011","62","19624200"
"chr9","31528868","31529171","chr9","31642231","31642531","9","113363"
"chr9","31529853","31530151","chr9","31643201","31643514","40","113348"
"chr9","31564091","31564371","chr9","31678826","31679106","9","114735"
"chr9","31576871","31577153","chr9","31686375","31686657","8","109504"
"chr9","31596029","31596332","chr9","31710931","31711234","8","114902"
"chr9","31601823","31602109","chr9","31716726","31717016","11","114903"
"chr9","31657124","31657266","chr9","31773545","31773700","16","116421"
"chr9","31658875","31659244","chr9","31775275","31775585","66","116400"
"chr9","31676281","31676566","chr9","31788190","31788473","4","111909"
"chr9","31683017","31683332","chr9","31795377","31795692","7","112360"
"chr9","31703361","31703655","chr9","31815451","31815746","5","112090"
"chr9","31705639","31705922","chr9","31817721","31818024","31","112082"
"chr9","31713550","31713838","chr9","31825649","31825937","4","112099"
"chr9","31718638","31718805","chr9","31830662","31830825","5","112024"
"chr9","31754705","31754985","chr9","31867980","31868263","8","113275"
"chr9","31791105","31791399","chr9","31903010","31903314","14","111905"
"chr9","31845972","31846248","chr17","1142710","1142998","62","30703262"
"chr9","31895602","31895827","chr9","32007548","32007772","9","111946"
"chr9","31905848","31906111","chr9","32019053","32019316","9","113205"
"chr9","32059151","32059427","chr9","32175971","32176274","34","116820"
"chr9","32164530","32164747","chr9","32289917","32290133","8","125387"
"chr9","32242907","32243074","chr9","32368160","32368331","8","125253"
"chr9","32256354","32256645","chr9","32382404","32382696","3","126050"
"chr9","32271662","32271777","chr9","32400654","32400780","17","128992"
"chr9","32283586","32283864","chr9","32412594","32412872","9","129008"
"chr9","32284709","32285022","chr9","32413736","32414040","21","129027"
"chr9","32294453","32294763","chr9","32423429","32423739","4","128976"
"chr9","32327090","32327395","chr9","32457586","32457891","9","130496"
"chr9","32332107","32332312","chr9","32462602","32462806","8","130495"
"chr9","32337651","32337964","chr9","32468087","32468401","16","130436"
"chr9","32340193","32340426","chr9","32470632","32470908","48","130439"
"chr9","32349074","32349168","chr9","32479438","32479532","3","130364"
"chr9","32479145","32479444","chr9","32610440","32610739","6","131295"
"chr9","32505205","32505491","chr9","32636220","32636506","5","131015"
"chr9","32537495","32537801","chr9","32668102","32668409","8","130607"
"chr9","32590300","32590607","chr9","32721188","32721493","10","130888"
"chr9","32699640","32699899","chr9","32830209","32830473","15","130569"
"chr9","32787710","32788000","chr9","32919271","32919561","3","131561"
"chr9","32807833","32808125","chr9","32938917","32939210","4","131084"
"chr9","32859575","32859870","chr9","32989248","32989543","4","129673"
"chr9","32865905","32866209","chr9","32995582","32995890","12","129677"
"chr9","32893307","32893601","chr9","33022569","33022867","14","129262"
"chr9","32902744","32903020","chr9","33032018","33032308","20","129274"
"chr9","32945225","32945526","chr9","33074612","33074913","5","129387"
"chr9","32953915","32954235","chr9","33083350","33083645","37","129435"
"chr9","32988854","32988940","chr9","33121832","33121921","3","132978"
"chr9","32998732","32999018","chr9","33131695","33131983","14","132963"
"chr9","33024956","33025266","chr9","33158135","33158445","9","133179"
"chr9","33036238","33036537","chr9","33169470","33169773","12","133232"
"chr9","33042477","33042780","chr9","33175704","33176007","8","133227"
"chr9","33067321","33067604","chr9","33200606","33200893","12","133285"
"chr9","33081278","33081360","chr9","33211776","33211858","5","130498"
"chr9","33104793","33105082","chr9","33234791","33235080","7","129998"
"chr9","33118316","33118614","chr9","33248629","33248925","7","130313"
"chr9","33139807","33140004","chr14","52389538","52389734","44","19249731"
"chr9","33163220","33163384","chr10","30277756","30277924","30","2885464"
"chr9","33177498","33177718","chr9","33312461","33312688","11","134963"
"chr9","33178886","33179034","chr4","151932285","151932427","30","118753399"
"chr9","33179331","33179523","chr9","33314330","33314519","4","134999"
"chr9","33181263","33181573","chr9","33316319","33316633","13","135056"
"chr9","33185112","33185140","chr9","33320393","33320421","2","135281"
"chr9","33185327","33185355","chr9","33320393","33320421","0","135066"
"chr9","33185481","33185509","chr9","33320393","33320421","2","134912"
"chr9","33207860","33208134","chr9","33342860","33343134","6","135000"
"chr9","33285829","33286205","chr13","85071330","85071690","109","51785501"
"chr9","33290247","33290570","chr13","84267549","84267857","63","50977302"
"chr9","33295976","33296284","chr9","33431145","33431446","18","135169"
"chr9","33302846","33303145","chr9","33438010","33438308","9","135164"
"chr9","33321185","33321484","chr9","33456006","33456289","25","134821"
"chr9","33322586","33322896","chr9","33457385","33457696","10","134799"
"chr9","33328363","33328652","chr9","33463245","33463536","7","134882"
"chr9","33333137","33333439","chr2","47911084","47911382","58","14577947"
"chr9","33334207","33334495","chr9","33469327","33469615","3","135120"
"chr9","33351137","33351428","chr9","33495925","33496216","5","144788"
"chr9","33387607","33387725","chr9","33523056","33523174","2","135449"
"chr9","33405429","33405715","chr9","33540485","33540771","8","135056"
"chr9","33417012","33417276","chrX","39026987","39027248","64","5609975"
"chr9","33440626","33440741","chr14","103907480","103907600","28","70466854"
"chr9","33440743","33440814","chr11","93682641","93682708","14","60241898"
"chr9","33470841","33470940","chr9","33606164","33606263","3","135323"
"chr9","33471568","33471762","chr9","33606891","33607084","3","135323"
"chr9","33480013","33480359","chr9","33615326","33615670","17","135313"
"chr9","33489858","33490019","chr9","33625208","33625367","2","135350"
"chr9","33551948","33552237","chr9","33686919","33687209","6","134971"
"chr9","33560592","33560861","chr9","33695608","33695868","11","135016"
"chr9","33576388","33576674","chr9","33710317","33710604","5","133929"
"chr9","33577463","33577674","chr9","33711356","33711567","5","133893"
"chr9","33588847","33589135","chr9","33723069","33723314","52","134222"
"chr9","33592693","33592814","chr1","38631720","38631844","23","5039027"
"chr9","33594146","33594296","chr2","100069015","100069158","38","66474869"
"chr9","33641064","33641357","chr9","33775295","33775588","10","134231"
"chr9","33644569","33644731","chr9","33778786","33778944","7","134217"
"chr9","33648253","33648504","chr9","33782458","33782709","4","134205"
"chr9","33658409","33658494","chr9","33792304","33792389","1","133895"
"chr9","33677875","33678168","chr5","34860263","34860535","57","1182388"
"chr9","33679292","33679572","chr9","33810949","33811229","10","131657"
"chr9","33680312","33680616","chr7","152524799","152525106","72","118844487"
"chr9","33690051","33690168","chr9","33821500","33821617","5","131449"
"chr9","33703771","33704052","chr7","91794238","91794517","58","58090467"
"chr9","33714063","33714117","chr19","42708640","42708692","12","8994577"
"chr9","33714116","33714173","chr19","42708640","42708692","15","8994524"
"chr9","33714172","33714229","chr19","42708640","42708692","14","8994468"
"chr9","33714228","33714283","chr19","42708640","42708692","12","8994412"
"chr9","33714284","33714503","chr1","109657289","109657518","59","75943005"
"chr9","33743175","33743472","chr9","33875601","33875898","9","132426"
"chr9","33747504","33747796","chr9","33879937","33880199","39","132433"
"chr9","33768039","33768285","chr9","33901013","33901261","12","132974"
"chr9","33774791","33774956","chr9","33911271","33911443","17","136480"
"chr9","33782767","33783079","chr9","33919253","33919558","21","136486"
"chr9","33789447","33789561","chr4","33992962","33993073","33","203515"
"chr9","33798464","33798653","chr9","33935306","33935495","3","136842"
"chr9","33831142","33831307","chr9","33968780","33968945","4","137638"
"chr9","33866932","33867211","chr9","34004392","34004668","13","137460"
"chr9","33875432","33875530","chr9","34012610","34012699","12","137178"
"chr9","33881059","33881282","chr9","34018569","34018792","5","137510"
"chr9","33886455","33886728","chr9","34024007","34024305","29","137552"
"chr9","33887229","33887544","chr9","34024740","34025059","6","137511"
"chr9","33915263","33915565","chr9","34052727","34053025","9","137464"
"chr9","33916474","33916736","chr9","34053935","34054197","2","137461"
"chr9","33923927","33924204","chr9","34061394","34061672","7","137467"
"chr9","33930945","33931180","chr9","34068387","34068616","13","137442"
"chr9","33962514","33962829","chr9","34100041","34100356","11","137527"
"chr9","33976029","33976217","chr9","34113561","34113749","5","137532"
"chr9","33978242","33978329","chr9","34116356","34116443","0","138114"
"chr9","33991420","33991719","chr9","34129268","34129568","4","137848"
"chr9","33991914","33992212","chr9","34129763","34130081","41","137849"
"chr9","34008072","34008368","chr9","34145413","34145709","7","137341"
"chr9","34024055","34024256","chr9","34161477","34161678","3","137422"
"chr9","34024285","34024317","chr9","34161707","34161739","0","137422"
"chr9","34045613","34045730","chr9","34183127","34183244","1","137514"
"chr9","34054878","34055139","chr9","34193034","34193302","21","138156"
"chr9","34058895","34059219","chr9","34197115","34197439","6","138220"
"chr9","34062964","34063262","chr9","34201195","34201489","11","138231"
"chr9","34076044","34076280","chr13","69148532","69148768","52","35072488"
"chr9","34076541","34076582","chr11","72134815","72134858","8","38058274"
"chr9","34089032","34089174","chr9","34228031","34228171","4","138999"
"chr9","34089175","34089445","chr9","34228174","34228444","2","138999"
"chr9","34097237","34097511","chr9","34236692","34236967","10","139455"
"chr9","34115687","34115988","chr9","34255217","34255519","9","139530"
"chr9","34117291","34117613","chr9","34257011","34257332","9","139720"
"chr9","34129699","34129989","chr9","34268970","34269259","10","139271"
"chr9","34130338","34130640","chr15","97229275","97229572","65","63098937"
"chr9","34133367","34133530","chr1","184282893","184283059","30","150149526"
"chr9","34133935","34134089","chr16","73575035","73575180","49","39441100"
"chr9","34149736","34150028","chr9","34289206","34289495","13","139470"
"chr9","34151413","34151690","chr9","34290869","34291147","2","139456"
"chr9","34152650","34152929","chr9","34291915","34292191","7","139265"
"chr9","34172022","34172282","chr9","34310842","34311101","12","138820"
"chr9","34174894","34175195","chr9","34313596","34313895","6","138702"
"chr9","34188405","34188694","chrX","123281532","123281821","7","89093127"
"chr9","34203045","34203349","chr9","34340985","34341295","12","137940"
"chr9","34217330","34217647","chr9","34361273","34361583","15","143943"
"chr9","34218523","34218734","chr9","34362488","34362699","3","143965"
"chr9","34226420","34226724","chr5","78616003","78616301","49","44389583"
"chr9","34293876","34294167","chr9","34442619","34442910","5","148743"
"chr9","34309014","34309289","chr9","34457563","34457832","12","148549"
"chr9","34315377","34315653","chr9","34464553","34464829","6","149176"
"chr9","34321999","34322261","chr9","34471731","34471987","14","149732"
"chr9","34327118","34327422","chr9","34476879","34477183","7","149761"
"chr9","34334853","34335141","chrX","17134244","17134545","58","17200609"
"chr9","34349995","34350296","chr9","34500555","34500856","0","150560"
"chr9","34370842","34371149","chr9","34521778","34522084","5","150936"
"chr9","34372117","34372329","chr14","33242830","33243041","45","1129287"
"chr9","34372664","34372738","chr1","34800369","34800443","14","427705"
"chr9","34376831","34377089","chr9","34528003","34528247","21","151172"
"chr9","34386913","34387211","chr9","34538452","34538748","7","151539"
"chr9","34399520","34399752","chr9","34550903","34551143","11","151383"
"chr9","34400088","34400140","chr10","71316510","71316563","8","36916422"
"chr9","34407440","34407749","chr9","34558813","34559124","7","151373"
"chr9","34412752","34413046","chr9","34564196","34564490","5","151444"
"chr9","34413768","34413937","chr9","34565215","34565381","7","151447"
"chr9","34415053","34415241","chr9","34566484","34566684","15","151431"
"chr9","34429085","34429350","chr9","34581183","34581498","54","152098"
"chr9","34435144","34435445","chr9","34586979","34587280","6","151835"
"chr9","34449017","34449328","chr9","34601814","34602128","12","152797"
"chr9","34454393","34454735","chr9","95284692","95285023","74","60830299"
"chr9","34454877","34455012","chr9","34607694","34607829","1","152817"
"chr9","34455323","34455497","chr9","34608140","34608314","3","152817"
"chr9","34494357","34494659","chr9","34647313","34647615","3","152956"
"chr9","34508145","34508455","chr9","34661660","34661970","18","153515"
"chr9","34509494","34509664","chr9","34662996","34663172","8","153502"
"chr9","34525541","34525803","chr9","34679415","34679649","33","153874"
"chr9","34538609","34538750","chr9","34692711","34692876","26","154102"
"chr9","34541221","34541517","chr9","34695336","34695632","6","154115"
"chr9","34543839","34544141","chr9","34697956","34698264","10","154117"
"chr9","34545193","34545479","chr9","34699317","34699603","6","154124"
"chr9","34597592","34597901","chr9","34746818","34747126","7","149226"
"chr9","34600672","34600804","chr9","34756877","34756992","18","156205"
"chr9","34601175","34601442","chr9","34757379","34757646","7","156204"
"chr9","34602587","34602725","chr11","60527399","60527534","34","25924812"
"chr9","34603501","34603813","chr9","34759610","34759922","8","156109"
"chr9","34606670","34606809","chr13","68237509","68237648","25","33630839"
"chr9","34608485","34608722","chr9","34764587","34764824","3","156102"
"chr9","34610979","34611228","chr9","34767065","34767314","3","156086"
"chr9","34622326","34622442","chr6","170540763","170540878","18","135918437"
"chr9","34624822","34624939","chr16","40912591","40912712","31","6287769"
"chr9","34625145","34625327","chr4","71615984","71616162","35","36990839"
"chr9","34635144","34635434","chr9","34791173","34791469","15","156029"
"chr9","34641551","34641810","chr9","34797626","34797837","51","156075"
"chr9","34708179","34708480","chr9","34864128","34864436","15","155949"
"chr9","34722082","34722382","chr9","34879358","34879664","16","157276"
"chr9","34722847","34723158","chr9","34880130","34880427","23","157283"
"chr9","34726193","34726496","chr9","34883447","34883754","15","157254"
"chr9","34797424","34797713","chr9","34954516","34954807","10","157092"
"chr9","34808393","34808681","chr9","34965504","34965792","10","157111"
"chr9","34866054","34866370","chr9","35023543","35023862","10","157489"
"chr9","34876899","34877215","chr8","69026798","69027102","63","34149899"
"chr9","34886164","34886466","chr9","35044066","35044390","29","157902"
"chr9","34889196","34889282","chr9","35047876","35047961","20","158680"
"chr9","34908911","34909225","chrX","96719817","96720114","69","61810906"
"chr9","34925403","34925700","chr9","35091666","35091963","4","166263"
"chr9","34941771","34942060","chr9","35108106","35108396","10","166335"
"chr9","34944873","34944962","chr12","61681391","61681478","16","26736518"
"chr9","34964827","34965130","chr9","35131179","35131477","17","166352"
"chr9","34970424","34970714","chr9","35136708","35136998","5","166284"
"chr9","35001835","35001972","chr9","35166680","35166818","5","164845"
"chr9","35004492","35004803","chr9","35168635","35168961","19","164143"
"chr9","35027498","35027796","chr9","35192580","35192878","2","165082"
"chr9","35089481","35089637","chr9","35252593","35252747","6","163112"
"chr9","35109181","35109479","chr9","35271983","35272262","33","162802"
"chr9","35144183","35144476","chr9","35308229","35308512","15","164046"
"chr9","35223255","35223555","chr9","35389166","35389457","15","165911"
"chr9","35306754","35307104","chr9","35462604","35462910","47","155850"
"chr9","35322620","35322717","chr5","50976098","50976200","32","15653478"
"chr9","35322919","35323032","chr3","157051887","157051998","22","121728968"
"chr9","35365908","35366044","chr19","44433640","44433773","28","9067732"
"chr9","35366087","35366203","chr13","24884251","24884369","23","10481836"
"chr9","35465902","35466062","chr9","102282987","102283142","24","66817085"
"chr9","35646128","35646387","chr9","36691698","36691955","15","1045570"
"chr9","35713412","35713682","chr9","36818860","36819130","6","1105448"
"chr9","35789940","35790266","chr9","36893309","36893635","11","1103369"
"chr9","35816244","35816398","chr4","43080170","43080307","39","7263926"
"chr9","35828072","35828381","chr9","36931122","36931429","13","1103050"
"chr9","35828896","35829165","chr9","36933534","36933803","5","1104638"
"chr9","36873143","36873321","chr11","30557931","30558081","55","6315212"
"chr9","36889732","36890021","chr2","48799733","48800024","46","11910001"
"chr9","36895395","36895676","chr9","37157324","37157607","43","261929"
"chr9","36946101","36946335","chr4","153703809","153704040","58","116757708"
"chr9","37088217","37088456","chr9","36028953","36029192","5","1059264"
"chr9","37121187","37121478","chr9","36057368","36057660","5","1063819"
"chr9","37142123","37142290","chr9","36072754","36072922","3","1069369"
"chr9","37142596","37142750","chr9","36450458","36450612","8","692138"
"chr9","37159608","37159921","chr9","36086365","36086666","20","1073243"
"chr9","37163457","37163758","chr11","112368816","112369118","64","75205359"
"chr9","37181525","37181664","chr6","131494129","131494271","22","94312604"
"chr9","37184642","37184938","chr9","36112334","36112630","6","1072308"
"chr9","37192601","37192905","chr9","36512452","36512762","28","680149"
"chr9","37195934","37196233","chr9","36123679","36123978","8","1072255"
"chr9","37199827","37200109","chr9","36127565","36127847","6","1072262"
"chr9","37231537","37231844","chr10","50389396","50389695","55","13157859"
"chr9","37279956","37280254","chr9","36165332","36165630","4","1114624"
"chr9","37349147","37349412","chr9","36587561","36587814","36","761586"
"chr9","37379128","37379390","chr7","156774645","156774921","70","119395517"
"chr9","37390534","37390687","chr6","148154766","148154916","31","110764232"
"chr9","37447960","37448211","chr11","93604681","93604934","54","56156721"
"chr9","37458050","37458291","chr9","26520267","26520507","37","10937783"
"chr9","37465660","37465953","chr9","26528635","26528939","39","10937025"
"chr9","37738791","37739066","chr1","124849036","124849325","66","87110245"
"chr9","37756858","37757154","chr10","29490092","29490386","60","8266766"
"chr9","37785652","37785807","chr9","36255338","36255516","40","1530314"
"chr9","37787274","37787563","chr9","36256940","36257244","22","1530334"
"chr9","37795354","37795660","chr9","36265136","36265467","34","1530218"
"chr9","37795748","37796044","chr9","36265555","36265851","6","1530193"
"chr9","37807903","37808216","JH682386","8502","8815","7","37799401"
"chr9","37814060","37814361","chr9","36165332","36165630","37","1648728"
"chr9","37859898","37860186","chr7","79804737","79805036","52","41944839"
"chr9","37895221","37895499","chr9","36519999","36520276","11","1375222"
"chr9","37899087","37899381","chr9","36516116","36516409","9","1382971"
"chr9","37902420","37902736","chr9","36512452","36512762","12","1389968"
"chr9","37910332","37910628","chr9","36504401","36504701","13","1405931"
"chr9","37911458","37911719","chr17","78489974","78490221","63","40578516"
"chr9","37930191","37930489","chr16","5343969","5344266","62","32586222"
"chr9","37933785","37934093","chr9","36468828","36469144","14","1464957"
"chr9","37952329","37952475","chr9","36450458","36450612","10","1501871"
"chr9","37952768","37952932","chr9","36449995","36450166","12","1502773"
"chr9","37982662","37982959","chr9","36419502","36419790","14","1563160"
"chr9","37990188","37990312","chr9","36412323","36412455","9","1577865"
"chr9","38000182","38000483","chr9","36402466","36402767","7","1597716"
"chr9","38017299","38017587","chr9","36385459","36385747","5","1631840"
"chr9","38044037","38044280","chr9","36357319","36357553","14","1686718"
"chr9","38075657","38075926","chr9","36322808","36323077","6","1752849"
"chr9","38097429","38097556","chr9","36303229","36303360","7","1794200"
"chr9","38097868","38098041","chr9","36302754","36302895","34","1795114"
"chr9","38099816","38100124","chr9","36300582","36300892","10","1799234"
"chr9","38119550","38119838","chr9","36281031","36281325","14","1838519"
"chr9","38121423","38121704","chr9","36281031","36281325","39","1840392"
"chr9","38164845","38164960","chrX","96209212","96209331","27","58044367"
"chr9","38165332","38165599","chr7","77448762","77449023","72","39283430"
"chr9","38169047","38169220","chr6","117185302","117185469","51","79016255"
"chr9","38235015","38235145","chr15","11659199","11659328","29","26575816"
"chr9","38281362","38281523","chr10","58325263","58325414","20","20043901"
"chr9","38294079","38294324","chr13","127283657","127283932","49","88989578"
"chr9","38328432","38328563","chr3","45943923","45944037","45","7615491"
"chr9","38332914","38333214","chr9","36504401","36504701","5","1828513"
"chr9","38350190","38350485","chr9","96132475","96132771","59","57782285"
"chr9","38352242","38352539","chr3","92730802","92731100","66","54378560"
"chr9","38378282","38378581","chr16","41812244","41812543","54","3433962"
"chr9","38386678","38386962","chr2","73673617","73673899","48","35286939"
"chr9","38391637","38391939","chr9","16871543","16871855","59","21520094"
"chr9","38395878","38396160","chr9","37134395","37134677","4","1261483"
"chr9","38463125","38463386","chr1","208786943","208787191","64","170323818"
"chr9","38475272","38475573","chr9","43048518","43048822","15","4573246"
"chr9","38479092","38479372","chr9","43044734","43045013","6","4565642"
"chr9","38501911","38502208","chr13","8855122","8855418","45","29646789"
"chr9","38511645","38511815","chr4","101765375","101765550","35","63253730"
"chr9","38522588","38522872","chr9","37157324","37157607","10","1365264"
"chr9","38567247","38567465","chr1","163740830","163741033","45","125173583"
"chr9","38576853","38576987","chr19","8578300","8578428","20","29998553"
"chr9","38584646","38584708","chr9","37220814","37220876","1","1363832"
"chr9","38657503","38657809","chr9","37294620","37294926","8","1362883"
"chr9","38671564","38671669","chr5","135158660","135158762","20","96487096"
"chr9","38776837","38777104","chr9","37410296","37410555","15","1366541"
"chr9","38828173","38828381","chr9","37462634","37462840","6","1365539"
"chr9","38845664","38845965","chr9","37479327","37479639","16","1366337"
"chr9","38850517","38850817","chr9","37484326","37484621","24","1366191"
"chr9","38947225","38947461","chr14","46305492","46305721","53","7358267"
"chr9","38954596","38954855","chr9","37590773","37591030","10","1363823"
"chr9","38964450","38964743","chr9","37601118","37601427","20","1363332"
"chr9","38965387","38965571","chr9","37602070","37602289","40","1363317"
"chr9","38983512","38983827","chr9","37621651","37621966","6","1361861"
"chr9","38984758","38984940","chr1","121080623","121080792","40","82095865"
"chr9","39009348","39009645","chr9","37648278","37648570","11","1361070"
"chr9","39014980","39015107","chr9","37651992","37652118","4","1362988"
"chr9","39015405","39015630","chr9","37652415","37652616","26","1362990"
"chr9","39017170","39017301","chr10","81984349","81984482","25","42967179"
"chr9","39017596","39017607","chr3","39984846","39984857","1","967250"
"chr9","39017634","39017762","chr11","108063934","108064062","30","69046300"
"chr9","39020231","39020402","chr9","37659720","37659891","1","1360511"
"chr9","39033904","39034202","chr9","37674224","37674532","14","1359680"
"chr9","39043278","39043565","chr9","37684536","37684858","41","1358742"
"chr9","39073034","39073188","chr9","37716596","37716750","2","1356438"
"chr9","39078255","39078553","chr9","37721834","37722130","31","1356421"
"chr9","39082519","39082778","chr9","37726397","37726656","4","1356122"
"chr9","39084175","39084341","chr9","37728060","37728226","2","1356115"
"chr9","39084981","39085124","chr9","37728872","37729024","20","1356109"
"chr9","39085431","39085558","chr3","87574600","87574729","26","48489169"
"chr9","39092896","39093067","chr9","37737856","37738028","4","1355040"
"chr9","39106978","39107109","chr9","37757399","37757530","1","1349579"
"chr9","39113996","39114291","chr9","37764562","37764863","11","1349434"
"chr9","39120016","39120329","chr9","37770943","37771256","4","1349073"
"chr9","39122641","39122709","chr4","57063686","57063754","11","17941045"
"chr9","39129847","39129903","chr1","42758961","42759014","15","3629114"
"chr9","39133614","39133903","chr9","37787955","37788249","11","1345659"
"chr9","39134969","39135253","chr9","37789312","37789596","8","1345657"
"chr9","39139016","39139162","chr9","37783237","37783402","24","1355779"
"chr9","39139461","39139591","chr9","37783702","37783841","13","1355759"
"chr9","39139607","39139820","chr9","37783847","37784060","7","1355760"
"chr9","39142016","39142182","chr9","37786266","37786424","18","1355750"
"chr9","39145081","39145450","chr6","166643574","166643917","88","127498493"
"chr9","39151938","39152222","chr5","112902184","112902472","70","73750246"
"chr9","39163421","39163653","chr10","506014","506227","62","38657407"
"chr9","39164922","39165226","chr7","50851740","50852042","62","11686818"
"chr9","39168957","39169090","chr7","43958844","43958975","27","4789887"
"chr9","39169091","39169319","chr7","33440652","33440885","52","5728439"
"chr9","39169716","39169848","chr6","65110840","65110974","18","25941124"
"chr9","39170035","39170348","chr2","147389211","147389518","60","108219176"
"chr9","39171337","39171418","chr3","109986164","109986245","18","70814827"
"chr9","39171722","39172024","chr8","98253181","98253489","58","59081459"
"chr9","39172590","39172903","chr1","163551503","163551805","54","124378913"
"chr9","39215406","39215696","chr9","37829737","37830027","5","1385669"
"chr9","39224676","39224841","chr9","37839089","37839255","5","1385587"
"chr9","39230543","39230686","chr2","154398330","154398458","36","115167787"
"chr9","39238104","39238321","chrX","50264118","50264341","61","11026014"
"chr9","39245858","39246027","chr9","37866208","37866377","2","1379650"
"chr9","39246088","39246204","chr9","37866413","37866529","1","1379675"
"chr9","39246252","39246458","chr9","37866577","37866783","3","1379675"
"chr9","39246502","39246769","chr9","37866859","37867103","26","1379643"
"chr9","39249473","39249563","chr11","121179079","121179166","29","81929606"
"chr9","39269226","39269535","chr9","55764860","55765163","66","16495634"
"chr9","39285420","39285704","chr9","37907247","37907531","8","1378173"
"chr9","39321051","39321147","chr9","37943043","37943139","2","1378008"
"chr9","39365983","39366279","chr9","37987914","37988212","15","1378069"
"chr9","39455221","39455536","chr9","38081606","38081949","39","1373615"
"chr9","39475397","39475667","chr9","38101729","38102020","23","1373668"
"chr9","39787683","39787997","chr9","38416459","38416773","8","1371224"
"chr9","39836803","39837070","chr9","38466509","38466825","57","1370294"
"chr9","40256200","40256488","chr9","38888724","38888999","34","1367476"
"chr9","40341383","40341685","chr6","33100388","33100695","49","7240995"
"chr9","40534291","40534441","chr1","179541903","179542057","38","139007612"
"chr9","40534572","40534583","chr4","98393891","98393903","2","57859319"
"chr9","40565275","40565566","chr2","44882107","44882408","59","4316832"
"chr9","40575421","40575713","chr3","33771870","33772170","50","6803551"
"chr9","40649257","40649446","chr9","21818957","21819147","40","18830300"
"chr9","40666911","40667256","chr4","152226280","152226592","82","111559369"
"chr9","40692193","40692336","chr9","35294870","35295033","36","5397323"
"chr9","40693590","40693736","chr9","35295333","35295481","14","5398257"
"chr9","40699139","40699314","chr3","36880238","36880409","32","3818901"
"chr9","40699624","40699676","chr3","39541632","39541683","10","1157992"
"chr9","40706613","40706902","chr9","35308229","35308512","49","5398384"
"chr9","40727184","40727453","chr9","37134395","37134677","51","3592789"
"chr9","40731444","40731747","chr4","36625432","36625738","62","4106012"
"chr9","40736117","40736412","chr13","127371729","127372026","48","86635612"
"chr9","40754413","40754714","chr16","41812244","41812543","57","1057831"
"chr9","40779287","40779337","chr10","79555938","79555983","13","38776651"
"chr9","40779367","40779616","chr11","121382141","121382385","48","80602774"
"chr9","40786699","40786997","chrX","122796771","122797063","66","82010072"
"chr9","40790232","40790552","chr6","71063971","71064276","75","30273739"
"chr9","40791186","40791475","chr1","134690685","134690975","61","93899499"
"chr9","40791786","40792072","chr1","54800363","54800645","77","14008577"
"chr9","40795022","40795334","chr9","17454563","17454858","78","23340459"
"chr9","40795416","40795689","chr1","88473270","88473553","60","47677854"
"chr9","40915694","40915999","chr9","39232935","39233235","16","1682759"
"chr9","40937057","40937184","chr9","39250120","39250247","2","1686937"
"chr9","41058510","41058800","chr11","59681370","59681647","57","18622860"
"chr9","41193988","41194100","chr9","39399579","39399691","2","1794409"
"chr9","41232484","41232673","chr9","39437715","39437904","5","1794769"
"chr9","41269712","41269995","chr9","39474234","39474516","2","1795478"
"chr9","41321768","41322108","chr10","29868023","29868350","78","11453745"
"chr9","41325742","41326013","chr9","39527421","39527692","2","1798321"
"chr9","41340900","41341166","chr9","39542146","39542436","35","1798754"
"chr9","41352969","41353233","chr9","39554544","39554807","9","1798425"
"chr9","41390895","41391219","chr9","39592158","39592500","25","1798737"
"chr9","41401395","41401597","chr1","127540223","127540414","57","86138828"
"chr9","41412707","41412879","chr13","69342923","69343088","37","27930216"
"chr9","41412906","41413021","chr13","118552882","118552999","18","77139976"
"chr9","41417040","41417335","chr9","39609015","39609326","28","1808025"
"chr9","41430226","41430483","chr9","39630811","39631069","7","1799415"
"chr9","41455317","41455654","chr9","39655243","39655570","23","1800074"
"chr9","41475444","41475726","chr9","39680819","39681113","17","1794625"
"chr9","41483287","41483475","chr9","39688644","39688833","5","1794643"
"chr9","41505705","41505928","chr9","39755151","39755374","14","1750554"
"chr9","41510306","41510571","chr4","165235287","165235547","65","123724981"
"chr9","41522885","41523165","chr9","39733687","39733972","13","1789198"
"chr9","41543434","41543657","chr9","39755151","39755374","14","1788283"
"chr9","41585498","41585584","chr9","39794823","39794909","1","1790675"
"chr9","41589064","41589251","chr9","39688644","39688833","5","1900420"
"chr9","41593091","41593164","chr16","60193976","60194040","14","18600885"
"chr9","41604510","41604764","chr9","39630811","39631069","14","1973699"
"chr9","41627421","41627731","chr9","39609015","39609326","19","2018406"
"chr9","41631698","41631987","chr8","87191709","87191998","49","45560011"
"chr9","41716458","41716741","chr9","39809096","39809379","5","1907362"
"chr9","41752121","41752180","chr1","86128485","86128542","11","44376364"
"chr9","41771560","41771845","chr9","39864504","39864818","36","1907056"
"chr9","41783032","41783330","chr9","39870299","39870597","9","1912733"
"chr9","41798459","41798770","chr9","39892545","39892854","8","1905914"
"chr9","41802109","41802403","chr9","39895960","39896254","6","1906149"
"chr9","41839831","41840109","chr9","39933371","39933647","10","1906460"
"chr9","41841772","41842075","chr9","39935312","39935614","4","1906460"
"chr9","41843188","41843416","chr4","154580360","154580587","49","112737172"
"chr9","41843698","41843927","chr10","80760345","80760554","67","38916647"
"chr9","41843948","41844228","chr11","6443103","6443394","54","35400845"
"chr9","41846229","41846518","chr11","30046486","30046779","58","11799743"
"chr9","41857424","41857713","chr9","39958436","39958725","9","1898988"
"chr9","41863161","41863461","chr9","39964148","39964448","2","1899013"
"chr9","41882143","41882345","chr19","2893758","2893958","46","38988385"
"chr9","41882346","41882395","chr6","148291297","148291342","11","106408951"
"chr9","41899814","41900100","chr9","40001369","40001642","21","1898445"
"chr9","41904673","41904850","chr8","129843517","129843692","44","87938844"
"chr9","41904876","41904988","chr11","119131765","119131872","27","77226889"
"chr9","41923704","41923995","chr9","40025206","40025497","4","1898498"
"chr9","41979303","41979616","chr9","40082570","40082877","14","1896733"
"chr9","41984879","41985143","chrX","60984054","60984323","58","18999175"
"chr9","41990102","41990233","chr9","40093373","40093504","1","1896729"
"chr9","42001541","42001709","chr9","40117500","40117668","1","1884041"
"chr9","42013854","42014022","chr9","40117500","40117668","1","1896354"
"chr9","42020277","42020445","chr9","40123922","40124083","9","1896355"
"chr9","42022919","42023213","chr9","40126555","40126853","7","1896364"
"chr9","42025794","42026094","chr9","116391762","116392058","66","74365968"
"chr9","42061567","42061852","chr9","40176093","40176378","6","1885474"
"chr9","42112106","42112367","chr9","40225346","40225645","45","1886760"
"chr9","42130280","42130572","chr9","40246259","40246551","5","1884021"
"chr9","42143900","42144220","chr9","40259834","40260154","13","1884066"
"chr9","42164402","42164698","chr9","40282423","40282720","9","1881979"
"chr9","42254017","42254300","chr9","40370572","40370863","13","1883445"
"chr9","42265907","42266196","chr9","40382472","40382750","14","1883435"
"chr9","42281096","42281398","chr9","40397086","40397387","7","1884010"
"chr9","42310062","42310274","chr9","40426318","40426530","5","1883744"
"chr9","42325943","42326236","chr9","40442008","40442302","10","1883935"
"chr9","42343800","42344097","chr9","40459672","40459968","8","1884128"
"chr9","42360897","42361198","chr9","40476647","40476947","7","1884250"
"chr9","42378741","42379048","chr9","40494724","40495016","18","1884017"
"chr9","42490678","42490950","chr9","56456050","56456320","61","13965372"
"chr9","42544415","42544653","chr9","40661348","40661584","9","1883067"
"chr9","42584946","42585141","chr9","110702178","110702325","78","68117232"
"chr9","42585292","42585404","chr9","40702021","40702130","7","1883271"
"chr9","42650398","42650694","chr9","40766517","40766811","8","1883881"
"chr9","42675559","42675811","chr2","75550330","75550579","51","32874771"
"chr9","42845729","42845767","chr8","76159201","76159238","7","33313472"
"chr9","42845832","42845990","chr9","40972566","40972748","27","1873266"
"chr9","42921446","42921732","chr9","41048201","41048487","2","1873245"
"chr9","42942409","42942683","chr9","41069413","41069705","26","1872996"
"chr9","43435631","43435913","chr9","41566887","41567183","18","1868744"
"chr9","43451423","43451723","chr9","41582644","41582945","5","1868779"
"chr9","43495289","43495585","chr20","35300841","35301130","69","8194448"
"chr9","43501777","43502077","chr9","41633578","41633877","7","1868199"
"chr9","43693241","43693489","chr4","35102585","35102835","54","8590656"
"chr9","44085100","44085403","chr9","42214274","42214576","16","1870826"
"chr9","44104925","44105027","chr1","124637552","124637650","27","80532627"
"chr9","44213780","44213855","chr19","26935199","26935268","16","17278581"
"chr9","44279472","44279782","chr9","42882286","42882598","10","1397186"
"chr9","44407956","44408242","chr9","42742614","42742905","11","1665342"
"chr9","44447192","44447494","chr9","42696408","42696711","10","1750784"
"chr9","44450071","44450331","chr9","42693586","42693853","11","1756485"
"chr9","44498378","44498667","chr9","42642930","42643224","12","1855448"
"chr9","44543910","44544205","chr9","42594494","42594797","16","1949416"
"chr9","44545601","44545889","chr9","42593119","42593416","27","1952482"
"chr9","44557590","44557878","chr9","42581241","42581525","7","1976349"
"chr9","44560484","44560776","chr9","42578342","42578634","1","1982142"
"chr9","44577791","44578090","chr9","42561520","42561820","3","2016271"
"chr9","44580081","44580200","chr9","42559409","42559528","5","2020672"
"chr9","44580243","44580425","chr9","42559184","42559366","5","2021059"
"chr9","44587915","44588198","chr9","42551344","42551626","7","2036571"
"chr9","44591275","44591586","chr9","42547955","42548264","8","2043320"
"chr9","44596016","44596291","chr9","42544574","42544850","3","2051442"
"chr9","44612980","44613301","chr9","42527354","42527675","15","2085626"
"chr9","44615251","44615539","chr13","42109828","42110126","62","2505423"
"chr9","44624434","44624690","chr9","42516499","42516755","4","2107935"
"chr9","44629643","44629934","chr9","42511411","42511702","4","2118232"
"chr9","44632609","44632905","chr9","42508769","42509065","5","2123840"
"chr9","44637000","44637191","chr9","42503348","42503540","5","2133652"
"chr9","44640990","44641242","chr9","42503974","42504226","4","2137016"
"chr9","44649011","44649308","chr9","42493265","42493562","11","2155746"
"chr9","44666439","44666608","chr12","35011112","35011282","35","9655327"
"chr9","44666898","44667027","chr5","58117816","58117948","26","13450918"
"chr9","44668578","44668857","chr9","42473059","42473338","3","2195519"
"chr9","44673084","44673353","chr9","42468556","42468825","5","2204528"
"chr9","44676191","44676466","chr9","42465460","42465743","23","2210731"
"chr9","44692962","44693249","chr9","42448052","42448359","31","2244910"
"chr9","44754844","44755147","chr9","39609015","39609326","36","5145829"
"chr9","44783666","44783756","chr8","15340325","15340413","21","29443341"
"chr9","44784194","44784451","chr19","42170220","42170486","54","2613974"
"chr9","44784686","44784984","chrX","71143099","71143397","62","26358413"
"chr9","44818055","44818361","chr9","39609015","39609326","41","5209040"
"chr9","44840171","44840429","chr9","39630811","39631069","19","5209360"
"chr9","44851417","44851544","chr15","21486506","21486626","32","23364911"
"chr9","44880067","44880361","chr9","43064321","43064607","18","1815746"
"chr9","44893737","44893859","chr9","43077975","43078097","1","1815762"
"chr9","44917892","44918190","chr9","43104760","43105057","7","1813132"
"chr9","44920996","44921295","chr9","43107860","43108159","7","1813136"
"chr9","44957861","44958156","chr9","43144312","43144611","10","1813549"
"chr9","44958448","44958802","chr12","59538526","59538862","89","14580078"
"chr9","44961683","44961875","chr9","43148170","43148362","4","1813513"
"chr9","44976585","44976866","chr9","43163099","43163380","5","1813486"
"chr9","44980437","44980735","chr4","104492669","104492965","53","59512232"
"chr9","45013688","45013904","chr9","43200258","43200469","10","1813430"
"chr9","45031102","45031245","chr13","42970669","42970807","29","2060433"
"chr9","45040136","45040432","chr9","43226708","43227008","18","1813428"
"chr9","45044167","45044508","chr9","43230624","43230927","43","1813543"
"chr9","45046440","45046724","chr9","43232692","43232990","37","1813748"
"chr9","45052491","45052569","chr9","43238850","43238929","1","1813641"
"chr9","45057470","45057749","chr9","43243868","43244149","10","1813602"
"chr9","45060493","45060780","chr9","43247173","43247447","18","1813320"
"chr9","45066262","45066560","chr9","43252716","43253015","4","1813546"
"chr9","45067872","45068157","chr9","43254675","43254963","14","1813197"
"chr9","45088395","45088693","chr9","43276127","43276425","5","1812268"
"chr9","45095046","45095201","chr7","109373466","109373612","37","64278420"
"chr9","45096590","45096715","chr9","43284332","43284457","1","1812258"
"chr9","45096716","45096998","chr9","43284458","43284740","3","1812258"
"chr9","45096999","45097131","chr9","43284741","43284873","6","1812258"
"chr9","45097700","45097851","chr2","172227852","172227991","48","127130152"
"chr9","45099387","45099667","chr9","43287129","43287409","2","1812258"
"chr9","45100953","45101071","chr6","131471826","131471944","24","86370873"
"chr9","45116005","45116310","chr9","43308252","43308545","19","1807753"
"chr9","45123252","45123428","chr9","43315780","43315943","23","1807472"
"chr9","45142337","45142626","chr9","43334532","43334831","21","1807805"
"chr9","45179092","45179398","chr9","43371733","43372033","14","1807359"
"chr9","45220796","45221078","chr4","36533353","36533634","58","8687443"
"chr9","45229870","45230016","chr9","43423562","43423708","4","1806308"
"chr9","45238750","45238918","chrX","43108262","43108438","36","2130488"
"chr9","45238962","45239081","chr1","48746228","48746346","18","3507266"
"chr9","45249386","45249681","chr9","43442596","43442898","13","1806790"
"chr9","45272469","45272730","chr9","43467879","43468127","22","1804590"
"chr9","45280297","45280577","chr9","43475160","43475455","20","1805137"
"chr9","45289454","45289754","chr7","133186044","133186347","68","87896590"
"chr9","45303126","45303411","chr9","43489868","43490153","3","1813258"
"chr9","45306447","45306796","chr9","43493182","43493544","25","1813265"
"chr9","45308792","45309084","chr9","43494376","43494651","23","1814416"
"chr9","45310476","45310799","chr9","43496377","43496698","4","1814099"
"chr9","45326558","45326845","chr9","43515400","43515690","5","1811158"
"chr9","45327585","45327881","chr9","43516427","43516681","45","1811158"
"chr9","45330450","45330760","chr9","43520075","43520375","16","1810375"
"chr9","45350947","45351124","chr6","33223434","33223602","59","12127513"
"chr9","45355603","45355893","chr9","43545311","43545602","9","1810292"
"chr9","45355897","45355962","chr17","82298131","82298199","14","36942234"
"chr9","45362176","45362434","chr9","43551826","43552083","5","1810350"
"chr9","45371239","45371537","chr9","43560883","43561186","9","1810356"
"chr9","45374039","45374339","chr9","43563708","43564008","4","1810331"
"chr9","45380021","45380320","chr9","43569683","43569982","11","1810338"
"chr9","45390219","45390516","chr9","43580732","43581029","7","1809487"
"chr9","45391750","45392043","chr9","43582244","43582538","7","1809506"
"chr9","45407817","45408126","chr9","43598588","43598897","2","1809229"
"chr9","45408324","45408587","chr9","43599099","43599351","14","1809225"
"chr9","45412708","45413009","chr9","43603061","43603362","8","1809647"
"chr9","45414566","45414695","chr9","43604934","43605064","4","1809632"
"chr9","45424550","45424841","chr9","43615000","43615291","2","1809550"
"chr9","45428285","45428424","chr9","43616659","43616798","0","1811626"
"chr9","45428486","45428606","chr9","43616944","43617066","3","1811542"
"chr9","45429497","45429789","chr9","43617954","43618245","4","1811543"
"chr9","45433233","45433386","chr2","74700022","74700174","27","29266789"
"chr9","45434683","45434994","chr9","43621638","43621945","13","1813045"
"chr9","45436283","45436584","chr9","43622496","43622797","4","1813787"
"chr9","45436647","45436938","chr9","43622864","43623137","22","1813783"
"chr9","45439029","45439317","chr9","43625307","43625597","10","1813722"
"chr9","45449953","45450282","chr9","43639253","43639566","20","1810700"
"chr9","45460764","45461049","chr9","43650132","43650421","8","1810632"
"chr9","45485911","45486213","chr9","43675288","43675590","8","1810623"
"chr9","45603428","45603710","chr15","40728892","40729179","58","4874536"
"chr9","45734033","45734343","chr9","43929634","43929936","15","1804399"
"chr9","45811546","45811839","chr9","44007021","44007313","8","1804525"
"chr9","45928796","45929093","chr9","44123457","44123754","4","1805339"
"chr9","46090156","46090445","chr9","44282386","44282676","12","1807770"
"chr9","46120514","46120819","chr9","44312327","44312627","7","1808187"
"chr9","46122596","46122887","chr9","44314592","44314873","15","1808004"
"chr9","46168209","46168514","chr9","44363279","44363587","12","1804930"
"chr9","46367266","46367557","chr9","44570856","44571161","21","1796410"
"chr9","46367596","46367615","chr12","44401369","44401386","2","1966227"
"chr9","46400323","46400428","chr7","38278340","38278444","23","8121983"
"chr9","46509322","46509607","chr9","44694456","44694739","8","1814866"
"chr9","46618610","46618901","chr9","44807861","44808152","6","1810749"
"chr9","46669930","46670212","chr9","44858846","44859128","5","1811084"
"chr9","46683419","46683579","chr9","44872333","44872492","4","1811086"
"chr9","46739867","46739946","chr1","30461803","30461882","17","16278064"
"chr9","46784727","46785031","chr9","44973242","44973545","15","1811485"
"chr9","46884644","46884951","chr9","45080285","45080593","11","1804359"
"chr9","47000821","47001074","chr9","45203511","45203767","8","1797310"
"chr9","47154466","47154779","chr9","45360104","45360396","31","1794362"
"chr9","47187226","47187518","chr9","45393353","45393644","6","1793873"
"chr9","47280044","47280171","chr9","45481901","45482033","9","1798143"
"chr9","47280462","47280632","chr16","15899759","15899928","33","31380703"
"chr9","47291505","47291627","chr9","45494596","45494730","15","1796909"
"chr9","47350921","47351188","chr9","45555476","45555743","4","1795445"
"chr9","47355163","47355451","chr9","45559739","45560026","6","1795424"
"chr9","47378228","47378369","chr2","97453761","97453897","40","50075533"
"chr9","47429383","47429522","chr9","45634367","45634507","7","1795016"
"chr9","47445212","47445366","chr10","59697209","59697344","34","12251997"
"chr9","47470017","47470282","chr9","45674223","45674483","12","1795794"
"chr9","47483368","47483663","chr9","45687290","45687584","6","1796078"
"chr9","47500278","47500586","chr9","45704750","45705069","14","1795528"
"chr9","47508852","47509137","chr9","45713353","45713635","8","1795499"
"chr9","47516375","47516656","chr9","45720558","45720845","15","1795817"
"chr9","47620460","47620731","chr9","45827329","45827600","14","1793131"
"chr9","47641198","47641496","chr9","45848196","45848497","12","1793002"
"chr9","47647965","47648246","chr9","45854969","45855277","39","1792996"
"chr9","47723131","47723273","chr9","20872338","20872472","41","26850793"
"chr9","47723522","47723697","chr9","45934602","45934774","14","1788920"
"chr9","47748799","47749088","chr9","45960319","45960619","19","1788480"
"chr9","47760511","47760790","chr9","45972258","45972539","6","1788253"
"chr9","47818624","47818945","chr9","46033686","46033971","48","1784938"
"chr9","47937979","47938283","chr9","46152328","46152632","10","1785651"
"chr9","48063001","48063278","chr9","46282326","46282603","10","1780675"
"chr9","48115662","48115835","chr9","46331658","46331831","4","1784004"
"chr9","48161222","48161537","chr9","46375630","46375940","18","1785592"
"chr9","48265037","48265156","chr5","353024","353149","27","47912013"
"chr9","48347394","48347663","chr9","46568052","46568320","9","1779342"
"chr9","48349256","48349552","chr7","63259439","63259745","67","14910183"
"chr9","48449275","48449557","chr9","46665803","46666087","13","1783472"
"chr9","48628586","48628882","chr9","46842649","46842963","24","1785937"
"chr9","48634071","48634364","chr9","46842649","46842963","30","1791422"
"chr9","48662628","48662907","chr9","46874926","46875206","7","1787702"
"chr9","48670446","48670515","chrX","41810303","41810372","11","6860143"
"chr9","48684415","48684698","chr9","46896490","46896772","12","1787925"
"chr9","48689479","48689766","chr9","46901544","46901832","4","1787935"
"chr9","48727865","48728154","chr9","46950178","46950478","16","1777687"
"chr9","48818857","48818968","chr9","47040367","47040478","3","1778490"
"chr9","48853200","48853495","chr9","47073939","47074232","10","1779261"
"chr9","48958622","48958935","chr9","47178015","47178318","22","1780607"
"chr9","48978248","48978539","chr9","47197793","47198088","17","1780455"
"chr9","49009286","49009580","chr1","203668759","203669050","62","154659473"
"chr9","49032170","49032498","chr9","47256621","47256954","10","1775549"
"chr9","49071616","49071922","chr9","47296741","47297049","13","1774875"
"chr9","49156403","49156696","chr9","47381014","47381305","7","1775389"
"chr9","49406418","49406709","chr9","47637342","47637635","4","1769076"
"chr9","49505434","49505659","chr10","17251638","17251864","51","32253796"
"chr9","49532300","49532593","chr16","69982430","69982726","61","20450130"
"chr9","49693214","49693500","chr9","47925431","47925737","27","1767783"
"chr9","49693873","49694044","chr9","47926102","47926279","7","1767771"
"chr9","49973528","49973841","chr9","48203768","48204074","29","1769760"
"chr9","50034616","50034918","chr9","48261556","48261859","11","1773060"
"chr9","50235156","50235424","chr9","48462774","48463034","14","1772382"
"chr9","50386862","50387109","chr9","48626247","48626492","13","1760615"
"chr9","50689411","50689546","chr1","87975285","87975420","36","37285874"
"chr9","50710524","50710803","chr9","48962769","48963056","26","1747755"
"chr9","50713909","50714005","chr2","86715591","86715692","29","36001682"
"chr9","50816172","50816468","chr9","49069079","49069376","12","1747093"
"chr9","50887816","50888112","chr9","49141883","49142184","10","1745933"
"chr9","50888830","50888956","chr9","49142868","49142994","5","1745962"
"chr9","50964751","50965038","chr9","49218787","49219088","28","1745964"
"chr9","51086314","51086605","chr9","49347339","49347630","8","1738975"
"chr9","51153632","51153965","chr9","49417742","49418067","19","1735890"
"chr9","51176336","51176623","chr9","49441373","49441666","13","1734963"
"chr9","51189056","51189349","chr9","49452151","49452443","14","1736905"
"chr9","51238738","51239015","chrX","45062646","45062924","59","6176092"
"chr9","51262153","51262420","chr4","132943203","132943474","53","81681050"
"chr9","51266248","51266536","chr9","49527898","49528186","1","1738350"
"chr9","51287247","51287508","chr9","49549142","49549403","10","1738105"
"chr9","51295067","51295365","chr9","49559451","49559749","7","1735616"
"chr9","51324134","51324332","chr9","49588495","49588704","15","1735639"
"chr9","51335264","51335368","chr9","71717231","71717332","19","20381967"
"chr9","51335644","51335840","chr9","49599879","49600073","5","1735765"
"chr9","51352688","51352899","chr9","49616446","49616657","4","1736242"
"chr9","51358849","51359142","chr9","49622599","49622875","19","1736250"
"chr9","51360052","51360265","chr4","35140053","35140267","47","16219999"
"chr9","51373510","51373714","chr7","76975807","76976022","46","25602297"
"chr9","51428235","51428501","chr9","49692075","49692341","7","1736160"
"chr9","51431881","51431998","chr7","132107772","132107886","20","80675891"
"chr9","51456713","51456850","chr9","49721669","49721795","13","1735044"
"chr9","51475119","51475466","chr9","49739322","49739669","8","1735797"
"chr9","51526265","51526428","chr20","17626783","17626946","37","33899482"
"chr9","51576534","51576830","chr9","50245531","50245827","16","1331003"
"chr9","51587187","51587302","chr1","30204145","30204262","21","21383042"
"chr9","51595091","51595401","chr9","49875302","49875612","10","1719789"
"chr9","51642598","51642910","chr9","49924880","49925192","9","1717718"
"chr9","51660490","51660760","chr9","49943559","49943829","3","1716931"
"chr9","51664932","51665221","chr9","49947986","49948293","21","1716946"
"chr9","51667617","51667916","chr9","49950721","49951022","8","1716896"
"chr9","51672175","51672470","chr9","49955294","49955591","13","1716881"
"chr9","51674955","51675205","chr11","120681257","120681492","72","69006302"
"chr9","51688319","51688587","chr9","49972544","49972814","6","1715775"
"chr9","51699630","51699783","chr9","49985840","49985993","1","1713790"
"chr9","51700080","51700213","chr9","49986292","49986424","4","1713788"
"chr9","51701775","51702057","chr9","49987983","49988266","8","1713792"
"chr9","51720993","51721301","chr10","27651885","27652188","66","24069108"
"chr9","51721405","51721582","chr9","50008861","50009034","7","1712544"
"chr9","51721913","51722033","chr9","50009338","50009473","17","1712575"
"chr9","51737196","51737241","chr11","1562814","1562859","11","50174382"
"chr9","51741999","51742277","chr9","50033406","50033699","19","1708593"
"chr9","51765138","51765405","chr9","50054886","50055193","52","1710252"
"chr9","51770598","51770884","chr9","50067862","50068148","6","1702736"
"chr9","51774577","51774710","chr9","50058861","50058994","2","1715716"
"chr9","51775032","51775258","chr20","57037584","57037793","51","5262552"
"chr9","51775906","51775968","chr1","6641003","6641065","6","45134903"
"chr9","51786632","51786759","chrX","95796607","95796734","24","44009975"
"chr9","51831286","51831588","chr9","50125028","50125329","13","1706258"
"chr9","51953919","51954231","chr9","50262542","50262862","20","1691377"
"chr9","51961693","51961872","chr2","85018239","85018415","38","33056546"
"chr9","51962108","51962219","chr9","50271552","50271660","3","1690556"
"chr9","51967549","51967839","chr4","7327839","7328133","56","44639710"
"chr9","51973235","51973513","chr9","50282962","50283240","10","1690273"
"chr9","51987499","51987712","chr1","93016186","93016399","36","41028687"
"chr9","51988369","51988680","chr9","50298605","50298918","9","1689764"
"chr9","51989197","51989506","chrX","9658035","9658344","67","42331162"
"chr9","51993152","51993278","chr9","50303419","50303545","0","1689733"
"chr9","51997181","51997471","chr9","50307466","50307756","6","1689715"
"chr9","52008611","52008898","chr9","59516905","59517184","58","7508294"
"chr9","52011988","52012266","chr9","50321984","50322262","6","1690004"
"chr9","52022373","52022692","chr9","50332796","50333113","5","1689577"
"chr9","52070276","52070523","chr7","124296473","124296707","62","72226197"
"chr9","52084705","52084891","chr9","50395839","50396025","4","1688866"
"chr9","52084932","52085050","chr9","50396060","50396179","3","1688872"
"chr9","52089754","52089908","chr9","50401251","50401405","1","1688503"
"chr9","52093201","52093520","chr9","50404675","50404992","15","1688526"
"chr9","52100847","52101001","chr9","50401251","50401405","1","1699596"
"chr9","52161061","52161341","chr9","50467606","50467887","14","1693455"
"chr9","52183435","52183730","chr9","50490122","50490426","17","1693313"
"chr9","52243523","52243817","chr9","50550334","50550651","28","1693189"
"chr9","52309507","52309817","chr9","50615888","50616198","6","1693619"
"chr9","52316279","52316563","chr9","50622614","50622897","6","1693665"
"chr9","52320613","52320889","chr9","50626959","50627230","9","1693654"
"chr9","52321348","52321570","chr12","59283692","59283911","49","6962344"
"chr9","52366287","52366605","chr9","50672546","50672863","7","1693741"
"chr9","52382314","52382570","chr9","50689236","50689514","32","1693078"
"chr9","52396241","52396549","chr9","50703164","50703472","7","1693077"
"chr9","52426373","52426677","chr9","50732660","50732964","8","1693713"
"chr9","52460675","52460965","chr1","93015842","93016132","58","40555167"
"chr9","52472860","52473147","chr9","50779900","50780188","8","1692960"
"chr9","52745074","52745376","chr9","51056068","51056370","6","1689006"
"chr9","53106210","53106346","chr9","51415104","51415240","2","1691106"
"chr9","53106390","53106516","chr9","51415264","51415390","1","1691126"
"chr9","53107447","53107766","chr9","51416320","51416632","10","1691127"
"chr9","53182120","53182392","chr9","51491182","51491455","13","1690938"
"chr9","53314751","53315043","chr9","51626616","51626900","22","1688135"
"chr9","53327915","53328222","chr9","51639330","51639610","37","1688585"
"chr9","53345963","53346075","chr9","51657121","51657233","1","1688842"
"chr9","53377271","53377568","chr9","51688265","51688552","19","1689006"
"chr9","53402633","53402907","chr9","51714309","51714583","7","1688324"
"chr9","53418982","53419240","chr9","51732192","51732450","5","1686790"
"chr9","53421834","53422138","chr9","51735142","51735438","14","1686692"
"chr9","53422574","53422878","chr9","51735874","51736188","17","1686700"
"chr9","53426987","53427288","chr9","51741333","51741634","8","1685654"
"chr9","53428841","53429143","chr10","13389158","13389451","58","40039683"
"chr9","53438152","53438376","chr9","51753175","51753398","6","1684977"
"chr9","53452178","53452472","chr9","51767444","51767739","9","1684734"
"chr9","53461518","53461824","chr9","51776854","51777166","9","1684664"
"chr9","53465456","53465696","chr9","51781097","51781336","7","1684359"
"chr9","53465775","53465980","chr9","51781414","51781619","6","1684361"
"chr9","53470611","53470914","chr6","71117228","71117522","62","17646617"
"chr9","53475436","53475586","chr9","51791397","51791547","6","1684039"
"chr9","53475888","53476055","chr9","51791855","51792021","9","1684033"
"chr9","53477628","53477939","chr9","51793595","51793906","8","1684033"
"chr9","53480990","53481268","chr9","51796561","51796838","5","1684429"
"chr9","53481474","53481772","chr9","51797045","51797345","10","1684429"
"chr9","53485435","53485726","chr15","40137625","40137920","58","13347810"
"chr9","53516715","53517011","chr9","51834725","51835018","7","1681990"
"chr9","53522037","53522192","chr8","93180055","93180211","31","39658018"
"chr9","53532353","53532635","chr9","51850348","51850629","13","1682005"
"chr9","53568062","53568378","chr9","51886125","51886425","32","1681937"
"chr9","53579534","53579823","chr9","51897572","51897858","10","1681962"
"chr9","53580042","53580327","chr9","51898077","51898362","3","1681965"
"chr9","53582194","53582501","chr9","51900223","51900530","6","1681971"
"chr9","53583543","53583839","chr9","51901547","51901881","45","1681996"
"chr9","53590823","53591069","chr9","51908567","51908766","50","1682256"
"chr9","53615238","53615443","chr9","30001122","30001326","55","23614116"
"chr9","53634905","53635221","chr9","51952122","51952412","32","1682783"
"chr9","53709716","53709907","chr9","52027191","52027380","12","1682525"
"chr9","53721468","53721550","chr20","9884110","9884193","23","43837358"
"chr9","53737582","53737873","chr9","52054040","52054331","14","1683542"
"chr9","53807913","53808205","chr9","52125830","52126124","7","1682083"
"chr9","53817186","53817415","chr9","52135101","52135330","4","1682085"
"chr9","53831231","53831524","chr9","52149071","52149366","14","1682160"
"chr9","53865788","53866074","chr14","733079","733357","70","53132709"
"chr9","53927464","53927590","chr9","52245503","52245625","8","1681961"
"chr9","53927630","53927793","chr9","52245665","52245838","15","1681965"
"chr9","54102231","54102500","chr2","44408892","44409163","60","9693339"
"chr9","54152988","54153298","chr9","52472425","52472728","17","1680563"
"chr9","54192515","54192818","chr9","52511823","52512121","14","1680692"
"chr9","54201692","54201902","chr9","52521338","52521516","34","1680354"
"chr9","54268600","54268905","chr9","52589041","52589348","18","1679559"
"chr9","54283217","54283517","chr9","52603667","52603967","20","1679550"
"chr9","54298542","54298748","chr9","52619325","52619533","10","1679217"
"chr9","54347825","54348101","chr9","52668805","52669079","10","1679020"
"chr9","54388403","54388572","chr11","109661307","109661458","45","55272904"
"chr9","54458435","54458520","chr20","70339218","70339301","21","15880783"
"chr9","54473583","54473879","chr9","52794148","52794445","10","1679435"
"chr9","54485383","54485684","chr9","52805952","52806253","6","1679431"
"chr9","54510187","54510495","chr9","52829002","52829306","10","1681185"
"chr9","54576403","54576672","chr1","26840548","26840823","63","27735855"
"chr9","54655778","54656075","chr9","52975892","52976185","12","1679886"
"chr9","54813036","54813331","chr9","53140092","53140387","12","1672944"
"chr9","54879855","54880155","chr9","53216173","53216473","5","1663682"
"chr9","54929997","54930277","chr9","53270270","53270578","36","1659727"
"chr9","54935472","54935797","chr9","53275830","53276124","40","1659642"
"chr9","54954478","54954764","chr9","53294510","53294796","11","1659968"
"chr9","54970852","54971152","chr9","53312738","53313038","2","1658114"
"chr9","55006188","55006476","chr9","53346857","53347145","5","1659331"
"chr9","55123098","55123377","chr9","53466446","53466729","12","1656652"
"chr9","55169721","55170021","chr9","53513120","53513416","10","1656601"
"chr9","55189936","55190224","chr9","53533349","53533626","17","1656587"
"chr9","55262795","55263080","chr9","53606987","53607290","29","1655808"
"chr9","55299015","55299151","chr9","53643325","53643461","3","1655690"
"chr9","55299181","55299295","chr9","53643491","53643605","3","1655690"
"chr9","55305664","55305940","chr9","53649925","53650201","6","1655739"
"chr9","55475681","55475999","chr9","53819573","53819887","14","1656108"
"chr9","55584268","55584552","chr3","125030767","125031037","62","69446499"
"chr9","55624609","55624909","chr9","53969848","53970147","9","1654761"
"chr9","55743010","55743249","chr9","54089774","54090014","3","1653236"
"chr9","55778676","55778968","chr9","54125424","54125716","4","1653252"
"chr9","55794912","55795220","chr9","54141751","54142058","11","1653161"
"chr9","55798067","55798363","chr9","54144905","54145203","3","1653162"
"chr9","55850102","55850364","chr9","54198303","54198564","10","1651799"
"chr9","55866675","55866967","chr9","54214839","54215131","6","1651836"
"chr9","55873857","55874129","chr9","54222095","54222367","6","1651762"
"chr9","55894430","55894706","chr9","54243289","54243559","10","1651141"
"chr9","55930100","55930380","chr9","54279262","54279542","2","1650838"
"chr9","55932769","55933062","chr9","54281930","54282223","9","1650839"
"chr9","55950380","55950675","chr9","54299922","54300223","19","1650458"
"chr9","55954366","55954463","chr15","4765942","4766043","20","51188424"
"chr9","55954915","55955081","chr20","50942751","50942924","38","5012164"
"chr9","55955458","55955752","chr9","54304886","54305184","6","1650572"
"chr9","55956637","55956952","chr9","54306068","54306383","8","1650569"
"chr9","55966598","55966881","chr9","54315215","54315498","6","1651383"
"chr9","56032186","56032498","chr9","54381235","54381543","13","1650951"
"chr9","56039082","56039361","chr9","54388853","54389111","29","1650229"
"chr9","56041699","56042000","chr9","54391582","54391885","18","1650117"
"chr9","56069619","56069733","chr13","40661290","40661406","20","15408329"
"chr9","56076881","56077164","chr3","44067077","44067369","49","12009804"
"chr9","56104027","56104319","chr9","54455057","54455349","11","1648970"
"chr9","56111824","56112018","chr9","54462827","54463021","2","1648997"
"chr9","56114758","56115029","chr9","54465738","54466006","13","1649020"
"chr9","56116052","56116096","chr11","44373663","44373705","9","11742389"
"chr9","56116384","56116689","chr9","54467217","54467526","21","1649167"
"chr9","56143975","56144265","chr9","54494587","54494890","22","1649388"
"chr9","56149618","56149683","chr4","115015478","115015551","18","58865860"
"chr9","56152437","56152714","chr9","54508444","54508721","7","1643993"
"chr9","56156740","56156964","chr15","23152220","23152440","52","33004520"
"chr9","56157025","56157182","chr9","54505218","54505373","5","1651807"
"chr9","56161635","56161921","chr9","54514180","54514472","15","1647455"
"chr9","56166185","56166352","chr9","54532275","54532439","11","1633910"
"chr9","56173998","56174248","chr9","54524866","54525116","6","1649132"
"chr9","56180474","56180773","chr9","54523285","54523584","6","1657189"
"chr9","56190397","56190685","chr9","54541366","54541657","11","1649031"
"chr9","56208206","56208518","chr9","54560341","54560653","6","1647865"
"chr9","56208705","56209008","chr9","54560840","54561143","6","1647865"
"chr9","56210350","56210585","chr9","54562494","54562731","8","1647856"
"chr9","56220254","56220535","chr9","54572220","54572500","3","1648034"
"chr9","56220573","56220585","chr1","15101615","15101626","2","41118958"
"chr9","56221483","56221768","chr9","54573447","54573737","15","1648036"
"chr9","56230121","56230429","chr9","54582615","54582913","16","1647506"
"chr9","56238120","56238423","chr9","54590619","54590912","15","1647501"
"chr9","56238534","56238828","chr9","54591023","54591313","14","1647511"
"chr9","56246449","56246755","chr9","54599593","54599901","6","1646856"
"chr9","56247003","56247324","chr9","54600150","54600476","16","1646853"
"chr9","56257727","56257821","chr9","54610877","54610971","1","1646850"
"chr9","56274723","56275016","chr9","54628131","54628422","10","1646592"
"chr9","56280153","56280260","chr9","54633746","54633852","6","1646407"
"chr9","56287739","56287975","chr9","54641286","54641526","13","1646453"
"chr9","56288981","56289047","chr9","54642527","54642593","4","1646454"
"chr9","56313424","56313732","chr9","54666920","54667223","10","1646504"
"chr9","56326705","56327015","chr9","54682242","54682557","9","1644463"
"chr9","56347089","56347371","chr9","54702439","54702728","13","1644650"
"chr9","56347374","56347508","chr9","54702731","54702865","2","1644643"
"chr9","56349000","56349130","chr1","21721800","21721934","17","34627200"
"chr9","56398229","56398522","chr9","54753702","54753995","6","1644527"
"chr9","56413711","56413846","chr9","54769162","54769297","2","1644549"
"chr9","56429248","56429406","chr3","75948694","75948847","36","19519446"
"chr9","56429407","56429466","chr6","132735119","132735181","14","76305712"
"chr9","56448126","56448431","chr9","54803238","54803543","10","1644888"
"chr9","56497900","56498202","chr9","54853200","54853502","6","1644700"
"chr9","56504847","56505023","chr9","54860074","54860247","9","1644773"
"chr9","56505456","56505802","chr9","54860639","54860983","8","1644817"
"chr9","56511312","56511607","chr9","54866576","54866874","8","1644736"
"chr9","56512966","56513271","chr9","54868236","54868541","5","1644730"
"chr9","56516310","56516605","chr9","54871583","54871887","12","1644727"
"chr9","56531241","56531497","chr9","54878050","54878306","11","1653191"
"chr9","56531723","56531858","chr9","54878532","54878667","4","1653191"
"chr9","56532171","56532473","chr9","54878976","54879278","7","1653195"
"chr9","56551667","56551809","chr5","170700200","170700344","46","114148533"
"chr9","56552114","56552213","chr7","126552282","126552380","25","70000168"
"chr9","56559046","56559209","chr15","22408227","22408398","37","34150819"
"chr9","56563622","56563797","chr9","54914269","54914444","2","1649353"
"chr9","56569580","56569741","chr9","54920627","54920788","2","1648953"
"chr9","56569747","56569809","chr9","54920794","54920856","0","1648953"
"chr9","56570964","56571305","chrX","44306757","44307052","108","12264207"
"chr9","56592016","56592307","chr9","54952557","54952892","48","1639459"
"chr9","56592351","56592675","chr9","54952896","54953222","15","1639455"
"chr9","56613056","56613370","chr9","54967813","54968122","10","1645243"
"chr9","56618462","56618598","chr9","54973222","54973366","14","1645240"
"chr9","56623473","56623753","chr10","29047313","29047589","55","27576160"
"chr9","56630500","56630803","chr9","54985166","54985469","7","1645334"
"chr9","56631627","56631923","chr9","54986300","54986592","16","1645327"
"chr9","56639281","56639459","chr9","54993793","54993971","6","1645488"
"chr9","56639900","56640052","chr9","54994412","54994564","3","1645488"
"chr9","56644321","56644432","chr9","54998795","54998906","2","1645526"
"chr9","56654459","56654743","chr9","55009476","55009761","3","1644983"
"chr9","56655156","56655404","chr9","55010176","55010424","4","1644980"
"chr9","56656665","56656962","chr9","55011660","55011943","44","1645005"
"chr9","56657314","56657618","chr9","55012300","55012604","3","1645014"
"chr9","56661230","56661523","chr9","55016381","55016681","9","1644849"
"chr9","56662290","56662592","chr9","55017451","55017743","15","1644839"
"chr9","56665089","56665402","chr9","55020242","55020556","13","1644847"
"chr9","56669451","56669689","chr9","55024605","55024842","4","1644846"
"chr9","56669744","56669996","chr9","55024890","55025135","10","1644854"
"chr9","56672522","56672768","chr9","55027649","55027895","2","1644873"
"chr9","56677259","56677548","chr9","55032400","55032689","4","1644859"
"chr9","56678537","56678795","chr9","55033671","55033931","4","1644866"
"chr9","56682318","56682616","chr2","99905203","99905497","53","43222885"
"chr9","56689914","56690211","chr9","55045152","55045449","4","1644762"
"chr9","56706460","56706746","chr9","55062030","55062316","5","1644430"
"chr9","56706771","56707070","chr9","55062341","55062640","8","1644430"
"chr9","56708642","56708940","chr9","55064238","55064519","24","1644404"
"chr9","56717700","56717992","chr9","55073232","55073528","8","1644468"
"chr9","56728571","56728883","chr9","55084124","55084438","9","1644447"
"chr9","56750213","56750496","chr16","47110781","47111067","51","9639432"
"chr9","56759178","56759484","chr9","55117060","55117367","11","1642118"
"chr9","56773611","56773906","chr9","55131713","55132014","8","1641898"
"chr9","56788120","56788338","chr9","55146821","55147039","2","1641299"
"chr9","56815234","56815529","chr9","55173708","55174014","17","1641526"
"chr9","56822776","56822989","chr7","17207459","17207671","44","39615317"
"chr9","56829490","56829782","chr9","55187338","55187630","5","1642152"
"chr9","56841133","56841415","chr9","55198937","55199243","28","1642196"
"chr9","56849004","56849302","chr9","55207130","55207430","7","1641874"
"chr9","56851644","56851858","chr9","55209787","55209999","6","1641857"
"chr9","56855959","56856248","chr9","55213985","55214274","4","1641974"
"chr9","56859334","56859621","chr9","55217357","55217649","11","1641977"
"chr9","56887339","56887525","chr9","55245662","55245849","6","1641677"
"chr9","56889041","56889331","chr9","55247655","55247943","15","1641386"
"chr9","56891771","56891876","chr9","55251178","55251282","5","1640593"
"chr9","56891922","56892018","chr9","55251335","55251431","0","1640587"
"chr9","56902029","56902335","chr9","55261662","55261970","10","1640367"
"chr9","56916356","56916657","chr9","55276215","55276515","9","1640141"
"chr9","56957297","56957551","chr9","55317855","55318109","9","1639442"
"chr9","56969572","56969742","chr9","55330095","55330274","12","1639477"
"chr9","56976846","56977155","chr9","55335741","55336050","10","1641105"
"chr9","56991473","56991778","chr9","55350078","55350381","12","1641395"
"chr9","57007078","57007340","chr9","55363427","55363689","4","1643651"
"chr9","57008042","57008293","chr9","55364377","55364628","6","1643665"
"chr9","57009534","57009820","chr9","55365867","55366152","6","1643667"
"chr9","57046761","57047050","chr9","55405145","55405435","4","1641616"
"chr9","57054705","57054960","chr9","55413511","55413770","9","1641194"
"chr9","57078487","57078787","chr9","55433099","55433393","10","1645388"
"chr9","57084878","57085086","chr9","55442565","55442773","7","1642313"
"chr9","57090007","57090275","chr9","55447625","55447888","11","1642382"
"chr9","57092335","57092509","chr14","120450685","120450839","36","63358350"
"chr9","57097820","57098128","chr9","55455136","55455442","7","1642684"
"chr9","57133243","57133565","chr9","55490594","55490912","15","1642649"
"chr9","57141051","57141374","chr9","55498752","55499062","16","1642299"
"chr9","57145200","57145501","chr9","55503201","55503502","8","1641999"
"chr9","57148008","57148302","chr9","55505709","55506018","24","1642299"
"chr9","57149198","57149280","chr20","17889421","17889500","18","39259777"
"chr9","57176174","57176300","chr9","55533047","55533173","0","1643127"
"chr9","57176594","57176770","chr9","55533452","55533632","9","1643142"
"chr9","57187936","57188241","chr9","55542301","55542613","17","1645635"
"chr9","57190637","57190840","chr9","55545002","55545205","9","1645635"
"chr9","57190887","57191225","chr9","55545252","55545590","11","1645635"
"chr9","57204374","57204673","chr9","55559259","55559557","5","1645115"
"chr9","57211823","57212141","chr9","55566491","55566809","14","1645332"
"chr9","57228821","57229121","chr9","55583500","55583803","12","1645321"
"chr9","57240973","57241287","chr9","55598155","55598468","20","1642818"
"chr9","57255666","57255954","chr9","55613308","55613618","31","1642358"
"chr9","57257988","57258165","chr9","55615723","55615874","27","1642265"
"chr9","57258491","57258564","chr9","55616200","55616273","1","1642291"
"chr9","57259782","57259910","chr7","43958844","43958975","23","13300938"
"chr9","57277573","57277846","chr9","34061394","34061672","56","23216179"
"chr9","57279340","57279671","chr9","55637170","55637496","11","1642170"
"chr9","57310936","57311224","chr9","55669490","55669780","11","1641446"
"chr9","57311282","57311577","chr9","55669831","55670127","6","1641451"
"chr9","57313452","57313717","chr9","55672237","55672502","6","1641215"
"chr9","57315754","57316060","chr15","40239504","40239798","79","17076250"
"chr9","57324324","57324478","chr16","17830883","17831042","33","39493441"
"chr9","57325669","57325938","chr9","55685132","55685401","4","1640537"
"chr9","57326996","57327299","chr9","55686450","55686754","6","1640546"
"chr9","57331257","57331530","chr4","153760478","153760767","65","96429221"
"chr9","57347423","57347728","chr9","55706271","55706580","9","1641152"
"chr9","57352686","57352983","chr9","55711881","55712168","14","1640805"
"chr9","57355546","57355841","chr9","55714938","55715226","12","1640608"
"chr9","57356482","57356755","chr7","148800220","148800490","51","91443738"
"chr9","57360186","57360462","chr9","55719938","55720214","5","1640248"
"chr9","57360635","57360967","chr9","55720696","55721006","27","1639939"
"chr9","57367764","57368087","chr9","55728492","55728815","8","1639272"
"chr9","57377647","57377922","chr9","55739620","55739919","33","1638027"
"chr9","57387867","57387918","chr20","55950731","55950778","13","1437136"
"chr9","57397075","57397375","chr9","55764860","55765163","3","1632215"
"chr9","57413202","57413522","chr19","12796647","12796952","63","44616555"
"chr9","57421481","57421778","chr9","55798826","55799132","16","1622655"
"chr9","57423871","57424092","chr9","55786924","55787145","5","1636947"
"chr9","57426527","57426830","chr9","55792852","55793194","46","1633675"
"chr9","57431256","57431551","chr9","55802280","55802577","4","1628976"
"chr9","57446060","57446357","chr9","55817301","55817600","8","1628759"
"chr9","57474598","57474879","chr9","55846299","55846580","2","1628299"
"chr9","57479214","57479273","chr9","55850743","55850801","3","1628471"
"chr9","57479373","57479607","chr9","55850901","55851136","7","1628472"
"chr9","57480517","57480797","chr2","42141549","42141836","57","15338968"
"chr9","57489807","57490112","chr9","55861795","55862100","6","1628012"
"chr9","57491846","57491989","chr9","55863819","55863962","2","1628027"
"chr9","57522547","57522852","chr9","55894664","55894969","6","1627883"
"chr9","57528497","57528760","chr9","55900633","55900894","11","1627864"
"chr9","57542085","57542251","chr9","55914401","55914567","3","1627684"
"chr9","57576225","57576523","chr9","55949293","55949596","11","1626932"
"chr9","57591997","57592299","chr9","55964910","55965213","5","1627087"
"chr9","57596325","57596468","chr1","18696758","18696894","30","38899567"
"chr9","57613745","57613913","chr9","55987168","55987332","8","1626577"
"chr9","57614242","57614346","chr9","55987658","55987764","5","1626584"
"chr9","57619167","57619279","chr8","6062597","6062712","26","51556570"
"chr9","57621119","57621416","chr9","55994641","55994938","9","1626478"
"chr9","57631413","57631534","chrX","108971246","108971363","18","51339833"
"chr9","57635238","57635314","chr9","56012860","56012936","3","1622378"
"chr9","57635598","57635827","chr9","56013194","56013436","18","1622404"
"chr9","57636800","57637085","chr9","56005061","56005346","11","1631739"
"chr9","57647586","57647902","chr15","7946893","7947207","30","49700693"
"chr9","57648858","57649154","chr9","56023097","56023393","6","1625761"
"chr9","57651516","57651814","chr9","56025760","56026051","14","1625756"
"chr9","57652617","57652904","chr9","56026854","56027150","14","1625763"
"chr9","57655238","57655532","chr9","56029482","56029776","6","1625756"
"chr9","57656318","57656608","chr4","105024649","105024934","51","47368331"
"chr9","57661093","57661408","chr9","56036292","56036598","18","1624801"
"chr9","57662362","57662633","chr9","56037549","56037829","16","1624813"
"chr9","57663806","57663965","chr14","55645181","55645344","42","2018625"
"chr9","57664453","57664621","chr9","56039665","56039833","6","1624788"
"chr9","57664918","57665071","chr9","56040131","56040278","10","1624787"
"chr9","57668876","57669156","chr9","56044601","56044868","18","1624275"
"chr9","57673159","57673323","chrX","14387257","14387417","30","43285902"
"chr9","57675789","57676099","chr9","56052625","56052898","50","1623164"
"chr9","57676893","57677150","chr9","56053698","56053955","4","1623195"
"chr9","57677893","57678186","chr9","56054691","56054989","12","1623202"
"chr9","57680588","57680862","chr9","56060576","56060850","7","1620012"
"chr9","57696161","57696477","chr9","56074996","56075312","13","1621165"
"chr9","57743564","57743857","chr9","56124545","56124838","4","1619019"
"chr9","57754637","57754767","chr15","39542579","39542711","26","18212058"
"chr9","57765207","57765507","chr9","56145164","56145471","14","1620043"
"chr9","57769604","57769891","chr9","56150258","56150539","10","1619346"
"chr9","57771656","57771960","chr13","62948659","62948963","7","5177003"
"chr9","57802005","57802293","chr9","56183929","56184217","1","1618076"
"chr9","57832466","57832762","chr9","56215449","56215745","6","1617017"
"chr9","57834921","57835197","chr6","51726671","51726918","69","6108250"
"chr9","57856154","57856471","chr9","56239328","56239646","8","1616826"
"chr9","57857163","57857467","chr9","56240314","56240621","7","1616849"
"chr9","57860050","57860343","chr9","56243844","56244136","7","1616206"
"chr9","57869960","57870249","chr9","56255382","56255669","8","1614578"
"chr9","57874312","57874615","chr9","56260097","56260400","6","1614215"
"chr9","57895964","57896272","chr9","56281596","56281908","11","1614368"
"chr9","57897275","57897393","chrX","131969934","131970064","27","74072659"
"chr9","57898500","57898783","chr9","56284464","56284728","24","1614036"
"chr9","57904081","57904382","chr9","56291970","56292271","6","1612111"
"chr9","57912350","57912597","chr1","186315344","186315593","53","128402994"
"chr9","57920053","57920362","chr9","56307168","56307476","12","1612885"
"chr9","57946387","57946676","chr9","56332157","56332467","25","1614230"
"chr9","57951510","57951822","chr9","56337582","56337893","11","1613928"
"chr9","57956258","57956575","chr9","56342352","56342670","9","1613906"
"chr9","57977833","57978107","chr10","26059826","26060100","53","31918007"
"chr9","57989585","57989833","chrX","107858419","107858669","54","49868834"
"chr9","57991459","57991761","chr9","56389485","56389783","15","1601974"
"chr9","58000508","58000649","chr17","77534754","77534894","28","19534246"
"chr9","58002699","58002972","chr9","56400139","56400464","58","1602560"
"chr9","58003008","58003019","chr11","45860084","45860095","0","12142924"
"chr9","58009453","58009728","chr2","2687811","2688085","63","55321642"
"chr9","58010923","58011035","chr9","56408864","56408976","3","1602059"
"chr9","58011403","58011600","chr9","56409344","56409546","9","1602059"
"chr9","58012689","58012988","chr19","28718617","28718918","53","29294072"
"chr9","58013158","58013267","chr9","56411098","56411209","5","1602060"
"chr9","58034905","58035190","chr9","56433182","56433469","7","1601723"
"chr9","58057193","58057463","chr9","56456050","56456320","3","1601143"
"chr9","58070670","58070949","chr9","56469226","56469529","29","1601444"
"chr9","58071725","58071941","chr9","56470265","56470483","7","1601460"
"chr9","58077893","58078204","chr9","56477107","56477418","3","1600786"
"chr9","58090204","58090495","chr9","56489709","56489997","9","1600495"
"chr9","58096743","58096997","chr15","90907018","90907283","64","32810275"
"chr9","58100652","58100700","chr6","148291297","148291342","12","90190645"
"chr9","58100862","58101076","chr6","173085588","173085802","58","114984726"
"chr9","58112025","58112326","chr9","56511538","56511839","4","1600487"
"chr9","58123398","58123773","chr9","56522888","56523252","25","1600510"
"chr9","58128949","58129027","chr9","56528440","56528518","2","1600509"
"chr9","58167351","58167637","chr9","56567154","56567448","12","1600197"
"chr9","58169576","58169600","chr9","56569092","56569115","1","1600484"
"chr9","58169919","58170006","chr9","56569424","56569511","1","1600495"
"chr9","58171808","58172111","chr9","56571312","56571615","5","1600496"
"chr9","58187526","58187828","chr9","56587650","56587956","10","1599876"
"chr9","58188795","58189070","chr9","56588941","56589202","32","1599854"
"chr9","58201569","58201756","chr1","37334133","37334321","43","20867436"
"chr9","58202104","58202221","chr11","112563198","112563320","23","54361094"
"chr9","58220746","58221030","chr9","56621651","56621949","16","1599095"
"chr9","58231486","58231799","chr9","56638459","56638772","10","1593027"
"chr9","58233088","58233372","chr9","56640386","56640671","11","1592702"
"chr9","58234920","58235224","chr9","56642197","56642492","18","1592723"
"chr9","58261462","58261738","chr15","10004086","10004365","58","48257376"
"chr9","58268165","58268439","chr17","27854216","27854497","63","30413949"
"chr9","58270445","58270653","chr9","56675094","56675302","2","1595351"
"chr9","58286276","58286435","chrX","14387257","14387417","28","43899019"
"chr9","58286857","58286974","chr9","56707722","56707839","3","1579135"
"chr9","58287014","58287162","chr9","56707871","56708023","7","1579143"
"chr9","58287754","58287819","chr4","27924851","27924917","14","30362903"
"chr9","58287867","58287983","chr18","14073676","14073792","17","44214191"
"chr9","58294227","58294514","chr9","56705177","56705470","29","1589050"
"chr9","58301621","58301722","chr9","56714532","56714633","5","1587089"
"chr9","58302827","58303101","chr9","56715737","56716011","2","1587090"
"chr9","58341417","58341682","chr7","148800220","148800490","58","90458803"
"chr9","58345360","58345623","chr1","39477138","39477394","62","18868222"
"chr9","58362505","58362805","chr9","56768153","56768449","18","1594352"
"chr9","58369592","58369693","chr7","133080439","133080539","25","74710847"
"chr9","58373053","58373323","chr9","56778958","56779238","13","1594095"
"chr9","58391814","58392129","chr9","56797623","56797944","11","1594191"
"chr9","58393031","58393333","chr9","56798840","56799143","6","1594191"
"chr9","58400015","58400314","chr9","56805828","56806135","17","1594187"
"chr9","58403167","58403370","chr9","56809291","56809494","5","1593876"
"chr9","58411118","58411420","chr9","56817737","56818029","14","1593381"
"chr9","58423091","58423252","chr9","56829686","56829846","5","1593405"
"chr9","58423563","58423696","chr9","56830156","56830289","2","1593407"
"chr9","58445158","58445325","chr9","56852088","56852262","9","1593070"
"chr9","58466835","58467127","chr9","56874263","56874556","22","1592572"
"chr9","58498509","58498813","chr9","56902803","56903088","23","1595706"
"chr9","58503777","58504050","chr9","56907921","56908194","8","1595856"
"chr9","58524555","58524853","chr15","70204095","70204396","60","11679540"
"chr9","58529959","58530040","chr6","139956525","139956610","17","81426566"
"chr9","58530135","58530321","chr9","56934293","56934467","12","1595842"
"chr9","58530909","58531206","chr9","56935064","56935361","3","1595845"
"chr9","58535632","58535928","chr9","56939784","56940085","11","1595848"
"chr9","58550265","58550461","chr9","56953816","56954001","15","1596449"
"chr9","58550755","58550908","chr7","38567520","38567681","30","19983235"
"chr9","58578236","58578391","chr12","13614701","13614861","33","44963535"
"chr9","58600680","58600995","chr9","57004430","57004747","9","1596250"
"chr9","58603298","58603627","chr9","57007046","57007375","12","1596252"
"chr9","58610366","58610680","chr13","72922007","72922316","68","14311641"
"chr9","58616671","58616781","chr9","57017666","57017776","1","1599005"
"chr9","58617084","58617217","chr3","173613198","173613322","38","114996114"
"chr9","58631125","58631290","chr19","10014739","10014903","27","48616386"
"chr9","58632438","58632677","chr9","57033859","57034098","5","1598579"
"chr9","58636768","58637075","chr9","57038830","57039137","3","1597938"
"chr9","58677639","58677910","chr9","57082840","57083109","6","1594799"
"chr9","58687315","58687607","chr9","57092476","57092768","6","1594839"
"chr9","58688237","58688332","chr3","5317936","5318032","17","53370301"
"chr9","58716636","58716805","chr9","57123004","57123173","5","1593632"
"chr9","58717095","58717226","chr9","57123457","57123588","2","1593638"
"chr9","58722434","58722753","chr1","93993308","93993624","60","35270874"
"chr9","58723938","58724220","chr9","57130323","57130610","14","1593615"
"chr9","58725989","58726314","chr9","57132391","57132724","22","1593598"
"chr9","58762261","58762558","chr9","57169783","57170084","12","1592478"
"chr9","58794477","58794734","chr9","57201711","57201976","11","1592766"
"chr9","58807407","58807548","chr9","57215806","57215947","1","1591601"
"chr9","58807555","58807854","chr9","57215954","57216258","13","1591601"
"chr9","58812657","58812928","chr9","57222020","57222278","22","1590637"
"chr9","58823389","58823524","chr9","57233192","57233327","1","1590197"
"chr9","58824178","58824347","chr9","57233961","57234121","15","1590217"
"chr9","58834222","58834399","chr9","57245987","57246164","5","1588235"
"chr9","58860453","58860593","chr9","57269001","57269143","3","1591452"
"chr9","58871477","58871630","chr20","15083166","15083314","26","43788311"
"chr9","58891733","58891791","chr9","57301970","57302028","1","1589763"
"chr9","58891977","58892208","chr9","57302217","57302448","4","1589760"
"chr9","58903808","58904105","chr9","57313030","57313327","6","1590778"
"chr9","58906837","58906891","chr1","201245463","201245514","14","142338626"
"chr9","58910695","58910935","chr9","57320748","57320988","8","1589947"
"chr9","58924085","58924344","chr3","37308911","37309161","61","21615174"
"chr9","58926600","58926912","chr9","57337066","57337378","3","1589534"
"chr9","58926919","58927096","chr9","57337385","57337565","6","1589534"
"chr9","58937003","58937318","chr9","57347406","57347721","5","1589597"
"chr9","58942278","58942469","chr9","57355599","57355813","25","1586679"
"chr9","58943598","58943887","chr9","57357939","57358228","3","1585659"
"chr9","58948406","58948677","chr9","57364259","57364531","6","1584147"
"chr9","58952212","58952507","chr9","57368063","57368358","9","1584149"
"chr9","58952575","58952894","chr9","57368426","57368745","7","1584149"
"chr9","58970019","58970292","chr9","57387999","57388272","17","1582020"
"chr9","58988013","58988174","chr2","149685908","149686075","28","90697895"
"chr9","58993965","58994134","chr9","57411655","57411824","2","1582310"
"chr9","58994439","58994458","chr9","57412133","57412152","0","1582306"
"chr9","59000841","59001138","chr9","57418487","57418784","5","1582354"
"chr9","59013238","59013406","chr6","124603094","124603262","27","65589856"
"chr9","59018577","59018883","chr9","57436862","57437172","9","1581715"
"chr9","59026815","59026998","chr13","103410227","103410404","46","44383412"
"chr9","59040527","59040693","chr9","23733254","23733414","28","35307273"
"chr9","59040746","59040769","chr4","136812065","136812089","3","77771319"
"chr9","59080043","59080332","chr9","57500664","57500954","9","1579379"
"chr9","59084887","59085176","chr9","57505836","57506125","3","1579051"
"chr9","59089758","59089813","chr3","77269037","77269092","15","18179279"
"chr9","59092102","59092406","chr9","57514349","57514655","8","1577753"
"chr9","59099981","59100196","chr9","57522314","57522506","24","1577667"
"chr9","59102082","59102355","chr9","57524388","57524661","14","1577694"
"chr9","59102442","59102699","chr9","57524706","57524998","39","1577736"
"chr9","59108551","59108687","chr9","57532376","57532512","1","1576175"
"chr9","59109318","59109483","chr11","38369515","38369683","31","20739803"
"chr9","59110589","59110901","chr9","57534408","57534719","19","1576181"
"chr9","59125476","59125616","chr9","57555153","57555293","4","1570323"
"chr9","59127425","59127743","chr5","142565235","142565540","64","83437810"
"chr9","59133324","59133627","chr9","57557780","57558083","4","1575544"
"chr9","59145073","59145154","chr2","136521964","136522046","8","77376891"
"chr9","59171359","59171556","chr9","57600571","57600740","32","1570788"
"chr9","59171860","59171993","chr9","57601044","57601177","0","1570816"
"chr9","59173525","59173687","chr9","57602710","57602872","3","1570815"
"chr9","59180455","59180753","chr9","57610167","57610471","7","1570288"
"chr9","59185259","59185373","chr9","37866413","37866529","18","21318846"
"chr9","59190534","59190832","chr9","57619635","57619933","4","1570899"
"chr9","59193662","59193961","chr9","57622760","57623059","5","1570902"
"chr9","59197488","59197724","chr5","175400136","175400371","59","116202648"
"chr9","59208794","59209073","chr9","57638468","57638753","13","1570326"
"chr9","59219320","59219607","chr9","57648963","57649252","9","1570357"
"chr9","59246709","59246965","chr9","57676804","57677052","13","1569905"
"chr9","59279005","59279152","chr13","26452448","26452594","32","32826557"
"chr9","59281751","59282055","chr9","57711324","57711623","19","1570427"
"chr9","59284737","59285025","chr9","57715322","57715610","6","1569415"
"chr9","59286121","59286403","chr9","57716708","57716990","3","1569413"
"chr9","59289191","59289299","chr9","61440073","61440181","14","2150882"
"chr9","59308353","59308589","chr9","57742865","57743108","13","1565488"
"chr9","59310450","59310758","chr9","57739773","57740081","10","1570677"
"chr9","59318843","59319146","chr9","57749650","57749948","7","1569193"
"chr9","59333977","59334279","chr9","57765182","57765499","21","1568795"
"chr9","59382252","59382492","chr9","57814380","57814611","12","1567872"
"chr9","59385656","59385765","chr19","40121340","40121449","24","19264316"
"chr9","59386160","59386437","chr9","57818514","57818801","26","1567646"
"chr9","59389797","59389969","chr9","57821793","57821959","11","1568004"
"chr9","59390250","59390383","chr9","57822241","57822374","8","1568009"
"chr9","59390679","59390779","chr3","38092595","38092692","29","21298084"
"chr9","59402099","59402339","chr9","57834174","57834463","55","1567925"
"chr9","59406152","59406323","chr9","57838617","57838789","1","1567535"
"chr9","59409725","59410033","chr9","57842168","57842471","13","1567557"
"chr9","59416656","59416990","chr16","39916720","39917037","87","19499936"
"chr9","59422653","59422951","chr2","101369844","101370136","56","41947191"
"chr9","59426146","59426218","chr9","57858293","57858375","12","1567853"
"chr9","59426692","59426798","chr9","57858850","57858956","2","1567842"
"chr9","59435613","59435901","chr9","57866927","57867216","8","1568686"
"chr9","59439954","59440094","chr9","57871275","57871414","3","1568679"
"chr9","59456017","59456285","chr9","57887943","57888186","27","1568074"
"chr9","59458068","59458352","chr9","57889947","57890232","7","1568121"
"chr9","59462903","59463193","chr15","39841182","39841477","55","19621721"
"chr9","59637325","59637651","chr9","58070848","58071174","8","1566477"
"chr9","59664937","59665095","chr9","102282987","102283142","25","42618050"
"chr9","59681818","59682129","chr9","58115127","58115426","16","1566691"
"chr9","59819444","59819737","chr9","58252893","58253184","6","1566551"
"chr9","59844064","59844390","chr9","58277568","58277894","8","1566496"
"chr9","59871629","59871938","chr9","58305597","58305895","20","1566032"
"chr9","59875690","59875967","chr9","58309217","58309494","6","1566473"
"chr9","59885009","59885131","chr7","23009438","23009561","18","36875571"
"chr9","59907225","59907410","chr9","58340996","58341181","3","1566229"
"chr9","59924973","59925204","chr1","153776522","153776751","51","93851549"
"chr9","59932342","59932653","chr9","58365993","58366304","12","1566349"
"chr9","59933996","59934110","chr4","7603859","7603973","15","52330137"
"chr9","59934412","59934444","chr1","113176685","113176713","13","53242273"
"chr9","59934756","59934921","chr9","58368098","58368274","16","1566658"
"chr9","59965785","59966083","chr9","58398683","58398981","10","1567102"
"chr9","60094801","60095097","chr9","58528238","58528532","7","1566563"
"chr9","60188023","60188319","chr9","58625775","58626057","19","1562248"
"chr9","60241593","60241877","chr9","58679165","58679449","5","1562428"
"chr9","60278223","60278517","chr9","58715932","58716227","12","1562291"
"chr9","60383374","60383386","chr9","58825598","58825611","1","1557776"
"chr9","60383675","60383822","chr9","58825909","58826057","4","1557766"
"chr9","60424293","60424567","chr9","58866243","58866517","7","1558050"
"chr9","60435592","60435906","chr9","58877004","58877318","8","1558588"
"chr9","60440052","60440353","chr9","58881463","58881768","13","1558589"
"chr9","60443166","60443472","chr9","58884593","58884899","6","1558573"
"chr9","60483233","60483535","chr9","58925116","58925418","4","1558117"
"chr9","60489553","60489729","chr1","206823091","206823266","39","146333538"
"chr9","60491346","60491459","chr4","152807333","152807454","25","92315987"
"chr9","60512037","60512339","chr9","58955695","58956003","7","1556342"
"chr9","60626998","60627168","chr9","59072569","59072732","12","1554429"
"chr9","60632155","60632453","chr9","59077720","59078014","17","1554435"
"chr9","60639187","60639469","chr9","59085076","59085358","8","1554111"
"chr9","60658072","60658363","chr9","59103492","59103785","10","1554580"
"chr9","60662635","60662690","chr15","35316596","35316647","10","25346039"
"chr9","60662860","60663089","chr1","197498153","197498380","45","136835293"
"chr9","60668306","60668612","chr9","59113723","59114040","14","1554583"
"chr9","60699797","60700049","chr9","59145022","59145273","8","1554775"
"chr9","60709856","60710156","chr9","59155227","59155524","8","1554629"
"chr9","60742190","60742458","chr4","17887711","17887996","65","42854479"
"chr9","60744412","60744685","chr9","59195814","59196087","10","1548598"
"chr9","60754259","60754555","chr9","59205798","59206094","4","1548461"
"chr9","60773614","60773922","chr9","59226119","59226431","8","1547495"
"chr9","60783733","60784007","chr9","59236971","59237246","19","1546762"
"chr9","60799057","60799339","chr9","59247062","59247347","7","1551995"
"chr9","60806511","60806814","chr9","59254874","59255174","9","1551637"
"chr9","60831967","60832277","chr9","59281253","59281551","20","1550714"
"chr9","60840134","60840357","chr9","59289779","59290004","7","1550355"
"chr9","60845962","60846044","chrX","122790606","122790686","19","61944644"
"chr9","60846627","60846804","chr9","59294730","59294910","15","1551897"
"chr9","60862058","60862359","chr9","59311711","59312007","17","1550347"
"chr9","60879428","60879726","chr9","59329709","59330014","16","1549719"
"chr9","60881209","60881516","chr9","59331498","59331805","12","1549711"
"chr9","60884938","60885113","chr9","59335245","59335420","3","1549693"
"chr9","60892738","60893021","chr9","59343925","59344208","11","1548813"
"chr9","60898066","60898127","chr2","113016285","113016344","11","52118219"
"chr9","60902557","60902853","chr7","30149330","30149627","71","30753227"
"chr9","60909957","60910128","chr1","16306842","16307019","38","44603115"
"chr9","60913236","60913448","chr9","59362108","59362323","6","1551128"
"chr9","60927928","60928098","chr9","59376680","59376872","30","1551248"
"chr9","60942348","60942661","chr9","59386831","59387153","14","1555517"
"chr9","60947697","60947825","chr5","12262075","12262204","24","48685622"
"chr9","60951315","60951628","chr9","59386831","59387153","14","1564484"
"chr9","60956664","60956956","chr9","102340368","102340668","56","41383704"
"chr9","60983745","60984046","chr9","59419477","59419779","13","1564268"
"chr9","60992163","60992465","chr16","69982430","69982726","48","8990267"
"chr9","60992497","60992797","chr13","38237330","38237635","44","22755167"
"chr9","61027408","61027735","chr11","50330487","50330804","61","10696921"
"chr9","61043875","61044134","chr9","59484644","59484903","5","1559231"
"chr9","61049630","61049936","chr9","59490420","59490718","10","1559210"
"chr9","61050538","61050847","chr9","59491330","59491624","21","1559208"
"chr9","61062683","61062863","chr9","59503756","59503951","17","1558927"
"chr9","61074151","61074461","chr9","59516336","59516646","5","1557815"
"chr9","61077199","61077502","chr9","59519395","59519692","10","1557804"
"chr9","61078301","61078585","chr9","59520507","59520785","15","1557794"
"chr9","61083785","61083958","chr9","59525950","59526121","7","1557835"
"chr9","61094797","61095093","chr9","59536949","59537244","20","1557848"
"chr9","61095269","61095560","chr9","59537420","59537715","8","1557849"
"chr9","61099512","61099861","chr9","59541681","59542012","25","1557831"
"chr9","61102768","61103056","chr9","59544591","59544891","14","1558177"
"chr9","61107148","61107404","chr9","59548931","59549199","24","1558217"
"chr9","61115771","61116070","chr9","59559607","59559913","14","1556164"
"chr9","61117632","61117911","chr9","59563905","59564201","33","1553727"
"chr9","61119137","61119425","chr11","122048982","122049261","58","60929845"
"chr9","61119998","61120291","chr15","60725603","60725890","61","394395"
"chr9","61120900","61121179","chr9","59567329","59567616","12","1553571"
"chr9","61126070","61126195","chr11","4764033","4764157","24","56362037"
"chr9","61127972","61128270","chr9","59575664","59575962","11","1552308"
"chr9","61131250","61131406","chr9","59578961","59579113","7","1552289"
"chr9","61136203","61136325","chr9","59584263","59584386","2","1551940"
"chr9","61144092","61144360","chr4","36629356","36629620","64","24514736"
"chr9","61177174","61177452","chr9","59623676","59623954","5","1553498"
"chr9","61181684","61181995","chr9","59627599","59627906","9","1554085"
"chr9","61208920","61209240","chr9","59655244","59655551","25","1553676"
"chr9","61219674","61219969","chr9","59666352","59666646","7","1553322"
"chr9","61222045","61222316","chr9","59668702","59668973","7","1553343"
"chr9","61222338","61222495","chr9","59668995","59669152","4","1553343"
"chr9","61240302","61240655","chr9","59686971","59687302","35","1553331"
"chr9","61265127","61265251","chr9","59711786","59711910","1","1553341"
"chr9","61274849","61275164","chr9","59721445","59721759","7","1553404"
"chr9","61286244","61286499","chr9","59732783","59733038","6","1553461"
"chr9","61288708","61289012","chr9","59733719","59734028","10","1554989"
"chr9","61303230","61303384","chr9","59749250","59749404","1","1553980"
"chr9","61306676","61306976","chr9","59752690","59752991","4","1553986"
"chr9","61315725","61316001","chr9","59761712","59761988","6","1554013"
"chr9","61316576","61316846","chr9","59762562","59762831","10","1554014"
"chr9","61357913","61358230","chr9","59803677","59803993","15","1554236"
"chr9","61366535","61366842","chr9","59812375","59812668","27","1554160"
"chr9","61438237","61438525","chr6","148413288","148413581","59","86975051"
"chr9","61447636","61447944","chr9","59897481","59897783","16","1550155"
"chr9","61586581","61586857","chr9","60038308","60038613","37","1548273"
"chr9","61635457","61635766","chr9","60083137","60083453","15","1552320"
"chr9","61660180","61660489","chr9","60104308","60104606","18","1555872"
"chr9","61715057","61715348","chr9","60160306","60160597","8","1554751"
"chr9","61752313","61752626","chr9","60196443","60196732","28","1555870"
"chr9","61788844","61789144","chr9","60232628","60232920","27","1556216"
"chr9","61793632","61793923","chr4","16613854","16614146","14","45179778"
"chr9","61797929","61798243","chr9","60241909","60242228","12","1556020"
"chr9","61799495","61799797","chr9","60243480","60243768","25","1556015"
"chr9","61829557","61829670","chr9","60273193","60273307","4","1556364"
"chr9","61829704","61829866","chr9","60273334","60273500","5","1556370"
"chr9","61846942","61847041","chr9","60290557","60290656","6","1556385"
"chr9","61850377","61850742","chr9","60294012","60294374","12","1556365"
"chr9","61857921","61858203","chr9","60301934","60302224","17","1555987"
"chr9","61869659","61869962","chr9","60313614","60313915","7","1556045"
"chr9","61888432","61888736","chr9","60333913","60334210","13","1554519"
"chr9","61919850","61920148","chr9","60365485","60365776","9","1554365"
"chr9","61923355","61923384","chr6","66953703","66953729","3","5030348"
"chr9","61923412","61923692","chr9","60369001","60369312","37","1554411"
"chr9","61927426","61927722","chr9","60373158","60373453","7","1554268"
"chr9","61931470","61931761","chr9","60377186","60377478","9","1554284"
"chr9","61936654","61936928","chr9","60382371","60382648","7","1554283"
"chr9","61938607","61938912","chr9","60384328","60384641","19","1554279"
"chr9","61954037","61954070","chr10","59147777","59147807","5","2806260"
"chr9","61954374","61954604","chr9","60400369","60400591","14","1554005"
"chr9","61956518","61956802","chr9","60402515","60402798","3","1554003"
"chr9","61963185","61963485","chr9","60409829","60410128","7","1553356"
"chr9","61965983","61966325","chr9","60412861","60413176","29","1553122"
"chr9","61977843","61978128","chr9","60423319","60423602","5","1554524"
"chr9","61978138","61978430","chr9","60423611","60423916","18","1554527"
"chr9","61987863","61987974","chr4","22356608","22356721","33","39631255"
"chr9","62016389","62016595","chr9","60462093","60462308","17","1554296"
"chr9","62031954","62032248","chr9","60477308","60477605","10","1554646"
"chr9","62040714","62041011","chr9","60486134","60486431","2","1554580"
"chr9","62043195","62043364","chr2","187026390","187026555","47","124983195"
"chr9","62055925","62056265","chr9","60499470","60499810","10","1556455"
"chr9","62058366","62058676","chr9","60501911","60502221","13","1556455"
"chr9","62075122","62075416","chr9","60517461","60517754","4","1557661"
"chr9","62076153","62076457","chr9","60518489","60518792","11","1557664"
"chr9","62088104","62088414","chr9","60530448","60530757","15","1557656"
"chr9","62095318","62095613","chr9","60537590","60537885","4","1557728"
"chr9","62100434","62100741","chr9","60542646","60542953","5","1557788"
"chr9","62108691","62108980","chr9","60550773","60551040","32","1557918"
"chr9","62113208","62113504","chr9","60556046","60556344","7","1557162"
"chr9","62126389","62126643","chr2","93333955","93334201","51","31207566"
"chr9","62137215","62137513","chr9","60580772","60581070","4","1556443"
"chr9","62154071","62154358","chr9","17454563","17454858","53","44699508"
"chr9","62155523","62155811","chr14","47814479","47814763","58","14341044"
"chr9","62155826","62155921","chr12","32617312","32617417","22","29538514"
"chr9","62159447","62159710","chr9","60603248","60603530","30","1556199"
"chr9","62173167","62173469","chr9","60615023","60615325","7","1558144"
"chr9","62174927","62175220","chr9","60616598","60616907","27","1558329"
"chr9","62181002","62181288","chr9","60623262","60623548","3","1557740"
"chr9","62194887","62195175","chr9","60638249","60638550","20","1556638"
"chr9","62201916","62202214","chr9","60645107","60645404","13","1556809"
"chr9","62212686","62212988","chr2","146788972","146789270","56","84576286"
"chr9","62220908","62221201","chr9","60659378","60659663","15","1561530"
"chr9","62222775","62222970","chr9","60661205","60661400","6","1561570"
"chr9","62223253","62223375","chr9","60661683","60661805","3","1561570"
"chr9","62228331","62228653","chr9","60667681","60667998","31","1560650"
"chr9","62239033","62239313","chr9","60678380","60678660","3","1560653"
"chr9","62243025","62243314","chr9","60682365","60682657","20","1560660"
"chr9","62244201","62244488","chr9","60683555","60683842","7","1560646"
"chr9","62244499","62244639","chr9","60683853","60683992","8","1560646"
"chr9","62244952","62245131","chr9","60684307","60684481","13","1560645"
"chr9","62249889","62250186","chr9","60689349","60689653","15","1560540"
"chr9","62265251","62265558","chr9","60705060","60705367","8","1560191"
"chr9","62270467","62270771","chr9","60710277","60710582","8","1560190"
"chr9","62276848","62277149","chr9","60716679","60716980","9","1560169"
"chr9","62285286","62285599","chr6","169559105","169559409","58","107273819"
"chr9","62288098","62288325","chr9","60728288","60728519","18","1559810"
"chr9","62292266","62292445","chr9","60732103","60732281","16","1560163"
"chr9","62300360","62300458","chr9","60738015","60738117","4","1562345"
"chr9","62308977","62309265","chr9","60749947","60750224","16","1559030"
"chr9","62310134","62310438","chr9","60751093","60751397","3","1559041"
"chr9","62311382","62311680","chr9","60752332","60752626","10","1559050"
"chr9","62318179","62318488","chr9","60759154","60759427","39","1559025"
"chr9","62330461","62330626","chr9","60772025","60772188","4","1558436"
"chr9","62332347","62332659","chr9","60773917","60774232","5","1558430"
"chr9","62333496","62333653","chr9","60775061","60775218","0","1558435"
"chr9","62333810","62333933","chr9","60775374","60775497","2","1558436"
"chr9","62348427","62348721","chr9","60789744","60790037","3","1558683"
"chr9","62353363","62353482","chr9","60794650","60794786","18","1558713"
"chr9","62353830","62353877","chr1","125184004","125184047","13","62830174"
"chr9","62356725","62357017","chr9","60797939","60798230","8","1558786"
"chr9","62371109","62371414","chr9","60811509","60811816","11","1559600"
"chr9","62382866","62383176","chr9","60823759","60824068","9","1559107"
"chr9","62385685","62385965","chr9","60826306","60826614","41","1559379"
"chr9","62386011","62386299","chr9","60826635","60826919","10","1559376"
"chr9","62389532","62389839","chr9","60830148","60830450","12","1559384"
"chr9","62395267","62395610","chr1","1258700","1259019","110","61136567"
"chr9","62405623","62405946","chr9","60845127","60845450","4","1560496"
"chr9","62415023","62415260","chr9","60855068","60855312","15","1559955"
"chr9","62415565","62415626","chr9","60855613","60855674","0","1559952"
"chr9","62416280","62416591","chr4","103468600","103468909","58","41052320"
"chr9","62435388","62435667","chr6","172818246","172818520","46","110382858"
"chr9","62471275","62471578","chr5","142565235","142565540","50","80093960"
"chr9","62488870","62489078","chr10","62176360","62176580","55","312510"
"chr9","62490802","62490992","chr17","87870105","87870293","39","25379303"
"chr9","62491298","62491429","chr11","120489731","120489854","26","57998433"
"chr9","62501063","62501172","chr3","40093454","40093554","38","22407609"
"chr9","62508443","62508758","chr9","60959557","60959871","10","1548886"
"chr9","62512501","62512745","chr9","60855068","60855312","28","1657433"
"chr9","62513048","62513109","chr9","60855613","60855674","3","1657435"
"chr9","62513546","62513715","chr2","187026390","187026555","39","124512844"
"chr9","62527150","62527431","chr9","60974810","60975091","6","1552340"
"chr9","62531287","62531580","chr7","130067300","130067592","49","67536013"
"chr9","62562543","62562706","chr11","131720798","131720962","31","69158255"
"chr9","62568012","62568314","chr9","61014025","61014328","8","1553987"
"chr9","62579557","62579837","chr9","61009509","61009789","3","1570048"
"chr9","62580705","62581002","chr9","61010659","61010956","6","1570046"
"chr9","62583939","62584236","chr9","61027769","61028066","6","1556170"
"chr9","62589570","62589712","chr3","39035056","39035216","38","23554514"
"chr9","62590867","62591150","JH680491","667","952","39","62590200"
"chr9","62592993","62593301","chr9","61045978","61046289","10","1547015"
"chr9","62595867","62596022","chr9","61048889","61049040","11","1546978"
"chr9","62596074","62596368","chr9","61049113","61049407","8","1546961"
"chr9","62607429","62607544","chr9","61068905","61069029","11","1538524"
"chr9","62608006","62608297","chr9","61069485","61069784","10","1538521"
"chr9","62608916","62609024","chrX","19749040","19749148","30","42859876"
"chr9","62609025","62609110","chr9","61070475","61070560","0","1538550"
"chr9","62609143","62609288","chr9","61070593","61070738","0","1538550"
"chr9","62609615","62609698","chr19","520624","520708","11","62088991"
"chr9","62612886","62613178","chr9","61074683","61074976","10","1538203"
"chr9","62617397","62617704","chr9","61079211","61079520","15","1538186"
"chr9","62623993","62624129","chr9","61086164","61086300","5","1537829"
"chr9","62624405","62624574","chr9","61086571","61086734","11","1537834"
"chr9","62625687","62626003","chr9","61087842","61088156","13","1537845"
"chr9","62629693","62629924","chr9","61092649","61092883","7","1537044"
"chr9","62634984","62635108","chr11","109293014","109293140","29","46658030"
"chr9","62635467","62635750","chr9","61098601","61098897","16","1536866"
"chr9","62648209","62648505","chr9","61112648","61112944","7","1535561"
"chr9","62658959","62659163","chr8","29191464","29191669","46","33467495"
"chr9","62661177","62661439","chr9","61126793","61127050","8","1534384"
"chr9","62661442","62661666","chr9","61127053","61127263","19","1534389"
"chr9","62661912","62661953","chr8","2732122","2732165","6","59929790"
"chr9","62670458","62670746","chr9","61135381","61135669","5","1535077"
"chr9","62674720","62675030","chr9","61140361","61140670","10","1534359"
"chr9","62677226","62677515","chr9","61143192","61143481","14","1534034"
"chr9","62678872","62678995","chr9","61144866","61144956","36","1534006"
"chr9","62683595","62683714","chr9","61150543","61150661","2","1533052"
"chr9","62684639","62684939","chr4","102309029","102309327","65","39624390"
"chr9","62686259","62686416","chr9","61153321","61153478","4","1532938"
"chr9","62693527","62693560","chr2","155954739","155954770","6","93261212"
"chr9","62693586","62693752","chr15","39862747","39862912","28","22830839"
"chr9","62694550","62694818","chr7","9730527","9730784","90","52964023"
"chr9","62715852","62716140","chr6","74238421","74238705","68","11522569"
"chr9","62724081","62724378","chr9","61193872","61194168","9","1530209"
"chr9","62727813","62727972","chr10","71661474","71661638","35","8933661"
"chr9","62739767","62739853","chr9","33792304","33792389","30","28947463"
"chr9","62747134","62747277","chr9","61217204","61217347","3","1529930"
"chr9","62759645","62759950","chr9","61229728","61230028","13","1529917"
"chr9","62761662","62761943","chr9","61231538","61231821","23","1530124"
"chr9","62765349","62765593","chr9","61235177","61235421","3","1530172"
"chr9","62771105","62771331","chr9","61241308","61241534","5","1529797"
"chr9","62771558","62771897","chr17","5011680","5011976","105","57759878"
"chr9","62777623","62777796","chr1","128840054","128840221","41","66062431"
"chr9","62779113","62779184","chr7","58985245","58985315","15","3793868"
"chr9","62786264","62786530","chr12","11137684","11137967","70","51648580"
"chr9","62787710","62787766","chr9","61258591","61258657","11","1529119"
"chr9","62791298","62791602","chr9","61262852","61263147","15","1528446"
"chr9","62793374","62793617","chr15","5787628","5787863","48","57005746"
"chr9","62795076","62795189","chr9","61266079","61266194","5","1528997"
"chr9","62795793","62795922","chr9","61266973","61267098","5","1528820"
"chr9","62808437","62808562","chr9","43471821","43471943","29","19336616"
"chr9","62814129","62814418","chr9","61286020","61286309","5","1528109"
"chr9","62814959","62815075","chr9","61286841","61286957","2","1528118"
"chr9","62821965","62822237","chr9","61294649","61294925","8","1527316"
"chr9","62823590","62823750","chr2","43194047","43194197","33","19629543"
"chr9","62825363","62825536","chr1","124613679","124613842","36","61788316"
"chr9","62828122","62828282","chr19","4403380","4403554","34","58424742"
"chr9","62828999","62829299","chr4","154948284","154948586","55","92119285"
"chr9","62832892","62833162","chr10","81577383","81577657","67","18744491"
"chr9","62837340","62837639","chr9","61304029","61304327","8","1533311"
"chr9","62845544","62845814","chr9","61319174","61319483","43","1526370"
"chr9","62864783","62864919","chr9","61341983","61342119","1","1522800"
"chr9","62865215","62865371","chr9","61342414","61342592","27","1522801"
"chr9","62866839","62867171","chr9","61343745","61344084","16","1523094"
"chr9","62873107","62873272","chr9","61353938","61354119","17","1519169"
"chr9","62889186","62889273","chr11","26523897","26523984","19","36365289"
"chr9","62892088","62892254","chr12","80509180","80509344","37","17617092"
"chr9","62892293","62892382","chr7","149399820","149399905","23","86507527"
"chr9","62894479","62894737","chr5","46044632","46044890","64","16849847"
"chr9","62907204","62907470","chr9","61388720","61388986","3","1518484"
"chr9","62915519","62915831","chr9","61404810","61405119","10","1510709"
"chr9","62941333","62941646","chr9","61427454","61427771","11","1513879"
"chr9","62945572","62945862","chr9","61431787","61432081","12","1513785"
"chr9","62948393","62948652","chr9","61434627","61434887","11","1513766"
"chr9","62951787","62951949","chr9","61439076","61439238","4","1512711"
"chr9","62952244","62952390","chr9","61437446","61437592","3","1514798"
"chr9","62958283","62958395","chr9","61444227","61444336","7","1514056"
"chr9","62958699","62958879","chr9","61444643","61444824","7","1514056"
"chr9","62964573","62964663","chr9","61450378","61450467","1","1514195"
"chr9","62968506","62968577","chr15","13500129","13500198","14","49468377"
"chr9","62968579","62968841","chr9","95186155","95186414","62","32217576"
"chr9","62970378","62970652","chr9","61458129","61458402","7","1512249"
"chr9","62972489","62972763","chr9","61458129","61458402","7","1514360"
"chr9","62974247","62974546","chr9","61459881","61460184","10","1514366"
"chr9","62982231","62982496","chr9","61469010","61469275","10","1513221"
"chr9","62982653","62982966","chr9","79994615","79994911","69","17011962"
"chr9","62983467","62983775","chr9","61470246","61470551","7","1513221"
"chr9","62983806","62983952","chr2","2876504","2876653","39","60107302"
"chr9","62996968","62997118","chr2","43194047","43194197","29","19802921"
"chr9","63000861","63001177","chr9","61486344","61486662","8","1514517"
"chr9","63006650","63006956","chr9","61492463","61492771","7","1514187"
"chr9","63007395","63007688","chr16","67509373","67509635","90","4501978"
"chr9","63009137","63009451","chr9","61494949","61495260","8","1514188"
"chr9","63017708","63017847","chr12","93529940","93530072","38","30512232"
"chr9","63024794","63025098","chr9","61511494","61511803","11","1513300"
"chr9","63031079","63031373","chr9","61516199","61516498","11","1514880"
"chr9","63064633","63064932","chr9","61554790","61555088","11","1509843"
"chr9","63079903","63080210","chr9","61562805","61563109","7","1517098"
"chr9","63104767","63105112","chr9","61596726","61597034","43","1508041"
"chr9","63121237","63121521","chr9","61613141","61613424","5","1508096"
"chr9","63148615","63148912","chr9","61639430","61639742","19","1509185"
"chr9","63153582","63153833","chr2","50890744","50890985","62","12262838"
"chr9","63166341","63166621","chr9","61661505","61661785","4","1504836"
"chr9","63188318","63188623","chr9","61683763","61684068","11","1504555"
"chr9","63201677","63201972","chr9","61697086","61697379","7","1504591"
"chr9","63204442","63204714","chr9","61699847","61700117","14","1504595"
"chr9","63205081","63205272","chr9","61700472","61700665","8","1504609"
"chr9","63208902","63209191","chr9","61704294","61704583","7","1504608"
"chr9","63210987","63211283","chr9","61706379","61706707","37","1504608"
"chr9","63212516","63212822","chr9","61707911","61708217","6","1504605"
"chr9","63221269","63221548","chr9","61716678","61716959","7","1504591"
"chr9","63226941","63227238","chr9","61721993","61722313","30","1504948"
"chr9","63243984","63244268","chr9","61739050","61739316","21","1504934"
"chr9","63263711","63264002","chr7","43370057","43370347","55","19893654"
"chr9","63282665","63282987","chr9","61777423","61777711","41","1505242"
"chr9","63289737","63290011","chr9","61784489","61784769","11","1505248"
"chr9","63291976","63292103","chr9","61786671","61786805","14","1505305"
"chr9","63293490","63293767","chr9","61788491","61788780","18","1504999"
"chr9","63307235","63307541","chr9","61802110","61802420","9","1505125"
"chr9","63309037","63309272","chr9","61803919","61804188","35","1505118"
"chr9","63321083","63321354","chr9","61815937","61816208","7","1505146"
"chr9","63332431","63332717","chr9","61827109","61827395","3","1505322"
"chr9","63334050","63334329","chr9","61828728","61829007","4","1505322"
"chr9","63339033","63339307","chr5","175210958","175211224","68","111871925"
"chr9","63344314","63344604","chr9","61839070","61839366","13","1505244"
"chr9","63361649","63361876","chr9","61854981","61855208","4","1506668"
"chr9","63380699","63380991","chr9","61874216","61874508","5","1506483"
"chr9","63381502","63381805","chr9","61875350","61875656","14","1506152"
"chr9","63385804","63386031","chr10","36845240","36845474","56","26540564"
"chr9","63389913","63390207","chr9","61883720","61884012","5","1506193"
"chr9","63435430","63435583","chr9","61931453","61931606","5","1503977"
"chr9","63452948","63453222","chr9","61947935","61948221","19","1505013"
"chr9","63459362","63459540","chr9","61954196","61954377","7","1505166"
"chr9","63478486","63478796","chr9","61972630","61972940","11","1505856"
"chr9","63479308","63479496","chr16","23061418","23061590","70","40417890"
"chr9","63483222","63483283","chr4","140933896","140933959","12","77450674"
"chr9","63491739","63492024","chr9","61986727","61987005","14","1505012"
"chr9","63492459","63492558","chr9","61987438","61987540","4","1505021"
"chr9","63503663","63503931","chr9","61999544","61999812","5","1504119"
"chr9","63504677","63504822","chr9","62000888","62001033","1","1503789"
"chr9","63505118","63505297","chr9","62001334","62001514","6","1503784"
"chr9","63530890","63531190","chr9","62033965","62034266","12","1496925"
"chr9","63538360","63538658","chr9","62045238","62045536","4","1493122"
"chr9","63544404","63544720","chr9","62051299","62051615","6","1493105"
"chr9","63555627","63555921","chr9","62062542","62062840","19","1493085"
"chr9","63563946","63564230","chr9","62071434","62071707","12","1492512"
"chr9","63582149","63582411","chr12","100377443","100377709","62","36795294"
"chr9","63585016","63585311","chr7","46249380","46249681","53","17335636"
"chr9","63586663","63586959","chr9","62093905","62094201","2","1492758"
"chr9","63602750","63603059","chr9","62110246","62110555","12","1492504"
"chr9","63603301","63603644","chr9","62110810","62111124","35","1492491"
"chr9","63604874","63605160","chr9","62112355","62112644","13","1492519"
"chr9","63605891","63605902","chr10","455759","455770","5","63150132"
"chr9","63606168","63606278","chr9","62113648","62113768","13","1492520"
"chr9","63617091","63617396","chr9","62124441","62124744","10","1492650"
"chr9","63672844","63673154","chr10","61952938","61953252","58","1719906"
"chr9","63732134","63732292","chr9","62241496","62241675","28","1490638"
"chr9","63758146","63758446","chr16","9926286","9926594","62","53831860"
"chr9","63804210","63804324","chr9","62312500","62312614","1","1491710"
"chr9","63804374","63804533","chr9","62312652","62312815","11","1491722"
"chr9","63818514","63818819","chr9","62332982","62333287","5","1485532"
"chr9","63905082","63905430","chr9","62418452","62418797","30","1486630"
"chr9","63908233","63908539","chr9","62421920","62422226","9","1486313"
"chr9","64015461","64015762","chr7","132337936","132338220","67","68322475"
"chr9","64083573","64083865","chr9","62606418","62606710","4","1477155"
"chr9","64114794","64115130","chr9","62637591","62637902","34","1477203"
"chr9","64115169","64115480","chr9","62637960","62638261","13","1477209"
"chr9","64170686","64170983","chr9","62697819","62698123","12","1472867"
"chr9","64171381","64171587","chr9","62698524","62698730","8","1472857"
"chr9","64171917","64172191","chr9","62699060","62699334","2","1472857"
"chr9","64178112","64178361","chr3","149465689","149465927","62","85287577"
"chr9","64187059","64187224","chr9","62719597","62719758","8","1467462"
"chr9","64199127","64199453","chr9","62732038","62732344","29","1467089"
"chr9","64301422","64301700","chr9","62838207","62838485","12","1463215"
"chr9","64325876","64325988","chr20","22725852","22725967","28","41600024"
"chr9","64326276","64326391","chr9","62863152","62863267","5","1463124"
"chr9","64539833","64540021","chr9","63090571","63090760","3","1449262"
"chr9","64671939","64672192","chr9","63228878","63229162","44","1443061"
"chr9","64678030","64678230","chr9","63234718","63234918","3","1443312"
"chr9","64716070","64716299","chr9","63272258","63272487","6","1443812"
"chr9","64831487","64831757","chr9","63392182","63392462","17","1439305"
"chr9","64968060","64968372","chr3","42315151","42315460","60","22652909"
"chr9","65059855","65059975","chr9","63633092","63633223","14","1426763"
"chr9","65060005","65060164","chr9","63633283","63633439","22","1426722"
"chr9","65153491","65153749","chr9","63730492","63730750","4","1422999"
"chr9","65178700","65179001","chr9","63755715","63756018","8","1422985"
"chr9","65354153","65354444","chr9","63930735","63931028","5","1423418"
"chr9","65362210","65362492","chr9","63938779","63939061","5","1423431"
"chr9","65401569","65401894","chr9","63978511","63978841","20","1423058"
"chr9","65485340","65485676","chr9","64064127","64064463","8","1421213"
"chr9","65546559","65546850","chr9","64125315","64125606","14","1421244"
"chr9","65741442","65741738","chr9","64324108","64324404","4","1417334"
"chr9","65906788","65907070","chr9","64491537","64491823","15","1415251"
"chr9","66007595","66007856","chr9","64592864","64593137","21","1414731"
"chr9","66018799","66019098","chr9","17454563","17454858","65","48564236"
"chr9","66043248","66043548","chr9","64628989","64629289","19","1414259"
"chr9","66058849","66059130","chr9","64644468","64644747","12","1414381"
"chr9","66090728","66091022","chr9","64676876","64677171","17","1413852"
"chr9","66146426","66146702","chr9","64734740","64735021","16","1411686"
"chr9","66517191","66517486","chr9","65102827","65103120","20","1414364"
"chr9","66628557","66628843","chr9","65220251","65220536","8","1408306"
"chr9","66630755","66631042","chr9","65222442","65222733","14","1408313"
"chr9","66635538","66635803","chr9","65228421","65228682","15","1407117"
"chr9","66700728","66701026","chrX","105819753","105820054","56","39119025"
"chr9","66802388","66802503","chr9","65395873","65395987","3","1406515"
"chr9","66802804","66802980","chr9","65396290","65396465","2","1406514"
"chr9","66838369","66838669","chr9","65431220","65431520","4","1407149"
"chr9","67124091","67124398","chr15","22361292","22361589","56","44762799"
"chr9","67331143","67331403","chr9","65940023","65940289","12","1391120"
"chr9","67440768","67440902","chr9","66036542","66036675","3","1404226"
"chr9","67441213","67441397","chr9","66036986","66037158","17","1404227"
"chr9","67447103","67447233","chr9","66042871","66043001","4","1404232"
"chr9","67480895","67481187","chr9","66076656","66076948","6","1404239"
"chr9","67507990","67508291","chr9","66105865","66106163","8","1402125"
"chr9","67513255","67513547","chr9","66111169","66111461","7","1402086"
"chr9","67521609","67521907","chr9","66119534","66119823","13","1402075"
"chr9","67532731","67532790","chr9","60855613","60855674","10","6677118"
"chr9","67533152","67533351","chr16","45301217","45301409","47","22231935"
"chr9","67538506","67538813","chr9","66136537","66136846","10","1401969"
"chr9","67548748","67549068","chrX","86830319","86830631","51","19281571"
"chr9","67549655","67549973","chr9","66147675","66147995","11","1401980"
"chr9","67569314","67569541","chr16","32165738","32165968","48","35403576"
"chr9","67573722","67574014","chr9","66171645","66171938","9","1402077"
"chr9","67582338","67582639","chr9","66181301","66181602","7","1401037"
"chr9","67598595","67598896","chr9","66199711","66200015","10","1398884"
"chr9","67606520","67606833","chrX","142116490","142116801","61","74509970"
"chr9","67614767","67615068","chr9","66216848","66217154","9","1397919"
"chr9","67617321","67617614","chr9","66219377","66219671","7","1397944"
"chr9","67647201","67647390","chr9","66240836","66241008","23","1406365"
"chr9","67647683","67647719","chr16","50138879","50138914","2","17508804"
"chr9","67651120","67651254","chr9","66252291","66252425","3","1398829"
"chr9","67651559","67651713","chr9","66252730","66252881","6","1398829"
"chr9","67664847","67665140","chr9","66265823","66266116","11","1399024"
"chr9","67665400","67665697","chr9","66266364","66266669","12","1399036"
"chr9","67674942","67675179","chr9","66276522","66276759","6","1398420"
"chr9","67680480","67680797","chr9","66282062","66282379","7","1398418"
"chr9","67680979","67681133","chr14","5991986","5992140","34","61688993"
"chr9","67693511","67693565","chrX","939789","939841","13","66753722"
"chr9","67693566","67693741","chr6","58082549","58082722","31","9611017"
"chr9","67698136","67698440","chr9","66300034","66300348","18","1398102"
"chr9","67715190","67715499","chr9","66317534","66317839","8","1397656"
"chr9","67722796","67723079","chr9","66325224","66325507","2","1397572"
"chr9","67723965","67724257","chr9","66326375","66326685","25","1397590"
"chr9","67759507","67759739","chr9","66362561","66362793","2","1396946"
"chr9","67765916","67766241","chr9","66368625","66368942","15","1397291"
"chr9","67801051","67801247","chr9","66404871","66405098","35","1396180"
"chr9","67801278","67801291","chr11","31518209","31518223","1","36283069"
"chr9","67830086","67830409","chr9","66434176","66434463","45","1395910"
"chr9","67834496","67834795","chr9","66438640","66438944","12","1395856"
"chr9","67842887","67843186","chrX","10212594","10212891","61","57630293"
"chr9","67846921","67847208","chr9","66451023","66451322","21","1395898"
"chr9","67892982","67893048","chr9","66497054","66497119","2","1395928"
"chr9","67896403","67896709","chr9","66500473","66500779","4","1395930"
"chr9","67906050","67906342","chr9","66510095","66510387","6","1395955"
"chr9","67928712","67928983","chr9","66532724","66532995","5","1395988"
"chr9","67929216","67929333","chr9","66533229","66533346","4","1395987"
"chr9","67929661","67929828","chr9","66533674","66533840","3","1395987"
"chr9","67930727","67931032","chr9","66535048","66535365","16","1395679"
"chr9","67935030","67935106","chr2","98163452","98163527","21","30228422"
"chr9","67951500","67951783","chr9","66555544","66555855","48","1395956"
"chr9","67959497","67959746","chr9","66563279","66563529","11","1396218"
"chr9","67960883","67961145","chr9","66564625","66564885","7","1396258"
"chr9","67965428","67965735","chr9","66568827","66569135","9","1396601"
"chr9","67976505","67976665","chr9","66580497","66580656","7","1396008"
"chr9","67980357","67980594","chr3","85054326","85054571","56","17073969"
"chr9","67990634","67990870","chr1","13263290","13263541","61","54727344"
"chr9","67991011","67991090","chr9","66593843","66593922","3","1397168"
"chr9","67994435","67994596","chr9","66597567","66597728","1","1396868"
"chr9","67995329","67995615","chr9","66598463","66598749","4","1396866"
"chr9","68002367","68002659","chr9","66611032","66611325","7","1391335"
"chr9","68018307","68018599","chr9","66611032","66611325","7","1407275"
"chr9","68027021","68027310","chr9","66629333","66629620","9","1397688"
"chr9","68030793","68031079","chr9","66633101","66633395","14","1397692"
"chr9","68046473","68046755","chr9","66650058","66650347","12","1396415"
"chr9","68046771","68047079","chr9","66650363","66650688","25","1396408"
"chr9","68068026","68068204","chr9","66671582","66671773","17","1396444"
"chr9","68068516","68068602","chr9","66672082","66672168","0","1396434"
"chr9","68095984","68096147","chr9","66700561","66700724","2","1395423"
"chr9","68105654","68105869","chr9","66709888","66710103","6","1395766"
"chr9","68109907","68110080","chr9","66714136","66714306","7","1395771"
"chr9","68110360","68110503","chr9","66714586","66714725","9","1395774"
"chr9","68117142","68117412","chr9","66721677","66721947","7","1395465"
"chr9","68122841","68123148","chr9","66727099","66727399","16","1395742"
"chr9","68149423","68149712","chr9","66753996","66754278","11","1395427"
"chr9","68162838","68163129","chr8","36041346","36041638","50","32121492"
"chr9","68166155","68166428","chr9","66769513","66769785","10","1396642"
"chr9","68166716","68167010","chr9","66770076","66770370","7","1396640"
"chr9","68168109","68168411","chr3","3692905","3693188","80","64475204"
"chr9","68171518","68171785","chr9","66774888","66775164","11","1396630"
"chr9","68186965","68187274","chr9","66790322","66790637","13","1396643"
"chr9","68200457","68200520","chr9","66802193","66802256","0","1398264"
"chr9","68212753","68212814","chr7","72859659","72859719","13","4646906"
"chr9","68212935","68213154","chr1","124198622","124198834","49","55985687"
"chr9","68219352","68219639","chr9","66821269","66821558","12","1398083"
"chr9","68244972","68245119","chr15","88391020","88391164","32","20146048"
"chr9","68245347","68245491","chr3","9571934","9572075","34","58673413"
"chr9","68254884","68255194","chr4","152226280","152226592","63","83971396"
"chr9","68256798","68257098","chr9","66857157","66857456","9","1399641"
"chr9","68270371","68270677","chr9","66870881","66871199","19","1399490"
"chr9","68281861","68282173","chr9","66882555","66882868","4","1399306"
"chr9","68303903","68304034","chr9","66904602","66904734","8","1399301"
"chr9","68305274","68305585","chr9","66906317","66906629","10","1398957"
"chr9","68319339","68319649","chr9","66920254","66920557","10","1399085"
"chr9","68323775","68324091","chr9","66924962","66925280","17","1398813"
"chr9","68337178","68337463","chr9","66938894","66939180","12","1398284"
"chr9","68354222","68354493","chr9","66956621","66956892","7","1397601"
"chr9","68388136","68388433","chr9","66990545","66990845","16","1397591"
"chr9","68399052","68399338","chr9","67001789","67002093","26","1397263"
"chr9","68412167","68412457","chr9","67014675","67014965","8","1397492"
"chr9","68497290","68497591","chr9","67101862","67102168","20","1395428"
"chr9","68499615","68499907","chr9","67104204","67104511","17","1395411"
"chr9","68603682","68603903","chr4","7639543","7639764","34","60964139"
"chr9","68682657","68682949","chr9","67287891","67288182","10","1394766"
"chr9","68707430","68707755","chr9","67312610","67312921","18","1394820"
"chr9","68740821","68741141","chr9","67346601","67346880","48","1394220"
"chr9","68809794","68809987","chr3","74910026","74910222","45","6100232"
"chr9","68964751","68964967","chr9","67585961","67586205","36","1378790"
"chr9","69008818","69008981","chr13","60228118","60228270","34","8780700"
"chr9","69009019","69009143","chr6","168702580","168702698","26","99693561"
"chr9","69023841","69024145","chr9","67652022","67652326","6","1371819"
"chr9","69039334","69039643","chr9","67667961","67668270","11","1371373"
"chr9","69047578","69047732","chr9","67676265","67676416","9","1371313"
"chr9","69047999","69048154","chr9","67676683","67676836","5","1371316"
"chr9","69055109","69055394","chr9","67683820","67684105","5","1371289"
"chr9","69057036","69057259","chr9","67685750","67685974","3","1371286"
"chr9","69077792","69077802","chr4","112312623","112312633","1","43234831"
"chr9","69077835","69078114","chr9","67705732","67706042","36","1372103"
"chr9","69078413","69078483","chr20","4103197","4103263","14","64975216"
"chr9","69113474","69113770","chr9","67741502","67741798","11","1371972"
"chr9","69160917","69161211","chr9","67788504","67788801","6","1372413"
"chr9","69178668","69178964","chr9","67806405","67806714","21","1372263"
"chr9","69200136","69200292","chr9","67828734","67828894","6","1371402"
"chr9","69200586","69200711","chr9","67829190","67829315","1","1371396"
"chr9","69208943","69209182","chr9","67837541","67837779","13","1371402"
"chr9","69273534","69273809","chr9","67898767","67899042","2","1374767"
"chr9","69326779","69326882","chr9","67951734","67951841","4","1375045"
"chr9","69351220","69351384","chr9","67976445","67976609","1","1374775"
"chr9","69354817","69355101","chr9","67980018","67980300","5","1374799"
"chr9","69361743","69361921","chrX","1974259","1974432","29","67387484"
"chr9","69396155","69396456","chr9","68020903","68021194","17","1375252"
"chr9","69464970","69465086","chr16","25279110","25279230","26","44185860"
"chr9","69468057","69468114","chr1","86128485","86128542","12","16660428"
"chr9","69481064","69481369","chr9","68107777","68108082","10","1373287"
"chr9","69491608","69491888","chr1","159614491","159614771","53","90122883"
"chr9","69596497","69596778","chr9","68224801","68225083","6","1371696"
"chr9","69598788","69599094","chr9","68227088","68227394","4","1371700"
"chr9","69679565","69679711","chr9","68307717","68307861","7","1371848"
"chr9","69683367","69683475","chr9","68312754","68312867","8","1370613"
"chr9","69855319","69855602","chr9","68489847","68490130","7","1365472"
"chr9","69928785","69928801","chr12","83941902","83941919","2","14013117"
"chr9","69928830","69929122","chr9","68563907","68564242","53","1364923"
"chr9","70002644","70002957","chr9","71417547","71417864","9","1414903"
"chr9","70031499","70031767","chr9","68662979","68663260","25","1368520"
"chr9","70051905","70052203","chr9","68684898","68685197","13","1367007"
"chr9","70159942","70160049","chr9","68796517","68796624","4","1363425"
"chr9","70217713","70218028","chr9","68854520","68854836","30","1363193"
"chr9","70222138","70222392","chr9","68858971","68859225","10","1363167"
"chr9","70308231","70308525","chr9","68944351","68944645","10","1363880"
"chr9","70432516","70432829","chr9","69067184","69067473","29","1365332"
"chr9","70463734","70464029","chr9","69098233","69098528","6","1365501"
"chr9","70480058","70480322","chr9","69114517","69114782","5","1365541"
"chr9","70486248","70486544","chr9","69120806","69121110","15","1365442"
"chr9","70496131","70496315","chr3","38843107","38843273","59","31653024"
"chr9","70506443","70506739","chr9","69141150","69141446","2","1365293"
"chr9","70542230","70542411","chr1","158523131","158523311","33","87980901"
"chr9","70562381","70562684","chr9","69191970","69192273","7","1370411"
"chr9","70566498","70566766","chr9","69196098","69196359","10","1370400"
"chr9","70573531","70573845","chr9","69202907","69203219","8","1370624"
"chr9","70577231","70577515","chr9","69206576","69206884","27","1370655"
"chr9","70628032","70628203","chr20","17236993","17237163","42","53391039"
"chr9","70631024","70631306","chr9","69257251","69257534","10","1373773"
"chr9","70632686","70632828","chr7","18591326","18591471","32","52041360"
"chr9","70682724","70682999","chr9","69311289","69311568","12","1371435"
"chr9","70690508","70690552","chr10","72806962","72807001","11","2116454"
"chr9","70690586","70690643","chr1","140487977","140488026","16","69797391"
"chr9","70693022","70693299","chr9","69321947","69322224","6","1371075"
"chr9","70783818","70784101","chr9","69412550","69412830","10","1371268"
"chr9","70785168","70785451","chr9","69413750","69414029","16","1371418"
"chr9","70799352","70799638","chr9","69428224","69428520","34","1371128"
"chr9","70816876","70817178","chr9","69445930","69446233","10","1370946"
"chr9","70819057","70819361","chr9","69448556","69448860","11","1370501"
"chr9","70837675","70837853","chr9","69466948","69467130","10","1370727"
"chr9","70837879","70837997","chr9","69467202","69467326","9","1370677"
"chr9","70869000","70869300","chr9","69498761","69499059","12","1370239"
"chr9","70922685","70922979","chr14","10142782","10143080","65","60779903"
"chr9","70930018","70930327","chr9","69560097","69560398","14","1369921"
"chr9","70961829","70962062","chr9","69591684","69591947","37","1370145"
"chr9","70991568","70991796","chr9","69620269","69620547","56","1371299"
"chr9","70993835","70994105","chr4","33245653","33245929","64","37748182"
"chr9","71070759","71070878","chr9","69700514","69700633","2","1370245"
"chr9","71093036","71093185","chr9","69722847","69722995","4","1370189"
"chr9","71098006","71098239","chr7","111499763","111500000","67","40401757"
"chr9","71104719","71105047","chr9","69733757","69734051","41","1370962"
"chr9","71122580","71122797","chr11","130089781","130089993","49","58967201"
"chr9","71158922","71159214","chr9","69788026","69788321","5","1370896"
"chr9","71166954","71167244","chr9","69796077","69796367","10","1370877"
"chr9","71216212","71216517","chr9","69845504","69845803","22","1370708"
"chr9","71223922","71224159","chr9","69853188","69853471","56","1370734"
"chr9","71273210","71273436","chr9","69902330","69902556","2","1370880"
"chr9","71295830","71296130","chr9","69925207","69925510","16","1370623"
"chr9","71306673","71306967","chr9","69936284","69936576","7","1370389"
"chr9","71310081","71310380","chr9","69939640","69939939","7","1370441"
"chr9","71328550","71328804","chr9","69958463","69958717","11","1370087"
"chr9","71333677","71333862","chr9","69963938","69964123","5","1369739"
"chr9","71344451","71344765","chr9","69977138","69977452","7","1367313"
"chr9","71396554","71396846","chr9","70019436","70019733","10","1377118"
"chr9","71422974","71423088","chr9","70046652","70046766","2","1376322"
"chr9","71423139","71423312","chr9","70046789","70046964","16","1376350"
"chr9","71429771","71429930","chr9","70053409","70053568","3","1376362"
"chr9","71430226","71430371","chr9","70053860","70054008","5","1376366"
"chr9","71453934","71454229","chr9","70077545","70077849","18","1376389"
"chr9","71508374","71508663","chr9","70133403","70133690","14","1374971"
"chr9","71526643","71526918","chr9","70152719","70152990","7","1373924"
"chr9","71550630","71550642","chr2","69403273","69403283","3","2147357"
"chr9","71550645","71550949","chr9","70186160","70186461","17","1364485"
"chr9","71555491","71555812","chr9","70191182","70191499","8","1364309"
"chr9","71579383","71579528","chr9","70214185","70214330","11","1365198"
"chr9","71583231","71583481","chr9","70218029","70218279","3","1365202"
"chr9","71595218","71595400","chr9","70230156","70230334","7","1365062"
"chr9","71603975","71604264","chr9","70238569","70238879","36","1365406"
"chr9","71659640","71659887","chr9","70294646","70294926","38","1364994"
"chr9","71670278","71670554","chr9","70305114","70305398","16","1365164"
"chr9","71692369","71692681","chr9","70326812","70327124","14","1365557"
"chr9","71701286","71701456","chr9","70335561","70335728","10","1365725"
"chr9","71701501","71701619","chr9","70335776","70335894","6","1365725"
"chr9","71704172","71704299","chr9","70338769","70338895","6","1365403"
"chr9","71718189","71718338","chr9","70353078","70353246","23","1365111"
"chr9","71758383","71758552","chr9","11882725","11882893","37","59875658"
"chr9","71837058","71837352","chr9","70473626","70473921","7","1363432"
"chr9","72254700","72254816","chr9","70894014","70894133","6","1360686"
"chr9","72254859","72255009","chr9","70894171","70894320","2","1360688"
"chr9","72304278","72304584","chr9","70943777","70944078","8","1360501"
"chr9","72305576","72305926","chr9","70945155","70945413","94","1360421"
"chr9","72419870","72420178","chr9","71061181","71061479","30","1358689"
"chr9","72437342","72437644","chr9","71080763","71081065","13","1356579"
"chr9","72491577","72491717","chr9","71140952","71141092","3","1350625"
"chr9","72496314","72496625","chr9","71145770","71146075","14","1350544"
"chr9","72506041","72506345","chr9","71155555","71155864","12","1350486"
"chr9","72524134","72524415","chr9","71172338","71172619","9","1351796"
"chr9","72566498","72566783","chr7","109446133","109446413","55","36879635"
"chr9","72571936","72572227","chr9","71224447","71224739","8","1347489"
"chr9","72594076","72594376","chr9","71246654","71246951","12","1347422"
"chr9","72652545","72652829","chr17","68838851","68839137","58","3813694"
"chr9","72655586","72655791","chr9","71304866","71305074","7","1350720"
"chr9","72674968","72675209","chr9","71324271","71324512","4","1350697"
"chr9","72675519","72675611","chr9","71324822","71324914","0","1350697"
"chr9","72754742","72755011","chr9","71404528","71404796","6","1350214"
"chr9","72832169","72832450","chr9","71486098","71486379","5","1346071"
"chr9","72854452","72854776","chr9","71508254","71508565","19","1346198"
"chr9","72872592","72872877","chr9","71526676","71526963","10","1345916"
"chr9","72895076","72895346","chr18","16208325","16208588","56","56686751"
"chr9","72905811","72906112","chr9","71561943","71562247","7","1343868"
"chr9","72906741","72907040","chr9","71562874","71563171","7","1343867"
"chr9","72973812","72973900","chr11","52148157","52148238","25","20825655"
"chr9","72997645","72997881","chr9","71655443","71655676","26","1342202"
"chr9","73014674","73014879","chr9","71672713","71672919","9","1341961"
"chr9","73019038","73019154","chr9","37866413","37866529","17","35152625"
"chr9","73039162","73039469","chr9","71698546","71698854","17","1340616"
"chr9","73057554","73057831","chr9","71716892","71717155","19","1340662"
"chr9","73057844","73058008","chr11","15162048","15162193","46","57895796"
"chr9","73081368","73081659","chr9","71740853","71741145","6","1340515"
"chr9","73085521","73085631","chr13","4102971","4103078","23","68982550"
"chr9","73165603","73165765","chr9","71825051","71825215","5","1340552"
"chr9","73165774","73166090","chr9","71825224","71825540","7","1340550"
"chr9","73210185","73210489","chr9","71867942","71868246","17","1342243"
"chr9","73219818","73220115","chr9","71877591","71877882","15","1342227"
"chr9","73258537","73258832","chr9","71916382","71916674","15","1342155"
"chr9","73285477","73285764","chr9","71943686","71943971","7","1341791"
"chr9","73291666","73291874","chr9","71949849","71950051","8","1341817"
"chr9","73312306","73312621","chr13","73478349","73478658","70","166043"
"chr9","73319174","73319355","chr9","71979488","71979669","2","1339686"
"chr9","73360857","73361151","chr9","72021946","72022238","8","1338911"
"chr9","73379326","73379606","chr9","72041605","72041886","5","1337721"
"chr9","73626050","73626339","chr9","72295346","72295635","11","1330704"
"chr9","74000844","74000995","chr9","72667524","72667679","10","1333320"
"chr9","74045267","74045538","chr9","72711970","72712241","5","1333297"
"chr9","74137522","74137673","chr3","160740675","160740837","36","86603153"
"chr9","74156604","74156696","chr9","72845265","72845357","3","1311339"
"chr9","74253566","74253721","chr9","72940261","72940415","4","1313305"
"chr9","74297381","74297664","chr9","72983705","72983989","9","1313676"
"chr9","74397755","74398057","chr12","103049769","103050069","65","28652014"
"chr9","74747512","74747651","chr9","73437934","73438070","3","1309578"
"chr9","74838514","74838855","chr9","73535970","73536293","24","1302544"
"chr9","74876931","74877116","chr9","73575378","73575563","7","1301553"
"chr9","75010080","75010283","chr9","73709887","73710091","8","1300193"
"chr9","75183349","75183662","chr9","73868153","73868442","43","1315196"
"chr9","75202379","75202678","chr9","73887163","73887462","18","1315216"
"chr9","75328223","75328532","chrX","117301386","117301698","72","41973163"
"chr9","75420237","75420500","chr13","23963301","23963557","11","51456936"
"chr9","75518043","75518327","chr9","74172449","74172734","14","1345594"
"chr9","75623640","75623915","chr9","74277881","74278159","6","1345759"
"chr9","75679516","75679789","chr9","74333959","74334245","20","1345557"
"chr9","75767402","75767693","chr9","74421675","74421968","15","1345727"
"chr9","75801182","75801441","chr7","110863277","110863528","65","35062095"
"chr9","75897229","75897544","chr13","84452913","84453227","70","8555684"
"chr9","76008298","76008568","chr9","74671042","74671312","11","1337256"
"chr9","76013319","76013624","chr9","74675494","74675825","36","1337825"
"chr9","76031523","76031760","chr9","74693424","74693670","16","1338099"
"chr9","76078072","76078190","chr6","116854167","116854277","36","40776095"
"chr9","76090373","76090680","chr9","74756129","74756433","13","1334244"
"chr9","76191368","76191648","chr9","74868763","74869086","52","1322605"
"chr9","76194053","76194369","chr2","68516022","68516333","68","7678031"
"chr9","76197178","76197331","chr8","28902234","28902382","27","47294944"
"chr9","76197360","76197476","chr13","60731646","60731762","19","15465714"
"chr9","76205801","76206143","chr9","74883196","74883503","42","1322605"
"chr9","76348495","76348752","chr4","81009580","81009821","66","4661085"
"chr9","76488861","76488990","chr9","75171291","75171417","5","1317570"
"chr9","76525455","76525575","chr9","75217049","75217169","2","1308406"
"chr9","76638273","76638547","chr9","75331163","75331449","23","1307110"
"chr9","76659300","76659598","chrX","105819753","105820054","65","29160453"
"chr9","76991796","76992086","chr10","13844876","13845167","73","63146920"
"chr9","77121101","77121415","chr16","57924277","57924585","75","19196824"
"chr9","77184874","77185186","chr9","75809606","75809910","19","1375268"
"chr9","77204271","77204575","chr9","75828769","75829071","15","1375502"
"chr9","77355165","77355301","chr9","75988278","75988414","6","1366887"
"chr9","77449574","77449585","chr1","15101615","15101626","2","62347959"
"chr9","77449615","77449897","chr9","76087417","76087726","37","1362198"
"chr9","77489562","77489826","chr9","76128062","76128326","4","1361500"
"chr9","77533908","77534188","chr9","76172944","76173237","20","1360964"
"chr9","77572826","77573163","chr9","106530616","106530926","91","28957790"
"chr9","77594096","77594382","chr9","76232265","76232556","13","1361831"
"chr9","77597445","77597662","chr9","76235982","76236197","9","1361463"
"chr9","77678075","77678380","chr9","76312608","76312915","12","1365467"
"chr9","77723466","77723768","chr4","109377890","109378185","65","31654424"
"chr9","77766102","77766398","chr9","76409756","76410053","19","1356346"
"chr9","77819476","77819791","chr9","76464027","76464342","13","1355449"
"chr9","77862136","77862433","chr9","76505014","76505310","20","1357122"
"chr9","77874772","77874814","chr9","76517632","76517674","4","1357140"
"chr9","77874848","77874986","chr9","76517706","76517857","15","1357142"
"chr9","77940290","77940559","chr9","76572294","76572561","7","1367996"
"chr9","77945434","77945727","chr9","76576483","76576775","10","1368951"
"chr9","77950167","77950468","chr9","76581800","76582101","5","1368367"
"chr9","78103635","78103970","chr9","76743437","76743742","44","1360198"
"chr9","78122326","78122616","chr9","76762487","76762777","9","1359839"
"chr9","78131779","78132054","chr9","76772833","76773115","33","1358946"
"chr9","78148422","78148575","chr9","76789917","76790034","39","1358505"
"chr9","78160972","78161252","chr9","76802699","76802979","10","1358273"
"chr9","78178210","78178547","chr9","76820168","76820505","16","1358042"
"chr9","78179354","78179488","chr9","76821328","76821447","18","1358026"
"chr9","78183437","78183748","chr9","76825289","76825591","24","1358148"
"chr9","78191667","78191974","chr9","76832518","76832826","21","1359149"
"chr9","78196094","78196373","chr9","76836950","76837229","11","1359144"
"chr9","78203446","78203724","chr9","76844484","76844761","8","1358962"
"chr9","78220392","78220735","chr9","76861002","76861345","7","1359390"
"chr9","78263774","78264050","chr9","76898486","76898762","7","1365288"
"chr9","78312451","78312740","chr9","76944916","76945209","14","1367535"
"chr9","78361879","78362190","chr9","76986466","76986777","12","1375413"
"chr9","78426103","78426290","chr10","12263463","12263647","55","66162640"
"chr9","78432685","78432978","chr9","77055893","77056184","7","1376792"
"chr9","78469386","78469673","chr9","77092012","77092299","3","1377374"
"chr9","78521036","78521336","chr9","77142779","77143078","6","1378257"
"chr9","78666099","78666401","chr7","122254516","122254824","77","43588417"
"chr9","78724864","78725169","chr9","77350238","77350529","24","1374626"
"chr9","78752808","78753105","chr9","77377070","77377366","8","1375738"
"chr9","78820482","78820552","chr9","77444822","77444886","8","1375660"
"chr9","78843552","78843842","chr9","77467809","77468098","10","1375743"
"chr9","78856883","78857037","chr9","77481409","77481563","3","1375474"
"chr9","78897765","78898040","chr9","77520695","77521003","40","1377070"
"chr9","78921298","78921567","chr9","77543706","77543975","13","1377592"
"chr9","79096781","79097086","chr9","77719445","77719754","12","1377336"
"chr9","79100989","79101171","chr9","77723650","77723834","3","1377339"
"chr9","79225995","79226293","chr9","77843237","77843544","18","1382758"
"chr9","79256350","79256396","chr3","127549410","127549458","6","48293060"
"chr9","79256397","79256589","chr4","24548983","24549171","44","54707414"
"chr9","79279871","79279920","chr7","4350753","4350803","16","74929118"
"chr9","79322422","79322717","chr9","77940064","77940363","25","1382358"
"chr9","79348784","79349091","chr9","77966491","77966798","7","1382293"
"chr9","79402172","79402457","chr9","78022411","78022713","27","1379761"
"chr9","79417770","79418071","chr9","78038113","78038420","21","1379657"
"chr9","79418150","79418412","chr9","78038499","78038761","10","1379651"
"chr9","79421888","79422184","chr9","78042495","78042788","35","1379393"
"chr9","79433008","79433309","chr9","78054060","78054362","22","1378948"
"chr9","79436772","79437082","chr9","78057853","78058182","27","1378919"
"chr9","79467952","79468266","chr9","78089088","78089404","29","1378864"
"chr9","79474803","79475086","chr9","78095936","78096219","8","1378867"
"chr9","79531682","79531914","chr11","44707573","44707813","49","34824109"
"chr9","79559929","79560203","chr2","60417120","60417375","72","19142809"
"chr9","79601618","79601801","chrX","15566621","15566795","47","64034997"
"chr9","79601842","79601959","chr10","71787480","71787597","19","7814362"
"chr9","79685174","79685310","chr9","78302497","78302633","6","1382677"
"chr9","79722514","79722697","chr8","7932406","7932588","33","71790108"
"chr9","79722737","79722774","chr11","131491556","131491594","9","51768819"
"chr9","79885258","79885566","chr9","78512484","78512790","12","1372774"
"chr9","79893448","79893761","chr9","78520520","78520841","24","1372928"
"chr9","79938473","79938797","chr9","78565227","78565535","18","1373246"
"chr9","79995513","79995804","chr9","78622680","78622972","8","1372833"
"chr9","80046995","80047285","chr9","78675049","78675341","12","1371946"
"chr9","80064026","80064308","chr9","78692820","78693083","24","1371206"
"chr9","80083776","80084092","chr9","78712490","78712808","26","1371286"
"chr9","80156433","80156586","chr5","5286846","5286983","39","74869587"
"chr9","80158623","80158909","chr9","78786866","78787152","6","1371757"
"chr9","80231437","80231737","chr9","78858111","78858403","14","1373326"
"chr9","80234244","80234541","chr9","78860928","78861221","13","1373316"
"chr9","80240182","80240319","chr13","84752135","84752271","23","4511953"
"chr9","80309165","80309408","chr9","78948002","78948246","7","1361163"
"chr9","80332060","80332349","chr9","78971102","78971381","21","1360958"
"chr9","80369657","80369953","chr9","67208223","67208521","63","13161434"
"chr9","80449272","80449571","chr9","79083046","79083345","9","1366226"
"chr9","80494879","80495104","chr9","79129361","79129584","6","1365518"
"chr9","80523301","80523580","chr9","79158122","79158402","12","1365179"
"chr9","80551416","80551677","chr9","79185479","79185750","27","1365937"
"chr9","80583338","80583640","chr9","79218011","79218314","9","1365327"
"chr9","80594262","80594552","chr9","79228815","79229104","5","1365447"
"chr9","80622115","80622155","chr1","55224051","55224090","9","25398064"
"chr9","80622158","80622317","chr9","79256338","79256503","29","1365820"
"chr9","80716030","80716327","chr9","79350422","79350709","20","1365608"
"chr9","80731673","80731955","chr9","79365903","79366183","8","1365770"
"chr9","80800063","80800355","chr9","79435126","79435419","7","1364937"
"chr9","80818081","80818098","chr6","154319045","154319061","3","73500964"
"chr9","80818161","80818307","chr19","2345059","2345207","30","78473102"
"chr9","80818335","80818439","chr1","44731342","44731445","23","36086993"
"chr9","80820151","80820447","chr9","79455110","79455411","10","1365041"
"chr9","80828779","80829089","chr9","79464001","79464290","26","1364778"
"chr9","80832569","80832859","chr14","3387026","3387321","51","77445543"
"chr9","80838643","80838927","chr9","79473736","79474020","8","1364907"
"chr9","80860580","80860870","chr9","79492036","79492330","15","1368544"
"chr9","80865451","80865777","chr10","13166562","13166889","67","67698889"
"chr9","80910140","80910439","chr9","79541697","79541996","3","1368443"
"chr9","80928059","80928307","chr9","79559619","79559867","6","1368440"
"chr9","80952108","80952247","chr9","79598309","79598448","3","1353799"
"chr9","80974016","80974299","chr9","79620463","79620778","37","1353553"
"chr9","80980743","80981054","chr9","79627131","79627443","10","1353612"
"chr9","80981818","80982117","chr9","79628209","79628510","8","1353609"
"chr9","81018014","81018312","chr9","79664824","79665126","10","1353190"
"chr9","81021013","81021309","chr16","21320831","21321123","55","59700182"
"chr9","81034683","81034971","chr9","79681641","79681921","17","1353042"
"chr9","81035826","81036121","chr9","79682776","79683068","8","1353050"
"chr9","81057583","81057880","chr9","79704954","79705260","20","1352629"
"chr9","81059606","81059898","chr9","79707425","79707717","3","1352181"
"chr9","81065914","81066242","chr9","79713712","79714052","27","1352202"
"chr9","81068833","81068990","chr7","149431087","149431239","44","68362254"
"chr9","81069022","81069069","chr10","31369460","31369504","9","49699562"
"chr9","81093448","81093760","chr9","79741364","79741660","24","1352084"
"chr9","81109581","81109862","chr9","79757551","79757862","36","1352030"
"chr9","81122464","81122762","chr9","79770426","79770725","9","1352038"
"chr9","81142951","81143254","chr9","79790846","79791142","11","1352105"
"chr9","81149021","81149322","chr9","79796889","79797194","14","1352132"
"chr9","81155024","81155311","chr9","79803204","79803491","2","1351820"
"chr9","81176323","81176622","chr9","79824744","79825040","6","1351579"
"chr9","81182085","81182239","chr5","1888026","1888179","38","79294059"
"chr9","81182830","81183111","chr9","79831231","79831510","11","1351599"
"chr9","81205920","81206211","chr9","79853946","79854233","6","1351974"
"chr9","81219206","81219509","chr9","79867267","79867571","10","1351939"
"chr9","81226184","81226429","chr9","79874571","79874841","28","1351613"
"chr9","81226551","81226852","chr9","79874938","79875239","5","1351613"
"chr9","81232799","81233082","chr9","79881429","79881735","34","1351370"
"chr9","81233163","81233175","chr1","15101615","15101626","1","66131548"
"chr9","81262857","81263150","chr9","79911410","79911702","8","1351447"
"chr9","81286452","81286750","chr9","79934481","79934775","9","1351971"
"chr9","81297772","81298068","chr9","79945024","79945326","16","1352748"
"chr9","81335308","81335601","chr9","79982257","79982545","16","1353051"
"chr9","81336140","81336435","chr9","79983084","79983380","4","1353056"
"chr9","81347879","81348175","chr9","79994615","79994911","10","1353264"
"chr9","81363430","81363725","chr9","80010207","80010521","22","1353223"
"chr9","81407947","81408254","chr9","80055433","80055735","11","1352514"
"chr9","81424084","81424355","chr9","80071489","80071755","9","1352595"
"chr9","81433589","81433895","chr9","80080680","80080986","12","1352909"
"chr9","81448674","81448981","chr9","80095735","80096042","6","1352939"
"chr9","81464233","81464526","chr9","80111399","80111692","6","1352834"
"chr9","81490145","81490303","chr9","92923276","92923427","26","11433131"
"chr9","81498992","81499301","chr9","80146497","80146802","6","1352495"
"chr9","81601458","81601688","chr9","80248401","80248628","10","1353057"
"chr9","81651096","81651371","chr9","80297680","80297958","10","1353416"
"chr9","81727044","81727342","chr1","202638456","202638752","65","120911412"
"chr9","82029971","82030140","chr11","49450864","49451029","31","32579107"
"chr9","82030166","82030207","chr1","36725977","36726016","9","45304189"
"chr9","82078909","82079029","chr9","80730275","80730395","5","1348634"
"chr9","82084011","82084279","chr9","80735358","80735628","4","1348653"
"chr9","82145614","82145896","chr9","80801213","80801521","34","1344401"
"chr9","82149082","82149392","chr9","80804703","80805009","11","1344379"
"chr9","82214073","82214385","chr9","80869848","80870160","13","1344225"
"chr9","82219442","82219740","chr9","80875210","80875513","8","1344232"
"chr9","82294231","82294552","chr9","80947667","80947976","21","1346564"
"chr9","82298827","82299114","chr9","80951927","80952214","3","1346900"
"chr9","82310563","82310865","chr9","80963642","80963942","12","1346921"
"chr9","82329762","82330045","chr9","80985751","80986034","10","1344011"
"chr9","82343543","82343863","chr13","41851851","41852159","68","40491692"
"chr9","82468071","82468186","chr7","17489983","17490098","34","64978088"
"chr9","82508704","82508992","chr9","81167657","81167946","7","1341047"
"chr9","82542434","82542588","chr19","8561853","8561997","41","73980581"
"chr9","82656089","82656374","chr9","81329177","81329458","16","1326912"
"chr9","82696149","82696474","chr9","81369789","81370120","26","1326360"
"chr9","82706727","82707040","chr9","81380323","81380629","17","1326404"
"chr9","82722280","82722576","chr9","81397360","81397656","10","1324920"
"chr9","82741962","82742263","chr9","81415189","81415491","10","1326773"
"chr9","82760053","82760342","chr9","81433958","81434247","3","1326095"
"chr9","82773874","82774181","chr9","81457906","81458200","23","1315968"
"chr9","82784867","82785157","chr9","81468841","81469132","10","1316026"
"chr9","82798371","82798665","chr9","81482295","81482588","11","1316076"
"chr9","82800419","82800750","chr9","81484323","81484656","17","1316096"
"chr9","82825613","82825907","chr9","81509706","81510006","25","1315907"
"chr9","82856020","82856333","chr9","81540080","81540395","22","1315940"
"chr9","82881195","82881377","chr9","81565309","81565490","8","1315886"
"chr9","82909008","82909173","chr9","81593698","81593863","3","1315310"
"chr9","82915829","82916128","chr9","81600229","81600535","10","1315600"
"chr9","82921549","82921862","chr9","81605798","81606107","13","1315751"
"chr9","82925201","82925493","chr9","81609264","81609573","22","1315937"
"chr9","82978260","82978554","chr9","81661290","81661579","12","1316970"
"chr9","82991484","82991558","chr7","24994410","24994488","14","57997074"
"chr9","83000397","83000697","chr9","81683447","81683747","10","1316950"
"chr9","83017476","83017783","chr2","167664248","167664541","64","84646772"
"chr9","83074466","83074791","chr9","81757905","81758214","28","1316561"
"chr9","83092989","83093296","chr9","81776449","81776758","8","1316540"
"chr9","83105159","83105347","chr9","81788336","81788505","22","1316823"
"chr9","83171707","83171989","chr9","81856259","81856542","5","1315448"
"chr9","83190124","83190428","chr9","81874064","81874368","11","1316060"
"chr9","83227370","83227536","chr17","27929797","27929964","36","55297573"
"chr9","83295512","83295822","chr2","99544921","99545226","57","16249409"
"chr9","83301788","83302084","chr9","81984000","81984296","10","1317788"
"chr9","83385725","83386067","chr9","82067412","82067741","23","1318313"
"chr9","83429035","83429254","chr9","82110650","82110868","7","1318385"
"chr9","83883600","83883890","chr15","7952627","7952915","59","75930973"
"chr9","84029937","84030227","chr9","82706676","82706967","19","1323261"
"chr9","84135788","84136025","chr1","152085538","152085797","73","67949750"
"chr9","84137764","84138038","chr9","82815933","82816209","6","1321831"
"chr9","84163606","84163923","chr9","82842186","82842502","28","1321420"
"chr9","84238212","84238526","chr9","82923988","82924304","10","1314224"
"chr9","84291104","84291408","chr9","82978375","82978674","16","1312729"
"chr9","84349703","84349976","chr9","83036556","83036829","7","1313147"
"chr9","84376233","84376539","chr9","83063166","83063478","12","1313067"
"chr9","84399180","84399359","chr9","83086582","83086761","1","1312598"
"chr9","84430884","84431124","chr9","83118233","83118474","11","1312651"
"chr9","84459708","84459956","chr9","83147227","83147475","11","1312481"
"chr9","84469001","84469118","chr9","83156968","83157085","0","1312033"
"chr9","84470799","84470921","chr9","83158765","83158889","3","1312034"
"chr9","84496695","84496784","chr9","83184738","83184827","0","1311957"
"chr9","84507535","84507849","chr9","83195548","83195862","12","1311987"
"chr9","84508746","84509054","chr9","83196774","83197076","14","1311972"
"chr9","84526291","84526520","chr1","161615230","161615461","52","77088939"
"chr9","84544947","84545254","chr9","83232819","83233102","27","1312128"
"chr9","84560399","84560699","chr9","83248320","83248642","32","1312079"
"chr9","84601192","84601501","chr9","83288949","83289257","6","1312243"
"chr9","84652841","84653140","chr9","83338544","83338850","17","1314297"
"chr9","84655258","84655551","chr9","83340954","83341219","41","1314304"
"chr9","84867146","84867457","chr9","83557771","83558085","10","1309375"
"chr9","84874807","84875110","chr9","83565406","83565709","6","1309401"
"chr9","84902338","84902537","chr15","9631612","9631819","36","75270726"
"chr9","84912312","84912606","chr7","125147857","125148143","56","40235545"
"chr9","84959579","84959889","chr9","83651618","83651921","26","1307961"
"chr9","85018298","85018417","chr9","83710604","83710721","3","1307694"
"chr9","85048402","85048638","chr9","83741878","83742113","5","1306524"
"chr9","85079213","85079344","chr9","83772481","83772602","11","1306732"
"chr9","85079347","85079605","chr9","83772615","83772877","10","1306732"
"chr9","85092304","85092581","chr9","83785923","83786200","5","1306381"
"chr9","85099125","85099404","chr9","83792460","83792739","6","1306665"
"chr9","85145091","85145395","chr1","129087396","129087689","58","43942305"
"chr9","85150731","85150995","chr9","83847225","83847489","6","1303506"
"chr9","85155908","85156191","chr9","83851839","83852128","10","1304069"
"chr9","85157564","85157766","chr9","83853498","83853703","12","1304066"
"chr9","85169621","85169917","chr9","83864613","83864909","8","1305008"
"chr9","85177641","85177689","chr16","42566583","42566634","10","42611058"
"chr9","85181228","85181372","chr9","83876342","83876486","1","1304886"
"chr9","85204498","85204788","chr9","83898827","83899116","12","1305671"
"chr9","85225310","85225604","chr9","83919723","83920017","8","1305587"
"chr9","85267592","85267897","chr9","83961537","83961835","13","1306055"
"chr9","85281808","85282061","chr9","83975867","83976115","14","1305941"
"chr9","85357416","85357701","chr9","84051916","84052190","15","1305500"
"chr9","85367297","85367503","chr9","84061932","84062138","7","1305365"
"chr9","85403340","85403646","chr9","84098212","84098525","16","1305128"
"chr9","85427477","85427582","chr1","213956995","213957102","20","128529518"
"chr9","85434135","85434417","chr9","84129138","84129432","17","1304997"
"chr9","85444861","85445114","chr9","84144448","84144697","8","1300413"
"chr9","85472994","85473294","chr9","84170383","84170670","19","1302611"
"chr9","85474387","85474696","chr9","84171764","84172068","11","1302623"
"chr9","85492754","85492913","chr11","18862892","18863055","45","66629862"
"chr9","85493296","85493600","chr9","84190468","84190770","10","1302828"
"chr9","85503088","85503360","chr9","84201684","84201960","13","1301404"
"chr9","85504031","85504145","chr9","84202631","84202742","5","1301400"
"chr9","85551120","85551417","chr9","84255918","84256203","19","1295202"
"chr9","85560787","85561083","chr9","84265938","84266239","21","1294849"
"chr9","85566215","85566518","chr9","84269238","84269535","12","1296977"
"chr9","85571095","85571415","chr9","84275065","84275376","20","1296030"
"chr9","85575347","85575649","chr9","84279615","84279916","13","1295732"
"chr9","85576789","85577083","chr17","5011680","5011976","67","80565109"
"chr9","85578172","85578442","chr9","84282926","84283195","7","1295246"
"chr9","85578448","85578579","chr1","41386651","41386780","23","44191797"
"chr9","85578947","85579127","chr20","50942751","50942924","42","34636196"
"chr9","85584482","85584617","chr9","84288933","84289068","3","1295549"
"chr9","85591291","85591577","chr9","84295755","84296042","5","1295536"
"chr9","85596587","85596903","chr9","84301055","84301361","15","1295532"
"chr9","85611072","85611378","chr9","84315429","84315731","21","1295643"
"chr9","85624406","85624448","chr5","324650","324693","13","85299756"
"chr9","85624459","85624521","chr17","77796811","77796873","9","7827648"
"chr9","85624741","85625066","chr9","84320408","84320723","14","1304333"
"chr9","85628796","85628931","chr18","17236866","17236992","42","68391930"
"chr9","85632988","85633193","chr9","84338858","84339055","14","1294130"
"chr9","85634817","85635017","chr9","84340712","84340894","20","1294105"
"chr9","85635306","85635431","chr9","84341168","84341298","7","1294138"
"chr9","85635829","85636044","chr9","84341699","84341915","5","1294130"
"chr9","85643547","85643773","chr9","84345530","84345752","10","1298017"
"chr9","85656355","85656488","chr2","88476438","88476570","22","2820083"
"chr9","85667474","85667634","chr9","84374724","84374880","13","1292750"
"chr9","85674987","85675113","chr9","84379993","84380119","2","1294994"
"chr9","85707589","85707872","chr8","89182347","89182634","46","3474758"
"chr9","85717306","85717595","chr9","84419606","84419895","6","1297700"
"chr9","85743961","85744238","chr13","43964477","43964755","71","41779484"
"chr9","85747031","85747330","chr9","84450376","84450674","11","1296655"
"chr9","85754660","85754959","chr7","26648001","26648299","68","59106659"
"chr9","85769123","85769409","chr1","129740316","129740602","49","43971193"
"chr9","85772271","85772351","chr9","84478291","84478371","4","1293980"
"chr9","85778846","85779151","chr9","84485109","84485406","14","1293737"
"chr9","85786100","85786247","chr19","43411371","43411524","27","42374729"
"chr9","85786274","85786306","chr20","2257024","2257051","9","83529250"
"chr9","85799168","85799463","chr9","84505043","84505341","6","1294125"
"chr9","85805697","85806008","chr9","84512180","84512490","8","1293517"
"chr9","85810004","85810292","chr9","84516485","84516770","10","1293519"
"chr9","85814702","85815000","chr9","84521684","84521989","13","1293018"
"chr9","85831130","85831443","chr9","84537118","84537435","9","1294012"
"chr9","85836361","85836659","chr9","84550449","84550746","3","1285912"
"chr9","85848217","85848394","chr9","84556928","84557102","5","1291289"
"chr9","85851852","85852129","chr9","84558677","84558973","23","1293175"
"chr9","85854200","85854509","chr9","84560797","84561105","5","1293403"
"chr9","85857336","85857654","chr9","84563942","84564252","14","1293394"
"chr9","85876163","85876478","chr9","84584012","84584322","24","1292151"
"chr9","85886463","85886671","chr9","84594984","84595192","3","1291479"
"chr9","85904562","85904866","chr9","84613201","84613503","7","1291361"
"chr9","85913811","85914093","chr9","84623746","84624018","11","1290065"
"chr9","85935538","85935792","chr9","84643482","84643736","10","1292056"
"chr9","85940712","85941003","chr9","84648650","84648946","13","1292062"
"chr9","85941739","85941830","chr9","33121832","33121921","14","52819907"
"chr9","85944164","85944293","chr9","84652337","84652466","2","1291827"
"chr9","86002620","86002795","chr8","127019364","127019537","42","41016744"
"chr9","86006300","86006599","chr20","10470152","10470455","54","75536148"
"chr9","86007103","86007411","chr9","84717047","84717358","18","1290056"
"chr9","86044640","86044942","chr9","84753578","84753880","7","1291062"
"chr9","86050621","86050826","chr9","84759867","84760074","9","1290754"
"chr9","86084805","86085110","chr9","84794672","84794975","10","1290133"
"chr9","86093405","86093702","chr9","84803504","84803815","21","1289901"
"chr9","86106797","86107091","chr4","35454882","35455179","48","50651915"
"chr9","86112501","86112582","chr8","74369844","74369927","13","11742657"
"chr9","86122318","86122596","chr9","84832475","84832758","13","1289843"
"chr9","86165839","86166139","chr9","84877077","84877372","9","1288762"
"chr9","86168442","86168729","chr9","84879658","84879946","7","1288784"
"chr9","86172232","86172440","chr9","84883432","84883640","3","1288800"
"chr9","86212460","86212699","chr9","84924311","84924550","7","1288149"
"chr9","86223921","86224183","chr9","84935888","84936141","16","1288033"
"chr9","86225386","86225649","chr9","84937344","84937611","20","1288042"
"chr9","86230668","86230894","chr9","84942515","84942735","11","1288153"
"chr9","86237035","86237321","chr9","84948864","84949167","23","1288171"
"chr9","86266740","86266880","chr9","84978695","84978835","7","1288045"
"chr9","86283232","86283393","chr9","84993746","84993904","6","1289486"
"chr9","86288175","86288468","chr9","84998707","84998991","15","1289468"
"chr9","86320890","86321185","chr9","85030659","85030955","4","1290231"
"chr9","86335905","86336189","chr9","85044816","85045145","47","1291089"
"chr9","86372015","86372300","chr9","85090728","85091021","15","1281287"
"chr9","86411150","86411460","chr9","85125068","85125376","10","1286082"
"chr9","86419045","86419347","chr9","85132891","85133200","14","1286154"
"chr9","86448840","86449116","chr9","85163891","85164156","21","1284949"
"chr9","86478397","86478694","chr1","52721517","52721809","46","33756880"
"chr9","86493915","86494052","chr9","85207942","85208093","16","1285973"
"chr9","86497818","86498044","chr9","85212278","85212497","15","1285540"
"chr9","86523701","86523991","chr9","85240423","85240715","9","1283278"
"chr9","86526131","86526422","chr9","85242794","85243104","23","1283337"
"chr9","86540732","86541044","chr9","85257396","85257711","19","1283336"
"chr9","86560267","86560561","chr9","85277005","85277295","9","1283262"
"chr9","86563666","86563929","chr9","85280392","85280655","2","1283274"
"chr9","86616348","86616632","chr20","17338084","17338370","57","69278264"
"chr9","86628161","86628337","chr9","85345037","85345205","12","1283124"
"chr9","86649870","86649983","chr9","85367448","85367561","1","1282422"
"chr9","86679520","86679826","chr9","85391739","85392045","8","1287781"
"chr9","86683387","86683632","chr9","85395324","85395569","7","1288063"
"chr9","86704591","86704886","chr9","85416910","85417205","13","1287681"
"chr9","86709812","86709937","chr9","85422135","85422260","1","1287677"
"chr9","86710236","86710419","chr9","85422559","85422734","12","1287677"
"chr9","86731909","86732181","chr17","71852249","71852523","53","14879660"
"chr9","86733974","86734241","chr9","85446118","85446385","4","1287856"
"chr9","86734682","86734972","chr9","85446826","85447130","17","1287856"
"chr9","86770548","86770856","chr9","85484465","85484774","15","1286083"
"chr9","86775121","86775455","chr9","85488998","85489303","63","1286123"
"chr9","86787694","86787994","chr9","85506045","85506341","8","1281649"
"chr9","86847640","86847941","chr9","85566600","85566898","7","1281040"
"chr9","86854165","86854447","chr4","139909044","139909322","55","53054879"
"chr9","86882441","86882717","chr3","153473984","153474262","56","66591543"
"chr9","86893974","86894281","chr9","85612790","85613097","2","1281184"
"chr9","86927690","86927799","chr9","85647205","85647316","6","1280485"
"chr9","86940238","86940490","chr9","85659752","85660008","16","1280486"
"chr9","86958001","86958078","chr9","85677384","85677461","1","1280617"
"chr9","86958414","86958646","chr9","85677785","85678015","3","1280629"
"chr9","86978560","86978849","chr9","85699257","85699564","23","1279303"
"chr9","87009022","87009326","chr9","85730718","85731025","16","1278304"
"chr9","87045770","87046094","chr9","85767577","85767894","24","1278193"
"chr9","87059161","87059468","chr9","85782703","85783010","14","1276458"
"chr9","87075221","87075524","chr3","126142561","126142866","55","39067340"
"chr9","87077861","87077914","chr4","150770223","150770275","10","63692362"
"chr9","87077926","87078019","chr9","85803569","85803662","3","1274357"
"chr9","87079358","87079489","chr7","155375051","155375186","26","68295693"
"chr9","87082052","87082366","chr1","13689301","13689610","66","73392751"
"chr9","87088749","87089050","chr16","6647668","6647972","50","80441081"
"chr9","87097256","87097539","chr9","85824522","85824805","6","1272734"
"chr9","87117546","87117862","chr9","85844117","85844425","14","1273429"
"chr9","87129410","87129704","chr9","85855992","85856288","8","1273418"
"chr9","87154273","87154539","chr9","85882692","85882958","9","1271581"
"chr9","87155214","87155500","chr9","85883637","85883931","14","1271577"
"chr9","87202952","87203288","chr9","85941133","85941458","13","1261819"
"chr9","87228026","87228344","chr4","144950140","144950459","63","57722114"
"chr9","87249439","87249640","chr9","85988387","85988588","2","1261052"
"chr9","87285937","87286243","chr9","86023604","86023906","10","1262333"
"chr9","87317417","87317731","chr9","86056465","86056775","16","1260952"
"chr9","87408866","87409153","chr9","86151676","86151964","9","1257190"
"chr9","87412242","87412525","chr9","86155055","86155351","19","1257187"
"chr9","87422446","87422710","chr9","86165258","86165522","11","1257188"
"chr9","87429519","87429640","chr9","86171830","86171951","4","1257689"
"chr9","87431808","87432106","chr9","86174120","86174418","14","1257688"
"chr9","87469736","87469867","chr9","86212094","86212213","16","1257642"
"chr9","87476306","87476543","chr9","86218762","86218999","6","1257544"
"chr9","87487974","87488315","chr9","86230475","86230783","39","1257499"
"chr9","87505380","87505675","chr9","86247543","86247844","11","1257837"
"chr9","87534365","87534672","chr9","86276361","86276659","19","1258004"
"chr9","87536390","87536695","chr12","64205828","64206133","8","23330562"
"chr9","87540176","87540446","chr9","86280576","86280846","3","1259600"
"chr9","87571351","87571648","chr9","86311157","86311454","5","1260194"
"chr9","87573953","87574082","chr9","86313758","86313887","0","1260195"
"chr9","87585961","87586265","chr9","86326036","86326346","11","1259925"
"chr9","87595528","87595796","chr15","96554245","96554521","63","8958717"
"chr9","87601383","87601550","chr9","86341266","86341424","11","1260117"
"chr9","87654970","87655275","chr9","86393840","86394140","18","1261130"
"chr9","87655406","87655687","chr11","67181941","67182227","56","20473465"
"chr9","87656457","87656770","chr9","86395624","86395934","16","1260833"
"chr9","87661731","87661948","chr9","86400917","86401134","7","1260814"
"chr9","87678755","87679040","chr9","86418637","86418922","10","1260118"
"chr9","87699137","87699420","chr9","86439954","86440236","11","1259183"
"chr9","87703785","87703911","chr10","78211575","78211700","24","9492210"
"chr9","87719938","87720130","chr7","80517313","80517495","38","7202625"
"chr9","87727903","87728115","chr9","86468723","86468937","14","1259180"
"chr9","87728888","87729205","chr9","86470043","86470336","35","1258845"
"chr9","87732738","87733034","chr9","86474191","86474488","7","1258547"
"chr9","87748806","87749116","chr9","86491834","86492138","12","1256972"
"chr9","87751859","87751991","chr9","86494870","86495002","1","1256989"
"chr9","87762295","87762592","chr9","86505788","86506088","8","1256507"
"chr9","87773584","87773890","chr9","86517068","86517375","7","1256516"
"chr9","87780104","87780286","chr9","86524211","86524389","7","1255893"
"chr9","87780288","87780640","chr9","86524391","86524743","10","1255897"
"chr9","87790107","87790350","chr7","156871585","156871829","52","69081478"
"chr9","87790351","87790505","chr9","86534805","86534958","6","1255546"
"chr9","87800072","87800354","chr9","86543613","86543892","13","1256459"
"chr9","87801780","87802057","chr9","86545342","86545617","6","1256438"
"chr9","87807646","87807944","chr9","86551487","86551785","11","1256159"
"chr9","87810263","87810606","chr9","86554093","86554430","18","1256170"
"chr9","87822714","87822946","chr1","207010836","207011073","59","119188122"
"chr9","87829554","87829668","chr9","86573701","86573815","1","1255853"
"chr9","87832362","87832631","chr9","86576512","86576781","5","1255850"
"chr9","87856825","87857104","chr9","86601627","86601915","13","1255198"
"chr9","87858708","87858873","chr9","86603514","86603685","11","1255194"
"chr9","87876867","87877129","chr9","86629246","86629508","3","1247621"
"chr9","87879673","87879834","chr9","86631758","86631910","10","1247915"
"chr9","87896026","87896340","chr9","86648214","86648503","31","1247812"
"chr9","87922952","87923234","chr13","92792576","92792858","59","4869624"
"chr9","87927144","87927293","chr9","86685617","86685766","4","1241527"
"chr9","87927603","87927741","chr9","86686072","86686226","21","1241531"
"chr9","87935124","87935434","chr9","86693511","86693822","13","1241613"
"chr9","88245379","88245683","chr9","86920022","86920340","24","1325357"
"chr9","88287697","88287986","chr9","86968029","86968322","30","1319668"
"chr9","88343326","88343625","chr12","68214690","68214985","68","20128636"
"chr9","88387217","88387522","chr9","87012821","87013126","8","1374396"
"chr9","88395681","88395817","chrX","6619860","6619994","21","81775821"
"chr9","88395949","88396096","chr10","76369365","76369516","32","12026584"
"chr9","88415989","88416258","chr9","87041882","87042154","5","1374107"
"chr9","88424000","88424299","chr9","87050181","87050483","11","1373819"
"chr9","88438265","88438564","chr6","78448208","78448505","56","9990057"
"chr9","88453739","88454047","chr9","87079268","87079572","11","1374471"
"chr9","88461677","88461919","chr6","161813107","161813350","44","73351430"
"chr9","88464336","88464476","chrX","68434404","68434545","38","20029932"
"chr9","88492116","88492388","chr9","87117009","87117274","47","1375107"
"chr9","88505389","88505689","chr9","87130237","87130537","9","1375152"
"chr9","88510713","88511000","chr9","87135865","87136152","3","1374848"
"chr9","88512436","88512611","chr1","66887413","66887590","42","21625023"
"chr9","88512670","88512798","chrX","106932697","106932823","32","18420027"
"chr9","88547310","88547464","chr9","87167222","87167360","19","1380088"
"chr9","88547761","88547940","chr9","87167661","87167825","19","1380100"
"chr9","88571169","88571492","chr9","87188441","87188764","13","1382728"
"chr9","88571493","88571630","chr20","4472198","4472331","23","84099295"
"chr9","88576393","88576698","chr9","87193683","87193996","18","1382710"
"chr9","88598574","88598872","chr9","87215671","87215972","8","1382903"
"chr9","88615536","88615820","chr1","217833241","217833529","52","129217705"
"chr9","88624321","88624645","chr9","87241973","87242297","9","1382348"
"chr9","88652142","88652444","chr9","87270153","87270451","11","1381989"
"chr9","88689484","88689785","chr9","87307387","87307688","4","1382097"
"chr9","88706321","88706618","chr9","87324553","87324851","11","1381768"
"chr9","88707256","88707383","chr9","87325485","87325612","0","1381771"
"chr9","88717028","88717377","chr9","87335828","87336140","41","1381200"
"chr9","88732878","88733188","chr9","87352002","87352299","17","1380876"
"chr9","88744913","88745211","chr9","87364460","87364734","27","1380453"
"chr9","88745657","88745959","chr9","87365177","87365481","14","1380480"
"chr9","88752853","88752986","chr15","3262224","3262356","21","85490629"
"chr9","88754008","88754274","chr1","134920895","134921167","70","46166887"
"chr9","88759248","88759428","chr3","37177589","37177771","38","51581659"
"chr9","88784469","88784768","chr9","87400667","87400966","7","1383802"
"chr9","88797029","88797164","chr9","87415050","87415185","3","1381979"
"chr9","88798960","88799254","chr9","87416983","87417277","9","1381977"
"chr9","88804319","88804622","chr9","87422309","87422612","8","1382010"
"chr9","88805487","88805654","chr9","87423477","87423644","4","1382010"
"chr9","88809245","88809504","chr9","87427257","87427510","14","1381988"
"chr9","88816139","88816508","chr9","87434173","87434531","23","1381966"
"chr9","88816516","88816689","chr9","87434542","87434718","16","1381974"
"chr9","88819407","88819699","chr16","22907502","22907793","54","65911905"
"chr9","88827436","88827586","chr9","87445157","87445307","0","1382279"
"chr9","88831453","88831610","chr1","204403717","204403875","27","115572264"
"chr9","88836298","88836615","chr9","87454036","87454348","18","1382262"
"chr9","88836618","88836905","chr9","87454351","87454638","6","1382267"
"chr9","88847497","88847815","chr19","2378632","2378943","59","86468865"
"chr9","88865091","88865254","chr9","87476588","87476750","7","1388503"
"chr9","88865391","88865693","chr9","87476888","87477193","12","1388503"
"chr9","88871968","88872258","chr9","87483472","87483762","14","1388496"
"chr9","88880164","88880471","chr9","87490735","87491042","7","1389429"
"chr9","88895550","88895836","chr11","12684721","12685000","63","76210829"
"chr9","88928727","88928850","chr9","87542754","87542867","12","1385973"
"chr9","88986628","88986937","chr9","87608228","87608530","13","1378400"
"chr9","89037108","89037387","chr9","87658350","87658630","5","1378758"
"chr9","89050813","89051104","chr9","87672454","87672745","8","1378359"
"chr9","89122185","89122479","chr9","87737752","87738047","6","1384433"
"chr9","89171078","89171233","chr9","87786889","87787044","3","1384189"
"chr9","89208350","89208628","chr9","87824432","87824710","7","1383918"
"chr9","89224025","89224213","chr9","87839954","87840141","6","1384071"
"chr9","89224694","89224972","chr9","87840624","87840902","6","1384070"
"chr9","89244839","89245138","chr9","87861435","87861735","6","1383404"
"chr9","89276445","89276743","chr9","87898485","87898783","2","1377960"
"chr9","89294637","89294939","chr9","87916634","87916937","9","1378003"
"chr9","89296894","89297181","chr9","87918898","87919185","3","1377996"
"chr9","89305657","89305974","chr9","87927740","87928044","26","1377917"
"chr9","89307788","89307992","chr9","87929856","87930060","2","1377932"
"chr9","89371737","89371989","chr9","87992621","87992872","6","1379116"
"chr9","89385803","89386097","chr9","88007169","88007466","16","1378634"
"chr9","89395028","89395325","chr9","88016396","88016700","14","1378632"
"chr9","89396570","89396867","chr9","88017946","88018241","12","1378624"
"chr9","89413770","89414070","chr9","88035151","88035447","11","1378619"
"chr9","89432979","89433260","chr9","88054049","88054330","3","1378930"
"chr9","89454410","89454565","chr8","40191767","40191900","41","49262643"
"chr9","89462713","89462978","chr9","88083921","88084189","13","1378792"
"chr9","89479706","89480002","chr9","88100334","88100630","2","1379372"
"chr9","89585743","89586053","chr9","88204588","88204905","13","1381155"
"chr9","89591555","89591846","chr9","88210722","88211013","1","1380833"
"chr9","89628962","89629249","chr9","88248281","88248577","19","1380681"
"chr9","89633436","89633589","chr9","88252762","88252915","4","1380674"
"chr9","89645348","89645626","chr9","88264661","88264939","4","1380687"
"chr9","89656280","89656570","chr9","88276233","88276530","19","1380047"
"chr9","89656748","89657016","chr9","88276708","88276972","14","1380040"
"chr9","89726505","89726784","chr9","88347160","88347439","6","1379345"
"chr9","89747205","89747503","chr9","88367237","88367543","9","1379968"
"chr9","89754861","89755162","chr9","88375016","88375317","15","1379845"
"chr9","89783261","89783554","chr9","88402774","88403067","9","1380487"
"chr9","89787059","89787382","chr9","88406221","88406544","8","1380838"
"chr9","89795283","89795569","chr2","173322007","173322288","70","83526724"
"chr9","89813251","89813370","chr9","88432219","88432337","3","1381032"
"chr9","89817843","89817962","chr8","95946480","95946600","15","6128637"
"chr9","89828287","89828562","chr1","37432610","37432885","45","52395677"
"chr9","89830476","89830770","chr6","74451874","74452169","59","15378602"
"chr9","89836646","89836844","chr9","88455638","88455836","15","1381008"
"chr9","89837144","89837274","chr9","88456134","88456263","2","1381010"
"chr9","89854353","89854654","chr9","88474326","88474626","13","1380027"
"chr9","89862970","89863284","chr9","88482595","88482900","22","1380375"
"chr9","89869796","89870006","chr9","88489427","88489637","7","1380369"
"chr9","89883974","89884266","chr2","155849752","155850024","64","65965778"
"chr9","89891641","89891916","chr9","88510440","88510727","27","1381201"
"chr9","89893775","89893937","chr9","88512590","88512749","8","1381185"
"chr9","89902576","89902860","chr9","88521367","88521650","8","1381209"
"chr9","89905011","89905146","chr9","88523791","88523925","4","1381220"
"chr9","89905450","89905636","chr9","88524250","88524424","14","1381200"
"chr9","89907900","89908030","chr9","88526683","88526813","7","1381217"
"chr9","89912763","89913053","chr9","88530969","88531260","7","1381794"
"chr9","89913503","89913819","chr9","88531711","88532020","13","1381792"
"chr9","89924191","89924484","chr9","88541748","88542045","15","1382443"
"chr9","89928775","89929057","chr9","88546201","88546474","29","1382574"
"chr9","89934848","89935136","chr9","88552272","88552558","7","1382576"
"chr9","89939371","89939487","chr20","24768103","24768223","17","65171268"
"chr9","89940093","89940400","chr9","88557654","88557953","18","1382439"
"chr9","89940795","89941032","chr9","88558339","88558590","21","1382456"
"chr9","89942721","89942794","chr13","43738967","43739026","29","46203754"
"chr9","89942923","89943211","chr9","88560479","88560768","4","1382444"
"chr9","89952874","89953151","chr9","88570631","88570908","3","1382243"
"chr9","89958972","89959225","chr14","10295012","10295277","65","79663960"
"chr9","89976537","89976698","chr19","48411837","48411998","28","41564700"
"chr9","89976995","89977126","chrX","6619860","6619994","27","83357135"
"chr9","89977127","89977185","chr10","71835894","71835948","12","18141233"
"chr9","89978701","89978981","chr5","155466677","155466988","34","65487976"
"chr9","89990662","89990964","chr5","155480970","155481276","11","65490308"
"chr9","89994353","89994622","chr6","75846636","75846905","51","14147717"
"chr9","89996256","89996428","chr5","155486320","155486475","26","65490064"
"chr9","89996724","89996858","chr5","155487015","155487148","2","65490291"
"chr9","90002643","90002914","chr5","155492813","155493080","16","65490170"
"chr9","90018548","90018846","chr9","88590739","88591038","7","1427809"
"chr9","90019896","90020180","chr9","88592084","88592370","8","1427812"
"chr9","90024962","90025265","chr9","88596851","88597155","13","1428111"
"chr9","90025693","90025962","chr9","88597566","88597852","24","1428127"
"chr9","90027209","90027245","chr8","76159201","76159238","6","13868008"
"chr9","90029474","90029765","chr6","79031249","79031542","67","10998225"
"chr9","90039769","90039816","chr4","103779745","103779791","6","13739976"
"chr9","90039819","90039993","chr7","36378179","36378355","36","53661640"
"chr9","90045619","90045924","chr9","88619621","88619925","17","1425998"
"chr9","90053427","90053741","chr13","54310531","54310841","58","35742896"
"chr9","90054427","90054707","chr9","88627670","88627949","7","1426757"
"chr9","90057576","90057879","chr9","88630972","88631265","16","1426604"
"chr9","90059242","90059546","chr9","88632973","88633277","8","1426269"
"chr9","90060808","90061090","chr9","88634559","88634841","7","1426249"
"chr9","90067391","90067711","chr9","88641107","88641439","17","1426284"
"chr9","90083757","90083949","chr9","88657624","88657841","29","1426133"
"chr9","90123876","90124172","chr9","88700894","88701188","9","1422982"
"chr9","90137597","90137878","chr9","88714609","88714891","8","1422988"
"chr9","90140084","90140369","chr9","88716864","88717158","14","1423220"
"chr9","90161736","90161777","chr4","128007844","128007885","6","37846108"
"chr9","90161856","90162011","chr1","109937652","109937805","39","19775796"
"chr9","90226398","90226705","chr9","88803057","88803356","15","1423341"
"chr9","90283888","90284189","chr9","88859831","88860132","5","1424057"
"chr9","90296380","90296621","chr9","88871954","88872163","38","1424426"
"chr9","90308730","90308956","chr9","88884302","88884528","6","1424428"
"chr9","90327464","90327759","chr9","88902934","88903229","8","1424530"
"chr9","90344927","90345035","chr9","88920355","88920457","7","1424572"
"chr9","90366280","90366584","chr9","88942078","88942382","5","1424202"
"chr9","90370384","90370687","chr9","88946484","88946788","11","1423900"
"chr9","90373215","90373480","chr9","88949316","88949581","2","1423899"
"chr9","90375339","90375614","chr9","88951487","88951760","5","1423852"
"chr9","90375946","90375985","chr9","88952092","88952131","0","1423854"
"chr9","90378786","90379088","chr9","88954939","88955220","29","1423847"
"chr9","90381428","90381727","chr15","97229275","97229572","54","6847847"
"chr9","90392063","90392228","chr9","88967166","88967333","6","1424897"
"chr9","90392263","90392391","chr9","88967363","88967488","4","1424900"
"chr9","90411158","90411332","chr9","88986141","88986321","8","1425017"
"chr9","90411493","90411790","chr9","88986481","88986777","12","1425012"
"chr9","90419520","90419788","chr9","88994583","88994882","41","1424937"
"chr9","90420113","90420247","chr12","84845710","84845843","37","5574403"
"chr9","90425980","90426256","chr9","89006027","89006300","6","1419953"
"chr9","90429437","90429733","chr9","88998246","88998541","7","1431191"
"chr9","90430123","90430329","chr9","88998930","88999136","1","1431193"
"chr9","90431822","90432109","chr9","89000629","89000916","6","1431193"
"chr9","90433406","90433491","chr19","16546380","16546463","18","73887026"
"chr9","90437506","90437765","chrX","41457035","41457309","62","48980471"
"chr9","90438812","90439111","chr9","89015224","89015521","14","1423588"
"chr9","90463077","90463349","chr9","89040417","89040702","28","1422660"
"chr9","90470100","90470233","chr1","1286964","1287097","16","89183136"
"chr9","90472349","90472450","chr1","64356404","64356510","26","26115945"
"chr9","90472761","90472776","chr10","32419973","32419989","1","58052788"
"chr9","90481784","90481847","chr4","35877984","35878045","16","54603800"
"chr9","90486224","90486455","chr9","89071379","89071608","4","1414845"
"chr9","90486867","90487156","chr9","89072327","89072615","6","1414540"
"chr9","90499097","90499381","chr9","89083767","89084051","14","1415330"
"chr9","90509003","90509298","chr3","9831319","9831617","82","80677684"
"chr9","90514286","90514609","chr9","89101381","89101685","29","1412905"
"chr9","90514698","90514995","chr9","89101788","89102073","16","1412910"
"chr9","90516661","90516966","chr9","89104049","89104354","8","1412612"
"chr9","90518947","90519234","chr9","89110111","89110397","6","1408836"
"chr9","90519300","90519474","chrX","1974259","1974432","39","88545041"
"chr9","90519563","90519861","chr9","89101788","89102073","15","1417775"
"chr9","90521210","90521516","chr9","89104049","89104354","9","1417161"
"chr9","90544806","90545089","chr9","89132611","89132899","16","1412195"
"chr9","90557041","90557253","chr20","49637070","49637275","52","40919971"
"chr9","90561089","90561244","chr10","27501941","27502094","25","63059148"
"chr9","90561588","90561886","chr4","37807738","37808034","49","52753850"
"chr9","90568876","90568981","chr16","67388413","67388508","19","23180463"
"chr9","90569785","90570039","chr9","89149334","89149594","12","1420451"
"chr9","90576698","90577021","chr9","102340368","102340668","82","11763670"
"chr9","90585363","90585632","chr2","69444498","69444769","56","21140865"
"chr9","90587289","90587453","chr9","89175108","89175278","20","1412181"
"chr9","90587751","90587915","chr9","89175108","89175278","13","1412643"
"chr9","90593104","90593415","chr9","89180371","89180677","15","1412733"
"chr9","90594227","90594521","chr9","89181489","89181783","11","1412738"
"chr9","90619274","90619428","chr9","89204480","89204639","16","1414794"
"chr9","90619744","90619840","chr9","89204946","89205038","4","1414798"
"chr9","90635493","90635804","chr9","89226612","89226928","12","1408881"
"chr9","90643418","90643709","chr4","151968419","151968719","62","61325001"
"chr9","90644661","90644950","chr9","89236402","89236696","12","1408259"
"chr9","90651517","90651802","chr9","89243318","89243603","3","1408199"
"chr9","90652703","90652978","chr9","89244454","89244740","18","1408249"
"chr9","90654472","90654678","chr9","89246242","89246439","13","1408230"
"chr9","90659039","90659090","chr10","71316510","71316563","8","19342529"
"chr9","90659091","90659221","chr3","87574600","87574729","15","3084491"
"chr9","90660208","90660499","chr9","89251722","89252008","20","1408486"
"chr9","90666878","90667170","chr9","89258406","89258701","13","1408472"
"chr9","90698376","90698491","chr7","121530756","121530864","24","30832380"
"chr9","90714115","90714407","chr18","43018318","43018613","52","47695797"
"chr9","90727392","90727712","chr9","89321030","89321346","12","1406362"
"chr9","90728751","90729054","chr9","89322385","89322683","12","1406366"
"chr9","90757542","90757850","chr9","89353576","89353883","9","1403966"
"chr9","90764690","90764943","chr2","81947439","81947687","53","8817251"
"chr9","90766540","90766846","chr9","89361419","89361729","8","1405121"
"chr9","90783285","90783599","chr1","28304360","28304675","53","62478925"
"chr9","90791706","90792006","chr9","89388691","89388999","18","1403015"
"chr9","90795606","90795911","chr9","89392938","89393243","11","1402668"
"chr9","90800143","90800222","chr9","89403988","89404067","2","1396155"
"chr9","90812919","90813230","chr9","88204588","88204905","62","2608331"
"chr9","90828932","90829215","chr9","89427456","89427739","5","1401476"
"chr9","90879560","90879861","chr9","89476646","89476947","7","1402914"
"chr9","90884336","90884648","chr9","89481740","89482052","7","1402596"
"chr9","90885701","90886000","chr9","89483007","89483307","11","1402694"
"chr9","90894516","90894824","chr9","89492210","89492520","6","1402306"
"chr9","90915626","90915936","chr9","89513889","89514205","12","1401737"
"chr9","90919117","90919286","chr1","160189078","160189241","29","69269961"
"chr9","90919584","90919717","chr2","82271675","82271805","27","8647909"
"chr9","90931209","90931361","chr19","8561853","8561997","36","82369356"
"chr9","90941064","90941395","chr9","89538765","89539101","17","1402299"
"chr9","90952527","90952789","chr9","89550238","89550500","5","1402289"
"chr9","90956263","90956546","chrX","17134931","17135217","52","73821332"
"chr9","90975815","90976116","chr9","89572987","89573286","14","1402828"
"chr9","90988175","90988460","chrX","65601558","65601839","55","25386617"
"chr9","91003489","91003775","chr9","89601496","89601782","8","1401993"
"chr9","91026148","91026374","chr7","137584373","137584602","44","46558225"
"chr9","91060047","91060348","chr9","89658631","89658937","22","1401416"
"chr9","91107455","91107764","chr9","89707070","89707378","8","1400385"
"chr9","91121300","91121621","chr9","89720918","89721223","19","1400382"
"chr9","91161151","91161449","chr9","89761591","89761889","3","1399560"
"chr9","91211520","91211807","chr9","89812387","89812675","12","1399133"
"chr9","91273100","91273413","chr9","89873778","89874087","17","1399322"
"chr9","91277580","91277686","chr9","89878251","89878351","6","1399329"
"chr9","91277740","91277759","chr7","85495331","85495351","4","5782409"
"chr9","91299610","91299735","chr9","89900354","89900481","4","1399256"
"chr9","91325057","91325340","chr9","89925775","89926057","6","1399282"
"chr9","91359281","91359405","chr9","89959915","89960039","4","1399366"
"chr9","91371878","91372198","chr1","54547550","54547855","66","36824328"
"chr9","91380398","91380678","chr9","89976539","89976819","4","1403859"
"chr9","91387105","91387404","chr9","89983271","89983570","2","1403834"
"chr9","91390155","91390386","chr9","89986312","89986543","4","1403843"
"chr9","91397906","91398190","chr9","89994052","89994340","7","1403854"
"chr9","91452528","91452791","chr8","99732515","99732777","52","8279987"
"chr9","91493362","91493662","chr9","90090174","90090477","18","1403188"
"chr9","91520501","91520796","chr9","90113580","90113890","25","1406921"
"chr9","91543127","91543389","chr9","90136263","90136525","7","1406864"
"chr9","91544783","91545068","chr9","90137911","90138197","7","1406872"
"chr9","91602134","91602410","chr9","90195204","90195479","5","1406930"
"chr9","91619611","91619905","chr11","91501493","91501782","56","118118"
"chr9","91622787","91623079","chr9","90215905","90216184","17","1406882"
"chr9","91787511","91787828","chr9","90378166","90378483","11","1409345"
"chr9","91836170","91836460","chr13","118405389","118405671","81","26569219"
"chr9","91930840","91931114","chr9","90524786","90525060","6","1406054"
"chr9","92048302","92048484","chr9","90648505","90648648","45","1399797"
"chr9","92048519","92048639","chr9","42559409","42559528","17","49489110"
"chr9","92193665","92193953","chr9","90795157","90795448","9","1398508"
"chr9","92309461","92309750","chr9","90914220","90914500","17","1395241"
"chr9","92315111","92315391","chr9","90919856","90920141","7","1395255"
"chr9","92352141","92352158","chr2","76096741","76096757","2","16255400"
"chr9","92352191","92352455","chr9","90977202","90977469","8","1374989"
"chr9","92359495","92359768","chr9","90985017","90985299","15","1374478"
"chr9","92401401","92401693","chr9","91028802","91029082","21","1372599"
"chr9","92426685","92426900","chr9","91108319","91108528","15","1318366"
"chr9","92446047","92446131","chr14","19752449","19752531","16","72693598"
"chr9","92466248","92466535","chr9","91149691","91149984","14","1316557"
"chr9","92531737","92532073","chr9","91215747","91216049","40","1315990"
"chr9","92533672","92533788","chrX","118023443","118023553","26","25489771"
"chr9","92533822","92533995","chr1","23596488","23596653","28","68937334"
"chr9","92539487","92539631","chr19","9562400","9562547","28","82977087"
"chr9","92541232","92541558","chr3","150569212","150569522","76","58027980"
"chr9","92549244","92549554","chr4","152226280","152226592","49","59677036"
"chr9","92555208","92555483","chr9","91237390","91237665","7","1317818"
"chr9","92565025","92565327","chr9","91247202","91247502","9","1317823"
"chr9","92603212","92603482","chr9","91286574","91286844","3","1316638"
"chr9","92605108","92605262","chr9","91288482","91288636","1","1316626"
"chr9","92608110","92608408","chr9","91291484","91291783","3","1316626"
"chr9","92615109","92615403","chr9","91298734","91299034","13","1316375"
"chr9","92618875","92619148","chr9","91302446","91302718","4","1316429"
"chr9","92621710","92621842","chr8","112529380","112529505","28","19907670"
"chr9","92622297","92622606","chr9","91306172","91306481","11","1316125"
"chr9","92631565","92631751","chr9","91315796","91315982","4","1315769"
"chr9","92638112","92638328","chr9","91322383","91322601","15","1315729"
"chr9","92647253","92647413","chr2","18303671","18303830","27","74343582"
"chr9","92653843","92654133","chr9","91340526","91340816","5","1313317"
"chr9","92680635","92680935","chr9","91367648","91367946","11","1312987"
"chr9","92697352","92697674","chr9","91378831","91379124","31","1318521"
"chr9","92713524","92713751","chr9","91401663","91401890","6","1311861"
"chr9","92728384","92728697","chr9","91416759","91417042","34","1311625"
"chr9","92731813","92732110","chr9","91420019","91420321","9","1311794"
"chr9","92733369","92733669","chr9","91421903","91422202","5","1311466"
"chr9","92741839","92742132","chr9","91429808","91430093","13","1312031"
"chr9","92742542","92742829","chr2","164143294","164143579","46","71400752"
"chr9","92780965","92781258","chr9","91472066","91472363","12","1308899"
"chr9","92782373","92782680","chr7","6120249","6120545","90","86662124"
"chr9","92784508","92784805","chr9","91475589","91475887","6","1308919"
"chr9","92809261","92809552","chr9","91502609","91502900","9","1306652"
"chr9","92815827","92816136","chr20","68993107","68993413","54","23822720"
"chr9","92823831","92824152","chr9","91520226","91520544","6","1303605"
"chr9","92846797","92847109","chr9","91542299","91542603","18","1304498"
"chr9","92872418","92872691","chr9","91569126","91569410","21","1303292"
"chr9","92883310","92883587","chr9","91580306","91580607","27","1303004"
"chr9","92890235","92890358","chr9","91588880","91589003","2","1301355"
"chr9","92890398","92890574","chr9","91589043","91589220","1","1301355"
"chr9","92906249","92906626","chr9","91603989","91604324","55","1302260"
"chr9","92906792","92906885","chr9","91604491","91604584","4","1302301"
"chr9","92912337","92912649","chr9","91610016","91610310","52","1302321"
"chr9","92921779","92922068","chr9","91620724","91621014","12","1301055"
"chr9","92922854","92922947","chr7","7898849","7898942","17","85024005"
"chr9","92933063","92933260","chr9","91631995","91632196","7","1301068"
"chr9","92949768","92949957","chr9","91649846","91650040","9","1299922"
"chr9","92951441","92951724","chr9","91651531","91651814","7","1299910"
"chr9","92952018","92952154","chr9","91652101","91652238","5","1299917"
"chr9","92953570","92953769","chr16","40110273","40110451","54","52843297"
"chr9","92955109","92955396","chr9","91655165","91655455","33","1299944"
"chr9","92959037","92959323","chr9","91659416","91659695","8","1299621"
"chr9","92963747","92964048","chr9","91664271","91664572","9","1299476"
"chr9","92969854","92970162","chr9","91670683","91670992","8","1299171"
"chr9","92991188","92991485","chr9","91692597","91692906","26","1298591"
"chr9","92996480","92996660","chr9","91697904","91698084","4","1298576"
"chr9","92998398","92998695","chr9","91699814","91700111","5","1298584"
"chr9","93000194","93000480","chr9","91701603","91701889","20","1298591"
"chr9","93005540","93005814","chr3","82712117","82712395","47","10293423"
"chr9","93009386","93009678","chr9","91710430","91710709","28","1298956"
"chr9","93011854","93012130","chr9","91713499","91713775","6","1298355"
"chr9","93018062","93018333","chr9","91719423","91719695","3","1298639"
"chr9","93019656","93019964","chr9","91721026","91721333","7","1298630"
"chr9","93022279","93022589","chr9","91723648","91723957","6","1298631"
"chr9","93022996","93023034","chr9","91724365","91724403","2","1298631"
"chr9","93023351","93023606","chr9","91724721","91724976","7","1298630"
"chr9","93028563","93028859","chr9","91729912","91730208","3","1298651"
"chr9","93030854","93031144","chr9","91732215","91732511","11","1298639"
"chr9","93036809","93037135","chr9","91738866","91739172","30","1297943"
"chr9","93052170","93052250","chr9","91752422","91752502","0","1299748"
"chr9","93057152","93057447","chr9","91757406","91757712","20","1299746"
"chr9","93068593","93068904","chr9","91767893","91768205","15","1300700"
"chr9","93072557","93072858","chr9","91771906","91772207","4","1300651"
"chr9","93074747","93075013","chr9","91774880","91775146","14","1299867"
"chr9","93079182","93079484","chr9","91779619","91779912","16","1299563"
"chr9","93083170","93083461","chr9","91783438","91783706","35","1299732"
"chr9","93087446","93087707","chr9","91788037","91788278","32","1299409"
"chr9","93088173","93088450","chr9","91788744","91789020","8","1299429"
"chr9","93091326","93091618","chr9","91792066","91792359","10","1299260"
"chr9","93100121","93100416","chr9","91800887","91801189","18","1299234"
"chr9","93105626","93105921","chr9","91800887","91801189","18","1304739"
"chr9","93109318","93109586","chr9","91804609","91804875","16","1304709"
"chr9","93110745","93111036","chr9","91806833","91807128","10","1303912"
"chr9","93119767","93120074","chr9","91815828","91816128","21","1303939"
"chr9","93121534","93121826","chr9","91817587","91817879","7","1303947"
"chr9","93124613","93124890","chr1","6935851","6936127","47","86188762"
"chr9","93132573","93132863","chr9","91829042","91829332","3","1303531"
"chr9","93135432","93135529","chr9","91832288","91832385","3","1303144"
"chr9","93136244","93136465","chr9","91833101","91833322","10","1303143"
"chr9","93138526","93138831","chr9","91835643","91835943","13","1302883"
"chr9","93141964","93142231","chr9","91839024","91839301","16","1302940"
"chr9","93149520","93149813","chr9","91846604","91846897","6","1302916"
"chr9","93158186","93158515","chr12","21369498","21369822","75","71788688"
"chr9","93161927","93162175","chr9","91857814","91858060","17","1304113"
"chr9","93187626","93187925","chr9","91884790","91885102","16","1302836"
"chr9","93191550","93191839","chr9","91888719","91889008","6","1302831"
"chr9","93196721","93197042","chr9","91894212","91894533","16","1302509"
"chr9","93202426","93202682","chr9","91899930","91900202","21","1302496"
"chr9","93234502","93234790","chr9","91931958","91932249","8","1302544"
"chr9","93241223","93241516","chr9","91938495","91938788","3","1302728"
"chr9","93257718","93258012","chr9","91956116","91956410","6","1301602"
"chr9","93288468","93288593","chr9","91986941","91987066","2","1301527"
"chr9","93297869","93298185","chr9","91996334","91996649","11","1301535"
"chr9","93305984","93306078","chr9","92005110","92005201","10","1300874"
"chr9","93306360","93306437","chr9","92005480","92005560","7","1300880"
"chr9","93332955","93333251","chr9","92033939","92034230","12","1299016"
"chr9","93341487","93341776","chr9","92043277","92043566","6","1298210"
"chr9","93350209","93350291","chr9","92052253","92052335","0","1297956"
"chr9","93350591","93350800","chr9","92052631","92052846","12","1297960"
"chr9","93363321","93363441","chr6","32938721","32938840","15","60424600"
"chr9","93363502","93363669","chr19","48411837","48411998","33","44951665"
"chr9","93364486","93364763","chr10","37463769","37464060","64","55900717"
"chr9","93368186","93368484","chr9","92071580","92071882","14","1296606"
"chr9","93388935","93389155","chr9","92093577","92093768","33","1295358"
"chr9","93391977","93392259","chr9","92096567","92096880","35","1295410"
"chr9","93408587","93408878","chr9","92112239","92112529","11","1296348"
"chr9","93421207","93421493","chr3","51390605","51390903","56","42030602"
"chr9","93421720","93422029","chr9","92129581","92129877","18","1292139"
"chr9","93440154","93440416","chr9","92149138","92149403","12","1291016"
"chr9","93440785","93440903","chr9","92149668","92149786","4","1291117"
"chr9","93448038","93448356","chr9","92158426","92158736","15","1289612"
"chr9","93463447","93463760","chr9","92171587","92171900","8","1291860"
"chr9","93466615","93466932","chr7","51567455","51567765","61","41899160"
"chr9","93470444","93470728","chr9","92187857","92188138","10","1282587"
"chr9","93486436","93486617","chr9","92203999","92204180","5","1282437"
"chr9","93535214","93535506","chr9","92252795","92253089","7","1282419"
"chr9","93542434","93542717","chr9","92260138","92260387","39","1282296"
"chr9","93555082","93555374","chr9","92272731","92273024","11","1282351"
"chr9","93555435","93555661","chr9","92273085","92273301","16","1282350"
"chr9","93560152","93560465","chr7","42772457","42772755","64","50787695"
"chr9","93564042","93564363","chr9","92281617","92281946","26","1282425"
"chr9","93565170","93565297","chr9","92282740","92282867","5","1282430"
"chr9","93614038","93614261","chr9","92337206","92337423","8","1276832"
"chr9","93621432","93621763","chr7","81644524","81644839","93","11976908"
"chr9","93663833","93664138","chr9","92383065","92383370","8","1280768"
"chr9","93693971","93693987","chr2","183734626","183734643","3","90040655"
"chr9","93694049","93694332","chr9","92414202","92414494","19","1279847"
"chr9","93722675","93722977","chr7","25185886","25186189","61","68536789"
"chr9","93745868","93746170","chr9","92467013","92467309","12","1278855"
"chr9","93815854","93816155","chr9","92536420","92536720","7","1279434"
"chr9","93859758","93860062","chr9","92579496","92579794","9","1280262"
"chr9","93867322","93867644","chr9","92585542","92585840","29","1281780"
"chr9","93911864","93912161","chr9","92630969","92631264","4","1280895"
"chr9","93920754","93921051","chr9","92639577","92639857","22","1281177"
"chr9","93924380","93924679","chr9","92643160","92643455","7","1281220"
"chr9","93937315","93937608","chr9","92655372","92655665","2","1281943"
"chr9","93940458","93940756","chr9","92658514","92658812","9","1281944"
"chr9","93944544","93944843","chr9","92662739","92663039","7","1281805"
"chr9","93954015","93954320","chr9","92672194","92672497","9","1281821"
"chr9","93955189","93955407","chr9","92673363","92673581","4","1281826"
"chr9","93958623","93958901","chr18","42859800","42860073","49","51098823"
"chr9","94000345","94000634","chr9","92718527","92718801","22","1281818"
"chr9","94010202","94010334","chr15","38198637","38198772","27","55811565"
"chr9","94010625","94010833","chr12","97058948","97059144","57","3048323"
"chr9","94023347","94023643","chr9","92741981","92742273","11","1281366"
"chr9","94042837","94043003","chr9","92762561","92762727","10","1280276"
"chr9","94058366","94058674","chr9","92778148","92778462","12","1280218"
"chr9","94096126","94096420","chr9","92815950","92816244","12","1280176"
"chr9","94121450","94121628","chr13","47285224","47285397","38","46836226"
"chr9","94132758","94133022","chr9","92853505","92853769","2","1279253"
"chr9","94133110","94133410","chr9","92853859","92854162","13","1279251"
"chr9","94176311","94176637","chr9","92897031","92897355","8","1279280"
"chr9","94179253","94179517","chr5","109821189","109821452","80","15641936"
"chr9","94186833","94187095","chr9","92907806","92908079","22","1279027"
"chr9","94187351","94187649","chr2","78493440","78493742","59","15693911"
"chr9","94193309","94193624","chr9","92913998","92914312","27","1279311"
"chr9","94194257","94194570","chr9","92914950","92915259","21","1279307"
"chr9","94197513","94197638","chr9","92922546","92922671","0","1274967"
"chr9","94198243","94198395","chr9","92923276","92923427","2","1274967"
"chr9","94215995","94216292","chr9","92935930","92936227","12","1280065"
"chr9","94223439","94223722","chr19","2321527","2321809","58","91901912"
"chr9","94224072","94224370","chr2","131563107","131563406","56","37339035"
"chr9","94236149","94236416","chr6","172279903","172280171","60","78043754"
"chr9","94256703","94256921","chr9","92976912","92977131","3","1279791"
"chr9","94268107","94268422","chr20","63338302","63338611","52","30929805"
"chr9","94273203","94273526","chr9","92995013","92995336","7","1278190"
"chr9","94290174","94290475","chr1","1175550","1175849","56","93114624"
"chr9","94296231","94296339","chr9","93016754","93016862","1","1279477"
"chr9","94296663","94296824","chr9","93017177","93017346","9","1279486"
"chr9","94299108","94299368","chr9","93019622","93019882","3","1279486"
"chr9","94300118","94300458","chr9","93020656","93020969","43","1279462"
"chr9","94316576","94316842","chr9","93037836","93038100","9","1278740"
"chr9","94326027","94326164","chr9","93045644","93045781","6","1280383"
"chr9","94356586","94356881","chr9","93076977","93077272","4","1279609"
"chr9","94358892","94359030","chr16","49484330","49484464","22","44874562"
"chr9","94360349","94360618","chr9","93078743","93079012","3","1281606"
"chr9","94366143","94366448","chr20","3206117","3206426","51","91160026"
"chr9","94366564","94366587","chr8","16505277","16505295","7","77861287"
"chr9","94386944","94386983","chr18","57287662","57287697","8","37099282"
"chr9","94390838","94390957","chr11","82060795","82060907","33","12330043"
"chr9","94391719","94392012","chr9","93114551","93114844","8","1277168"
"chr9","94392278","94392519","chr9","93115240","93115442","41","1277038"
"chr9","94404282","94404475","chr9","93126980","93127172","3","1277302"
"chr9","94410080","94410363","chr9","93132911","93133194","7","1277169"
"chr9","94426631","94426918","chr9","93148618","93148905","2","1278013"
"chr9","94431401","94431718","chr13","72922007","72922316","60","21509394"
"chr9","94438682","94438954","chrX","33038985","33039255","55","61399697"
"chr9","94447615","94447791","chr9","93169792","93169967","5","1277823"
"chr9","94450019","94450326","chr9","93172200","93172494","21","1277819"
"chr9","94454540","94454834","chr9","93176705","93176998","4","1277835"
"chr9","94458537","94458800","chrX","50489900","50490170","62","43968637"
"chr9","94503508","94503806","chr9","93226634","93226929","13","1276874"
"chr9","94521595","94521878","chr9","93244753","93245036","13","1276842"
"chr9","94567387","94567667","chr9","93291358","93291638","4","1276029"
"chr9","94568552","94568845","chr9","93292526","93292820","3","1276026"
"chr9","94576221","94576511","chr9","93301024","93301313","8","1275197"
"chr9","94609715","94609874","chr9","93334902","93335066","6","1274813"
"chr9","94613586","94613722","chr9","93338784","93338920","1","1274802"
"chr9","94614040","94614232","chr9","93339235","93339424","14","1274805"
"chr9","94616660","94616946","chr9","93341845","93342102","34","1274815"
"chr9","94630559","94630695","chr15","96789184","96789319","18","2158625"
"chr9","94659624","94659808","chrX","51016455","51016635","34","43643169"
"chr9","94659834","94660123","chrX","51017000","51017291","8","43642834"
"chr9","94681646","94681951","chr9","93406856","93407161","6","1274790"
"chr9","94691590","94691650","chr9","93417345","93417405","0","1274245"
"chr9","94725364","94725563","chr9","93451686","93451892","11","1273678"
"chr9","94737918","94738203","chr9","93464818","93465103","4","1273100"
"chr9","94738433","94738744","chr9","93465330","93465639","10","1273103"
"chr9","94742527","94742799","chr9","93469346","93469618","5","1273181"
"chr9","94743493","94743735","chr9","93470330","93470553","22","1273163"
"chr9","94749775","94750067","chr9","93476661","93476953","8","1273114"
"chr9","94763597","94763911","chr9","93490648","93490964","6","1272949"
"chr9","94770082","94770367","chr9","93496213","93496498","11","1273869"
"chr9","94771956","94772258","chr9","93498091","93498393","0","1273865"
"chr9","94774084","94774217","chr9","93500535","93500668","5","1273549"
"chr9","94778685","94778998","chr9","93504476","93504789","2","1274209"
"chr9","94779188","94779299","chr9","93504979","93505090","7","1274209"
"chr9","94780842","94781047","chr9","93506604","93506809","4","1274238"
"chr9","94784528","94784803","chr9","93510261","93510565","35","1274267"
"chr9","94815671","94815721","chr1","54500597","54500644","11","40315074"
"chr9","94815777","94815876","chr5","20259577","20259676","18","74556200"
"chr9","94816901","94817183","chrX","96302964","96303244","57","1486063"
"chr9","94832372","94832597","chr9","93559044","93559271","8","1273328"
"chr9","94833812","94833943","chr9","93560482","93560613","1","1273330"
"chr9","94838404","94838684","chr9","93565083","93565365","11","1273321"
"chr9","94887036","94887178","chr9","123418869","123419012","31","28531833"
"chr9","94901053","94901346","chr9","93628610","93628918","20","1272443"
"chr9","94903170","94903489","chr9","93630426","93630753","15","1272744"
"chr9","94909576","94909753","chr20","10428154","10428328","37","84481422"
"chr9","94909903","94910022","chr14","6669230","6669349","27","88240673"
"chr9","94920429","94920739","chr9","93647088","93647395","12","1273341"
"chr9","94923283","94923559","chr9","93649917","93650195","8","1273366"
"chr9","94924885","94925180","chr9","93651492","93651787","7","1273393"
"chr9","94925221","94925526","chr9","93651828","93652134","4","1273393"
"chr9","94931998","94932272","chr9","93658618","93658899","14","1273380"
"chr9","94943950","94944240","chr9","93671515","93671805","1","1272435"
"chr9","94947854","94948146","chr9","93675722","93676016","5","1272132"
"chr9","94971927","94972235","chr9","93699895","93700203","4","1272032"
"chr9","94972706","94973010","chr9","93700663","93700967","3","1272043"
"chr9","94985405","94985703","chr9","93714375","93714664","16","1271030"
"chr9","94987339","94987636","chr9","93716290","93716583","6","1271049"
"chr9","94988145","94988449","chr9","93717091","93717395","7","1271054"
"chr9","95004315","95004610","chr9","93733021","93733316","5","1271294"
"chr9","95010068","95010126","chr6","29753449","29753493","19","65256619"
"chr9","95016792","95017065","chr9","93745936","93746153","65","1270856"
"chr9","95034376","95034682","chr2","146910253","146910552","55","51875877"
"chr9","95062987","95063292","chr9","93793172","93793477","8","1269815"
"chr9","95070247","95070558","chr9","93801490","93801810","16","1268757"
"chr9","95083152","95083437","chr9","93818640","93818930","12","1264512"
"chr9","95093835","95094104","chr9","22946307","22946588","65","72147528"
"chr9","95106612","95106913","chr9","93846011","93846313","9","1260601"
"chr9","95109685","95109969","chr9","93848776","93849060","6","1260909"
"chr9","95113041","95113344","chr9","93852874","93853186","20","1260167"
"chr9","95117256","95117536","chr9","93857352","93857632","6","1259904"
"chr9","95118827","95119128","chr9","93859546","93859848","18","1259281"
"chr9","95121742","95121905","chr9","93863203","93863367","3","1258539"
"chr9","95122210","95122361","chr9","93863672","93863822","6","1258538"
"chr9","95126158","95126456","chr9","93867621","93867922","5","1258537"
"chr9","95127781","95128100","chr9","39655243","39655570","67","55472538"
"chr9","95128609","95128892","chr9","93876552","93876844","17","1252057"
"chr9","95131808","95132007","chr9","93879854","93880042","28","1251954"
"chr9","95132340","95132609","chr9","93869227","93869496","4","1263113"
"chr9","95133403","95133691","chr9","93870301","93870589","6","1263102"
"chr9","95163407","95163461","chr10","6785229","6785278","11","88378178"
"chr9","95163464","95163507","chr15","96559713","96559756","7","1396249"
"chr9","95167922","95168088","chr14","7866222","7866397","26","87301700"
"chr9","95168117","95168263","chr14","46916493","46916638","22","48251624"
"chr9","95184451","95184750","chr9","93935116","93935413","6","1249335"
"chr9","95192489","95192788","chr9","93945050","93945340","13","1247439"
"chr9","95200181","95200469","chr8","10034943","10035230","50","85165238"
"chr9","95201063","95201264","chr7","26742740","26742920","55","68458323"
"chr9","95201573","95201702","chr2","88234514","88234634","27","6967059"
"chr9","95207816","95207981","chr14","63560003","63560159","37","31647813"
"chr9","95210628","95210740","chr9","93960974","93961086","2","1249654"
"chr9","95228703","95228839","chr9","93980611","93980747","3","1248092"
"chr9","95230068","95230360","chr9","93981652","93981944","3","1248416"
"chr9","95232283","95232358","chr12","69601772","69601849","14","25630511"
"chr9","95236548","95236765","chr9","93986370","93986587","6","1250178"
"chr9","95237468","95237586","chr9","93987286","93987404","2","1250182"
"chr9","95239580","95239879","chr5","58326342","58326643","48","36913238"
"chr9","95259664","95259971","chr9","94012673","94012980","3","1246991"
"chr9","95287086","95287400","chr9","94040065","94040378","4","1247021"
"chr9","95289455","95289761","chr9","94042743","94043034","39","1246712"
"chr9","95290404","95290679","chr9","94043662","94043939","5","1246742"
"chr9","95293172","95293466","chr9","94046424","94046724","9","1246748"
"chr9","95312733","95313024","chr9","94066215","94066506","4","1246518"
"chr9","95326710","95326983","chr1","53403313","53403576","57","41923397"
"chr9","95327699","95327986","chr9","94081004","94081269","52","1246695"
"chr9","95335407","95335461","chr4","7549914","7549964","8","87785493"
"chr9","95351548","95351830","chr9","94107798","94108080","2","1243750"
"chr9","95356288","95356579","chr9","94110449","94110714","29","1245839"
"chr9","95357024","95357321","chr9","94111163","94111484","31","1245861"
"chr9","95366321","95366486","chr9","94120344","94120519","15","1245977"
"chr9","95381070","95381366","chr9","94136062","94136358","9","1245008"
"chr9","95382490","95382640","chr9","94137799","94137949","4","1244691"
"chr9","95398895","95399187","chr9","94154415","94154706","2","1244480"
"chr9","95411852","95412135","chr9","94167485","94167768","6","1244367"
"chr9","95416512","95416779","chr19","48370959","48371231","47","47045553"
"chr9","95418859","95418983","chr9","22920838","22920964","28","72498021"
"chr9","95421512","95421634","chr9","94175902","94176024","2","1245610"
"chr9","95422269","95422542","chr9","94177825","94178106","16","1244444"
"chr9","95424477","95424614","chr9","94180640","94180777","4","1243837"
"chr9","95458301","95458629","chr9","94214800","94215128","11","1243501"
"chr9","95464177","95464406","chr9","94222658","94222892","9","1241519"
"chr9","95464979","95465289","chr9","94223473","94223777","15","1241506"
"chr9","95470450","95470631","chr14","62644580","62644753","32","32825870"
"chr9","95472852","95473161","chr9","94228108","94228416","7","1244744"
"chr9","95475174","95475464","chr9","94233643","94233933","6","1241531"
"chr9","95479206","95479502","chr9","94237615","94237907","9","1241591"
"chr9","95482977","95483254","chr9","94241396","94241677","9","1241581"
"chr9","95483864","95484156","chr16","32714688","32714980","60","62769176"
"chr9","95489284","95489568","chr9","94248362","94248647","6","1240922"
"chr9","95503078","95503357","chr9","94263402","94263679","5","1239676"
"chr9","95515282","95515569","chr9","94275542","94275823","14","1239740"
"chr9","95522813","95523043","chr9","94283365","94283601","11","1239448"
"chr9","95528987","95529290","chr9","94289640","94289917","35","1239347"
"chr9","95538125","95538425","chr9","94298788","94299085","11","1239337"
"chr9","95540012","95540312","chr9","94300742","94301042","7","1239270"
"chr9","95547400","95547673","chr9","94308131","94308399","11","1239269"
"chr9","95554941","95555250","chr9","94315901","94316206","8","1239040"
"chr9","95558360","95558470","chr7","77579136","77579242","33","17979224"
"chr9","95562069","95562366","chr8","135138906","135139204","55","39576837"
"chr9","95565172","95565468","chr9","94326077","94326372","8","1239095"
"chr9","95571877","95572040","chr9","94332857","94333003","22","1239020"
"chr9","95573024","95573341","chr9","94333986","94334299","15","1239038"
"chr9","95575552","95575852","chr9","94336504","94336805","8","1239048"
"chr9","95584657","95584822","chrX","16632915","16633082","31","78951742"
"chr9","95584862","95585192","chr9","94346520","94346845","16","1238342"
"chr9","95590777","95590943","chr9","94352730","94352896","6","1238047"
"chr9","95594051","95594312","chr9","94356826","94357088","17","1237225"
"chr9","95594337","95594649","chr9","94357129","94357437","7","1237208"
"chr9","95603032","95603339","chr9","94369572","94369884","12","1233460"
"chr9","95606400","95606700","chr9","94367676","94367971","17","1238724"
"chr9","95612330","95612509","chr10","49278527","49278703","38","46333803"
"chr9","95612819","95612924","chr14","10235509","10235617","20","85377310"
"chr9","95624986","95625279","chr9","94390546","94390839","2","1234440"
"chr9","95632008","95632288","chr9","94397636","94397920","9","1234372"
"chr9","95633834","95634126","chr9","94399467","94399764","11","1234367"
"chr9","95669685","95669911","chr9","94431594","94431788","35","1238091"
"chr9","95687282","95687590","chr9","94451271","94451567","18","1236011"
"chr9","95688354","95688656","chr9","94452330","94452627","30","1236024"
"chr9","95690483","95690583","chr9","94454462","94454562","0","1236021"
"chr9","95691484","95691699","chr9","94455463","94455672","9","1236021"
"chr9","95699387","95699546","chr4","66622065","66622223","25","29077322"
"chr9","95715940","95716167","chr9","94483153","94483380","5","1232787"
"chr9","95726418","95726722","chr9","94494299","94494605","7","1232119"
"chr9","95739434","95739740","chr9","94508165","94508470","11","1231269"
"chr9","95740300","95740553","chr9","94509029","94509282","6","1231271"
"chr9","95745398","95745704","chr9","94508165","94508470","11","1237233"
"chr9","95746263","95746515","chr9","94509029","94509282","7","1237234"
"chr9","95747266","95747569","chr9","94510337","94510640","8","1236929"
"chr9","95753345","95753654","chr9","94516472","94516781","5","1236873"
"chr9","95758399","95758715","chr9","94524922","94525236","9","1233477"
"chr9","95777710","95777772","chr8","124931380","124931440","16","29153670"
"chr9","95777932","95778092","chr17","27005847","27006006","35","68772085"
"chr9","95778557","95778877","chr9","94545136","94545451","14","1233421"
"chr9","95783569","95783878","chr9","94550143","94550452","5","1233426"
"chr9","95787739","95788039","chr9","94554286","94554588","12","1233453"
"chr9","95789628","95789681","chr9","94556178","94556231","2","1233450"
"chr9","95793508","95793806","chr9","94560161","94560458","9","1233347"
"chr9","95798601","95798903","chr9","94565208","94565508","3","1233393"
"chr9","95800916","95801210","chr9","94567520","94567816","6","1233396"
"chr9","95807698","95807991","chr9","94574568","94574863","8","1233130"
"chr9","95809967","95810231","chr9","94577572","94577836","6","1232395"
"chr9","95831831","95832135","chr9","94599480","94599781","11","1232351"
"chr9","95832971","95833137","chr9","94600623","94600804","20","1232348"
"chr9","95840388","95840597","chr6","35266842","35267046","44","60573546"
"chr9","95855710","95856003","chr17","26763424","26763712","52","69092286"
"chr9","95856102","95856175","chr2","34288520","34288595","12","61567582"
"chr9","95860165","95860413","chr9","94627410","94627658","9","1232755"
"chr9","95862229","95862555","chr9","94629465","94629793","15","1232764"
"chr9","95866675","95866970","chr9","94632651","94632956","17","1234024"
"chr9","95891329","95891638","chr9","94656890","94657197","10","1234439"
"chr9","95892551","95892824","chr3","47955206","47955477","75","47937345"
"chr9","95900239","95900537","chr9","94666276","94666571","7","1233963"
"chr9","95910910","95911111","chr9","94676868","94677089","24","1234042"
"chr9","95921584","95921839","chr9","94688030","94688285","8","1233554"
"chr9","95926389","95926676","chr9","94693553","94693846","9","1232836"
"chr9","95930671","95930959","chr9","94697845","94698130","10","1232826"
"chr9","95953677","95953941","chr9","94722616","94722840","43","1231061"
"chr9","95961232","95961551","chr9","94731799","94732116","9","1229433"
"chr9","95965441","95965611","chr3","51994702","51994870","33","43970739"
"chr9","95977607","95977740","chr9","94747785","94747915","6","1229822"
"chr9","95978056","95978213","chr3","46580688","46580847","28","49397368"
"chr9","96002065","96002354","chr9","94769300","94769589","6","1232765"
"chr9","96012332","96012638","chr9","94779338","94779635","13","1232994"
"chr9","96016797","96016972","chr9","94783120","94783297","6","1233677"
"chr9","96017011","96017143","chr9","94783328","94783470","10","1233683"
"chr9","96027677","96027896","chr9","94793428","94793647","3","1234249"
"chr9","96049780","96050004","chr9","94815349","94815573","3","1234431"
"chr9","96053430","96053742","chr9","94818500","94818811","25","1234930"
"chr9","96054263","96054540","chr9","94819338","94819611","8","1234925"
"chr9","96062295","96062595","chr9","94827452","94827746","12","1234843"
"chr9","96066435","96066717","chr9","94831374","94831656","4","1235061"
"chr9","96069834","96070163","chr9","94834768","94835068","35","1235066"
"chr9","96076745","96077053","chr9","94841979","94842284","16","1234766"
"chr9","96120348","96120647","chr9","94884447","94884742","9","1235901"
"chr9","96135952","96136109","chr11","110402020","110402179","28","14266068"
"chr9","96144768","96145063","chr9","94909114","94909410","6","1235654"
"chr9","96149840","96150119","chr9","94914179","94914476","19","1235661"
"chr9","96166305","96166620","chr9","94931349","94931654","19","1234956"
"chr9","96176266","96176551","chr1","22940926","22941211","59","73235340"
"chr9","96186682","96186982","chr9","94951057","94951357","4","1235625"
"chr9","96187697","96187897","chr9","94952110","94952310","4","1235587"
"chr9","96200781","96200876","chr9","94964933","94965029","2","1235848"
"chr9","96214301","96214600","chr9","94978231","94978530","4","1236070"
"chr9","96217231","96217522","chr9","94981181","94981471","7","1236050"
"chr9","96221596","96221841","chr9","94985541","94985786","5","1236055"
"chr9","96223365","96223677","chr9","94987571","94987889","15","1235794"
"chr9","96226300","96226574","chr9","94990809","94991084","8","1235491"
"chr9","96231448","96231759","chr9","94995631","94995933","17","1235817"
"chr9","96243446","96243652","chr4","152299818","152300020","38","56056372"
"chr9","96251106","96251408","chr9","95017946","95018244","4","1233160"
"chr9","96251844","96252147","chr15","74219376","74219673","44","22032468"
"chr9","96269955","96270131","chr4","92632680","92632864","39","3637275"
"chr9","96270243","96270559","chr9","95039063","95039379","3","1231180"
"chr9","96275335","96275633","chr9","95043826","95044116","13","1231509"
"chr9","96275974","96276265","chr9","95044457","95044748","6","1231517"
"chr9","96282951","96283248","chr9","95051301","95051601","5","1231650"
"chr9","96294358","96294641","chr9","95069637","95069962","52","1224721"
"chr9","96295945","96296216","chr9","95062760","95063032","9","1233185"
"chr9","96297709","96298014","chr9","95064525","95064830","9","1233184"
"chr9","96298608","96298831","chr9","95065423","95065646","2","1233185"
"chr9","96300206","96300415","chr9","95067025","95067234","8","1233181"
"chr9","96310129","96310439","chr9","95077936","95078253","12","1232193"
"chr9","96313520","96313843","chr9","95081353","95081676","10","1232167"
"chr9","96315660","96316000","chr9","95083947","95084262","31","1231713"
"chr9","96348505","96348773","chr9","95117184","95117463","23","1231321"
"chr9","96351321","96351393","chr6","84577771","84577838","18","11773550"
"chr9","96351829","96351944","chr9","95121699","95121814","4","1230130"
"chr9","96352879","96353185","chr9","95122753","95123061","6","1230126"
"chr9","96353196","96353515","chr6","142644890","142645186","68","46291694"
"chr9","96353534","96353809","chr9","95123414","95123689","2","1230120"
"chr9","96354630","96354945","chr9","95124504","95124818","5","1230126"
"chr9","96355651","96355941","chr9","95125533","95125823","8","1230118"
"chr9","96356686","96356982","chr9","95126633","95126935","11","1230053"
"chr9","96357420","96357617","chr9","95127373","95127527","50","1230047"
"chr9","96367907","96368213","chr9","95139300","95139606","8","1228607"
"chr9","96383836","96384111","chr9","95157701","95157975","4","1226135"
"chr9","96385397","96385692","chr9","95159158","95159451","6","1226239"
"chr9","96392218","96392372","chr3","82362989","82363140","31","14029229"
"chr9","96401838","96401999","chr7","18872374","18872535","31","77529464"
"chr9","96402710","96402903","chr16","48745480","48745675","37","47657230"
"chr9","96402923","96403206","chr4","101462173","101462439","78","5059250"
"chr9","96405556","96405815","chr9","95186155","95186414","2","1219401"
"chr9","96407227","96407531","chr9","95182291","95182587","14","1224936"
"chr9","96426280","96426556","chr9","95206215","95206514","26","1220065"
"chr9","96436083","96436373","chr1","39815879","39816161","57","56620204"
"chr9","96457837","96457986","chr9","95237076","95237235","14","1220761"
"chr9","96458607","96458740","chr9","95237848","95237981","4","1220759"
"chr9","96472867","96473144","chr9","95252263","95252542","10","1220604"
"chr9","96475970","96476273","chr9","95255355","95255650","15","1220615"
"chr9","96504081","96504422","chr9","95284692","95285023","13","1219389"
"chr9","96508528","96508709","chr9","95289131","95289311","9","1219397"
"chr9","96533661","96533958","chr9","95313792","95314089","7","1219869"
"chr9","96551702","96551842","chr19","15705849","15705993","25","80845853"
"chr9","96560641","96560760","chr9","95340985","95341108","5","1219656"
"chr9","96564110","96564414","chr9","95344439","95344745","11","1219671"
"chr9","96586324","96586604","chr9","95366481","95366761","12","1219843"
"chr9","96587872","96588166","chr1","67042253","67042549","49","29545619"
"chr9","96614434","96614751","chr9","95394523","95394840","6","1219911"
"chr9","96628870","96629182","chr9","95408534","95408837","14","1220336"
"chr9","96632665","96632968","chr9","95412316","95412616","13","1220349"
"chr9","96673689","96673811","chr9","95453191","95453313","2","1220498"
"chr9","96691565","96691882","chr9","95470986","95471288","23","1220579"
"chr9","96709841","96710137","chr9","95489236","95489532","6","1220605"
"chr9","96727295","96727465","chr9","95506670","95506840","5","1220625"
"chr9","96727762","96727897","chr9","95507139","95507272","3","1220623"
"chr9","96774376","96774619","chr9","95556246","95556489","8","1218130"
"chr9","96774917","96774975","chr9","95556802","95556858","6","1218115"
"chr9","96785715","96786004","chr9","95567275","95567562","5","1218440"
"chr9","96789851","96790139","chr1","28007973","28008264","61","68781878"
"chr9","96803458","96803744","chr9","95585091","95585377","7","1218367"
"chr9","96816659","96816954","chr1","40884817","40885110","54","55931842"
"chr9","96819029","96819327","chr9","95600829","95601141","21","1218200"
"chr9","96840048","96840361","chr9","95620224","95620537","6","1219824"
"chr9","96842582","96842745","chr13","8757901","8758069","28","88084681"
"chr9","96865927","96866232","chr11","108003591","108003884","67","11137664"
"chr9","96908460","96908733","chr9","95688796","95689068","10","1219664"
"chr9","96912320","96912611","chr9","95692682","95692973","2","1219638"
"chr9","96913400","96913480","chr9","95693762","95693842","2","1219638"
"chr9","96913514","96913676","chr9","95698139","95698301","4","1215375"
"chr9","96915639","96915832","chr9","95700261","95700454","4","1215378"
"chr9","96916135","96916245","chr9","95700757","95700867","1","1215378"
"chr9","96916347","96916651","chr9","95700968","95701277","9","1215379"
"chr9","96964155","96964231","chr20","49943865","49943942","13","47020290"
"chr9","96977375","96977522","chr1","37879071","37879202","38","59098304"
"chr9","96981906","96982195","chr9","95765869","95766156","7","1216037"
"chr9","96986540","96986816","chr9","95770471","95770747","9","1216069"
"chr9","97023865","97024159","chr9","95808501","95808776","27","1215364"
"chr9","97055567","97055691","chr9","95840606","95840726","4","1214961"
"chr9","97055734","97055910","chr9","95840761","95840931","14","1214973"
"chr9","97134014","97134220","chr9","95917995","95918201","3","1216019"
"chr9","97160758","97160902","chr9","95945463","95945607","2","1215295"
"chr9","97161207","97161373","chr9","95945917","95946077","11","1215290"
"chr9","97180547","97180851","chr9","95965610","95965914","6","1214937"
"chr9","97187651","97187954","chr9","95972723","95973026","5","1214928"
"chr9","97190608","97190910","chr9","95975689","95975991","3","1214919"
"chr9","97289144","97289372","chr9","96078687","96078927","13","1210457"
"chr9","97307829","97308125","chr9","96097047","96097347","6","1210782"
"chr9","97309065","97309332","chr9","96098310","96098574","6","1210755"
"chr9","97326438","97326452","chr17","27932146","27932161","3","69394292"
"chr9","97329987","97330292","chr9","96119542","96119842","32","1210445"
"chr9","97332386","97332671","chr9","96121937","96122239","28","1210449"
"chr9","97334193","97334476","chr9","96123763","96124054","23","1210430"
"chr9","97335563","97335870","chr9","96125135","96125442","6","1210428"
"chr9","97339187","97339486","chr9","96129049","96129348","2","1210138"
"chr9","97342596","97342887","chr9","96132475","96132771","12","1210121"
"chr9","97343557","97343688","chr1","47081281","47081406","23","50262276"
"chr9","97343693","97343935","chr9","96133567","96133802","13","1210126"
"chr9","97345312","97345634","chr9","96135178","96135501","6","1210134"
"chr9","97358272","97358558","chr9","96148150","96148435","6","1210122"
"chr9","97373188","97373495","chr9","96162785","96163092","6","1210403"
"chr9","97391939","97392234","chr9","96181904","96182188","19","1210035"
"chr9","97431864","97431988","chr3","51197142","51197262","31","46234722"
"chr9","97432023","97432327","chr9","96222056","96222363","16","1209967"
"chr9","97474421","97474770","chr9","96267544","96267859","39","1206877"
"chr9","97492411","97492518","chr9","96286117","96286223","3","1206294"
"chr9","97492563","97492587","chr1","212678714","212678738","6","115186151"
"chr9","97546704","97546973","JH679691","222956","223223","57","97323748"
"chr9","97548198","97548499","chr9","96341694","96341987","27","1206504"
"chr9","97596893","97597181","chr9","96390292","96390580","6","1206601"
"chr9","97624482","97624774","chr19","28718617","28718918","60","68905865"
"chr9","97704175","97704481","chr9","96497189","96497503","15","1206986"
"chr9","97857276","97857569","chr9","96647976","96648270","2","1209300"
"chr9","97872073","97872389","chr9","96664004","96664326","16","1208069"
"chr9","97891385","97891677","chr9","96683117","96683413","15","1208268"
"chr9","97896845","97897131","chr9","96688489","96688773","5","1208356"
"chr9","97916512","97916820","chr9","96708319","96708619","17","1208193"
"chr9","98005783","98006043","chr9","96798108","96798386","20","1207675"
"chr9","98217425","98217722","chr9","97008708","97008997","19","1208717"
"chr9","98314427","98314594","chr9","97106507","97106675","5","1207920"
"chr9","98350514","98350812","chr9","97142029","97142321","20","1208485"
"chr9","98640986","98641118","chr1","69516883","69517020","24","29124103"
"chr9","98643091","98643138","chr11","28776209","28776259","11","69866882"
"chr9","98643269","98643523","chr6","113208272","113208524","63","14565003"
"chr9","98770703","98771013","chr11","108574369","108574679","59","9803666"
"chr9","98885879","98886167","chr9","97688203","97688492","21","1197676"
"chr9","99107075","99107344","chr9","97909819","97910082","19","1197256"
"chr9","99169221","99169513","chr6","66368105","66368396","62","32801116"
"chr9","99221658","99221966","chr9","98026823","98027122","18","1194835"
"chr9","99260510","99260771","chr9","98065489","98065766","19","1195021"
"chr9","99373189","99373274","chr9","98177773","98177858","4","1195416"
"chr9","99373305","99373617","chr9","98177889","98178206","13","1195416"
"chr9","99390616","99390860","chr9","98199236","98199480","5","1191380"
"chr9","99547924","99548209","chr9","98355416","98355713","20","1192508"
"chr9","99556687","99556969","chr9","98364246","98364528","6","1192441"
"chr9","99571288","99571571","chr9","98378800","98379083","4","1192488"
"chr9","99645655","99645833","chr9","98452472","98452647","8","1193183"
"chr9","99675238","99675388","chr5","72245907","72246033","45","27429331"
"chr9","99701570","99701894","chr9","98508216","98508537","32","1193354"
"chr9","99732383","99732502","chr4","17500554","17500677","17","82231829"
"chr9","99816165","99816446","chr9","98619338","98619618","6","1196827"
"chr9","99930883","99931182","chr9","98735461","98735761","20","1195422"
"chr9","100000819","100001126","chr9","98806052","98806349","20","1194767"
"chr9","100054370","100054681","chr9","98860168","98860449","34","1194202"
"chr9","100071960","100072298","chr9","98879339","98879675","17","1192621"
"chr9","100108280","100108447","chr7","38855816","38855970","42","61252464"
"chr9","100108756","100108801","chr9","22971194","22971237","12","77137562"
"chr9","100108988","100109073","chr1","109584082","109584169","18","9475094"
"chr9","100149585","100149743","chr6","169794377","169794541","40","69644792"
"chr9","100195063","100195371","chr9","99004893","99005200","7","1190170"
"chr9","100207372","100207621","chr9","99017022","99017301","36","1190350"
"chr9","100355388","100355685","chr9","99164291","99164581","13","1191097"
"chr9","100367510","100367808","chr9","99176127","99176459","38","1191383"
"chr9","100468072","100468370","chr9","99278327","99278625","5","1189745"
"chr9","100530561","100530871","chr9","99343062","99343368","10","1187499"
"chr9","100586070","100586394","chr9","99398597","99398899","30","1187473"
"chr9","100744931","100745238","chr9","99567303","99567603","22","1177628"
"chr9","100746584","100746756","chr9","99568947","99569121","12","1177637"
"chr9","100786271","100786435","chr4","146081163","146081333","43","45294892"
"chr9","100807546","100807778","chr9","99633149","99633369","17","1174397"
"chr9","100851397","100851702","chr9","99675697","99676002","19","1175700"
"chr9","100889724","100889991","chr9","99719247","99719521","18","1170477"
"chr9","100937424","100937558","chr6","132948781","132948913","27","32011357"
"chr9","100951749","100952071","chr1","112392013","112392327","70","11440264"
"chr9","101015057","101015329","chrX","21956129","21956396","57","79058928"
"chr9","101017703","101017987","chr3","38659314","38659601","63","62358389"
"chr9","101396648","101396939","chr9","100127037","100127327","20","1269611"
"chr9","101466185","101466476","chr9","100196165","100196456","13","1270020"
"chr9","101472928","101473216","chr9","100202815","100203131","35","1270113"
"chr9","101523526","101523831","chr9","100252713","100253016","14","1270813"
"chr9","101557215","101557495","chr1","184750438","184750715","62","83193223"
"chr9","101557533","101557545","chr1","139382811","139382823","2","37825278"
"chr9","101582621","101582928","chr9","100311309","100311619","18","1271312"
"chr9","101624547","101624862","chr7","158585944","158586255","55","56961397"
"chr9","101912142","101912470","chr16","56102262","56102569","84","45809880"
"chr9","102034785","102035102","chr9","100765817","100766137","21","1268968"
"chr9","102052083","102052336","chr12","33912936","33913184","50","68139147"
"chr9","102250383","102250652","chr9","100977331","100977596","14","1273052"
"chr9","102290673","102290979","chr9","101017713","101018019","5","1272960"
"chr9","102325971","102326265","chr9","101050576","101050870","10","1275395"
"chr9","102425604","102425740","chr11","84387535","84387667","34","18038069"
"chr9","102512340","102512654","chr9","101231164","101231474","14","1281176"
"chr9","102535327","102535412","chr1","83535930","83536020","19","18999397"
"chr9","102616356","102616516","chr9","101349099","101349259","2","1267257"
"chr9","102630511","102630793","chr9","101362851","101363132","4","1267660"
"chr9","102793247","102793566","chr9","101530789","101531105","13","1262458"
"chr9","102808738","102809040","chr9","101546038","101546343","13","1262700"
"chr9","102810773","102811049","chr9","101548059","101548338","11","1262714"
"chr9","102834869","102835068","chr9","101572194","101572393","2","1262675"
"chr9","102835069","102835361","chr9","101572394","101572685","7","1262675"
"chr9","102885844","102886161","chr9","101629731","101630046","13","1256113"
"chr9","102904777","102905080","chr9","101649581","101649884","5","1255196"
"chr9","102924180","102924483","chr9","101670283","101670595","20","1253897"
"chr9","102974698","102974993","chr9","101723832","101724134","13","1250866"
"chr9","102992344","102992636","chr9","101741567","101741858","5","1250777"
"chr9","103021248","103021529","chr9","101770372","101770649","4","1250876"
"chr9","103022355","103022445","chr9","101771507","101771600","3","1250848"
"chr9","103023984","103024291","chr9","101773215","101773519","7","1250769"
"chr9","103044261","103044402","chr9","101793673","101793825","17","1250588"
"chr9","103078503","103078801","chr9","101827152","101827455","13","1251351"
"chr9","103086968","103087264","chr7","58492189","58492482","62","44594779"
"chr9","103087566","103087728","chr9","101836921","101837084","8","1250645"
"chr9","103089475","103089785","chr9","101839178","101839488","4","1250297"
"chr9","103112641","103112948","chr9","101863655","101863962","8","1248986"
"chr9","103160538","103160831","chr9","101910690","101910983","6","1249848"
"chr9","103232460","103232772","chr9","101984570","101984877","14","1247890"
"chr9","103240947","103241295","chr9","101993152","101993457","50","1247795"
"chr9","103280748","103281046","chr9","102033042","102033325","17","1247706"
"chr9","103313852","103314148","chr5","79159592","79159894","52","24154260"
"chr9","103322541","103322853","chr9","102072309","102072608","23","1250232"
"chr9","103335387","103335694","chr9","102084840","102085152","12","1250547"
"chr9","103351319","103351500","chr2","50635868","50636051","37","52715451"
"chr9","103351773","103351796","chr16","25046784","25046804","6","78304989"
"chr9","103355478","103355777","chr9","102105360","102105657","9","1250118"
"chr9","103361743","103362055","chr9","102111548","102111859","5","1250195"
"chr9","103372660","103372962","chr9","102123825","102124127","10","1248835"
"chr9","103381807","103382103","chr9","102132666","102132940","37","1249141"
"chr9","103389663","103389989","chr9","102140549","102140874","4","1249114"
"chr9","103399152","103399287","chr9","102149913","102150048","2","1249239"
"chr9","103410891","103411060","chr9","102158457","102158626","8","1252434"
"chr9","103411103","103411204","chr15","6139004","6139107","17","97272099"
"chr9","103413417","103413427","chr13","26700377","26700387","2","76713040"
"chr9","103413458","103413734","chr9","102160913","102161219","33","1252545"
"chr9","103417957","103418225","chr9","102165894","102166150","34","1252063"
"chr9","103454135","103454243","chr9","102202494","102202598","6","1251641"
"chr9","103470722","103470874","chr15","96789184","96789319","30","6681538"
"chr9","103471773","103472069","chr2","134572018","134572314","57","31100245"
"chr9","103480927","103481240","chr9","102228936","102229249","5","1251991"
"chr9","103494417","103494715","chr9","102241769","102242067","13","1252648"
"chr9","103522016","103522272","chr9","102269524","102269780","6","1252492"
"chr9","103522273","103522534","chr13","54552195","54552446","56","48970078"
"chr9","103523967","103524246","chr9","102271302","102271579","10","1252665"
"chr9","103535991","103536142","chr9","102282987","102283142","7","1253004"
"chr9","103555862","103556139","chr9","102302898","102303201","32","1252964"
"chr9","103592328","103592632","chr9","102340368","102340668","10","1251960"
"chr9","103598936","103599199","chr9","102347013","102347282","30","1251923"
"chr9","103605320","103605583","chr9","102353007","102353270","7","1252313"
"chr9","103697686","103697931","chr7","158628499","158628744","55","54930813"
"chr9","103727389","103727586","chr9","102476200","102476397","5","1251189"
"chr9","103779475","103779770","chr9","102528848","102529150","17","1250627"
"chr9","103789783","103789986","chr9","56809291","56809494","44","46980492"
"chr9","103806684","103806965","chr9","102556109","102556407","25","1250575"
"chr9","103807193","103807509","chr9","102556606","102556895","37","1250587"
"chr9","103813530","103813770","chr9","102562615","102562857","10","1250915"
"chr9","103852830","103853107","chr9","102601746","102602022","2","1251084"
"chr9","103866377","103866660","chr9","102615326","102615610","7","1251051"
"chr9","103878006","103878158","chr19","6552140","6552292","30","97325866"
"chr9","103883891","103884043","chr19","6552140","6552292","30","97331751"
"chr9","103914994","103915266","chr9","102657431","102657700","9","1257563"
"chr9","103918635","103918935","chr9","102661088","102661391","12","1257547"
"chr9","103937652","103937949","chr9","102679949","102680246","6","1257703"
"chr9","103998171","103998473","chr9","102740501","102740803","11","1257670"
"chr9","104131645","104131952","chr9","102874824","102875147","26","1256821"
"chr9","104149489","104149762","chr9","102892686","102892959","7","1256803"
"chr9","104412520","104412605","chr1","137945723","137945800","19","33533203"
"chr9","104507036","104507327","chr9","103272358","103272647","4","1234678"
"chr9","104616059","104616247","chr9","103373678","103373861","15","1242381"
"chr9","104625457","104625662","chr9","103382983","103383188","1","1242474"
"chr9","104649017","104649295","chr9","103406541","103406818","10","1242476"
"chr9","104811390","104811720","chr9","103571437","103571764","14","1239953"
"chr9","104822213","104822512","chr9","103582600","103582894","16","1239613"
"chr9","104828340","104828621","chr9","103589081","103589360","10","1239259"
"chr9","104837906","104838215","chr9","103598535","103598843","13","1239371"
"chr9","104963511","104963781","chr9","103724575","103724846","11","1238936"
"chr9","105100812","105101099","chr9","103862538","103862825","4","1238274"
"chr9","105139423","105139720","chr9","103902000","103902308","22","1237423"
"chr9","105216637","105216909","chr9","103978284","103978551","10","1238353"
"chr9","105255184","105255477","chr3","2797380","2797675","58","102457804"
"chr9","105255553","105255706","chr12","83005289","83005458","36","22250264"
"chr9","105263918","105264227","chr9","104022170","104022474","12","1241748"
"chr9","105266195","105266421","chr9","104024758","104024984","5","1241437"
"chr9","105266422","105266486","chr9","104024985","104025053","7","1241437"
"chr9","105267704","105268015","chr9","104026266","104026577","11","1241438"
"chr9","105276237","105276361","chr9","104034787","104034917","6","1241450"
"chr9","105276663","105276822","chr9","104035215","104035376","5","1241448"
"chr9","105285745","105286024","chr9","104045027","104045317","21","1240718"
"chr9","105291780","105292085","chr9","104052300","104052583","40","1239480"
"chr9","105332958","105333277","chr9","104092696","104093014","12","1240262"
"chr9","105384252","105384564","chr9","104144660","104144975","5","1239592"
"chr9","105388195","105388367","chr9","104148557","104148728","2","1239638"
"chr9","105429412","105429703","chr9","104189830","104190121","8","1239582"
"chr9","105449517","105449792","chr9","104210236","104210516","14","1239281"
"chr9","105472617","105472886","chr9","104233668","104233970","38","1238949"
"chr9","105533870","105534161","chr9","104295704","104296000","12","1238166"
"chr9","105588310","105588478","chr9","104350929","104351097","6","1237381"
"chr9","105637348","105637648","chr9","104400485","104400781","15","1236863"
"chr9","105681490","105681777","chr9","104444248","104444535","12","1237242"
"chr9","105683449","105683620","chr3","41868999","41869175","27","63814450"
"chr9","105710101","105710168","chr9","104473090","104473162","9","1237011"
"chr9","105710206","105710364","chr9","104473200","104473357","7","1237006"
"chr9","105746875","105747179","chr9","104510103","104510417","27","1236772"
"chr9","105753417","105753577","chr9","104516478","104516617","26","1236939"
"chr9","105757728","105757985","chr9","104520766","104521017","23","1236962"
"chr9","105758038","105758350","chr9","104521070","104521352","43","1236968"
"chr9","105781509","105781818","chr9","104543897","104544206","19","1237612"
"chr9","105790407","105790557","chr19","13060538","13060678","37","92729869"
"chr9","105793290","105793585","chr9","104556223","104556519","6","1237067"
"chr9","105800252","105800543","chr9","104563373","104563650","21","1236879"
"chr9","105807750","105808070","chr1","26606474","26606791","54","79201276"
"chr9","105815685","105815724","chr2","134202631","134202672","5","28386946"
"chr9","105868534","105868864","chr9","104633494","104633804","29","1235040"
"chr9","105889496","105889797","chr9","104654931","104655235","14","1234565"
"chr9","106006497","106006564","chr8","124931380","124931440","19","18924883"
"chr9","106065930","106066193","chr2","136526318","136526571","67","30460388"
"chr9","106077292","106077571","chr9","104840646","104840927","14","1236646"
"chr9","106113587","106113890","chr9","104875674","104875977","6","1237913"
"chr9","106115879","106116193","chr9","104877712","104878024","20","1238167"
"chr9","106207509","106207812","chr9","104969701","104970004","10","1237808"
"chr9","106213923","106214206","chr9","104976343","104976626","6","1237580"
"chr9","106347357","106347667","chr9","105109553","105109859","10","1237804"
"chr9","106355974","106356287","chr9","105117690","105117995","19","1238284"
"chr9","106361105","106361404","chr9","105122823","105123124","6","1238282"
"chr9","106398797","106398933","chr9","105160285","105160419","9","1238512"
"chr9","106410889","106411181","chr9","158559","158852","57","106252330"
"chr9","106412751","106413032","chr9","105174071","105174353","10","1238680"
"chr9","106463246","106463562","chr9","105225373","105225679","18","1237873"
"chr9","106486125","106486431","chr9","105248226","105248532","8","1237899"
"chr9","106594514","106594819","chr7","40477394","40477699","61","66117120"
"chr9","106618097","106618398","chr9","105383337","105383646","21","1234760"
"chr9","106635760","106635864","chr9","105401337","105401441","4","1234423"
"chr9","106635865","106635943","chr9","105401442","105401520","2","1234423"
"chr9","106663653","106663965","chr9","105429431","105429745","18","1234222"
"chr9","106679905","106680045","chr10","14839660","14839807","31","91840245"
"chr9","106730839","106731127","chr9","105495271","105495559","12","1235568"
"chr9","106832617","106832681","chr9","105596350","105596414","1","1236267"
"chr9","106833211","106833391","chr9","105596942","105597115","11","1236269"
"chr9","106874343","106874599","chr9","105638011","105638268","6","1236332"
"chr9","106894713","106895019","chr9","105658366","105658670","8","1236347"
"chr9","106916032","106916219","chr9","105680433","105680625","21","1235599"
"chr9","106930045","106930356","chr9","105693679","105693990","10","1236366"
"chr9","106944500","106944778","chr9","105708090","105708375","20","1236410"
"chr9","106946504","106946800","chr15","20053312","20053616","70","86893192"
"chr9","106964109","106964329","chr9","105728172","105728414","27","1235937"
"chr9","106987477","106987765","chr9","105751846","105752146","18","1235631"
"chr9","106995080","106995387","chr9","105759457","105759768","9","1235623"
"chr9","107021753","107022040","chr16","18768739","18769026","52","88253014"
"chr9","107027980","107028289","chr9","105792142","105792451","12","1235838"
"chr9","107031303","107031609","chr9","105795744","105796061","32","1235559"
"chr9","107033762","107034084","chr13","41851851","41852159","70","65181911"
"chr9","107088626","107088810","chr9","105852834","105852991","29","1235792"
"chr9","107099612","107099902","chr9","105863326","105863617","14","1236286"
"chr9","107129232","107129530","chr9","105894081","105894379","5","1235151"
"chr9","107138197","107138482","chr9","105903005","105903290","4","1235192"
"chr9","107186594","107186875","chr9","105950430","105950673","46","1236164"
"chr9","107224817","107225099","chr9","105988416","105988696","14","1236401"
"chr9","107237700","107237993","chr9","106001682","106001975","6","1236018"
"chr9","107274934","107275033","chr19","16663461","16663559","16","90611473"
"chr9","107276282","107276484","chr9","106039495","106039697","6","1236787"
"chr9","107286411","107286705","chr9","106049625","106049918","22","1236786"
"chr9","107305139","107305440","chr9","106068619","106068928","17","1236520"
"chr9","107313017","107313315","chr9","106076849","106077147","6","1236168"
"chr9","107350793","107351100","chr9","106114339","106114634","25","1236454"
"chr9","107361974","107362263","chrX","120356258","120356539","57","12994284"
"chr9","107370831","107370908","chr15","20113910","20113989","14","87256921"
"chr9","107370909","107371215","chr9","106133245","106133547","11","1237664"
"chr9","107373634","107373923","chr9","106135948","106136241","10","1237686"
"chr9","107381081","107381291","chr9","106143408","106143616","4","1237673"
"chr9","107384790","107385085","chr9","106146787","106147082","16","1238003"
"chr9","107437666","107437970","chr9","106205132","106205441","11","1232534"
"chr9","107489578","107489869","chr9","106251586","106251895","31","1237992"
"chr9","107490245","107490427","chr9","106252271","106252452","4","1237974"
"chr9","107537222","107537528","chr9","106299307","106299610","12","1237915"
"chr9","107580749","107580778","chr9","106343899","106343928","0","1236850"
"chr9","107581139","107581332","chr9","106344289","106344481","5","1236850"
"chr9","107588145","107588419","chr9","106351316","106351600","13","1236829"
"chr9","107596660","107596934","chr7","157971739","157972008","61","50375079"
"chr9","107598548","107598806","chr9","106362424","106362686","8","1236124"
"chr9","107615088","107615258","chr9","106378998","106379168","6","1236090"
"chr9","107652234","107652537","chr9","106415553","106415857","12","1236681"
"chr9","107660945","107661239","chr9","106425130","106425424","5","1235815"
"chr9","107694223","107694513","chr9","106458090","106458382","9","1236133"
"chr9","107712853","107713162","chr9","106477983","106478288","7","1234870"
"chr9","107758644","107758746","chr9","106523473","106523575","4","1235171"
"chr9","107765742","107766051","chr9","106530616","106530926","10","1235126"
"chr9","107769109","107769398","chr9","106533979","106534268","5","1235130"
"chr9","107795582","107795894","chr9","106561289","106561591","19","1234293"
"chr9","107812127","107812430","chr9","106583014","106583318","6","1229113"
"chr9","107815156","107815408","chr9","106586040","106586292","0","1229116"
"chr9","107866035","107866339","chr9","106637271","106637571","49","1228764"
"chr9","107945206","107945349","chr2","92212320","92212468","33","15732886"
"chr9","107995947","107996245","chr9","106771678","106771965","23","1224269"
"chr9","108430541","108430817","chr9","107225139","107225415","2","1205402"
"chr9","108493789","108494091","chr9","107298198","107298498","12","1195591"
"chr9","108499341","108499618","chr8","68894766","68895040","51","39604575"
"chr9","108551168","108551480","chr9","107343527","107343838","14","1207641"
"chr9","108678737","108678975","chr9","107470643","107470884","11","1208094"
"chr9","108718792","108719086","chr9","107510941","107511235","9","1207851"
"chr9","108804059","108804350","chr9","107595342","107595633","5","1208717"
"chr9","108862107","108862397","chr9","107653906","107654196","7","1208201"
"chr9","109216502","109216799","chr9","108009086","108009390","15","1207416"
"chr9","109423265","109423557","chr9","108223287","108223581","9","1199978"
"chr9","109565322","109565651","chr9","108363124","108363454","11","1202198"
"chr9","109588388","109588696","chr3","12644640","12644921","75","96943748"
"chr9","109588724","109588741","chr1","102370369","102370384","4","7218355"
"chr9","109590082","109590327","chr9","108388471","108388718","16","1201611"
"chr9","109603297","109603636","chr9","108401357","108401677","33","1201940"
"chr9","109604067","109604383","chr9","108402119","108402433","8","1201948"
"chr9","109617024","109617355","chr9","108415362","108415675","25","1201662"
"chr9","109630714","109631008","chr9","108428672","108428967","10","1202042"
"chr9","109635836","109636099","chr9","94110449","94110714","57","15525387"
"chr9","109641678","109641964","chr9","108440927","108441213","5","1200751"
"chr9","109678425","109678646","chr3","45613516","45613724","50","64064909"
"chr9","109681434","109681711","chr15","10496638","10496919","71","99184796"
"chr9","109686370","109686658","chr9","108486061","108486350","7","1200309"
"chr9","109761886","109762183","chr9","108562117","108562414","9","1199769"
"chr9","109787723","109787977","chr9","108588417","108588671","10","1199306"
"chr9","109802169","109802477","chr9","108602609","108602917","6","1199560"
"chr9","109830410","109830696","chr9","108630345","108630634","13","1200065"
"chr9","109903068","109903349","chr9","108704627","108704917","21","1198441"
"chr9","109920928","109921228","chr1","46978927","46979224","47","62942001"
"chr9","109938093","109938246","chr9","108739344","108739500","6","1198749"
"chr9","109997386","109997661","chr9","108798629","108798904","9","1198757"
"chr9","110002142","110002385","chr8","109730264","109730512","59","271878"
"chr9","110030218","110030334","chr9","108831038","108831152","8","1199180"
"chr9","110062157","110062296","chr9","108863289","108863428","3","1198868"
"chr9","110075380","110075696","chr9","108876520","108876813","29","1198860"
"chr9","110090233","110090543","chr9","108891367","108891677","10","1198866"
"chr9","110135133","110135339","chr9","108937363","108937568","6","1197770"
"chr9","110135542","110135603","chr9","108937769","108937830","0","1197773"
"chr9","110136385","110136672","chr9","108938608","108938895","6","1197777"
"chr9","110142092","110142388","chr9","108944467","108944765","7","1197625"
"chr9","110167886","110168171","chr9","108969973","108970258","4","1197913"
"chr9","110180606","110180922","chr9","108982779","108983095","9","1197827"
"chr9","110191008","110191166","chr9","108993260","108993425","11","1197748"
"chr9","110198867","110199154","chr9","109000886","109001203","35","1197981"
"chr9","110206673","110206969","chr9","109007933","109008238","17","1198740"
"chr9","110241133","110241416","chr9","109042222","109042505","3","1198911"
"chr9","110264823","110265023","chr9","109065948","109066145","4","1198875"
"chr9","110265465","110265783","chr9","109066590","109066880","37","1198875"
"chr9","110317977","110318283","chr9","109119396","109119702","6","1198581"
"chr9","110383604","110383910","chr9","109185433","109185737","11","1198171"
"chr9","110384450","110384763","chr9","109186313","109186612","17","1198137"
"chr9","110402486","110402787","chr9","109204374","109204681","10","1198112"
"chr9","110406321","110406607","chr9","109208213","109208500","5","1198108"
"chr9","110446024","110446339","chr9","109247976","109248288","16","1198048"
"chr9","110591565","110591724","chr9","109391711","109391870","4","1199854"
"chr9","110618450","110618753","chr9","109417729","109418030","13","1200721"
"chr9","110637608","110637750","chr9","109437865","109438023","18","1199743"
"chr9","110651646","110651976","chr9","109451504","109451810","36","1200142"
"chr9","110691200","110691505","chr9","109490970","109491279","13","1200230"
"chr9","110713753","110713890","chr9","109513571","109513714","33","1200182"
"chr9","110726495","110726632","chr8","138639847","138639985","20","27913352"
"chr9","110739586","110739698","chr6","70388086","70388194","25","40351500"
"chr9","110743142","110743472","chr9","109542766","109543092","13","1200376"
"chr9","110745348","110745651","chr9","109544963","109545267","12","1200385"
"chr9","110758162","110758464","chr9","109557776","109558078","2","1200386"
"chr9","110892428","110892702","chr9","109692516","109692788","7","1199912"
"chr9","111153178","111153466","chr9","109951730","109951988","40","1201448"
"chr9","111191315","111191564","chr16","56215248","56215499","66","54976067"
"chr9","111205138","111205387","chr9","110002711","110002960","10","1202427"
"chr9","111257391","111257560","chr9","110055117","110055262","26","1202274"
"chr9","111307478","111307772","chr9","110105011","110105304","3","1202467"
"chr9","111398256","111398528","chr9","110195966","110196264","41","1202290"
"chr9","111404381","111404533","chr9","110202113","110202266","8","1202268"
"chr9","111404836","111404963","chr9","110202592","110202717","7","1202244"
"chr9","111441740","111442046","chr9","110242913","110243219","4","1198827"
"chr9","111524441","111524745","chr9","110329052","110329352","15","1195389"
"chr9","111526352","111526644","chr9","110330964","110331257","7","1195388"
"chr9","111533295","111533602","chr9","110337586","110337897","14","1195709"
"chr9","111535952","111536268","chr9","110340546","110340859","18","1195406"
"chr9","111556263","111556531","chr9","110360335","110360588","23","1195928"
"chr9","111557467","111557774","chr9","110361541","110361841","20","1195926"
"chr9","111580767","111581069","chr9","110385437","110385738","8","1195330"
"chr9","111639461","111639782","chr9","110444516","110444838","18","1194945"
"chr9","111678907","111679208","chr9","110484084","110484386","12","1194823"
"chr9","111706859","111707147","chr8","27951401","27951689","75","83755458"
"chr9","111707416","111707717","chr9","110513273","110513561","21","1194143"
"chr9","111711726","111711793","chr9","110517506","110517573","1","1194220"
"chr9","111723318","111723617","chr9","110528988","110529273","29","1194330"
"chr9","111766199","111766274","chr9","110567760","110567843","11","1198439"
"chr9","111780798","111780907","chr9","110582537","110582646","2","1198261"
"chr9","111781873","111782075","chr9","110583614","110583820","12","1198259"
"chr9","111788654","111788795","chr9","110590653","110590795","4","1198001"
"chr9","111803946","111804148","chr9","110606624","110606826","4","1197322"
"chr9","111808387","111808649","chr9","110610887","110611149","4","1197500"
"chr9","111811840","111812115","chr9","110614153","110614433","14","1197687"
"chr9","111832116","111832419","chr9","110638145","110638437","18","1193971"
"chr9","111836822","111837114","chr9","110636228","110636524","16","1200594"
"chr9","111837332","111837388","chrX","46137496","46137548","10","65699836"
"chr9","111846490","111846576","chr9","110649132","110649218","1","1197358"
"chr9","111847069","111847353","chr9","110649689","110649986","24","1197380"
"chr9","111848117","111848419","chr9","110650755","110651039","23","1197362"
"chr9","111876025","111876310","chr9","110692047","110692355","36","1183978"
"chr9","111877154","111877401","chr9","110693108","110693388","39","1184046"
"chr9","111877706","111878016","chr4","37823652","37823958","52","74054054"
"chr9","111891123","111891418","chr9","110697099","110697388","15","1194024"
"chr9","111892986","111893276","chr9","110690151","110690435","17","1202835"
"chr9","111894935","111895151","chr15","43952866","43953074","47","67942069"
"chr9","111895169","111895324","chr10","14579784","14579941","26","97315385"
"chr9","111896944","111897203","chr9","110701206","110701458","13","1195738"
"chr9","111897915","111898146","chr1","213994464","213994694","41","102096549"
"chr9","111899859","111900037","chr9","110704112","110704296","10","1195747"
"chr9","111901802","111902021","chr9","110706019","110706238","8","1195783"
"chr9","111902217","111902434","chr9","110706434","110706646","7","1195783"
"chr9","111912299","111912427","chr9","110719914","110720042","2","1192385"
"chr9","111919079","111919398","chr9","110725444","110725766","14","1193635"
"chr9","111927803","111928102","chr9","110733855","110734154","6","1193948"
"chr9","111933887","111934058","chr9","110739805","110739976","2","1194082"
"chr9","111934930","111935207","chr9","110740849","110741125","4","1194081"
"chr9","111937855","111938155","chr9","110749895","110750199","9","1187960"
"chr9","111939098","111939173","chr1","93795970","93796048","15","18143128"
"chr9","111945252","111945265","chr5","153409354","153409366","3","41464102"
"chr9","111945295","111945540","chr9","110746401","110746671","26","1198894"
"chr9","111960160","111960340","chr3","152433547","152433713","46","40473387"
"chr9","111962016","111962151","chr3","151750650","151750785","27","39788634"
"chr9","111967513","111967813","chr9","110774988","110775275","24","1192525"
"chr9","111985603","111985891","chr9","110793503","110793797","10","1192100"
"chr9","111992244","111992497","chr6","174152363","174152589","72","62160119"
"chr9","112003630","112003933","chr9","110810937","110811239","6","1192693"
"chr9","112017450","112017684","chr9","110825352","110825588","6","1192098"
"chr9","112019461","112019565","chr9","110827351","110827455","2","1192110"
"chr9","112019918","112019946","chr8","45484008","45484035","5","66535910"
"chr9","112040137","112040393","chr13","54552195","54552446","52","57487942"
"chr9","112121660","112121670","chrX","44546405","44546415","2","67575255"
"chr9","112121721","112122045","chr9","110926911","110927231","13","1194810"
"chr9","112144055","112144330","chr9","110952636","110952906","11","1191419"
"chr9","112175004","112175297","chr9","110983909","110984203","16","1191095"
"chr9","112260596","112260769","chr9","111067778","111067966","22","1192818"
"chr9","112265529","112265734","chr13","63754209","63754408","39","48511320"
"chr9","112266647","112266963","chr9","111073869","111074193","20","1192778"
"chr9","112297277","112297579","chr9","111102735","111103030","11","1194542"
"chr9","112301750","112302035","chr11","59560038","59560325","48","52741712"
"chr9","112302071","112302103","chr6","126580289","126580322","7","14278218"
"chr9","112308990","112309090","chr9","111114165","111114265","0","1194825"
"chr9","112310605","112310885","chr9","111115798","111116076","10","1194807"
"chr9","112320196","112320325","chr9","111126307","111126437","2","1193889"
"chr9","112320627","112320820","chr9","111126740","111126924","17","1193887"
"chr9","112327994","112328275","chr9","111134114","111134394","11","1193880"
"chr9","112335783","112336088","chr7","5470642","5470930","76","106865141"
"chr9","112339155","112339264","chr1","117287665","117287776","20","4948510"
"chr9","112340646","112340824","chr19","1717038","1717214","44","110623608"
"chr9","112343593","112343863","chr9","111149594","111149865","9","1193999"
"chr9","112367720","112368007","chr9","111174714","111175004","6","1193006"
"chr9","112395646","112395831","chr9","111198506","111198692","10","1197140"
"chr9","112399850","112399974","chr9","111202726","111202850","1","1197124"
"chr9","112404496","112404687","chr9","111207170","111207361","3","1197326"
"chr9","112406267","112406570","chr9","111208943","111209246","8","1197324"
"chr9","112419001","112419281","chr9","111221166","111221454","29","1197835"
"chr9","112426488","112426800","chr19","33355872","33356175","59","79070616"
"chr9","112430982","112431260","chr9","111234024","111234308","20","1196958"
"chr9","112463245","112463531","chr10","29344041","29344325","52","83119204"
"chr9","112479073","112479225","chr16","68073669","68073817","40","44405404"
"chr9","112486060","112486320","chr9","111289522","111289807","32","1196538"
"chr9","112492423","112492713","chr9","111295774","111296078","28","1196649"
"chr9","112521062","112521366","chr9","111324284","111324594","17","1196778"
"chr9","112531596","112531891","chr9","111335337","111335634","8","1196259"
"chr9","112551409","112551710","chr9","111354678","111354981","8","1196731"
"chr9","112558371","112558670","chr9","111361692","111361991","5","1196679"
"chr9","112562533","112562628","chr9","111366128","111366223","2","1196405"
"chr9","112566577","112566709","chr3","29129700","29129829","40","83436877"
"chr9","112568279","112568551","chr9","111372169","111372440","5","1196110"
"chr9","112570321","112570463","chr15","14010818","14010957","30","98559503"
"chr9","112573902","112574199","chr14","52879118","52879412","44","59694784"
"chr9","112579255","112579500","chr9","111383941","111384186","3","1195314"
"chr9","112620917","112621156","chr9","111425820","111426060","5","1195097"
"chr9","112626754","112627061","chr12","27863620","27863927","57","84763134"
"chr9","112628034","112628279","chr11","88643601","88643856","48","23984433"
"chr9","112645235","112645553","chr9","111451779","111452097","7","1193456"
"chr9","112649701","112649989","chr9","111456230","111456528","17","1193471"
"chr9","112672201","112672485","chr9","111480261","111480545","4","1191940"
"chr9","112673404","112673635","chr9","111482224","111482456","5","1191180"
"chr9","112674072","112674234","chr9","111482896","111483048","12","1191176"
"chr9","112674308","112674410","chr10","32503651","32503748","19","80170657"
"chr9","112683840","112684131","chr6","5632108","5632390","72","107051732"
"chr9","112692807","112693087","chr13","73461011","73461290","62","39231796"
"chr9","112697370","112697667","chr9","111506499","111506796","12","1190871"
"chr9","112701245","112701347","chr11","52043148","52043246","35","60658097"
"chr9","112701653","112701818","chr9","111510819","111510979","10","1190834"
"chr9","112703796","112703962","chr2","100069015","100069158","53","12634781"
"chr9","112703969","112704279","chr9","111512826","111513138","17","1191143"
"chr9","112704818","112705119","chr9","111513677","111513973","20","1191141"
"chr9","112717530","112717818","chr9","111526071","111526359","4","1191459"
"chr9","112724098","112724239","chr8","94138574","94138715","31","18585524"
"chr9","112732461","112732764","chr9","111541741","111542051","18","1190720"
"chr9","112744338","112744625","chr2","101764441","101764747","64","10979897"
"chr9","112757119","112757428","chr9","111567848","111568139","26","1189271"
"chr9","112765695","112766007","chr9","111576750","111577061","15","1188945"
"chr9","112766467","112766765","chr9","111577860","111578156","10","1188607"
"chr9","112779509","112779594","chr1","18745459","18745551","12","94034050"
"chr9","112787538","112787849","chr9","111601828","111602139","10","1185710"
"chr9","112789229","112789476","chr9","111603530","111603782","12","1185699"
"chr9","112795369","112795658","chr9","111609713","111610002","8","1185656"
"chr9","112840642","112840940","chr9","111655563","111655835","46","1185079"
"chr9","112867200","112867452","chr8","51813351","51813614","60","61053849"
"chr9","112928704","112928997","chr9","111752621","111752914","6","1176083"
"chr9","113005678","113005933","chr9","111829405","111829660","6","1176273"
"chr9","113038900","113039228","chr9","111860912","111861237","13","1177988"
"chr9","113247856","113248144","chr9","112069466","112069750","10","1178390"
"chr9","113316357","113316515","chr9","84993746","84993904","39","28322611"
"chr9","113424619","113424913","chr9","112244361","112244667","19","1180258"
"chr9","113490252","113490574","chr9","112310369","112310691","6","1179883"
"chr9","113609166","113609476","chr9","112437406","112437715","13","1171760"
"chr9","113656813","113656987","chr9","112484452","112484623","4","1172361"
"chr9","113961745","113962029","chr9","112787912","112788194","5","1173833"
"chr9","114003749","114004056","chr9","112830295","112830606","27","1173454"
"chr9","114130816","114131053","chr9","112956906","112957138","22","1173910"
"chr9","114229512","114229814","chr9","113054200","113054505","12","1175312"
"chr9","114251736","114251891","chr9","113076467","113076619","6","1175269"
"chr9","114277046","114277342","chr9","113102120","113102416","12","1174926"
"chr9","114337067","114337383","chr9","113161811","113162119","20","1175256"
"chr9","114391584","114391876","chr9","113215752","113216044","4","1175832"
"chr9","114405781","114405915","chr9","113230001","113230135","4","1175780"
"chr9","114406221","114406397","chr9","113230439","113230613","15","1175782"
"chr9","114412752","114413069","chr20","18037580","18037887","57","96375172"
"chr9","114484983","114485112","chr12","64505010","64505135","32","49979973"
"chr9","114544202","114544443","chr9","113369708","113369983","41","1174494"
"chr9","114565112","114565394","chr9","113392847","113393130","8","1172265"
"chr9","114570612","114570908","chr9","113398226","113398527","14","1172386"
"chr9","114576726","114576970","chr7","92616878","92617124","49","21959848"
"chr9","114654586","114654870","chr9","113489526","113489818","22","1165060"
"chr9","114671798","114672140","chr9","113501390","113501731","15","1170408"
"chr9","114681533","114681687","chr3","38028233","38028396","34","76653300"
"chr9","114682008","114682128","chr5","172489020","172489140","26","57807012"
"chr9","114707806","114708099","chr9","113536888","113537181","6","1170918"
"chr9","114718409","114718571","chr9","113547396","113547559","14","1171013"
"chr9","114729244","114729537","chr9","113560987","113561291","22","1168257"
"chr9","114732729","114733056","chr9","113564485","113564800","20","1168244"
"chr9","114740832","114741015","chr13","71842081","71842251","36","42898751"
"chr9","114782186","114782306","chr9","113616678","113616798","3","1165508"
"chr9","114815242","114815562","chr9","113649252","113649559","17","1165990"
"chr9","114823979","114824268","chr9","113658183","113658472","6","1165796"
"chr9","114826178","114826452","chr9","113660587","113660871","15","1165591"
"chr9","114873764","114873920","chrX","124230750","124230911","38","9356986"
"chr9","114893680","114893970","chr9","113727787","113728077","11","1165893"
"chr9","114906662","114906972","chr9","113740769","113741081","11","1165893"
"chr9","114911927","114912220","chr9","113745930","113746223","8","1165997"
"chr9","114915630","114915910","chr9","113749716","113749995","10","1165914"
"chr9","114974395","114974549","chr1","20887612","20887751","48","94086783"
"chr9","115050101","115050392","chr9","113886635","113886926","6","1163466"
"chr9","115076345","115076656","chr9","113914010","113914320","17","1162335"
"chr9","115081471","115081624","chr9","113919152","113919305","8","1162319"
"chr9","115094215","115094356","chr9","113931878","113932031","20","1162337"
"chr9","115114126","115114425","chr9","113951777","113952076","4","1162349"
"chr9","115173383","115173686","chr9","114011397","114011701","7","1161986"
"chr9","115189864","115190156","chr9","114027276","114027569","13","1162588"
"chr9","115252264","115252534","chr9","114089090","114089380","37","1163174"
"chr9","115253026","115253310","chr9","114089852","114090146","27","1163174"
"chr9","115268635","115268903","chr9","114105542","114105810","7","1163093"
"chr9","115281695","115282008","chr9","114118513","114118826","14","1163182"
"chr9","115302318","115302472","chr9","114139221","114139375","3","1163097"
"chr9","115302498","115302622","chr9","114139396","114139520","3","1163102"
"chr9","115523973","115524249","chr9","114377442","114377720","14","1146531"
"chr9","115596952","115597010","chr9","114452152","114452209","2","1144800"
"chr9","115627732","115627920","chr9","114486043","114486237","8","1141689"
"chr9","115638022","115638292","chr9","114496166","114496437","2","1141856"
"chr9","115673548","115673629","chr9","114532128","114532209","1","1141420"
"chr9","115673729","115673827","chr9","114532309","114532407","5","1141420"
"chr9","115695330","115695472","chr9","114554034","114554176","1","1141296"
"chr9","115705036","115705119","chr9","3301496","3301580","24","112403540"
"chr9","115731076","115731315","chr9","114590611","114590851","3","1140465"
"chr9","115747267","115747568","chr9","114606390","114606691","4","1140877"
"chr9","115750638","115750917","chr9","114609781","114610074","20","1140857"
"chr9","115785197","115785470","chr9","114644342","114644615","6","1140855"
"chr9","115840202","115840396","chr9","114700433","114700627","10","1139769"
"chr9","115864677","115864968","chr9","114724785","114725078","12","1139892"
"chr9","115872791","115873006","chr9","114732916","114733132","2","1139875"
"chr9","115892234","115892546","chr9","114754392","114754704","8","1137842"
"chr9","115934437","115934732","chr2","147298646","147298934","51","31364209"
"chr9","116188057","116188362","chr9","115061454","115061755","24","1126603"
"chr9","116228229","116228534","chr9","115101235","115101541","8","1126994"
"chr9","116315206","116315343","chr9","115187326","115187463","2","1127880"
"chr9","116316450","116316735","chr9","115188519","115188793","26","1127931"
"chr9","116376497","116376788","chr9","115250119","115250411","10","1126378"
"chr9","116466816","116466962","chr7","10651936","10652072","43","105814880"
"chr9","116466998","116467116","chrX","108971246","108971363","14","7495752"
"chr9","116492167","116492475","chr9","115367650","115367962","13","1124517"
"chr9","116651657","116651946","chr9","115526938","115527230","10","1124719"
"chr9","116661994","116662291","chr9","115543179","115543480","6","1118815"
"chr9","116683909","116684211","chr9","115565852","115566167","21","1118057"
"chr9","116712919","116713214","chr9","115594897","115595187","15","1118022"
"chr9","116724936","116725249","chr9","115606965","115607278","10","1117971"
"chr9","116796633","116796925","chr9","115679472","115679761","14","1117161"
"chr9","116825958","116826249","chr9","115709215","115709504","10","1116743"
"chr9","116859778","116859908","chr9","115740103","115740233","6","1119675"
"chr9","116860254","116860289","chr4","14956334","14956369","3","101903920"
"chr9","116938934","116939071","chr9","115815172","115815318","11","1123762"
"chr9","116955446","116955736","chr9","115835577","115835857","17","1119869"
"chr9","116955927","116956228","chr9","115836044","115836345","11","1119883"
"chr9","116990793","116991043","chr9","115872094","115872344","2","1118699"
"chr9","117009993","117010171","JH682236","192307","192486","40","116817686"
"chr9","117023219","117023375","chr9","86631758","86631910","32","30391461"
"chr9","117032106","117032409","chr9","115913382","115913695","18","1118724"
"chr9","117072505","117072781","chr9","115954132","115954417","20","1118373"
"chr9","117077018","117077336","chr9","115958278","115958597","14","1118740"
"chr9","117085822","117086121","chr9","115967063","115967362","10","1118759"
"chr9","117091318","117091610","chr9","115974128","115974415","10","1117190"
"chr9","117096192","117096515","chr9","115979102","115979425","8","1117090"
"chr9","117098359","117098505","chr9","115981232","115981379","5","1117127"
"chr9","117099611","117099896","chr9","115982485","115982771","12","1117126"
"chr9","117101443","117101735","chr9","115984053","115984349","10","1117390"
"chr9","117103494","117103805","chr9","115985986","115986293","15","1117508"
"chr9","117104744","117104909","chr9","115987249","115987414","8","1117495"
"chr9","117125114","117125427","chr9","116007778","116008090","5","1117336"
"chr9","117127641","117127790","chr9","116010303","116010453","13","1117338"
"chr9","117131578","117131703","chr9","116014180","116014305","1","1117398"
"chr9","117133926","117134229","chr9","116016513","116016817","17","1117413"
"chr9","117158825","117159038","chr9","54871888","54872070","59","62286937"
"chr9","117159331","117159470","chr5","45356290","45356430","23","71803041"
"chr9","117164855","117165168","chr9","116045318","116045632","10","1119537"
"chr9","117166479","117166778","chr9","116046938","116047238","31","1119541"
"chr9","117197156","117197291","chr9","116078867","116079002","4","1118289"
"chr9","117197565","117197730","chr9","116079282","116079446","6","1118283"
"chr9","117210750","117211052","chr9","116093500","116093822","25","1117250"
"chr9","117218594","117218897","chr11","111565027","111565329","54","5653567"
"chr9","117268774","117269076","chr9","116150728","116151030","8","1118046"
"chr9","117288463","117288771","chr9","116170959","116171266","12","1117504"
"chr9","117377438","117377747","chr9","116259420","116259727","9","1118018"
"chr9","117378917","117379118","chr9","116260896","116261097","3","1118021"
"chr9","117379568","117379860","chr9","116261547","116261839","11","1118021"
"chr9","117385681","117385949","chr1","27113084","27113350","47","90272597"
"chr9","117410822","117411076","chr14","107640563","107640819","47","9770259"
"chr9","117411110","117411151","chr1","112395701","112395744","6","5015409"
"chr9","117419886","117420151","chr9","116303497","116303762","5","1116389"
"chr9","117420553","117420831","chr9","116304831","116305110","12","1115722"
"chr9","117435349","117435660","chr9","116321290","116321605","14","1114059"
"chr9","117437186","117437475","chr9","116323145","116323430","15","1114041"
"chr9","117439097","117439280","chr9","116326910","116327078","17","1112187"
"chr9","117440748","117440869","chr20","19814709","19814828","23","97626039"
"chr9","117468766","117469061","chr9","116359188","116359482","4","1109578"
"chr9","117479183","117479484","chr9","116369528","116369829","5","1109655"
"chr9","117491791","117491919","chr1","129871697","129871827","22","12379906"
"chr9","117497700","117497933","chr9","116388855","116389045","52","1108845"
"chr9","117499743","117500000","chr9","116391762","116392058","50","1107981"
"chr9","117503672","117503983","chr9","116395662","116395972","8","1108010"
"chr9","117506091","117506298","chr9","116398084","116398292","9","1108007"
"chr9","117506299","117506581","chr9","116398293","116398575","1","1108006"
"chr9","117506582","117506710","chr9","116398576","116398704","3","1108006"
"chr9","117506733","117506850","chr9","116398727","116398843","4","1108006"
"chr9","117514540","117514846","chr9","116409366","116409672","6","1105174"
"chr9","117517402","117517680","chr9","116413384","116413666","11","1104018"
"chr9","117524931","117525119","chr3","78556408","78556595","40","38968523"
"chr9","117527152","117527471","chr9","116421633","116421943","20","1105519"
"chr9","117531217","117531532","chr9","116423939","116424241","23","1107278"
"chr9","117538672","117538962","chr9","116431090","116431380","8","1107582"
"chr9","117543848","117544160","chr9","116436375","116436694","23","1107473"
"chr9","117544613","117544909","chr9","116437120","116437416","7","1107493"
"chr9","117549634","117549768","chr9","116442504","116442647","14","1107130"
"chr9","117549771","117549861","chr20","9083124","9083211","19","108466647"
"chr9","117551920","117552054","chr9","116442504","116442647","14","1109416"
"chr9","117552057","117552350","chr9","116442650","116442938","8","1109407"
"chr9","117555330","117555594","chr9","116449892","116450154","21","1105438"
"chr9","117558711","117558868","chr9","116454821","116454980","3","1103890"
"chr9","117566482","117566644","chr9","116465299","116465457","9","1101183"
"chr9","117575929","117576215","chr18","3644200","3644488","66","113931729"
"chr9","117583986","117584273","chr9","116481853","116482138","6","1102133"
"chr9","117591431","117591716","chr9","116489296","116489580","16","1102135"
"chr9","117596027","117596319","chr8","94393001","94393292","53","23203026"
"chr9","117600253","117600579","chr9","116497286","116497628","28","1102967"
"chr9","117605806","117606101","chr9","116502642","116502920","26","1103164"
"chr9","117616932","117617225","chr9","116513069","116513369","14","1103863"
"chr9","117619748","117620057","chr9","116515952","116516261","7","1103796"
"chr9","117621402","117621683","chr9","116517612","116517893","5","1103790"
"chr9","117624322","117624583","chr9","116520196","116520460","7","1104126"
"chr9","117636584","117636698","chr9","116532065","116532180","3","1104519"
"chr9","117687330","117687624","chr9","116582292","116582585","6","1105038"
"chr9","117690801","117690998","chr9","116585779","116585976","7","1105022"
"chr9","117712109","117712390","chr9","116607468","116607721","35","1104641"
"chr9","117736215","117736300","chr11","92599905","92599995","19","25136310"
"chr9","117737487","117737764","chr9","116632403","116632707","37","1105084"
"chr9","117750953","117751064","chr4","52607254","52607360","24","65143699"
"chr9","117751112","117751361","chr9","116646460","116646708","8","1104652"
"chr9","117766919","117767063","chr9","116661901","116662046","7","1105018"
"chr9","117793497","117793798","chr9","116688675","116688966","18","1104822"
"chr9","117843852","117844145","chr9","116739087","116739379","6","1104765"
"chr9","117866741","117866979","chr9","116761858","116762095","11","1104883"
"chr9","117902625","117902919","chr9","116797579","116797873","6","1105046"
"chr9","117960538","117960830","chr9","116856305","116856597","6","1104233"
"chr9","117965922","117966211","chr9","116861686","116861975","4","1104236"
"chr9","117990624","117990924","chr9","116889205","116889507","6","1101419"
"chr9","118002802","118003111","chr9","116901696","116902001","10","1101106"
"chr9","118029447","118029750","chr9","116928519","116928823","5","1100928"
"chr9","118040743","118041038","chr9","116939944","116940244","19","1100799"
"chr9","118041382","118041564","chr9","116940557","116940740","9","1100825"
"chr9","118046876","118047069","chr9","116946045","116946237","7","1100831"
"chr9","118074892","118075182","chr6","50522980","50523258","62","67551912"
"chr9","118091249","118091424","chr9","116992246","116992447","28","1099003"
"chr9","118091450","118091757","chr9","116992452","116992753","14","1098998"
"chr9","118202040","118202324","chr9","117100735","117101023","18","1101305"
"chr9","118220702","118221006","chr9","117119794","117120098","9","1100908"
"chr9","118229848","118230141","chr9","117128610","117128889","22","1101238"
"chr9","118233407","118233719","chr9","117132176","117132478","24","1101231"
"chr9","118271652","118271931","chr9","117170740","117171040","28","1100912"
"chr9","118272600","118272907","chr9","117171723","117172027","21","1100877"
"chr9","118281542","118281854","chr9","117180977","117181308","28","1100565"
"chr9","118365761","118366075","chr9","117265512","117265820","13","1100249"
"chr9","118387706","118388002","chr9","117289806","117290113","19","1097900"
"chr9","118390137","118390435","chr9","117292264","117292546","19","1097873"
"chr9","118393720","118393851","chr9","117296152","117296271","15","1097568"
"chr9","118393879","118394053","chr9","117296307","117296487","10","1097572"
"chr9","118399974","118400268","chr9","117302848","117303163","29","1097126"
"chr9","118403921","118404229","chr9","117306818","117307133","14","1097103"
"chr9","118432394","118432478","chr9","117335365","117335449","0","1097029"
"chr9","118433066","118433183","chr9","117336022","117336139","3","1097044"
"chr9","118441456","118441712","chr9","117344693","117344947","11","1096763"
"chr9","118498424","118498732","chr9","117401548","117401853","16","1096876"
"chr9","118503146","118503433","chr9","117406269","117406559","19","1096877"
"chr9","118505097","118505383","chr9","117408259","117408545","2","1096838"
"chr9","118539594","118539869","chr9","117443143","117443424","13","1096451"
"chr9","118547059","118547341","chr9","117450182","117450464","5","1096877"
"chr9","118547696","118547982","chr9","117450818","117451098","11","1096878"
"chr9","118548045","118548297","chr9","117451161","117451413","5","1096884"
"chr9","118548437","118548597","chr9","117451553","117451712","2","1096884"
"chr9","118551629","118551783","chr9","117454660","117454814","4","1096969"
"chr9","118555145","118555459","chr9","117458182","117458482","29","1096963"
"chr9","118575671","118575949","chr9","117478774","117479050","12","1096897"
"chr9","118581267","118581560","chrX","50021280","50021572","61","68559987"
"chr9","118597400","118597567","chr9","117500131","117500298","7","1097269"
"chr9","118609563","118609854","chr9","117512438","117512750","27","1097125"
"chr9","118632049","118632155","chr12","32617312","32617417","18","86014737"
"chr9","118900777","118901036","chr9","117803067","117803348","30","1097710"
"chr9","118947259","118947417","chr9","91288482","91288636","34","27658777"
"chr9","118947418","118947498","chr7","2805668","2805748","14","116141750"
"chr9","119008392","119008702","chr9","117910428","117910738","6","1097964"
"chr9","119033483","119033766","chr9","117935505","117935786","8","1097978"
"chr9","119047816","119047957","chr9","117949827","117949957","13","1097989"
"chr9","119062713","119063000","chr9","117964753","117965057","26","1097960"
"chr9","119074065","119074376","chr9","117976076","117976378","15","1097989"
"chr9","119156670","119156939","chr9","118061324","118061622","45","1095346"
"chr9","119213648","119213871","chr7","40872150","40872364","49","78341498"
"chr9","119225829","119226131","chr9","118130214","118130523","12","1095615"
"chr9","119237277","119237586","chr4","152226280","152226592","66","32989003"
"chr9","119379726","119380030","chr9","118283781","118284085","4","1095945"
"chr9","119394898","119395009","chr9","88436818","88436931","19","30958080"
"chr9","119435767","119436041","chr9","118341301","118341561","23","1094466"
"chr9","119470083","119470386","chr9","118375917","118376218","11","1094166"
"chr9","119528175","119528436","chr7","160179366","160179629","82","40651191"
"chr9","119535483","119535766","chr1","198202863","198203154","71","78667380"
"chr9","119584393","119584682","chr9","118484278","118484571","20","1100115"
"chr9","119592941","119593268","chr9","118493306","118493629","13","1099635"
"chr9","119613485","119613656","chr9","118513675","118513825","24","1099810"
"chr9","119616348","119616617","chr7","157971739","157972008","58","38355391"
"chr9","119616920","119617226","chr1","46010090","46010390","69","73606830"
"chr9","119620004","119620305","chr9","118520744","118521045","5","1099260"
"chr9","119631961","119632252","chr9","118532560","118532851","9","1099401"
"chr9","119632906","119633067","chr10","14005143","14005298","35","105627763"
"chr9","119639680","119639988","chr9","118540670","118540979","16","1099010"
"chr9","119647977","119648280","chr9","118549029","118549317","22","1098948"
"chr9","119663829","119664133","chr9","118565955","118566259","9","1097874"
"chr9","119688598","119688779","chr9","118591394","118591575","7","1097204"
"chr9","119689155","119689174","chr9","118591952","118591970","1","1097203"
"chr9","119706259","119706415","chr13","37806114","37806270","29","81900145"
"chr9","119707099","119707255","chr9","118609949","118610101","16","1097150"
"chr9","119718999","119719282","chr9","118621688","118621971","4","1097311"
"chr9","119844208","119844376","chr9","118746811","118746978","10","1097397"
"chr9","119875483","119875802","chr9","118775597","118775886","38","1099886"
"chr9","119914501","119914792","chr11","95219088","95219380","52","24695413"
"chr9","119974644","119974901","chr9","118869881","118870138","12","1104763"
"chr9","120047019","120047117","chr9","118942299","118942395","5","1104720"
"chr9","120048901","120049195","chr9","118944190","118944484","13","1104711"
"chr9","120118030","120118334","chr9","119013735","119014043","8","1104295"
"chr9","120310795","120310911","chr9","119208298","119208414","1","1102497"
"chr9","120310942","120311111","chr9","119208441","119208632","26","1102501"
"chr9","120370188","120370472","chr11","95417935","95418225","63","24952253"
"chr9","120393228","120393519","chr9","119291186","119291469","14","1102042"
"chr9","120393712","120393950","chr9","119291660","119291897","13","1102052"
"chr9","120447548","120447746","chr11","48017316","48017508","50","72430232"
"chr9","120447794","120447924","chr9","119346126","119346245","13","1101668"
"chr9","120459795","120460094","chr1","34930657","34930953","69","85529138"
"chr9","120464969","120465233","chr9","119363025","119363289","11","1101944"
"chr9","120474124","120474279","chr9","119372231","119372383","6","1101893"
"chr9","120485484","120485764","chr9","119383612","119383889","14","1101872"
"chr9","120492089","120492286","chr9","119389988","119390175","20","1102101"
"chr9","120492581","120492715","chr9","119390480","119390614","7","1102101"
"chr9","120495745","120495966","chr9","119393749","119393970","3","1101996"
"chr9","120515553","120515850","chr9","119413586","119413893","17","1101967"
"chr9","120552627","120552938","chr14","46869765","46870085","84","73682862"
"chr9","120584772","120584894","chr9","119483126","119483248","3","1101646"
"chr9","120641615","120641895","chr9","119540214","119540489","14","1101401"
"chr9","120657154","120657381","chr1","14828122","14828342","44","105829032"
"chr9","120689469","120689800","chr9","119586035","119586356","25","1103434"
"chr9","120727444","120727713","chr9","119625325","119625572","31","1102119"
"chr9","120736083","120736391","chr9","119634281","119634593","15","1101802"
"chr9","120749266","120749564","chr9","119648014","119648316","20","1101252"
"chr9","120753762","120754075","chr9","119652365","119652684","15","1101397"
"chr9","120768549","120768684","chr11","95527470","95527604","35","25241079"
"chr9","120772588","120772802","chrX","50716939","50717149","58","70055649"
"chr9","120773285","120773590","chr12","63788215","63788522","53","56985070"
"chr9","120799242","120799527","chr9","119693103","119693365","29","1106139"
"chr9","120832722","120832986","chr9","119726315","119726579","12","1106407"
"chr9","120862126","120862430","chr9","119756241","119756520","31","1105885"
"chr9","120945581","120945718","chr9","119839726","119839874","20","1105855"
"chr9","121037700","121037771","chr9","119932467","119932539","2","1105233"
"chr9","121105935","121106218","chr9","120000523","120000816","17","1105412"
"chr9","121272938","121273254","chr9","120168444","120168758","13","1104494"
"chr9","121308075","121308409","chr9","120203327","120203648","29","1104748"
"chr9","121349569","121349860","chr9","120247361","120247652","14","1102208"
"chr9","121406094","121406194","chr9","120304387","120304487","1","1101707"
"chr9","121406216","121406258","chr9","120304509","120304551","3","1101707"
"chr9","121473032","121473314","chr9","120374002","120374281","7","1099030"
"chr9","121548186","121548487","chr4","35454882","35455179","53","86093304"
"chr9","121602352","121602629","chr9","120502935","120503212","8","1099417"
"chr9","121716362","121716663","chr9","120617743","120618044","7","1098619"
"chr9","121903430","121903715","chr16","30049598","30049881","63","91853832"
"chr9","121922324","121922608","chr16","30049598","30049881","64","91872726"
"chr9","122008019","122008264","chr9","120885499","120885738","9","1122520"
"chr9","122071627","122071778","chr9","801634","801780","24","121269993"
"chr9","122071779","122071846","chr4","140933896","140933959","11","18862117"
"chr9","122124107","122124398","chr9","120999472","120999764","4","1124635"
"chr9","122152364","122152681","chr9","121028443","121028764","14","1123921"
"chr9","122308444","122308724","chr9","121189957","121190241","18","1118487"
"chr9","122426058","122426329","chr9","121306337","121306624","22","1119721"
"chr9","122434711","122435004","chr9","121315216","121315523","43","1119495"
"chr9","122474264","122474549","chr9","121355122","121355407","6","1119142"
"chr9","122532472","122532768","chr9","121414058","121414354","4","1118414"
"chr9","122537026","122537337","chr9","121418562","121418872","15","1118464"
"chr9","122546034","122546352","chr9","121427564","121427864","27","1118470"
"chr9","122659261","122659569","chr9","121543578","121543881","11","1115683"
"chr9","122663185","122663486","chr9","121547804","121548105","11","1115381"
"chr9","122668694","122668858","chr1","45065798","45065959","28","77602896"
"chr9","122668888","122669006","chr2","83766108","83766225","20","38902780"
"chr9","122716764","122717064","chr8","36210505","36210799","68","86506259"
"chr9","122718948","122719118","chr9","18285887","18286056","29","104433061"
"chr9","122723693","122723992","chr9","121610848","121611142","16","1112845"
"chr9","122738684","122738998","chr9","121624772","121625081","13","1113912"
"chr9","122739020","122739321","chr9","121625103","121625404","9","1113917"
"chr9","122741695","122741948","chr9","121627793","121628046","14","1113902"
"chr9","122772014","122772310","chr9","121659865","121660161","3","1112149"
"chr9","122783656","122783955","chr9","121672184","121672484","15","1111472"
"chr9","122784766","122785051","chr9","121673293","121673582","10","1111473"
"chr9","122802188","122802460","chr9","121690639","121690911","5","1111549"
"chr9","122817425","122817725","chr9","121705843","121706139","14","1111582"
"chr9","122946396","122946691","chr9","121838187","121838482","11","1108209"
"chr9","122949475","122949763","chr9","121841510","121841794","7","1107965"
"chr9","122960390","122960676","chr9","121852500","121852786","9","1107890"
"chr9","122993300","122993531","chr4","6834072","6834310","53","116159228"
"chr9","123000721","123001036","chr9","121892795","121893110","13","1107926"
"chr9","123339894","123340051","chr17","52222366","52222518","30","71117528"
"chr9","123522162","123522456","chr9","122409374","122409667","9","1112788"
"chr9","123585276","123585582","chr9","122471541","122471844","19","1113735"
"chr9","123770788","123770902","chr9","122658554","122658668","7","1112234"
"chr9","123948331","123948371","chr3","139974736","139974777","8","16026405"
"chr9","123985480","123985768","chr9","122883313","122883624","43","1102167"
"chr9","123994900","123995168","chr9","122891624","122891890","10","1103276"
"chr9","124003158","124003472","chr9","102084840","102085152","63","21918318"
"chr9","124020598","124020894","chr15","20591601","20591894","59","103428997"
"chr9","124042125","124042413","chr9","122939388","122939708","40","1102737"
"chr9","124067769","124068081","chr9","122965843","122966149","17","1101926"
"chr9","124111729","124112025","chr9","123009482","123009798","24","1102247"
"chr9","124120603","124120889","chr9","123019060","123019345","9","1101543"
"chr9","124268805","124268879","chr9","123165955","123166027","3","1102850"
"chr9","124302453","124302740","chr9","123198405","123198693","16","1104048"
"chr9","124409216","124409370","chr7","115979076","115979229","29","8430140"
"chr9","124442540","124442860","chr9","123335124","123335443","11","1107416"
"chr9","124444734","124445035","chr9","123337317","123337617","12","1107417"
"chr9","124499124","124499226","chr9","123393682","123393784","0","1105442"
"chr9","124510410","124510642","chr9","123405013","123405243","6","1105397"
"chr9","124512884","124513185","chr9","123407474","123407788","26","1105410"
"chr9","124516410","124516713","chr9","123411387","123411690","6","1105023"
"chr9","124524989","124525132","chr9","123418869","123419012","1","1106120"
"chr9","124587291","124587562","chr9","123481789","123482053","15","1105502"
"chr9","124591856","124592145","chr9","123486325","123486608","18","1105531"
"chr9","124594851","124595098","chr9","123489872","123490119","2","1104979"
"chr9","124597302","124597556","chr9","123492050","123492297","11","1105252"
"chr9","124600345","124600578","chr9","123499795","123499994","52","1100550"
"chr9","124605118","124605229","chr1","160037558","160037669","17","35432440"
"chr9","124629044","124629238","chr11","109515429","109515628","62","15113615"
"chr9","124637639","124637804","chr9","123536360","123536525","1","1101279"
"chr9","124638853","124639150","chr5","19021997","19022290","58","105616856"
"chr9","124643889","124644088","chr8","69729004","69729200","39","54914885"
"chr9","124664200","124664491","chr4","122595128","122595418","60","2069072"
"chr9","124665129","124665459","chr7","64426107","64426435","66","60239022"
"chr9","124681634","124681649","chr18","3847925","3847939","3","120833709"
"chr9","124681687","124681960","chr3","157652954","157653239","60","32971267"
"chr9","124688159","124688260","chr9","123583154","123583261","7","1105005"
"chr9","124693841","124694146","chr9","123588670","123588982","25","1105171"
"chr9","124695667","124695803","chr9","123590506","123590639","7","1105161"
"chr9","124695932","124696075","chr9","123590769","123590909","9","1105163"
"chr9","124705604","124705706","chr9","123600682","123600788","9","1104922"
"chr9","124718380","124718667","chr9","123614257","123614542","17","1104123"
"chr9","124736797","124737120","chr9","123633775","123634083","22","1103022"
"chr9","124737445","124737610","chr13","73038885","73039048","38","51698560"
"chr9","124755947","124756242","chr9","123654465","123654760","4","1101482"
"chr9","124818999","124819145","chr9","123718773","123718919","2","1100226"
"chr9","124868355","124868486","chr11","106085517","106085648","37","18782838"
"chr9","124869095","124869150","chr12","95723167","95723218","11","29145928"
"chr9","124899854","124900149","chr9","123800739","123801034","6","1099115"
"chr9","124904073","124904364","chr9","123805300","123805591","11","1098773"
"chr9","124917283","124917587","chr9","123818237","123818533","19","1099046"
"chr9","124972029","124972185","chr9","123875551","123875707","6","1096478"
"chr9","125093393","125093694","chr9","123986863","123987161","14","1106530"
"chr9","125102039","125102189","chr14","112696162","112696308","40","12405877"
"chr9","125105277","125105551","chr9","123997526","123997839","57","1107751"
"chr9","125131435","125131732","chr9","124030193","124030530","43","1101242"
"chr9","125141099","125141372","chr9","124039898","124040171","7","1101201"
"chr9","125143634","125143927","chr7","91577498","91577776","19","33566136"
"chr9","125158806","125158997","chr7","58729599","58729780","46","66429207"
"chr9","125162865","125163042","chr9","124071291","124071467","6","1091574"
"chr9","125178502","125178790","chr9","124087476","124087761","16","1091026"
"chr9","125179870","125180176","chr9","124088842","124089145","12","1091028"
"chr9","125234454","125234718","chr7","67006604","67006868","67","58227850"
"chr9","125336305","125336623","chr9","32668102","32668409","64","92668203"
"chr9","125403318","125403575","chr14","62491192","62491444","60","62912126"
"chr9","125414387","125414586","chr2","186908456","186908658","44","61494069"
"chr9","125485828","125485924","chr9","124398110","124398199","9","1087718"
"chr9","125641142","125641414","chr9","124548816","124549088","3","1092326"
"chr9","125655273","125655584","chr9","124562233","124562545","8","1093040"
"chrX","17956662","17956972","chrX","16725705","16726015","7","1230957"
"chrX","35258293","35258566","chrX","34151245","34151518","6","1107048"
"chrX","43777861","43778147","chrX","43612520","43612808","25","165341"
"chrX","45350728","45350990","chrX","45281051","45281316","63","69677"
"chrX","45743851","45744193","chrX","45623197","45623527","17","120654"
"chrX","47578994","47579291","chrX","47545736","47546033","10","33258"
"chrX","96206785","96207071","chrX","97471530","97471816","4","1264745"
"chrX","108265380","108265687","chrX","121387352","121387657","10","13121972"
"chrX","108658487","108658771","chrX","121790184","121790475","14","13131697"
"chrX","114950083","114950375","chr7","6547566","6547862","63","108402517"
"chrX","115867370","115867671","chrX","128885614","128885917","19","13018244"
"chrX","14075","14393","chr16","58924259","58924568","65","58910184"
"chrX","35244","35550","chr1","19076165","19076474","54","19040921"
"chrX","39921","40146","chr6","151329651","151329875","46","151289730"
"chrX","101543","101707","chr1","39513747","39513909","40","39412204"
"chrX","125630","125775","chr16","10767566","10767716","38","10641936"
"chrX","188723","188913","chrX","107339105","107339290","43","107150382"
"chrX","261386","261696","chr4","103468600","103468909","58","103207214"
"chrX","279449","279638","chrX","107339105","107339290","35","107059656"
"chrX","309592","309870","chr9","34061394","34061672","52","33751802"
"chrX","342472","342778","chr15","25283553","25283851","70","24941081"
"chrX","386293","386610","chr5","81488443","81488750","57","81102150"
"chrX","397426","397588","JH680086","345974","346143","20","51452"
"chrX","426045","426340","JH680086","321356","321655","20","104689"
"chrX","428312","428622","JH680086","319157","319464","17","109155"
"chrX","469355","469645","chr4","100530810","100531098","66","100061455"
"chrX","476197","476494","JH680086","267483","267780","15","208714"
"chrX","513285","513596","JH680086","240156","240465","8","273129"
"chrX","533356","533664","chr13","84452913","84453227","55","83919557"
"chrX","545431","545730","JH680086","211151","211459","29","334280"
"chrX","560149","560442","JH680086","196510","196802","41","363639"
"chrX","561124","561288","JH680086","175910","176073","25","385214"
"chrX","569521","569646","chr19","16290186","16290314","24","15720665"
"chrX","580263","580555","JH680086","196510","196802","11","383753"
"chrX","581258","581406","chr6","148154766","148154916","37","147573508"
"chrX","591458","591622","JH680086","189778","189942","3","401680"
"chrX","591928","592052","JH680086","189352","189476","3","402576"
"chrX","593961","594115","chr1","34052300","34052451","38","33458339"
"chrX","600514","600677","JH680086","175910","176073","8","424604"
"chrX","634758","635066","JH680086","142181","142489","13","492577"
"chrX","658309","658487","JH680086","115833","116003","10","542476"
"chrX","658780","658915","JH680086","115404","115540","5","543376"
"chrX","667407","667714","JH680086","104749","105057","47","562658"
"chrX","668648","668968","JH680086","103973","104285","14","564675"
"chrX","675561","675731","JH680086","97210","97377","6","578351"
"chrX","675811","675960","JH680086","96987","97136","4","578824"
"chrX","681710","681920","JH680086","91440","91650","7","590270"
"chrX","682241","682371","JH680086","90996","91126","1","591245"
"chrX","685205","685441","chr16","28567012","28567218","92","27881807"
"chrX","693890","694081","JH680086","78840","79035","16","615050"
"chrX","704425","704733","JH680086","61613","61932","20","642812"
"chrX","713391","713682","chrX","6605464","6605752","72","5892073"
"chrX","720631","720749","chr18","28460702","28460817","30","27740071"
"chrX","809211","809396","chrX","8950","9136","9","800261"
"chrX","809397","809707","chrX","9137","9443","12","800260"
"chrX","809708","809796","chrX","9444","9532","2","800264"
"chrX","850967","851259","chrX","50640","50932","6","800327"
"chrX","874332","874371","chr1","4590193","4590229","6","3715861"
"chrX","874374","874497","chr2","85795101","85795227","20","84920727"
"chrX","874717","874727","chr2","86546670","86546680","5","85671953"
"chrX","874729","874803","chr19","51145014","51145077","21","50270285"
"chrX","923121","923293","chrX","127854","128040","20","795267"
"chrX","923815","924127","chr2","101508511","101508813","52","100584696"
"chrX","942511","942799","chr1","219515609","219515894","68","218573098"
"chrX","969502","969631","chr14","5923002","5923113","41","4953500"
"chrX","995041","995368","chrX","144587","144917","11","850454"
"chrX","1003002","1003289","chrX","153040","153321","12","849962"
"chrX","1025359","1025652","chrX","175042","175337","8","850317"
"chrX","1049287","1049583","chrX","198747","199044","8","850540"
"chrX","1050092","1050402","chrX","199556","199866","4","850536"
"chrX","1063250","1063556","chrX","212835","213132","13","850415"
"chrX","1071016","1071316","chrX","220600","220906","10","850416"
"chrX","1074766","1075065","chrX","224061","224366","12","850705"
"chrX","1092829","1093110","chr2","102831206","102831491","57","101738377"
"chrX","1093404","1093697","JH682906","27720","28014","62","1065684"
"chrX","1094567","1094701","chrX","243677","243812","9","850890"
"chrX","1102065","1102363","chrX","251139","251440","10","850926"
"chrX","1111113","1111419","chrX","260366","260671","3","850747"
"chrX","1116608","1116902","chrX","267071","267372","12","849537"
"chrX","1119617","1119871","chr1","38226653","38226911","56","37107036"
"chrX","1120581","1120870","chrX","269631","269923","6","850950"
"chrX","1125074","1125363","chrX","273914","274198","13","851160"
"chrX","1130539","1130850","chrX","279338","279649","2","851201"
"chrX","1131408","1131691","chrX","280211","280490","11","851197"
"chrX","1146395","1146724","chrX","296526","296859","13","849869"
"chrX","1148271","1148546","chr2","48014863","48015140","60","46866592"
"chrX","1150547","1150855","chrX","300743","301044","9","849804"
"chrX","1162018","1162353","chrX","311655","311971","23","850363"
"chrX","1162980","1163225","chrX","312612","312882","28","850368"
"chrX","1164010","1164161","chr10","19872472","19872610","39","18708462"
"chrX","1168411","1168563","chr19","14673246","14673394","37","13504835"
"chrX","1192307","1192366","chr20","51565073","51565124","11","50372766"
"chrX","1195024","1195320","chrX","344929","345228","13","850095"
"chrX","1195650","1195908","chrX","345654","345953","48","849996"
"chrX","1197386","1197476","chrX","347434","347526","5","849952"
"chrX","1203216","1203497","chrX","353293","353574","4","849923"
"chrX","1206814","1207093","chrX","356577","356877","40","850237"
"chrX","1214582","1214859","chrX","364379","364661","9","850203"
"chrX","1219968","1220134","chrX","369804","369979","14","850164"
"chrX","1220160","1220281","chrX","370019","370130","13","850141"
"chrX","1252270","1252549","chrX","401984","402263","2","850286"
"chrX","1264326","1264632","chrX","418265","418572","5","846061"
"chrX","1283783","1284082","chrX","438873","439171","8","844910"
"chrX","1305436","1305731","chrX","457971","458267","8","847465"
"chrX","1321430","1321724","chrX","474013","474301","15","847417"
"chrX","1324757","1325066","chr7","37314940","37315240","58","35990183"
"chrX","1328003","1328310","chrX","497697","498004","2","830306"
"chrX","1337772","1337919","chrX","507412","507551","13","830360"
"chrX","1339375","1339667","chrX","509011","509303","6","830364"
"chrX","1352419","1352733","chrX","525539","525882","40","826880"
"chrX","1370080","1370392","chrX","537550","537861","5","832530"
"chrX","1390533","1390850","chrX","557600","557913","13","832933"
"chrX","1398305","1398593","chrX","565357","565648","14","832948"
"chrX","1401002","1401287","chrX","567965","568202","50","833037"
"chrX","1424213","1424495","chrX","585778","586083","30","838435"
"chrX","1482928","1483216","chr7","114771143","114771443","63","113288215"
"chrX","1544102","1544382","chrX","692247","692527","6","851855"
"chrX","1566352","1566650","chrX","708718","709031","77","857634"
"chrX","1567407","1567706","chrX","708718","709031","20","858689"
"chrX","1586712","1587011","chr15","70204095","70204396","56","68617383"
"chrX","1605420","1605717","chrX","750812","751109","9","854608"
"chrX","1632291","1632606","chrX","777156","777443","33","855135"
"chrX","1635813","1636100","chrX","780634","780927","11","855179"
"chrX","1648257","1648540","chrX","792808","793087","8","855449"
"chrX","1680327","1680449","chrX","831298","831411","11","849029"
"chrX","1687223","1687516","chrX","834586","834879","6","852637"
"chrX","1688347","1688672","chrX","835710","836032","16","852637"
"chrX","1697742","1698053","chrX","844718","845029","2","853024"
"chrX","1716475","1716682","chr8","20905723","20905928","47","19189248"
"chrX","1717538","1717669","chrX","864241","864385","17","853297"
"chrX","1789143","1789428","chrX","917697","917969","22","871446"
"chrX","1795425","1795575","chrX","924018","924167","3","871407"
"chrX","1797060","1797267","chrX","925654","925860","4","871406"
"chrX","1820661","1820956","chrX","25838840","25839128","54","24018179"
"chrX","1824508","1824554","chrX","939789","939841","6","884719"
"chrX","1824945","1825189","chrX","940231","940476","6","884714"
"chrX","1827318","1827618","chrX","942928","943235","11","884390"
"chrX","1847304","1847564","chr10","66319308","66319573","62","64472004"
"chrX","1848700","1849001","chr12","38458678","38458979","66","36609978"
"chrX","1850236","1850525","chrX","958856","959149","27","891380"
"chrX","1856634","1856934","chrX","964673","964970","51","891961"
"chrX","1857503","1857768","chrX","967827","968093","6","889676"
"chrX","1860184","1860479","chrX","964673","964970","11","895511"
"chrX","1861812","1862134","chr6","150697005","150697307","71","148835193"
"chrX","1882219","1882407","chrX","982341","982529","6","899878"
"chrX","1882961","1883059","chr20","10873553","10873651","24","8990592"
"chrX","1885841","1886137","chrX","981272","981569","6","904569"
"chrX","1892518","1892799","chrX","989681","989963","18","902837"
"chrX","1918392","1918685","chrX","1012011","1012306","6","906381"
"chrX","1927909","1928201","chrX","1012011","1012306","54","915898"
"chrX","1945465","1945750","chrX","1023641","1023938","49","921824"
"chrX","1946989","1947166","chr6","102665153","102665322","44","100718164"
"chrX","1949159","1949453","chrX","1023641","1023938","9","925518"
"chrX","1950644","1950808","chrX","1025136","1025285","18","925508"
"chrX","1958239","1958419","chr14","97467258","97467444","36","95509019"
"chrX","1961782","1962004","chrX","1035709","1035962","34","926073"
"chrX","1964720","1965017","chrX","1040403","1040700","7","924317"
"chrX","1968187","1968494","chrX","1040403","1040700","52","927784"
"chrX","1973701","1974013","chr20","10254510","10254822","60","8280809"
"chrX","1988705","1989009","chr2","90884759","90885054","60","88896054"
"chrX","1992357","1992518","chrX","1061623","1061796","16","930734"
"chrX","1992714","1992983","chr1","46023850","46024131","68","44031136"
"chrX","1995076","1995185","chrX","1062233","1062346","21","932843"
"chrX","2000475","2000637","chrX","1064780","1064944","9","935695"
"chrX","2020232","2020435","chrX","1083819","1084022","1","936413"
"chrX","2022833","2022972","chrX","1086441","1086612","32","936392"
"chrX","2026819","2027105","chrX","1090566","1090852","6","936253"
"chrX","2032688","2032994","chrX","1095970","1096278","8","936718"
"chrX","2040644","2040952","chrX","1104280","1104588","9","936364"
"chrX","2042285","2042589","chrX","1105968","1106272","11","936317"
"chrX","2046451","2046721","chrX","1110082","1110352","10","936369"
"chrX","2064079","2064205","chrX","1127893","1128019","3","936186"
"chrX","2065008","2065189","chrX","1128837","1128999","22","936171"
"chrX","2081886","2082172","chrX","1146324","1146614","14","935562"
"chrX","2082665","2082817","chrX","1147105","1147257","3","935560"
"chrX","2086705","2087007","chrX","1151044","1151346","7","935661"
"chrX","2121071","2121380","chrX","1194333","1194639","12","926738"
"chrX","2138287","2138570","chrX","1210224","1210509","5","928063"
"chrX","2140233","2140532","chrX","1211792","1212101","17","928441"
"chrX","2166870","2167163","chr10","29047313","29047589","58","26880443"
"chrX","2167320","2167621","chrX","1239195","1239496","3","928125"
"chrX","2172720","2173056","chrX","1244585","1244924","10","928135"
"chrX","2176335","2176611","chrX","1248530","1248809","12","927805"
"chrX","2179040","2179329","chrX","1251071","1251360","5","927969"
"chrX","2207485","2207776","chrX","1278210","1278495","7","929275"
"chrX","2241634","2241893","chrX","1312122","1312379","7","929512"
"chrX","2241954","2241973","chr4","148551272","148551286","10","146309318"
"chrX","2255571","2255884","chrX","1326894","1327207","6","928677"
"chrX","2258145","2258411","chrX","1329480","1329748","13","928665"
"chrX","2267795","2268096","chrX","1340529","1340832","12","927266"
"chrX","2314706","2314931","chr7","123708653","123708877","54","121393947"
"chrX","2315046","2315137","chr1","24072214","24072303","16","21757168"
"chrX","2330984","2331284","chrX","1405886","1406185","8","925098"
"chrX","2384888","2384959","chrX","1459697","1459768","0","925191"
"chrX","2418010","2418294","chrX","1492675","1492990","35","925335"
"chrX","2460041","2460322","chrX","1536217","1536498","1","923824"
"chrX","2491773","2492083","chrX","1559935","1560243","11","931838"
"chrX","2498471","2498644","chrX","1573064","1573227","10","925407"
"chrX","2506372","2506660","chrX","1580808","1581101","8","925564"
"chrX","2522186","2522254","chr17","52446568","52446633","20","49924382"
"chrX","2543815","2544147","chr13","53853251","53853557","72","51309436"
"chrX","2550293","2550559","chrX","1623300","1623566","8","926993"
"chrX","2560420","2560565","chrX","1633423","1633552","16","926997"
"chrX","2577348","2577654","chrX","1649688","1649993","9","927660"
"chrX","2595874","2596183","chrX","1669200","1669509","10","926674"
"chrX","2608763","2609047","chrX","1682802","1683087","6","925961"
"chrX","2612426","2612718","chrX","1686431","1686714","12","925995"
"chrX","2625849","2626005","chr18","68865502","68865659","25","66239653"
"chrX","2626040","2626159","chr13","63120596","63120714","16","60494556"
"chrX","2654792","2654970","chr4","132799520","132799687","43","130144728"
"chrX","2659494","2659769","chrX","1742262","1742536","8","917232"
"chrX","2670480","2670631","chr9","20377689","20377836","24","17707209"
"chrX","2675041","2675300","chrX","1758442","1758746","51","916599"
"chrX","2675336","2675347","chr19","50554167","50554177","1","47878831"
"chrX","2688959","2689228","chrX","1805516","1805785","1","883443"
"chrX","2708400","2708641","chr4","43105703","43105947","69","40397303"
"chrX","2776996","2777323","chrX","1899705","1900011","31","877291"
"chrX","2796658","2796971","chrX","1919622","1919937","8","877036"
"chrX","2804896","2805066","chrX","1927840","1928010","4","877056"
"chrX","2825385","2825674","chrX","1944759","1945047","12","880626"
"chrX","2830477","2830767","chr14","118181471","118181757","66","115350994"
"chrX","2838708","2839014","chrX","1958344","1958662","17","880364"
"chrX","2840081","2840382","chrX","1959724","1960025","4","880357"
"chrX","2849342","2849427","chrX","1968956","1969032","19","880386"
"chrX","2849744","2849853","chr1","21556103","21556211","33","18706359"
"chrX","2853918","2854219","chrX","1973496","1973797","2","880422"
"chrX","2854649","2854822","chrX","1974259","1974432","3","880390"
"chrX","2856596","2856781","chrX","1976211","1976417","26","880385"
"chrX","2858281","2858332","chr4","16517011","16517063","9","13658730"
"chrX","2887435","2887709","chrX","2007085","2007359","5","880350"
"chrX","2894602","2894917","chrX","2014899","2015184","35","879703"
"chrX","2899246","2899554","chrX","2020184","2020498","16","879062"
"chrX","2904711","2905028","chrX","2025654","2025970","14","879057"
"chrX","2943854","2944152","chrX","2062107","2062402","8","881747"
"chrX","2974502","2974775","chrX","2092882","2093155","1","881620"
"chrX","2977803","2978109","chrX","2096189","2096495","9","881614"
"chrX","2993549","2993851","chrX","2111705","2111980","30","881844"
"chrX","3031976","3032175","chrX","2150608","2150805","10","881368"
"chrX","3052310","3052594","chrX","2171271","2171568","23","881039"
"chrX","3073965","3074272","chrX","2192893","2193201","7","881072"
"chrX","3089842","3089950","chrX","2208885","2208993","2","880957"
"chrX","3115189","3115472","chrX","2233488","2233774","12","881701"
"chrX","3123858","3124150","chrX","2242249","2242544","11","881609"
"chrX","3135084","3135371","chrX","2253480","2253773","12","881604"
"chrX","3136929","3137245","chrX","2255321","2255637","5","881608"
"chrX","3144718","3145000","chrX","2263102","2263419","42","881616"
"chrX","3158913","3159203","chrX","2277415","2277702","5","881498"
"chrX","3165365","3165655","chrX","2283865","2284155","4","881500"
"chrX","3172822","3172984","chrX","2294064","2294226","4","878758"
"chrX","3183922","3184141","chrX","2302241","2302460","4","881681"
"chrX","3209329","3209615","chrX","2327158","2327444","5","882171"
"chrX","3213177","3213463","chr8","44115676","44115967","58","40902499"
"chrX","3284539","3284832","chrX","2405372","2405664","7","879167"
"chrX","3286262","3286551","chrX","2407079","2407394","33","879183"
"chrX","3300075","3300384","chr1","14767405","14767708","60","11467330"
"chrX","3301080","3301374","chrX","2421813","2422107","4","879267"
"chrX","3308774","3309064","chrX","2429508","2429789","20","879266"
"chrX","3326165","3326179","chrX","96283781","96283796","1","92957616"
"chrX","3326236","3326507","chrX","2447059","2447333","5","879177"
"chrX","3345143","3345392","chrX","2466532","2466780","8","878611"
"chrX","3361022","3361126","chr18","28177435","28177532","23","24816413"
"chrX","3369135","3369429","chrX","2490253","2490547","3","878882"
"chrX","3385775","3386000","chrX","2505178","2505440","40","880597"
"chrX","3388748","3389042","chrX","2508143","2508443","9","880605"
"chrX","3393014","3393299","chrX","2512414","2512714","25","880600"
"chrX","3393325","3393335","chr3","43728889","43728901","4","40335564"
"chrX","3393405","3393417","chrX","62602306","62602318","1","59208901"
"chrX","3413310","3413534","chrX","2532166","2532387","7","881144"
"chrX","3414458","3414752","chrX","2533315","2533610","4","881143"
"chrX","3419225","3419513","chrX","2538013","2538303","10","881212"
"chrX","3453062","3453209","chrX","2571658","2571805","3","881404"
"chrX","3462943","3463263","chrX","2581026","2581347","7","881917"
"chrX","3480332","3480608","chrX","2598625","2598931","33","881707"
"chrX","3482394","3482531","chrX","2600726","2600862","4","881668"
"chrX","3483649","3483769","chr6","162438658","162438779","15","158955009"
"chrX","3483821","3484006","chr3","42298682","42298860","38","38814861"
"chrX","3505071","3505349","chrX","2623731","2624006","15","881340"
"chrX","3528552","3528853","chrX","2647540","2647840","4","881012"
"chrX","3557108","3557393","chrX","2675931","2676216","8","881177"
"chrX","3571149","3571438","chrX","2689440","2689728","6","881709"
"chrX","3596921","3597048","chr4","96485150","96485274","31","92888229"
"chrX","3613551","3613707","chrX","2732000","2732156","6","881551"
"chrX","3621413","3621560","chrX","2739689","2739836","4","881724"
"chrX","3625750","3626061","chrX","2742764","2743079","9","882986"
"chrX","3641526","3641722","chrX","2758666","2758860","10","882860"
"chrX","3647383","3647680","chrX","2764643","2764938","18","882740"
"chrX","3652277","3652385","chrX","2769514","2769622","4","882763"
"chrX","3702471","3702768","chrX","2817333","2817633","15","885138"
"chrX","3705394","3705697","chrX","2820148","2820455","11","885246"
"chrX","3710802","3711082","chrX","2825537","2825815","9","885265"
"chrX","3771846","3772146","chr2","97022915","97023209","70","93251069"
"chrX","3787431","3787597","chr2","22660862","22661026","33","18873431"
"chrX","3790107","3790272","chrX","2905444","2905609","5","884663"
"chrX","3845483","3845699","chrX","2969763","2969978","2","875720"
"chrX","3871679","3871803","chr4","17500554","17500677","22","13628875"
"chrX","3886090","3886344","chrX","3011835","3012089","6","874255"
"chrX","3907730","3908038","chrX","3033153","3033461","4","874577"
"chrX","3922165","3922424","chr2","78229727","78229990","58","74307562"
"chrX","3922508","3922840","chrX","3047630","3047919","69","874878"
"chrX","3928348","3928554","chrX","3053624","3053872","49","874724"
"chrX","3949900","3950156","chrX","3065829","3066101","41","884071"
"chrX","3956242","3956498","chrX","3065829","3066101","41","890413"
"chrX","3977680","3977984","chrX","3078690","3078995","10","898990"
"chrX","4033067","4033367","chrX","3136679","3136979","6","896388"
"chrX","4064640","4064924","chr1","152496631","152496900","56","148431991"
"chrX","4064960","4064978","chr1","104032729","104032745","3","99967769"
"chrX","4106525","4106785","chrX","3208081","3208341","6","898444"
"chrX","4111218","4111523","chrX","3224259","3224564","3","886959"
"chrX","4203009","4203272","chrX","3319402","3319685","21","883607"
"chrX","4236865","4237106","chrX","3347134","3347375","6","889731"
"chrX","4241521","4241650","chr3","38951836","38951946","42","34710315"
"chrX","4256624","4256798","chr3","126194838","126195007","44","121938214"
"chrX","4257183","4257290","chr4","136772738","136772846","23","132515555"
"chrX","4263481","4263737","chrX","3378194","3378405","50","885287"
"chrX","4295484","4295784","chrX","3411382","3411691","37","884102"
"chrX","4318674","4318987","chrX","3433061","3433380","13","885613"
"chrX","4328899","4329193","chrX","3443903","3444196","9","884996"
"chrX","4332169","4332313","chr10","78413102","78413252","36","74080933"
"chrX","4332606","4332727","chr11","82993111","82993234","31","78660505"
"chrX","4376388","4376591","chrX","3540097","3540303","4","836291"
"chrX","4382325","4382603","chr5","159268129","159268410","68","154885804"
"chrX","4392378","4392657","chr5","159268129","159268410","69","154875751"
"chrX","4409474","4409768","chrX","3549900","3550194","5","859574"
"chrX","4422509","4422815","chr12","38919021","38919319","80","34496512"
"chrX","4433680","4433969","chrX","3562578","3562867","7","871102"
"chrX","4450650","4450812","chrX","3579699","3579861","1","870951"
"chrX","4488638","4488933","chrX","3618572","3618867","2","870066"
"chrX","4489596","4489866","chrX","3619556","3619822","9","870040"
"chrX","4541863","4542188","chrX","3672888","3673212","7","868975"
"chrX","4545160","4545441","chrX","3676175","3676456","11","868985"
"chrX","4596029","4596327","chrX","3726459","3726755","13","869570"
"chrX","4609533","4609822","chr3","43967838","43968145","53","39358305"
"chrX","4611723","4612016","chrX","3739196","3739489","8","872527"
"chrX","4635233","4635543","chr4","38519901","38520214","78","33884668"
"chrX","4657553","4657847","chrX","3785230","3785524","8","872323"
"chrX","4720941","4721109","chr9","25296901","25297069","46","20575960"
"chrX","4722916","4723018","JH679796","3334","3438","23","4719582"
"chrX","4723523","4723830","chr4","152226280","152226592","69","147502757"
"chrX","4801889","4802183","chrX","3798842","3799136","45","1003047"
"chrX","4815932","4816226","chrX","3798842","3799136","45","1017090"
"chrX","4915044","4915238","chrX","3895041","3895239","9","1020003"
"chrX","4959672","4959965","chrX","3937234","3937523","4","1022438"
"chrX","4960287","4960451","chrX","3937847","3938009","3","1022440"
"chrX","4972836","4972956","chrX","3950380","3950500","5","1022456"
"chrX","4972984","4973147","chrX","3950533","3950688","9","1022451"
"chrX","4986006","4986104","chr5","101495715","101495801","28","96509709"
"chrX","4986262","4986413","chr15","90520160","90520315","33","85533898"
"chrX","5011736","5012027","chrX","3990878","3991169","3","1020858"
"chrX","5022137","5022414","chr8","10034943","10035230","56","5012806"
"chrX","5036547","5036643","chr4","35751803","35751900","17","30715256"
"chrX","5044755","5045069","chrX","4023906","4024220","8","1020849"
"chrX","5062749","5062850","chr1","30363734","30363833","20","25300985"
"chrX","5088092","5088366","chrX","4133372","4133645","4","954720"
"chrX","5125664","5125712","chrX","4167093","4167141","0","958571"
"chrX","5171106","5171366","chrX","4220709","4220969","0","950397"
"chrX","5175898","5176192","chrX","4226022","4226312","12","949876"
"chrX","5197772","5198047","chrX","4247620","4247896","5","950152"
"chrX","5201016","5201319","chrX","4250860","4251165","8","950156"
"chrX","5231075","5231380","chrX","4281309","4281614","5","949766"
"chrX","5239743","5240037","chrX","4290624","4290918","4","949119"
"chrX","5241291","5241511","chr7","42721249","42721463","43","37479958"
"chrX","5241820","5241894","chr2","33626076","33626151","13","28384256"
"chrX","5260188","5260487","chr15","5023540","5023842","78","236648"
"chrX","5260962","5261092","chr3","87298191","87298310","36","82037229"
"chrX","5263487","5263619","chr11","110489058","110489194","35","105225571"
"chrX","5273544","5273851","chr1","163551503","163551805","72","158277959"
"chrX","5338781","5339074","chr14","30200281","30200571","76","24861500"
"chrX","5349051","5349349","chrX","4046123","4046419","9","1302928"
"chrX","5352796","5353101","chrX","4049891","4050196","7","1302905"
"chrX","5356208","5356518","chrX","4052966","4053280","9","1303242"
"chrX","5380137","5380447","chr8","1644209","1644520","59","3735928"
"chrX","5400190","5400327","chrX","4098992","4099129","2","1301198"
"chrX","5449063","5449337","chr11","45315","45590","71","5403748"
"chrX","5509877","5510177","chrX","4350052","4350352","2","1159825"
"chrX","5514834","5515118","chr4","45519316","45519603","82","40004482"
"chrX","5609806","5610111","chrX","4442858","4443159","11","1166948"
"chrX","5618657","5618973","chrX","4451689","4452001","13","1166968"
"chrX","5619964","5620241","chrX","4453007","4453284","2","1166957"
"chrX","5628384","5628696","chrX","4461434","4461741","10","1166950"
"chrX","5634459","5634745","chrX","4467960","4468246","2","1166499"
"chrX","5643585","5643872","chrX","4477124","4477409","13","1166461"
"chrX","5665306","5665584","chrX","4492963","4493240","8","1172343"
"chrX","5693742","5694024","chrX","4523798","4524081","5","1169944"
"chrX","5700679","5700871","chrX","4530703","4530895","8","1169976"
"chrX","5735173","5735456","chrX","4567223","4567541","39","1167950"
"chrX","5742550","5742821","chrX","4574621","4574904","15","1167929"
"chrX","5776408","5776701","chrX","4598777","4599073","14","1177631"
"chrX","5789410","5789710","chrX","4612102","4612407","19","1177308"
"chrX","5826444","5826600","chr15","6063703","6063862","27","237259"
"chrX","5832738","5833038","chrX","4655578","4655883","8","1177160"
"chrX","5838515","5838826","chr7","42951017","42951323","55","37112502"
"chrX","5844292","5844601","chrX","4667550","4667840","22","1176742"
"chrX","5848513","5848833","chrX","4672065","4672400","24","1176448"
"chrX","5860983","5861277","chrX","4684569","4684863","11","1176414"
"chrX","5884810","5885106","chrX","4708341","4708639","11","1176469"
"chrX","5920269","5920365","chrX","4745761","4745857","3","1174508"
"chrX","6020151","6020425","chrX","4838709","4838978","17","1181442"
"chrX","6027960","6028122","chr3","46143201","46143361","28","40115241"
"chrX","6028161","6028260","chr7","91614802","91614905","26","85586641"
"chrX","6032020","6032333","chr2","101764441","101764747","58","95732421"
"chrX","6034136","6034366","chrX","4852507","4852737","4","1181629"
"chrX","6099088","6099409","chr9","88204588","88204905","75","82105500"
"chrX","6187548","6187813","chrX","5001309","5001603","34","1186239"
"chrX","6190633","6190767","chrX","5004383","5004514","4","1186250"
"chrX","6288091","6288161","chr11","72246771","72246840","14","65958680"
"chrX","6364139","6364438","chrX","5174239","5174538","4","1189900"
"chrX","6364508","6364695","chrX","5174605","5174793","9","1189903"
"chrX","6370720","6370947","chrX","5180791","5181018","5","1189929"
"chrX","6424995","6425303","chrX","5229321","5229628","7","1195674"
"chrX","6490142","6490431","chrX","5289760","5290052","9","1200382"
"chrX","6513116","6513337","chrX","5313162","5313408","28","1199954"
"chrX","6525431","6525738","chrX","5325322","5325631","10","1200109"
"chrX","6526533","6526824","chrX","5326633","5326943","23","1199900"
"chrX","6571265","6571504","chr14","43190528","43190768","9","36619263"
"chrX","6588210","6588507","chr14","43207497","43207770","32","36619287"
"chrX","6593485","6593651","chr14","43212111","43212277","3","36618626"
"chrX","6595649","6595957","chrX","5368118","5368430","10","1227531"
"chrX","6602671","6602946","chrX","5376490","5376788","24","1226181"
"chrX","6618523","6618689","chrX","5392380","5392542","5","1226143"
"chrX","6664902","6664980","chr11","119993391","119993458","19","113328489"
"chrX","6771491","6771788","chrX","5547188","5547485","7","1224303"
"chrX","6804670","6804963","chr1","44753798","44754095","65","37949128"
"chrX","6807990","6808275","chrX","5583445","5583727","11","1224545"
"chrX","6817960","6818219","chr1","159493818","159494076","62","152675858"
"chrX","6818459","6818549","chr11","108175220","108175313","23","101356761"
"chrX","6858303","6858590","chrX","5636359","5636641","9","1221944"
"chrX","6864596","6864867","chrX","5642755","5643026","6","1221841"
"chrX","6881024","6881302","chrX","5659066","5659338","13","1221958"
"chrX","6898612","6898926","chrX","5676974","5677282","21","1221638"
"chrX","6952963","6953252","chrX","5710286","5710574","6","1242677"
"chrX","6968176","6968473","chrX","5727194","5727489","7","1240982"
"chrX","7053289","7053593","chrX","5814377","5814686","16","1238912"
"chrX","7089951","7090278","chrX","5861307","5861626","16","1228644"
"chrX","7090390","7090548","chrX","5861741","5861899","1","1228649"
"chrX","7120970","7121254","chrX","5895466","5895751","2","1225504"
"chrX","7122276","7122422","chrX","5896775","5896921","5","1225501"
"chrX","7197274","7197375","chrX","5958409","5958517","9","1238865"
"chrX","7222305","7222611","chrX","5985007","5985312","10","1237298"
"chrX","7239065","7239383","chrX","6002545","6002830","37","1236520"
"chrX","7249065","7249384","chrX","6002545","6002830","36","1246520"
"chrX","7283590","7283715","chrX","6265570","6265695","5","1018020"
"chrX","7286399","7286601","chrX","6266995","6267190","10","1019404"
"chrX","7341916","7342221","chrX","6322275","6322579","5","1019641"
"chrX","7343417","7343723","chrX","6323774","6324085","16","1019643"
"chrX","7473442","7473745","chrX","6188434","6188728","16","1285008"
"chrX","7548919","7549230","chrX","6327826","6328122","16","1221093"
"chrX","7565658","7565963","chrX","6344772","6345077","6","1220886"
"chrX","7591639","7591916","chrX","6370782","6371059","1","1220857"
"chrX","7696396","7696626","chrX","6477297","6477503","29","1219099"
"chrX","7710825","7710970","chr7","48559190","48559326","37","40848365"
"chrX","7718006","7718308","chrX","6498837","6499136","11","1219169"
"chrX","7723587","7723857","chrX","6504455","6504725","3","1219132"
"chrX","7759386","7759678","chrX","6539686","6539993","21","1219700"
"chrX","7764195","7764496","chrX","6544527","6544818","16","1219668"
"chrX","7765488","7765785","chrX","6545822","6546120","5","1219666"
"chrX","7769115","7769348","chrX","6549465","6549708","14","1219650"
"chrX","7775687","7776004","chrX","6556026","6556343","4","1219661"
"chrX","7778963","7779272","chrX","6559649","6559949","15","1219314"
"chrX","7786548","7786716","chrX","6567555","6567723","3","1218993"
"chrX","7788572","7788728","chr13","79761188","79761336","34","71972616"
"chrX","7791730","7792025","chrX","6572731","6573026","3","1218999"
"chrX","7797564","7797844","chrX","6578559","6578839","8","1219005"
"chrX","7803741","7803905","chrX","6584787","6584950","4","1218954"
"chrX","7823973","7824261","chrX","6605464","6605752","1","1218509"
"chrX","7826642","7826817","chrX","6608130","6608302","9","1218512"
"chrX","7840476","7840775","chrX","6622302","6622598","11","1218174"
"chrX","7855157","7855402","chrX","6637383","6637664","42","1217774"
"chrX","7855825","7855958","chrX","6638084","6638217","2","1217741"
"chrX","7858680","7858842","chrX","6640939","6641101","4","1217741"
"chrX","7867374","7867682","chrX","6649905","6650214","8","1217469"
"chrX","7877247","7877509","chrX","6669109","6669371","4","1208138"
"chrX","7883286","7883570","chrX","6675155","6675439","0","1208131"
"chrX","7885825","7885880","chrX","62920364","62920413","20","55034539"
"chrX","7890075","7890313","chrX","6681907","6682144","3","1208168"
"chrX","7900818","7901118","chrX","6697914","6698214","8","1202904"
"chrX","7903486","7903779","chrX","6693024","6693322","6","1210462"
"chrX","7904447","7904751","chrX","6688137","6688443","4","1216310"
"chrX","7916314","7916623","chrX","6707346","6707651","5","1208968"
"chrX","7941764","7941982","chr4","7639543","7639764","41","302221"
"chrX","7943915","7944228","chr11","116582902","116583213","65","108638987"
"chrX","7947667","7947845","chr1","134137168","134137349","38","126189501"
"chrX","7947883","7948003","chr7","19596811","19596930","20","11648928"
"chrX","7949109","7949265","chrX","6741012","6741176","10","1208097"
"chrX","7951207","7951519","chrX","6743105","6743419","11","1208102"
"chrX","8007471","8007770","chrX","6802009","6802308","2","1205462"
"chrX","8008572","8008811","chrX","6803109","6803349","5","1205463"
"chrX","8019957","8020258","chr4","36593951","36594258","63","28573994"
"chrX","8028580","8028852","chrX","6823004","6823277","2","1205576"
"chrX","8031073","8031379","chrX","6825501","6825807","12","1205572"
"chrX","8060112","8060325","chr4","42686105","42686316","45","34625993"
"chrX","8076554","8076863","chrX","6871210","6871516","9","1205344"
"chrX","8094402","8094698","chrX","6891977","6892273","8","1202425"
"chrX","8095912","8096153","chrX","6893483","6893724","12","1202429"
"chrX","8102145","8102477","chr7","126153184","126153502","73","118051039"
"chrX","8103711","8104022","chrX","6901009","6901320","5","1202702"
"chrX","8109999","8110327","chrX","6907298","6907615","15","1202701"
"chrX","8112459","8112721","chrX","6909758","6910026","10","1202701"
"chrX","8125551","8125843","chrX","6922821","6923113","5","1202730"
"chrX","8138022","8138314","chrX","6935259","6935553","7","1202763"
"chrX","8139008","8139145","chrX","6936247","6936384","2","1202761"
"chrX","8151488","8151773","chrX","6948735","6949022","8","1202753"
"chrX","8163489","8163778","chrX","6960715","6961000","8","1202774"
"chrX","8194783","8195071","chrX","6988971","6989259","6","1205812"
"chrX","8200254","8200381","chr18","66738454","66738584","19","58538200"
"chrX","8205801","8206068","chrX","7001285","7001551","7","1204516"
"chrX","8220711","8220832","chrX","7017109","7017230","0","1203602"
"chrX","8220867","8221021","chrX","7017263","7017417","3","1203604"
"chrX","8223533","8223687","chr19","6552140","6552292","36","1671393"
"chrX","8229549","8229805","chrX","7025914","7026190","25","1203635"
"chrX","8230474","8230762","chrX","7026899","7027187","4","1203575"
"chrX","8233892","8234099","chrX","7030313","7030520","3","1203579"
"chrX","8235482","8235596","chr14","61164463","61164572","25","52928981"
"chrX","8237331","8237499","chrX","7033700","7033866","3","1203631"
"chrX","8239144","8239457","chrX","7035515","7035828","5","1203629"
"chrX","8244327","8244487","chrX","7040535","7040695","6","1203792"
"chrX","8249967","8250259","chrX","7046208","7046498","6","1203759"
"chrX","8252905","8253217","chrX","7049119","7049430","10","1203786"
"chrX","8257895","8258212","chrX","7054108","7054419","10","1203787"
"chrX","8259137","8259325","chr8","7892133","7892317","40","367004"
"chrX","8259355","8259473","chr10","60281952","60282069","19","52022597"
"chrX","8279339","8279636","chrX","7075317","7075614","11","1204022"
"chrX","8282084","8282398","chrX","7077997","7078310","14","1204087"
"chrX","8282822","8282988","chrX","7078739","7078905","4","1204083"
"chrX","8289890","8289971","chrX","7086050","7086132","4","1203840"
"chrX","8295236","8295529","chrX","7091539","7091832","12","1203697"
"chrX","8299133","8299432","chrX","7095445","7095744","3","1203688"
"chrX","8305155","8305466","chrX","7101490","7101801","18","1203665"
"chrX","8328938","8329253","chrX","7125130","7125447","7","1203808"
"chrX","8357670","8357981","chrX","7154436","7154747","4","1203234"
"chrX","8359038","8359305","chr2","115594294","115594558","67","107235256"
"chrX","8366101","8366260","chr3","82362989","82363140","31","73996888"
"chrX","8381365","8381666","chrX","7178326","7178630","10","1203039"
"chrX","8384933","8385163","chrX","7181911","7182149","15","1203022"
"chrX","8388207","8388498","chrX","7185210","7185501","4","1202997"
"chrX","8394301","8394430","chrX","7191349","7191478","2","1202952"
"chrX","8397963","8398272","chrX","7195337","7195652","11","1202626"
"chrX","8411214","8411458","chr14","52216423","52216666","60","43805209"
"chrX","8413440","8413739","chrX","7211273","7211571","14","1202167"
"chrX","8416341","8416635","chr1","30332304","30332596","58","21915963"
"chrX","8424967","8425257","chrX","7224503","7224803","16","1200464"
"chrX","8426643","8426902","chrX","7226173","7226432","10","1200470"
"chrX","8437507","8437781","chrX","7237085","7237359","9","1200422"
"chrX","8445392","8445686","chrX","7245204","7245498","4","1200188"
"chrX","8454013","8454321","chrX","7253791","7254100","5","1200222"
"chrX","8465347","8465584","chrX","7265098","7265335","2","1200249"
"chrX","8469904","8470039","chr2","50541510","50541642","21","42071606"
"chrX","8474895","8475196","chrX","7275505","7275845","45","1199390"
"chrX","8484990","8485262","chrX","7285805","7286080","8","1199185"
"chrX","8492642","8492816","chrX","7292115","7292290","2","1200527"
"chrX","8513476","8513772","chrX","7312938","7313223","13","1200538"
"chrX","8529109","8529411","chrX","7328531","7328829","12","1200578"
"chrX","8547025","8547315","chr2","167664248","167664541","51","159117223"
"chrX","8553101","8553395","chrX","7352536","7352834","9","1200565"
"chrX","8570330","8570638","chrX","7369476","7369780","10","1200854"
"chrX","8596250","8596518","chrX","7395371","7395642","8","1200879"
"chrX","8642048","8642333","chrX","7442855","7443141","2","1199193"
"chrX","8655140","8655451","chr7","149750584","149750895","54","141095444"
"chrX","8660667","8660981","chr8","47765516","47765819","54","39104849"
"chrX","8730334","8730665","chrX","7528822","7529162","14","1201512"
"chrX","8763186","8763486","chrX","7561748","7562034","20","1201438"
"chrX","8921158","8921379","chrX","7728008","7728229","2","1193150"
"chrX","8938538","8938703","chrX","121442692","121442847","33","112504154"
"chrX","8938708","8938764","chr1","33811567","33811625","9","24872859"
"chrX","8939593","8939904","chrX","41341410","41341721","44","32401817"
"chrX","8946488","8946756","chrX","7754021","7754287","7","1192467"
"chrX","8955564","8955876","chrX","7758629","7758939","3","1196935"
"chrX","8973733","8974009","chrX","7779558","7779819","16","1194175"
"chrX","8978978","8979265","chrX","7784780","7785078","17","1194198"
"chrX","8997410","8997742","chrX","7800630","7800944","25","1196780"
"chrX","8999287","8999465","chrX","7802437","7802619","6","1196850"
"chrX","9006569","9006842","chrX","7814052","7814318","13","1192517"
"chrX","9019538","9019725","chr3","43295884","43296061","36","34276346"
"chrX","9019757","9019861","chr15","83993662","83993765","23","74973905"
"chrX","9031314","9031602","chrX","7838611","7838897","5","1192703"
"chrX","9079141","9079442","chrX","7887016","7887337","22","1192125"
"chrX","9080749","9081003","chrX","7888642","7888896","2","1192107"
"chrX","9105258","9105559","chrX","7916287","7916588","5","1188971"
"chrX","9124660","9124917","chrX","7935714","7935971","2","1188946"
"chrX","9132362","9132646","chrX","7943415","7943692","10","1188947"
"chrX","9139500","9139788","chrX","7950908","7951205","12","1188592"
"chrX","9144970","9145261","chrX","7956382","7956653","33","1188588"
"chrX","9146903","9147198","chrX","7958293","7958588","7","1188610"
"chrX","9152065","9152362","chrX","7963435","7963731","6","1188630"
"chrX","9166099","9166393","chrX","7977714","7978008","6","1188385"
"chrX","9168810","9168849","chr7","39599901","39599938","7","30431091"
"chrX","9170820","9171103","chrX","7981969","7982252","0","1188851"
"chrX","9182113","9182288","chr14","37380836","37381003","29","28198723"
"chrX","9197751","9198020","chrX","8010354","8010623","5","1187397"
"chrX","9204363","9204533","chr14","115088820","115088985","29","105884457"
"chrX","9204567","9204694","chr2","87140260","87140382","20","77935693"
"chrX","9208590","9208821","chrX","8021168","8021399","4","1187422"
"chrX","9227267","9227549","chrX","8039964","8040246","3","1187303"
"chrX","9244712","9245046","chrX","8047046","8047385","7","1197666"
"chrX","9246010","9246212","chr15","19587763","19587975","62","10341753"
"chrX","9298688","9298987","chrX","8098316","8098615","5","1200372"
"chrX","9299391","9299593","chr16","20736966","20737160","39","11437575"
"chrX","9423106","9423398","chrX","8234710","8235002","2","1188396"
"chrX","9570737","9571016","chrX","8392555","8392834","2","1178182"
"chrX","9586061","9586351","chrX","8407913","8408205","8","1178148"
"chrX","9609887","9610004","chrX","8432103","8432220","2","1177784"
"chrX","9640595","9640605","chr19","28248347","28248357","0","18607752"
"chrX","9640692","9640991","chrX","8463076","8463376","4","1177616"
"chrX","9645722","9646006","chrX","8468154","8468440","6","1177568"
"chrX","9689232","9689568","chrX","8525910","8526195","54","1163322"
"chrX","9757109","9757388","chrX","8599684","8599996","37","1157425"
"chrX","9757433","9757465","chr1","180949229","180949261","8","171191796"
"chrX","9911063","9911183","chr10","7392070","7392198","40","2518993"
"chrX","9975947","9976103","chr3","75948694","75948847","32","65972747"
"chrX","9976116","9976176","chr5","20311447","20311509","10","10335331"
"chrX","10056324","10056632","chrX","8832455","8832756","16","1223869"
"chrX","10101012","10101325","chrX","8878273","8878585","8","1222739"
"chrX","10179800","10180108","chrX","8956317","8956625","6","1223483"
"chrX","10220186","10220306","chr1","185635832","185635953","22","175415646"
"chrX","10236834","10237124","chrX","9014600","9014890","3","1222234"
"chrX","10243456","10243766","chrX","9021213","9021523","6","1222243"
"chrX","10270610","10270905","chrX","9047859","9048156","4","1222751"
"chrX","10293198","10293503","chrX","9069614","9069919","5","1223584"
"chrX","10374859","10375149","chrX","9159814","9160104","6","1215045"
"chrX","10447488","10447797","chrX","35397461","35397776","56","24949973"
"chrX","10562247","10562549","chr4","24567157","24567462","54","14004910"
"chrX","10611699","10611920","chrX","9412000","9412221","3","1199699"
"chrX","10712430","10712731","chr10","58190121","58190423","62","47477691"
"chrX","10717672","10717872","chrX","9520448","9520678","33","1197224"
"chrX","10719502","10719684","chrX","9522306","9522488","1","1197196"
"chrX","10724564","10724687","chr18","50055634","50055758","28","39331070"
"chrX","10829011","10829309","chrX","9631453","9631752","5","1197558"
"chrX","10853880","10854188","chrX","9658035","9658344","6","1195845"
"chrX","10887076","10887377","chrX","9694342","9694640","8","1192734"
"chrX","10953815","10954116","chr11","64850506","64850813","56","53896691"
"chrX","10965574","10965862","chrX","9774962","9775250","3","1190612"
"chrX","11035016","11035282","chr20","9066762","9067027","57","1968254"
"chrX","11044029","11044308","chrX","9856064","9856343","3","1187965"
"chrX","11045800","11046091","chrX","9857791","9858082","4","1188009"
"chrX","11047849","11048032","chrX","9859824","9860029","22","1188025"
"chrX","11065195","11065502","chrX","9877475","9877780","8","1187720"
"chrX","11132834","11133151","chrX","9944212","9944519","15","1188622"
"chrX","11191355","11191633","chrX","10002499","10002784","13","1188856"
"chrX","11203182","11203495","chrX","10014368","10014686","9","1188814"
"chrX","11263040","11263337","chrX","10073689","10073951","41","1189351"
"chrX","11266365","11266660","chrX","10077317","10077612","5","1189048"
"chrX","11277876","11278198","chrX","10088728","10089050","11","1189148"
"chrX","11307725","11308017","chrX","10118485","10118776","11","1189240"
"chrX","11323265","11323333","chr6","8905671","8905741","13","2417594"
"chrX","11323335","11323493","chr10","78413102","78413252","34","67089767"
"chrX","11323669","11323978","chrX","10135075","10135387","10","1188594"
"chrX","11365130","11365202","chr2","33626076","33626151","14","22260946"
"chrX","11380047","11380341","chrX","10192320","10192615","8","1187727"
"chrX","11386294","11386602","chrX","10198538","10198851","13","1187756"
"chrX","11396690","11396988","chrX","10208906","10209204","4","1187784"
"chrX","11400401","11400698","chrX","10212594","10212891","4","1187807"
"chrX","11427205","11427352","chr6","172208530","172208677","34","160781325"
"chrX","11434232","11434514","chrX","10246354","10246634","7","1187878"
"chrX","11450316","11450539","chr3","161810116","161810345","67","150359800"
"chrX","11459309","11459623","chrX","10264887","10265189","12","1194422"
"chrX","11461444","11461617","chrX","10267019","10267191","3","1194425"
"chrX","11480753","11481015","chrX","10286368","10286629","2","1194385"
"chrX","11496594","11496723","chr3","172909319","172909449","23","161412725"
"chrX","11496767","11496943","chr20","18992050","18992226","36","7495283"
"chrX","11544126","11544407","chrX","10352170","10352467","18","1191956"
"chrX","11548673","11548986","chrX","10356749","10357062","2","1191924"
"chrX","11550131","11550438","chrX","10358011","10358318","4","1192120"
"chrX","11568542","11568839","chrX","10376791","10377088","5","1191751"
"chrX","11586987","11587273","chrX","10395525","10395809","7","1191462"
"chrX","11597703","11597999","chrX","10405936","10406248","25","1191767"
"chrX","11614579","11614915","chrX","10422847","10423182","10","1191732"
"chrX","11644696","11645008","chrX","10453710","10454021","10","1190986"
"chrX","11697839","11698145","chrX","10507458","10507764","4","1190381"
"chrX","11733937","11734029","chrX","10545067","10545163","6","1188870"
"chrX","11734585","11734772","chrX","10545713","10545903","10","1188872"
"chrX","11753313","11753605","chrX","10564933","10565237","19","1188380"
"chrX","11768899","11769187","chrX","10580786","10581074","2","1188113"
"chrX","11781494","11781795","chrX","10593693","10594000","10","1187801"
"chrX","11810541","11810703","chrX","10650011","10650173","2","1160530"
"chrX","11814528","11814825","chrX","10653914","10654212","3","1160614"
"chrX","11824982","11825235","chrX","10662739","10662988","7","1162243"
"chrX","11827655","11827804","chrX","10665409","10665558","3","1162246"
"chrX","11834240","11834538","chrX","10671992","10672289","4","1162248"
"chrX","11841344","11841659","chrX","10679168","10679487","23","1162176"
"chrX","11855026","11855326","chrX","10692801","10693127","28","1162225"
"chrX","11855938","11856239","chrX","10693739","10694036","14","1162199"
"chrX","11925001","11925311","chrX","10762696","10763006","9","1162305"
"chrX","11928949","11929253","chrX","10766646","10766946","13","1162303"
"chrX","11938669","11938995","chrX","10776386","10776716","15","1162283"
"chrX","11997516","11997819","chrX","10836682","10836986","6","1160834"
"chrX","11998311","11998598","chrX","10837479","10837778","20","1160832"
"chrX","12041006","12041205","chrX","10873453","10873670","22","1167553"
"chrX","12079285","12079438","chr17","37486639","37486792","50","25407354"
"chrX","12118000","12118308","chrX","10949871","10950174","14","1168129"
"chrX","12161214","12161532","chrX","10978048","10978373","18","1183166"
"chrX","12162569","12162846","chrX","10979409","10979685","6","1183160"
"chrX","12168184","12168497","chrX","10985035","10985337","17","1183149"
"chrX","12170776","12171063","chrX","10987622","10987909","7","1183154"
"chrX","12192240","12192529","chrX","11009206","11009498","7","1183034"
"chrX","12193064","12193366","chrX","11010016","11010316","9","1183048"
"chrX","12212614","12212927","chrX","11030031","11030337","8","1182583"
"chrX","12231722","12232021","chr10","13389158","13389451","55","1157436"
"chrX","12236556","12236847","chrX","11056723","11057010","11","1179833"
"chrX","12270950","12271261","chrX","11091453","11091772","11","1179497"
"chrX","12315472","12315646","chrX","46059207","46059384","38","33743735"
"chrX","12344983","12345203","chrX","11166264","11166476","11","1178719"
"chrX","12351550","12351861","chr16","26045115","26045411","65","13693565"
"chrX","12354317","12354681","chrX","11175740","11176098","27","1178577"
"chrX","12360761","12361072","chrX","11182194","11182502","9","1178567"
"chrX","12366176","12366481","chrX","11187695","11188006","17","1178481"
"chrX","12404571","12404855","chrX","11223615","11223897","9","1180956"
"chrX","12405167","12405454","chrX","11224209","11224496","7","1180958"
"chrX","12408328","12408615","chrX","11227390","11227676","9","1180938"
"chrX","12433259","12433562","chrX","11251552","11251855","3","1181707"
"chrX","12463374","12463504","chr7","10651936","10652072","32","1811438"
"chrX","12463533","12463651","chr3","121908538","121908650","17","109445005"
"chrX","12482887","12483044","chr14","63608556","63608715","36","51125669"
"chrX","12503327","12503489","chr11","27626881","27627040","32","15123554"
"chrX","12556218","12556508","chrX","11370433","11370728","15","1185785"
"chrX","12614092","12614375","chrX","11428498","11428780","6","1185594"
"chrX","12648137","12648419","chrX","11463545","11463850","30","1184592"
"chrX","12698908","12699075","chrX","11515236","11515402","2","1183672"
"chrX","12778657","12778951","chrX","11603815","11604109","5","1174842"
"chrX","12784193","12784511","chrX","11608944","11609269","10","1175249"
"chrX","13062988","13063289","chrX","11893330","11893633","8","1169658"
"chrX","13196406","13196694","chrX","12034711","12034992","13","1161695"
"chrX","13203070","13203318","chrX","12043166","12043410","7","1159904"
"chrX","13311683","13311810","chr14","123047256","123047379","24","109735573"
"chrX","13311844","13312030","chrX","36990863","36991041","40","23679019"
"chrX","13395916","13396223","chrX","12243504","12243811","6","1152412"
"chrX","13409093","13409393","chrX","12257345","12257646","7","1151748"
"chrX","13410685","13410984","chrX","12258926","12259228","8","1151759"
"chrX","13420562","13420876","chrX","12268482","12268804","15","1152080"
"chrX","13423157","13423463","chrX","12271086","12271393","7","1152071"
"chrX","13435576","13435847","chrX","12283179","12283473","34","1152397"
"chrX","13482819","13483112","chrX","12331823","12332121","11","1150996"
"chrX","13487189","13487432","chrX","12336175","12336416","13","1151014"
"chrX","13499613","13499898","chrX","12350518","12350804","6","1149095"
"chrX","13585192","13585362","chrX","12443248","12443416","5","1141944"
"chrX","13836963","13837271","chrX","12687957","12688267","7","1149006"
"chrX","13900992","13901032","chr9","88952092","88952131","4","75051100"
"chrX","13930108","13930390","chrX","12778727","12779009","4","1151381"
"chrX","14001345","14001658","chrX","12854457","12854735","44","1146888"
"chrX","14072676","14072983","chrX","12925780","12926087","8","1146896"
"chrX","14076239","14076521","chrX","12929341","12929628","6","1146898"
"chrX","14083883","14084190","chrX","12937008","12937307","20","1146875"
"chrX","14134316","14134608","chrX","13038376","13038668","4","1095940"
"chrX","14149904","14150190","chrX","12990367","12990668","21","1159537"
"chrX","14159327","14159617","chrX","12999564","12999846","10","1159763"
"chrX","14194777","14195057","chrX","13066544","13066824","6","1128233"
"chrX","14222718","14223023","chrX","13095977","13096273","20","1126741"
"chrX","14225904","14226081","chrX","13099469","13099639","27","1126435"
"chrX","14226477","14226617","chrX","13100251","13100391","5","1126226"
"chrX","14246274","14246445","chrX","13120758","13120929","4","1125516"
"chrX","14248277","14248439","chrX","13122752","13122914","3","1125525"
"chrX","14248753","14248832","chrX","13123229","13123308","0","1125524"
"chrX","14264397","14264690","chrX","13138679","13138940","36","1125718"
"chrX","14292124","14292165","chrX","13167231","13167269","3","1124893"
"chrX","14294824","14295113","chrX","13169956","13170242","5","1124868"
"chrX","14324014","14324333","chrX","13199716","13200035","4","1124298"
"chrX","14325198","14325484","chrX","13200902","13201186","8","1124296"
"chrX","14328716","14329012","chr1","21109084","21109381","53","6780368"
"chrX","14348704","14349025","chrX","13224572","13224867","29","1124132"
"chrX","14354320","14354633","chrX","13230991","13231305","8","1123329"
"chrX","14362068","14362371","chrX","13240123","13240434","9","1121945"
"chrX","14368017","14368195","chr19","4403380","4403554","31","9964637"
"chrX","14382106","14382269","chrX","13260055","13260231","16","1122051"
"chrX","14384929","14385192","chrX","13262934","13263197","4","1121995"
"chrX","14478747","14479042","chrX","13359664","13359972","17","1119083"
"chrX","14613844","14614126","chr7","25157841","25158135","55","10543997"
"chrX","14690444","14690596","chrX","13579624","13579776","8","1110820"
"chrX","14693146","14693294","chrX","13582208","13582358","4","1110938"
"chrX","14874005","14874277","chrX","13756576","13756858","18","1117429"
"chrX","14885677","14885981","chrX","13768398","13768702","8","1117279"
"chrX","14901430","14901734","chrX","13784179","13784482","7","1117251"
"chrX","14914297","14914585","chr1","161479667","161479958","48","146565370"
"chrX","14920179","14920498","chr9","113740769","113741081","57","98820590"
"chrX","14955892","14956183","chrX","13838373","13838661","7","1117519"
"chrX","14982926","14983222","chr1","161479667","161479958","58","146496741"
"chrX","15007948","15008251","chrX","13890799","13891107","18","1117149"
"chrX","15008799","15009018","chr14","55438360","55438588","47","40429561"
"chrX","15009712","15010015","chrX","13892566","13892872","6","1117146"
"chrX","15022703","15022974","chrX","13906885","13907145","15","1115818"
"chrX","15047557","15047863","chrX","13933693","13933989","13","1113864"
"chrX","15049971","15050064","chrX","13936177","13936268","3","1113794"
"chrX","15074386","15074676","chrX","13963355","13963645","3","1111031"
"chrX","15080287","15080602","chrX","13969684","13970000","16","1110603"
"chrX","15087263","15087393","chrX","13976975","13977099","7","1110288"
"chrX","15090121","15090416","chr10","30001295","30001591","56","14911174"
"chrX","15092563","15092751","chr3","49903199","49903384","39","34810636"
"chrX","15093051","15093181","chr14","10256467","10256598","22","4836584"
"chrX","15095512","15095812","chr14","61825888","61826189","55","46730376"
"chrX","15109778","15109941","chr4","119074513","119074677","30","103964735"
"chrX","15117269","15117552","chr4","10521860","10522142","59","4595409"
"chrX","15118882","15119194","chr8","62400318","62400625","51","47281436"
"chrX","15123718","15123890","chr20","22514170","22514340","36","7390452"
"chrX","15124771","15125066","chr7","46194827","46195126","57","31070056"
"chrX","15127489","15127792","chr8","23772838","23773141","58","8645349"
"chrX","15131276","15131581","chr16","56403428","56403729","55","41272152"
"chrX","15132937","15133238","chr9","110361541","110361841","54","95228604"
"chrX","15156174","15156314","chr1","18210697","18210833","25","3054523"
"chrX","15159866","15159879","chr1","8928246","8928258","3","6231620"
"chrX","15175106","15175398","chr16","41671981","41672272","54","26496875"
"chrX","15179872","15180160","chr4","41350972","41351258","57","26171100"
"chrX","15183822","15184026","chr13","53892039","53892240","43","38708217"
"chrX","15185876","15186047","chr4","125683393","125683568","34","110497517"
"chrX","15190716","15191035","chr14","108304405","108304714","59","93113689"
"chrX","15194439","15194724","chr10","8095710","8096004","47","7098729"
"chrX","15199913","15200190","chr1","123594749","123595027","58","108394836"
"chrX","15200309","15200439","chr1","217348236","217348356","39","202147927"
"chrX","15202172","15202263","chr15","99095140","99095224","26","83892968"
"chrX","15215141","15215282","chr1","1658615","1658747","55","13556526"
"chrX","15222433","15222582","chrX","13996135","13996270","16","1226298"
"chrX","15226909","15227180","chr3","160494898","160495171","57","145267989"
"chrX","15248655","15248744","chrX","14024090","14024179","1","1224565"
"chrX","15254374","15254674","chrX","14030172","14030475","7","1224202"
"chrX","15259251","15259373","chr9","50303419","50303545","21","35044168"
"chrX","15259669","15259813","chr4","32792250","32792391","32","17532581"
"chrX","15270859","15271125","chrX","14046511","14046785","10","1224348"
"chrX","15271544","15271847","chrX","14047206","14047509","3","1224338"
"chrX","15273425","15273563","chr1","85858415","85858535","38","70584990"
"chrX","15274196","15274325","chr3","40555344","40555474","23","25281148"
"chrX","15279783","15280047","chrX","14055394","14055658","9","1224389"
"chrX","15297043","15297218","chr1","12065537","12065718","32","3231506"
"chrX","15297248","15297367","chr20","50206776","50206893","16","34909528"
"chrX","15314799","15315099","chrX","14088747","14089047","4","1226052"
"chrX","15323642","15323955","chrX","14097801","14098116","7","1225841"
"chrX","15329999","15330272","chrX","14108748","14109021","3","1221251"
"chrX","15336414","15336706","chrX","14111306","14111598","6","1225108"
"chrX","15336793","15337077","chrX","14111685","14111967","3","1225108"
"chrX","15356948","15357184","chrX","14131701","14131977","44","1225247"
"chrX","15364115","15364426","chrX","14140152","14140470","11","1223963"
"chrX","15368350","15368493","chr19","33264223","33264359","26","17895873"
"chrX","15369199","15369491","chrX","14145287","14145579","3","1223912"
"chrX","15380644","15380954","chrX","14156478","14156794","9","1224166"
"chrX","15383252","15383468","chrX","14158827","14159037","7","1224425"
"chrX","15386129","15386422","chrX","14161704","14161997","3","1224425"
"chrX","15390207","15390515","chrX","14165760","14166068","5","1224447"
"chrX","15392951","15393225","chrX","14174184","14174458","6","1218767"
"chrX","15400008","15400292","chrX","14181256","14181539","7","1218752"
"chrX","15409507","15409805","chr13","53097153","53097452","57","37687646"
"chrX","15410596","15410861","chrX","14192163","14192441","18","1218433"
"chrX","15433003","15433257","chrX","14214862","14215116","0","1218141"
"chrX","15433259","15433554","chrX","14215118","14215413","7","1218141"
"chrX","15439897","15440195","chrX","14221509","14221807","2","1218388"
"chrX","15466050","15466332","chr14","21750164","21750451","56","6284114"
"chrX","15473296","15473481","chr2","115338144","115338317","36","99864848"
"chrX","15524085","15524365","chrX","14307700","14307980","2","1216385"
"chrX","15536808","15537102","chrX","14320693","14320985","8","1216115"
"chrX","15599215","15599492","chrX","14383964","14384241","1","1215251"
"chrX","15600379","15600683","chrX","14385128","14385432","4","1215251"
"chrX","15602512","15602807","chr6","156887783","156888072","51","141285271"
"chrX","15634834","15634927","chrX","14424589","14424682","2","1210245"
"chrX","15635528","15635731","chrX","14425280","14425483","6","1210248"
"chrX","15638762","15639052","chrX","14428501","14428791","4","1210261"
"chrX","15639085","15639111","chr6","66953703","66953729","3","51314618"
"chrX","15645865","15646040","chr10","77241900","77242057","48","61596035"
"chrX","15654377","15654683","chrX","14445709","14446006","12","1208668"
"chrX","15675927","15676210","chrX","14472508","14472790","9","1203419"
"chrX","15676822","15676921","chrX","14473401","14473500","1","1203421"
"chrX","15813231","15813484","chrX","14623709","14623960","6","1189522"
"chrX","15836276","15836572","chrX","14646815","14647108","9","1189461"
"chrX","15840602","15840897","chrX","14651131","14651416","12","1189471"
"chrX","15932465","15932741","chrX","14745765","14746040","8","1186700"
"chrX","15932835","15933133","chrX","14746134","14746428","12","1186701"
"chrX","15956606","15956907","chrX","14767246","14767544","7","1189360"
"chrX","16000001","16000250","chr6","113208272","113208524","46","97208271"
"chrX","16062211","16062489","chrX","14860395","14860676","23","1201816"
"chrX","16114759","16115046","chrX","14912683","14912977","12","1202076"
"chrX","16124854","16125145","chrX","14922678","14922970","6","1202176"
"chrX","16147293","16147584","chrX","14947147","14947432","14","1200146"
"chrX","16150079","16150196","chr7","46204039","46204155","20","30053960"
"chrX","16150228","16150399","chr20","18131267","18131438","28","1981039"
"chrX","16196026","16196282","chrX","14996007","14996266","7","1200019"
"chrX","16246088","16246263","chr16","17895663","17895828","39","1649575"
"chrX","16260327","16260627","chrX","15057949","15058249","5","1202378"
"chrX","16356818","16357030","chrX","15157668","15157876","12","1199150"
"chrX","16382237","16382527","chrX","15182851","15183140","5","1199386"
"chrX","16392837","16393015","chr19","35682499","35682669","31","19289662"
"chrX","16430288","16430598","chr20","25253165","25253473","48","8822877"
"chrX","16450920","16451125","chrX","15245263","15245468","4","1205657"
"chrX","16504496","16504808","chrX","15301811","15302124","7","1202685"
"chrX","16520051","16520339","chrX","15322392","15322680","5","1197659"
"chrX","16541762","16542018","chrX","15343963","15344212","10","1197799"
"chrX","16553114","16553328","chrX","15355411","15355627","4","1197703"
"chrX","16577970","16578278","chrX","15386253","15386559","9","1191717"
"chrX","16582534","16582839","chrX","15381687","15381988","12","1200847"
"chrX","16599285","16599568","chrX","15413438","15413721","2","1185847"
"chrX","16601072","16601362","chrX","15415229","15415519","7","1185843"
"chrX","16605762","16606050","chrX","15419923","15420211","4","1185839"
"chrX","16611604","16611898","chrX","15425768","15426060","7","1185836"
"chrX","16617701","16617960","chrX","15431866","15432124","6","1185835"
"chrX","16618054","16618357","chrX","15432219","15432521","5","1185835"
"chrX","16618590","16618900","chrX","15432754","15433064","3","1185836"
"chrX","16622703","16623008","chrX","15436554","15436859","6","1186149"
"chrX","16638316","16638614","chrX","15452213","15452512","7","1186103"
"chrX","16644389","16644533","chrX","15458628","15458760","14","1185761"
"chrX","16647094","16647389","chr17","72880935","72881238","69","56233841"
"chrX","16658016","16658349","chr9","106530616","106530926","77","89872600"
"chrX","16663735","16664024","chr11","92349408","92349696","50","75685673"
"chrX","16669859","16670162","chrX","15483697","15484000","5","1186162"
"chrX","16672762","16673074","chrX","15486605","15486916","3","1186157"
"chrX","16684364","16684670","chr11","52684611","52684917","46","36000247"
"chrX","16710849","16711153","chr9","94565208","94565508","63","77854359"
"chrX","16729365","16729664","chrX","15533863","15534162","3","1195502"
"chrX","16733843","16734140","chrX","15538370","15538623","49","1195473"
"chrX","16754673","16754984","chrX","15565481","15565792","2","1189192"
"chrX","16759173","16759478","chrX","15553370","15553675","4","1205803"
"chrX","16759995","16760167","chr5","73422543","73422715","41","56662548"
"chrX","16765152","16765278","chrX","15572309","15572438","3","1192843"
"chrX","16786732","16787043","chrX","15593541","15593850","4","1193191"
"chrX","16793596","16793900","chrX","15598709","15599011","3","1194887"
"chrX","16793922","16794273","chrX","15599039","15599393","19","1194883"
"chrX","16807662","16807966","chrX","15613662","15613963","15","1194000"
"chrX","16808719","16809006","chr7","65087706","65087997","48","48278987"
"chrX","16829142","16829454","chrX","15635217","15635534","11","1193925"
"chrX","16843322","16843606","chr10","70734931","70735210","60","53891609"
"chrX","16848532","16848751","chrX","15657043","15657274","16","1191489"
"chrX","16853829","16854123","chrX","15662330","15662626","8","1191499"
"chrX","16856755","16857038","chr2","148920479","148920767","59","132063724"
"chrX","16865886","16865959","chrX","15674651","15674724","2","1191235"
"chrX","16866076","16866251","chrX","15674835","15675009","3","1191241"
"chrX","16879469","16879631","chr7","148427644","148427808","29","131548175"
"chrX","16879999","16880304","chr4","151028880","151029183","57","134148881"
"chrX","16884043","16884347","chrX","15693305","15693607","6","1190738"
"chrX","16888097","16888398","chrX","15697361","15697669","12","1190736"
"chrX","16897354","16897643","chrX","15706780","15707067","5","1190574"
"chrX","16903456","16903716","chrX","15713707","15713967","5","1189749"
"chrX","16905266","16905576","chrX","15715992","15716309","12","1189274"
"chrX","16930853","16931157","chrX","15737904","15738213","22","1192949"
"chrX","16934263","16934457","chrX","15741314","15741508","2","1192949"
"chrX","16939265","16939384","chrX","15746311","15746429","2","1192954"
"chrX","16943411","16943698","chrX","15750451","15750738","4","1192960"
"chrX","16947333","16947583","chrX","15754330","15754589","14","1193003"
"chrX","16952002","16952304","chrX","15759249","15759547","11","1192753"
"chrX","16952583","16952863","chrX","15759787","15760085","24","1192796"
"chrX","16987192","16987508","chrX","15795261","15795577","3","1191931"
"chrX","16988533","16988818","chrX","15796604","15796905","21","1191929"
"chrX","16991967","16992259","chrX","15800038","15800330","2","1191929"
"chrX","16998573","16998855","chrX","15806539","15806822","2","1192034"
"chrX","17011847","17012146","chrX","15820094","15820392","8","1191753"
"chrX","17013290","17013583","chr6","60973325","60973614","51","43960035"
"chrX","17046570","17046827","chrX","15854902","15855156","7","1191668"
"chrX","17058474","17058770","chrX","15866769","15867067","9","1191705"
"chrX","17059035","17059207","chrX","15867329","15867490","13","1191706"
"chrX","17061557","17061837","chr1","159614491","159614771","52","142552934"
"chrX","17068220","17068534","chrX","15875161","15875452","28","1193059"
"chrX","17073565","17073874","chrX","15880495","15880802","6","1193070"
"chrX","17084358","17084379","chr20","4102878","4102895","9","12981480"
"chrX","17095964","17096236","chrX","15902639","15902909","8","1193325"
"chrX","17102024","17102230","chrX","15908644","15908857","20","1193380"
"chrX","17103829","17104176","chrX","15910472","15910785","41","1193357"
"chrX","17117338","17117486","chrX","15923460","15923608","3","1193878"
"chrX","17124402","17124546","chr9","16691156","16691299","35","433246"
"chrX","17124606","17124897","chrX","15930616","15930937","35","1193990"
"chrX","17134894","17135193","chrX","15942617","15942912","15","1192277"
"chrX","17140188","17140452","chrX","15947873","15948137","1","1192315"
"chrX","17149688","17149979","chrX","15957376","15957666","4","1192312"
"chrX","17151217","17151509","chrX","15958890","15959180","13","1192327"
"chrX","17151765","17152016","chrX","15959436","15959686","10","1192329"
"chrX","17164286","17164585","chrX","15971354","15971652","5","1192932"
"chrX","17189715","17190001","chr11","23742599","23742891","51","6552884"
"chrX","17192016","17192224","chrX","15999346","15999556","6","1192670"
"chrX","17203314","17203488","chrX","16010611","16010785","2","1192703"
"chrX","17217469","17217754","chrX","16024967","16025253","7","1192502"
"chrX","17236235","17236525","chr4","69077877","69078163","48","51841642"
"chrX","17244261","17244564","chrX","16052168","16052466","9","1192093"
"chrX","17250146","17250450","chrX","16058024","16058329","7","1192122"
"chrX","17252338","17252609","chrX","16060517","16060786","10","1191821"
"chrX","17296972","17297263","chrX","16108286","16108579","7","1188686"
"chrX","17319049","17319192","chrX","16131461","16131590","16","1187588"
"chrX","17320393","17320697","chrX","16132686","16132993","11","1187707"
"chrX","17328963","17329246","chrX","16140755","16141038","4","1188208"
"chrX","17347821","17348115","chrX","16163005","16163299","7","1184816"
"chrX","17354589","17354897","chrX","16168056","16168360","8","1186533"
"chrX","17356397","17356689","chrX","16169864","16170164","20","1186533"
"chrX","17407899","17408174","chrX","16221865","16222151","25","1186034"
"chrX","17431674","17431978","chrX","16245529","16245781","54","1186145"
"chrX","17442294","17442594","chrX","16256296","16256596","3","1185998"
"chrX","17445884","17446179","chrX","16260249","16260549","8","1185635"
"chrX","17469969","17470263","chrX","16284483","16284777","9","1185486"
"chrX","17478687","17478982","chrX","16293258","16293553","5","1185429"
"chrX","17502639","17502945","chrX","16317219","16317520","11","1185420"
"chrX","17514844","17515164","chrX","16319485","16319790","20","1195359"
"chrX","17522935","17523222","chrX","16327292","16327599","23","1195643"
"chrX","17526937","17527248","chrX","16331311","16331623","5","1195626"
"chrX","17529374","17529529","chrX","16333733","16333888","8","1195641"
"chrX","17537073","17537358","chrX","16341469","16341754","6","1195604"
"chrX","17544692","17544987","chrX","16349170","16349472","22","1195522"
"chrX","17544988","17545149","chrX","2294064","2294226","27","15250924"
"chrX","17549504","17549814","chrX","16353228","16353543","10","1196276"
"chrX","17551201","17551510","chrX","16354910","16355220","9","1196291"
"chrX","17561968","17562253","chrX","16365301","16365583","19","1196667"
"chrX","17565943","17566094","chr10","27372874","27373024","27","9806931"
"chrX","17566871","17567050","chr19","14777981","14778157","36","2788890"
"chrX","17576755","17577065","chrX","16379590","16379894","10","1197165"
"chrX","17582710","17583011","chrX","16385465","16385766","5","1197245"
"chrX","17587004","17587326","chrX","16389649","16389963","23","1197355"
"chrX","17594381","17594688","chrX","16397305","16397614","10","1197076"
"chrX","17628473","17628801","chrX","16426494","16426799","27","1201979"
"chrX","17633355","17633635","chr1","159614491","159614771","50","141981136"
"chrX","17645812","17646118","chrX","16443776","16444056","31","1202036"
"chrX","17652790","17652954","chrX","16450788","16450950","4","1202002"
"chrX","17672583","17672870","chrX","16476290","16476577","5","1196293"
"chrX","17679266","17679456","chr1","137963187","137963374","36","120283921"
"chrX","17682200","17682499","chrX","16485944","16486241","5","1196256"
"chrX","17693246","17693533","chrX","16497794","16498082","11","1195452"
"chrX","17708451","17708738","chrX","16497794","16498082","11","1210657"
"chrX","17719229","17719283","chrX","46137496","46137548","6","28418267"
"chrX","17719585","17719766","chrX","16508947","16509126","5","1210638"
"chrX","17728718","17729044","chrX","16517932","16518238","26","1210786"
"chrX","17733142","17733278","chr15","39542579","39542711","19","21809437"
"chrX","17734203","17734356","chrX","16522438","16522587","9","1211765"
"chrX","17765798","17766074","chrX","16554293","16554590","26","1211505"
"chrX","17766487","17766659","chr11","6988011","6988177","29","10778476"
"chrX","17778916","17779195","chrX","16567367","16567658","17","1211549"
"chrX","17781780","17781989","chrX","16570227","16570436","1","1211553"
"chrX","17784661","17784976","chr1","33067744","33068053","58","15283083"
"chrX","17796410","17796687","chr19","27639596","27639887","59","9843186"
"chrX","17798979","17799286","chrX","16579290","16579571","29","1219689"
"chrX","17799677","17799960","chrX","16579950","16580233","2","1219727"
"chrX","17806597","17806878","chrX","16587589","16587869","4","1219008"
"chrX","17810473","17810770","chrX","16591352","16591653","7","1219121"
"chrX","17817433","17817669","chrX","16598785","16599023","3","1218648"
"chrX","17822469","17822765","chrX","16604286","16604578","7","1218183"
"chrX","17854033","17854354","chrX","142271458","142271746","87","124417425"
"chrX","17864973","17865264","chrX","16644866","16645159","3","1220107"
"chrX","17865783","17866087","chr16","31689462","31689756","61","13823679"
"chrX","17870419","17870734","chrX","16647576","16647889","13","1222843"
"chrX","17906235","17906446","chrX","16673720","16673931","4","1232515"
"chrX","17920551","17920693","chr3","104055274","104055407","30","86134723"
"chrX","17925974","17926280","chrX","16696600","16696911","12","1229374"
"chrX","17935169","17935465","chrX","16705843","16706139","4","1229326"
"chrX","17941470","17941565","chrX","16716981","16717076","0","1224489"
"chrX","17948233","17948521","chrX","16717395","16717694","20","1230838"
"chrX","17968922","17969117","chrX","16742280","16742479","5","1226642"
"chrX","17969900","17970197","chrX","16739548","16739871","30","1230352"
"chrX","17972623","17972911","chrX","16738678","16738964","9","1233945"
"chrX","17974243","17974574","chrX","16743418","16743709","49","1230825"
"chrX","17997790","17997901","chr2","44878969","44879063","31","26881179"
"chrX","18003417","18003716","chrX","16768016","16768316","5","1235401"
"chrX","18012083","18012379","chrX","16776685","16776982","6","1235398"
"chrX","18016773","18016970","chrX","16781389","16781597","14","1235384"
"chrX","18035465","18035768","chrX","16801699","16802003","13","1233766"
"chrX","18038865","18039152","chrX","16804247","16804534","7","1234618"
"chrX","18066527","18066687","chrX","16831872","16832031","2","1234655"
"chrX","18067822","18067970","chrX","16833237","16833385","2","1234585"
"chrX","18070089","18070362","chrX","16835517","16835788","13","1234572"
"chrX","18080852","18081155","chrX","16846259","16846558","12","1234593"
"chrX","18085941","18086230","chrX","16851667","16851964","16","1234274"
"chrX","18088621","18088919","chrX","16854350","16854640","13","1234271"
"chrX","18096171","18096453","chrX","16861894","16862173","6","1234277"
"chrX","18113235","18113523","chrX","16878039","16878330","6","1235196"
"chrX","18133697","18133982","chrX","16898995","16899276","9","1234702"
"chrX","18138777","18139083","chrX","16904079","16904376","17","1234698"
"chrX","18160814","18161113","chrX","16925223","16925520","8","1235591"
"chrX","18184680","18184895","chrX","16949141","16949357","3","1235539"
"chrX","18186302","18186595","chrX","16950775","16951079","14","1235527"
"chrX","18188698","18188888","chr9","106344289","106344481","39","88155591"
"chrX","18194395","18194689","chrX","16958964","16959251","16","1235431"
"chrX","18209187","18209479","chrX","16973700","16973992","8","1235487"
"chrX","18215517","18215821","chrX","16979676","16979984","12","1235841"
"chrX","18236301","18236593","chrX","17000664","17000956","4","1235637"
"chrX","18241791","18242116","chrX","17006002","17006338","18","1235789"
"chrX","18251672","18251967","chrX","17016043","17016341","7","1235629"
"chrX","18252574","18252879","chrX","17016945","17017254","7","1235629"
"chrX","18254077","18254395","chrX","17018452","17018767","13","1235625"
"chrX","18256507","18256801","chrX","17020880","17021150","51","1235627"
"chrX","18264283","18264602","chr3","34788995","34789298","66","16524712"
"chrX","18264609","18264787","chr8","127335489","127335660","34","109070880"
"chrX","18268134","18268442","chrX","17033788","17034097","5","1234346"
"chrX","18281873","18282172","chr8","61522372","61522671","48","43240499"
"chrX","18287642","18287960","chrX","17053554","17053871","5","1234088"
"chrX","18294394","18294691","chrX","17060314","17060612","2","1234080"
"chrX","18299055","18299351","chr17","75485485","75485787","56","57186430"
"chrX","18303328","18303583","chrX","17065422","17065677","2","1237906"
"chrX","18340103","18340418","chrX","17101579","17101894","4","1238524"
"chrX","18348427","18348725","chrX","17109330","17109598","36","1239097"
"chrX","18359789","18360085","chrX","17120640","17120926","13","1239149"
"chrX","18361109","18361417","chrX","17121954","17122261","7","1239155"
"chrX","18365124","18365238","chr9","60625091","60625208","19","42259967"
"chrX","18365264","18365439","chr15","96562373","96562547","23","78197109"
"chrX","18369363","18369648","chrX","17131214","17131499","5","1238149"
"chrX","18372433","18372738","chrX","17134244","17134545","8","1238189"
"chrX","18372797","18372964","chrX","17134604","17134772","7","1238193"
"chrX","18373125","18373411","chrX","17134931","17135217","5","1238194"
"chrX","18378495","18378563","chrX","17140239","17140307","3","1238256"
"chrX","18382002","18382269","chrX","17143502","17143755","17","1238500"
"chrX","18390148","18390466","chrX","17151663","17151981","4","1238485"
"chrX","18401718","18401877","chrX","17163667","17163825","9","1238051"
"chrX","18404981","18405272","chrX","17166927","17167219","3","1238054"
"chrX","18413967","18414269","chrX","17175958","17176275","21","1238009"
"chrX","18417885","18418173","chr13","7974690","7974977","45","10443195"
"chrX","18426221","18426512","chrX","17187153","17187450","14","1239068"
"chrX","18428605","18428913","chrX","17189543","17189851","6","1239062"
"chrX","18437800","18438105","chrX","17198195","17198501","9","1239605"
"chrX","18446162","18446315","chr19","8561853","8561997","38","9884309"
"chrX","18449635","18449755","chr1","19764286","19764410","27","1314651"
"chrX","18481955","18482255","chrX","17242579","17242884","9","1239376"
"chrX","18485787","18486093","chr1","33010955","33011254","64","14525168"
"chrX","18512509","18512764","chrX","17275069","17275314","17","1237440"
"chrX","18518512","18518804","chrX","17280957","17281258","13","1237555"
"chrX","18572823","18573025","chrX","17335376","17335553","25","1237447"
"chrX","18576788","18577085","chrX","17340521","17340818","6","1236267"
"chrX","18580284","18580565","chrX","17344019","17344333","38","1236265"
"chrX","18584405","18584678","chrX","17348181","17348454","4","1236224"
"chrX","18587150","18587436","chrX","17350937","17351223","7","1236213"
"chrX","18599061","18599371","chrX","17362563","17362870","10","1236498"
"chrX","18601699","18601803","chrX","17365308","17365412","4","1236391"
"chrX","18602098","18602272","chrX","17365709","17365878","8","1236389"
"chrX","18621288","18621585","chrX","17384926","17385221","6","1236362"
"chrX","18632244","18632442","chrX","17396202","17396400","1","1236042"
"chrX","18633218","18633521","chrX","17397177","17397481","3","1236041"
"chrX","18640918","18641203","chrX","17404861","17405144","8","1236057"
"chrX","18648698","18649019","chrX","17412971","17413292","11","1235727"
"chrX","18649679","18649908","chrX","17413954","17414183","4","1235725"
"chrX","18657026","18657304","chrX","17421304","17421584","9","1235722"
"chrX","18679233","18679539","chrX","17441779","17442073","17","1237454"
"chrX","18830819","18830986","chr15","317884","318046","40","18512935"
"chrX","18903354","18903627","chrX","17658706","17659004","29","1244648"
"chrX","18903653","18903669","chr6","90997773","90997789","2","72094120"
"chrX","18960340","18960642","chrX","17722728","17723030","5","1237612"
"chrX","18994769","18995085","chrX","17757200","17757516","4","1237569"
"chrX","19287180","19287474","chrX","18071050","18071344","7","1216130"
"chrX","19421174","19421298","chrX","18215037","18215161","2","1206137"
"chrX","19736449","19736494","chrX","18540009","18540054","0","1196440"
"chrX","19755091","19755392","chrX","18546307","18546615","9","1208784"
"chrX","19850297","19850605","chrX","18634823","18635133","11","1215474"
"chrX","19978424","19978702","chr14","18211787","18212071","60","1766637"
"chrX","20034411","20034698","chrX","18832162","18832449","0","1202249"
"chrX","20051354","20051640","chr16","18768739","18769026","40","1282615"
"chrX","20058427","20058702","chrX","18856473","18856748","4","1201954"
"chrX","20069835","20070160","chrX","18866887","18867211","14","1202948"
"chrX","20096773","20097045","chrX","18893194","18893487","26","1203579"
"chrX","20136104","20136289","chrX","18930267","18930455","7","1205837"
"chrX","20157030","20157337","chrX","18951791","18952098","6","1205239"
"chrX","20189498","20189783","chrX","18983924","18984209","5","1205574"
"chrX","20249527","20249838","chrX","19043973","19044284","4","1205554"
"chrX","20304012","20304300","chrX","19091969","19092253","10","1212043"
"chrX","20304781","20305088","chrX","19092751","19093049","14","1212030"
"chrX","20324428","20324656","chrX","19112486","19112681","36","1211942"
"chrX","20339012","20339289","chrX","19128492","19128769","7","1210520"
"chrX","20342012","20342323","chrX","19131478","19131791","14","1210534"
"chrX","20343896","20344198","chrX","19133374","19133676","4","1210522"
"chrX","20379012","20379305","chrX","44083154","44083444","55","23704142"
"chrX","20390934","20391231","chrX","19181073","19181369","6","1209861"
"chrX","20409902","20410171","chrX","19200348","19200617","3","1209554"
"chrX","20422269","20422522","chrX","19212677","19212932","5","1209592"
"chrX","20430895","20431181","chrX","19221346","19221647","21","1209549"
"chrX","20443349","20443449","chrX","19233662","19233762","1","1209687"
"chrX","20443454","20443698","chrX","19233767","19234011","3","1209687"
"chrX","20446086","20446232","chrX","19236399","19236545","0","1209687"
"chrX","20451111","20451300","chrX","19241379","19241567","5","1209732"
"chrX","20463595","20463919","chrX","19253992","19254315","10","1209603"
"chrX","20467885","20468177","chrX","19258316","19258609","3","1209569"
"chrX","20493690","20493968","chrX","19290086","19290364","4","1203604"
"chrX","20499487","20499770","chrX","19295526","19295805","6","1203961"
"chrX","20543457","20543753","chr13","61846681","61846973","54","41303224"
"chrX","20584048","20584345","chrX","19380368","19380682","20","1203680"
"chrX","20602575","20602866","chrX","19398894","19399185","5","1203681"
"chrX","20612542","20612819","chrX","19409106","19409383","3","1203436"
"chrX","20612820","20612955","chrX","19409384","19409519","4","1203436"
"chrX","20741460","20741717","chrX","19539112","19539369","4","1202348"
"chrX","20814700","20815003","chrX","19613902","19614208","12","1200798"
"chrX","20863645","20863768","chrX","19666198","19666302","20","1197447"
"chrX","20869412","20869493","chr3","173428304","173428385","11","152558892"
"chrX","20946541","20946648","chrX","19749040","19749148","5","1197501"
"chrX","20981591","20981870","chrX","19783463","19783742","2","1198128"
"chrX","21059705","21059857","chr19","14673246","14673394","39","6386459"
"chrX","21064231","21064544","chrX","19866876","19867184","8","1197355"
"chrX","21085029","21085306","chrX","19888239","19888516","4","1196790"
"chrX","21196011","21196327","chrX","20001599","20001911","20","1194412"
"chrX","21315014","21315325","chrX","20127759","20128069","20","1187255"
"chrX","21421650","21421940","chrX","20234466","20234751","10","1187184"
"chrX","21567773","21567943","chrX","20381746","20381923","7","1186027"
"chrX","21987337","21987639","chrX","20805646","20805948","5","1181691"
"chrX","22050477","22050608","chrX","20901471","20901603","4","1149006"
"chrX","22051608","22051905","chrX","20902603","20902898","9","1149005"
"chrX","22071578","22071658","chr4","99934465","99934546","14","77862887"
"chrX","22081168","22081469","chrX","20932811","20933120","16","1148357"
"chrX","22125879","22126177","chrX","20978439","20978730","10","1147440"
"chrX","22130805","22131090","chrX","20983668","20983957","5","1147137"
"chrX","22137115","22137412","chrX","20989918","20990197","20","1147197"
"chrX","22140805","22141115","chrX","20993502","20993812","3","1147303"
"chrX","22143066","22143374","chrX","20995759","20996068","5","1147307"
"chrX","22143725","22144033","chrX","20996419","20996724","13","1147306"
"chrX","22146092","22146351","chrX","20998775","20999048","20","1147317"
"chrX","22159682","22159846","chrX","21014781","21014942","9","1144901"
"chrX","22163672","22163937","chrX","21018700","21018949","27","1144972"
"chrX","22165726","22165888","chrX","21020737","21020908","20","1144989"
"chrX","22166198","22166331","chrX","21021202","21021335","4","1144996"
"chrX","22168831","22168948","chrX","21023817","21023934","2","1145014"
"chrX","22172355","22172653","chrX","21027315","21027613","8","1145040"
"chrX","22184625","22184923","chrX","21040106","21040404","4","1144519"
"chrX","22200078","22200368","chrX","21054651","21054929","17","1145427"
"chrX","22200865","22200983","chrX","21055438","21055556","1","1145427"
"chrX","22201015","22201176","chrX","21055578","21055738","2","1145437"
"chrX","22243199","22243505","chrX","21091485","21091791","6","1151714"
"chrX","22244609","22244728","chrX","21089793","21089912","1","1154816"
"chrX","22256236","22256525","chr11","30046486","30046779","48","7790250"
"chrX","22259221","22259547","chrX","21098565","21098892","8","1160656"
"chrX","22279743","22279758","chr13","67486160","67486172","4","45206417"
"chrX","22280072","22280124","chr15","9384259","9384308","15","12895813"
"chrX","22284431","22284729","chrX","21123460","21123758","8","1160971"
"chrX","22286259","22286431","chrX","21125442","21125614","3","1160817"
"chrX","22287070","22287214","chrX","21126215","21126359","4","1160855"
"chrX","22288360","22288654","chrX","21127829","21128124","3","1160531"
"chrX","22291561","22291849","chrX","21137795","21138085","6","1153766"
"chrX","22293063","22293364","chrX","21131434","21131735","4","1161629"
"chrX","22293713","22293847","chrX","21132078","21132210","7","1161635"
"chrX","22301884","22302180","chrX","21141892","21142188","3","1159992"
"chrX","22312535","22312851","chrX","21153231","21153548","8","1159304"
"chrX","22313946","22313960","chr9","55630","55645","1","22258316"
"chrX","22313993","22314255","chrX","21154644","21154940","36","1159349"
"chrX","22320059","22320367","chrX","21160748","21161052","11","1159311"
"chrX","22320410","22320666","chrX","21161086","21161344","7","1159324"
"chrX","22321082","22321123","chrX","21161758","21161797","2","1159324"
"chrX","22322035","22322317","chrX","21162715","21162997","2","1159320"
"chrX","22355686","22355983","chrX","21182475","21182776","9","1173211"
"chrX","22367461","22367764","chr2","93479675","93479975","54","71112214"
"chrX","22367897","22368178","chrX","21195966","21196247","6","1171931"
"chrX","22402959","22403100","chrX","21232411","21232552","0","1170548"
"chrX","22411120","22411200","chrX","21240971","21241051","0","1170149"
"chrX","22419083","22419381","chrX","21249181","21249477","10","1169902"
"chrX","22420027","22420306","chrX","21250122","21250422","25","1169905"
"chrX","22449123","22449433","chrX","21276523","21276821","22","1172600"
"chrX","22464420","22464664","chrX","21292254","21292503","10","1172166"
"chrX","22467319","22467648","chrX","21295163","21295499","16","1172156"
"chrX","22476849","22477119","chrX","21304301","21304578","14","1172548"
"chrX","22500323","22500473","chrX","21332227","21332394","19","1168096"
"chrX","22506193","22506498","chrX","21322145","21322453","10","1184048"
"chrX","22507439","22507751","chrX","21337844","21338153","8","1169595"
"chrX","22511843","22512143","chrX","21342577","21342876","6","1169266"
"chrX","22512335","22512481","chr19","13418697","13418850","34","9093638"
"chrX","22525125","22525377","chrX","21358553","21358805","5","1166572"
"chrX","22539211","22539507","chrX","21375127","21375421","3","1164084"
"chrX","22553438","22553734","chrX","21388377","21388673","4","1165061"
"chrX","22561338","22561387","chr8","97753789","97753835","9","75192451"
"chrX","22562089","22562177","chr17","53106387","53106473","21","30544298"
"chrX","22568882","22569105","chrX","21397823","21398048","4","1171059"
"chrX","22580076","22580380","chrX","21406151","21406455","5","1173925"
"chrX","22586052","22586352","chrX","21413531","21413828","10","1172521"
"chrX","22590279","22590415","chrX","21424589","21424721","6","1165690"
"chrX","22591881","22592171","chrX","21426193","21426483","5","1165688"
"chrX","22599147","22599324","chrX","21420505","21420685","13","1178642"
"chrX","22606610","22606912","chr19","28718617","28718918","60","6112007"
"chrX","22607731","22608040","chrX","21444518","21444831","16","1163213"
"chrX","22611765","22611876","chrX","21436860","21436971","2","1174905"
"chrX","22622029","22622318","chrX","21451253","21451538","7","1170776"
"chrX","22622354","22622645","chrX","21451574","21451864","5","1170780"
"chrX","22652718","22653019","chrX","21481466","21481769","11","1171252"
"chrX","22667358","22667680","chrX","21492338","21492660","8","1175020"
"chrX","22688141","22688312","chrX","21513188","21513366","9","1174953"
"chrX","22706118","22706410","chrX","21527033","21527345","24","1179085"
"chrX","22709483","22709778","chrX","21530737","21531032","8","1178746"
"chrX","22711535","22711645","chrX","21532789","21532905","10","1178746"
"chrX","22715202","22715511","chrX","21536402","21536711","9","1178800"
"chrX","22715994","22716069","chr8","5663671","5663745","11","17052323"
"chrX","22719712","22720013","chrX","21540677","21540988","18","1179035"
"chrX","22722314","22722611","chrX","21543288","21543583","14","1179026"
"chrX","22723096","22723418","chrX","21544086","21544401","14","1179010"
"chrX","22725492","22725792","chrX","21546454","21546754","5","1179038"
"chrX","22728238","22728532","chrX","21549164","21549458","9","1179074"
"chrX","22740602","22740893","chrX","21561876","21562167","2","1178726"
"chrX","22759437","22759568","chr3","87574600","87574729","16","64815163"
"chrX","22762382","22762655","chrX","21584116","21584389","4","1178266"
"chrX","22767166","22767459","chrX","21589412","21589704","3","1177754"
"chrX","22773685","22773976","chrX","21595898","21596187","5","1177787"
"chrX","22790288","22790588","chr2","97499012","97499310","59","74708724"
"chrX","22793749","22793980","chr10","29530691","29530911","51","6736942"
"chrX","22794083","22794206","chr4","125651321","125651440","22","102857238"
"chrX","22797568","22797866","chrX","21617310","21617624","23","1180258"
"chrX","22807805","22808148","chrX","21665369","21665721","15","1142436"
"chrX","22814492","22814680","chrX","21658825","21659017","11","1155667"
"chrX","22814992","22815129","chrX","21658377","21658514","3","1156615"
"chrX","22819865","22820151","chrX","21653424","21653710","3","1166441"
"chrX","22841640","22841929","chrX","21631560","21631853","12","1210080"
"chrX","22862684","22862970","chrX","21684253","21684514","31","1178431"
"chrX","22922616","22922911","chrX","21742175","21742475","10","1180441"
"chrX","22935937","22936233","chrX","21755657","21755953","1","1180280"
"chrX","22939979","22940306","chrX","21759700","21760011","18","1180279"
"chrX","22940685","22940974","chrX","21760392","21760681","5","1180293"
"chrX","22948904","22949189","chrX","21766212","21766513","20","1182692"
"chrX","22958990","22959274","chrX","21778765","21779049","3","1180225"
"chrX","22967306","22967582","chrX","21787144","21787422","7","1180162"
"chrX","22975567","22975846","chrX","21794801","21795080","6","1180766"
"chrX","23042559","23042830","chrX","21855203","21855472","7","1187356"
"chrX","23071131","23071386","chrX","21883772","21884027","1","1187359"
"chrX","23104482","23104795","chrX","21916981","21917292","6","1187501"
"chrX","23119864","23120153","chrX","21933031","21933317","8","1186833"
"chrX","23141300","23141599","chrX","21954952","21955260","13","1186348"
"chrX","23142472","23142739","chrX","21956129","21956396","4","1186343"
"chrX","23152889","23153222","chrX","21966534","21966834","36","1186355"
"chrX","23200357","23200668","chrX","22014089","22014401","9","1186268"
"chrX","23276585","23276850","chrX","22090739","22091014","15","1185846"
"chrX","23287210","23287366","chr6","61964429","61964585","38","38677219"
"chrX","23300635","23300935","chrX","22116379","22116675","8","1184256"
"chrX","23315047","23315360","chrX","22130802","22131119","9","1184245"
"chrX","23324588","23324874","chrX","22140340","22140627","6","1184248"
"chrX","23352428","23352735","chrX","22167971","22168278","2","1184457"
"chrX","23360253","23360533","chrX","22176104","22176393","15","1184149"
"chrX","23375411","23375700","chrX","22192453","22192742","5","1182958"
"chrX","23386632","23386901","chrX","22203153","22203420","8","1183479"
"chrX","23402009","23402110","chrX","22218785","22218886","1","1183224"
"chrX","23438500","23438723","chrX","22255317","22255540","0","1183183"
"chrX","23442987","23443295","chrX","22259812","22260116","8","1183175"
"chrX","23463631","23463927","chrX","22280779","22281079","7","1182852"
"chrX","23485434","23485622","chr16","17895663","17895828","42","5589771"
"chrX","23543275","23543568","chrX","22358735","22359029","6","1184540"
"chrX","23592221","23592394","chrX","22410052","22410225","4","1182169"
"chrX","23593816","23594021","chrX","22411595","22411800","10","1182221"
"chrX","23608711","23608970","chrX","22435424","22435685","6","1173287"
"chrX","23655770","23656072","chrX","22479769","22480069","10","1176001"
"chrX","23797655","23797940","chrX","22629859","22630134","18","1167796"
"chrX","23894290","23894451","chr7","54412705","54412868","27","30518415"
"chrX","24131637","24131952","chrX","22972433","22972748","9","1159204"
"chrX","24171029","24171332","chrX","23012245","23012548","9","1158784"
"chrX","24195072","24195380","chr16","40801326","40801623","68","16606254"
"chrX","24325339","24325603","chrX","23174694","23174964","13","1150645"
"chrX","24491989","24492249","chrX","23308848","23309108","6","1183141"
"chrX","24614792","24615074","chrX","23436028","23436310","6","1178764"
"chrX","24671753","24672041","chrX","23495440","23495728","8","1176313"
"chrX","24757535","24757836","chrX","23581878","23582178","9","1175657"
"chrX","24863291","24863593","chrX","23691375","23691678","10","1171916"
"chrX","24882340","24882554","chrX","23710167","23710381","4","1172173"
"chrX","24944642","24944737","chrX","23772895","23772990","1","1171747"
"chrX","25022824","25023112","chrX","23857611","23857897","4","1165213"
"chrX","25066999","25067293","chrX","23903241","23903539","11","1163758"
"chrX","25128020","25128229","chr11","100820741","100820953","41","75692721"
"chrX","25150311","25150605","chrX","23985542","23985836","4","1164769"
"chrX","25329385","25329695","chrX","24172811","24173128","20","1156574"
"chrX","25489134","25489264","chrX","24331015","24331145","1","1158119"
"chrX","25551569","25551862","chrX","24395219","24395509","5","1156350"
"chrX","25622846","25623133","chrX","24466305","24466588","10","1156541"
"chrX","25815727","25815802","chrX","24664131","24664204","3","1151596"
"chrX","25843770","25844012","chrX","24694562","24694806","5","1149208"
"chrX","25851451","25851738","chrX","24702072","24702359","4","1149379"
"chrX","25886076","25886388","chr2","44882107","44882408","67","18996031"
"chrX","25886562","25886821","chrX","24736669","24736950","25","1149893"
"chrX","25944779","25945074","chrX","24794618","24794914","6","1150161"
"chrX","25982899","25983176","chrX","24833454","24833749","27","1149445"
"chrX","26048087","26048309","chrX","24898525","24898742","7","1149562"
"chrX","26068619","26068915","chrX","24918605","24918905","11","1150014"
"chrX","26090193","26090367","chr1","24160077","24160252","38","1930116"
"chrX","26195731","26195917","chrX","25044330","25044514","5","1151401"
"chrX","26208659","26208845","chrX","25044330","25044514","5","1164329"
"chrX","26273621","26273921","chrX","25122374","25122671","8","1151247"
"chrX","26299687","26299964","chrX","25152114","25152390","2","1147573"
"chrX","26443674","26443956","chr9","5750814","5751112","64","20692860"
"chrX","26541459","26541770","chrX","25409134","25409445","6","1132325"
"chrX","26646037","26646343","chrX","25525087","25525393","5","1120950"
"chrX","26647984","26648288","chrX","25527031","25527357","28","1120953"
"chrX","26721260","26721564","chrX","25605553","25605862","10","1115707"
"chrX","26737962","26738243","chrX","25621919","25622199","6","1116043"
"chrX","26801068","26801363","chrX","25688140","25688435","7","1112928"
"chrX","26821931","26822239","chrX","25708725","25709033","3","1113206"
"chrX","26858300","26858634","chrX","25749665","25750000","7","1108635"
"chrX","26911974","26912269","chrX","25799841","25800136","2","1112133"
"chrX","26951459","26951747","chrX","25838840","25839128","2","1112619"
"chrX","26974434","26974749","chrX","25862073","25862387","14","1112361"
"chrX","27047014","27047332","chrX","25937146","25937454","18","1109868"
"chrX","27117297","27117602","chrX","26009512","26009818","6","1107785"
"chrX","27210261","27210544","chrX","26104356","26104639","4","1105905"
"chrX","27215722","27215990","chrX","26109512","26109787","9","1106210"
"chrX","27330124","27330278","chrX","26222964","26223119","6","1107160"
"chrX","27330650","27330779","chrX","26223494","26223623","1","1107156"
"chrX","27355419","27355583","chr20","49704963","49705118","55","22349544"
"chrX","27515672","27515973","chrX","26403821","26404122","11","1111851"
"chrX","27523016","27523294","chrX","26413792","26414060","22","1109224"
"chrX","27783680","27783995","chrX","26667701","26668017","14","1115979"
"chrX","27802940","27803223","chrX","26686462","26686745","9","1116478"
"chrX","27805589","27805914","chr3","171607028","171607345","80","143801439"
"chrX","27811441","27811740","chrX","26695046","26695340","10","1116395"
"chrX","27816321","27816604","chrX","26699916","26700188","17","1116405"
"chrX","27821568","27821870","chrX","26704929","26705230","5","1116639"
"chrX","27848932","27849144","chrX","26731087","26731303","11","1117845"
"chrX","27860394","27860668","chrX","26742900","26743171","7","1117494"
"chrX","27881732","27881829","chrX","26764748","26764845","2","1116984"
"chrX","27894672","27894974","chr13","24727688","24727990","66","3166984"
"chrX","27914917","27915226","chrX","26798134","26798443","7","1116783"
"chrX","27939953","27940262","chr5","12517747","12518050","60","15422206"
"chrX","27945117","27945256","chr2","172227852","172227991","35","144282735"
"chrX","27960458","27960766","chr16","59760836","59761134","60","31800378"
"chrX","27972918","27973221","chrX","26858344","26858654","15","1114574"
"chrX","28005739","28005856","chrX","26890556","26890673","2","1115183"
"chrX","28022334","28022588","chrX","26906840","26907095","7","1115494"
"chrX","28053331","28053627","chrX","26937650","26937946","6","1115681"
"chrX","28060042","28060326","chrX","26944365","26944649","12","1115677"
"chrX","28101181","28101479","chrX","26989406","26989705","10","1111775"
"chrX","28167259","28167564","chrX","27053819","27054125","11","1113440"
"chrX","28224318","28224611","chrX","27118039","27118332","5","1106279"
"chrX","28280166","28280440","chrX","27171500","27171782","15","1108666"
"chrX","28484688","28484802","chrX","27378968","27379079","4","1105720"
"chrX","28574694","28574846","chr7","135930852","135930999","38","107356158"
"chrX","28635274","28635571","chr1","146805879","146806164","67","118170605"
"chrX","28681048","28681323","chrX","27576041","27576323","10","1105007"
"chrX","28861316","28861609","chrX","27750237","27750538","13","1111079"
"chrX","28889096","28889387","chrX","27777487","27777778","5","1111609"
"chrX","28989543","28989700","chrX","27884976","27885136","9","1104567"
"chrX","28999521","28999814","chrX","27894759","27895057","12","1104762"
"chrX","29006577","29006847","chrX","27903049","27903319","3","1103528"
"chrX","29036261","29036555","chr20","62664542","62664827","58","33628281"
"chrX","29126083","29126383","chrX","28023457","28023757","9","1102626"
"chrX","29127611","29127921","chrX","28024990","28025301","5","1102621"
"chrX","29129432","29129724","chrX","28026802","28027094","12","1102630"
"chrX","29134768","29135041","chr5","158962682","158962956","50","129827914"
"chrX","29141625","29141818","chr20","62793124","62793314","44","33651499"
"chrX","29154338","29154635","chrX","28050916","28051217","13","1103422"
"chrX","29165264","29165568","chrX","28060948","28061245","15","1104316"
"chrX","29174646","29174947","chr9","118375917","118376218","53","89201271"
"chrX","29175833","29176112","chr7","60601953","60602221","62","31426120"
"chrX","29240561","29240850","chrX","28133797","28134090","8","1106764"
"chrX","29241599","29241909","chrX","28134840","28135131","24","1106759"
"chrX","29242921","29243088","chrX","28136158","28136325","1","1106763"
"chrX","29255440","29255724","chrX","28148653","28148937","5","1106787"
"chrX","29264976","29265283","chrX","28158227","28158530","8","1106749"
"chrX","29271105","29271320","chrX","28164346","28164561","2","1106759"
"chrX","29273294","29273584","chr8","89182347","89182634","58","59909053"
"chrX","29297124","29297398","chrX","28190151","28190431","11","1106973"
"chrX","29302514","29302784","chr8","31825080","31825346","51","2522566"
"chrX","29305140","29305347","chrX","28198188","28198407","14","1106952"
"chrX","29325519","29325804","chrX","28218329","28218638","27","1107190"
"chrX","29339445","29339615","chrX","28232756","28232926","0","1106689"
"chrX","29339735","29339808","chrX","28233042","28233115","2","1106693"
"chrX","29440242","29440536","chrX","28334826","28335121","11","1105416"
"chrX","29459910","29460209","chrX","28354487","28354792","15","1105423"
"chrX","29524768","29525072","chrX","28420173","28420466","26","1104595"
"chrX","29525073","29525372","chrX","28420467","28420766","7","1104606"
"chrX","29528787","29529066","chrX","28424198","28424478","7","1104589"
"chrX","29580747","29581038","chrX","28476015","28476305","6","1104732"
"chrX","29665461","29665760","chrX","28560944","28561254","17","1104517"
"chrX","29678490","29678783","chrX","28573964","28574257","3","1104526"
"chrX","29739066","29739382","chrX","28631409","28631738","23","1107657"
"chrX","29775873","29776042","chrX","28669309","28669477","5","1106564"
"chrX","29955247","29955544","chrX","28840150","28840445","7","1115097"
"chrX","29975649","29975938","chrX","28865776","28866061","11","1109873"
"chrX","30013062","30013373","chrX","28897651","28897959","12","1115411"
"chrX","30028207","30028508","chrX","28912836","28913142","14","1115371"
"chrX","30252711","30253003","chrX","29136803","29137096","6","1115908"
"chrX","30396183","30396507","chrX","29277917","29278236","17","1118266"
"chrX","30564987","30565239","chr8","76427874","76428118","51","45862887"
"chrX","30585230","30585516","chrX","29468082","29468377","33","1117148"
"chrX","30615600","30615888","chrX","74522407","74522691","60","43906807"
"chrX","30886776","30887079","chrX","29786491","29786792","5","1100285"
"chrX","30930417","30930713","chr3","33909922","33910216","57","2979505"
"chrX","31184740","31184904","chr20","54044757","54044924","6","22860017"
"chrX","31255503","31255808","chrX","30167191","30167498","47","1088312"
"chrX","31372130","31372423","chrX","30275234","30275527","10","1096896"
"chrX","31431063","31431364","chrX","30331593","30331921","32","1099470"
"chrX","31456374","31456653","chrX","30355168","30355448","6","1101206"
"chrX","31580261","31580525","chrX","30478415","30478679","4","1101846"
"chrX","32193177","32193487","chrX","31085648","31085916","46","1107529"
"chrX","32441870","32442067","chrX","31336665","31336867","15","1105205"
"chrX","32469739","32469937","chrX","31368996","31369194","3","1100743"
"chrX","32546261","32546551","chrX","31443388","31443678","7","1102873"
"chrX","32559888","32560137","chrX","31456192","31456441","4","1103696"
"chrX","32609102","32609407","chrX","31505347","31505666","21","1103755"
"chrX","32632823","32633130","chrX","31528876","31529183","6","1103947"
"chrX","32650856","32651164","chrX","31552762","31553067","9","1098094"
"chrX","32694248","32694554","chrX","31599585","31599891","9","1094663"
"chrX","32695613","32695919","chrX","31600951","31601262","8","1094662"
"chrX","32940961","32941258","chrX","31830690","31830976","15","1110271"
"chrX","32985682","32985776","chr20","19887217","19887309","18","13098465"
"chrX","33001278","33001550","chrX","31899131","31899399","7","1102147"
"chrX","33040580","33040859","chrX","31944143","31944422","3","1096437"
"chrX","33184075","33184218","chrX","32087277","32087420","2","1096798"
"chrX","33288166","33288470","chrX","32190467","32190771","5","1097699"
"chrX","33382509","33382811","chrX","32286880","32287185","13","1095629"
"chrX","33409280","33409589","chrX","32313635","32313948","15","1095645"
"chrX","33495911","33496183","chrX","32398157","32398424","7","1097754"
"chrX","33504546","33504863","chrX","32407398","32407715","6","1097148"
"chrX","33849435","33849680","chrX","32752909","32753155","4","1096526"
"chrX","34184432","34184738","chrX","33094088","33094399","19","1090344"
"chrX","34197240","34197498","chrX","33106256","33106514","7","1090984"
"chrX","34257026","34257214","chrX","33154906","33155096","10","1102120"
"chrX","34283361","34283484","chrX","33182367","33182489","3","1100994"
"chrX","34283780","34283936","chrX","33182790","33182975","32","1100990"
"chrX","34368259","34368562","chrX","33265855","33266158","17","1102404"
"chrX","34407560","34407747","chrX","33305085","33305273","35","1102475"
"chrX","34434105","34434276","chrX","33329240","33329411","34","1104865"
"chrX","34448944","34449224","chr5","71834612","71834890","53","37385668"
"chrX","34476399","34476709","chrX","33375410","33375741","42","1100989"
"chrX","34505011","34505355","chr16","58924259","58924568","96","24419248"
"chrX","34778986","34779269","chrX","33672799","33673081","10","1106187"
"chrX","34825416","34825706","chrX","33718422","33718713","4","1106994"
"chrX","34958468","34958769","chrX","33854354","33854656","4","1104114"
"chrX","35064120","35064400","chrX","33959561","33959833","12","1104559"
"chrX","35136952","35137229","chrX","34030621","34030902","11","1106331"
"chrX","35202546","35202712","chrX","14387257","14387417","33","20815289"
"chrX","35256588","35256803","chrX","34149552","34149767","1","1107036"
"chrX","35291609","35291889","chrX","34183020","34183293","14","1108589"
"chrX","35311570","35311850","chrX","34183020","34183293","14","1128550"
"chrX","35460771","35461063","chrX","34352442","34352735","2","1108329"
"chrX","35626545","35626834","chrX","35637616","35637905","8","11071"
"chrX","35664001","35664309","chrX","35675467","35675779","7","11466"
"chrX","35678225","35678352","chrX","35689977","35690096","10","11752"
"chrX","35678380","35678523","chrX","35690131","35690271","3","11751"
"chrX","35839396","35839697","chrX","35852804","35853105","4","13408"
"chrX","35841062","35841369","chrX","35854468","35854769","12","13406"
"chrX","35848696","35848829","chrX","35864223","35864351","19","15527"
"chrX","35852146","35852310","chr12","78635801","78635964","26","42783655"
"chrX","35912589","35912894","chrX","35926316","35926613","24","13727"
"chrX","35923210","35923486","chrX","35936912","35937188","8","13702"
"chrX","35927279","35927564","chr8","95348068","95348360","54","59420789"
"chrX","35995644","35995949","chrX","36008685","36008995","10","13041"
"chrX","36009321","36009750","chr1","101341972","101342336","123","65332651"
"chrX","36026686","36026962","chrX","36040016","36040290","8","13330"
"chrX","36318201","36318230","chr11","97989142","97989169","5","61670941"
"chrX","36318298","36318585","chrX","36337216","36337533","40","18918"
"chrX","36498697","36499026","chrX","36518750","36519075","26","20053"
"chrX","36708344","36708647","chr1","92535733","92536035","62","55827389"
"chrX","36727802","36728093","chrX","36771528","36771819","15","43726"
"chrX","36767326","36767621","chrX","36812579","36812875","8","45253"
"chrX","36787941","36788218","chrX","36832915","36833192","3","44974"
"chrX","36803052","36803304","chrX","36848271","36848520","5","45219"
"chrX","36853417","36853716","chrX","36898642","36898941","3","45225"
"chrX","36901093","36901351","chrX","36946577","36946836","4","45484"
"chrX","36903210","36903379","chr19","35682499","35682669","24","1220711"
"chrX","36903887","36904171","chrX","20983668","20983957","47","15920219"
"chrX","36910027","36910324","chrX","36955491","36955788","3","45464"
"chrX","36921392","36921724","chrX","36967165","36967491","20","45773"
"chrX","36927548","36927863","chrX","36973769","36974080","12","46221"
"chrX","36936507","36936791","chrX","36982758","36983068","30","46251"
"chrX","36943795","36943907","chrX","36990390","36990502","2","46595"
