"chr1","186061","186108","GL873691","2903502","2903535","20","2717441"
"chr1","335355","335658","GL873541","16268070","16268366","93","15932715"
"chr1","449611","449665","GL873554","10500008","10500061","16","10050397"
"chr1","477959","478266","GL873528","36697151","36697434","96","36219192"
"chr1","609311","609594","GL873547","2222074","2222356","90","1612763"
"chr1","677235","677538","GL873541","16268070","16268366","91","15590835"
"chr1","744549","744843","GL873659","913070","913333","93","168521"
"chr1","1614248","1614549","GL873541","16268070","16268366","84","14653822"
"chr1","2272506","2272749","GL873528","25203621","25203847","89","22931115"
"chr1","2837320","2837613","GL873547","2222074","2222356","83","615246"
"chr1","2858071","2858382","GL873547","2222074","2222356","93","635997"
"chr1","3056484","3056789","GL873541","16268070","16268366","91","13211586"
"chr1","3229303","3229603","GL873530","16647228","16647517","80","13417925"
"chr1","3490115","3490413","GL873547","2222074","2222356","91","1268041"
"chr1","3707481","3707762","GL873562","3299887","3300144","88","407594"
"chr1","3989695","3989768","GL873554","10500008","10500061","31","6510313"
"chr1","4334927","4335105","GL873541","1550303","1550443","75","2784624"
"chr1","4366395","4366679","GL873547","2222074","2222356","86","2144321"
"chr1","4595848","4596152","GL873547","2222074","2222356","90","2373774"
"chr1","4893725","4894019","GL873541","16268070","16268366","89","11374345"
"chr1","5224241","5224483","GL873528","25203621","25203847","86","19979380"
"chr1","5427338","5427631","GL873547","2222074","2222356","94","3205264"
"chr1","5552622","5552912","GL873547","2222074","2222356","79","3330548"
"chr1","5552986","5553001","GL873691","2903502","2903535","21","2649484"
"chr1","5587451","5587576","GL873552","12711845","12711956","48","7124394"
"chr1","5638729","5639007","GL873659","913070","913333","98","4725659"
"chr1","6419013","6419323","GL873541","16268070","16268366","94","9849057"
"chr1","6672443","6672757","GL873541","16268070","16268366","90","9595627"
"chr1","6699501","6699787","GL873547","2222074","2222356","82","4477427"
"chr1","6987555","6987855","GL873541","16268070","16268366","86","9280515"
"chr1","7025973","7026277","GL873530","16647228","16647517","92","9621255"
"chr1","7047997","7048113","GL873622","7076274","7076365","40","28277"
"chr1","7060986","7061285","GL873541","16268070","16268366","91","9207084"
"chr1","7266169","7266537","GL873608","6630366","6630673","136","635803"
"chr1","7308588","7308867","GL873562","3299887","3300144","86","4008701"
"chr1","7322568","7322865","GL873541","16268070","16268366","88","8945502"
"chr1","7613399","7613709","GL873541","16268070","16268366","100","8654671"
"chr1","7718282","7718558","GL873547","2222074","2222356","87","5496208"
"chr1","7743906","7744215","GL873541","16268070","16268366","92","8524164"
"chr1","7748670","7748967","GL873541","16268070","16268366","80","8519400"
"chr1","7765384","7765518","GL873550","5998776","5998900","36","1766608"
"chr1","7881259","7881572","GL873541","16268070","16268366","98","8386811"
"chr1","8006090","8006394","GL873541","16268070","16268366","87","8261980"
"chr1","8012608","8012872","GL873680","3005257","3005482","85","5007351"
"chr1","8086501","8086784","GL873547","2222074","2222356","91","5864427"
"chr1","8192862","8192993","GL873619","2497092","2497229","47","5695770"
"chr1","8274775","8274983","GL873521","1458597","1458764","72","6816178"
"chr1","8643052","8643358","GL873541","16268070","16268366","89","7625018"
"chr1","8696866","8697165","GL873530","16647228","16647517","85","7950362"
"chr1","8731653","8731900","GL873680","3005257","3005482","75","5726396"
"chr1","8790492","8790780","GL873541","16268070","16268366","87","7477578"
"chr1","8926569","8926682","GL873622","7076274","7076365","43","1850295"
"chr1","9062745","9063044","GL873541","16268070","16268366","79","7205325"
"chr1","9142653","9142941","GL873547","2222074","2222356","77","6920579"
"chr1","9185341","9185424","GL873643","6205658","6205743","39","2979683"
"chr1","9328689","9328993","GL873541","16268070","16268366","89","6939381"
"chr1","9360845","9361141","GL873547","2222074","2222356","77","7138771"
"chr1","9431377","9431502","GL873622","7076274","7076365","52","2355103"
"chr1","9839303","9839433","GL873550","5998776","5998900","50","3840527"
"chr1","9886544","9886740","GL873630","2508568","2508753","67","7377976"
"chr1","9923402","9923684","GL873530","16647228","16647517","93","6723826"
"chr1","10049442","10049732","GL873547","2222074","2222356","79","7827368"
"chr1","10049733","10049863","GL873550","5998776","5998900","39","4050957"
"chr1","10318162","10318458","GL873547","2222074","2222356","76","8096088"
"chr1","10415859","10416187","GL873812","559768","560073","111","9856091"
"chr1","10521098","10521406","GL873528","36697151","36697434","97","26176053"
"chr1","10575351","10575643","GL873541","16268070","16268366","97","5692719"
"chr1","10737262","10737562","GL873541","16268070","16268366","93","5530808"
"chr1","10885665","10885964","GL873541","16268070","16268366","80","5382405"
"chr1","10964645","10964948","GL873528","36697151","36697434","86","25732506"
"chr1","11038030","11038180","GL873530","5593486","5593649","54","5444544"
"chr1","11078438","11078735","GL873607","1418062","1418355","95","9660376"
"chr1","11098683","11098970","GL873547","2222074","2222356","81","8876609"
"chr1","11195470","11195768","GL873547","2222074","2222356","100","8973396"
"chr1","11268259","11268544","GL873562","3299887","3300144","116","7968372"
"chr1","11405147","11405439","GL873530","16647228","16647517","84","5242081"
"chr1","11449541","11449843","GL873541","16268070","16268366","87","4818529"
"chr1","11509705","11509992","GL873547","2222074","2222356","83","9287631"
"chr1","12214032","12214369","GL873530","16647228","16647517","120","4433196"
"chr1","12438139","12438436","GL873541","16268070","16268366","95","3829931"
"chr1","12586729","12587026","GL873541","16268070","16268366","90","3681341"
"chr1","13421153","13421461","GL873541","16268070","16268366","92","2846917"
"chr1","14034706","14035003","GL873530","16647228","16647517","94","2612522"
"chr1","14043292","14043520","GL873557","3858721","3858924","81","10184571"
"chr1","14058753","14059032","GL873562","3299887","3300144","85","10758866"
"chr1","14059072","14059086","GL873691","2903502","2903535","21","11155570"
"chr1","14340703","14341012","GL873528","36697151","36697434","100","22356448"
"chr1","14536369","14536671","GL873608","6630366","6630673","93","7906003"
"chr1","14591159","14591426","GL873680","3005257","3005482","103","11585902"
"chr1","14808370","14808664","GL873547","2222074","2222356","96","12586296"
"chr1","15543077","15543374","GL873541","16268070","16268366","88","724993"
"chr1","15609288","15609586","GL873541","16268070","16268366","88","658782"
"chr1","15692486","15692585","GL873524","43272658","43272747","44","27580172"
"chr1","15791159","15791466","GL873541","16268070","16268366","88","476911"
"chr1","15800958","15801262","GL873530","16647228","16647517","92","846270"
"chr1","15862065","15862374","GL873541","16268070","16268366","91","406005"
"chr1","16370675","16370978","GL873547","2222074","2222356","98","14148601"
"chr1","16536871","16537143","GL873562","3299887","3300144","98","13236984"
"chr1","16838288","16838572","GL873547","2222074","2222356","87","14616214"
"chr1","17105200","17105498","GL873752","427788","428097","83","16677412"
"chr1","17283164","17283472","GL873607","1418062","1418355","94","15865102"
"chr1","17423123","17423430","GL873541","16268070","16268366","98","1155053"
"chr1","17663927","17664181","GL873543","13038674","13038909","96","4625253"
"chr1","17768407","17768750","GL873541","16268070","16268366","121","1500337"
"chr1","17951011","17951309","GL873547","2222074","2222356","85","15728937"
"chr1","18300604","18300863","GL873562","3299887","3300144","86","15000717"
"chr1","18375911","18376144","GL873630","2508568","2508753","83","15867343"
"chr1","18422941","18422987","GL873527","37742071","37742124","20","19319130"
"chr1","18525048","18525193","GL873611","3799989","3800137","60","14725059"
"chr1","18569784","18570097","GL873541","16268070","16268366","101","2301714"
"chr1","18628504","18628807","GL873541","16268070","16268366","88","2360434"
"chr1","18675946","18676242","GL873659","913070","913333","86","17762876"
"chr1","19144468","19144609","GL873541","1550303","1550443","63","17594165"
"chr1","19144850","19144895","GL873691","2903502","2903535","20","16241348"
"chr1","19184037","19184145","GL873622","7076274","7076365","37","12107763"
"chr1","19362596","19362906","GL873528","36697151","36697434","92","17334555"
"chr1","20271829","20272128","GL873530","16647228","16647517","92","3624601"
"chr1","20346354","20346557","GL873535","24407607","24407780","55","4061253"
"chr1","20836893","20837193","GL873541","16268070","16268366","79","4568823"
"chr1","21312868","21313163","GL873541","16268070","16268366","88","5044798"
"chr1","21484113","21484426","GL873528","36697151","36697434","98","15213038"
"chr1","21512792","21512987","GL873630","2508568","2508753","70","19004224"
"chr1","21805992","21806296","GL873530","16647228","16647517","81","5158764"
"chr1","21908644","21908788","GL873550","5998776","5998900","45","15909868"
"chr1","21908799","21908872","GL873554","10500008","10500061","34","11408791"
"chr1","21908885","21909148","GL873680","3005257","3005482","89","18903628"
"chr1","22014129","22014427","GL873541","16268070","16268366","78","5746059"
"chr1","23339210","23339516","GL873541","16268070","16268366","97","7071140"
"chr1","23837818","23838095","GL873547","2222074","2222356","86","21615744"
"chr1","24159641","24159900","GL873547","2222074","2222356","83","21937567"
"chr1","25333745","25334052","GL873541","16268070","16268366","98","9065675"
"chr1","25788556","25788851","GL873607","1418062","1418355","88","24370494"
"chr1","25850304","25850598","GL873530","16647228","16647517","88","9203076"
"chr1","25876974","25877264","GL873541","16268070","16268366","93","9608904"
"chr1","25970067","25970095","GL873691","2903502","2903535","15","23066565"
"chr1","25970139","25970266","GL873550","5998776","5998900","51","19971363"
"chr1","26009573","26009876","GL873541","16268070","16268366","91","9741503"
"chr1","26009898","26010068","GL873574","7318344","7318500","58","18691554"
"chr1","26110143","26110449","GL873541","16268070","16268366","89","9842073"
"chr1","27400169","27400450","GL873547","2222074","2222356","85","25178095"
"chr1","27402816","27403106","GL873530","16647228","16647517","90","10755588"
"chr1","27745206","27745486","GL873565","12307556","12307825","91","15437650"
"chr1","29294849","29295125","GL873562","3299887","3300144","78","25994962"
"chr1","29387010","29387289","GL873547","2222074","2222356","86","27164936"
"chr1","29400915","29401120","GL873531","3555300","3555500","61","25845615"
"chr1","29620105","29620414","GL873547","2222074","2222356","99","27398031"
"chr1","29621888","29622188","GL873530","16647228","16647517","83","12974660"
"chr1","29712863","29713163","GL873541","16268070","16268366","87","13444793"
"chr1","29918251","29918559","GL873541","16268070","16268366","98","13650181"
"chr1","29954875","29955174","GL873528","36697151","36697434","95","6742276"
"chr1","30466769","30467065","GL873541","16268070","16268366","87","14198699"
"chr1","30968724","30968989","GL873547","2222074","2222356","85","28746650"
"chr1","31094940","31095265","GL873541","16268070","16268366","113","14826870"
"chr1","31172513","31172803","GL873608","6630366","6630673","86","24542147"
"chr1","31207787","31208094","GL873541","16268070","16268366","91","14939717"
"chr1","31259486","31259780","GL873547","2222074","2222356","79","29037412"
"chr1","32028693","32028980","GL873528","36697151","36697434","92","4668458"
"chr1","32042837","32043070","GL873564","8360716","8360913","79","23682121"
"chr1","32046279","32046567","GL873530","16647228","16647517","83","15399051"
"chr1","32051188","32051490","GL873530","16647228","16647517","92","15403960"
"chr1","32078310","32078620","GL873528","36697151","36697434","93","4618841"
"chr1","32185350","32185644","GL873541","16268070","16268366","81","15917280"
"chr1","32220138","32220445","GL873541","16268070","16268366","90","15952068"
"chr1","32292104","32292395","GL873547","2222074","2222356","83","30070030"
"chr1","32351687","32351986","GL873541","16268070","16268366","89","16083617"
"chr1","32665386","32665665","GL873562","3299887","3300144","89","29365499"
"chr1","32854681","32854917","GL873558","7532067","7532273","79","25322614"
"chr1","32855214","32855299","GL873524","43272658","43272747","32","10417444"
"chr1","33322646","33322945","GL873607","1418062","1418355","87","31904584"
"chr1","33477981","33478289","GL873541","16268070","16268366","91","17209911"
"chr1","33616874","33617163","GL873547","2222074","2222356","78","31394800"
"chr1","33735181","33735329","GL873541","1550303","1550443","60","32184878"
"chr1","34830370","34830659","GL873530","16647228","16647517","81","18183142"
"chr1","35298023","35298312","GL873547","2222074","2222356","81","33075949"
"chr1","36079803","36080100","GL873541","16268070","16268366","78","19811733"
"chr1","36656708","36657018","GL873607","1418062","1418355","96","35238646"
"chr1","37357851","37358154","GL873541","16268070","16268366","91","21089781"
"chr1","37625094","37625393","GL873530","16647228","16647517","84","20977866"
"chr1","38609642","38609938","GL873541","16268070","16268366","84","22341572"
"chr1","39303248","39303448","GL873530","5593486","5593649","75","33709762"
"chr1","39576787","39576899","GL873587","10002051","10002151","51","29574736"
"chr1","39957000","39957281","GL873562","3299887","3300144","86","36657113"
"chr1","40186193","40186501","GL873541","16268070","16268366","87","23918123"
"chr1","40645791","40646085","GL873607","1418062","1418355","94","39227729"
"chr1","40789827","40790128","GL873541","16268070","16268366","84","24521757"
"chr1","41056319","41056617","GL873541","16268070","16268366","83","24788249"
"chr1","41721050","41721340","GL873530","16647228","16647517","90","25073822"
"chr1","41979357","41979596","GL873538","2567037","2567262","77","39412320"
"chr1","42089594","42089908","GL873541","16268070","16268366","103","25821524"
"chr1","42767254","42767406","GL873550","5998776","5998900","57","36768478"
"chr1","42919860","42920102","GL873640","6426205","6426399","97","36493655"
"chr1","43486737","43487042","GL873541","16268070","16268366","87","27218667"
"chr1","43793964","43794268","GL873541","16268070","16268366","84","27525894"
"chr1","44309687","44309985","GL873541","16268070","16268366","90","28041617"
"chr1","44310511","44310819","GL873528","36697151","36697434","93","7613360"
"chr1","44461610","44461904","GL873667","4451263","4451534","88","40010347"
"chr1","44914161","44914452","GL873541","16268070","16268366","84","28646091"
"chr1","44962256","44962555","GL873541","16268070","16268366","90","28694186"
"chr1","45751661","45751954","GL873541","16268070","16268366","87","29483591"
"chr1","45859746","45859907","GL873530","5593486","5593649","50","40266260"
"chr1","46268949","46269013","GL873550","5998911","5998963","26","40270038"
"chr1","46491849","46492150","GL873530","16647228","16647517","84","29844621"
"chr1","47529841","47530117","GL873530","16647228","16647517","90","30882613"
"chr1","47703990","47704286","GL873530","16647228","16647517","80","31056762"
"chr1","48247145","48247405","GL873535","4830564","4830824","99","43416581"
"chr1","50364882","50365169","GL873541","16268070","16268366","84","34096812"
"chr1","50489230","50489525","GL873530","16647228","16647517","99","33842002"
"chr1","50529774","50530054","GL873541","16268070","16268366","90","34261704"
"chr1","50673810","50674113","GL873541","16268070","16268366","86","34405740"
"chr1","50678867","50679117","GL873680","3005257","3005482","84","47673610"
"chr1","51035370","51035662","GL873530","16647228","16647517","81","34388142"
"chr1","51164773","51165080","GL873547","2222074","2222356","92","48942699"
"chr1","52499822","52500000","GL873530","5593486","5593649","58","46906336"
"chr1","52791819","52792090","GL873562","3299887","3300144","82","49491932"
"chr1","53337568","53337863","GL873547","2222074","2222356","76","51115494"
"chr1","53767711","53767998","GL873547","2222074","2222356","81","51545637"
"chr1","54184359","54184664","GL873541","16268070","16268366","94","37916289"
"chr1","54806147","54806254","GL873622","7076274","7076365","38","47729873"
"chr1","54907567","54907700","GL873622","7076274","7076365","56","47831293"
"chr1","55208231","55208438","GL873680","3005257","3005482","71","52202974"
"chr1","55236878","55237165","GL873530","16647228","16647517","84","38589650"
"chr1","55338811","55339115","GL873528","36697151","36697434","97","18641660"
"chr1","55404389","55404686","GL873608","6630366","6630673","85","48774023"
"chr1","55462685","55462982","GL873541","16268070","16268366","92","39194615"
"chr1","55474087","55474393","GL873530","16647228","16647517","98","38826859"
"chr1","55479193","55479488","GL873530","16647228","16647517","83","38831965"
"chr1","55513701","55514011","GL873541","16268070","16268366","103","39245631"
"chr1","55554572","55554867","GL873530","16647228","16647517","89","38907344"
"chr1","55601903","55602194","GL873530","16647228","16647517","85","38954675"
"chr1","56961737","56962012","GL873547","5449763","5449997","91","51511974"
"chr1","57280474","57280765","GL873547","2222074","2222356","95","55058400"
"chr1","57899913","57900199","GL873530","16647228","16647517","83","41252685"
"chr1","57993153","57993457","GL873541","16268070","16268366","88","41725083"
"chr1","58165735","58166033","GL873541","16268070","16268366","98","41897665"
"chr1","60789638","60789947","GL873541","16268070","16268366","87","44521568"
"chr1","60987539","60987752","GL873531","3555300","3555500","67","57432239"
"chr1","61048676","61048974","GL873541","16268070","16268366","90","44780606"
"chr1","61085007","61085301","GL873547","2222074","2222356","81","58862933"
"chr1","61657675","61657969","GL873541","16268070","16268366","84","45389605"
"chr1","62605399","62605682","GL873528","36697151","36697434","96","25908248"
"chr1","62973229","62973484","GL873543","13038674","13038909","94","49934555"
"chr1","63117384","63117672","GL873547","2222074","2222356","90","60895310"
"chr1","63188406","63188712","GL873608","6630366","6630673","92","56558040"
"chr1","63674757","63674878","GL873622","7076274","7076365","50","56598483"
"chr1","63711064","63711362","GL873547","2222074","2222356","88","61488990"
"chr1","63915738","63916013","GL873565","12307556","12307825","105","51608182"
"chr1","64217354","64217661","GL873541","16268070","16268366","90","47949284"
"chr1","64406402","64406682","GL873530","16647228","16647517","88","47759174"
"chr1","64682907","64683033","GL873552","12711845","12711956","55","51971062"
"chr1","64816119","64816429","GL873541","16268070","16268366","93","48548049"
"chr1","64865119","64865416","GL873547","2222074","2222356","80","62643045"
"chr1","64953626","64953920","GL873541","16268070","16268366","79","48685556"
"chr1","64982479","64982761","GL873547","2222074","2222356","87","62760405"
"chr1","65042237","65042542","GL873659","913070","913333","90","64129167"
"chr1","65102131","65102418","GL873607","1418062","1418355","85","63684069"
"chr1","65146619","65146931","GL873541","16268070","16268366","88","48878549"
"chr1","65166959","65167258","GL873541","16268070","16268366","86","48898889"
"chr1","65667573","65667874","GL873541","16268070","16268366","91","49399503"
"chr1","65713054","65713343","GL873530","16647228","16647517","85","49065826"
"chr1","65810600","65810904","GL873541","16268070","16268366","96","49542530"
"chr1","65811390","65811700","GL873528","36697151","36697434","92","29114239"
"chr1","65812549","65812863","GL873528","36697151","36697434","100","29115398"
"chr1","66543995","66544268","GL873530","16647228","16647517","88","49896767"
"chr1","66559431","66559714","GL873659","913070","913333","82","65646361"
"chr1","66607389","66607682","GL873530","16647228","16647517","84","49960161"
"chr1","66763889","66764138","GL873528","25203621","25203847","82","41560268"
"chr1","66770178","66770346","GL873530","5593486","5593649","46","61176692"
"chr1","66802088","66802400","GL873541","16268070","16268366","98","50534018"
"chr1","66926212","66926503","GL873547","2222074","2222356","86","64704138"
"chr1","67566937","67567228","GL873547","2222074","2222356","81","65344863"
"chr1","68394201","68394508","GL873541","16268070","16268366","84","52126131"
"chr1","68504497","68504793","GL873541","16268070","16268366","76","52236427"
"chr1","68581324","68581621","GL873541","16268070","16268366","82","52313254"
"chr1","68860714","68860974","GL873543","13038674","13038909","93","55822040"
"chr1","68970266","68970543","GL873530","16647228","16647517","86","52323038"
"chr1","68990574","68990859","GL873547","2222074","2222356","78","66768500"
"chr1","69066009","69066297","GL873607","1418062","1418355","90","67647947"
"chr1","69523603","69523888","GL873547","2222074","2222356","90","67301529"
"chr1","69987806","69987963","GL873611","3799989","3800137","55","66187817"
"chr1","70897757","70898029","GL873562","3299887","3300144","81","67597870"
"chr1","71131341","71131637","GL873541","16268070","16268366","86","54863271"
"chr1","71429644","71429947","GL873530","16647228","16647517","101","54782416"
"chr1","71596274","71596584","GL873541","16268070","16268366","99","55328204"
"chr1","72701898","72702181","GL873547","2222074","2222356","82","70479824"
"chr1","73623928","73624197","GL873547","2222074","2222356","88","71401854"
"chr1","74176948","74177248","GL873541","16268070","16268366","79","57908878"
"chr1","74396070","74396346","GL873541","16268070","16268366","84","58128000"
"chr1","74575739","74576035","GL873547","2222074","2222356","85","72353665"
"chr1","74924300","74924595","GL873547","2222074","2222356","90","72702226"
"chr1","74938780","74939084","GL873608","6630366","6630673","94","68308414"
"chr1","75066446","75066748","GL873541","16268070","16268366","85","58798376"
"chr1","75070017","75070323","GL873607","1418062","1418355","93","73651955"
"chr1","75349818","75350108","GL873547","2222074","2222356","91","73127744"
"chr1","75433981","75434284","GL873541","16268070","16268366","96","59165911"
"chr1","76828086","76828358","GL873562","3299887","3300144","92","73528199"
"chr1","76971015","76971314","GL873541","16268070","16268366","89","60702945"
"chr1","77058753","77059041","GL873562","3299887","3300144","101","73758866"
"chr1","77159136","77159266","GL873619","2497092","2497229","45","74662044"
"chr1","77272974","77273269","GL873541","16268070","16268366","92","61004904"
"chr1","77580958","77581251","GL873530","16647228","16647517","82","60933730"
"chr1","77624095","77624399","GL873528","36697151","36697434","94","40926944"
"chr1","78313905","78314211","GL873667","4451263","4451534","97","73862642"
"chr1","79252124","79252431","GL873667","4451263","4451534","93","74800861"
"chr1","79460359","79460616","GL873565","12307556","12307825","96","67152803"
"chr1","79707021","79707313","GL873547","2222074","2222356","78","77484947"
"chr1","80493355","80493645","GL873607","1418062","1418355","100","79075293"
"chr1","80644072","80644378","GL873541","16268070","16268366","95","64376002"
"chr1","80729590","80729904","GL873541","16268070","16268366","115","64461520"
"chr1","81475649","81475939","GL873530","16647228","16647517","91","64828421"
"chr1","81771309","81771421","GL873587","10002051","10002151","40","71769258"
"chr1","82406258","82406566","GL873541","16268070","16268366","101","66138188"
"chr1","82778210","82778474","GL873659","913070","913333","103","81865140"
"chr1","82778475","82778604","GL873550","5998776","5998900","40","76779699"
"chr1","83212418","83212718","GL873752","427788","428097","92","82784630"
"chr1","83241401","83241681","GL873547","2222074","2222356","86","81019327"
"chr1","84078127","84078396","GL873680","3005257","3005482","91","81072870"
"chr1","84581325","84581595","GL873565","12307556","12307825","96","72273769"
"chr1","84642400","84642694","GL873547","2222074","2222356","79","82420326"
"chr1","84644303","84644440","GL873529","2453810","2453957","60","82190493"
"chr1","84961868","84962156","GL873547","2222074","2222356","94","82739794"
"chr1","84971033","84971323","GL873547","2222074","2222356","81","82748959"
"chr1","85324611","85324884","GL873547","2222074","2222356","92","83102537"
"chr1","85717191","85717455","GL873659","913070","913333","99","84804121"
"chr1","86467570","86467849","GL873547","2222074","2222356","96","84245496"
"chr1","86920138","86920446","GL873541","16268070","16268366","101","70652068"
"chr1","87321652","87321963","GL873541","16268070","16268366","91","71053582"
"chr1","89061601","89061890","GL873530","16647228","16647517","82","72414373"
"chr1","89781597","89781911","GL873528","36697151","36697434","93","53084446"
"chr1","89981933","89982205","GL873680","3005257","3005482","89","86976676"
"chr1","90666375","90666673","GL873541","16268070","16268366","85","74398305"
"chr1","93017942","93018239","GL873530","16647228","16647517","86","76370714"
"chr1","93207858","93208126","GL873565","12307556","12307825","94","80900302"
"chr1","93636747","93637027","GL873547","2222074","2222356","86","91414673"
"chr1","93684906","93685203","GL873608","6630366","6630673","84","87054540"
"chr1","93797372","93797669","GL873547","2222074","2222356","85","91575298"
"chr1","94293794","94293836","GL873691","2903502","2903535","23","91390292"
"chr1","94449783","94450074","GL873547","2222074","2222356","79","92227709"
"chr1","94481618","94481900","GL873528","36697151","36697434","92","57784467"
"chr1","94563215","94563485","GL873659","913070","913333","88","93650145"
"chr1","97251820","97252124","GL873541","16268070","16268366","82","80983750"
"chr1","98693974","98694233","GL873659","913070","913333","93","97780904"
"chr1","98859957","98860273","GL873528","36697151","36697434","96","62162806"
"chr1","98960303","98960603","GL873541","16268070","16268366","79","82692233"
"chr1","99010740","99011053","GL873530","16647228","16647517","95","82363512"
"chr1","99121590","99121880","GL873607","1418062","1418355","94","97703528"
"chr1","99215117","99215253","GL873550","5998776","5998900","43","93216341"
"chr1","99228374","99228543","GL873530","5593486","5593649","44","93634888"
"chr1","99995650","99995808","GL873611","3799989","3800137","53","96195661"
"chr1","100637811","100638119","GL873530","16647228","16647517","91","83990583"
"chr1","101377877","101378171","GL873547","2222074","2222356","79","99155803"
"chr1","101516444","101516734","GL873530","16647228","16647517","85","84869216"
"chr1","101573986","101574156","GL873585","9209559","9209725","52","92364427"
"chr1","101591751","101591871","GL873587","10002051","10002151","49","91589700"
"chr1","102600458","102600751","GL873547","2222074","2222356","88","100378384"
"chr1","102867195","102867490","GL873530","16647228","16647517","87","86219967"
"chr1","103001759","103002077","GL873541","16268070","16268366","101","86733689"
"chr1","103446520","103446822","GL873541","16268070","16268366","78","87178450"
"chr1","103457985","103458293","GL873607","1418062","1418355","91","102039923"
"chr1","104470958","104471266","GL873541","16268070","16268366","91","88202888"
"chr1","104562716","104563010","GL873547","2222074","2222356","84","102340642"
"chr1","104868341","104868632","GL873547","2222074","2222356","80","102646267"
"chr1","105084599","105084898","GL873607","1418062","1418355","83","103666537"
"chr1","105107738","105107949","GL873531","3555300","3555500","71","101552438"
"chr1","106079163","106079424","GL873528","25203621","25203847","90","80875542"
"chr1","106185361","106185647","GL873547","2222074","2222356","88","103963287"
"chr1","106576923","106577226","GL873541","16268070","16268366","82","90308853"
"chr1","106771173","106771469","GL873607","1418062","1418355","91","105353111"
"chr1","106862023","106862331","GL873541","16268070","16268366","96","90593953"
"chr1","106959839","106960069","GL873680","3005257","3005482","69","103954582"
"chr1","107134266","107134447","GL873530","5593486","5593649","53","101540780"
"chr1","107553578","107553909","GL873541","16268070","16268366","125","91285508"
"chr1","108232344","108232644","GL873547","2222074","2222356","85","106010270"
"chr1","108300659","108300949","GL873541","16268070","16268366","85","92032589"
"chr1","108391842","108392049","GL873697","3111225","3111427","58","105280617"
"chr1","108478581","108478891","GL873530","16647228","16647517","95","91831353"
"chr1","108497843","108498144","GL873541","16268070","16268366","85","92229773"
"chr1","108537320","108537632","GL873528","36697151","36697434","95","71840169"
"chr1","108598109","108598405","GL873547","2222074","2222356","86","106376035"
"chr1","108655903","108656196","GL873530","16647228","16647517","83","92008675"
"chr1","108685785","108686085","GL873541","16268070","16268366","79","92417715"
"chr1","109790831","109791123","GL873530","16647228","16647517","82","93143603"
"chr1","109836504","109836802","GL873541","16268070","16268366","87","93568434"
"chr1","109924260","109924555","GL873607","1418062","1418355","85","108506198"
"chr1","109936724","109937027","GL873528","36697151","36697434","90","73239573"
"chr1","110010130","110010435","GL873541","16268070","16268366","94","93742060"
"chr1","110069942","110070217","GL873562","3299887","3300144","82","106770055"
"chr1","110070240","110070388","GL873550","5998776","5998900","49","104071464"
"chr1","110114606","110114888","GL873547","2222074","2222356","89","107892532"
"chr1","110201575","110201864","GL873547","2222074","2222356","91","107979501"
"chr1","110215983","110216163","GL873527","37742145","37742300","61","72473838"
"chr1","110317100","110317399","GL873541","16268070","16268366","94","94049030"
"chr1","110377684","110377975","GL873530","16647228","16647517","81","93730456"
"chr1","110773079","110773145","GL873554","10500008","10500061","22","100273071"
"chr1","111061341","111061624","GL873547","2222074","2222356","88","108839267"
"chr1","111196741","111196824","GL873643","6205658","6205743","39","104991083"
"chr1","111196822","111196945","GL873622","7076274","7076365","53","104120548"
"chr1","111610052","111610341","GL873530","16647228","16647517","88","94962824"
"chr1","111740704","111741003","GL873541","16268070","16268366","77","95472634"
"chr1","112155935","112156212","GL873562","3299887","3300144","87","108856048"
"chr1","112610540","112610791","GL873680","3005257","3005482","89","109605283"
"chr1","112862393","112862695","GL873541","16268070","16268366","89","96594323"
"chr1","112885529","112885826","GL873608","6630366","6630673","85","106255163"
"chr1","112893855","112893969","GL873587","10002051","10002151","41","102891804"
"chr1","112929344","112929645","GL873541","16268070","16268366","87","96661274"
"chr1","113156150","113156398","GL873557","3858721","3858924","89","109297429"
"chr1","113325394","113325698","GL873541","16268070","16268366","82","97057324"
"chr1","113504457","113504743","GL873530","16647228","16647517","87","96857229"
"chr1","113701331","113701623","GL873659","913070","913333","92","112788261"
"chr1","113921523","113921820","GL873541","16268070","16268366","79","97653453"
"chr1","114033894","114034193","GL873547","2222074","2222356","84","111811820"
"chr1","114383689","114383989","GL873541","16268070","16268366","89","98115619"
"chr1","114482348","114482630","GL873547","2222074","2222356","82","112260274"
"chr1","114482634","114482933","GL873547","2222074","2222356","91","112260560"
"chr1","114796555","114796864","GL873541","16268070","16268366","88","98528485"
"chr1","114835639","114835962","GL873541","16268070","16268366","106","98567569"
"chr1","114922378","114922500","GL873622","7076274","7076365","47","107846104"
"chr1","115101604","115101892","GL873541","16268070","16268366","97","98833534"
"chr1","115936272","115936491","GL873680","3005257","3005482","73","112931015"
"chr1","116702652","116702933","GL873547","2222074","2222356","88","114480578"
"chr1","117026263","117026426","GL873541","1550303","1550443","58","115475960"
"chr1","117411082","117411394","GL873607","1418062","1418355","93","115993020"
"chr1","117467462","117467775","GL873608","6630366","6630673","90","110837096"
"chr1","117515422","117515718","GL873541","16268070","16268366","103","101247352"
"chr1","117571736","117572044","GL873541","16268070","16268366","93","101303666"
"chr1","117659829","117660135","GL873541","16268070","16268366","94","101391759"
"chr1","117954305","117954603","GL873541","16268070","16268366","92","101686235"
"chr1","119205630","119205915","GL873547","2222074","2222356","91","116983556"
"chr1","119206012","119206024","GL873691","2903502","2903535","22","116302510"
"chr1","119397052","119397342","GL873528","36697151","36697434","99","82699901"
"chr1","120017858","120018145","GL873541","16268070","16268366","95","103749788"
"chr1","120476004","120476295","GL873541","16268070","16268366","87","104207934"
"chr1","120558770","120559064","GL873541","16268070","16268366","84","104290700"
"chr1","120796869","120797167","GL873530","16647228","16647517","78","104149641"
"chr1","120828578","120828903","GL873608","6630366","6630673","96","114198212"
"chr1","121229121","121229428","GL873541","16268070","16268366","92","104961051"
"chr1","121387173","121387472","GL873530","16647228","16647517","101","104739945"
"chr1","122078820","122079044","GL873625","6060130","6060345","67","116018690"
"chr1","122227386","122227685","GL873530","16647228","16647517","97","105580158"
"chr1","122551837","122552126","GL873608","6630366","6630673","87","115921471"
"chr1","122586994","122587271","GL873562","3299887","3300144","90","119287107"
"chr1","122670348","122670644","GL873547","2222074","2222356","86","120448274"
"chr1","122978514","122978847","GL873607","1418062","1418355","122","121560452"
"chr1","123688344","123688484","GL873529","2453810","2453957","58","121234534"
"chr1","123915771","123915811","GL873691","2903502","2903535","12","121012269"
"chr1","123952715","123953023","GL873528","36697151","36697434","101","87255564"
"chr1","124050303","124050454","GL873550","5998776","5998900","56","118051527"
"chr1","124050496","124050647","GL873619","2497092","2497229","58","121553404"
"chr1","124153480","124153811","GL873547","2222074","2222356","112","121931406"
"chr1","124161627","124161932","GL873541","16268070","16268366","91","107893557"
"chr1","124889574","124889841","GL873680","3005257","3005482","93","121884317"
"chr1","125024996","125025302","GL873541","16268070","16268366","83","108756926"
"chr1","125539185","125539461","GL873659","913070","913333","91","124626115"
"chr1","125540644","125540920","GL873659","913070","913333","91","124627574"
"chr2","201326","201639","GL873541","16268070","16268366","95","16066744"
"chr2","313678","313866","GL873521","1458597","1458764","53","1144919"
"chr2","499327","499617","GL873530","16647228","16647517","81","16147901"
"chr2","1066142","1066417","GL873547","2222074","2222356","85","1155932"
"chr2","1356667","1356900","GL873528","25203621","25203847","82","23846954"
"chr2","1554332","1554443","GL873622","7076274","7076365","41","5521942"
"chr2","1991028","1991334","GL873541","16268070","16268366","88","14277042"
"chr2","2127280","2127583","GL873607","1418062","1418355","93","709218"
"chr2","2422785","2423088","GL873528","36697151","36697434","91","34274366"
"chr2","3129696","3130003","GL873608","6630366","6630673","94","3500670"
"chr2","3799077","3799394","GL873608","6630366","6630673","102","2831289"
"chr2","4550329","4550583","GL873528","25203621","25203847","89","20653292"
"chr2","4709136","4709412","GL873562","3299887","3300144","89","1409249"
"chr2","4976621","4976741","GL873552","12711845","12711956","45","7735224"
"chr2","5238241","5238519","GL873562","3299887","3300144","83","1938354"
"chr2","5560803","5561086","GL873541","16268070","16268366","95","10707267"
"chr2","5724032","5724228","GL873535","24407607","24407780","55","18683575"
"chr2","6238770","6239073","GL873530","16647228","16647517","92","10408458"
"chr2","6749911","6750206","GL873667","4451263","4451534","92","2298648"
"chr2","6803049","6803335","GL873547","2222074","2222356","76","4580975"
"chr2","7233653","7233960","GL873541","16268070","16268366","94","9034417"
"chr2","7363281","7363456","GL873530","5593486","5593649","53","1769795"
"chr2","7504886","7505196","GL873547","2222074","2222356","96","5282812"
"chr2","7577214","7577318","GL873526","41480965","41481045","38","33903751"
"chr2","7577624","7577697","GL873521","9884269","9884347","29","2306645"
"chr2","7593632","7593755","GL873552","12711845","12711956","50","5118213"
"chr2","7687079","7687401","GL873608","6630366","6630673","99","1056713"
"chr2","7721210","7721494","GL873530","16647228","16647517","86","8926018"
"chr2","7727690","7727993","GL873530","16647228","16647517","92","8919538"
"chr2","8823834","8824133","GL873812","559768","560073","113","8264066"
"chr2","9139853","9140140","GL873528","36697151","36697434","99","27557298"
"chr2","9615696","9615984","GL873547","2222074","2222356","89","7393622"
"chr2","10270080","10270351","GL873562","3299887","3300144","90","6970193"
"chr2","10339052","10339336","GL873547","2222074","2222356","87","8116978"
"chr2","10369127","10369438","GL873541","16268070","16268366","92","5898943"
"chr2","10557335","10557628","GL873547","2222074","2222356","78","8335261"
"chr2","10875291","10875598","GL873541","16268070","16268366","82","5392779"
"chr2","11078883","11079185","GL873541","16268070","16268366","82","5189187"
"chr2","11271756","11272045","GL873530","16647228","16647517","83","5375472"
"chr2","11465611","11465929","GL873608","6630366","6630673","96","4835245"
"chr2","11892453","11892737","GL873541","16268070","16268366","94","4375617"
"chr2","11941673","11941971","GL873608","6630366","6630673","88","5311307"
"chr2","11956421","11956671","GL873680","3005257","3005482","81","8951164"
"chr2","12016761","12017041","GL873528","36697151","36697434","95","24680390"
"chr2","12031294","12031409","GL873587","10002051","10002151","45","2029243"
"chr2","12062172","12062451","GL873547","2222074","2222356","86","9840098"
"chr2","12068141","12068435","GL873541","16268070","16268366","85","4199929"
"chr2","12094825","12095113","GL873530","16647228","16647517","90","4552403"
"chr2","12099007","12099299","GL873528","36697151","36697434","95","24598144"
"chr2","12229035","12229246","GL873531","3555300","3555500","65","8673735"
"chr2","12277309","12277609","GL873541","16268070","16268366","86","3990761"
"chr2","12327184","12327443","GL873680","3005257","3005482","92","9321927"
"chr2","12745355","12745631","GL873547","2222074","2222356","93","10523281"
"chr2","13048439","13048721","GL873541","16268070","16268366","88","3219631"
"chr2","13154797","13154910","GL873622","7076274","7076365","36","6078523"
"chr2","13316902","13317112","GL873531","3555300","3555500","64","9761602"
"chr2","13376263","13376578","GL873528","36697151","36697434","99","23320888"
"chr2","13470021","13470309","GL873667","4451263","4451534","86","9018758"
"chr2","13869990","13870296","GL873541","16268070","16268366","95","2398080"
"chr2","13964815","13965120","GL873541","16268070","16268366","95","2303255"
"chr2","14061215","14061443","GL873680","3005257","3005482","73","11055958"
"chr2","14267810","14267928","GL873622","7076274","7076365","43","7191536"
"chr2","14656862","14657036","GL873529","2453810","2453957","66","12203052"
"chr2","14763961","14764264","GL873541","16268070","16268366","90","1504109"
"chr2","14829712","14830008","GL873530","16647228","16647517","92","1817516"
"chr2","14848640","14848936","GL873547","2222074","2222356","83","12626566"
"chr2","14953819","14954119","GL873541","16268070","16268366","80","1314251"
"chr2","15018674","15018965","GL873547","2222074","2222356","83","12796600"
"chr2","15099785","15100094","GL873541","16268070","16268366","92","1168285"
"chr2","15866953","15867257","GL873607","1418062","1418355","98","14448891"
"chr2","16303035","16303338","GL873541","16268070","16268366","98","34965"
"chr2","16354446","16354549","GL873643","6205658","6205743","46","10148788"
"chr2","16420377","16420670","GL873530","16647228","16647517","80","226851"
"chr2","16490472","16490777","GL873607","1418062","1418355","93","15072410"
"chr2","16628919","16629201","GL873547","2222074","2222356","85","14406845"
"chr2","17423179","17423489","GL873541","16268070","16268366","95","1155109"
"chr2","17881225","17881532","GL873541","16268070","16268366","88","1613155"
"chr2","17964279","17964583","GL873541","16268070","16268366","87","1696209"
"chr2","18115940","18116064","GL873587","10002051","10002151","50","8113889"
"chr2","18228939","18229246","GL873541","16268070","16268366","92","1960869"
"chr2","18516475","18516643","GL873530","5593486","5593649","55","12922989"
"chr2","18738978","18739284","GL873541","16268070","16268366","91","2470908"
"chr2","19330470","19330726","GL873547","2222074","2222356","93","17108396"
"chr2","19488342","19488513","GL873560","5855436","5855580","62","13632906"
"chr2","19488516","19488687","GL873530","5593486","5593649","54","13895030"
"chr2","20173547","20173802","GL873543","13038674","13038909","87","7134873"
"chr2","20205590","20205884","GL873530","16647228","16647517","88","3558362"
"chr2","20258865","20259070","GL873630","2508568","2508753","68","17750297"
"chr2","20475768","20476080","GL873530","16647228","16647517","97","3828540"
"chr2","20863548","20863834","GL873547","2222074","2222356","90","18641474"
"chr2","20882482","20882766","GL873607","1418062","1418355","89","19464420"
"chr2","21148444","21148739","GL873530","16647228","16647517","82","4501216"
"chr2","21232084","21232379","GL873530","16647228","16647517","84","4584856"
"chr2","21653453","21653734","GL873547","2222074","2222356","86","19431379"
"chr2","21913107","21913421","GL873541","16268070","16268366","100","5645037"
"chr2","22096502","22096602","GL873587","10002051","10002151","32","12094451"
"chr2","22498222","22498473","GL873535","4830564","4830824","89","17667658"
"chr2","22686656","22686932","GL873530","16647228","16647517","91","6039428"
"chr2","22763066","22763371","GL873541","16268070","16268366","88","6494996"
"chr2","22860155","22860456","GL873541","16268070","16268366","87","6592085"
"chr2","23207246","23207530","GL873528","36697151","36697434","90","13489905"
"chr2","23799581","23799880","GL873541","16268070","16268366","87","7531511"
"chr2","24016767","24017061","GL873607","1418062","1418355","86","22598705"
"chr2","25020464","25020568","GL873524","43272658","43272747","50","18252194"
"chr2","25020841","25020984","GL873550","5998776","5998900","47","19022065"
"chr2","25267364","25267665","GL873541","16268070","16268366","94","8999294"
"chr2","25341460","25341756","GL873530","16647228","16647517","93","8694232"
"chr2","25395451","25395747","GL873530","16647228","16647517","82","8748223"
"chr2","25629978","25630164","GL873524","42560728","42560902","55","16930750"
"chr2","25630213","25630417","GL873558","7532067","7532273","50","18098146"
"chr2","26081597","26081888","GL873607","1418062","1418355","94","24663535"
"chr2","26376276","26376553","GL873667","4451263","4451534","90","21925013"
"chr2","26528623","26528910","GL873528","36697151","36697434","86","10168528"
"chr2","27301273","27301513","GL873640","6426205","6426399","92","20875068"
"chr2","27449856","27450162","GL873541","16268070","16268366","83","11181786"
"chr2","28886041","28886224","GL874079","15836","16035","59","28870205"
"chr2","28924967","28925242","GL873680","3005257","3005482","101","25919710"
"chr2","29171160","29171476","GL873528","36697151","36697434","97","7525991"
"chr2","29575503","29575809","GL873541","16268070","16268366","91","13307433"
"chr2","30454897","30455000","GL873546","7627047","7627148","46","22827850"
"chr2","30859594","30859892","GL873547","2222074","2222356","86","28637520"
"chr2","31673396","31673700","GL873528","36697151","36697434","95","5023755"
"chr2","31762511","31762800","GL873547","2222074","2222356","85","29540437"
"chr2","32023937","32024233","GL873547","2222074","2222356","81","29801863"
"chr2","32184528","32184666","GL873622","7076274","7076365","64","25108254"
"chr2","32385695","32385901","GL873558","7532067","7532273","56","24853628"
"chr2","32487196","32487486","GL873530","16647228","16647517","89","15839968"
"chr2","32652390","32652683","GL873528","36697151","36697434","88","4044761"
"chr2","32956895","32957194","GL873541","16268070","16268366","87","16688825"
"chr2","33016289","33016582","GL873547","2222074","2222356","87","30794215"
"chr2","33070354","33070635","GL873667","4451263","4451534","84","28619091"
"chr2","33075526","33075826","GL873541","16268070","16268366","86","16807456"
"chr2","33108990","33109245","GL873543","13038674","13038909","94","20070316"
"chr2","33183923","33184074","GL873541","1550303","1550443","50","31633620"
"chr2","33362197","33362503","GL873528","36697151","36697434","81","3334954"
"chr2","33541511","33541824","GL873547","2222074","2222356","97","31319437"
"chr2","33707250","33707543","GL873659","913070","913333","84","32794180"
"chr2","33804259","33804558","GL873541","16268070","16268366","92","17536189"
"chr2","34482356","34482663","GL873541","16268070","16268366","89","18214286"
"chr2","34494066","34494356","GL873530","16647228","16647517","80","17846838"
"chr2","34532527","34532825","GL873547","2222074","2222356","86","32310453"
"chr2","34676186","34676487","GL873530","16647228","16647517","87","18028958"
"chr2","34764440","34764750","GL873541","16268070","16268366","91","18496370"
"chr2","34831793","34832095","GL873541","16268070","16268366","85","18563723"
"chr2","34904629","34904927","GL873528","36697151","36697434","98","1792522"
"chr2","35606219","35606479","GL873562","3299887","3300144","86","32306332"
"chr2","35628252","35628546","GL873547","2222074","2222356","82","33406178"
"chr2","35981314","35981608","GL873530","16647228","16647517","75","19334086"
"chr2","35995833","35996141","GL873607","1418062","1418355","89","34577771"
"chr2","36005066","36005257","GL873530","5593486","5593649","60","30411580"
"chr2","36039113","36039395","GL873530","16647228","16647517","83","19391885"
"chr2","36086667","36086826","GL873530","5593486","5593649","44","30493181"
"chr2","36155382","36155672","GL873547","2222074","2222356","91","33933308"
"chr2","36642349","36642638","GL873530","16647228","16647517","86","19995121"
"chr2","36659699","36659910","GL873625","6060130","6060345","53","30599569"
"chr2","37089057","37089357","GL873528","36697151","36697434","94","391906"
"chr2","37265929","37266230","GL873541","16268070","16268366","92","20997859"
"chr2","37372792","37373072","GL873562","3299887","3300144","85","34072905"
"chr2","37474857","37475158","GL873541","16268070","16268366","86","21206787"
"chr2","37531355","37531649","GL873541","16268070","16268366","88","21263285"
"chr2","37710707","37710833","GL873550","5998776","5998900","35","31711931"
"chr2","37782743","37782903","GL873530","5593486","5593649","40","32189257"
"chr2","37861699","37861799","GL873524","43272658","43272747","39","5410959"
"chr2","37889377","37889595","GL873531","3555300","3555500","81","34334077"
"chr2","37911703","37911992","GL873547","2222074","2222356","81","35689629"
"chr2","38014360","38014507","GL873550","5998776","5998900","52","32015584"
"chr2","38442624","38442927","GL873541","16268070","16268366","89","22174554"
"chr2","38500160","38500459","GL873541","16268070","16268366","83","22232090"
"chr2","38540030","38540323","GL873547","2222074","2222356","77","36317956"
"chr2","38673458","38673740","GL873562","3299887","3300144","92","35373571"
"chr2","38677111","38677407","GL873530","16647228","16647517","84","22029883"
"chr2","38816251","38816554","GL873608","6630366","6630673","92","32185885"
"chr2","38886585","38886848","GL873680","3005257","3005482","91","35881328"
"chr2","38953517","38953810","GL873547","2222074","2222356","78","36731443"
"chr2","38962090","38962387","GL873752","427788","428097","85","38534302"
"chr2","40676301","40676592","GL873541","16268070","16268366","86","24408231"
"chr2","41618586","41618908","GL873528","36697151","36697434","100","4921435"
"chr2","42406046","42406352","GL873607","1418062","1418355","87","40987984"
"chr2","42519286","42519394","GL873587","10002051","10002151","40","32517235"
"chr2","42758401","42758709","GL873541","16268070","16268366","83","26490331"
"chr2","42862488","42862793","GL873541","16268070","16268366","91","26594418"
"chr2","43159394","43159686","GL873530","16647228","16647517","81","26512166"
"chr2","43165239","43165543","GL873530","16647228","16647517","86","26518011"
"chr2","43519972","43520283","GL873541","16268070","16268366","95","27251902"
"chr2","43916943","43917252","GL873541","16268070","16268366","93","27648873"
"chr2","44451176","44451458","GL873530","16647228","16647517","79","27803948"
"chr2","45141571","45141868","GL873541","16268070","16268366","85","28873501"
"chr2","45153479","45153780","GL873541","16268070","16268366","85","28885409"
"chr2","46730058","46730278","GL873531","3555300","3555500","70","43174758"
"chr2","47166434","47166744","GL873541","16268070","16268366","96","30898364"
"chr2","47277038","47277305","GL873547","5449763","5449997","98","41827275"
"chr2","47485248","47485546","GL873541","16268070","16268366","79","31217178"
"chr2","47509921","47510201","GL873547","2222074","2222356","84","45287847"
"chr2","47624112","47624409","GL873541","16268070","16268366","84","31356042"
"chr2","48284907","48285200","GL873530","16647228","16647517","85","31637679"
"chr2","48470866","48471168","GL873541","16268070","16268366","89","32202796"
"chr2","48815725","48815824","GL873524","43272658","43272747","33","5543067"
"chr2","49133313","49133623","GL873541","16268070","16268366","84","32865243"
"chr2","50460100","50460401","GL873541","16268070","16268366","88","34192030"
"chr2","51179671","51179972","GL873541","16268070","16268366","87","34911601"
"chr2","51353946","51354056","GL873550","5998776","5998900","45","45355170"
"chr2","51487811","51488079","GL873680","3005257","3005482","94","48482554"
"chr2","51926965","51927264","GL873547","2222074","2222356","92","49704891"
"chr2","52457627","52457845","GL873557","3858721","3858924","69","48598906"
"chr2","53896143","53896442","GL873541","16268070","16268366","91","37628073"
"chr2","54312462","54312771","GL873528","36697151","36697434","87","17615311"
"chr2","55098978","55099287","GL873528","36697151","36697434","96","18401827"
"chr2","55278122","55278418","GL873547","2222074","2222356","92","53056048"
"chr2","55776820","55777113","GL873547","2222074","2222356","90","53554746"
"chr2","56072846","56073138","GL873547","2222074","2222356","84","53850772"
"chr2","56304243","56304415","GL873530","5593486","5593649","52","50710757"
"chr2","56321978","56322246","GL873547","5449763","5449997","89","50872215"
"chr2","56439278","56439567","GL873530","16647228","16647517","80","39792050"
"chr2","56535195","56535481","GL873547","2222074","2222356","78","54313121"
"chr2","56682841","56683139","GL873547","2222074","2222356","88","54460767"
"chr2","56770497","56770741","GL873680","3005257","3005482","77","53765240"
"chr2","57090491","57090774","GL873562","3299887","3300144","91","53790604"
"chr2","57178242","57178539","GL873607","1418062","1418355","93","55760180"
"chr2","57179081","57179370","GL873547","2222074","2222356","86","54957007"
"chr2","57300310","57300610","GL873541","16268070","16268366","92","41032240"
"chr2","57324560","57324855","GL873547","2222074","2222356","80","55102486"
"chr2","57442491","57442792","GL873541","16268070","16268366","93","41174421"
"chr2","58132919","58133197","GL873565","12307556","12307825","87","45825363"
"chr2","58880536","58880834","GL873541","16268070","16268366","87","42612466"
"chr2","59602741","59603032","GL873547","2222074","2222356","77","57380667"
"chr2","59673149","59673450","GL873528","36697151","36697434","88","22975998"
"chr2","60035684","60035992","GL873530","16647228","16647517","94","43388456"
"chr2","60044452","60044731","GL873547","2222074","2222356","82","57822378"
"chr2","60076736","60077043","GL873530","16647228","16647517","94","43429508"
"chr2","60377784","60378082","GL873667","4451263","4451534","91","55926521"
"chr2","60482424","60482723","GL873547","2222074","2222356","91","58260350"
"chr2","60488088","60488342","GL873680","3005257","3005482","82","57482831"
"chr2","60596700","60596797","GL873524","43272658","43272747","38","17324042"
"chr2","60614842","60615123","GL873547","2222074","2222356","87","58392768"
"chr2","60917282","60917576","GL873530","16647228","16647517","86","44270054"
"chr2","61035797","61036096","GL873541","16268070","16268366","82","44767727"
"chr2","61077485","61077788","GL873541","16268070","16268366","85","44809415"
"chr2","61082854","61083126","GL873547","2222074","2222356","96","58860780"
"chr2","61248634","61248935","GL873541","16268070","16268366","88","44980564"
"chr2","61587057","61587366","GL873608","6630366","6630673","95","54956691"
"chr2","62123204","62123503","GL873530","16647228","16647517","88","45475976"
"chr2","62455607","62455904","GL873541","16268070","16268366","102","46187537"
"chr2","62653856","62654177","GL873528","36697151","36697434","104","25956705"
"chr2","62763587","62763877","GL873530","16647228","16647517","85","46116359"
"chr2","62954520","62954811","GL873752","427788","428097","85","62526732"
"chr2","63072225","63072522","GL873565","12307556","12307825","95","50764669"
"chr2","63172174","63172281","GL873622","7076274","7076365","35","56095900"
"chr2","63201658","63201876","GL873557","3858721","3858924","70","59342937"
"chr2","63398108","63398331","GL873531","3555300","3555500","73","59842808"
"chr2","63761420","63761716","GL873547","2222074","2222356","84","61539346"
"chr2","63906412","63906704","GL873541","16268070","16268366","86","47638342"
"chr2","64407922","64408226","GL873528","36697151","36697434","94","27710771"
"chr2","64489411","64489719","GL873541","16268070","16268366","87","48221341"
"chr2","64905517","64905799","GL873607","1418062","1418355","92","63487455"
"chr2","65450198","65450327","GL873622","7076274","7076365","55","58373924"
"chr2","65988272","65988503","GL873557","3858721","3858924","76","62129551"
"chr2","66145819","66146129","GL873541","16268070","16268366","93","49877749"
"chr2","66197208","66197368","GL873585","9209559","9209725","58","56987649"
"chr2","66275098","66275390","GL873541","16268070","16268366","84","50007028"
"chr2","66559968","66560273","GL873541","16268070","16268366","88","50291898"
"chr2","66937766","66938027","GL873547","5449763","5449997","92","61488003"
"chr2","67590959","67591254","GL873541","16268070","16268366","92","51322889"
"chr2","68536270","68536565","GL873528","36697151","36697434","87","31839119"
"chr2","68587842","68588180","GL873541","16268070","16268366","115","52319772"
"chr2","68873500","68873683","GL873521","1458597","1458764","61","67414903"
"chr2","68949142","68949439","GL873547","2222074","2222356","88","66727068"
"chr2","69175527","69175812","GL873547","2222074","2222356","85","66953453"
"chr2","70699454","70699583","GL873550","5998776","5998900","53","64700678"
"chr2","71291805","71292108","GL873528","36697151","36697434","92","34594654"
"chr2","71625140","71625445","GL873541","16268070","16268366","88","55357070"
"chr2","71646286","71646551","GL873667","4451263","4451534","94","67195023"
"chr2","72053518","72053810","GL873547","2222074","2222356","94","69831444"
"chr2","72075917","72076212","GL873541","16268070","16268366","91","55807847"
"chr2","72579806","72580084","GL873565","12307556","12307825","97","60272250"
"chr2","73174593","73174882","GL873541","16268070","16268366","103","56906523"
"chr2","73702314","73702622","GL873528","36697151","36697434","103","37005163"
"chr2","74004467","74004653","GL873521","1458597","1458764","73","72545870"
"chr2","74710313","74710618","GL873528","36697151","36697434","90","38013162"
"chr2","75072072","75072198","GL873619","2497092","2497229","55","72574980"
"chr2","75079791","75080041","GL873538","2567037","2567262","95","72512754"
"chr2","75560964","75561267","GL873541","16268070","16268366","87","59292894"
"chr2","75600430","75600728","GL873541","16268070","16268366","83","59332360"
"chr2","77531718","77532009","GL873547","2222074","2222356","87","75309644"
"chr2","78310154","78310445","GL873541","16268070","16268366","89","62042084"
"chr2","78874579","78874878","GL873547","2222074","2222356","91","76652505"
"chr2","80207037","80207332","GL873530","16647228","16647517","84","63559809"
"chr2","80207342","80207643","GL873528","36697151","36697434","93","43510191"
"chr2","80227980","80228270","GL873547","2222074","2222356","76","78005906"
"chr2","80287194","80287488","GL873547","2222074","2222356","88","78065120"
"chr2","80337518","80337819","GL873541","16268070","16268366","92","64069448"
"chr2","80347966","80348251","GL873541","16268070","16268366","89","64079896"
"chr2","80417312","80417598","GL873547","2222074","2222356","80","78195238"
"chr2","80503770","80504077","GL873541","16268070","16268366","96","64235700"
"chr2","80562522","80562815","GL873528","36697151","36697434","93","43865371"
"chr2","81109541","81109824","GL873547","2222074","2222356","90","78887467"
"chr2","81887439","81887738","GL873541","16268070","16268366","91","65619369"
"chr2","82901304","82901603","GL873541","16268070","16268366","82","66633234"
"chr2","83534299","83534610","GL873541","16268070","16268366","93","67266229"
"chr2","83680043","83680349","GL873541","16268070","16268366","93","67411973"
"chr2","84188640","84188920","GL873562","3299887","3300144","86","80888753"
"chr2","84330949","84331232","GL873530","16647228","16647517","91","67683721"
"chr2","84407708","84407986","GL873547","2222074","2222356","87","82185634"
"chr2","84532991","84533282","GL873565","12307556","12307825","95","72225435"
"chr2","84553599","84553896","GL873530","16647228","16647517","81","67906371"
"chr2","84708126","84708397","GL873680","3005257","3005482","95","81702869"
"chr2","84758685","84758786","GL873587","10002051","10002151","29","74756634"
"chr2","85363437","85363750","GL873528","36697151","36697434","97","48666286"
"chr2","85366952","85367170","GL873538","2567037","2567262","77","82799915"
"chr2","86153898","86154193","GL873541","16268070","16268366","74","69885828"
"chr2","86184084","86184387","GL873530","16647228","16647517","98","69536856"
"chr2","86745912","86746147","GL873680","3005257","3005482","66","83740655"
"chr2","86879795","86880085","GL873541","16268070","16268366","84","70611725"
"chr2","87262500","87262610","GL873587","10002051","10002151","44","77260449"
"chr2","87596117","87596251","GL873550","5998776","5998900","53","81597341"
"chr2","87793122","87793434","GL873541","16268070","16268366","95","71525052"
"chr2","87954053","87954315","GL873562","3299887","3300144","85","84654166"
"chr2","88281672","88281971","GL873541","16268070","16268366","89","72013602"
"chr2","88587431","88587729","GL873541","16268070","16268366","85","72319361"
"chr2","88624954","88625246","GL873530","16647228","16647517","81","71977726"
"chr2","89657258","89657531","GL873528","36697151","36697434","94","52960107"
"chr2","89875723","89876040","GL873541","16268070","16268366","91","73607653"
"chr2","89878041","89878342","GL873530","16647228","16647517","84","73230813"
"chr2","89933012","89933180","GL873530","5593486","5593649","56","84339526"
"chr2","89947260","89947394","GL873550","5998776","5998900","40","83948484"
"chr2","90007462","90007528","GL873554","10500008","10500061","24","79507454"
"chr3","83514","83868","GL873608","6630366","6630673","125","6546852"
"chr3","160895","161193","GL873541","16268070","16268366","87","16107175"
"chr3","187105","187248","GL873619","2497092","2497229","49","2309987"
"chr3","236200","236464","GL873659","913070","913333","97","676870"
"chr3","465439","465676","GL873531","3555300","3555500","76","3089861"
"chr3","550166","550467","GL873528","36697151","36697434","91","36146985"
"chr3","955871","956176","GL873541","16268070","16268366","97","15312199"
"chr3","1027313","1027609","GL873541","16268070","16268366","80","15240757"
"chr3","1042702","1042991","GL873541","16268070","16268366","85","15225368"
"chr3","1140844","1141149","GL873607","1418062","1418355","94","277218"
"chr3","1157862","1158136","GL873659","913070","913333","95","244792"
"chr3","1161792","1161901","GL873764","716399","716485","43","445393"
"chr3","1167554","1167585","GL873691","2903502","2903535","10","1735948"
"chr3","1524101","1524380","GL873562","3299887","3300144","89","1775786"
"chr3","2750641","2750933","GL873547","2222074","2222356","86","528567"
"chr3","2756529","2756821","GL873547","2222074","2222356","85","534455"
"chr3","3394481","3394641","GL873530","5593486","5593649","55","2199005"
"chr3","3986658","3986959","GL873541","16268070","16268366","91","12281412"
"chr3","4134949","4135250","GL873608","6630366","6630673","91","2495417"
"chr3","4293091","4293398","GL873541","16268070","16268366","92","11974979"
"chr3","4648816","4649103","GL873530","16647228","16647517","78","11998412"
"chr3","4720558","4720866","GL873541","16268070","16268366","95","11547512"
"chr3","4974321","4974606","GL873530","16647228","16647517","89","11672907"
"chr3","5382081","5382368","GL873547","2222074","2222356","84","3160007"
"chr3","6022508","6022797","GL873530","16647228","16647517","74","10624720"
"chr3","6259071","6259348","GL873547","2222074","2222356","85","4036997"
"chr3","6398027","6398319","GL873547","2222074","2222356","88","4175953"
"chr3","6414985","6415283","GL873547","2222074","2222356","85","4192911"
"chr3","6781605","6781888","GL873547","2222074","2222356","84","4559531"
"chr3","6847417","6847692","GL873562","3299887","3300144","83","3547530"
"chr3","6891184","6891493","GL873752","427788","428097","92","6463396"
"chr3","7053245","7053532","GL873530","16647228","16647517","92","9593983"
"chr3","7123986","7124280","GL873541","16268070","16268366","88","9144084"
"chr3","7226127","7226416","GL873547","2222074","2222356","84","5004053"
"chr3","7473141","7473445","GL873541","16268070","16268366","93","8794929"
"chr3","8083700","8084007","GL873541","16268070","16268366","91","8184370"
"chr3","8300700","8301001","GL873541","16268070","16268366","83","7967370"
"chr3","9361719","9361992","GL873530","16647228","16647517","84","7285509"
"chr3","9362033","9362299","GL873562","3299887","3300144","83","6062146"
"chr3","9624297","9624590","GL873530","16647228","16647517","79","7022931"
"chr3","10130706","10131016","GL873530","16647228","16647517","99","6516522"
"chr3","10572108","10572251","GL873611","3799989","3800137","54","6772119"
"chr3","10616517","10616797","GL873547","2222074","2222356","88","8394443"
"chr3","10998901","10999200","GL873528","36697151","36697434","87","25698250"
"chr3","11063125","11063453","GL873541","16268070","16268366","100","5204945"
"chr3","11234332","11234470","GL873541","1550303","1550443","61","9684029"
"chr3","11271071","11271367","GL873530","16647228","16647517","86","5376157"
"chr3","12445792","12446101","GL873541","16268070","16268366","88","3822278"
"chr3","12589664","12589959","GL873530","16647228","16647517","86","4057564"
"chr3","13246592","13246827","GL873680","3005257","3005482","68","10241335"
"chr3","13740829","13741130","GL873541","16268070","16268366","85","2527241"
"chr3","14193434","14193735","GL873530","16647228","16647517","87","2453794"
"chr3","14236526","14236826","GL873547","2222074","2222356","86","12014452"
"chr3","14454094","14454349","GL873543","13038674","13038909","86","1415420"
"chr3","15238031","15238325","GL873541","16268070","16268366","83","1030039"
"chr3","15377296","15377589","GL873547","2222074","2222356","85","13155222"
"chr3","15858937","15859245","GL873541","16268070","16268366","96","409133"
"chr3","16012013","16012288","GL873667","4451263","4451534","87","11560750"
"chr3","16130634","16130935","GL873541","16268070","16268366","91","137436"
"chr3","16226997","16227277","GL873547","2222074","2222356","80","14004923"
"chr3","18155545","18155834","GL873608","6630366","6630673","93","11525179"
"chr3","18369063","18369363","GL873541","16268070","16268366","90","2100993"
"chr3","18442914","18443095","GL873530","5593486","5593649","54","12849428"
"chr3","18929139","18929429","GL873530","16647228","16647517","76","2281911"
"chr3","19022983","19023279","GL873607","1418062","1418355","105","17604921"
"chr3","19065739","19066007","GL873562","3299887","3300144","92","15765852"
"chr3","19120606","19120895","GL873530","16647228","16647517","91","2473378"
"chr3","19142444","19142731","GL873547","2222074","2222356","86","16920370"
"chr3","19281727","19282020","GL873530","16647228","16647517","83","2634499"
"chr3","19312325","19312633","GL873530","16647228","16647517","92","2665097"
"chr3","19321332","19321620","GL873547","2222074","2222356","83","17099258"
"chr3","19357254","19357547","GL873541","16268070","16268366","82","3089184"
"chr3","19360395","19360634","GL873680","3005257","3005482","71","16355138"
"chr3","19362946","19363243","GL873541","16268070","16268366","89","3094876"
"chr3","19377596","19377889","GL873547","2222074","2222356","81","17155522"
"chr3","19427213","19427505","GL873530","16647228","16647517","84","2779985"
"chr3","19437037","19437326","GL873547","2222074","2222356","77","17214963"
"chr3","19446908","19447193","GL873547","2222074","2222356","82","17224834"
"chr3","19502017","19502316","GL873541","16268070","16268366","82","3233947"
"chr3","19656225","19656523","GL873541","16268070","16268366","89","3388155"
"chr3","19781093","19781390","GL873541","16268070","16268366","80","3513023"
"chr3","19980447","19980715","GL873547","5449763","5449997","91","14530684"
"chr3","20127544","20127848","GL873547","2222074","2222356","86","17905470"
"chr3","20182377","20182673","GL873541","16268070","16268366","75","3914307"
"chr3","20463117","20463410","GL873530","16647228","16647517","75","3815889"
"chr3","20934298","20934579","GL873547","2222074","2222356","93","18712224"
"chr3","21173446","21173746","GL873541","16268070","16268366","87","4905376"
"chr3","21415578","21415909","GL873541","16268070","16268366","107","5147508"
"chr3","21549412","21549664","GL873680","3005257","3005482","86","18544155"
"chr3","21737714","21737910","GL873558","7532067","7532273","60","14205647"
"chr3","22696639","22696942","GL873530","16647228","16647517","87","6049411"
"chr3","22829609","22829907","GL873541","16268070","16268366","87","6561539"
"chr3","23136316","23136470","GL873574","7318344","7318500","55","15817972"
"chr3","23181629","23181925","GL873530","16647228","16647517","84","6534401"
"chr3","23197224","23197451","GL873531","3555300","3555500","71","19641924"
"chr3","23214628","23214930","GL873530","16647228","16647517","94","6567400"
"chr3","23328017","23328315","GL873530","16647228","16647517","86","6680789"
"chr3","23455201","23455479","GL873547","2222074","2222356","89","21233127"
"chr3","23465495","23465773","GL873547","2222074","2222356","89","21243421"
"chr3","23477064","23477343","GL873530","16647228","16647517","88","6829836"
"chr3","23495387","23495693","GL873541","16268070","16268366","90","7227317"
"chr3","23590467","23590757","GL873530","16647228","16647517","76","6943239"
"chr3","23937395","23937697","GL873541","16268070","16268366","86","7669325"
"chr3","24122582","24122878","GL873547","2222074","2222356","80","21900508"
"chr3","24607497","24607806","GL873547","2222074","2222356","97","22385423"
"chr3","24797388","24797693","GL873607","1418062","1418355","89","23379326"
"chr3","24930798","24931089","GL873541","16268070","16268366","79","8662728"
"chr3","25784267","25784567","GL873541","16268070","16268366","83","9516197"
"chr3","25922879","25923130","GL873680","3005257","3005482","74","22917622"
"chr3","26057799","26058091","GL873659","913070","913333","85","25144729"
"chr3","26133895","26134193","GL873528","36697151","36697434","83","10563256"
"chr3","26140048","26140345","GL873530","16647228","16647517","94","9492820"
"chr3","26574983","26575280","GL873608","6630366","6630673","91","19944617"
"chr3","27002540","27002834","GL873607","1418062","1418355","88","25584478"
"chr3","27047348","27047655","GL873608","6630366","6630673","89","20416982"
"chr3","27275366","27275671","GL873541","16268070","16268366","93","11007296"
"chr3","27485256","27485565","GL873541","16268070","16268366","91","11217186"
"chr3","27624788","27625072","GL873530","16647228","16647517","79","10977560"
"chr3","27770358","27770665","GL873541","16268070","16268366","93","11502288"
"chr3","27839765","27840043","GL873547","2222074","2222356","87","25617691"
"chr3","27879990","27880287","GL873607","1418062","1418355","83","26461928"
"chr3","27911177","27911379","GL873630","2508568","2508753","69","25402609"
"chr3","28939304","28939471","GL873530","5593486","5593649","49","23345818"
"chr3","29455537","29455826","GL873547","2222074","2222356","85","27233463"
"chr3","29617498","29617804","GL873530","16647228","16647517","91","12970270"
"chr3","30038544","30038841","GL873541","16268070","16268366","83","13770474"
"chr3","30187575","30187872","GL873541","16268070","16268366","84","13919505"
"chr3","30259939","30260247","GL873528","36697151","36697434","105","6437212"
"chr3","30521039","30521319","GL873547","2222074","2222356","87","28298965"
"chr3","31757392","31757689","GL873541","16268070","16268366","81","15489322"
"chr3","32577359","32577665","GL873541","16268070","16268366","85","16309289"
"chr3","32873359","32873648","GL873752","427788","428097","80","32445571"
"chr3","33333826","33334103","GL873562","3299887","3300144","94","30033939"
"chr3","33360705","33361010","GL873530","16647228","16647517","99","16713477"
"chr3","34159737","34160028","GL873547","2222074","2222356","82","31937663"
"chr3","34329967","34330258","GL873541","16268070","16268366","98","18061897"
"chr3","35526671","35526946","GL873547","2222074","2222356","97","33304597"
"chr3","35728999","35729297","GL873541","16268070","16268366","90","19460929"
"chr3","35950519","35950827","GL873530","16647228","16647517","93","19303291"
"chr3","36176602","36176898","GL873752","427788","428097","87","35748814"
"chr3","36294282","36294553","GL873680","3005257","3005482","92","33289025"
"chr3","36526593","36526889","GL873528","36697151","36697434","103","170558"
"chr3","38217916","38218209","GL873530","16647228","16647517","81","21570688"
"chr3","40470983","40471273","GL873547","2222074","2222356","87","38248909"
"chr3","41364566","41364870","GL873528","36697151","36697434","95","4667415"
"chr3","41464505","41464810","GL873541","16268070","16268366","90","25196435"
"chr3","42327257","42327554","GL873541","16268070","16268366","88","26059187"
"chr3","42418904","42419203","GL873541","16268070","16268366","83","26150834"
"chr3","44477956","44478242","GL873565","12307556","12307825","100","32170400"
"chr3","44607737","44607934","GL873530","5593486","5593649","81","39014251"
"chr3","44785614","44785924","GL873541","16268070","16268366","97","28517544"
"chr3","45027409","45027681","GL873547","2222074","2222356","90","42805335"
"chr3","45154458","45154749","GL873530","16647228","16647517","86","28507230"
"chr3","46170082","46170384","GL873541","16268070","16268366","81","29902012"
"chr3","46511112","46511397","GL873607","1418062","1418355","84","45093050"
"chr3","47272846","47273137","GL873547","2222074","2222356","88","45050772"
"chr3","48384874","48385182","GL873608","6630366","6630673","97","41754508"
"chr3","48923946","48924132","GL873530","5593486","5593649","60","43330460"
"chr3","49243046","49243339","GL873530","16647228","16647517","86","32595818"
"chr3","49368179","49368438","GL873562","3299887","3300144","81","46068292"
"chr3","50709473","50709774","GL873530","16647228","16647517","89","34062245"
"chr3","50736278","50736560","GL873541","16268070","16268366","94","34468208"
"chr3","50847040","50847275","GL873640","6426205","6426399","84","44420835"
"chr3","52274420","52274723","GL873547","2222074","2222356","88","50052346"
"chr3","52662868","52662884","GL873691","2903502","2903535","20","49759366"
"chr3","52662911","52663192","GL873562","3299887","3300144","84","49363024"
"chr3","52673565","52673861","GL873541","16268070","16268366","90","36405495"
"chr3","52681783","52682077","GL873541","16268070","16268366","84","36413713"
"chr3","52994122","52994427","GL873541","16268070","16268366","90","36726052"
"chr3","54097857","54098084","GL873531","3555300","3555500","68","50542557"
"chr3","54134214","54134510","GL873530","16647228","16647517","77","37486986"
"chr3","54517299","54517407","GL873524","43272770","43272878","46","11244529"
"chr3","54798951","54799262","GL873528","36697151","36697434","99","18101800"
"chr3","55583770","55584072","GL873528","36697151","36697434","87","18886619"
"chr3","55656768","55657069","GL873547","2222074","2222356","96","53434694"
"chr3","55935272","55935580","GL873541","16268070","16268366","91","39667202"
"chr3","56221621","56221727","GL873622","7076274","7076365","39","49145347"
"chr3","56241784","56242028","GL873528","25203621","25203847","87","31038163"
"chr3","57780898","57781190","GL873667","4451263","4451534","88","53329635"
"chr3","57875644","57875943","GL873541","16268070","16268366","77","41607574"
"chr3","58641664","58641979","GL873541","16268070","16268366","97","42373594"
"chr3","59219577","59219884","GL873541","16268070","16268366","94","42951507"
"chr3","59228557","59228868","GL873541","16268070","16268366","91","42960487"
"chr3","60073361","60073662","GL873541","16268070","16268366","87","43805291"
"chr3","60983853","60984141","GL873528","36697151","36697434","94","24286702"
"chr3","61105522","61105802","GL873547","2222074","2222356","88","58883448"
"chr3","62299810","62300119","GL873541","16268070","16268366","95","46031740"
"chr3","62923778","62924082","GL873530","16647228","16647517","99","46276550"
"chr3","63724032","63724205","GL873530","5593486","5593649","65","58130546"
"chr3","63724231","63724346","GL873550","5998776","5998900","42","57725455"
"chr3","63855865","63856174","GL873541","16268070","16268366","88","47587795"
"chr3","64637516","64637817","GL873541","16268070","16268366","83","48369446"
"chr3","64830263","64830435","GL873585","9209559","9209725","48","55620704"
"chr3","64945365","64945678","GL873528","36697151","36697434","99","28248214"
"chr3","64952340","64952627","GL873667","4451263","4451534","100","60501077"
"chr3","65008053","65008325","GL873562","3299887","3300144","85","61708166"
"chr3","65405335","65405640","GL873541","16268070","16268366","91","49137265"
"chr3","65948030","65948140","GL873622","7076274","7076365","39","58871756"
"chr3","65955649","65955922","GL873562","3299887","3300144","84","62655762"
"chr3","66521917","66522194","GL873547","2222074","2222356","93","64299843"
"chr3","66770442","66770733","GL873530","16647228","16647517","81","50123214"
"chr3","66945321","66945652","GL873608","6630366","6630673","116","60314955"
"chr3","67113942","67114229","GL873547","2222074","2222356","76","64891868"
"chr3","67889935","67890219","GL873528","36697151","36697434","99","31192784"
"chr3","67989792","67990120","GL873541","16268070","16268366","112","51721722"
"chr3","70578319","70578616","GL873541","16268070","16268366","87","54310249"
"chr3","70806997","70807294","GL873530","16647228","16647517","88","54159769"
"chr3","71026264","71026566","GL873541","16268070","16268366","98","54758194"
"chr3","71560550","71560829","GL873547","2222074","2222356","90","69338476"
"chr3","72295086","72295392","GL873608","6630366","6630673","94","65664720"
"chr3","72587268","72587566","GL873541","16268070","16268366","98","56319198"
"chr3","72758143","72758434","GL873547","2222074","2222356","81","70536069"
"chr3","73292441","73292730","GL873547","2222074","2222356","74","71070367"
"chr3","73473143","73473443","GL873541","16268070","16268366","83","57205073"
"chr3","74544923","74545231","GL873541","16268070","16268366","84","58276853"
"chr3","76063430","76063623","GL873697","3111225","3111427","60","72952205"
"chr3","76685504","76685637","GL873550","5998776","5998900","41","70686728"
"chr3","76748195","76748329","GL873550","5998776","5998900","31","70749419"
"chr3","76758914","76759196","GL873547","2222074","2222356","88","74536840"
"chr3","76855982","76856288","GL873528","36697151","36697434","90","40158831"
"chr3","77031908","77032244","GL873541","16268070","16268366","123","60763838"
"chr3","77299702","77299832","GL873550","5998776","5998900","37","71300926"
"chr3","77317951","77318084","GL873550","5998776","5998900","37","71319175"
"chr3","77318398","77318568","GL873530","5593486","5593649","46","71724912"
"chr3","77518664","77518968","GL873541","16268070","16268366","91","61250594"
"chr3","77559405","77559679","GL873547","2222074","2222356","94","75337331"
"chr3","77614350","77614655","GL873608","6630366","6630673","92","70983984"
"chr3","77902958","77903231","GL873659","913070","913333","80","76989888"
"chr3","77996540","77996847","GL873541","16268070","16268366","90","61728470"
"chr3","78223204","78223508","GL873528","36697151","36697434","89","41526053"
"chr3","78360421","78360714","GL873547","2222074","2222356","80","76138347"
"chr3","79032373","79032682","GL873528","36697151","36697434","91","42335222"
"chr3","79049370","79049678","GL873607","1418062","1418355","88","77631308"
"chr3","79076042","79076363","GL873528","36697151","36697434","98","42378891"
"chr3","79179286","79179587","GL873541","16268070","16268366","85","62911216"
"chr3","81970581","81970881","GL873607","1418062","1418355","87","80552519"
"chr3","83114324","83114628","GL873667","4451263","4451534","104","78663061"
"chr3","83536295","83536572","GL873530","16647228","16647517","89","66889067"
"chr3","83613783","83614076","GL873541","16268070","16268366","83","67345713"
"chr3","83651230","83651533","GL873541","16268070","16268366","87","67383160"
"chr3","83737947","83738251","GL873528","36697151","36697434","90","47040796"
"chr3","84292373","84292678","GL873541","16268070","16268366","85","68024303"
"chr3","84994259","84994563","GL873530","16647228","16647517","87","68347031"
"chr3","85996161","85996469","GL873541","16268070","16268366","93","69728091"
"chr3","86115648","86115938","GL873547","2222074","2222356","79","83893574"
"chr3","86122139","86122444","GL873541","16268070","16268366","91","69854069"
"chr3","86666150","86666449","GL873541","16268070","16268366","88","70398080"
"chr3","87414575","87414849","GL873530","16647228","16647517","85","70767347"
"chr3","87476427","87476721","GL873547","2222074","2222356","88","85254353"
"chr3","88057816","88058114","GL873530","16647228","16647517","83","71410588"
"chr3","88255366","88255656","GL873530","16647228","16647517","86","71608138"
"chr3","88339148","88339454","GL873541","16268070","16268366","91","72071078"
"chr3","88516944","88517224","GL873547","2222074","2222356","81","86294870"
"chr3","89188408","89188669","GL873562","3299887","3300144","90","85888521"
"chr3","90399273","90399425","GL873585","9209559","9209725","59","81189714"
"chr3","90712665","90712972","GL873607","1418062","1418355","90","89294603"
"chr3","91282609","91282911","GL873752","427788","428097","91","90854821"
"chr3","91297346","91297654","GL873528","36697151","36697434","101","54600195"
"chr3","91323675","91323968","GL873547","2222074","2222356","85","89101601"
"chr3","91495192","91495505","GL873541","16268070","16268366","97","75227122"
"chr3","91778271","91778445","GL873823","304319","304508","54","91473952"
"chr3","92080490","92080787","GL873541","16268070","16268366","92","75812420"
"chr3","92082225","92082371","GL873543","18789325","18789460","54","73292900"
"chr3","92122150","92122443","GL873530","16647228","16647517","86","75474922"
"chr4","353906","354210","GL873541","16268070","16268366","88","15914164"
"chr4","595008","595111","GL873524","43272658","43272747","37","42677650"
"chr4","1428493","1428782","GL873547","2222074","2222356","82","793581"
"chr4","3149271","3149531","GL873659","913070","913333","106","2236201"
"chr4","3214636","3214930","GL873541","16268070","16268366","89","13053434"
"chr4","3920177","3920441","GL873562","3299887","3300144","91","620290"
"chr4","5227391","5227661","GL873547","2222074","2222356","92","3005317"
"chr4","5501212","5501493","GL873530","16647228","16647517","91","11146016"
"chr4","5553230","5553534","GL873530","16647228","16647517","97","11093998"
"chr4","5561570","5561873","GL873528","36697151","36697434","80","31135581"
"chr4","8073802","8074109","GL873528","36697151","36697434","92","28623349"
"chr4","8161526","8161754","GL873697","3111225","3111427","77","5050301"
"chr4","9014198","9014517","GL873541","16268070","16268366","106","7253872"
"chr4","10168457","10168762","GL873547","2222074","2222356","90","7946383"
"chr4","10952635","10952918","GL873547","2222074","2222356","82","8730561"
"chr4","11736984","11737266","GL873547","2222074","2222356","85","9514910"
"chr4","12724053","12724355","GL873528","36697151","36697434","88","23973098"
"chr4","13625073","13625381","GL873547","2222074","2222356","92","11402999"
"chr4","13952658","13952953","GL873530","16647228","16647517","76","2694570"
"chr4","14253886","14254130","GL873528","25203621","25203847","82","10949735"
"chr4","14273946","14274129","GL873535","8592877","8593062","64","5681069"
"chr4","15418543","15418780","GL873630","2508568","2508753","96","12909975"
"chr4","16384098","16384397","GL873528","36697151","36697434","85","20313053"
"chr4","16522976","16523291","GL873541","16268070","16268366","97","254906"
"chr4","16635429","16635752","GL873608","6630366","6630673","93","10005063"
"chr4","16637644","16637926","GL873528","36697151","36697434","91","20059507"
"chr4","16642614","16642902","GL873547","2222074","2222356","94","14420540"
"chr4","16644815","16645118","GL873541","16268070","16268366","97","376745"
"chr4","16698834","16699130","GL873607","1418062","1418355","89","15280772"
"chr4","16699370","16699665","GL873530","16647228","16647517","84","52142"
"chr4","16704565","16704869","GL873547","2222074","2222356","97","14482491"
"chr4","16716893","16717190","GL873541","16268070","16268366","84","448823"
"chr4","17223100","17223400","GL873541","16268070","16268366","84","955030"
"chr4","17325528","17325836","GL873528","36697151","36697434","94","19371623"
"chr4","18673226","18673396","GL873585","9209559","9209725","59","9463667"
"chr4","18845420","18845719","GL873541","16268070","16268366","86","2577350"
"chr4","18870831","18871143","GL873528","36697151","36697434","88","17826320"
"chr4","19815227","19815505","GL873565","12307556","12307825","95","7507671"
"chr4","20165683","20165971","GL873547","2222074","2222356","88","17943609"
"chr4","20662650","20662959","GL873547","2222074","2222356","92","18440576"
"chr4","20898484","20898799","GL873541","16268070","16268366","104","4630414"
"chr4","21684072","21684366","GL873541","16268070","16268366","85","5416002"
"chr4","22507506","22507813","GL873528","36697151","36697434","98","14189645"
"chr4","23566654","23566961","GL873541","16268070","16268366","99","7298584"
"chr4","23846919","23847228","GL873541","16268070","16268366","94","7578849"
"chr4","23863002","23863295","GL873659","913070","913333","90","22949932"
"chr4","23997845","23998097","GL873528","25203621","25203847","90","1205776"
"chr4","24019282","24019594","GL873541","16268070","16268366","91","7751212"
"chr4","24837229","24837516","GL873541","16268070","16268366","87","8569159"
"chr4","25513093","25513392","GL873541","16268070","16268366","87","9245023"
"chr4","25922078","25922364","GL873530","16647228","16647517","81","9274850"
"chr4","26037746","26038051","GL873541","16268070","16268366","91","9769676"
"chr4","27242855","27243145","GL873547","2222074","2222356","89","25020781"
"chr4","27513094","27513384","GL873547","2222074","2222356","86","25291020"
"chr4","28117804","28118116","GL873607","1418062","1418355","99","26699742"
"chr4","28911855","28912153","GL873547","2222074","2222356","91","26689781"
"chr4","29087392","29087554","GL873541","1550303","1550443","68","27537089"
"chr4","29535153","29535451","GL873752","427788","428097","89","29107365"
"chr4","30395771","30396077","GL873530","16647228","16647517","98","13748543"
"chr4","30931102","30931406","GL873541","16268070","16268366","88","14663032"
"chr4","30949113","30949412","GL873541","16268070","16268366","80","14681043"
"chr4","30973086","30973380","GL873547","2222074","2222356","88","28751012"
"chr4","31063540","31063840","GL873541","16268070","16268366","87","14795470"
"chr4","31123067","31123369","GL873541","16268070","16268366","87","14854997"
"chr4","31240462","31240592","GL873550","5998776","5998900","36","25241686"
"chr4","31240902","31241097","GL873697","3111225","3111427","60","28129677"
"chr4","31243267","31243542","GL873562","3299887","3300144","95","27943380"
"chr4","31354445","31354741","GL873607","1418062","1418355","88","29936383"
"chr4","31597386","31597695","GL873541","16268070","16268366","97","15329316"
"chr4","31810785","31811076","GL873535","4830564","4830824","107","26980221"
"chr4","31811484","31811787","GL873541","16268070","16268366","81","15543414"
"chr4","33846106","33846406","GL873541","16268070","16268366","87","17578036"
"chr4","34473885","34474174","GL873607","1418062","1418355","92","33055823"
"chr4","35151336","35151637","GL873541","16268070","16268366","81","18883266"
"chr4","35239086","35239384","GL873541","16268070","16268366","95","18971016"
"chr4","35304028","35304322","GL873608","6630366","6630673","88","28673662"
"chr4","35507229","35507520","GL873547","2222074","2222356","82","33285155"
"chr4","35916772","35917124","GL873608","6630366","6630673","126","29286406"
"chr4","36018469","36018767","GL873530","16647228","16647517","87","19371241"
"chr4","36056954","36057249","GL873530","16647228","16647517","82","19409726"
"chr4","36106904","36107172","GL873680","3005257","3005482","91","33101647"
"chr4","36121643","36121897","GL873680","3005257","3005482","81","33116386"
"chr4","36175247","36175552","GL873530","16647228","16647517","89","19528019"
"chr4","36232768","36233068","GL873541","16268070","16268366","85","19964698"
"chr4","36244920","36245208","GL873659","913070","913333","98","35331850"
"chr4","36472091","36472381","GL873547","2222074","2222356","80","34250017"
"chr4","37011773","37012100","GL873607","1418062","1418355","110","35593711"
"chr4","37086524","37086833","GL873541","16268070","16268366","90","20818454"
"chr4","37190615","37190909","GL873541","16268070","16268366","86","20922545"
"chr4","37507534","37507805","GL873562","3299887","3300144","85","34207647"
"chr4","37731664","37731929","GL873547","2222074","2222356","89","35509590"
"chr4","38380301","38380562","GL873680","3005257","3005482","91","35375044"
"chr4","38579698","38579963","GL873535","4830564","4830824","88","33749134"
"chr4","39404751","39404989","GL873557","3858721","3858924","82","35546030"
"chr4","39455494","39455790","GL873547","2222074","2222356","83","37233420"
"chr4","39478466","39478755","GL873530","16647228","16647517","84","22831238"
"chr4","39545054","39545348","GL873530","16647228","16647517","92","22897826"
"chr4","39565288","39565578","GL873547","2222074","2222356","94","37343214"
"chr4","39570762","39571053","GL873530","16647228","16647517","92","22923534"
"chr4","39579807","39580088","GL873547","2222074","2222356","86","37357733"
"chr4","39670594","39670891","GL873547","2222074","2222356","87","37448520"
"chr4","39673939","39674248","GL873547","2222074","2222356","90","37451865"
"chr4","39921192","39921459","GL873562","3299887","3300144","90","36621305"
"chr4","40000311","40000454","GL873541","1550303","1550443","52","38450008"
"chr4","41804274","41804565","GL873667","4451263","4451534","86","37353011"
"chr4","41950371","41950681","GL873541","16268070","16268366","94","25682301"
"chr4","41996393","41996718","GL873530","16647228","16647517","111","25349165"
"chr4","42016989","42017303","GL873528","36697151","36697434","101","5319838"
"chr4","42367925","42368233","GL873541","16268070","16268366","82","26099855"
"chr4","42564876","42565166","GL873547","2222074","2222356","83","40342802"
"chr4","43675527","43675821","GL873547","2222074","2222356","83","41453453"
"chr4","44010553","44010857","GL873541","16268070","16268366","87","27742483"
"chr4","44230051","44230350","GL873541","16268070","16268366","86","27961981"
"chr4","46594958","46595290","GL873541","16268070","16268366","122","30326888"
"chr4","46732400","46732694","GL873530","16647228","16647517","89","30085172"
"chr4","46909947","46910225","GL873562","3299887","3300144","91","43610060"
"chr4","46934213","46934338","GL873552","12711845","12711956","60","34222368"
"chr4","46948665","46948958","GL873667","4451263","4451534","90","42497402"
"chr4","47383241","47383541","GL873541","16268070","16268366","85","31115171"
"chr4","47409062","47409370","GL873541","16268070","16268366","92","31140992"
"chr4","48004583","48004887","GL873530","16647228","16647517","88","31357355"
"chr4","48419592","48419894","GL873608","6630366","6630673","87","41789226"
"chr4","49650239","49650453","GL873680","3005257","3005482","69","46644982"
"chr4","49912342","49912609","GL873659","913070","913333","87","48999272"
"chr4","50265941","50266233","GL873530","16647228","16647517","86","33618713"
"chr4","50510683","50510871","GL873535","24407607","24407780","49","26103076"
"chr4","50511162","50511228","GL873524","36505249","36505303","36","14005913"
"chr4","51389633","51389929","GL873547","2222074","2222356","89","49167559"
"chr4","51700470","51700755","GL873547","2222074","2222356","89","49478396"
"chr4","51785403","51785707","GL873541","16268070","16268366","85","35517333"
"chr4","51846047","51846344","GL873528","36697151","36697434","96","15148896"
"chr4","51976280","51976557","GL873562","3299887","3300144","76","48676393"
"chr4","52198329","52198623","GL873530","16647228","16647517","84","35551101"
"chr4","52216157","52216355","GL873530","5593486","5593649","81","46622671"
"chr4","52219696","52219985","GL873530","16647228","16647517","86","35572468"
"chr4","52226463","52226762","GL873528","36697151","36697434","93","15529312"
"chr4","52387044","52387336","GL873547","2222074","2222356","74","50164970"
"chr4","52706069","52706362","GL873541","16268070","16268366","96","36437999"
"chr4","53276499","53276787","GL873530","16647228","16647517","90","36629271"
"chr4","53282326","53282626","GL873541","16268070","16268366","86","37014256"
"chr4","53318518","53318817","GL873752","427788","428097","89","52890730"
"chr4","53460153","53460432","GL873547","2222074","2222356","80","51238079"
"chr4","54308868","54309095","GL873538","2567037","2567262","69","51741831"
"chr4","55250836","55251018","GL873835","160446","160628","63","55090390"
"chr4","55296239","55296547","GL873541","16268070","16268366","94","39028169"
"chr4","55312698","55312962","GL873538","2567037","2567262","96","52745661"
"chr4","56195016","56195323","GL873541","16268070","16268366","89","39926946"
"chr4","57028327","57028627","GL873541","16268070","16268366","87","40760257"
"chr4","57050132","57050412","GL873547","2222074","2222356","87","54828058"
"chr4","57711841","57712143","GL873541","16268070","16268366","84","41443771"
"chr4","58050970","58051273","GL873541","16268070","16268366","89","41782900"
"chr4","58182166","58182477","GL873541","16268070","16268366","89","41914096"
"chr4","58622830","58622931","GL873622","7076274","7076365","31","51546556"
"chr4","58642331","58642606","GL873562","3299887","3300144","80","55342444"
"chr4","58649414","58649707","GL873530","16647228","16647517","85","42002186"
"chr4","58823194","58823500","GL873547","2222074","2222356","91","56601120"
"chr4","58862987","58863253","GL873562","3299887","3300144","91","55563100"
"chr4","59046319","59046573","GL873680","3005257","3005482","85","56041062"
"chr4","59175467","59175595","GL873587","10002051","10002151","59","49173416"
"chr4","59215106","59215410","GL873530","16647228","16647517","90","42567878"
"chr4","60136287","60136567","GL873541","16268070","16268366","99","43868217"
"chr4","60273988","60274269","GL873547","2222074","2222356","93","58051914"
"chr4","60274875","60275075","GL873697","3111225","3111427","53","57163650"
"chr4","60732086","60732298","GL873640","6426205","6426399","73","54305881"
"chr4","60732328","60732387","GL873550","5998911","5998963","31","54733417"
"chr4","61125414","61125714","GL873541","16268070","16268366","91","44857344"
"chr4","61648917","61649213","GL873541","16268070","16268366","98","45380847"
"chr4","61692314","61692609","GL873547","2222074","2222356","81","59470240"
"chr4","61708512","61708831","GL873608","6630366","6630673","99","55078146"
"chr4","62133864","62134158","GL873547","2222074","2222356","88","59911790"
"chr4","62134466","62134776","GL873541","16268070","16268366","97","45866396"
"chr4","63292257","63292566","GL873541","16268070","16268366","91","47024187"
"chr4","63987483","63987776","GL873547","2222074","2222356","84","61765409"
"chr4","64026900","64027187","GL873667","4451263","4451534","91","59575637"
"chr4","64041991","64042292","GL873541","16268070","16268366","97","47773921"
"chr4","64240680","64240978","GL873607","1418062","1418355","81","62822618"
"chr4","64277160","64277451","GL873530","16647228","16647517","87","47629932"
"chr4","64314996","64315286","GL873547","2222074","2222356","80","62092922"
"chr4","65223730","65224021","GL873547","2222074","2222356","84","63001656"
"chr4","65263107","65263348","GL873528","25203621","25203847","81","40059486"
"chr4","65353875","65353933","GL873527","37742071","37742124","23","27611804"
"chr4","65357267","65357566","GL873541","16268070","16268366","80","49089197"
"chr4","65360239","65360531","GL873530","16647228","16647517","80","48713011"
"chr4","65519938","65520243","GL873541","16268070","16268366","91","49251868"
"chr4","65572224","65572519","GL873541","16268070","16268366","87","49304154"
"chr4","65572534","65572831","GL873530","16647228","16647517","83","48925306"
"chr4","65803502","65803802","GL873530","16647228","16647517","84","49156274"
"chr4","66655504","66655608","GL873520","23895808","23895898","43","42759696"
"chr4","66826794","66826969","GL873530","5593486","5593649","41","61233308"
"chr4","66827010","66827031","GL873691","2903502","2903535","26","63923508"
"chr4","66827074","66827199","GL873550","5998776","5998900","37","60828298"
"chr4","66900272","66900596","GL873528","36697151","36697434","99","30203121"
"chr4","66981602","66981900","GL873547","2222074","2222356","86","64759528"
"chr4","67317453","67317748","GL873541","16268070","16268366","79","51049383"
"chr4","67353413","67353712","GL873547","2222074","2222356","95","65131339"
"chr4","67712015","67712304","GL873659","913070","913333","89","66798945"
"chr4","67806059","67806358","GL873541","16268070","16268366","82","51537989"
"chr4","68066459","68066738","GL873530","16647228","16647517","88","51419231"
"chr4","68790654","68790959","GL873541","16268070","16268366","91","52522584"
"chr4","69032146","69032449","GL873541","16268070","16268366","87","52764076"
"chr4","69132756","69132980","GL873531","3555300","3555500","64","65577456"
"chr4","69249366","69249677","GL873541","16268070","16268366","102","52981296"
"chr4","69421013","69421249","GL873547","5449763","5449997","80","63971250"
"chr4","69590080","69590360","GL873565","12307556","12307825","96","57282524"
"chr4","69731790","69732072","GL873547","2222074","2222356","84","67509716"
"chr4","69738737","69739032","GL873530","16647228","16647517","86","53091509"
"chr4","70526953","70527078","GL873526","41480965","41481045","57","29045988"
"chr4","70686234","70686528","GL873530","16647228","16647517","85","54039006"
"chr4","71021162","71021459","GL873541","16268070","16268366","94","54753092"
"chr4","71146291","71146587","GL873541","16268070","16268366","82","54878221"
"chr4","71160137","71160418","GL873547","2222074","2222356","89","68938063"
"chr4","71214492","71214802","GL873608","6630366","6630673","88","64584126"
"chr4","71365655","71365946","GL873530","16647228","16647517","79","54718427"
"chr4","71555519","71555804","GL873547","2222074","2222356","79","69333445"
"chr4","71688456","71688734","GL873547","2222074","2222356","94","69466382"
"chr4","71701959","71702257","GL873530","16647228","16647517","85","55054731"
"chr4","71710060","71710362","GL873530","16647228","16647517","86","55062832"
"chr4","71930185","71930354","GL873530","5593486","5593649","47","66336699"
"chr4","72191672","72191981","GL873541","16268070","16268366","97","55923602"
"chr4","72252015","72252325","GL873541","16268070","16268366","98","55983945"
"chr4","72474636","72474936","GL873541","16268070","16268366","85","56206566"
"chr4","72611984","72612288","GL873541","16268070","16268366","88","56343914"
"chr4","72666859","72667146","GL873528","36697151","36697434","103","35969708"
"chr4","73195761","73196064","GL873541","16268070","16268366","83","56927691"
"chr4","73247567","73247863","GL873530","16647228","16647517","84","56600339"
"chr4","73317887","73318198","GL873541","16268070","16268366","95","57049817"
"chr4","73421373","73421681","GL873541","16268070","16268366","92","57153303"
"chr4","73426230","73426534","GL873541","16268070","16268366","97","57158160"
"chr4","73764736","73765059","GL873541","16268070","16268366","105","57496666"
"chr4","73783048","73783346","GL873547","2222074","2222356","86","71560974"
"chr4","73839786","73840081","GL873530","16647228","16647517","77","57192558"
"chr4","73918339","73918647","GL873607","1418062","1418355","96","72500277"
"chr4","74101468","74101794","GL873530","16647228","16647517","109","57454240"
"chr4","74247685","74247799","GL873520","23895808","23895898","52","50351877"
"chr4","74248285","74248581","GL873541","16268070","16268366","84","57980215"
"chr4","74370955","74371202","GL873680","3005257","3005482","71","71365698"
"chr4","74425133","74425439","GL873528","36697151","36697434","91","37727982"
"chr4","74426423","74426724","GL873530","16647228","16647517","87","57779195"
"chr4","74435289","74435585","GL873547","2222074","2222356","91","72213215"
"chr4","74707922","74708225","GL873541","16268070","16268366","92","58439852"
"chr4","74750244","74750542","GL873541","16268070","16268366","79","58482174"
"chr4","74886439","74886738","GL873530","16647228","16647517","89","58239211"
"chr4","75163820","75164115","GL873530","16647228","16647517","90","58516592"
"chr4","75310346","75310655","GL873541","16268070","16268366","88","59042276"
"chr4","75640074","75640331","GL873565","12307556","12307825","93","63332518"
"chr4","75730761","75731061","GL873530","16647228","16647517","83","59083533"
"chr4","75817095","75817389","GL873667","4451263","4451534","84","71365832"
"chr4","76340083","76340392","GL873528","36697151","36697434","93","39642932"
"chr4","76488596","76488882","GL873547","2222074","2222356","85","74266522"
"chr4","76595623","76595922","GL873607","1418062","1418355","90","75177561"
"chr4","76880020","76880299","GL873562","3299887","3300144","87","73580133"
"chr4","77447300","77447609","GL873528","36697151","36697434","93","40750149"
"chr4","77849836","77850141","GL873541","16268070","16268366","89","61581766"
"chr4","77854051","77854348","GL873607","1418062","1418355","85","76435989"
"chr4","77908589","77908714","GL873622","7076274","7076365","49","70832315"
"chr4","78114669","78114960","GL873659","913070","913333","90","77201599"
"chr4","78123071","78123366","GL873541","16268070","16268366","87","61855001"
"chr4","79164268","79164566","GL873541","16268070","16268366","91","62896198"
"chr4","79269343","79269680","GL873541","16268070","16268366","120","63001273"
"chr4","80126586","80126881","GL873528","36697151","36697434","101","43429435"
"chr4","80772364","80772644","GL873547","2222074","2222356","86","78550290"
"chr4","80861929","80862230","GL873541","16268070","16268366","84","64593859"
"chr4","82546266","82546573","GL873541","16268070","16268366","87","66278196"
"chr4","83090752","83091031","GL873562","3299887","3300144","82","79790865"
"chr4","83649187","83649493","GL873541","16268070","16268366","108","67381117"
"chr4","84019065","84019240","GL873530","5593486","5593649","53","78425579"
"chr4","84260822","84261120","GL873528","36697151","36697434","95","47563671"
"chr4","84554901","84555191","GL873541","16268070","16268366","94","68286831"
"chr4","84688333","84688637","GL873541","16268070","16268366","86","68420263"
"chr4","84905450","84905741","GL873541","16268070","16268366","83","68637380"
"chr4","85442132","85442428","GL873608","6630366","6630673","87","78811766"
"chr4","86674162","86674456","GL873530","16647228","16647517","86","70026934"
"chr4","86772634","86772966","GL873541","16268070","16268366","110","70504564"
"chr4","87629258","87629557","GL873667","4451263","4451534","101","83177995"
"chr4","88296578","88296885","GL873607","1418062","1418355","94","86878516"
"chr4","89686474","89686771","GL873530","16647228","16647517","79","73039246"
"chr4","89699439","89699731","GL873541","16268070","16268366","87","73431369"
"chr4","90460665","90460796","GL873619","2497092","2497229","47","87963573"
"chr4","90505106","90505414","GL873541","16268070","16268366","95","74237036"
"chr4","90590936","90591257","GL873528","36697151","36697434","104","53893785"
"chr4","90750684","90750957","GL873547","2222074","2222356","84","88528610"
"chr5","58720226","58720521","GL873547","2222074","2222356","79","56498152"
"chr5","2752439","2752739","GL873530","16647228","16647517","84","13894789"
"chr5","1959","2255","GL873541","16268070","16268366","89","16266111"
"chr5","63256","63474","GL873557","3858721","3858924","63","3795465"
"chr5","90433","90696","GL873565","12307556","12307825","95","12217123"
"chr5","156553","156850","GL873530","16647228","16647517","86","16490675"
"chr5","162477","162770","GL873565","12307556","12307825","97","12145079"
"chr5","171053","171221","GL873524","23693028","23693185","62","23521975"
"chr5","192637","192820","GL874079","15836","16035","57","176801"
"chr5","344659","344932","GL873565","12307556","12307825","96","11962897"
"chr5","387698","387992","GL873541","16268070","16268366","85","15880372"
"chr5","432745","433046","GL873528","36697151","36697434","88","36264406"
"chr5","1269490","1269604","GL873550","5998776","5998900","42","4729286"
"chr5","1310910","1311190","GL873547","2222074","2222356","84","911164"
"chr5","1493580","1493878","GL873547","2222074","2222356","90","728494"
"chr5","1515008","1515156","GL873550","5998776","5998900","51","4483768"
"chr5","1515160","1515290","GL873550","5998776","5998900","40","4483616"
"chr5","1534309","1534592","GL873547","2222074","2222356","89","687765"
"chr5","1633491","1633544","GL873554","10500008","10500061","20","8866517"
"chr5","1759268","1759563","GL873528","36697151","36697434","96","34937883"
"chr5","1761194","1761460","GL873667","4451263","4451534","83","2690069"
"chr5","1820968","1821148","GL873530","5593486","5593649","55","3772518"
"chr5","2033212","2033345","GL873550","5998776","5998900","34","3965564"
"chr5","2037622","2037750","GL873623","513318","513444","38","1524304"
"chr5","2113905","2114193","GL873667","4451263","4451534","93","2337358"
"chr5","2114328","2114601","GL873667","4451263","4451534","83","2336935"
"chr5","2161169","2161467","GL873541","16268070","16268366","85","14106901"
"chr5","2444835","2444979","GL873541","1550303","1550443","64","894532"
"chr5","2445257","2445270","GL873691","2903502","2903535","23","458245"
"chr5","2445271","2445559","GL873547","2222074","2222356","84","223197"
"chr5","2445602","2445676","GL873526","41481654","41481719","23","39036052"
"chr5","2453413","2453685","GL873530","16647228","16647517","88","14193815"
"chr5","2524007","2524312","GL873541","16268070","16268366","90","13744063"
"chr5","2662366","2662648","GL873667","4451263","4451534","90","1788897"
"chr5","2889319","2889628","GL873541","16268070","16268366","91","13378751"
"chr5","2991133","2991439","GL873541","16268070","16268366","86","13276937"
"chr5","3121561","3121864","GL873541","16268070","16268366","85","13146509"
"chr5","3130841","3131136","GL873547","2222074","2222356","80","908767"
"chr5","3148405","3148630","GL873557","3858721","3858924","73","710316"
"chr5","3297052","3297343","GL873547","2222074","2222356","82","1074978"
"chr5","3304750","3305059","GL873530","16647228","16647517","101","13342478"
"chr5","3395348","3395668","GL873541","16268070","16268366","102","12872722"
"chr5","3855595","3855900","GL873541","16268070","16268366","94","12412475"
"chr5","3873106","3873396","GL873547","2222074","2222356","77","1651032"
"chr5","3990832","3990970","GL873619","2497092","2497229","44","1493740"
"chr5","4117734","4118037","GL873608","6630366","6630673","129","2512632"
"chr5","4181040","4181346","GL873541","16268070","16268366","119","12087030"
"chr5","4207569","4207789","GL873531","3555300","3555500","64","652269"
"chr5","4315617","4315921","GL873528","36697151","36697434","94","32381534"
"chr5","4580294","4580616","GL873528","36697151","36697434","105","32116857"
"chr5","5298594","5298888","GL873530","16647228","16647517","77","11348634"
"chr5","5335108","5335336","GL873680","3005257","3005482","72","2329851"
"chr5","5366960","5367222","GL873680","3005257","3005482","91","2361703"
"chr5","5368402","5368670","GL873680","3005257","3005482","95","2363145"
"chr5","5827035","5827340","GL873528","36697151","36697434","93","30870116"
"chr5","6024181","6024490","GL873541","16268070","16268366","92","10243889"
"chr5","6078089","6078400","GL873541","16268070","16268366","94","10189981"
"chr5","6292099","6292292","GL873535","8592877","8593062","61","2300778"
"chr5","7080160","7080178","GL873691","2903502","2903535","20","4176658"
"chr5","7080218","7080461","GL873640","6426205","6426399","88","654013"
"chr5","7544889","7545193","GL873541","16268070","16268366","86","8723181"
"chr5","7770149","7770458","GL873541","16268070","16268366","89","8497921"
"chr5","7773383","7773699","GL873541","16268070","16268366","98","8494687"
"chr5","7964407","7964709","GL873667","4451263","4451534","98","3513144"
"chr5","8085876","8086176","GL873541","16268070","16268366","89","8182194"
"chr5","8416289","8416592","GL873528","36697151","36697434","93","28280862"
"chr5","8452769","8452882","GL873622","7076274","7076365","45","1376495"
"chr5","8486852","8487161","GL873541","16268070","16268366","92","7781218"
"chr5","8522815","8522957","GL873550","5998776","5998900","49","2524039"
"chr5","8523254","8523384","GL873550","5998776","5998900","57","2524478"
"chr5","8592767","8593093","GL873541","16268070","16268366","104","7675303"
"chr5","8620824","8621131","GL873541","16268070","16268366","92","7647246"
"chr5","8635602","8635904","GL873541","16268070","16268366","89","7632468"
"chr5","9525581","9525872","GL873547","2222074","2222356","83","7303507"
"chr5","10684080","10684389","GL873541","16268070","16268366","91","5583990"
"chr5","10773138","10773407","GL873565","12307556","12307825","94","1534418"
"chr5","10824452","10824759","GL873541","16268070","16268366","89","5443618"
"chr5","10938981","10939201","GL873528","25203621","25203847","86","14264640"
"chr5","11011822","11012097","GL873547","2222074","2222356","90","8789748"
"chr5","11086039","11086329","GL873541","16268070","16268366","87","5182031"
"chr5","11443215","11443517","GL873541","16268070","16268366","92","4824855"
"chr5","11792904","11793204","GL873530","16647228","16647517","85","4854324"
"chr5","12075297","12075602","GL873528","36697151","36697434","90","24621854"
"chr5","12096818","12097110","GL873530","16647228","16647517","79","4550410"
"chr5","12500001","12500225","GL873557","3858721","3858924","74","8641280"
"chr5","13045752","13045988","GL873528","25203621","25203847","90","12157869"
"chr5","13049151","13049451","GL873541","16268070","16268366","87","3218919"
"chr5","13147332","13147640","GL873541","16268070","16268366","90","3120738"
"chr5","13152570","13152862","GL873530","16647228","16647517","81","3494658"
"chr5","13172968","13173157","GL873630","2508568","2508753","70","10664400"
"chr5","13357154","13357277","GL873552","12711845","12711956","50","645309"
"chr5","13794232","13794494","GL873565","12307556","12307825","92","1486676"
"chr5","13817613","13817918","GL873541","16268070","16268366","91","2450457"
"chr5","14014957","14015112","GL873530","5593486","5593649","57","8421471"
"chr5","14139090","14139392","GL873541","16268070","16268366","76","2128980"
"chr5","14187319","14187618","GL873528","36697151","36697434","90","22509832"
"chr5","14188445","14188456","GL873691","2903502","2903535","23","11284943"
"chr5","14188492","14188770","GL873547","2222074","2222356","92","11966418"
"chr5","14198316","14198616","GL873541","16268070","16268366","78","2069754"
"chr5","14218217","14218516","GL873541","16268070","16268366","83","2049853"
"chr5","14248550","14248851","GL873541","16268070","16268366","93","2019520"
"chr5","14308413","14308583","GL873585","9209559","9209725","61","5098854"
"chr5","14348561","14348863","GL873530","16647228","16647517","93","2298667"
"chr5","14396960","14397193","GL873630","2508568","2508753","84","11888392"
"chr5","14554853","14555151","GL873541","16268070","16268366","89","1713217"
"chr5","14683331","14683646","GL873608","6630366","6630673","97","8052965"
"chr5","14905530","14905745","GL873680","3005257","3005482","77","11900273"
"chr5","15018258","15018547","GL873530","16647228","16647517","92","1628970"
"chr5","15436309","15436599","GL873659","913070","913333","86","14523239"
"chr5","15593128","15593380","GL873528","25203621","25203847","82","9610493"
"chr5","15631627","15631930","GL873541","16268070","16268366","82","636443"
"chr5","15675488","15675795","GL873541","16268070","16268366","94","592582"
"chr5","15825478","15825762","GL873530","16647228","16647517","83","821750"
"chr5","16452354","16452474","GL873622","7076274","7076365","48","9376080"
"chr5","16552891","16553190","GL873541","16268070","16268366","84","284821"
"chr5","16845146","16845444","GL873528","36697151","36697434","88","19852005"
"chr5","17047031","17047324","GL873541","16268070","16268366","85","778961"
"chr5","17089691","17089976","GL873547","2222074","2222356","89","14867617"
"chr5","17127346","17127649","GL873667","4451263","4451534","96","12676083"
"chr5","17275333","17275653","GL873530","16647228","16647517","101","628105"
"chr5","17774575","17774803","GL873557","3858721","3858924","74","13915854"
"chr5","17834793","17835078","GL873607","1418062","1418355","90","16416731"
"chr5","18024245","18024538","GL873530","16647228","16647517","74","1377017"
"chr5","18174098","18174398","GL873541","16268070","16268366","87","1906028"
"chr5","18812184","18812478","GL873607","1418062","1418355","84","17394122"
"chr5","18894425","18894562","GL873550","5998776","5998900","57","12895649"
"chr5","18961215","18961512","GL873541","16268070","16268366","81","2693145"
"chr5","19308389","19308684","GL873530","16647228","16647517","90","2661161"
"chr5","19508317","19508613","GL873541","16268070","16268366","88","3240247"
"chr5","19938843","19939015","GL873530","5593486","5593649","44","14345357"
"chr5","21234566","21234683","GL873622","7076274","7076365","46","14158292"
"chr5","21268347","21268633","GL873547","2222074","2222356","84","19046273"
"chr5","21679185","21679468","GL873547","2222074","2222356","84","19457111"
"chr5","21993783","21994011","GL873538","2567037","2567262","77","19426746"
"chr5","22905442","22905727","GL873547","2222074","2222356","79","20683368"
"chr5","23010177","23010233","GL873527","37742071","37742124","22","14731894"
"chr5","23063378","23063665","GL873547","2222074","2222356","80","20841304"
"chr5","23433036","23433330","GL873541","16268070","16268366","80","7164966"
"chr5","23442343","23442622","GL873547","2222074","2222356","80","21220269"
"chr5","23694768","23695068","GL873528","36697151","36697434","91","13002383"
"chr5","23857201","23857369","GL873530","5593486","5593649","50","18263715"
"chr5","24017386","24017690","GL873528","36697151","36697434","91","12679765"
"chr5","24261288","24261580","GL873541","16268070","16268366","91","7993218"
"chr5","24852161","24852433","GL873667","4451263","4451534","87","20400898"
"chr5","24868108","24868406","GL873530","16647228","16647517","87","8220880"
"chr5","24978166","24978457","GL873530","16647228","16647517","82","8330938"
"chr5","25044505","25044772","GL873565","12307556","12307825","90","12736949"
"chr5","25924274","25924560","GL873547","2222074","2222356","84","23702200"
"chr5","25933140","25933266","GL873622","7076274","7076365","51","18856866"
"chr5","25969437","25969747","GL873528","36697151","36697434","98","10727714"
"chr5","26026229","26026536","GL873541","16268070","16268366","81","9758159"
"chr5","26108737","26108888","GL873541","1550303","1550443","52","24558434"
"chr5","26136499","26136633","GL873550","5998776","5998900","41","20137723"
"chr5","26136927","26136938","GL873691","2903502","2903535","24","23233425"
"chr5","26162823","26163130","GL873541","16268070","16268366","89","9894753"
"chr5","26202803","26203112","GL873528","36697151","36697434","97","10494348"
"chr5","26250500","26250802","GL873541","16268070","16268366","83","9982430"
"chr5","26327986","26328184","GL873693","2625207","2625379","54","23702779"
"chr5","26398215","26398518","GL873541","16268070","16268366","93","10130145"
"chr5","26491060","26491223","GL873530","5593486","5593649","48","20897574"
"chr5","26527272","26527384","GL873524","43272658","43272747","52","16745386"
"chr5","26568928","26569231","GL873608","6630366","6630673","92","19938562"
"chr5","26586506","26586810","GL873541","16268070","16268366","83","10318436"
"chr5","26714462","26714737","GL873565","12307556","12307825","94","14406906"
"chr5","26715790","26716088","GL873541","16268070","16268366","77","10447720"
"chr5","26735308","26735442","GL873550","5998776","5998900","36","20736532"
"chr5","26735743","26735929","GL873530","5593486","5593649","59","21142257"
"chr5","26789060","26789247","GL873530","5593486","5593649","67","21195574"
"chr5","26884776","26885075","GL873530","16647228","16647517","84","10237548"
"chr5","27021691","27021898","GL873535","24407607","24407780","69","2614084"
"chr5","27320796","27321102","GL873541","16268070","16268366","95","11052726"
"chr5","27334768","27335067","GL873530","16647228","16647517","86","10687540"
"chr5","27366001","27366319","GL873528","36697151","36697434","102","9331150"
"chr5","27379020","27379315","GL873547","2222074","2222356","81","25156946"
"chr5","27458400","27458707","GL873541","16268070","16268366","96","11190330"
"chr5","27478830","27479130","GL873541","16268070","16268366","84","11210760"
"chr5","27721310","27721636","GL873541","16268070","16268366","109","11453240"
"chr5","28019402","28019692","GL873530","16647228","16647517","93","11372174"
"chr5","28141689","28141978","GL873541","16268070","16268366","92","11873619"
"chr5","28803934","28804215","GL873530","16647228","16647517","97","12156706"
"chr5","31524831","31525118","GL873565","12307556","12307825","95","19217275"
"chr5","31772135","31772431","GL873547","2222074","2222356","86","29550061"
"chr5","31903242","31903538","GL873530","16647228","16647517","85","15256014"
"chr5","32317760","32318052","GL873547","2222074","2222356","79","30095686"
"chr5","32345127","32345259","GL873619","2497092","2497229","54","29848035"
"chr5","32589331","32589640","GL873541","16268070","16268366","90","16321261"
"chr5","32677022","32677328","GL873541","16268070","16268366","88","16408952"
"chr5","32711590","32711864","GL873562","3299887","3300144","85","29411703"
"chr5","32762367","32762666","GL873541","16268070","16268366","87","16494297"
"chr5","32820601","32820910","GL873541","16268070","16268366","96","16552531"
"chr5","32985467","32985765","GL873547","2222074","2222356","90","30763393"
"chr5","33058717","33059006","GL873547","2222074","2222356","92","30836643"
"chr5","33752677","33752967","GL873528","36697151","36697434","86","2944474"
"chr5","34149578","34149877","GL873530","16647228","16647517","89","17502350"
"chr5","34199615","34199685","GL873691","1645655","1645707","35","32553960"
"chr5","34361928","34362228","GL873541","16268070","16268366","74","18093858"
"chr5","35527839","35528147","GL873608","6630366","6630673","93","28897473"
"chr5","35670617","35670917","GL873541","16268070","16268366","92","19402547"
"chr5","35673928","35674232","GL873547","2222074","2222356","103","33451854"
"chr5","35781887","35782186","GL873547","2222074","2222356","88","33559813"
"chr5","35961442","35961590","GL873550","5998776","5998900","52","29962666"
"chr5","36011819","36012117","GL873541","16268070","16268366","92","19743749"
"chr5","36214286","36214586","GL873530","16647228","16647517","89","19567058"
"chr5","36822671","36822777","GL873546","7627047","7627148","35","29195624"
"chr5","36841858","36842169","GL873528","36697151","36697434","105","144707"
"chr5","38089293","38089622","GL873530","16647228","16647517","112","21442065"
"chr5","38130069","38130369","GL873541","16268070","16268366","90","21861999"
"chr5","38616107","38616411","GL873541","16268070","16268366","90","22348037"
"chr5","38877798","38878102","GL873608","6630366","6630673","83","32247432"
"chr5","39245444","39245739","GL873530","16647228","16647517","88","22598216"
"chr5","39313832","39314136","GL873541","16268070","16268366","90","23045762"
"chr5","39493566","39493868","GL873541","16268070","16268366","84","23225496"
"chr5","40121650","40121947","GL873667","4451263","4451534","95","35670387"
"chr5","40797839","40798128","GL873541","16268070","16268366","99","24529769"
"chr5","42181877","42182168","GL873547","2222074","2222356","81","39959803"
"chr5","42741407","42741679","GL873565","12307556","12307825","99","30433851"
"chr5","42930459","42930742","GL873530","16647228","16647517","89","26283231"
"chr5","43917989","43918246","GL873535","4830564","4830824","89","39087425"
"chr5","43989885","43990146","GL873535","4830564","4830824","88","39159321"
"chr5","44027879","44028194","GL873541","16268070","16268366","100","27759809"
"chr5","44499469","44499605","GL873541","1550303","1550443","54","42949166"
"chr5","44590847","44590967","GL873622","7076274","7076365","55","37514573"
"chr5","44721639","44721877","GL873543","13038674","13038909","97","31682965"
"chr5","44935769","44936070","GL873541","16268070","16268366","87","28667699"
"chr5","45237922","45238211","GL873541","16268070","16268366","90","28969852"
"chr5","45398070","45398367","GL873541","16268070","16268366","87","29130000"
"chr5","46180774","46181070","GL873530","16647228","16647517","86","29533546"
"chr5","46405447","46405755","GL873541","16268070","16268366","96","30137377"
"chr5","46609143","46609429","GL873547","2222074","2222356","87","44387069"
"chr5","47269444","47269766","GL873528","36697151","36697434","104","10572293"
"chr5","47696213","47696511","GL873541","16268070","16268366","89","31428143"
"chr5","47801337","47801665","GL873541","16268070","16268366","111","31533267"
"chr5","48794817","48794876","GL873554","10500008","10500061","16","38294809"
"chr5","48929246","48929551","GL873530","16647228","16647517","95","32282018"
"chr5","49048681","49048953","GL873528","36697151","36697434","97","12351530"
"chr5","49217739","49218030","GL873547","2222074","2222356","88","46995665"
"chr5","49291944","49292253","GL873659","913070","913333","101","48378874"
"chr5","49568120","49568383","GL873547","2222074","2222356","88","47346046"
"chr5","49897782","49898065","GL873547","2222074","2222356","80","47675708"
"chr5","50016290","50016499","GL873528","25203621","25203847","74","24812669"
"chr5","50397998","50398292","GL873547","2222074","2222356","83","48175924"
"chr5","50816609","50816913","GL873541","16268070","16268366","98","34548539"
"chr5","50869557","50869819","GL873680","3005257","3005482","98","47864300"
"chr5","51020573","51020870","GL873541","16268070","16268366","82","34752503"
"chr5","51819593","51819888","GL873541","16268070","16268366","85","35551523"
"chr5","52301833","52302110","GL873562","3299887","3300144","92","49001946"
"chr5","52401150","52401448","GL873541","16268070","16268366","84","36133080"
"chr5","52456603","52456912","GL873541","16268070","16268366","88","36188533"
"chr5","52763847","52764135","GL873547","2222074","2222356","86","50541773"
"chr5","52819060","52819345","GL873530","16647228","16647517","90","36171832"
"chr5","52998685","52998970","GL873547","2222074","2222356","86","50776611"
"chr5","53063323","53063617","GL873541","16268070","16268366","85","36795253"
"chr5","53115080","53115359","GL873547","2222074","2222356","89","50893006"
"chr5","53117243","53117523","GL873547","2222074","2222356","88","50895169"
"chr5","53126152","53126269","GL873550","5998776","5998900","46","47127376"
"chr5","53126639","53126932","GL873541","16268070","16268366","85","36858569"
"chr5","53178607","53178883","GL873547","2222074","2222356","95","50956533"
"chr5","53275481","53275764","GL873541","16268070","16268366","92","37007411"
"chr5","53285593","53285884","GL873547","2222074","2222356","78","51063519"
"chr5","53503219","53503505","GL873547","2222074","2222356","78","51281145"
"chr5","53605194","53605490","GL873541","16268070","16268366","84","37337124"
"chr5","53612869","53613171","GL873541","16268070","16268366","88","37344799"
"chr5","53658885","53659206","GL873541","16268070","16268366","114","37390815"
"chr5","53686310","53686602","GL873659","913070","913333","96","52773240"
"chr5","54600933","54601231","GL873541","16268070","16268366","83","38332863"
"chr5","54825245","54825525","GL873547","2222074","2222356","86","52603171"
"chr5","54895761","54895974","GL873554","16339732","16339922","67","38556029"
"chr5","54909540","54909828","GL873547","2222074","2222356","89","52687466"
"chr5","55077408","55077713","GL873541","16268070","16268366","88","38809338"
"chr5","55179159","55179451","GL873530","16647228","16647517","78","38531931"
"chr5","55258104","55258323","GL873823","304319","304508","74","54953785"
"chr5","56224591","56224886","GL873541","16268070","16268366","87","39956521"
"chr5","56318780","56319084","GL873528","36697151","36697434","93","19621629"
"chr5","56326093","56326386","GL873752","427788","428097","82","55898305"
"chr5","56561173","56561481","GL873541","16268070","16268366","93","40293103"
"chr5","56830114","56830393","GL873562","3299887","3300144","91","53530227"
"chr5","56854328","56854613","GL873530","16647228","16647517","77","40207100"
"chr5","57024929","57025233","GL873541","16268070","16268366","90","40756859"
"chr5","57508889","57509197","GL873541","16268070","16268366","97","41240819"
"chr5","57592055","57592355","GL873541","16268070","16268366","80","41323985"
"chr5","57617761","57618066","GL873530","16647228","16647517","90","40970533"
"chr5","57760857","57761160","GL873541","16268070","16268366","95","41492787"
"chr5","57963178","57963416","GL873528","25203621","25203847","83","32759557"
"chr5","58048044","58048323","GL873547","2222074","2222356","92","55825970"
"chr5","58083773","58084055","GL873547","2222074","2222356","83","55861699"
"chr5","58400847","58401143","GL873530","16647228","16647517","88","41753619"
"chr5","58570534","58570829","GL873541","16268070","16268366","84","42302464"
"chr5","58697889","58698179","GL873547","2222074","2222356","90","56475815"
"chr5","58728971","58729249","GL873530","16647228","16647517","88","42081743"
"chr5","58744327","58744642","GL873541","16268070","16268366","90","42476257"
"chr5","58786826","58787128","GL873607","1418062","1418355","87","57368764"
"chr5","58804401","58804706","GL873541","16268070","16268366","91","42536331"
"chr5","59135017","59135312","GL873667","4451263","4451534","94","54683754"
"chr5","59182441","59182727","GL873530","16647228","16647517","79","42535213"
"chr5","59213077","59213388","GL873541","16268070","16268366","95","42945007"
"chr5","59311262","59311556","GL873530","16647228","16647517","80","42664034"
"chr5","59448143","59448449","GL873541","16268070","16268366","97","43180073"
"chr5","59460120","59460252","GL873541","1550303","1550443","52","57909817"
"chr5","59585562","59585855","GL873659","913070","913333","91","58672492"
"chr5","59623239","59623540","GL873541","16268070","16268366","95","43355169"
"chr5","59823557","59823855","GL873547","2222074","2222356","89","57601483"
"chr5","59859588","59859879","GL873547","2222074","2222356","88","57637514"
"chr5","59961619","59961919","GL873541","16268070","16268366","88","43693549"
"chr5","60081803","60082112","GL873528","36697151","36697434","99","23384652"
"chr5","60383314","60383607","GL873659","913070","913333","89","59470244"
"chr5","60509808","60510109","GL873607","1418062","1418355","93","59091746"
"chr5","60542028","60542347","GL873541","16268070","16268366","108","44273958"
"chr5","60551584","60551875","GL873547","2222074","2222356","81","58329510"
"chr5","60561649","60561955","GL873530","16647228","16647517","96","43914421"
"chr5","60662262","60662557","GL873541","16268070","16268366","81","44394192"
"chr5","60688846","60689113","GL873680","3005257","3005482","95","57683589"
"chr5","60824315","60824624","GL873752","427788","428097","89","60396527"
"chr5","61000001","61000165","GL873541","1550303","1550443","67","59449698"
"chr5","61098134","61098429","GL873541","16268070","16268366","86","44830064"
"chr5","61163693","61163994","GL873530","16647228","16647517","92","44516465"
"chr5","61301603","61301897","GL873547","2222074","2222356","84","59079529"
"chr5","61385422","61385725","GL873541","16268070","16268366","84","45117352"
"chr5","61407809","61408111","GL873607","1418062","1418355","91","59989747"
"chr5","62110575","62110883","GL873541","16268070","16268366","90","45842505"
"chr5","62601202","62601507","GL873541","16268070","16268366","86","46333132"
"chr5","62606906","62607072","GL873530","5593486","5593649","41","57013420"
"chr5","62618626","62618927","GL873547","2222074","2222356","85","60396552"
"chr5","62734556","62734837","GL873667","4451263","4451534","98","58283293"
"chr5","62952724","62953028","GL873528","36697151","36697434","92","26255573"
"chr5","63341434","63341671","GL873680","3005257","3005482","69","60336177"
"chr5","63715133","63715428","GL873541","16268070","16268366","83","47447063"
"chr5","64143057","64143366","GL873608","6630366","6630673","95","57512691"
"chr5","64574523","64574813","GL873547","2222074","2222356","85","62352449"
"chr5","64822530","64822834","GL873607","1418062","1418355","93","63404468"
"chr5","65180409","65180667","GL873680","3005257","3005482","87","62175152"
"chr5","66071789","66072080","GL873659","913070","913333","81","65158719"
"chr5","66352492","66352757","GL873528","36697151","36697434","91","29655341"
"chr5","66362355","66362668","GL873541","16268070","16268366","98","50094285"
"chr5","66420515","66420816","GL873541","16268070","16268366","86","50152445"
"chr5","66452880","66453187","GL873547","2222074","2222356","85","64230806"
"chr5","66698782","66699090","GL873528","36697151","36697434","120","30001631"
"chr5","66805828","66806143","GL873608","6630366","6630673","102","60175462"
"chr5","68931470","68931751","GL873562","3299887","3300144","85","65631583"
"chr5","68988585","68988863","GL873547","2222074","2222356","92","66766511"
"chr5","69299877","69300170","GL873547","2222074","2222356","75","67077803"
"chr5","69551327","69551602","GL873608","6630366","6630673","102","62920961"
"chr5","69599282","69599452","GL873530","5593486","5593649","55","64005796"
"chr5","69611985","69612280","GL873547","2222074","2222356","89","67389911"
"chr5","69888466","69888766","GL873541","16268070","16268366","82","53620396"
"chr5","70104459","70104602","GL873550","5998776","5998900","57","64105683"
"chr5","70321221","70321359","GL873541","1550303","1550443","57","68770918"
"chr5","70426117","70426301","GL873524","42560728","42560902","53","27865389"
"chr5","70455154","70455449","GL873547","2222074","2222356","86","68233080"
"chr5","70640572","70640701","GL873550","5998776","5998900","34","64641796"
"chr5","70640719","70641012","GL873547","2222074","2222356","98","68418645"
"chr5","71122050","71122197","GL873585","9209559","9209725","51","61912491"
"chr5","71345812","71346114","GL873530","16647228","16647517","91","54698584"
"chr5","72021457","72021750","GL873528","36697151","36697434","108","35324306"
"chr5","72051782","72052054","GL873528","36697151","36697434","92","35354631"
"chr5","72199351","72199647","GL873547","2222074","2222356","83","69977277"
"chr5","72531006","72531315","GL873541","16268070","16268366","99","56262936"
"chr5","72789102","72789412","GL873541","16268070","16268366","88","56521032"
"chr5","73081706","73081993","GL873541","16268070","16268366","99","56813636"
"chr5","73283924","73284233","GL873607","1418062","1418355","89","71865862"
"chr5","73917182","73917479","GL873541","16268070","16268366","88","57649112"
"chr5","73939526","73939822","GL873530","16647228","16647517","84","57292298"
"chr5","74278756","74278811","GL873603","2092652","2092704","29","72186104"
"chr5","75007005","75007203","GL873823","304319","304508","62","74702686"
"chr5","75051854","75052150","GL873547","2222074","2222356","81","72829780"
"chr5","75072071","75072324","GL873659","913070","913333","76","74159001"
"chr5","75157259","75157399","GL873550","5998776","5998900","41","69158483"
"chr5","75158813","75159122","GL873541","16268070","16268366","86","58890743"
"chr6","1834902","1835193","GL873547","2222074","2222356","80","387172"
"chr6","15073070","15073386","GL873541","16268070","16268366","98","1195000"
"chr6","7057","7319","GL873547","2222074","2222356","93","2215017"
"chr6","409960","410262","GL873541","16268070","16268366","86","15858110"
"chr6","419435","419732","GL873530","16647228","16647517","79","16227793"
"chr6","524480","524618","GL873587","10002051","10002151","59","9477571"
"chr6","672671","672973","GL873530","16647228","16647517","98","15974557"
"chr6","734907","735191","GL873547","2222074","2222356","85","1487167"
"chr6","960893","961189","GL873530","16647228","16647517","88","15686335"
"chr6","1136364","1136672","GL873530","16647228","16647517","89","15510864"
"chr6","1215950","1216241","GL873547","2222074","2222356","88","1006124"
"chr6","2002271","2002438","GL873530","5593486","5593649","45","3591215"
"chr6","2059086","2059384","GL873528","36697151","36697434","84","34638065"
"chr6","2172009","2172246","GL873528","25203621","25203847","75","23031612"
"chr6","2235183","2235482","GL873541","16268070","16268366","90","14032887"
"chr6","2678488","2678781","GL873547","2222074","2222356","86","456414"
"chr6","3646070","3646335","GL873659","913070","913333","84","2733000"
"chr6","3660529","3660831","GL873541","16268070","16268366","88","12607541"
"chr6","3926445","3926746","GL873530","16647228","16647517","89","12720783"
"chr6","3930503","3930591","GL873520","23895808","23895898","37","19965305"
"chr6","3974552","3974843","GL873547","2222074","2222356","79","1752478"
"chr6","4052562","4052861","GL873530","16647228","16647517","86","12594666"
"chr6","4074649","4074950","GL873530","16647228","16647517","96","12572579"
"chr6","4117409","4117710","GL873541","16268070","16268366","90","12150661"
"chr6","4195999","4196304","GL873541","16268070","16268366","94","12072071"
"chr6","4289783","4290054","GL873562","3299887","3300144","86","989896"
"chr6","4352025","4352345","GL873541","16268070","16268366","96","11916045"
"chr6","4421814","4422096","GL873528","36697151","36697434","94","32275337"
"chr6","4460632","4460822","GL873697","3111225","3111427","58","1349407"
"chr6","4470814","4470996","GL873530","5593486","5593649","61","1122672"
"chr6","4471309","4471442","GL873550","5998776","5998900","36","1527467"
"chr6","4605883","4606176","GL873547","2222074","2222356","86","2383809"
"chr6","4607954","4608251","GL873530","16647228","16647517","94","12039274"
"chr6","5274722","5275018","GL873530","16647228","16647517","83","11372506"
"chr6","5326150","5326458","GL873541","16268070","16268366","97","10941920"
"chr6","5826877","5827168","GL873541","16268070","16268366","77","10441193"
"chr6","5829024","5829329","GL873541","16268070","16268366","90","10439046"
"chr6","5950273","5950578","GL873607","1418062","1418355","93","4532211"
"chr6","5968140","5968449","GL873541","16268070","16268366","92","10299930"
"chr6","6166086","6166377","GL873530","16647228","16647517","80","10481142"
"chr6","6217754","6218043","GL873547","2222074","2222356","84","3995680"
"chr6","6359779","6360068","GL873530","16647228","16647517","92","10287449"
"chr6","6580883","6581170","GL873547","2222074","2222356","104","4358809"
"chr6","6600237","6600537","GL873530","16647228","16647517","94","10046991"
"chr6","6607557","6607844","GL873541","16268070","16268366","85","9660513"
"chr6","6659482","6659779","GL873541","16268070","16268366","86","9608588"
"chr6","6839496","6839780","GL873528","36697151","36697434","96","29857655"
"chr6","6895400","6895701","GL873541","16268070","16268366","87","9372670"
"chr6","6976403","6976632","GL873538","2567037","2567262","69","4409366"
"chr6","7079762","7079989","GL873531","3555300","3555500","73","3524462"
"chr6","7226111","7226410","GL873547","2222074","2222356","92","5004037"
"chr6","7321959","7322011","GL873554","10500008","10500061","20","3178049"
"chr6","7393071","7393381","GL873530","16647228","16647517","101","9254157"
"chr6","7704476","7704617","GL873550","5998776","5998900","46","1705700"
"chr6","7742559","7742713","GL873574","7318344","7318500","63","424215"
"chr6","7790540","7790840","GL873530","16647228","16647517","88","8856688"
"chr6","8264535","8264832","GL873541","16268070","16268366","80","8003535"
"chr6","8326203","8326512","GL873541","16268070","16268366","87","7941867"
"chr6","8448101","8448397","GL873607","1418062","1418355","88","7030039"
"chr6","8515911","8516193","GL873547","2222074","2222356","84","6293837"
"chr6","8575416","8575668","GL873680","3005257","3005482","100","5570159"
"chr6","8595798","8596126","GL873541","16268070","16268366","109","7672272"
"chr6","8634857","8635167","GL873541","16268070","16268366","87","7633213"
"chr6","8728657","8728838","GL873530","5593486","5593649","59","3135171"
"chr6","8778755","8779051","GL873530","16647228","16647517","83","7868473"
"chr6","8818794","8819102","GL873541","16268070","16268366","95","7449276"
"chr6","9014692","9014992","GL873541","16268070","16268366","88","7253378"
"chr6","9130512","9130814","GL873541","16268070","16268366","92","7137558"
"chr6","9253209","9253500","GL873547","2222074","2222356","81","7031135"
"chr6","9333797","9334084","GL873547","2222074","2222356","81","7111723"
"chr6","9512040","9512178","GL873550","5998776","5998900","40","3513264"
"chr6","9521176","9521483","GL873541","16268070","16268366","90","6746894"
"chr6","9550495","9550686","GL873823","304319","304508","52","9246176"
"chr6","9600277","9600585","GL873541","16268070","16268366","89","6667793"
"chr6","9604562","9604849","GL873547","2222074","2222356","82","7382488"
"chr6","9713724","9714033","GL873541","16268070","16268366","89","6554346"
"chr6","9931908","9932038","GL873550","5998776","5998900","32","3933132"
"chr6","9932043","9932339","GL873541","16268070","16268366","84","6336027"
"chr6","9984726","9984998","GL873659","913070","913333","80","9071656"
"chr6","10057203","10057486","GL873547","2222074","2222356","84","7835129"
"chr6","10066569","10066858","GL873530","16647228","16647517","82","6580659"
"chr6","10072412","10072486","GL873526","41481654","41481719","25","31409242"
"chr6","10140058","10140347","GL873547","2222074","2222356","81","7917984"
"chr6","10179837","10180133","GL873530","16647228","16647517","83","6467391"
"chr6","10254804","10255108","GL873541","16268070","16268366","92","6013266"
"chr6","10292704","10293001","GL873530","16647228","16647517","90","6354524"
"chr6","10335041","10335331","GL873547","2222074","2222356","77","8112967"
"chr6","10364417","10364709","GL873547","2222074","2222356","83","8142343"
"chr6","10520211","10520321","GL873526","41480965","41481045","48","30960754"
"chr6","10540061","10540366","GL873541","16268070","16268366","92","5728009"
"chr6","10613040","10613338","GL873541","16268070","16268366","80","5655030"
"chr6","10813838","10814113","GL873562","3299887","3300144","95","7513951"
"chr6","10866576","10866746","GL873524","42560728","42560902","57","31694152"
"chr6","10963028","10963286","GL873562","3299887","3300144","83","7663141"
"chr6","11109008","11109077","GL873691","1645655","1645707","35","9463353"
"chr6","11109295","11109311","GL873691","2903502","2903535","22","8205793"
"chr6","11124626","11124914","GL873547","2222074","2222356","78","8902552"
"chr6","11215683","11215935","GL873543","13038674","13038909","82","1822991"
"chr6","11340998","11341271","GL873562","3299887","3300144","94","8041111"
"chr6","11531294","11531588","GL873530","16647228","16647517","91","5115934"
"chr6","11553526","11553659","GL873550","5998776","5998900","41","5554750"
"chr6","11731789","11732083","GL873530","16647228","16647517","78","4915439"
"chr6","11844044","11844146","GL873524","43272658","43272747","40","31428614"
"chr6","11855994","11856193","GL873535","24407607","24407780","58","12551613"
"chr6","11860560","11860869","GL873541","16268070","16268366","98","4407510"
"chr6","12057552","12057827","GL873535","4830564","4830824","98","7226988"
"chr6","12149057","12149346","GL873547","2222074","2222356","79","9926983"
"chr6","12396081","12396390","GL873541","16268070","16268366","90","3871989"
"chr6","12397624","12397929","GL873607","1418062","1418355","96","10979562"
"chr6","12451422","12451661","GL873528","25203621","25203847","86","12752199"
"chr6","12469520","12469644","GL873619","2497092","2497229","51","9972428"
"chr6","12566317","12566375","GL873527","37742071","37742124","23","25175754"
"chr6","12588115","12588415","GL873608","6630366","6630673","80","5957749"
"chr6","12625993","12626287","GL873547","2222074","2222356","90","10403919"
"chr6","12654543","12654836","GL873530","16647228","16647517","84","3992685"
"chr6","12664043","12664255","GL873630","2508568","2508753","78","10155475"
"chr6","12891724","12892015","GL873530","16647228","16647517","81","3755504"
"chr6","12995139","12995204","GL873527","37742071","37742124","28","24746932"
"chr6","13075381","13075667","GL873547","2222074","2222356","86","10853307"
"chr6","13187870","13188002","GL873550","5998776","5998900","40","7189094"
"chr6","13267855","13268127","GL873541","16268070","16268366","91","3000215"
"chr6","13476172","13476428","GL873680","3005257","3005482","85","10470915"
"chr6","13510002","13510305","GL873541","16268070","16268366","80","2758068"
"chr6","13551926","13552059","GL873550","5998776","5998900","51","7553150"
"chr6","13630052","13630352","GL873541","16268070","16268366","91","2638018"
"chr6","13633461","13633769","GL873547","2222074","2222356","86","11411387"
"chr6","13675822","13676131","GL873667","4451263","4451534","93","9224559"
"chr6","13689310","13689592","GL873547","2222074","2222356","77","11467236"
"chr6","13748455","13748744","GL873530","16647228","16647517","90","2898773"
"chr6","13795451","13795605","GL873530","5593486","5593649","54","8201965"
"chr6","13795980","13796274","GL873541","16268070","16268366","92","2472090"
"chr6","13900198","13900483","GL873530","16647228","16647517","90","2747030"
"chr6","13913107","13913406","GL873541","16268070","16268366","87","2354963"
"chr6","14015955","14016254","GL873541","16268070","16268366","92","2252115"
"chr6","14093262","14093526","GL873659","913070","913333","97","13180192"
"chr6","14168551","14168844","GL873528","36697151","36697434","99","22528600"
"chr6","14195319","14195628","GL873541","16268070","16268366","96","2072751"
"chr6","14432972","14433266","GL873547","2222074","2222356","82","12210898"
"chr6","14588703","14589006","GL873528","36697151","36697434","93","22108448"
"chr6","14665723","14665938","GL873543","13038674","13038909","80","1627049"
"chr6","14700854","14701130","GL873680","3005257","3005482","107","11695597"
"chr6","14781892","14782193","GL873607","1418062","1418355","90","13363830"
"chr6","14852108","14852417","GL873541","16268070","16268366","92","1415962"
"chr6","14981710","14982031","GL873528","36697151","36697434","100","21715441"
"chr6","15004939","15005239","GL873541","16268070","16268366","80","1263131"
"chr6","15019743","15019968","GL873531","3555300","3555500","66","11464443"
"chr6","15375419","15375710","GL873547","2222074","2222356","84","13153345"
"chr6","15817692","15817995","GL873541","16268070","16268366","91","450378"
"chr6","15881889","15882179","GL873530","16647228","16647517","81","765339"
"chr6","15883873","15884100","GL873538","2567037","2567262","68","13316836"
"chr6","16068570","16068846","GL873547","2222074","2222356","91","13846496"
"chr6","16393117","16393286","GL873529","2453810","2453957","65","13939307"
"chr6","16749695","16749759","GL873554","10500008","10500061","21","6249687"
"chr6","16770305","16770602","GL873541","16268070","16268366","98","502235"
"chr6","16796004","16796335","GL873541","16268070","16268366","116","527934"
"chr6","16827841","16828125","GL873528","36697151","36697434","101","19869310"
"chr6","16868585","16868872","GL873547","2222074","2222356","80","14646511"
"chr6","16935358","16935648","GL873530","16647228","16647517","78","288130"
"chr6","17068605","17068897","GL873530","16647228","16647517","85","421377"
"chr6","17369404","17369708","GL873541","16268070","16268366","88","1101334"
"chr6","17390935","17391221","GL873565","12307556","12307825","91","5083379"
"chr6","17499337","17499593","GL873680","3005257","3005482","89","14494080"
"chr6","17503778","17504034","GL873680","3005257","3005482","89","14498521"
"chr6","17513286","17513490","GL873531","3555300","3555500","58","13957986"
"chr6","17619547","17619860","GL873528","36697151","36697434","96","19077604"
"chr6","17748730","17748781","GL873731","2008517","2008552","24","15740213"
"chr6","17748959","17749125","GL873574","7318344","7318500","56","10430615"
"chr6","17749126","17749175","GL873731","2008517","2008552","22","15740609"
"chr6","17749395","17749522","GL873550","5998776","5998900","39","11750619"
"chr6","17785992","17786292","GL873541","16268070","16268366","82","1517922"
"chr6","17822088","17822391","GL873541","16268070","16268366","85","1554018"
"chr6","17894365","17894631","GL873547","5449763","5449997","85","12444602"
"chr6","17934323","17934618","GL873547","2222074","2222356","85","15712249"
"chr6","17986464","17986776","GL873541","16268070","16268366","93","1718394"
"chr6","17998791","17999090","GL873541","16268070","16268366","86","1730721"
"chr6","18027687","18027847","GL873530","5593486","5593649","49","12434201"
"chr6","18081079","18081310","GL873528","25203621","25203847","77","7122542"
"chr6","18118955","18119355","GL873559","3737111","3737481","134","14381844"
"chr6","18258477","18258772","GL873530","16647228","16647517","91","1611249"
"chr6","18283849","18284139","GL873530","16647228","16647517","88","1636621"
"chr6","18327045","18327343","GL873530","16647228","16647517","93","1679817"
"chr6","18381048","18381335","GL873547","2222074","2222356","89","16158974"
"chr6","18389302","18389600","GL873528","36697151","36697434","95","18307849"
"chr6","18509832","18510100","GL873547","5449763","5449997","92","13060069"
"chr6","18584011","18584321","GL873547","2222074","2222356","109","16361937"
"chr6","18621982","18622283","GL873608","6630366","6630673","91","11991616"
"chr6","18634414","18634667","GL873680","3005257","3005482","82","15629157"
"chr6","18658379","18658589","GL873557","3858721","3858924","73","14799658"
"chr6","18681338","18681613","GL873528","36697151","36697434","99","18015813"
"chr6","18694445","18694724","GL873562","3299887","3300144","89","15394558"
"chr6","18711403","18711615","GL873531","3555300","3555500","69","15156103"
"chr6","18761743","18761979","GL873680","3005257","3005482","71","15756486"
"chr6","18766546","18766836","GL873530","16647228","16647517","82","2119318"
"chr6","18773772","18774088","GL873528","36697151","36697434","108","17923379"
"chr6","18802994","18803224","GL873557","3858721","3858924","87","14944273"
"chr6","18811456","18811724","GL873562","3299887","3300144","86","15511569"
"chr6","18852331","18852633","GL873530","16647228","16647517","84","2205103"
"chr6","18854826","18855127","GL873541","16268070","16268366","85","2586756"
"chr6","18856457","18856747","GL873530","16647228","16647517","79","2209229"
"chr6","18891953","18892253","GL873541","16268070","16268366","82","2623883"
"chr6","18955672","18955980","GL873541","16268070","16268366","92","2687602"
"chr6","18995033","18995335","GL873541","16268070","16268366","97","2726963"
"chr6","19271013","19271145","GL873550","5998776","5998900","36","13272237"
"chr6","19309988","19310286","GL873530","16647228","16647517","84","2662760"
"chr6","19487478","19487762","GL873547","2222074","2222356","82","17265404"
"chr6","19556533","19556792","GL873547","5449763","5449997","79","14106770"
"chr6","19611002","19611300","GL873541","16268070","16268366","82","3342932"
"chr6","19619422","19619729","GL873541","16268070","16268366","95","3351352"
"chr6","19846864","19847167","GL873528","36697151","36697434","92","16850287"
"chr6","19939041","19939336","GL873541","16268070","16268366","85","3670971"
"chr6","20181325","20181610","GL873667","4451263","4451534","93","15730062"
"chr6","20231794","20232088","GL873547","2222074","2222356","91","18009720"
"chr6","20371715","20372027","GL873541","16268070","16268366","94","4103645"
"chr6","20403523","20403807","GL873547","2222074","2222356","93","18181449"
"chr6","20405358","20405666","GL873541","16268070","16268366","97","4137288"
"chr6","20486258","20486561","GL873541","16268070","16268366","82","4218188"
"chr6","20524832","20525137","GL873547","2222074","2222356","97","18302758"
"chr6","20604921","20605215","GL873530","16647228","16647517","85","3957693"
"chr6","20730433","20730694","GL873667","4451263","4451534","93","16279170"
"chr6","20774886","20775179","GL873547","2222074","2222356","80","18552812"
"chr6","20879534","20879842","GL873541","16268070","16268366","95","4611464"
"chr6","20881494","20881803","GL873541","16268070","16268366","97","4613424"
"chr6","20891378","20891665","GL873530","16647228","16647517","82","4244150"
"chr6","21085792","21086103","GL873608","6630366","6630673","101","14455426"
"chr6","21119238","21119524","GL873547","2222074","2222356","80","18897164"
"chr6","21131745","21131971","GL873531","3555300","3555500","81","17576445"
"chr6","21215806","21216076","GL873562","3299887","3300144","82","17915919"
"chr6","21288064","21288203","GL873550","5998776","5998900","45","15289288"
"chr6","21431109","21431412","GL873541","16268070","16268366","95","5163039"
"chr6","21485777","21486069","GL873607","1418062","1418355","87","20067715"
"chr6","21576313","21576617","GL873541","16268070","16268366","92","5308243"
"chr6","21578339","21578582","GL873528","25203621","25203847","84","3625282"
"chr6","21615158","21615471","GL873541","16268070","16268366","96","5347088"
"chr6","22812294","22812593","GL873528","36697151","36697434","112","13884857"
"chr6","23642427","23642737","GL873541","16268070","16268366","88","7374357"
"chr6","23920960","23921228","GL873562","3299887","3300144","84","20621073"
"chr6","24929140","24929447","GL873607","1418062","1418355","106","23511078"
"chr6","25120377","25120396","GL873691","2903502","2903535","20","22216875"
"chr6","25120427","25120677","GL873630","2508568","2508753","96","22611859"
"chr6","25415783","25416087","GL873541","16268070","16268366","95","9147713"
"chr6","25576830","25577122","GL873530","16647228","16647517","79","8929602"
"chr6","26355914","26356221","GL873528","36697151","36697434","96","10341237"
"chr6","26593661","26593944","GL873530","16647228","16647517","84","9946433"
"chr6","26635721","26636030","GL873541","16268070","16268366","90","10367651"
"chr6","27299870","27300164","GL873541","16268070","16268366","81","11031800"
"chr6","27359988","27360296","GL873528","36697151","36697434","95","9337163"
"chr6","27462198","27462492","GL873547","2222074","2222356","85","25240124"
"chr6","27769176","27769470","GL873541","16268070","16268366","83","11501106"
"chr6","28190603","28190847","GL873547","5449763","5449997","80","22740840"
"chr6","28516028","28516241","GL873531","3555300","3555500","66","24960728"
"chr6","28536850","28537140","GL873530","16647228","16647517","79","11889622"
"chr6","28952414","28952710","GL873530","16647228","16647517","95","12305186"
"chr6","29263945","29264247","GL873528","36697151","36697434","95","7433206"
"chr6","29307068","29307396","GL873541","16268070","16268366","124","13038998"
"chr6","29326893","29327203","GL873541","16268070","16268366","93","13058823"
"chr6","29394044","29394346","GL873541","16268070","16268366","79","13125974"
"chr6","29466294","29466586","GL873530","16647228","16647517","81","12819066"
"chr6","29480212","29480322","GL873622","7076274","7076365","35","22403938"
"chr6","29664605","29664916","GL873541","16268070","16268366","97","13396535"
"chr6","29978902","29979203","GL873530","16647228","16647517","92","13331674"
"chr6","30079079","30079380","GL873541","16268070","16268366","84","13811009"
"chr6","30148587","30148895","GL873541","16268070","16268366","87","13880517"
"chr6","30660476","30660773","GL873752","427788","428097","85","30232688"
"chr6","30731657","30731958","GL873541","16268070","16268366","88","14463587"
"chr6","31000002","31000169","GL873530","5593486","5593649","61","25406516"
"chr6","31012335","31012615","GL873607","1418062","1418355","91","29594273"
"chr6","31036996","31037291","GL873547","2222074","2222356","85","28814922"
"chr6","31266140","31266475","GL873541","16268070","16268366","118","14998070"
"chr6","31277843","31278132","GL873659","913070","913333","81","30364773"
"chr6","31304931","31305237","GL873541","16268070","16268366","83","15036861"
"chr6","31343661","31343934","GL873680","3005257","3005482","102","28338404"
"chr6","31355177","31355481","GL873547","2222074","2222356","84","29133103"
"chr6","31575657","31575965","GL873528","36697151","36697434","98","5121494"
"chr6","31759631","31759931","GL873541","16268070","16268366","95","15491561"
"chr6","31992433","31992727","GL873528","36697151","36697434","88","4704718"
"chr6","32001484","32001774","GL873530","16647228","16647517","82","15354256"
"chr6","32070099","32070395","GL873541","16268070","16268366","86","15802029"
"chr6","32338202","32338477","GL873565","12307556","12307825","96","20030646"
"chr6","32749709","32750008","GL873547","2222074","2222356","81","30527635"
"chr6","32750511","32750811","GL873530","16647228","16647517","90","16103283"
"chr6","32968909","32969196","GL873547","2222074","2222356","79","30746835"
"chr6","33123269","33123569","GL873528","36697151","36697434","89","3573882"
"chr6","33161451","33161636","GL873530","5593486","5593649","62","27567965"
"chr6","33188390","33188702","GL873541","16268070","16268366","91","16920320"
"chr6","33578769","33578895","GL873552","12711845","12711956","50","20866924"
"chr6","33595384","33595692","GL873541","16268070","16268366","91","17327314"
"chr6","33618456","33618572","GL873622","7076274","7076365","40","26542182"
"chr6","33632441","33632741","GL873547","2222074","2222356","90","31410367"
"chr6","33738823","33739106","GL873541","16268070","16268366","81","17470753"
"chr6","33811352","33811518","GL873560","5855436","5855580","55","27955916"
"chr6","33839130","33839249","GL873550","5998776","5998900","43","27840354"
"chr6","33874776","33875082","GL873541","16268070","16268366","94","17606706"
"chr6","33884735","33884854","GL873550","5998776","5998900","43","27885959"
"chr6","33943883","33944057","GL873529","2453810","2453957","61","31490073"
"chr6","34319212","34319516","GL873541","16268070","16268366","89","18051142"
"chr6","34401728","34402034","GL873541","16268070","16268366","89","18133658"
"chr6","34524049","34524352","GL873528","36697151","36697434","94","2173102"
"chr6","34524610","34524898","GL873530","16647228","16647517","79","17877382"
"chr6","34888139","34888179","GL873691","2903502","2903535","18","31984637"
"chr6","35097365","35097661","GL873530","16647228","16647517","85","18450137"
"chr6","35186892","35187202","GL873528","36697151","36697434","94","1510259"
"chr6","35225208","35225505","GL873547","2222074","2222356","82","33003134"
"chr6","35228961","35229244","GL873659","913070","913333","79","34315891"
"chr6","35238025","35238103","GL873526","41480965","41481045","26","6242940"
"chr6","35238396","35238588","GL873554","16339732","16339922","63","18898664"
"chr6","35301468","35301762","GL873530","16647228","16647517","82","18654240"
"chr6","35563514","35563804","GL873541","16268070","16268366","85","19295444"
"chr6","35661566","35661675","GL873622","7076274","7076365","36","28585292"
"chr6","35690001","35690290","GL873547","2222074","2222356","85","33467927"
"chr6","35714667","35714966","GL873541","16268070","16268366","87","19446597"
"chr6","35784044","35784367","GL873541","16268070","16268366","111","19515974"
"chr6","35787759","35788073","GL873608","6630366","6630673","93","29157393"
"chr6","36277562","36277869","GL873541","16268070","16268366","87","20009492"
"chr6","36288281","36288590","GL873541","16268070","16268366","91","20020211"
"chr6","36523708","36524007","GL873547","2222074","2222356","86","34301634"
"chr6","36544223","36544528","GL873541","16268070","16268366","91","20276153"
"chr6","36569539","36569832","GL873541","16268070","16268366","94","20301469"
"chr6","36745743","36745874","GL873550","5998776","5998900","35","30746967"
"chr6","37046372","37046501","GL873622","7076274","7076365","55","29970098"
"chr6","37080139","37080396","GL873547","5449763","5449997","96","31630376"
"chr6","37243057","37243268","GL873531","3555300","3555500","67","33687757"
"chr6","37574407","37574720","GL873541","16268070","16268366","89","21306337"
"chr6","37700130","37700440","GL873541","16268070","16268366","91","21432060"
"chr6","37703627","37703760","GL873619","2497092","2497229","45","35206535"
"chr6","38224226","38224525","GL873541","16268070","16268366","87","21956156"
"chr6","38401499","38401809","GL873541","16268070","16268366","96","22133429"
"chr6","38511235","38511538","GL873541","16268070","16268366","89","22243165"
"chr6","38518813","38519120","GL873541","16268070","16268366","94","22250743"
"chr6","38525113","38525276","GL873530","5593486","5593649","50","32931627"
"chr6","38591587","38591772","GL873524","42560728","42560902","57","3969141"
"chr6","38664077","38664273","GL873697","3111225","3111427","67","35552852"
"chr6","38843176","38843318","GL873550","5998776","5998900","48","32844400"
"chr6","38857673","38857980","GL873547","2222074","2222356","95","36635599"
"chr6","38915404","38915671","GL873667","4451263","4451534","95","34464141"
"chr6","39131422","39131721","GL873608","6630366","6630673","86","32501056"
"chr6","39165108","39165288","GL873585","9209559","9209725","64","29955549"
"chr6","39188990","39189299","GL873541","16268070","16268366","94","22920920"
"chr6","39200188","39200407","GL873531","3555300","3555500","77","35644888"
"chr6","39933164","39933461","GL873530","16647228","16647517","84","23285936"
"chr6","39971719","39972008","GL873547","2222074","2222356","87","37749645"
"chr6","40152175","40152459","GL873547","2222074","2222356","93","37930101"
"chr6","40152497","40152507","GL873691","2903502","2903535","23","37248995"
"chr6","40316487","40316767","GL873547","2222074","2222356","85","38094413"
"chr6","40319371","40319672","GL873547","2222074","2222356","99","38097297"
"chr6","40467631","40467923","GL873541","16268070","16268366","84","24199561"
"chr6","40470724","40471018","GL873541","16268070","16268366","93","24202654"
"chr6","40545425","40545717","GL873547","2222074","2222356","82","38323351"
"chr6","40553473","40553784","GL873528","36697151","36697434","98","3856322"
"chr6","40572443","40572731","GL873530","16647228","16647517","81","23925215"
"chr6","40667690","40667978","GL873547","2222074","2222356","83","38445616"
"chr6","40761408","40761681","GL873528","25203621","25203847","99","15557787"
"chr6","40853500","40853668","GL873524","42560728","42560902","50","1707228"
"chr6","40853681","40853861","GL873530","5593486","5593649","52","35260195"
"chr6","40918864","40919008","GL873541","1550303","1550443","47","39368561"
"chr6","40919176","40919192","GL873691","2903502","2903535","23","38015674"
"chr6","40969610","40969790","GL873530","5593486","5593649","59","35376124"
"chr6","41197723","41197928","GL873693","2625207","2625379","70","38572516"
"chr6","41450363","41450644","GL873562","3299887","3300144","97","38150476"
"chr6","41798014","41798320","GL873541","16268070","16268366","101","25529944"
"chr6","42029376","42029671","GL873547","2222074","2222356","87","39807302"
"chr6","42205935","42206250","GL873541","16268070","16268366","98","25937865"
"chr6","42211844","42212151","GL873547","2222074","2222356","95","39989770"
"chr6","42312823","42313125","GL873547","2222074","2222356","86","40090749"
"chr6","42411295","42411593","GL873530","16647228","16647517","87","25764067"
"chr6","42473527","42473824","GL873530","16647228","16647517","83","25826299"
"chr6","42489173","42489475","GL873541","16268070","16268366","94","26221103"
"chr6","42557870","42558166","GL873541","16268070","16268366","93","26289800"
"chr6","42649829","42649957","GL873550","5998776","5998900","34","36651053"
"chr6","42658151","42658463","GL873547","2222074","2222356","94","40436077"
"chr6","42685582","42685857","GL873667","4451263","4451534","82","38234319"
"chr6","42696036","42696123","GL873521","9884269","9884347","37","32811767"
"chr6","42696409","42696543","GL873550","5998776","5998900","41","36697633"
"chr6","42701719","42701998","GL873530","16647228","16647517","91","26054491"
"chr6","42814521","42814820","GL873607","1418062","1418355","89","41396459"
"chr6","42850599","42850904","GL873541","16268070","16268366","99","26582529"
"chr6","42924119","42924422","GL873607","1418062","1418355","103","41506057"
"chr6","43196483","43196784","GL873530","16647228","16647517","86","26549255"
"chr6","43312813","43312867","GL873527","37742071","37742124","29","5570742"
"chr6","43313179","43313189","GL873691","2903502","2903535","24","40409677"
"chr6","43357442","43357739","GL873541","16268070","16268366","84","27089372"
"chr6","43429100","43429261","GL873530","5593486","5593649","46","37835614"
"chr6","43712697","43713005","GL873541","16268070","16268366","91","27444627"
"chr6","43799528","43799839","GL873541","16268070","16268366","93","27531458"
"chr6","43807734","43807857","GL873552","12711845","12711956","51","31095889"
"chr6","43814489","43814792","GL873608","6630366","6630673","99","37184123"
"chr6","43894940","43895230","GL873541","16268070","16268366","92","27626870"
"chr6","43900231","43900457","GL873680","3005257","3005482","74","40894974"
"chr6","44288782","44289079","GL873667","4451263","4451534","99","39837519"
"chr6","44360451","44360754","GL873541","16268070","16268366","93","28092381"
"chr6","44499748","44500000","GL873547","5449763","5449997","83","39049985"
"chr6","44726967","44727090","GL873550","5998776","5998900","38","38728191"
"chr6","44727396","44727576","GL873524","42560728","42560902","57","2166668"
"chr6","44959547","44959862","GL873528","36697151","36697434","99","8262396"
"chr6","45139557","45139861","GL873541","16268070","16268366","97","28871487"
"chr6","45153564","45153869","GL873541","16268070","16268366","96","28885494"
"chr6","45204746","45204963","GL873538","2567037","2567262","63","42637709"
"chr6","45212319","45212574","GL873680","3005257","3005482","87","42207062"
"chr6","45268893","45269048","GL873585","9209559","9209725","58","36059334"
"chr6","45276349","45276508","GL873611","3799989","3800137","62","41476360"
"chr6","45276812","45276943","GL873550","5998776","5998900","38","39278036"
"chr6","45298082","45298336","GL873680","3005257","3005482","94","42292825"
"chr6","45303606","45303772","GL873524","42560728","42560902","58","2742878"
"chr6","45364644","45364820","GL873530","5593486","5593649","56","39771158"
"chr6","45404844","45405129","GL873530","16647228","16647517","93","28757616"
"chr6","45405297","45405586","GL873530","16647228","16647517","91","28758069"
"chr6","45412468","45412650","GL873530","5593486","5593649","60","39818982"
"chr6","45453260","45453545","GL873530","16647228","16647517","91","28806032"
"chr6","45453713","45454008","GL873530","16647228","16647517","90","28806485"
"chr6","45482782","45482952","GL873529","2453810","2453957","63","43028972"
"chr6","45506811","45506975","GL873524","42560728","42560902","62","2946083"
"chr6","45509488","45509798","GL873541","16268070","16268366","95","29241418"
"chr6","45579600","45579859","GL873659","913070","913333","92","44666530"
"chr6","45586618","45586914","GL873547","2222074","2222356","90","43364544"
"chr6","45646329","45646508","GL873524","23693028","23693185","68","21953301"
"chr6","45751608","45751639","GL873691","2903502","2903535","10","42848106"
"chr6","45751992","45752173","GL873530","5593486","5593649","54","40158506"
"chr6","45775236","45775510","GL873547","2222074","2222356","84","43553162"
"chr6","45864958","45865249","GL873530","16647228","16647517","84","29217730"
"chr6","45915188","45915480","GL873667","4451263","4451534","87","41463925"
"chr6","45938257","45938403","GL873585","9209559","9209725","52","36728698"
"chr6","45947188","45947479","GL873547","2222074","2222356","89","43725114"
"chr6","46079297","46079413","GL873622","7076274","7076365","41","39003023"
"chr6","46083149","46083326","GL873530","5593486","5593649","58","40489663"
"chr6","46117792","46117959","GL873530","5593486","5593649","61","40524306"
"chr6","46139934","46140052","GL873622","7076274","7076365","43","39063660"
"chr6","46168037","46168160","GL873622","7076274","7076365","48","39091763"
"chr6","46170073","46170252","GL873530","5593486","5593649","56","40576587"
"chr6","46175421","46175541","GL873550","5998776","5998900","36","40176645"
"chr6","46207652","46207780","GL873622","7076274","7076365","53","39131378"
"chr6","46217489","46217813","GL873541","16268070","16268366","119","29949419"
"chr6","46356987","46357293","GL873541","16268070","16268366","89","30088917"
"chr6","46449400","46449559","GL873550","5998776","5998900","67","40450624"
"chr6","46477226","46477469","GL873543","13038674","13038909","103","33438552"
"chr6","47032560","47032866","GL873608","6630366","6630673","91","40402194"
"chr6","47105039","47105343","GL873541","16268070","16268366","89","30836969"
"chr6","47134015","47134308","GL873607","1418062","1418355","88","45715953"
"chr6","47148309","47148623","GL873528","36697151","36697434","115","10451158"
"chr6","47198378","47198509","GL873550","5998776","5998900","35","41199602"
"chr6","47227981","47228287","GL873608","6630366","6630673","96","40597615"
"chr6","47395448","47395746","GL873530","16647228","16647517","92","30748220"
"chr6","47552885","47553187","GL873608","6630366","6630673","92","40922519"
"chr6","47581758","47582042","GL873528","36697151","36697434","85","10884607"
"chr6","47650116","47650422","GL873541","16268070","16268366","94","31382046"
"chr6","47666475","47666785","GL873541","16268070","16268366","90","31398405"
"chr6","48018560","48018866","GL873541","16268070","16268366","91","31750490"
"chr6","48020403","48020706","GL873541","16268070","16268366","87","31752333"
"chr6","48297213","48297510","GL873530","16647228","16647517","89","31649985"
"chr6","48438518","48438666","GL873530","5593486","5593649","49","42845032"
"chr6","48541295","48541599","GL873541","16268070","16268366","78","32273225"
"chr6","48617359","48617659","GL873547","2222074","2222356","86","46395285"
"chr6","48697016","48697293","GL873562","3299887","3300144","85","45397129"
"chr6","48824017","48824275","GL873755","463833","464092","101","48360184"
"chr6","49004703","49004998","GL873541","16268070","16268366","79","32736633"
"chr6","49216569","49216874","GL873541","16268070","16268366","92","32948499"
"chr6","49678053","49678351","GL873541","16268070","16268366","85","33409983"
"chr6","49773604","49773861","GL873680","3005257","3005482","95","46768347"
"chr6","49811713","49811999","GL873530","16647228","16647517","80","33164485"
"chr6","50023972","50024262","GL873528","36697151","36697434","99","13326821"
"chr6","50043518","50043816","GL873541","16268070","16268366","88","33775448"
"chr6","50064441","50064739","GL873541","16268070","16268366","80","33796371"
"chr6","50104830","50105118","GL873547","2222074","2222356","94","47882756"
"chr6","50142716","50143016","GL873541","16268070","16268366","84","33874646"
"chr6","50164890","50165177","GL873530","16647228","16647517","83","33517662"
"chr6","50247864","50247995","GL873550","5998776","5998900","37","44249088"
"chr6","50248277","50248467","GL873530","5593486","5593649","63","44654791"
"chr6","50443219","50443522","GL873541","16268070","16268366","94","34175149"
"chr6","50525951","50526248","GL873541","16268070","16268366","87","34257881"
"chr6","50531575","50531801","GL873531","3555300","3555500","71","46976275"
"chr6","50646888","50647023","GL873622","7076274","7076365","57","43570614"
"chr6","50722550","50722845","GL873530","16647228","16647517","82","34075322"
"chr6","50805503","50805627","GL873550","5998776","5998900","47","44806727"
"chr6","50805949","50806148","GL873697","3111225","3111427","62","47694724"
"chr7","891828","892139","GL873541","16268070","16268366","92","15376242"
"chr7","1156406","1156708","GL873547","2222074","2222356","89","1065668"
"chr7","1203123","1203428","GL873528","36697151","36697434","91","35494028"
"chr7","2001133","2001439","GL873541","16268070","16268366","91","14266937"
"chr7","2834981","2835275","GL873541","16268070","16268366","92","13433089"
"chr7","2977301","2977600","GL873541","16268070","16268366","90","13290769"
"chr7","3580226","3580526","GL873547","2222074","2222356","89","1358152"
"chr7","3698247","3698392","GL873691","508903","509045","43","3189344"
"chr7","3996830","3997123","GL873528","36697151","36697434","101","32700321"
"chr7","4386537","4386818","GL873547","2222074","2222356","87","2164463"
"chr7","4450131","4450438","GL873541","16268070","16268366","97","11817939"
"chr7","4720807","4721079","GL873541","16268070","16268366","90","11547263"
"chr7","5415747","5416015","GL873659","913070","913333","95","4502677"
"chr7","5547827","5548118","GL873530","16647228","16647517","83","11099401"
"chr7","5618297","5618582","GL873530","16647228","16647517","99","11028931"
"chr7","5641727","5642028","GL873528","36697151","36697434","91","31055424"
"chr7","6685281","6685520","GL873557","3858721","3858924","89","2826560"
"chr7","6899636","6899932","GL873547","2222074","2222356","84","4677562"
"chr7","7059429","7059723","GL873541","16268070","16268366","85","9208641"
"chr7","7172147","7172362","GL873557","3858721","3858924","65","3313426"
"chr7","8420327","8420587","GL873538","2567037","2567262","88","5853290"
"chr7","9939123","9939406","GL873547","2222074","2222356","88","7717049"
"chr7","11055190","11055479","GL873547","2222074","2222356","88","8833116"
"chr7","11195218","11195468","GL873547","5449763","5449997","77","5745455"
"chr7","11323428","11323717","GL873541","16268070","16268366","88","4944642"
"chr7","11845973","11846107","GL873622","7076274","7076365","58","4769699"
"chr7","11870928","11871220","GL873547","2222074","2222356","79","9648854"
"chr7","12805304","12805612","GL873528","36697151","36697434","96","23891847"
"chr7","13171467","13171771","GL873541","16268070","16268366","89","3096603"
"chr7","13179907","13180204","GL873541","16268070","16268366","83","3088163"
"chr7","13236072","13236374","GL873541","16268070","16268366","90","3031998"
"chr7","13358881","13359164","GL873547","2222074","2222356","84","11136807"
"chr7","13662830","13663133","GL873547","2222074","2222356","86","11440756"
"chr7","13901555","13901862","GL873608","6630366","6630673","95","7271189"
"chr7","14220558","14220867","GL873541","16268070","16268366","94","2047512"
"chr7","14406714","14407012","GL873607","1418062","1418355","88","12988652"
"chr7","14566769","14567068","GL873547","2222074","2222356","88","12344695"
"chr7","15192493","15192784","GL873528","36697151","36697434","88","21504658"
"chr7","15251330","15251507","GL873530","5593486","5593649","58","9657844"
"chr7","15488529","15488644","GL873541","15100979","15101074","54","387550"
"chr7","15843784","15844084","GL873607","1418062","1418355","87","14425722"
"chr7","19053592","19053622","GL873691","2903502","2903535","12","16150090"
"chr7","19172829","19173113","GL873547","2222074","2222356","83","16950755"
"chr7","19393125","19393391","GL873547","2222074","2222356","94","17171051"
"chr7","19420990","19421297","GL873541","16268070","16268366","98","3152920"
"chr7","19906680","19906991","GL873528","36697151","36697434","94","16790471"
"chr7","20125238","20125254","GL873691","2903502","2903535","20","17221736"
"chr7","20125290","20125568","GL873562","3299887","3300144","90","16825403"
"chr7","20254080","20254376","GL873541","16268070","16268366","90","3986010"
"chr7","20255043","20255350","GL873541","16268070","16268366","96","3986973"
"chr7","20273457","20273763","GL873541","16268070","16268366","91","4005387"
"chr7","20465511","20465743","GL873640","6426205","6426399","77","14039306"
"chr7","21071333","21071472","GL873619","2497092","2497229","48","18574241"
"chr7","21541280","21541573","GL873541","16268070","16268366","82","5273210"
"chr7","21648998","21649302","GL873541","16268070","16268366","83","5380928"
"chr7","21710213","21710499","GL873547","2222074","2222356","81","19488139"
"chr7","22703406","22703694","GL873547","2222074","2222356","87","20481332"
"chr7","22735422","22735720","GL873528","36697151","36697434","92","13961729"
"chr7","22922671","22922972","GL873541","16268070","16268366","101","6654601"
"chr7","23404745","23405044","GL873547","2222074","2222356","103","21182671"
"chr7","23405105","23405115","GL873691","2903502","2903535","23","20501603"
"chr7","23572867","23573162","GL873530","16647228","16647517","88","6925639"
"chr7","23993957","23994218","GL873680","3005257","3005482","91","20988700"
"chr7","24191105","24191414","GL873541","16268070","16268366","86","7923035"
"chr7","24200201","24200494","GL873607","1418062","1418355","86","22782139"
"chr7","24347557","24347839","GL873547","2222074","2222356","85","22125483"
"chr7","24354570","24354672","GL873524","43272658","43272747","43","18918088"
"chr7","24372563","24372858","GL873547","2222074","2222356","78","22150489"
"chr7","24551837","24552140","GL873530","16647228","16647517","85","7904609"
"chr7","24644755","24645036","GL873667","4451263","4451534","83","20193492"
"chr7","24710157","24710436","GL873562","3299887","3300144","89","21410270"
"chr7","24801198","24801442","GL873680","3005257","3005482","74","21795941"
"chr7","24831990","24832293","GL873541","16268070","16268366","92","8563920"
"chr7","24942829","24943136","GL873541","16268070","16268366","89","8674759"
"chr7","24971750","24972047","GL873541","16268070","16268366","93","8703680"
"chr7","26331840","26332140","GL873541","16268070","16268366","87","10063770"
"chr7","26338472","26338675","GL873554","16339732","16339922","58","9998740"
"chr7","26823427","26823711","GL873547","2222074","2222356","83","24601353"
"chr7","26866300","26866600","GL873530","16647228","16647517","89","10219072"
"chr7","27620515","27620606","GL873643","6205658","6205743","42","21414857"
"chr7","27620996","27621280","GL873528","36697151","36697434","94","9076155"
"chr7","27708719","27708994","GL873528","36697151","36697434","92","8988432"
"chr7","27773832","27773964","GL873550","5998776","5998900","37","21775056"
"chr7","29402602","29402871","GL873562","3299887","3300144","91","26102715"
"chr7","29422863","29423146","GL873530","16647228","16647517","75","12775635"
"chr7","29986701","29987005","GL873528","36697151","36697434","97","6710450"
"chr7","30250588","30250897","GL873541","16268070","16268366","89","13982518"
"chr7","30890623","30890649","GL873691","2903502","2903535","18","27987121"
"chr7","30890678","30890962","GL873547","2222074","2222356","92","28668604"
"chr7","31225213","31225514","GL873541","16268070","16268366","78","14957143"
"chr7","31487501","31487784","GL873541","16268070","16268366","88","15219431"
"chr7","32910002","32910297","GL873541","16268070","16268366","85","16641932"
"chr7","33041855","33042152","GL873541","16268070","16268366","83","16773785"
"chr7","33072744","33073024","GL873547","2222074","2222356","94","30850670"
"chr7","33320220","33320517","GL873667","4451263","4451534","91","28868957"
"chr7","33514999","33515284","GL873547","2222074","2222356","82","31292925"
"chr7","33982555","33982863","GL873541","16268070","16268366","102","17714485"
"chr7","34934290","34934580","GL873607","1418062","1418355","90","33516228"
"chr7","34960845","34961140","GL873541","16268070","16268366","85","18692775"
"chr7","35352063","35352355","GL873547","2222074","2222356","84","33129989"
"chr7","36241306","36241610","GL873541","16268070","16268366","85","19973236"
"chr7","36480773","36481082","GL873528","36697151","36697434","88","216378"
"chr7","37326581","37326867","GL873530","16647228","16647517","81","20679353"
"chr7","38024145","38024428","GL873547","2222074","2222356","90","35802071"
"chr7","38047909","38048019","GL873550","5998776","5998900","46","32049133"
"chr7","39417307","39417586","GL873547","2222074","2222356","89","37195233"
"chr7","39675958","39676266","GL873607","1418062","1418355","98","38257896"
"chr7","39889201","39889517","GL873541","16268070","16268366","98","23621131"
"chr7","40765977","40766260","GL873547","2222074","2222356","87","38543903"
"chr7","41065663","41065917","GL873640","6426205","6426399","100","34639458"
"chr7","41308056","41308331","GL873562","3299887","3300144","88","38008169"
"chr7","41384280","41384575","GL873530","16647228","16647517","79","24737052"
"chr7","41667098","41667239","GL873550","5998776","5998900","45","35668322"
"chr7","42484247","42484533","GL873547","2222074","2222356","81","40262173"
"chr7","42735840","42736150","GL873608","6630366","6630673","98","36105474"
"chr7","42923647","42923938","GL873607","1418062","1418355","83","41505585"
"chr7","42985842","42986116","GL873659","913070","913333","92","42072772"
"chr7","43123606","43123906","GL873541","16268070","16268366","87","26855536"
"chr7","44551901","44552170","GL873565","12307556","12307825","91","32244345"
"chr7","45826895","45827179","GL873562","3299887","3300144","96","42527008"
"chr7","46260245","46260560","GL873607","1418062","1418355","94","44842183"
"chr7","46404456","46404759","GL873541","16268070","16268366","85","30136386"
"chr7","46447300","46447610","GL873541","16268070","16268366","97","30179230"
"chr7","47020699","47021015","GL873541","16268070","16268366","101","30752629"
"chr7","47965103","47965389","GL873547","2222074","2222356","81","45743029"
"chr7","48521802","48522039","GL873538","2567037","2567262","79","45954765"
"chr7","49199303","49199565","GL873565","12307556","12307825","93","36891747"
"chr7","49272670","49272973","GL873528","36697151","36697434","92","12575519"
"chr7","49403405","49403732","GL873541","16268070","16268366","114","33135335"
"chr7","49482276","49482577","GL873541","16268070","16268366","81","33214206"
"chr7","49670577","49670859","GL873547","2222074","2222356","84","47448503"
"chr7","49792557","49792853","GL873541","16268070","16268366","82","33524487"
"chr7","49960380","49960632","GL873528","25203621","25203847","92","24756759"
"chr7","50314095","50314403","GL873528","36697151","36697434","95","13616944"
"chr7","50627217","50627517","GL873530","16647228","16647517","84","33979989"
"chr7","50956562","50956862","GL873530","16647228","16647517","94","34309334"
"chr7","51035709","51036002","GL873541","16268070","16268366","83","34767639"
"chr7","51669838","51670136","GL873541","16268070","16268366","85","35401768"
"chr7","52274956","52275272","GL873608","6630366","6630673","99","45644590"
"chr7","53019505","53019823","GL873528","36697151","36697434","102","16322354"
"chr7","53053520","53053810","GL873530","16647228","16647517","94","36406292"
"chr7","53120863","53121084","GL873625","6060130","6060345","69","47060733"
"chr7","53191822","53192096","GL873659","913070","913333","100","52278752"
"chr7","53409977","53410265","GL873530","16647228","16647517","91","36762749"
"chr7","53676129","53676419","GL873547","2222074","2222356","83","51454055"
"chr7","53694223","53694498","GL873547","2222074","2222356","92","51472149"
"chr7","53699595","53699877","GL873565","12307556","12307825","98","41392039"
"chr7","54287147","54287455","GL873528","36697151","36697434","94","17589996"
"chr7","54321080","54321382","GL873541","16268070","16268366","87","38053010"
"chr7","54554606","54554894","GL873528","36697151","36697434","92","17857455"
"chr7","54742026","54742158","GL873541","1550303","1550443","53","53191723"
"chr7","54942222","54942331","GL873524","43272770","43272878","44","11669452"
"chr7","55740326","55740609","GL873547","2222074","2222356","78","53518252"
"chr7","56672640","56672949","GL873541","16268070","16268366","96","40404570"
"chr7","56722287","56722580","GL873547","2222074","2222356","84","54500213"
"chr7","57273431","57273708","GL873562","3299887","3300144","89","53973544"
"chr7","57344542","57344818","GL873562","3299887","3300144","85","54044655"
"chr7","57349519","57349804","GL873547","2222074","2222356","80","55127445"
"chr7","57435793","57436086","GL873547","2222074","2222356","82","55213719"
"chr7","57464491","57464651","GL873530","5593486","5593649","47","51871005"
"chr7","57513437","57513664","GL873538","2567037","2567262","64","54946400"
"chr7","57808342","57808470","GL873550","5998776","5998900","33","51809566"
"chr7","58072985","58073304","GL873541","16268070","16268366","99","41804915"
"chr7","58081445","58081753","GL873541","16268070","16268366","88","41813375"
"chr7","58118569","58118878","GL873541","16268070","16268366","88","41850499"
"chr7","58300547","58300835","GL873547","2222074","2222356","77","56078473"
"chr7","58468958","58469266","GL873541","16268070","16268366","90","42200888"
"chr7","59480176","59480463","GL873607","1418062","1418355","83","58062114"
"chr7","59775412","59775716","GL873528","36697151","36697434","93","23078261"
"chr7","59813439","59813734","GL873530","16647228","16647517","82","43166211"
"chr7","59847879","59848174","GL873541","16268070","16268366","84","43579809"
"chr7","60434436","60434734","GL873541","16268070","16268366","83","44166366"
"chr7","60477492","60477780","GL873547","2222074","2222356","84","58255418"
"chr7","60485572","60485704","GL873550","5998776","5998900","35","54486796"
"chr7","60496185","60496480","GL873541","16268070","16268366","91","44228115"
"chr7","60515616","60515925","GL873541","16268070","16268366","91","44247546"
"chr7","60532449","60532597","GL873541","1550303","1550443","58","58982146"
"chr7","60547669","60547891","GL873557","3858721","3858924","68","56688948"
"chr7","62660163","62660470","GL873547","2222074","2222356","101","60438089"
"chr7","62781024","62781320","GL873547","2222074","2222356","96","60558950"
"chr7","62849073","62849355","GL873530","16647228","16647517","86","46201845"
"chr7","63249598","63249849","GL873565","12307556","12307825","91","50942042"
"chr7","64828175","64828487","GL873608","6630366","6630673","107","58197809"
"chr7","64928201","64928503","GL873541","16268070","16268366","89","48660131"
"chr7","65282758","65283067","GL873541","16268070","16268366","91","49014688"
"chr7","65920486","65920802","GL873667","4451263","4451534","101","61469223"
"chr7","66173724","66174019","GL873752","427788","428097","85","65745936"
"chr7","68237604","68237895","GL873547","2222074","2222356","85","66015530"
"chr7","68423806","68424115","GL873541","16268070","16268366","93","52155736"
"chr7","69084278","69084588","GL873541","16268070","16268366","110","52816208"
"chr7","69245938","69246240","GL873547","2222074","2222356","88","67023864"
"chr7","69267241","69267530","GL873667","4451263","4451534","87","64815978"
"chr7","69674278","69674571","GL873530","16647228","16647517","85","53027050"
"chr7","69846926","69847219","GL873530","16647228","16647517","91","53199698"
"chr7","70000181","70000466","GL873547","2222074","2222356","80","67778107"
"chr7","70574331","70574621","GL873538","2567037","2567262","114","68007294"
"chr7","70702517","70702812","GL873547","2222074","2222356","85","68480443"
"chr7","70811787","70812077","GL873547","2222074","2222356","80","68589713"
"chr7","71512790","71513099","GL873541","16268070","16268366","86","55244720"
"chr7","72037814","72038129","GL873541","16268070","16268366","105","55769744"
"chr7","72133201","72133479","GL873562","3299887","3300144","87","68833314"
"chr7","72879002","72879295","GL873530","16647228","16647517","86","56231774"
"chr7","72961203","72961346","GL873529","2453810","2453957","47","70507393"
"chr7","73884647","73884945","GL873541","16268070","16268366","92","57616577"
"chr7","74023025","74023334","GL873541","16268070","16268366","91","57754955"
"chr7","74162295","74162596","GL873541","16268070","16268366","92","57894225"
"chr7","74694438","74694701","GL873680","3005257","3005482","86","71689181"
"chr7","75226938","75227214","GL873547","2222074","2222356","81","73004864"
"chr7","75279006","75279306","GL873530","16647228","16647517","89","58631778"
"chr7","75281084","75281363","GL873547","2222074","2222356","82","73059010"
"chr7","75367393","75367695","GL873541","16268070","16268366","82","59099323"
"chr7","75473573","75473880","GL873530","16647228","16647517","93","58826345"
"chr7","75799139","75799438","GL873667","4451263","4451534","95","71347876"
"chr7","75864255","75864559","GL873541","16268070","16268366","94","59596185"
"chr7","75870311","75870612","GL873541","16268070","16268366","83","59602241"
"chr7","76116518","76116821","GL873541","16268070","16268366","90","59848448"
"chr7","76724885","76725176","GL873541","16268070","16268366","91","60456815"
"chr7","77404341","77404641","GL873541","16268070","16268366","87","61136271"
"chr7","77715175","77715472","GL873541","16268070","16268366","83","61447105"
"chr7","78063873","78064187","GL873530","16647228","16647517","99","61416645"
"chr7","78143519","78143828","GL873528","36697151","36697434","97","41446368"
"chr7","78150899","78151202","GL873541","16268070","16268366","92","61882829"
"chr7","78322851","78323137","GL873547","2222074","2222356","82","76100777"
"chr7","79279323","79279629","GL873547","2222074","2222356","94","77057249"
"chr7","79359165","79359398","GL873680","3005257","3005482","70","76353908"
"chr7","79722713","79723020","GL873541","16268070","16268366","100","63454643"
"chr7","79844932","79845238","GL873541","16268070","16268366","92","63576862"
"chr7","80171086","80171393","GL873541","16268070","16268366","91","63903016"
"chr7","80800733","80801033","GL873530","16647228","16647517","97","64153505"
"chr7","81106381","81106677","GL873541","16268070","16268366","87","64838311"
"chr7","81299111","81299412","GL873541","16268070","16268366","88","65031041"
"chr7","81582881","81583191","GL873541","16268070","16268366","94","65314811"
"chr7","82678375","82678655","GL873530","16647228","16647517","88","66031147"
"chr7","83116429","83116634","GL873531","3555300","3555500","67","79561129"
"chr7","83748521","83748802","GL873547","2222074","2222356","88","81526447"
"chr7","84167560","84167862","GL873530","16647228","16647517","87","67520332"
"chr7","84427242","84427547","GL873547","2222074","2222356","92","82205168"
"chr7","84507890","84508188","GL873528","36697151","36697434","100","47810739"
"chr7","85118186","85118480","GL873547","2222074","2222356","88","82896112"
"chr7","85539356","85539672","GL873608","6630366","6630673","97","78908990"
"chr7","85704991","85705288","GL873607","1418062","1418355","85","84286929"
"chr7","85944353","85944653","GL873541","16268070","16268366","85","69676283"
"chr7","85968342","85968639","GL873530","16647228","16647517","90","69321114"
"chr7","86194021","86194297","GL873562","3299887","3300144","89","82894134"
"chr7","86200912","86201218","GL873528","36697151","36697434","86","49503761"
"chr7","86204648","86204954","GL873528","36697151","36697434","88","49507497"
"chr7","86286493","86286622","GL873550","5998776","5998900","32","80287717"
"chr7","86399268","86399563","GL873541","16268070","16268366","86","70131198"
"chr7","86452593","86452908","GL873541","16268070","16268366","97","70184523"
"chr7","86536420","86536716","GL873530","16647228","16647517","89","69889192"
"chr7","88802575","88802866","GL873547","2222074","2222356","82","86580501"
"chr7","89078880","89079179","GL873608","6630366","6630673","102","82448514"
"chr7","89454668","89454974","GL873530","16647228","16647517","86","72807440"
"chr7","89998147","89998437","GL873541","16268070","16268366","91","73730077"
"chr7","90775402","90775735","GL873541","16268070","16268366","120","74507332"
"chr7","91843770","91844065","GL873530","16647228","16647517","83","75196542"
"chr7","92273159","92273465","GL873541","16268070","16268366","87","76005089"
"chr7","92430695","92430980","GL873565","12307556","12307825","100","80123139"
"chr7","92803834","92804013","GL873530","5593486","5593649","50","87210348"
"chr7","93779028","93779150","GL873550","5998776","5998900","35","87780252"
"chr7","94179247","94179545","GL873541","16268070","16268366","83","77911177"
"chr7","94226437","94226745","GL873541","16268070","16268366","96","77958367"
"chr7","94252245","94252543","GL873541","16268070","16268366","93","77984175"
"chr7","95230430","95230731","GL873541","16268070","16268366","87","78962360"
"chr7","95455735","95455993","GL873680","3005257","3005482","85","92450478"
"chr7","96395974","96396266","GL873565","12307556","12307825","99","84088418"
"chr7","97587429","97587716","GL873547","2222074","2222356","84","95365355"
"chr7","97644705","97645012","GL873528","36697151","36697434","104","60947554"
"chr7","97703417","97703707","GL873541","16268070","16268366","90","81435347"
"chr7","97741073","97741285","GL873531","3555300","3555500","63","94185773"
"chr7","97803272","97803563","GL873541","16268070","16268366","87","81535202"
"chr7","98604210","98604509","GL873530","16647228","16647517","90","81956982"
"chr7","98998541","98998834","GL873541","16268070","16268366","83","82730471"
"chr7","99781337","99781642","GL873541","16268070","16268366","91","83513267"
"chr7","100001570","100001727","GL873530","5593486","5593649","43","94408084"
"chr7","100059327","100059620","GL873608","6630366","6630673","89","93428961"
"chr7","100955235","100955543","GL873528","36697151","36697434","98","64258084"
"chr7","101114700","101114999","GL873541","16268070","16268366","89","84846630"
"chr7","101337266","101337481","GL873557","3858721","3858924","63","97478545"
"chr7","101503506","101503804","GL873530","16647228","16647517","86","84856278"
"chr7","101583373","101583666","GL873607","1418062","1418355","91","100165311"
"chr7","101729187","101729489","GL873530","16647228","16647517","85","85081959"
"chr7","101737997","101738299","GL873530","16647228","16647517","85","85090769"
"chr7","101887455","101887761","GL873541","16268070","16268366","84","85619385"
"chr7","101941406","101941710","GL873541","16268070","16268366","91","85673336"
"chr7","102123288","102123467","GL873530","5593486","5593649","57","96529802"
"chr7","102129980","102130268","GL873547","2222074","2222356","75","99907906"
"chr7","102178960","102179247","GL873659","913070","913333","91","101265890"
"chr7","102503358","102503478","GL873550","5998776","5998900","40","96504582"
"chr7","102503520","102503698","GL873530","5593486","5593649","58","96910034"
"chr7","102952244","102952557","GL873608","6630366","6630673","100","96321878"
"chr7","102954374","102954666","GL873541","16268070","16268366","91","86686304"
"chr7","103499225","103499505","GL873530","16647228","16647517","84","86851997"
"chr7","103665953","103666103","GL873541","1550303","1550443","60","102115650"
"chr7","103855472","103855749","GL873659","913070","913333","98","102942402"
"chr7","104547332","104547633","GL873547","2222074","2222356","92","102325258"
"chr7","105198466","105198762","GL873607","1418062","1418355","91","103780404"
"chr7","105619823","105620118","GL873547","2222074","2222356","86","103397749"
"chr7","105847722","105848015","GL873530","16647228","16647517","80","89200494"
"chr7","105880955","105881077","GL873526","41480965","41481045","53","64399990"
"chr7","105934969","105935236","GL873528","36697151","36697434","98","69237818"
"chr7","106456851","106457137","GL873530","16647228","16647517","87","89809623"
"chr7","106961382","106961674","GL873530","16647228","16647517","86","90314154"
"chr7","106999873","106999998","GL873524","43272770","43272878","46","63727103"
"chr7","107023358","107023481","GL873550","5998776","5998900","44","101024582"
"chr7","107111101","107111393","GL873530","16647228","16647517","78","90463873"
"chr7","107239053","107239342","GL873547","2222074","2222356","81","105016979"
"chr7","107489489","107489795","GL873541","16268070","16268366","94","91221419"
"chr7","107686854","107687159","GL873752","427788","428097","97","107259066"
"chr7","107767642","107767900","GL873547","5449763","5449997","95","102317879"
"chr7","107769601","107769898","GL873528","36697151","36697434","109","71072450"
"chr7","108155880","108156188","GL873541","16268070","16268366","95","91887810"
"chr7","108418621","108418894","GL873547","2222074","2222356","89","106196547"
"chr7","109154569","109154703","GL873541","1550303","1550443","52","107604266"
"chr7","109488918","109489218","GL873541","16268070","16268366","91","93220848"
"chr7","109750336","109750636","GL873530","16647228","16647517","91","93103108"
"chr7","109772958","109773249","GL873530","16647228","16647517","73","93125730"
"chr7","111254599","111254886","GL873530","16647228","16647517","86","94607371"
"chr7","111431694","111431968","GL873547","2222074","2222356","83","109209620"
"chr7","111452262","111452389","GL873619","2497092","2497229","47","108955170"
"chr7","112023446","112023745","GL873752","427788","428097","95","111595658"
"chr7","112053504","112053834","GL873608","6630366","6630673","104","105423138"
"chr7","112263322","112263621","GL873547","2222074","2222356","94","110041248"
"chr7","112505944","112506247","GL873541","16268070","16268366","90","96237874"
"chr7","112675082","112675373","GL873541","16268070","16268366","91","96407012"
"chr7","112969862","112970173","GL873528","36697151","36697434","103","76272711"
"chr7","114431227","114431518","GL873541","16268070","16268366","89","98163157"
"chr7","114538743","114539042","GL873530","16647228","16647517","88","97891515"
"chr7","115034643","115034942","GL873528","36697151","36697434","87","78337492"
"chr7","115157979","115158272","GL873547","2222074","2222356","76","112935905"
"chr7","115265532","115265839","GL873541","16268070","16268366","100","98997462"
"chr7","115268697","115268994","GL873541","16268070","16268366","80","99000627"
"chr7","115323773","115324059","GL873659","913070","913333","84","114410703"
"chr7","115722293","115722607","GL873541","16268070","16268366","100","99454223"
"chr7","115873914","115874207","GL873530","16647228","16647517","80","99226686"
"chr7","116216737","116217000","GL873659","913070","913333","88","115303667"
"chr7","116251443","116251737","GL873562","3299887","3300144","100","112951556"
"chr7","116851744","116852023","GL873547","2222074","2222356","85","114629670"
"chr7","117720558","117720808","GL873528","25203621","25203847","89","92516937"
"chr7","118644656","118644933","GL873562","3299887","3300144","88","115344769"
"chr7","118654611","118654730","GL873550","5998776","5998900","44","112655835"
"chr7","118654776","118654934","GL873611","3799989","3800137","55","114854787"
"chr7","118981728","118981994","GL873680","3005257","3005482","86","115976471"
"chr7","119466216","119466521","GL873530","16647228","16647517","87","102818988"
"chr7","120665318","120665613","GL873607","1418062","1418355","92","119247256"
"chr7","120780634","120780943","GL873608","6630366","6630673","95","114150268"
"chr7","121199366","121199510","GL873541","1550303","1550443","58","119649063"
"chr7","121388994","121389307","GL873530","16647228","16647517","97","104741766"
"chr7","121422574","121422872","GL873541","16268070","16268366","82","105154504"
"chr7","121793848","121794147","GL873530","16647228","16647517","91","105146620"
"chr7","122220159","122220276","GL873619","2497092","2497229","54","119723067"
"chr7","122255729","122256007","GL873528","36697151","36697434","99","85558578"
"chr7","123137214","123137527","GL873541","16268070","16268366","90","106869144"
"chr7","123545475","123545783","GL873541","16268070","16268366","91","107277405"
"chr7","123774563","123774871","GL873528","36697151","36697434","103","87077412"
"chr7","123855965","123856242","GL873547","2222074","2222356","86","121633891"
"chr7","124425284","124425594","GL873528","36697151","36697434","97","87728133"
"chr7","124784677","124784977","GL873608","6630366","6630673","83","118154311"
"chr7","124943372","124943680","GL873547","2222074","2222356","97","122721298"
"chr7","124946819","124947102","GL873547","2222074","2222356","89","122724745"
"chr7","125616517","125616798","GL873547","2222074","2222356","86","123394443"
"chr7","126266432","126266557","GL873587","10002051","10002151","54","116264381"
"chr7","126579847","126579983","GL873552","12711845","12711956","59","113868002"
"chr7","127222130","127222429","GL873541","16268070","16268366","84","110954060"
"chr7","128084002","128084300","GL873541","16268070","16268366","94","111815932"
"chr7","128575348","128575645","GL873541","16268070","16268366","94","112307278"
"chr7","128844205","128844485","GL873547","2222074","2222356","89","126622131"
"chr7","128863138","128863406","GL873680","3005257","3005482","88","125857881"
"chr7","129102420","129102724","GL873541","16268070","16268366","88","112834350"
"chr7","129281648","129281753","GL873524","43272658","43272747","43","86008990"
"chr7","129635706","129636004","GL873530","16647228","16647517","90","112988478"
"chr7","129756150","129756458","GL873541","16268070","16268366","99","113488080"
"chr7","129912785","129913051","GL873680","3005257","3005482","89","126907528"
"chr7","129915776","129916077","GL873607","1418062","1418355","89","128497714"
"chr7","130077066","130077339","GL873565","12307556","12307825","89","117769510"
"chr7","130270349","130270650","GL873528","36697151","36697434","88","93573198"
"chr7","130487673","130487953","GL873547","2222074","2222356","88","128265599"
"chr7","130487996","130488008","GL873691","2903502","2903535","21","127584494"
"chr7","130499463","130499763","GL873541","16268070","16268366","87","114231393"
"chr7","130777659","130777943","GL873565","12307556","12307825","93","118470103"
"chr7","130833061","130833371","GL873541","16268070","16268366","94","114564991"
"chr7","130904274","130904570","GL873530","16647228","16647517","79","114257046"
"chr7","131117886","131118177","GL873547","2222074","2222356","82","128895812"
"chr7","131233865","131234062","GL873630","2508568","2508753","64","128725297"
"chr7","131300376","131300681","GL873607","1418062","1418355","88","129882314"
"chr7","131381115","131381412","GL873541","16268070","16268366","80","115113045"
"chr7","131555078","131555210","GL873552","12711845","12711956","58","118843233"
"chr7","131684975","131685280","GL873528","36697151","36697434","96","94987824"
"chr7","131928605","131928903","GL873541","16268070","16268366","84","115660535"
"chr7","131974332","131974638","GL873541","16268070","16268366","89","115706262"
"chr7","132323830","132324126","GL873530","16647228","16647517","84","115676602"
"chr7","132382832","132383026","GL873630","2508568","2508753","72","129874264"
"chr7","132396211","132396485","GL873562","3299887","3300144","79","129096324"
"chr7","132875812","132876090","GL873547","2222074","2222356","85","130653738"
"chr7","133367054","133367360","GL873528","36697151","36697434","91","96669903"
"chr7","133599241","133599536","GL873547","2222074","2222356","82","131377167"
"chr7","133963052","133963328","GL873547","2222074","2222356","85","131740978"
"chr7","134093637","134093925","GL873547","2222074","2222356","93","131871563"
"chr7","134135454","134135750","GL873530","16647228","16647517","88","117488226"
"chr7","134396981","134397279","GL873607","1418062","1418355","89","132978919"
"chr7","134521954","134522241","GL873547","2222074","2222356","93","132299880"
"chr7","134574240","134574527","GL873565","12307556","12307825","108","122266684"
"chr7","134944613","134944920","GL873541","16268070","16268366","93","118676543"
"chr7","134954325","134954597","GL873530","16647228","16647517","96","118307097"
"chr8","984259","984551","GL873547","2222074","2222356","85","1237815"
"chr8","1064617","1064892","GL873528","36697151","36697434","93","35632534"
"chr8","2424069","2424375","GL873530","16647228","16647517","95","14223159"
"chr8","2669726","2670029","GL873541","16268070","16268366","83","13598344"
"chr8","2899627","2899798","GL873524","42560728","42560902","50","39661101"
"chr8","3089126","3089413","GL873547","2222074","2222356","87","867052"
"chr8","3445056","3445362","GL873541","16268070","16268366","94","12823014"
"chr8","3608025","3608324","GL873607","1418062","1418355","92","2189963"
"chr8","3656453","3656751","GL873541","16268070","16268366","95","12611617"
"chr8","3901990","3902289","GL873541","16268070","16268366","89","12366080"
"chr8","3968152","3968451","GL873607","1418062","1418355","94","2550090"
"chr8","5982700","5982989","GL873541","16268070","16268366","100","10285370"
"chr8","6262086","6262388","GL873541","16268070","16268366","90","10005984"
"chr8","6943296","6943578","GL873547","2222074","2222356","89","4721222"
"chr8","7202688","7202991","GL873541","16268070","16268366","85","9065382"
"chr8","7331653","7331946","GL873547","2222074","2222356","79","5109579"
"chr8","7397753","7398059","GL873528","36697151","36697434","101","29299398"
"chr8","7755206","7755327","GL873552","12711845","12711956","49","4956639"
"chr8","8098625","8098936","GL873541","16268070","16268366","89","8169445"
"chr8","10085160","10085454","GL873530","16647228","16647517","90","6562068"
"chr8","10695872","10696188","GL873541","16268070","16268366","104","5572198"
"chr8","11054132","11054440","GL873528","36697151","36697434","91","25643019"
"chr8","11128323","11128603","GL873547","2222074","2222356","88","8906249"
"chr8","11165799","11166080","GL873547","2222074","2222356","85","8943725"
"chr8","11215621","11215918","GL873547","2222074","2222356","79","8993547"
"chr8","11747357","11747666","GL873541","16268070","16268366","96","4520713"
"chr8","13024673","13024940","GL873680","3005257","3005482","93","10019416"
"chr8","13081730","13082037","GL873541","16268070","16268366","96","3186340"
"chr8","13685643","13685900","GL873535","4830564","4830824","100","8855079"
"chr8","13735661","13735943","GL873547","2222074","2222356","92","11513587"
"chr8","13931614","13931921","GL873541","16268070","16268366","89","2336456"
"chr8","14590939","14591216","GL873538","2567037","2567262","98","12023902"
"chr8","14933483","14933770","GL873547","2222074","2222356","86","12711409"
"chr8","15979992","15980271","GL873547","2222074","2222356","88","13757918"
"chr8","16026191","16026454","GL873680","3005257","3005482","93","13020934"
"chr8","16106636","16106932","GL873607","1418062","1418355","86","14688574"
"chr8","16840054","16840360","GL873541","16268070","16268366","90","571984"
"chr8","16864470","16864770","GL873528","36697151","36697434","93","19832681"
"chr8","17131358","17131640","GL873547","2222074","2222356","84","14909284"
"chr8","17491064","17491369","GL873541","16268070","16268366","82","1222994"
"chr8","17555118","17555243","GL873622","7076274","7076365","53","10478844"
"chr8","17692689","17693012","GL873528","36697151","36697434","110","19004462"
"chr8","17995734","17996040","GL873547","2222074","2222356","96","15773660"
"chr8","18134221","18134514","GL873667","4451263","4451534","89","13682958"
"chr8","18157010","18157313","GL873541","16268070","16268366","92","1888940"
"chr8","18311423","18311700","GL873530","16647228","16647517","84","1664195"
"chr8","19789333","19789603","GL873565","12307556","12307825","102","7481777"
"chr8","19815854","19816162","GL873541","16268070","16268366","96","3547784"
"chr8","19923916","19924216","GL873530","16647228","16647517","90","3276688"
"chr8","20072572","20072880","GL873528","36697151","36697434","92","16624579"
"chr8","20543057","20543355","GL873607","1418062","1418355","93","19124995"
"chr8","20589841","20590142","GL873541","16268070","16268366","90","4321771"
"chr8","20779287","20779584","GL873547","2222074","2222356","79","18557213"
"chr8","21110357","21110668","GL873528","36697151","36697434","92","15586794"
"chr8","21582433","21582657","GL873630","2508568","2508753","80","19073865"
"chr8","21910872","21911092","GL873531","3555300","3555500","68","18355572"
"chr8","22033998","22034299","GL873541","16268070","16268366","84","5765928"
"chr8","22317483","22317778","GL873530","16647228","16647517","80","5670255"
"chr8","22789986","22790291","GL873541","16268070","16268366","91","6521916"
"chr8","23153226","23153535","GL873530","16647228","16647517","101","6505998"
"chr8","23531210","23531497","GL873530","16647228","16647517","86","6883982"
"chr8","23675201","23675353","GL873619","2497092","2497229","55","21178109"
"chr8","23770060","23770358","GL873530","16647228","16647517","89","7122832"
"chr8","24114739","24115043","GL873541","16268070","16268366","104","7846669"
"chr8","24399745","24400024","GL873530","16647228","16647517","90","7752517"
"chr8","24795420","24795725","GL873541","16268070","16268366","92","8527350"
"chr8","25285175","25285413","GL873538","2567037","2567262","79","22718138"
"chr8","26151222","26151528","GL873541","16268070","16268366","95","9883152"
"chr8","26708835","26709150","GL873541","16268070","16268366","103","10440765"
"chr8","26836895","26837193","GL873530","16647228","16647517","95","10189667"
"chr8","26937588","26937887","GL873530","16647228","16647517","94","10290360"
"chr8","28232319","28232611","GL873530","16647228","16647517","84","11585091"
"chr8","28472414","28472713","GL873541","16268070","16268366","85","12204344"
"chr8","28600331","28600634","GL873541","16268070","16268366","88","12332261"
"chr8","29582632","29582928","GL873541","16268070","16268366","82","13314562"
"chr8","30178273","30178553","GL873547","2222074","2222356","90","27956199"
"chr8","30764649","30764946","GL873607","1418062","1418355","83","29346587"
"chr8","31525260","31525540","GL873562","3299887","3300144","86","28225373"
"chr8","32468828","32469131","GL873607","1418062","1418355","88","31050766"
"chr8","33579907","33580215","GL873608","6630366","6630673","96","26949541"
"chr8","33946661","33946948","GL873547","2222074","2222356","87","31724587"
"chr8","34305653","34305936","GL873547","2222074","2222356","87","32083579"
"chr8","35213787","35214077","GL873547","2222074","2222356","87","32991713"
"chr8","35220424","35220718","GL873530","16647228","16647517","80","18573196"
"chr8","35477559","35477834","GL873565","12307556","12307825","98","23170003"
"chr8","35853380","35853672","GL873547","2222074","2222356","82","33631306"
"chr8","35933102","35933402","GL873541","16268070","16268366","90","19665032"
"chr8","36000687","36000995","GL873607","1418062","1418355","101","34582625"
"chr8","36132452","36132717","GL873659","913070","913333","87","35219382"
"chr8","36168194","36168492","GL873528","36697151","36697434","90","528957"
"chr8","36275171","36275462","GL873530","16647228","16647517","82","19627943"
"chr8","36288462","36288761","GL873541","16268070","16268366","87","20020392"
"chr8","36493015","36493296","GL873530","16647228","16647517","79","19845787"
"chr8","36545404","36545573","GL873524","42560728","42560902","47","6015324"
"chr8","36630499","36630813","GL873608","6630366","6630673","91","30000133"
"chr8","36925667","36925820","GL873530","5593486","5593649","56","31332181"
"chr8","37023291","37023589","GL873659","913070","913333","85","36110221"
"chr8","37123660","37123948","GL873547","2222074","2222356","87","34901586"
"chr8","38338211","38338499","GL873528","36697151","36697434","97","1641060"
"chr8","38499328","38499599","GL873543","13038674","13038909","87","25460654"
"chr8","38515296","38515605","GL873541","16268070","16268366","93","22247226"
"chr8","38934719","38935050","GL873541","16268070","16268366","108","22666649"
"chr8","39512493","39512759","GL873547","5449763","5449997","97","34062730"
"chr8","39553865","39554173","GL873541","16268070","16268366","89","23285795"
"chr8","39732091","39732426","GL873541","16268070","16268366","114","23464021"
"chr8","39953645","39953944","GL873530","16647228","16647517","86","23306417"
"chr8","40231397","40231673","GL873562","3299887","3300144","85","36931510"
"chr8","40324172","40324481","GL873541","16268070","16268366","95","24056102"
"chr8","40516078","40516386","GL873541","16268070","16268366","98","24248008"
"chr8","40550009","40550275","GL873530","16647228","16647517","96","23902781"
"chr8","40644845","40645130","GL873547","2222074","2222356","82","38422771"
"chr8","40646626","40646917","GL873607","1418062","1418355","91","39228564"
"chr8","40712258","40712534","GL873528","36697151","36697434","89","4015107"
"chr8","40880658","40880827","GL873530","5593486","5593649","44","35287172"
"chr8","40934240","40934534","GL873752","427788","428097","89","40506452"
"chr8","40990809","40990921","GL873622","7076274","7076365","43","33914535"
"chr8","41018649","41018955","GL873530","16647228","16647517","93","24371421"
"chr8","41085206","41085488","GL873547","2222074","2222356","92","38863132"
"chr8","41114260","41114558","GL873547","2222074","2222356","83","38892186"
"chr8","43300370","43300668","GL873541","16268070","16268366","89","27032300"
"chr8","43526692","43526971","GL873562","3299887","3300144","90","40226805"
"chr8","43709944","43710222","GL873607","1418062","1418355","88","42291882"
"chr8","43884776","43885049","GL873562","3299887","3300144","99","40584889"
"chr8","45936976","45937252","GL873562","3299887","3300144","89","42637089"
"chr8","46147564","46147867","GL873541","16268070","16268366","96","29879494"
"chr8","47492135","47492438","GL873541","16268070","16268366","94","31224065"
"chr8","47492686","47492899","GL873697","3111225","3111427","58","44381461"
"chr8","47767283","47767592","GL873547","2222074","2222356","95","45545209"
"chr8","47785599","47785911","GL873607","1418062","1418355","95","46367537"
"chr8","48022956","48023263","GL873667","4451263","4451534","100","43571693"
"chr8","48302577","48302871","GL873541","16268070","16268366","100","32034507"
"chr8","48793891","48794013","GL873622","7076274","7076365","57","41717617"
"chr8","49694557","49694865","GL873541","16268070","16268366","90","33426487"
"chr8","49917593","49917900","GL873530","16647228","16647517","91","33270365"
"chr8","50097874","50098168","GL873530","16647228","16647517","86","33450646"
"chr8","50399337","50399652","GL873530","16647228","16647517","105","33752109"
"chr8","50443752","50444055","GL873541","16268070","16268366","91","34175682"
"chr8","50604549","50604805","GL873755","463833","464092","98","50140716"
"chr8","50843851","50844144","GL873547","2222074","2222356","81","48621777"
"chr8","51214368","51214580","GL873531","3555300","3555500","61","47659068"
"chr8","51467183","51467461","GL873547","2222074","2222356","79","49245109"
"chr8","51986052","51986312","GL873680","3005257","3005482","93","48980795"
"chr8","52917794","52918096","GL873607","1418062","1418355","91","51499732"
"chr8","53329535","53329844","GL873541","16268070","16268366","95","37061465"
"chr8","53822866","53823165","GL873607","1418062","1418355","85","52404804"
"chr8","54156799","54157108","GL873528","36697151","36697434","94","17459648"
"chr8","54639056","54639335","GL873547","2222074","2222356","89","52416982"
"chr8","55340223","55340522","GL873547","2222074","2222356","85","53118149"
"chr8","55423938","55424265","GL873541","16268070","16268366","123","39155868"
"chr8","55560146","55560173","GL873691","2903502","2903535","21","52656644"
"chr8","55560211","55560526","GL873812","559768","560073","113","55000443"
"chr8","56385729","56386034","GL873541","16268070","16268366","88","40117659"
"chr8","57305700","57306037","GL873752","427788","428097","115","56877912"
"chr8","57977187","57977292","GL873587","10002051","10002151","38","47975136"
"chr8","58392679","58392986","GL873541","16268070","16268366","88","42124609"
"chr8","58657012","58657301","GL873530","16647228","16647517","78","42009784"
"chr8","59341069","59341369","GL873541","16268070","16268366","82","43072999"
"chr8","59554968","59555274","GL873541","16268070","16268366","91","43286898"
"chr8","60236332","60236636","GL873547","2222074","2222356","92","58014258"
"chr8","60694585","60694789","GL873535","24407607","24407780","67","36286978"
"chr8","61385172","61385470","GL873541","16268070","16268366","78","45117102"
"chr8","61468082","61468391","GL873541","16268070","16268366","96","45200012"
"chr8","61535373","61535670","GL873547","2222074","2222356","88","59313299"
"chr8","61557035","61557316","GL873547","2222074","2222356","89","59334961"
"chr8","61628346","61628644","GL873528","36697151","36697434","102","24931195"
"chr8","61720623","61720752","GL873550","5998776","5998900","35","55721847"
"chr8","62310553","62310826","GL873659","913070","913333","87","61397483"
"chr8","62437297","62437604","GL873752","427788","428097","96","62009509"
"chr8","62514995","62515291","GL873547","2222074","2222356","90","60292921"
"chr8","62600942","62601247","GL873528","36697151","36697434","95","25903791"
"chr8","62694510","62694804","GL873528","36697151","36697434","95","25997359"
"chr8","62762310","62762525","GL873535","24407607","24407780","77","38354703"
"chr8","62951749","62952044","GL873608","6630366","6630673","90","56321383"
"chr8","65561730","65562034","GL873541","16268070","16268366","89","49293660"
"chr8","65678156","65678464","GL873607","1418062","1418355","87","64260094"
"chr8","65702393","65702689","GL873530","16647228","16647517","88","49055165"
"chr8","65772916","65773222","GL873528","36697151","36697434","96","29075765"
"chr8","66009337","66009652","GL873608","6630366","6630673","102","59378971"
"chr8","67193968","67194249","GL873528","36697151","36697434","94","30496817"
"chr8","67381789","67382098","GL873541","16268070","16268366","95","51113719"
"chr8","67900698","67901017","GL873541","16268070","16268366","97","51632628"
"chr8","68202170","68202479","GL873541","16268070","16268366","94","51934100"
"chr8","68594971","68595284","GL873541","16268070","16268366","95","52326901"
"chr8","69052241","69052548","GL873541","16268070","16268366","94","52784171"
"chr8","69208048","69208328","GL873547","2222074","2222356","90","66985974"
"chr8","69246653","69246944","GL873547","2222074","2222356","80","67024579"
"chr8","69269472","69269767","GL873541","16268070","16268366","82","53001402"
"chr8","69536522","69536828","GL873530","16647228","16647517","87","52889294"
"chr8","69588461","69588765","GL873541","16268070","16268366","95","53320391"
"chr8","69633464","69633707","GL873528","25203621","25203847","81","44429843"
"chr8","69740310","69740614","GL873541","16268070","16268366","91","53472240"
"chr8","69745807","69745879","GL873554","10500008","10500061","38","59245799"
"chr8","69748100","69748235","GL873541","1550303","1550443","59","68197797"
"chr8","70665673","70665975","GL873541","16268070","16268366","91","54397603"
"chr8","70677455","70677750","GL873541","16268070","16268366","85","54409385"
"chr8","71442694","71443005","GL873547","2222074","2222356","101","69220620"
"chr8","74679906","74680079","GL873520","40003955","40004123","59","34675951"
"chr8","75310214","75310504","GL873547","2222074","2222356","76","73088140"
"chr8","75505632","75505847","GL873680","3005257","3005482","83","72500375"
"chr8","75521913","75522205","GL873530","16647228","16647517","83","58874685"
"chr8","75586608","75586838","GL873543","13038674","13038909","91","62547934"
"chr8","75768230","75768533","GL873530","16647228","16647517","89","59121002"
"chr8","76021813","76022153","GL873541","16268070","16268366","122","59753743"
"chr8","76684830","76685120","GL873547","2222074","2222356","84","74462756"
"chr8","76950508","76950824","GL873541","16268070","16268366","97","60682438"
"chr8","77469644","77469870","GL873630","2508568","2508753","79","74961076"
"chr8","77607784","77608004","GL873531","3555300","3555500","70","74052484"
"chr8","78033513","78033806","GL873530","16647228","16647517","90","61386285"
"chr8","78727988","78728258","GL873659","913070","913333","96","77814918"
"chr8","78735337","78735439","GL873587","10002051","10002151","33","68733286"
"chr8","80065290","80065596","GL873530","16647228","16647517","95","63418062"
"chr8","80615009","80615223","GL873557","3858721","3858924","66","76756288"
"chr8","81271245","81271332","GL873622","7076274","7076365","37","74194971"
"chr8","81297064","81297340","GL873547","2222074","2222356","86","79074990"
"chr8","81491576","81491880","GL873541","16268070","16268366","84","65223506"
"chr8","81604561","81604853","GL873607","1418062","1418355","86","80186499"
"chr8","82670717","82670998","GL873541","16268070","16268366","94","66402647"
"chr8","82893449","82893733","GL873530","16647228","16647517","89","66246221"
"chr8","82968834","82969119","GL873541","16268070","16268366","97","66700764"
"chr8","83103614","83103902","GL873659","913070","913333","104","82190544"
"chr8","84017746","84018054","GL873541","16268070","16268366","94","67749676"
"chr8","84910330","84910386","GL873550","5998911","5998963","28","78911419"
"chr8","84923925","84924237","GL873530","16647228","16647517","96","68276697"
"chr8","85135409","85135712","GL873541","16268070","16268366","87","68867339"
"chr8","86519677","86519941","GL873547","2222074","2222356","97","84297603"
"chr8","86693058","86693181","GL873552","12711845","12711956","48","73981213"
"chr8","86741708","86741993","GL873530","16647228","16647517","94","70094480"
"chr8","87061427","87061725","GL873541","16268070","16268366","82","70793357"
"chr8","87168888","87169185","GL873659","913070","913333","86","86255818"
"chr8","87202705","87203008","GL873541","16268070","16268366","86","70934635"
"chr8","87257411","87257721","GL873752","427788","428097","91","86829623"
"chr8","88261673","88261783","GL873622","7076274","7076365","40","81185399"
"chr8","88728726","88729002","GL873562","3299887","3300144","91","85428839"
"chr8","88827137","88827437","GL873547","2222074","2222356","94","86605063"
"chr8","88905550","88905835","GL873530","16647228","16647517","88","72258322"
"chr8","89451648","89451956","GL873541","16268070","16268366","89","73183578"
"chr8","89482243","89482494","GL873659","913070","913333","87","88569173"
"chr8","89599004","89599311","GL873541","16268070","16268366","94","73330934"
"chr8","89650836","89651128","GL873530","16647228","16647517","96","73003608"
"chr8","89689349","89689648","GL873530","16647228","16647517","85","73042121"
"chr8","89769464","89769801","GL873541","16268070","16268366","118","73501394"
"chr8","89812095","89812363","GL873562","3299887","3300144","87","86512208"
"chr8","91956995","91957287","GL873530","16647228","16647517","83","75309767"
"chr8","92386298","92386588","GL873530","16647228","16647517","89","75739070"
"chr8","92403075","92403367","GL873547","2222074","2222356","85","90181001"
"chr8","92455330","92455504","GL873524","42560728","42560902","58","49894602"
"chr8","92570169","92570339","GL873530","5593486","5593649","45","86976683"
"chr8","92651231","92651365","GL873550","5998776","5998900","42","86652455"
"chr8","92669732","92669771","GL873731","2008517","2008552","22","90661215"
"chr8","92760135","92760414","GL873530","16647228","16647517","93","76112907"
"chr8","93002551","93002843","GL873565","12307556","12307825","113","80694995"
"chr8","93004179","93004415","GL873543","13038674","13038909","84","79965505"
"chr8","93911861","93912169","GL873530","16647228","16647517","93","77264633"
"chr8","94003619","94003752","GL873550","5998776","5998900","42","88004843"
"chr8","94232568","94232884","GL873541","16268070","16268366","95","77964498"
"chr8","94271195","94271438","GL873547","5449763","5449997","81","88821432"
"chr8","94532373","94532636","GL873535","4830564","4830824","85","89701809"
"chr8","95586621","95586833","GL873531","3555300","3555500","62","92031321"
"chr8","95629728","95630040","GL873541","16268070","16268366","93","79361658"
"chr8","95798162","95798434","GL873562","3299887","3300144","88","92498275"
"chr8","95859478","95859783","GL873528","36697151","36697434","89","59162327"
"chr8","95912699","95913006","GL873541","16268070","16268366","91","79644629"
"chr8","95936429","95936725","GL873541","16268070","16268366","87","79668359"
"chr8","96348911","96349211","GL873541","16268070","16268366","85","80080841"
"chr8","97137579","97137683","GL873643","6205658","6205743","45","90931921"
"chr8","97232424","97232719","GL873530","16647228","16647517","88","80585196"
"chr8","97282392","97282672","GL873562","3299887","3300144","92","93982505"
"chr8","97643743","97644059","GL873541","16268070","16268366","98","81375673"
"chr8","97652885","97653192","GL873541","16268070","16268366","85","81384815"
"chr8","97685673","97685826","GL873550","5998776","5998900","56","91686897"
"chr8","97749211","97749527","GL873541","16268070","16268366","102","81481141"
"chr8","98107505","98107789","GL873541","16268070","16268366","89","81839435"
"chr8","98533747","98533957","GL873557","3858721","3858924","65","94675026"
"chr8","98826757","98827066","GL873528","36697151","36697434","90","62129606"
"chr8","100037545","100037817","GL873680","3005257","3005482","96","97032288"
"chr8","100301904","100302201","GL873530","16647228","16647517","90","83654676"
"chr8","100409007","100409325","GL873541","16268070","16268366","100","84140937"
"chr8","101497296","101497559","GL873565","12307556","12307825","91","89189740"
"chr8","101515267","101515526","GL873664","1986243","1986439","103","99529024"
"chr8","102187954","102188258","GL873530","16647228","16647517","85","85540726"
"chr8","102360562","102360888","GL873541","16268070","16268366","102","86092492"
"chr8","102451078","102451387","GL873659","913070","913333","98","101538008"
"chr8","102954218","102954523","GL873547","2222074","2222356","93","100732144"
"chr8","103858835","103859092","GL873528","36697151","36697434","95","67161684"
"chr8","104245966","104246259","GL873530","16647228","16647517","86","87598738"
"chr8","104279467","104279601","GL873622","7076274","7076365","59","97203193"
"chr8","105780169","105780464","GL873547","2222074","2222356","87","103558095"
"chr8","106101262","106101506","GL873640","6426205","6426399","95","99675057"
"chr8","106426880","106427176","GL873547","2222074","2222356","91","104204806"
"chr8","108329811","108330075","GL873565","12307556","12307825","92","96022255"
"chr8","108422759","108423053","GL873607","1418062","1418355","96","107004697"
"chr8","109331308","109331612","GL873541","16268070","16268366","98","93063238"
"chr8","109561118","109561375","GL873680","3005257","3005482","93","106555861"
"chr8","109844839","109845147","GL873547","2222074","2222356","88","107622765"
"chr8","111042264","111042570","GL873752","427788","428097","92","110614476"
"chr8","111718957","111719240","GL873659","913070","913333","78","110805887"
"chr8","112469219","112469524","GL873541","16268070","16268366","89","96201149"
"chr8","112591683","112591837","GL873541","1550303","1550443","48","111041380"
"chr8","112617389","112617668","GL873562","3299887","3300144","89","109317502"
"chr8","112629520","112629695","GL873530","5593486","5593649","55","107036034"
"chr8","112758202","112758505","GL873528","36697151","36697434","95","76061051"
"chr8","113814535","113814833","GL873541","16268070","16268366","85","97546465"
"chr8","114449333","114449485","GL873585","9209559","9209725","56","105239774"
"chr8","114453792","114454090","GL873541","16268070","16268366","85","98185722"
"chr8","114504538","114504808","GL873547","2222074","2222356","90","112282464"
"chr8","114724651","114724931","GL873547","2222074","2222356","94","112502577"
"chr8","114916529","114916774","GL873557","3858721","3858924","87","111057808"
"chr8","115225161","115225472","GL873541","16268070","16268366","93","98957091"
"chr8","115294220","115294508","GL873547","2222074","2222356","79","113072146"
"chr8","115906671","115906974","GL873528","36697151","36697434","90","79209520"
"chr8","115987929","115988232","GL873547","2222074","2222356","91","113765855"
"chr8","116452753","116452890","GL873550","5998776","5998900","41","110453977"
"chr8","116453395","116453685","GL873547","2222074","2222356","85","114231321"
"chr8","117050961","117051074","GL873552","12711845","12711956","47","104339116"
"chr8","117631524","117631816","GL873530","16647228","16647517","88","100984296"
"chr8","117901691","117901983","GL873607","1418062","1418355","80","116483629"
"chr8","118004544","118004800","GL873557","3858721","3858924","97","114145823"
"chr8","118595912","118596213","GL873541","16268070","16268366","91","102327842"
"chr8","118910423","118910720","GL873530","16647228","16647517","90","102263195"
"chr8","119134907","119135216","GL873607","1418062","1418355","91","117716845"
"chr8","119825796","119826097","GL873541","16268070","16268366","86","103557726"
"chr8","119952153","119952476","GL873541","16268070","16268366","111","103684083"
"chr8","120022388","120022697","GL873607","1418062","1418355","96","118604326"
"chr8","120238157","120238376","GL873531","3555300","3555500","63","116682857"
"chr8","120450677","120450792","GL873521","9884269","9884347","54","110566408"
"chr8","120451086","120451210","GL873550","5998776","5998900","40","114452310"
"chr8","120816956","120817260","GL873528","36697151","36697434","91","84119805"
"chr8","120823525","120823827","GL873530","16647228","16647517","96","104176297"
"chr8","120883432","120883531","GL873587","10002051","10002151","44","110881381"
"chr8","120935975","120936284","GL873528","36697151","36697434","98","84238824"
"chr8","121280472","121280769","GL873547","2222074","2222356","86","119058398"
"chr8","121502988","121503294","GL873541","16268070","16268366","89","105234918"
"chr8","121527131","121527436","GL873608","6630366","6630673","87","114896765"
"chr8","121566414","121566716","GL873541","16268070","16268366","79","105298344"
"chr8","121880813","121881121","GL873541","16268070","16268366","89","105612743"
"chr8","122071808","122072100","GL873530","16647228","16647517","72","105424580"
"chr8","122178361","122178637","GL873562","3299887","3300144","89","118878474"
"chr8","122224133","122224437","GL873752","427788","428097","92","121796345"
"chr8","122252804","122253107","GL873541","16268070","16268366","82","105984734"
"chr8","122465744","122465992","GL873755","463833","464092","92","122001911"
"chr8","122495490","122495785","GL873547","2222074","2222356","85","120273416"
"chr8","122752019","122752322","GL873541","16268070","16268366","92","106483949"
"chr8","122806227","122806529","GL873528","36697151","36697434","90","86109076"
"chr8","123000488","123000764","GL873547","2222074","2222356","90","120778414"
"chr8","123147855","123148084","GL873680","3005257","3005482","65","120142598"
"chr8","123183663","123183785","GL873524","43272658","43272747","55","79911005"
"chr8","123966087","123966384","GL873547","2222074","2222356","82","121744013"
"chr8","124375616","124375768","GL873550","5998776","5998900","54","118376840"
"chr8","124394946","124395236","GL873541","16268070","16268366","86","108126876"
"chr8","124623986","124624289","GL873541","16268070","16268366","92","108355916"
"chr8","124933735","124933890","GL873530","5593486","5593649","45","119340249"
"chr8","124995937","124996065","GL873622","7076274","7076365","48","117919663"
"chr8","125663310","125663603","GL873541","16268070","16268366","84","109395240"
"chr8","127300489","127300798","GL873541","16268070","16268366","93","111032419"
"chr8","127413553","127413847","GL873541","16268070","16268366","84","111145483"
"chr8","128368260","128368538","GL873547","2222074","2222356","88","126146186"
"chr8","128803899","128804193","GL873547","2222074","2222356","85","126581825"
"chr8","129058185","129058497","GL873541","16268070","16268366","96","112790115"
"chr8","129484148","129484454","GL873541","16268070","16268366","89","113216078"
"chr8","129847962","129848244","GL873547","2222074","2222356","86","127625888"
"chr8","130270958","130271262","GL873547","2222074","2222356","91","128048884"
"chr8","131565068","131565363","GL873752","427788","428097","84","131137280"
"chr8","132288778","132289057","GL873547","2222074","2222356","95","130066704"
"chr8","132587149","132587427","GL873562","3299887","3300144","85","129287262"
"chr8","132902347","132902636","GL873547","2222074","2222356","80","130680273"
"chr8","134175017","134175316","GL873541","16268070","16268366","84","117906947"
"chr8","134553618","134553914","GL873530","16647228","16647517","89","117906390"
"chr8","134659425","134659735","GL873528","36697151","36697434","96","97962274"
"chr8","134729160","134729454","GL873547","2222074","2222356","83","132507086"
"chr8","134739696","134740043","GL873541","16268070","16268366","127","118471626"
"chr8","134889069","134889363","GL873541","16268070","16268366","87","118620999"
"chr8","135160319","135160614","GL873547","2222074","2222356","89","132938245"
"chr8","135272767","135273059","GL873752","427788","428097","89","134844979"
"chr8","136932938","136933238","GL873541","16268070","16268366","81","120664868"
"chr8","137519698","137519974","GL873565","12307556","12307825","100","125212142"
"chr8","137866592","137866904","GL873541","16268070","16268366","92","121598522"
"chr8","138179124","138179376","GL873528","25203621","25203847","98","112975503"
"chr8","138385912","138386190","GL873547","2222074","2222356","88","136163838"
"chr8","138386235","138386250","GL873691","2903502","2903535","20","135482733"
"chr8","138508118","138508261","GL873550","5998776","5998900","46","132509342"
"chr8","138517416","138517706","GL873547","2222074","2222356","75","136295342"
"chr8","138632513","138632523","GL873691","2903502","2903535","23","135729011"
"chr8","138632819","138633003","GL873530","5593486","5593649","60","133039333"
"chr8","138864150","138864442","GL873607","1418062","1418355","86","137446088"
"chr8","138915663","138915971","GL873528","36697151","36697434","91","102218512"
"chr8","138976562","138976862","GL873541","16268070","16268366","82","122708492"
"chr8","139032492","139032788","GL873547","2222074","2222356","88","136810418"
"chr8","139291341","139291475","GL873524","43272770","43272878","58","96018571"
"chr9","61996966","61997268","GL873541","16268070","16268366","90","45728896"
"chr9","103022453","103022725","GL873562","3299887","3300144","90","99722566"
"chr9","9227","9537","GL873541","16268070","16268366","107","16258843"
"chr9","250796","251089","GL873530","16647228","16647517","83","16396432"
"chr9","281952","282252","GL873547","2222074","2222356","85","1940122"
"chr9","696614","696675","GL873691","1645655","1645707","32","949041"
"chr9","696662","696723","GL873524","36505249","36505303","32","35808587"
"chr9","696710","696771","GL873524","36505249","36505303","33","35808539"
"chr9","865770","866054","GL873547","2222074","2222356","82","1356304"
"chr9","1010736","1011036","GL873607","1418062","1418355","102","407326"
"chr9","1017394","1017694","GL873530","16647228","16647517","90","15629834"
"chr9","1816543","1816811","GL873547","2222074","2222356","98","405531"
"chr9","2538018","2538311","GL873530","16647228","16647517","88","14109210"
"chr9","2700317","2700652","GL873752","427788","428097","119","2272529"
"chr9","2994195","2994491","GL873541","16268070","16268366","86","13273875"
"chr9","3918407","3918523","GL873622","7076274","7076365","42","3157867"
"chr9","3919838","3919963","GL873622","7076274","7076365","52","3156436"
"chr9","4103297","4103422","GL873550","5998776","5998900","38","1895479"
"chr9","4882925","4883070","GL873628","6402015","6402153","50","1519090"
"chr9","5032418","5032709","GL873541","16268070","16268366","83","11235652"
"chr9","5039926","5040235","GL873541","16268070","16268366","91","11228144"
"chr9","5800018","5800307","GL873530","16647228","16647517","86","10847210"
"chr9","5924947","5925255","GL873541","16268070","16268366","95","10343123"
"chr9","6345719","6346054","GL873528","36697151","36697434","117","30351432"
"chr9","6382689","6382978","GL873530","16647228","16647517","77","10264539"
"chr9","6711821","6711939","GL873550","5998776","5998900","46","713045"
"chr9","6712228","6712442","GL873558","7532067","7532273","60","819839"
"chr9","7206134","7206410","GL873547","2222074","2222356","90","4984060"
"chr9","7813383","7813660","GL873659","913070","913333","90","6900313"
"chr9","8416733","8416881","GL873550","5998776","5998900","54","2417957"
"chr9","9150804","9151113","GL873528","36697151","36697434","101","27546347"
"chr9","9179352","9179648","GL873659","913070","913333","89","8266282"
"chr9","9186120","9186416","GL873565","12307556","12307825","113","3121436"
"chr9","9478003","9478291","GL873528","36697151","36697434","104","27219148"
"chr9","10075024","10075323","GL873530","16647228","16647517","86","6572204"
"chr9","10103118","10103400","GL873528","36697151","36697434","103","26594033"
"chr9","10233514","10233805","GL873547","2222074","2222356","82","8011440"
"chr9","10818422","10818721","GL873530","16647228","16647517","87","5828806"
"chr9","11605766","11606044","GL873565","12307556","12307825","100","701790"
"chr9","11828451","11828739","GL873547","2222074","2222356","79","9606377"
"chr9","12033034","12033337","GL873752","427788","428097","85","11605246"
"chr9","12117147","12117447","GL873541","16268070","16268366","87","4150923"
"chr9","12175458","12175653","GL873630","2508568","2508753","80","9666890"
"chr9","12200560","12200854","GL873659","913070","913333","87","11287490"
"chr9","12358932","12359208","GL873547","2222074","2222356","88","10136858"
"chr9","12360770","12361060","GL873565","12307556","12307825","88","53214"
"chr9","13140428","13140722","GL873547","2222074","2222356","80","10918354"
"chr9","13435910","13436244","GL873812","559768","560073","107","12876142"
"chr9","13706440","13706735","GL873541","16268070","16268366","90","2561630"
"chr9","13985494","13985803","GL873547","2222074","2222356","92","11763420"
"chr9","14090186","14090481","GL873530","16647228","16647517","80","2557042"
"chr9","14235867","14236169","GL873608","6630366","6630673","96","7605501"
"chr9","14295014","14295301","GL873547","2222074","2222356","83","12072940"
"chr9","14734927","14735217","GL873547","2222074","2222356","83","12512853"
"chr9","14805430","14805732","GL873541","16268070","16268366","92","1462640"
"chr9","14933470","14933765","GL873530","16647228","16647517","84","1713758"
"chr9","14957021","14957185","GL873560","5855436","5855580","57","9101585"
"chr9","15498056","15498356","GL873541","16268070","16268366","86","770014"
"chr9","15616927","15617219","GL873530","16647228","16647517","84","1030301"
"chr9","15636801","15637097","GL873547","2222074","2222356","84","13414727"
"chr9","16041473","16041777","GL873608","6630366","6630673","90","9411107"
"chr9","16383553","16383853","GL873607","1418062","1418355","88","14965491"
"chr9","16728188","16728446","GL873680","3005257","3005482","86","13722931"
"chr9","17137360","17137638","GL873547","2222074","2222356","90","14915286"
"chr9","17257086","17257171","GL873526","41481654","41481719","30","24224568"
"chr9","17291473","17291768","GL873541","16268070","16268366","96","1023403"
"chr9","17334979","17335249","GL873659","913070","913333","89","16421909"
"chr9","17384544","17384792","GL873547","5449763","5449997","80","11934781"
"chr9","17498149","17498440","GL873530","16647228","16647517","87","850921"
"chr9","17507275","17507574","GL873541","16268070","16268366","91","1239205"
"chr9","17524063","17524194","GL873550","5998776","5998900","38","11525287"
"chr9","17526312","17526604","GL873530","16647228","16647517","80","879084"
"chr9","17604750","17605020","GL873667","4451263","4451534","82","13153487"
"chr9","17794454","17794749","GL873547","2222074","2222356","81","15572380"
"chr9","17799612","17799903","GL873547","2222074","2222356","83","15577538"
"chr9","17889265","17889555","GL873530","16647228","16647517","85","1242037"
"chr9","17988400","17988707","GL873607","1418062","1418355","95","16570338"
"chr9","18200453","18200803","GL873607","1418062","1418355","123","16782391"
"chr9","18227013","18227322","GL873541","16268070","16268366","94","1958943"
"chr9","18313882","18314160","GL873530","16647228","16647517","82","1666654"
"chr9","18322402","18322692","GL873547","2222074","2222356","80","16100328"
"chr9","18364112","18364422","GL873541","16268070","16268366","95","2096042"
"chr9","18431205","18431432","GL873538","2567037","2567262","68","15864168"
"chr9","18556843","18557135","GL873528","36697151","36697434","89","18140308"
"chr9","18559511","18559812","GL873530","16647228","16647517","92","1912283"
"chr9","18571795","18572093","GL873528","36697151","36697434","91","18125356"
"chr9","18580784","18581088","GL873541","16268070","16268366","91","2312714"
"chr9","18609734","18610034","GL873752","427788","428097","84","18181946"
"chr9","18956238","18956478","GL873640","6426205","6426399","92","12530033"
"chr9","19128373","19128555","GL873823","304319","304508","58","18824054"
"chr9","19131306","19131613","GL873541","16268070","16268366","99","2863236"
"chr9","20557395","20557703","GL873541","16268070","16268366","87","4289325"
"chr9","21077436","21077601","GL873530","5593486","5593649","53","15483950"
"chr9","21081815","21082046","GL873558","7532067","7532273","69","13549748"
"chr9","21135134","21135430","GL873547","2222074","2222356","80","18913060"
"chr9","21149539","21149749","GL873538","2567037","2567262","65","18582502"
"chr9","21296896","21297210","GL873541","16268070","16268366","95","5028826"
"chr9","21467038","21467321","GL873547","2222074","2222356","90","19244964"
"chr9","21481454","21481754","GL873528","36697151","36697434","93","15215697"
"chr9","22617797","22618102","GL873541","16268070","16268366","91","6349727"
"chr9","22687772","22688068","GL873541","16268070","16268366","89","6419702"
"chr9","23211217","23211527","GL873528","36697151","36697434","96","13485934"
"chr9","24007723","24008020","GL873541","16268070","16268366","86","7739653"
"chr9","24376232","24376542","GL873528","36697151","36697434","94","12320919"
"chr9","24462869","24463196","GL873608","6630366","6630673","122","17832503"
"chr9","24595991","24596279","GL873547","2222074","2222356","79","22373917"
"chr9","25451624","25451936","GL873607","1418062","1418355","98","24033562"
"chr9","25700993","25701269","GL873562","3299887","3300144","89","22401106"
"chr9","26074944","26075233","GL873547","2222074","2222356","87","23852870"
"chr9","26249645","26249831","GL873521","1458597","1458764","75","24791048"
"chr9","26249863","26249880","GL873691","2903502","2903535","20","23346361"
"chr9","26353807","26354013","GL873524","42560728","42560902","73","16206921"
"chr9","26604353","26604622","GL873535","4830564","4830824","88","21773789"
"chr9","28112269","28112568","GL873541","16268070","16268366","78","11844199"
"chr9","28285762","28286057","GL873530","16647228","16647517","86","11638534"
"chr9","28400445","28400752","GL873541","16268070","16268366","91","12132375"
"chr9","29130810","29131082","GL873667","4451263","4451534","86","24679547"
"chr9","29365731","29366038","GL873530","16647228","16647517","93","12718503"
"chr9","29396396","29396702","GL873541","16268070","16268366","90","13128326"
"chr9","29459013","29459303","GL873528","36697151","36697434","86","7238138"
"chr9","29591044","29591346","GL873752","427788","428097","86","29163256"
"chr9","29960526","29960826","GL873541","16268070","16268366","85","13692456"
"chr9","30251077","30251372","GL873541","16268070","16268366","89","13983007"
"chr9","30541985","30542296","GL873541","16268070","16268366","92","14273915"
"chr9","31281354","31281649","GL873547","2222074","2222356","84","29059280"
"chr9","31404682","31404998","GL873541","16268070","16268366","93","15136612"
"chr9","31597272","31597540","GL873565","12307556","12307825","95","19289716"
"chr9","31803610","31803894","GL873667","4451263","4451534","84","27352347"
"chr9","31906378","31906642","GL873562","3299887","3300144","86","28606491"
"chr9","32125196","32125331","GL873565","1666380","1666535","54","30458816"
"chr9","32604399","32604698","GL873541","16268070","16268366","78","16336329"
"chr9","33664309","33664589","GL873659","913070","913333","88","32751239"
"chr9","33949671","33949970","GL873530","16647228","16647517","93","17302443"
"chr9","34238966","34239271","GL873607","1418062","1418355","96","32820904"
"chr9","34571025","34571210","GL873630","2508568","2508753","66","32062457"
"chr9","34584819","34584990","GL873530","5593486","5593649","53","28991333"
"chr9","35115847","35116051","GL873521","1458597","1458764","76","33657250"
"chr9","35398950","35399260","GL873541","16268070","16268366","97","19130880"
"chr9","35523871","35524150","GL873562","3299887","3300144","96","32223984"
"chr9","35524179","35524190","GL873691","2903502","2903535","23","32620677"
"chr9","35626955","35627232","GL873547","2222074","2222356","88","33404881"
"chr9","36937433","36937631","GL873823","304319","304508","60","36633114"
"chr9","36981551","36981851","GL873541","16268070","16268366","82","20713481"
"chr9","37094555","37094860","GL873607","1418062","1418355","86","35676493"
"chr9","37176495","37176808","GL873541","16268070","16268366","101","20908425"
"chr9","37250014","37250336","GL873608","6630366","6630673","102","30619648"
"chr9","37506235","37506530","GL873541","16268070","16268366","91","21238165"
"chr9","37834594","37834907","GL873608","6630366","6630673","95","31204228"
"chr9","37917394","37917670","GL873530","16647228","16647517","90","21270166"
"chr9","38031843","38032141","GL873607","1418062","1418355","88","36613781"
"chr9","38032937","38033244","GL873528","36697151","36697434","88","1335786"
"chr9","38218018","38218314","GL873530","16647228","16647517","90","21570790"
"chr9","38433186","38433471","GL873541","16268070","16268366","94","22165116"
"chr9","38720826","38721120","GL873530","16647228","16647517","80","22073598"
"chr9","38837074","38837370","GL873530","16647228","16647517","80","22189846"
"chr9","39039867","39040150","GL873547","2222074","2222356","80","36817793"
"chr9","39131563","39131858","GL873607","1418062","1418355","90","37713501"
"chr9","39487572","39487853","GL873667","4451263","4451534","79","35036309"
"chr9","40611873","40612168","GL873659","913070","913333","94","39698803"
"chr9","41352290","41352411","GL873550","5998776","5998900","49","35353514"
"chr9","41489082","41489363","GL873541","16268070","16268366","94","25221012"
"chr9","41529323","41529631","GL873541","16268070","16268366","89","25261253"
"chr9","41554874","41555138","GL873530","16647228","16647517","91","24907646"
"chr9","41583753","41584046","GL873547","2222074","2222356","89","39361679"
"chr9","41715824","41716134","GL873547","2222074","2222356","100","39493750"
"chr9","42379110","42379415","GL873541","16268070","16268366","87","26111040"
"chr9","42526419","42526716","GL873541","16268070","16268366","83","26258349"
"chr9","43184239","43184544","GL873607","1418062","1418355","88","41766177"
"chr9","43231930","43232235","GL873547","2222074","2222356","91","41009856"
"chr9","44129525","44129702","GL873530","5593486","5593649","52","38536039"
"chr9","44129740","44129861","GL873550","5998776","5998900","40","38130964"
"chr9","44627579","44627756","GL873585","9209559","9209725","63","35418020"
"chr9","44637205","44637501","GL873541","16268070","16268366","88","28369135"
"chr9","44699947","44700265","GL873530","16647228","16647517","108","28052719"
"chr9","44855299","44855602","GL873541","16268070","16268366","93","28587229"
"chr9","44856525","44856829","GL873541","16268070","16268366","97","28588455"
"chr9","44890494","44890803","GL873547","2222074","2222356","85","42668420"
"chr9","44976434","44976562","GL873550","5998776","5998900","52","38977658"
"chr9","45115462","45115767","GL873541","16268070","16268366","94","28847392"
"chr9","45167813","45168121","GL873547","2222074","2222356","93","42945739"
"chr9","45229574","45229869","GL873530","16647228","16647517","87","28582346"
"chr9","45291084","45291370","GL873547","2222074","2222356","85","43069010"
"chr9","45309559","45309857","GL873530","16647228","16647517","86","28662331"
"chr9","46624912","46625212","GL873541","16268070","16268366","89","30356842"
"chr9","46711156","46711444","GL873547","2222074","2222356","93","44489082"
"chr9","46858385","46858682","GL873541","16268070","16268366","88","30590315"
"chr9","47580831","47581120","GL873530","16647228","16647517","87","30933603"
"chr9","47788519","47788631","GL873587","10002051","10002151","50","37786468"
"chr9","48488638","48488859","GL873531","3555300","3555500","65","44933338"
"chr9","48788101","48788226","GL873622","7076274","7076365","51","41711827"
"chr9","49543198","49543506","GL873541","16268070","16268366","95","33275128"
"chr9","50174527","50174800","GL873680","3005257","3005482","100","47169270"
"chr9","51130702","51130760","GL873527","37742071","37742124","24","13388631"
"chr9","52584616","52584911","GL873530","16647228","16647517","76","35937388"
"chr9","53365918","53366210","GL873530","16647228","16647517","80","36718690"
"chr9","53392827","53393126","GL873541","16268070","16268366","82","37124757"
"chr9","53409388","53409496","GL873643","6205658","6205743","47","47203730"
"chr9","53409532","53409725","GL873823","304319","304508","53","53105213"
"chr9","53482634","53482932","GL873528","36697151","36697434","115","16785483"
"chr9","53586174","53586479","GL873541","16268070","16268366","83","37318104"
"chr9","53616632","53616931","GL873541","16268070","16268366","82","37348562"
"chr9","53843723","53844024","GL873608","6630366","6630673","90","47213357"
"chr9","56192319","56192614","GL873547","2222074","2222356","80","53970245"
"chr9","56425008","56425194","GL873823","304319","304508","56","56120689"
"chr9","56661115","56661154","GL873731","2008517","2008552","22","54652598"
"chr9","56706151","56706456","GL873541","16268070","16268366","90","40438081"
"chr9","56963126","56963432","GL873607","1418062","1418355","95","55545064"
"chr9","57200375","57200688","GL873528","36697151","36697434","101","20503224"
"chr9","57398632","57398875","GL873640","6426205","6426399","91","50972427"
"chr9","57444017","57444321","GL873541","16268070","16268366","89","41175947"
"chr9","57682430","57682738","GL873541","16268070","16268366","92","41414360"
"chr9","57685249","57685546","GL873562","3299887","3300144","104","54385362"
"chr9","57732450","57732667","GL873538","2567037","2567262","61","55165413"
"chr9","57758315","57758609","GL873530","16647228","16647517","86","41111087"
"chr9","57842134","57842442","GL873541","16268070","16268366","85","41574064"
"chr9","57921121","57921405","GL873547","2222074","2222356","75","55699047"
"chr9","57930457","57930736","GL873547","2222074","2222356","89","55708383"
"chr9","57933408","57933710","GL873541","16268070","16268366","79","41665338"
"chr9","58080503","58080760","GL873543","13038674","13038909","88","45041829"
"chr9","58111172","58111449","GL873528","36697151","36697434","98","21414021"
"chr9","58131577","58131871","GL873541","16268070","16268366","91","41863507"
"chr9","58134791","58135089","GL873547","2222074","2222356","90","55912717"
"chr9","58155888","58156167","GL873562","3299887","3300144","84","54856001"
"chr9","58167683","58167979","GL873541","16268070","16268366","87","41899613"
"chr9","58506362","58506668","GL873541","16268070","16268366","93","42238292"
"chr9","58507566","58507653","GL873521","9884269","9884347","30","48623297"
"chr9","58606043","58606351","GL873530","16647228","16647517","95","41958815"
"chr9","58607834","58608063","GL873630","2508568","2508753","89","56099266"
"chr9","58645917","58646207","GL873530","16647228","16647517","77","41998689"
"chr9","58668568","58668702","GL873550","5998776","5998900","44","52669792"
"chr9","58670072","58670386","GL873528","36697151","36697434","104","21972921"
"chr9","58710862","58711158","GL873541","16268070","16268366","83","42442792"
"chr9","58730997","58731300","GL873541","16268070","16268366","86","42462927"
"chr9","58733287","58733589","GL873541","16268070","16268366","95","42465217"
"chr9","59060139","59060189","GL873527","37742071","37742124","24","21318068"
"chr9","59423774","59424053","GL873565","12307556","12307825","90","47116218"
"chr9","59439528","59439826","GL873541","16268070","16268366","89","43171458"
"chr9","60942007","60942325","GL873541","16268070","16268366","104","44673937"
"chr9","60950974","60951292","GL873541","16268070","16268366","104","44682904"
"chr9","61444147","61444444","GL873547","2222074","2222356","87","59222073"
"chr9","61648531","61648713","GL873530","5593486","5593649","56","56055045"
"chr9","61801514","61801812","GL873541","16268070","16268366","80","45533444"
"chr9","61842765","61843058","GL873530","16647228","16647517","83","45195537"
"chr9","61932207","61932503","GL873541","16268070","16268366","83","45664137"
"chr9","62008432","62008726","GL873541","16268070","16268366","85","45740362"
"chr9","62107659","62107981","GL873541","16268070","16268366","98","45839589"
"chr9","62219075","62219386","GL873541","16268070","16268366","87","45951005"
"chr9","62358644","62358941","GL873541","16268070","16268366","89","46090574"
"chr9","62372766","62372941","GL873530","5593486","5593649","52","56779280"
"chr9","62403015","62403310","GL873541","16268070","16268366","83","46134945"
"chr9","62505561","62505849","GL873530","16647228","16647517","77","45858333"
"chr9","62576210","62576517","GL873541","16268070","16268366","91","46308140"
"chr9","62603477","62603760","GL873547","2222074","2222356","87","60381403"
"chr9","62605265","62605568","GL873607","1418062","1418355","89","61187203"
"chr9","62609877","62610171","GL873547","2222074","2222356","83","60387803"
"chr9","62759956","62760257","GL873667","4451263","4451534","97","58308693"
"chr9","62857264","62857555","GL873530","16647228","16647517","87","46210036"
"chr9","62884448","62884749","GL873530","16647228","16647517","88","46237220"
"chr9","63035534","63035829","GL873541","16268070","16268366","96","46767464"
"chr9","63288555","63288786","GL873630","2508568","2508753","87","60779987"
"chr9","63346049","63346355","GL873541","16268070","16268366","89","47077979"
"chr9","63454003","63454248","GL873680","3005257","3005482","78","60448746"
"chr9","63510109","63510400","GL873541","16268070","16268366","85","47242039"
"chr9","63529374","63529673","GL873667","4451263","4451534","90","59078111"
"chr9","63956761","63957022","GL873680","3005257","3005482","95","60951504"
"chr9","64071102","64071411","GL873541","16268070","16268366","92","47803032"
"chr9","64212629","64212940","GL873528","36697151","36697434","94","27515478"
"chr9","64282193","64282488","GL873541","16268070","16268366","85","48014123"
"chr9","64943570","64943887","GL873541","16268070","16268366","109","48675500"
"chr9","64999445","64999694","GL873528","25203621","25203847","100","39795824"
"chr9","65259832","65260126","GL873530","16647228","16647517","91","48612604"
"chr9","65393011","65393302","GL873547","2222074","2222356","79","63170937"
"chr9","65472474","65472697","GL873531","3555300","3555500","68","61917174"
"chr9","65477386","65477685","GL873541","16268070","16268366","96","49209316"
"chr9","65726506","65726624","GL873622","7076274","7076365","50","58650232"
"chr9","65878775","65878915","GL873619","2497092","2497229","46","63381683"
"chr9","66244248","66244540","GL873547","2222074","2222356","92","64022174"
"chr9","66262949","66263158","GL873557","3858721","3858924","57","62404228"
"chr9","67035398","67035706","GL873607","1418062","1418355","98","65617336"
"chr9","67138092","67138396","GL873541","16268070","16268366","84","50870022"
"chr9","67628980","67629015","GL873731","2008517","2008552","15","65620463"
"chr9","67629312","67629469","GL873550","5998776","5998900","57","61630536"
"chr9","67639808","67639920","GL873603","2092720","2092796","59","65547088"
"chr9","67746620","67746918","GL873541","16268070","16268366","89","51478550"
"chr9","67760632","67760912","GL873659","913070","913333","86","66847562"
"chr9","67769205","67769511","GL873547","2222074","2222356","100","65547131"
"chr9","67870027","67870321","GL873547","2222074","2222356","85","65647953"
"chr9","68148214","68148507","GL873530","16647228","16647517","86","51500986"
"chr9","68644589","68644886","GL873541","16268070","16268366","81","52376519"
"chr9","69153009","69153268","GL873680","3005257","3005482","86","66147752"
"chr9","69241585","69241897","GL873541","16268070","16268366","89","52973515"
"chr9","69452636","69452932","GL873541","16268070","16268366","88","53184566"
"chr9","70321709","70322101","GL873559","3737111","3737481","143","66584598"
"chr9","70380929","70381021","GL873546","7627047","7627148","41","62753882"
"chr9","70458028","70458334","GL873541","16268070","16268366","93","54189958"
"chr9","70693452","70693731","GL873562","3299887","3300144","90","67393565"
"chr9","71261864","71262167","GL873608","6630366","6630673","84","64631498"
"chr9","71302456","71302761","GL873541","16268070","16268366","92","55034386"
"chr9","71336983","71337290","GL873541","16268070","16268366","89","55068913"
"chr9","71541710","71542000","GL873528","36697151","36697434","97","34844559"
"chr9","71553184","71553492","GL873607","1418062","1418355","95","70135122"
"chr9","72204818","72205147","GL873541","16268070","16268366","110","55936748"
"chr9","72945488","72945758","GL873535","4830564","4830824","89","68114924"
"chr9","74284985","74285274","GL873530","16647228","16647517","86","57637757"
"chr9","75383512","75383792","GL873547","2222074","2222356","83","73161438"
"chr9","75430497","75430792","GL873607","1418062","1418355","89","74012435"
"chr9","75686669","75686959","GL873530","16647228","16647517","89","59039441"
"chr9","75856373","75856677","GL873541","16268070","16268366","93","59588303"
"chr9","77639784","77640078","GL873752","427788","428097","92","77211996"
"chr9","77769706","77770010","GL873541","16268070","16268366","86","61501636"
"chr9","78073476","78073771","GL873530","16647228","16647517","84","61426248"
"chr9","78821434","78821740","GL873541","16268070","16268366","90","62553364"
"chr9","79042732","79043042","GL873541","16268070","16268366","92","62774662"
"chr9","79931572","79931872","GL873541","16268070","16268366","89","63663502"
"chr9","80798088","80798364","GL873547","2222074","2222356","89","78576014"
"chr9","80941843","80942007","GL873585","9209559","9209725","55","71732284"
"chr9","81013808","81014095","GL873547","2222074","2222356","77","78791734"
"chr9","81080759","81081052","GL873530","16647228","16647517","86","64433531"
"chr9","81148286","81148590","GL873528","36697151","36697434","91","44451135"
"chr9","82673644","82673950","GL873528","36697151","36697434","92","45976493"
"chr9","82673956","82674243","GL873680","3005257","3005482","111","79668699"
"chr9","82933673","82933981","GL873607","1418062","1418355","96","81515611"
"chr9","82934747","82934829","GL873520","23895808","23895898","38","59038939"
"chr9","84100088","84100388","GL873541","16268070","16268366","88","67832018"
"chr9","84128242","84128544","GL873541","16268070","16268366","89","67860172"
"chr9","84549588","84549890","GL873541","16268070","16268366","87","68281518"
"chr9","84846162","84846475","GL873547","2222074","2222356","96","82624088"
"chr9","85145434","85145738","GL873608","6630366","6630673","90","78515068"
"chr9","85157244","85157394","GL873541","1550303","1550443","45","83606941"
"chr9","85271496","85271805","GL873541","16268070","16268366","89","69003426"
"chr9","85410997","85411306","GL873530","16647228","16647517","98","68763769"
"chr9","85427055","85427353","GL873607","1418062","1418355","79","84008993"
"chr9","85446191","85446466","GL873547","2222074","2222356","93","83224117"
"chr9","85590626","85590929","GL873541","16268070","16268366","96","69322556"
"chr9","85636273","85636563","GL873530","16647228","16647517","81","68989045"
"chr9","85650594","85650901","GL873541","16268070","16268366","92","69382524"
"chr9","85854517","85854826","GL873541","16268070","16268366","88","69586447"
"chr9","85881610","85881918","GL873541","16268070","16268366","96","69613540"
"chr9","85885306","85885614","GL873541","16268070","16268366","88","69617236"
"chr9","85897385","85897596","GL873531","3555300","3555500","66","82342085"
"chr9","85945261","85945569","GL873541","16268070","16268366","96","69677191"
"chr9","86239175","86239476","GL873541","16268070","16268366","86","69971105"
"chr9","86462800","86463057","GL873680","3005257","3005482","85","83457543"
"chr9","86508245","86508534","GL873530","16647228","16647517","80","69861017"
"chr9","86584742","86585030","GL873530","16647228","16647517","82","69937514"
"chr9","86699927","86700224","GL873547","2222074","2222356","80","84477853"
"chr9","86755766","86756000","GL873557","3858721","3858924","76","82897045"
"chr9","86914519","86914814","GL873547","2222074","2222356","85","84692445"
"chr9","87614811","87615108","GL873541","16268070","16268366","85","71346741"
"chr9","87786102","87786399","GL873528","36697151","36697434","95","51088951"
"chr9","87793699","87793980","GL873547","2222074","2222356","83","85571625"
"chr9","88765558","88765871","GL873530","16647228","16647517","103","72118330"
"chr9","88766790","88767071","GL873530","16647228","16647517","90","72119562"
"chr9","88916735","88917024","GL873547","2222074","2222356","80","86694661"
"chr9","89506696","89506996","GL873541","16268070","16268366","89","73238626"
"chr9","89828662","89828969","GL873541","16268070","16268366","93","73560592"
"chr9","89864364","89864670","GL873541","16268070","16268366","90","73596294"
"chr9","89877762","89877892","GL873550","5998776","5998900","36","83878986"
"chr9","89899910","89900206","GL873752","427788","428097","84","89472122"
"chr9","90012081","90012374","GL873530","16647228","16647517","93","73364853"
"chr9","90075111","90075410","GL873547","2222074","2222356","87","87853037"
"chr9","90662318","90662625","GL873607","1418062","1418355","91","89244256"
"chr9","90820966","90821256","GL873547","2222074","2222356","77","88598892"
"chr9","91366737","91367038","GL873541","16268070","16268366","87","75098667"
"chr9","91986577","91986870","GL873607","1418062","1418355","76","90568515"
"chr9","92128473","92128648","GL873574","7318344","7318500","55","84810129"
"chr9","92146521","92146829","GL873541","16268070","16268366","83","75878451"
"chr9","92267415","92267704","GL873547","2222074","2222356","78","90045341"
"chr9","92308955","92309251","GL873541","16268070","16268366","76","76040885"
"chr9","92317558","92317853","GL873547","2222074","2222356","84","90095484"
"chr9","92431556","92431852","GL873541","16268070","16268366","84","76163486"
"chr9","92515837","92516145","GL873528","36697151","36697434","88","55818686"
"chr9","93004422","93004722","GL873528","36697151","36697434","119","56307271"
"chr9","93177011","93177307","GL873541","16268070","16268366","76","76908941"
"chr9","93270058","93270350","GL873528","36697151","36697434","96","56572907"
"chr9","94014462","94014754","GL873547","2222074","2222356","87","91792388"
"chr9","94273623","94273934","GL873541","16268070","16268366","96","78005553"
"chr9","94487850","94488148","GL873541","16268070","16268366","83","78219780"
"chr9","94823467","94823746","GL873562","3299887","3300144","85","91523580"
"chr9","94836769","94837069","GL873528","36697151","36697434","91","58139618"
"chr9","94895115","94895423","GL873528","36697151","36697434","93","58197964"
"chr9","95087866","95088160","GL873541","16268070","16268366","86","78819796"
"chr9","95286564","95286873","GL873607","1418062","1418355","97","93868502"
"chr9","95380691","95380840","GL873550","5998776","5998900","47","89381915"
"chr9","95481900","95482210","GL873541","16268070","16268366","93","79213830"
"chr9","95732281","95732561","GL873547","2222074","2222356","82","93510207"
"chr9","95871617","95871918","GL873530","16647228","16647517","86","79224389"
"chr9","95893210","95893517","GL873541","16268070","16268366","88","79625140"
"chr9","95918044","95918334","GL873541","16268070","16268366","85","79649974"
"chr9","95928999","95929295","GL873530","16647228","16647517","84","79281771"
"chr9","95932742","95933048","GL873541","16268070","16268366","88","79664672"
"chr9","96011649","96011958","GL873541","16268070","16268366","93","79743579"
"chr9","96160413","96160676","GL873562","3299887","3300144","97","92860526"
"chr9","96272747","96273028","GL873547","2222074","2222356","79","94050673"
"chr9","96286060","96286366","GL873541","16268070","16268366","88","80017990"
"chr9","96295119","96295420","GL873541","16268070","16268366","78","80027049"
"chr9","97168771","97169058","GL873528","36697151","36697434","86","60471620"
"chr9","97265638","97265929","GL873607","1418062","1418355","88","95847576"
"chr9","97661124","97661420","GL873530","16647228","16647517","83","81013896"
"chr9","98025352","98025582","GL873680","3005257","3005482","88","95020095"
"chr9","98451716","98451741","GL873691","2903502","2903535","19","95548214"
"chr9","98451886","98452164","GL873547","2222074","2222356","92","96229812"
"chr9","98453445","98453725","GL873547","2222074","2222356","81","96231371"
"chr9","99150611","99150768","GL873530","5593486","5593649","53","93557125"
"chr9","99706736","99707004","GL873659","913070","913333","96","98793666"
"chr9","99714018","99714298","GL873562","3299887","3300144","79","96414131"
"chr9","99884759","99885066","GL873528","36697151","36697434","91","63187608"
"chr9","99924801","99925102","GL873541","16268070","16268366","85","83656731"
"chr9","102021686","102021958","GL873562","3299887","3300144","87","98721799"
"chr9","102063613","102063962","GL873541","16268070","16268366","125","85795543"
"chr9","102171132","102171424","GL873541","16268070","16268366","90","85903062"
"chr9","102401107","102401408","GL873541","16268070","16268366","84","86133037"
"chr9","102562141","102562433","GL873547","2222074","2222356","82","100340067"
"chr9","102654131","102654414","GL873547","2222074","2222356","78","100432057"
"chr9","102983131","102983431","GL873607","1418062","1418355","80","101565069"
"chr9","103100202","103100514","GL873541","16268070","16268366","97","86832132"
"chr9","103138976","103139260","GL873547","2222074","2222356","79","100916902"
"chr9","103543040","103543342","GL873752","427788","428097","90","103115252"
"chr9","103826386","103826660","GL873528","36697151","36697434","94","67129235"
"chr9","104154348","104154646","GL873541","16268070","16268366","81","87886278"
"chr9","105264842","105265042","GL873554","16339732","16339922","60","88925110"
"chr9","105575072","105575353","GL873547","2222074","2222356","81","103352998"
"chr9","105978796","105979106","GL873541","16268070","16268366","95","89710726"
"chr9","106070100","106070395","GL873530","16647228","16647517","82","89422872"
"chr9","106480345","106480644","GL873541","16268070","16268366","90","90212275"
"chr9","106648222","106648531","GL873528","36697151","36697434","89","69951071"
"chr9","106946005","106946287","GL873530","16647228","16647517","88","90298777"
"chr9","107345252","107345537","GL873547","2222074","2222356","85","105123178"
"chr9","107431700","107431879","GL873530","5593486","5593649","55","101838214"
"chr9","107431918","107432039","GL873550","5998776","5998900","49","101433142"
"chr9","107561541","107561712","GL873574","7318344","7318500","58","100243197"
"chr9","107635736","107636023","GL873528","36697151","36697434","99","70938585"
"chr9","107655043","107655341","GL873530","16647228","16647517","96","91007815"
"chr9","107658239","107658538","GL873541","16268070","16268366","84","91390169"
"chr9","107667653","107667821","GL873530","5593486","5593649","53","102074167"
"chr9","107903655","107903958","GL873607","1418062","1418355","91","106485593"
"chr9","108072173","108072507","GL873541","16268070","16268366","124","91804103"
"chr9","108252209","108252516","GL873752","427788","428097","96","107824421"
"chr9","109572271","109572590","GL873752","427788","428097","102","109144483"
"chr9","111133985","111134291","GL873607","1418062","1418355","98","109715923"
"chr9","111183120","111183448","GL873541","16268070","16268366","111","94915050"
"chr9","111337288","111337584","GL873541","16268070","16268366","87","95069218"
"chr9","111920509","111920805","GL873541","16268070","16268366","79","95652439"
"chr9","111931133","111931342","GL873554","16339732","16339922","78","95591401"
"chr9","111931703","111931800","GL873622","7076274","7076365","38","104855429"
"chr9","111986262","111986571","GL873541","16268070","16268366","88","95718192"
"chr9","112015657","112015776","GL873622","7076274","7076365","43","104939383"
"chr9","112179487","112179789","GL873541","16268070","16268366","89","95911417"
"chr9","112478762","112478901","GL873541","1550303","1550443","61","110928459"
"chr9","112478902","112479025","GL873552","12711845","12711956","45","99767057"
"chr9","112506336","112506644","GL873528","36697151","36697434","92","75809185"
"chr9","112570496","112570836","GL873607","1418062","1418355","123","111152434"
"chr9","113022091","113022380","GL873547","2222074","2222356","82","110800017"
"chr9","114198366","114198650","GL873547","2222074","2222356","93","111976292"
"chr9","114569319","114569619","GL873659","913070","913333","84","113656249"
"chr9","114647001","114647280","GL873565","12307556","12307825","103","102339445"
"chr9","114669635","114669933","GL873608","6630366","6630673","85","108039269"
"chr9","114689314","114689468","GL873550","5998776","5998900","49","108690538"
"chr9","114693205","114693503","GL873541","16268070","16268366","80","98425135"
"chr9","114704023","114704332","GL873528","36697151","36697434","89","78006872"
"chr9","114780703","114780993","GL873547","2222074","2222356","79","112558629"
"chr9","115742475","115742773","GL873530","16647228","16647517","93","99095247"
"chr9","116103758","116104050","GL873541","16268070","16268366","88","99835688"
"chr9","117090585","117090897","GL873541","16268070","16268366","100","100822515"
"chr9","117104920","117105209","GL873547","2222074","2222356","73","114882846"
"chr9","117447767","117448062","GL873541","16268070","16268366","84","101179697"
"chr9","117468321","117468614","GL873607","1418062","1418355","90","116050259"
"chr9","117471956","117472107","GL873543","18789325","18789460","53","98682631"
"chr9","117553173","117553468","GL873607","1418062","1418355","91","116135111"
"chr9","117718342","117718597","GL873659","913070","913333","84","116805272"
"chr9","117819250","117819547","GL873547","2222074","2222356","85","115597176"
"chr9","118212875","118213175","GL873541","16268070","16268366","84","101944805"
"chr9","118502206","118502505","GL873528","36697151","36697434","92","81805055"
"chr9","119241694","119241960","GL873659","913070","913333","75","118328624"
"chr9","119499838","119500000","GL873530","5593486","5593649","48","113906352"
"chr9","119511304","119511603","GL873528","36697151","36697434","91","82814153"
"chr9","119662466","119662760","GL873659","913070","913333","84","118749396"
"chr9","119761241","119761543","GL873528","36697151","36697434","84","83064090"
"chr9","120076412","120076710","GL873541","16268070","16268366","86","103808342"
"chr9","120719378","120719663","GL873541","16268070","16268366","82","104451308"
"chr9","120994772","120995071","GL873547","2222074","2222356","90","118772698"
"chr9","121297150","121297424","GL873565","12307556","12307825","86","108989594"
"chr9","122258208","122258500","GL873607","1418062","1418355","87","120840146"
"chr9","122633388","122633672","GL873565","12307556","12307825","86","110325832"
"chr9","122688439","122688742","GL873608","6630366","6630673","85","116058073"
"chr9","122729670","122729833","GL873530","5593486","5593649","39","117136184"
"chr9","122981352","122981639","GL873607","1418062","1418355","90","121563290"
"chr9","124677133","124677428","GL873530","16647228","16647517","90","108029905"
"chr9","125588714","125589005","GL873547","2222074","2222356","89","123366640"
"chrX","31067","31367","GL873541","16268070","16268366","90","16237003"
"chrX","167136","167201","GL873527","37742071","37742124","23","37574935"
"chrX","238563","238744","GL873524","42560728","42560902","47","42322165"
"chrX","246016","246303","GL873565","12307556","12307825","88","12061540"
"chrX","276473","276749","GL873547","2222074","2222356","90","1945601"
"chrX","347902","348103","GL873521","1458597","1458764","69","1110695"
"chrX","388719","388999","GL873547","2222074","2222356","81","1833355"
"chrX","393783","394078","GL873547","2222074","2222356","88","1828291"
"chrX","555973","556115","GL873628","6402015","6402153","60","5846042"
"chrX","644767","645072","GL873541","16268070","16268366","100","15623303"
"chrX","648656","648963","GL873541","16268070","16268366","89","15619414"
"chrX","803016","803259","GL873640","6426205","6426399","90","5623189"
"chrX","924773","924921","GL873541","1550303","1550443","45","625530"
"chrX","1574328","1574653","GL873541","16268070","16268366","105","14693742"
"chrX","1994173","1994365","GL873535","24407607","24407780","57","22413434"
"chrX","2015756","2016053","GL873530","16647228","16647517","88","14631472"
"chrX","2972234","2972536","GL873541","16268070","16268366","87","13295836"
"chrX","5651910","5652138","GL873680","3005257","3005482","65","2646653"
"chrX","6571847","6572139","GL873547","2222074","2222356","79","4349773"
"chrX","6929619","6929911","GL873547","2222074","2222356","78","4707545"
"chrX","7030538","7030840","GL873528","36697151","36697434","94","29666613"
"chrX","8371532","8371844","GL873541","16268070","16268366","94","7896538"
"chrX","8450209","8450520","GL873541","16268070","16268366","99","7817861"
"chrX","9661823","9662102","GL873547","2222074","2222356","86","7439749"
"chrX","9917675","9917971","GL873530","16647228","16647517","88","6729553"
"chrX","10833505","10833807","GL873752","427788","428097","88","10405717"
"chrX","10891227","10891532","GL873541","16268070","16268366","84","5376843"
"chrX","11078548","11078855","GL873541","16268070","16268366","94","5189522"
"chrX","11264436","11264549","GL873550","5998776","5998900","41","5265660"
"chrX","12578700","12578996","GL873547","2222074","2222356","95","10356626"
"chrX","13750936","13751243","GL873547","2222074","2222356","91","11528862"
"chrX","13770781","13771028","GL873547","5449763","5449997","91","8321018"
"chrX","15182503","15182794","GL873547","2222074","2222356","88","12960429"
"chrX","15472103","15472409","GL873541","16268070","16268366","93","795967"
"chrX","16787052","16787197","GL873611","3799989","3800137","55","12987063"
"chrX","17208880","17209175","GL873607","1418062","1418355","87","15790818"
"chrX","17253815","17254108","GL873530","16647228","16647517","81","606587"
"chrX","17607321","17607456","GL873550","5998776","5998900","40","11608545"
"chrX","17670935","17671231","GL873530","16647228","16647517","77","1023707"
"chrX","17716344","17716633","GL873530","16647228","16647517","79","1069116"
"chrX","18237548","18237842","GL873541","16268070","16268366","95","1969478"
"chrX","18575272","18575575","GL873607","1418062","1418355","91","17157210"
"chrX","18610557","18610801","GL873557","3858721","3858924","92","14751836"
"chrX","18696547","18696849","GL873528","36697151","36697434","97","18000604"
"chrX","19817070","19817288","GL873625","6060130","6060345","65","13756940"
"chrX","20550878","20551180","GL873607","1418062","1418355","92","19132816"
"chrX","21015371","21015648","GL873562","3299887","3300144","88","17715484"
"chrX","21414541","21414857","GL873608","6630366","6630673","99","14784175"
"chrX","22117998","22118290","GL873547","2222074","2222356","79","19895924"
"chrX","22165889","22166197","GL873541","16268070","16268366","97","5897819"
"chrX","22263273","22263581","GL873607","1418062","1418355","92","20845211"
"chrX","22290067","22290351","GL873547","2222074","2222356","83","20067993"
"chrX","22291111","22291240","GL873550","5998776","5998900","36","16292335"
"chrX","22441873","22442168","GL873752","427788","428097","89","22014085"
"chrX","22769091","22769252","GL873585","9209559","9209725","58","13559532"
"chrX","22829405","22829716","GL873541","16268070","16268366","92","6561335"
"chrX","22987522","22987790","GL873680","3005257","3005482","97","19982265"
"chrX","23182631","23182933","GL873528","36697151","36697434","84","13514520"
"chrX","23470949","23471243","GL873541","16268070","16268366","84","7202879"
"chrX","23700187","23700515","GL873608","6630366","6630673","103","17069821"
"chrX","23709198","23709505","GL873528","36697151","36697434","94","12987953"
"chrX","25031930","25032223","GL873530","16647228","16647517","87","8384702"
"chrX","25041190","25041485","GL873530","16647228","16647517","78","8393962"
"chrX","25114903","25115212","GL873541","16268070","16268366","98","8846833"
"chrX","25189129","25189418","GL873547","2222074","2222356","95","22967055"
"chrX","25278669","25278849","GL873530","5593486","5593649","52","19685183"
"chrX","25445320","25445602","GL873530","16647228","16647517","92","8798092"
"chrX","25550974","25551266","GL873530","16647228","16647517","84","8903746"
"chrX","25795029","25795220","GL873823","304319","304508","58","25490710"
"chrX","25942314","25942621","GL873541","16268070","16268366","88","9674244"
"chrX","25950718","25951008","GL873530","16647228","16647517","83","9303490"
"chrX","26424289","26424585","GL873541","16268070","16268366","99","10156219"
"chrX","26479311","26479602","GL873547","2222074","2222356","74","24257237"
"chrX","26795226","26795533","GL873528","36697151","36697434","92","9901925"
"chrX","26822518","26822730","GL873640","6426205","6426399","73","20396313"
"chrX","26838912","26839217","GL873541","16268070","16268366","91","10570842"
"chrX","27003044","27003350","GL873528","36697151","36697434","97","9694107"
"chrX","27191887","27192195","GL873541","16268070","16268366","96","10923817"
"chrX","27745528","27745826","GL873752","427788","428097","82","27317740"
"chrX","27780980","27781289","GL873541","16268070","16268366","90","11512910"
"chrX","27930262","27930538","GL873659","913070","913333","90","27017192"
"chrX","28441716","28441974","GL873562","3299887","3300144","91","25141829"
"chrX","28657995","28658281","GL873530","16647228","16647517","87","12010767"
"chrX","28983794","28984018","GL873543","13038674","13038909","88","15945120"
"chrX","29122889","29123179","GL873530","16647228","16647517","87","12475661"
"chrX","29421069","29421376","GL873608","6630366","6630673","91","22790703"
"chrX","29423471","29423800","GL873608","6630366","6630673","113","22793105"
"chrX","29558025","29558318","GL873530","16647228","16647517","82","12910797"
"chrX","29570714","29571003","GL873547","2222074","2222356","80","27348640"
"chrX","29670774","29671076","GL873541","16268070","16268366","83","13402704"
"chrX","29833617","29833775","GL873585","9209559","9209725","53","20624058"
"chrX","30370992","30371286","GL873530","16647228","16647517","79","13723764"
"chrX","30701874","30702179","GL873528","36697151","36697434","89","5995277"
"chrX","31518548","31518858","GL873541","16268070","16268366","96","15250478"
"chrX","31589687","31589809","GL873552","12711845","12711956","51","18877842"
"chrX","31796420","31796709","GL873530","16647228","16647517","85","15149192"
"chrX","32243062","32243337","GL873562","3299887","3300144","86","28943175"
"chrX","32649258","32649566","GL873541","16268070","16268366","88","16381188"
"chrX","33027186","33027484","GL873541","16268070","16268366","87","16759116"
"chrX","33372284","33372581","GL873547","2222074","2222356","93","31150210"
"chrX","33652934","33653207","GL873530","16647228","16647517","98","17005706"
"chrX","33912908","33913193","GL873547","2222074","2222356","91","31690834"
"chrX","34090863","34091182","GL873541","16268070","16268366","97","17822793"
"chrX","34454786","34455054","GL873565","12307556","12307825","88","22147230"
"chrX","34581089","34581238","GL873585","9209559","9209725","56","25371530"
"chrX","34615908","34616239","GL873607","1418062","1418355","113","33197846"
"chrX","37267846","37268149","GL873541","16268070","16268366","86","20999776"
"chrX","37342702","37343011","GL873541","16268070","16268366","93","21074632"
"chrX","37510117","37510417","GL873530","16647228","16647517","86","20862889"
"chrX","37598773","37599077","GL873528","36697151","36697434","90","901622"
"chrX","37629343","37629581","GL873625","6060130","6060345","76","31569213"
"chrX","37746028","37746173","GL873541","1550303","1550443","49","36195725"
"chrX","37746430","37746490","GL873527","37742071","37742124","26","4359"
"chrX","37861407","37861589","GL873530","5593486","5593649","57","32267921"
"chrX","38077262","38077554","GL873541","16268070","16268366","80","21809192"
"chrX","38186867","38187158","GL873547","2222074","2222356","76","35964793"
"chrX","38237137","38237434","GL873541","16268070","16268366","83","21969067"
"chrX","38292909","38293216","GL873541","16268070","16268366","85","22024839"
"chrX","38462565","38462648","GL873546","7627047","7627148","39","30835518"
"chrX","38491163","38491471","GL873608","6630366","6630673","87","31860797"
"chrX","38494415","38494717","GL873607","1418062","1418355","84","37076353"
"chrX","38611512","38611809","GL873541","16268070","16268366","78","22343442"
"chrX","38621211","38621504","GL873530","16647228","16647517","93","21973983"
"chrX","38649521","38649815","GL873541","16268070","16268366","81","22381451"
"chrX","38700708","38700847","GL873541","1550303","1550443","59","37150405"
"chrX","38804025","38804323","GL873530","16647228","16647517","89","22156797"
"chrX","38856623","38856929","GL873541","16268070","16268366","88","22588553"
"chrX","39510488","39510791","GL873541","16268070","16268366","91","23242418"
"chrX","40270412","40270722","GL873752","427788","428097","91","39842624"
"chrX","40429653","40429961","GL873528","36697151","36697434","91","3732502"
"chrX","41521503","41521683","GL873530","5593486","5593649","68","35928017"
"chrX","41719158","41719438","GL873547","2222074","2222356","78","39497084"
"chrX","41878389","41878698","GL873541","16268070","16268366","87","25610319"
"chrX","41905010","41905298","GL873659","913070","913333","88","40991940"
"chrX","41933825","41934124","GL873541","16268070","16268366","90","25665755"
"chrX","41936824","41937138","GL873528","36697151","36697434","93","5239673"
"chrX","41991578","41991873","GL873541","16268070","16268366","95","25723508"
"chrX","41997399","41997696","GL873547","2222074","2222356","88","39775325"
"chrX","42007554","42007848","GL873528","36697151","36697434","85","5310403"
"chrX","42051106","42051420","GL873541","16268070","16268366","99","25783036"
"chrX","42102700","42103012","GL873752","427788","428097","99","41674912"
"chrX","42131988","42132277","GL873541","16268070","16268366","82","25863918"
"chrX","43777377","43777676","GL873547","2222074","2222356","81","41555303"
"chrX","43976893","43977176","GL873562","3299887","3300144","100","40677006"
"chrX","44238718","44239009","GL873530","16647228","16647517","84","27591490"
"chrX","44317094","44317397","GL873541","16268070","16268366","82","28049024"
"chrX","44659146","44659440","GL873530","16647228","16647517","86","28011918"
"chrX","44706716","44707031","GL873607","1418062","1418355","101","43288654"
"chrX","44765457","44765762","GL873541","16268070","16268366","96","28497387"
"chrX","44843876","44844005","GL873552","12711845","12711956","50","32132031"
"chrX","45160626","45160926","GL873530","16647228","16647517","81","28513398"
"chrX","45176036","45176346","GL873547","2222074","2222356","86","42953962"
"chrX","45346313","45346592","GL873562","3299887","3300144","86","42046426"
"chrX","45485426","45485697","GL873562","3299887","3300144","89","42185539"
"chrX","45497583","45497903","GL873547","2222074","2222356","107","43275509"
"chrX","45517655","45517669","GL873691","2903502","2903535","20","42614153"
"chrX","45517967","45518126","GL873530","5593486","5593649","56","39924481"
"chrX","45554787","45555062","GL873530","16647228","16647517","91","28907559"
"chrX","45701597","45701901","GL873547","2222074","2222356","89","43479523"
"chrX","46000995","46001304","GL873528","36697151","36697434","95","9303844"
"chrX","46213593","46213878","GL873541","16268070","16268366","91","29945523"
"chrX","46221523","46221808","GL873547","2222074","2222356","83","43999449"
"chrX","46516548","46516857","GL873541","16268070","16268366","95","30248478"
"chrX","46595117","46595394","GL873562","3299887","3300144","83","43295230"
"chrX","47726776","47727071","GL873541","16268070","16268366","77","31458706"
"chrX","47764320","47764623","GL873541","16268070","16268366","93","31496250"
"chrX","48482081","48482375","GL873530","16647228","16647517","89","31834853"
"chrX","49534531","49534828","GL873541","16268070","16268366","88","33266461"
"chrX","49589459","49589586","GL873552","12711845","12711956","53","36877614"
"chrX","49834303","49834604","GL873541","16268070","16268366","83","33566233"
"chrX","50105371","50105687","GL873541","16268070","16268366","98","33837301"
"chrX","50173920","50174228","GL873541","16268070","16268366","93","33905850"
"chrX","50314401","50314697","GL873530","16647228","16647517","85","33667173"
"chrX","50449700","50450001","GL873547","2222074","2222356","86","48227626"
"chrX","50512059","50512366","GL873541","16268070","16268366","90","34243989"
"chrX","51256568","51256876","GL873607","1418062","1418355","89","49838506"
"chrX","51954113","51954412","GL873541","16268070","16268366","79","35686043"
"chrX","52113070","52113307","GL873557","3858721","3858924","80","48254349"
"chrX","52195937","52196235","GL873530","16647228","16647517","86","35548709"
"chrX","52211528","52211834","GL873541","16268070","16268366","94","35943458"
"chrX","52279531","52279815","GL873530","16647228","16647517","88","35632303"
"chrX","52749386","52749689","GL873541","16268070","16268366","87","36481316"
"chrX","53262471","53262775","GL873541","16268070","16268366","94","36994401"
"chrX","55072908","55073148","GL873528","25203621","25203847","74","29869287"
"chrX","55414295","55414622","GL873541","16268070","16268366","107","39146225"
"chrX","55543373","55543674","GL873547","2222074","2222356","89","53321299"
"chrX","55588928","55589224","GL873541","16268070","16268366","83","39320858"
"chrX","55638054","55638168","GL873622","7076274","7076365","41","48561780"
"chrX","57832153","57832446","GL873528","36697151","36697434","93","21135002"
"chrX","58653577","58653858","GL873547","2222074","2222356","86","56431503"
"chrX","58936464","58936765","GL873659","913070","913333","97","58023394"
"chrX","58994083","58994385","GL873528","36697151","36697434","87","22296932"
"chrX","59145114","59145394","GL873547","2222074","2222356","81","56923040"
"chrX","59180543","59180839","GL873547","2222074","2222356","77","56958469"
"chrX","59433343","59433625","GL873547","2222074","2222356","90","57211269"
"chrX","60057029","60057325","GL873541","16268070","16268366","82","43788959"
"chrX","60403420","60403723","GL873541","16268070","16268366","83","44135350"
"chrX","60649445","60649759","GL873608","6630366","6630673","102","54019079"
"chrX","60684656","60684964","GL873541","16268070","16268366","92","44416586"
"chrX","60857217","60857504","GL873547","2222074","2222356","89","58635143"
"chrX","61006175","61006470","GL873547","2222074","2222356","75","58784101"
"chrX","61298159","61298442","GL873541","16268070","16268366","91","45030089"
"chrX","61307972","61308247","GL873528","36697151","36697434","92","24610821"
"chrX","61451744","61451869","GL873550","5998776","5998900","53","55452968"
"chrX","61756996","61757299","GL873541","16268070","16268366","88","45488926"
"chrX","64192264","64192524","GL873547","5449763","5449997","89","58742501"
"chrX","66670909","66671202","GL873530","16647228","16647517","82","50023681"
"chrX","66718809","66719106","GL873547","2222074","2222356","79","64496735"
"chrX","66835729","66835905","GL873530","5593486","5593649","56","61242243"
"chrX","66837968","66838254","GL873547","2222074","2222356","78","64615894"
"chrX","66890006","66890304","GL873541","16268070","16268366","90","50621936"
"chrX","67019055","67019356","GL873541","16268070","16268366","81","50750985"
"chrX","67414554","67414730","GL873585","9209559","9209725","54","58204995"
"chrX","68096695","68096999","GL873541","16268070","16268366","88","51828625"
"chrX","69769247","69769395","GL873530","5593486","5593649","54","64175761"
"chrX","70483943","70484226","GL873562","3299887","3300144","101","67184056"
"chrX","70899370","70899679","GL873608","6630366","6630673","97","64269004"
"chrX","71000271","71000334","GL873603","2092720","2092796","31","68907551"
"chrX","71108937","71109246","GL873541","16268070","16268366","94","54840867"
"chrX","71669937","71670242","GL873541","16268070","16268366","96","55401867"
"chrX","74279612","74279913","GL873607","1418062","1418355","96","72861550"
"chrX","75025184","75025222","GL873691","2903502","2903535","13","72121682"
"chrX","76267140","76267381","GL873528","25203621","25203847","87","51063519"
"chrX","76703169","76703456","GL873530","16647228","16647517","79","60055941"
"chrX","76719674","76719974","GL873541","16268070","16268366","84","60451604"
"chrX","77324374","77324510","GL873622","7076274","7076365","61","70248100"
"chrX","77382577","77382858","GL873547","2222074","2222356","84","75160503"
"chrX","77848675","77848984","GL873541","16268070","16268366","94","61580605"
"chrX","78367633","78367906","GL873562","3299887","3300144","89","75067746"
"chrX","78779381","78779687","GL873541","16268070","16268366","86","62511311"
"chrX","78950749","78950994","GL873528","25203621","25203847","86","53747128"
"chrX","81009213","81009508","GL873530","16647228","16647517","89","64361985"
"chrX","81295866","81296177","GL873607","1418062","1418355","102","79877804"
"chrX","82956023","82956330","GL873541","16268070","16268366","90","66687953"
"chrX","83516689","83516982","GL873565","12307556","12307825","96","71209133"
"chrX","84014332","84014584","GL873680","3005257","3005482","89","81009075"
"chrX","84654998","84655292","GL873607","1418062","1418355","86","83236936"
"chrX","85191239","85191542","GL873541","16268070","16268366","88","68923169"
"chrX","85322398","85322677","GL873562","3299887","3300144","93","82022511"
"chrX","85654277","85654587","GL873541","16268070","16268366","97","69386207"
"chrX","85693757","85694048","GL873528","36697151","36697434","83","48996606"
"chrX","85766361","85766653","GL873541","16268070","16268366","83","69498291"
"chrX","85829317","85829602","GL873547","2222074","2222356","78","83607243"
"chrX","85931987","85932257","GL873535","4830564","4830824","92","81101423"
"chrX","88542284","88542587","GL873667","4451263","4451534","96","84091021"
"chrX","89384564","89384871","GL873547","2222074","2222356","98","87162490"
"chrX","89385183","89385466","GL873547","2222074","2222356","79","87163109"
"chrX","89417992","89418174","GL873530","5593486","5593649","55","83824506"
"chrX","89653867","89653941","GL873554","10500008","10500061","27","79153859"
"chrX","89680401","89680694","GL873530","16647228","16647517","79","73033173"
"chrX","89705847","89706141","GL873530","16647228","16647517","95","73058619"
"chrX","89742775","89743068","GL873541","16268070","16268366","83","73474705"
"chrX","89774515","89774754","GL873528","25203621","25203847","85","64570894"
"chrX","89895070","89895375","GL873528","36697151","36697434","94","53197919"
"chrX","90594181","90594481","GL873541","16268070","16268366","79","74326111"
"chrX","90715027","90715323","GL873547","2222074","2222356","84","88492953"
"chrX","90939813","90940045","GL873680","3005257","3005482","68","87934556"
"chrX","91634237","91634528","GL873541","16268070","16268366","84","75366167"
"chrX","92031737","92032050","GL873541","16268070","16268366","99","75763667"
"chrX","92061605","92061898","GL873530","16647228","16647517","86","75414377"
"chrX","92139744","92140037","GL873541","16268070","16268366","87","75871674"
"chrX","92178511","92178733","GL873538","2567037","2567262","63","89611474"
"chrX","93288705","93289029","GL873547","2222074","2222356","118","91066631"
"chrX","93407735","93408042","GL873607","1418062","1418355","94","91989673"
"chrX","94042142","94042438","GL873541","16268070","16268366","89","77774072"
"chrX","94085782","94086067","GL873530","16647228","16647517","79","77438554"
"chrX","94914016","94914311","GL873547","2222074","2222356","86","92691942"
"chrX","95626245","95626526","GL873530","16647228","16647517","87","78979017"
"chrX","95678892","95679186","GL873541","16268070","16268366","80","79410822"
"chrX","97605103","97605403","GL873530","16647228","16647517","88","80957875"
"chrX","98332955","98333260","GL873530","16647228","16647517","93","81685727"
"chrX","98448235","98448532","GL873541","16268070","16268366","85","82180165"
"chrX","99571855","99571971","GL873550","5998776","5998900","48","93573079"
"chrX","99749721","99750008","GL873547","2222074","2222356","84","97527647"
"chrX","100082116","100082286","GL873560","5855436","5855580","66","94226680"
"chrX","100101177","100101483","GL873541","16268070","16268366","88","83833107"
"chrX","101271704","101272011","GL873541","16268070","16268366","116","85003634"
"chrX","101313701","101313970","GL873659","913070","913333","98","100400631"
"chrX","101551243","101551537","GL873541","16268070","16268366","82","85283173"
"chrX","101716125","101716341","GL873557","3858721","3858924","77","97857404"
"chrX","102054365","102054620","GL873547","5449763","5449997","90","96604602"
"chrX","102719621","102719759","GL873550","5998776","5998900","43","96720845"
"chrX","102908749","102909057","GL873541","16268070","16268366","84","86640679"
"chrX","103690587","103690853","GL873680","3005257","3005482","97","100685330"
"chrX","103871090","103871389","GL873530","16647228","16647517","92","87223862"
"chrX","104307505","104307815","GL873541","16268070","16268366","95","88039435"
"chrX","105034883","105035059","GL873530","5593486","5593649","52","99441397"
"chrX","105035101","105035194","GL873520","23895808","23895898","42","81139293"
"chrX","105230154","105230456","GL873547","2222074","2222356","94","103008080"
"chrX","105255765","105255881","GL873521","9884269","9884347","53","95371496"
"chrX","105256184","105256211","GL873691","2903502","2903535","17","102352682"
"chrX","105348076","105348380","GL873541","16268070","16268366","86","89080006"
"chrX","105436039","105436210","GL873530","5593486","5593649","41","99842553"
"chrX","107292270","107292573","GL873530","16647228","16647517","87","90645042"
"chrX","107405185","107405479","GL873530","16647228","16647517","84","90757957"
"chrX","108462793","108463063","GL873547","2222074","2222356","83","106240719"
"chrX","108581703","108581840","GL873550","5998776","5998900","40","102582927"
"chrX","109019895","109020211","GL873608","6630366","6630673","118","102389529"
"chrX","109997067","109997364","GL873607","1418062","1418355","85","108579005"
"chrX","110033309","110033615","GL873541","16268070","16268366","91","93765239"
"chrX","110082766","110083078","GL873528","36697151","36697434","91","73385615"
"chrX","110384449","110384738","GL873547","2222074","2222356","81","108162375"
"chrX","110835648","110835769","GL873619","2497092","2497229","54","108338556"
"chrX","111147394","111147703","GL873528","36697151","36697434","91","74450243"
"chrX","111529648","111529952","GL873541","16268070","16268366","83","95261578"
"chrX","111651674","111651980","GL873528","36697151","36697434","91","74954523"
"chrX","111735939","111736245","GL873541","16268070","16268366","87","95467869"
"chrX","111741254","111741564","GL873607","1418062","1418355","99","110323192"
"chrX","111860937","111861239","GL873541","16268070","16268366","89","95592867"
"chrX","111920717","111921020","GL873541","16268070","16268366","91","95652647"
"chrX","111956587","111956885","GL873530","16647228","16647517","90","95309359"
"chrX","111958920","111959222","GL873541","16268070","16268366","85","95690850"
"chrX","111986305","111986441","GL873622","7076274","7076365","61","104910031"
"chrX","112024341","112024568","GL873538","2567037","2567262","70","109457304"
"chrX","112564357","112564662","GL873541","16268070","16268366","96","96296287"
"chrX","112798429","112798648","GL873531","3555300","3555500","69","109243129"
"chrX","112938185","112938493","GL873541","16268070","16268366","89","96670115"
"chrX","114391790","114392083","GL873530","16647228","16647517","97","97744562"
"chrX","114563807","114563945","GL873628","6402015","6402153","54","108161792"
"chrX","115467837","115468152","GL873541","16268070","16268366","103","99199767"
"chrX","115863431","115863725","GL873541","16268070","16268366","83","99595361"
"chrX","116564124","116564433","GL873541","16268070","16268366","99","100296054"
"chrX","116656458","116656749","GL873547","2222074","2222356","80","114434384"
"chrX","117264554","117264858","GL873541","16268070","16268366","86","100996484"
"chrX","117755768","117756090","GL873608","6630366","6630673","96","111125402"
"chrX","118182064","118182317","GL873547","5449763","5449997","89","112732301"
"chrX","118289388","118289408","GL873691","2903502","2903535","20","115385886"
"chrX","118289457","118289709","GL873528","25203621","25203847","84","93085836"
"chrX","119012515","119012807","GL873547","2222074","2222356","77","116790441"
"chrX","119054955","119055198","GL873640","6426205","6426399","94","112628750"
"chrX","119095487","119095797","GL873607","1418062","1418355","94","117677425"
"chrX","119486036","119486347","GL873541","16268070","16268366","90","103217966"
"chrX","119796334","119796637","GL873541","16268070","16268366","101","103528264"
"chrX","120345103","120345411","GL873541","16268070","16268366","98","104077033"
"chrX","120888991","120889289","GL873541","16268070","16268366","82","104620921"
"chrX","121140605","121140902","GL873541","16268070","16268366","87","104872535"
"chrX","121174144","121174425","GL873547","2222074","2222356","86","118952070"
"chrX","121197060","121197345","GL873547","2222074","2222356","90","118974986"
"chrX","121463443","121463741","GL873541","16268070","16268366","90","105195373"
"chrX","121766970","121767247","GL873547","2222074","2222356","90","119544896"
"chrX","124044846","124044944","GL873524","43272658","43272747","41","80772188"
"chrX","124509631","124509844","GL873640","6426205","6426399","79","118083426"
"chrX","125597726","125598033","GL873607","1418062","1418355","89","124179664"
"chrX","125770526","125770749","GL873538","2567037","2567262","61","123203489"
"chrX","126026422","126026735","GL873528","36697151","36697434","96","89329271"
"chrX","126202780","126203078","GL873541","16268070","16268366","81","109934710"
"chrX","126577906","126578182","GL873547","2222074","2222356","84","124355832"
"chrX","127444889","127445196","GL873541","16268070","16268366","93","111176819"
"chrX","128244687","128244971","GL873547","2222074","2222356","92","126022613"
"chrX","128648873","128649172","GL873541","16268070","16268366","81","112380803"
"chrX","128760625","128760752","GL873622","7076274","7076365","52","121684351"
"chrX","128965771","128966056","GL873607","1418062","1418355","82","127547709"
"chrX","129188877","129189189","GL873607","1418062","1418355","103","127770815"
"chrX","129559518","129559811","GL873547","2222074","2222356","78","127337444"
"chrX","129744426","129744635","GL873531","3555300","3555500","62","126189126"
"chrY","420067","420368","GL873541","16268070","16268366","94","15848003"
"chrY","436198","436500","GL873541","16268070","16268366","96","15831872"
"chrY","967212","967518","GL873608","6630366","6630673","95","5663154"
"chrY","1040648","1040841","GL873535","24407607","24407780","59","23366959"
"chrY","1041155","1041191","GL873691","2903502","2903535","21","1862347"
"chrY","1126419","1126738","GL873541","16268070","16268366","110","15141651"
"chrY","1303428","1303700","GL873565","12307556","12307825","98","11004128"
"chrY","1309108","1309272","GL873560","5855436","5855580","64","4546328"
"chrY","1432483","1432759","GL873547","2222074","2222356","84","789591"
"chrY","1513352","1513631","GL873547","2222074","2222356","95","708722"
"chrY","1590752","1591046","GL873547","2222074","2222356","88","631322"
"chrY","2364931","2365185","GL873547","5449763","5449997","93","3084832"
"chrY","2466093","2466368","GL873562","3299887","3300144","98","833794"
"chrY","2947341","2947648","GL873541","16268070","16268366","100","13320729"
"chrY","3023141","3023417","GL873547","2222074","2222356","95","801067"
"chrY","3055757","3056044","GL873565","12307556","12307825","117","9251799"
"chrY","3349096","3349272","GL873530","5593486","5593649","61","2244390"
"chrY","3907360","3907654","GL873541","16268070","16268366","79","12360710"
"chrY","4218393","4218689","GL873541","16268070","16268366","94","12049677"
"chrY","4273439","4273739","GL873541","16268070","16268366","97","11994631"
"chrY","4288192","4288452","GL873547","2222074","2222356","100","2066118"
"chrY","4307035","4307295","GL873547","2222074","2222356","100","2084961"
"chrY","4476729","4477037","GL873547","2222074","2222356","108","2254655"
"chrY","4854341","4854619","GL873547","2222074","2222356","97","2632267"
"chrY","4897672","4897844","GL873530","5593486","5593649","67","695814"
"chrY","5141135","5141258","GL873550","5998776","5998900","41","857641"
"chrY","5241822","5242142","GL873541","16268070","16268366","102","11026248"
"chrY","5966693","5966993","GL873541","16268070","16268366","96","10301377"
"chr10","4456160","4456480","GL873541","16268070","16268366","113","11811910"
"chr10","25648","25946","GL873541","16268070","16268366","86","16242422"
"chr10","214000","214254","GL873528","25203621","25203847","85","24989621"
"chr10","331654","331952","GL873541","16268070","16268366","86","15936416"
"chr10","566086","566387","GL873541","16268070","16268366","91","15701984"
"chr10","1809321","1809617","GL873752","427788","428097","90","1381533"
"chr10","2002856","2003151","GL873530","16647228","16647517","85","14644372"
"chr10","2090892","2091004","GL873550","5998776","5998900","36","3907884"
"chr10","2093071","2093373","GL873541","16268070","16268366","82","14174999"
"chr10","2202474","2202766","GL873530","16647228","16647517","81","14444754"
"chr10","2305086","2305382","GL873541","16268070","16268366","84","13962984"
"chr10","2392993","2393285","GL873530","16647228","16647517","80","14254235"
"chr10","2398947","2399250","GL873541","16268070","16268366","90","13869123"
"chr10","2548528","2548653","GL873619","2497092","2497229","47","51436"
"chr10","2654634","2654928","GL873530","16647228","16647517","82","13992594"
"chr10","2699319","2699513","GL873630","2508568","2508753","75","190751"
"chr10","2741681","2741971","GL873541","16268070","16268366","108","13526389"
"chr10","2863772","2864000","GL873543","13038674","13038909","89","10174902"
"chr10","2879152","2879453","GL873547","2222074","2222356","86","657078"
"chr10","2924579","2924878","GL873541","16268070","16268366","85","13343491"
"chr10","2990888","2991187","GL873547","2222074","2222356","82","768814"
"chr10","3054215","3054517","GL873541","16268070","16268366","88","13213855"
"chr10","3146735","3147007","GL873562","3299887","3300144","88","153152"
"chr10","3183940","3184232","GL873547","2222074","2222356","84","961866"
"chr10","3212185","3212451","GL873562","3299887","3300144","87","87702"
"chr10","3357802","3358112","GL873528","36697151","36697434","94","33339349"
"chr10","3952502","3952782","GL873547","2222074","2222356","81","1730428"
"chr10","4026227","4026536","GL873541","16268070","16268366","103","12241843"
"chr10","4397964","4398071","GL873524","43272658","43272747","42","38874694"
"chr10","5463543","5463827","GL873528","36697151","36697434","93","31233608"
"chr10","6426904","6426923","GL873691","2903502","2903535","20","3523402"
"chr10","6426962","6427256","GL873547","2222074","2222356","106","4204888"
"chr10","6604599","6604904","GL873530","16647228","16647517","90","10042629"
"chr10","7768808","7769121","GL873541","16268070","16268366","100","8499262"
"chr10","7797356","7797663","GL873528","36697151","36697434","93","28899795"
"chr10","7911634","7911931","GL873530","16647228","16647517","89","8735594"
"chr10","8072735","8073035","GL873541","16268070","16268366","82","8195335"
"chr10","8208994","8209286","GL873530","16647228","16647517","84","8438234"
"chr10","8687736","8688014","GL873562","3299887","3300144","85","5387849"
"chr10","8877900","8878196","GL873667","4451263","4451534","92","4426637"
"chr10","9201728","9202027","GL873608","6630366","6630673","83","2571362"
"chr10","9299553","9299853","GL873547","2222074","2222356","100","7077479"
"chr10","10255291","10255578","GL873530","16647228","16647517","83","6391937"
"chr10","10812813","10813115","GL873541","16268070","16268366","95","5455257"
"chr10","12219788","12220083","GL873541","16268070","16268366","96","4048282"
"chr10","12406176","12406463","GL873530","16647228","16647517","85","4241052"
"chr10","13442881","13443202","GL873541","16268070","16268366","98","2825189"
"chr10","15445887","15446178","GL873547","2222074","2222356","86","13223813"
"chr10","15526811","15527117","GL873541","16268070","16268366","86","741259"
"chr10","15716114","15716444","GL873541","16268070","16268366","123","551956"
"chr10","15761052","15761080","GL873691","2903502","2903535","19","12857550"
"chr10","15761247","15761525","GL873562","3299887","3300144","88","12461360"
"chr10","16224051","16224189","GL873524","43272770","43272878","52","27048719"
"chr10","16411492","16411762","GL873562","3299887","3300144","92","13111605"
"chr10","16493852","16494144","GL873541","16268070","16268366","88","225782"
"chr10","17135780","17136077","GL873607","1418062","1418355","92","15717718"
"chr10","17940486","17940768","GL873547","2222074","2222356","90","15718412"
"chr10","18120093","18120403","GL873541","16268070","16268366","94","1852023"
"chr10","18339526","18339800","GL873547","2222074","2222356","92","16117452"
"chr10","18802261","18802546","GL873528","36697151","36697434","96","17894890"
"chr10","18939692","18939979","GL873547","2222074","2222356","84","16717618"
"chr10","18999032","18999324","GL873547","2222074","2222356","75","16776958"
"chr10","19424832","19425142","GL873528","36697151","36697434","90","17272319"
"chr10","19453903","19454200","GL873541","16268070","16268366","89","3185833"
"chr10","19464958","19465253","GL873541","16268070","16268366","90","3196888"
"chr10","19493425","19493724","GL873541","16268070","16268366","82","3225355"
"chr10","19583407","19583687","GL873547","2222074","2222356","80","17361333"
"chr10","19715617","19715909","GL873530","16647228","16647517","83","3068389"
"chr10","19743696","19743976","GL873547","2222074","2222356","86","17521622"
"chr10","20264517","20264820","GL873541","16268070","16268366","90","3996447"
"chr10","20320018","20320311","GL873547","2222074","2222356","89","18097944"
"chr10","20385629","20385910","GL873547","2222074","2222356","95","18163555"
"chr10","20449891","20450184","GL873528","36697151","36697434","84","16247260"
"chr10","20588769","20589059","GL873547","2222074","2222356","79","18366695"
"chr10","21171624","21171917","GL873607","1418062","1418355","86","19753562"
"chr10","21173478","21173783","GL873541","16268070","16268366","82","4905408"
"chr10","21184865","21185183","GL873752","427788","428097","105","20757077"
"chr10","21708343","21708646","GL873541","16268070","16268366","87","5440273"
"chr10","22366485","22366789","GL873541","16268070","16268366","88","6098415"
"chr10","22386619","22386887","GL873659","913070","913333","101","21473549"
"chr10","23691204","23691490","GL873547","2222074","2222356","78","21469130"
"chr10","23978015","23978297","GL873547","2222074","2222356","83","21755941"
"chr10","24210364","24210604","GL873640","6426205","6426399","87","17784159"
"chr10","24786097","24786370","GL873562","3299887","3300144","79","21486210"
"chr10","25077486","25077794","GL873541","16268070","16268366","99","8809416"
"chr10","25727281","25727589","GL873608","6630366","6630673","96","19096915"
"chr10","25885595","25885886","GL873547","2222074","2222356","86","23663521"
"chr10","26432221","26432521","GL873541","16268070","16268366","80","10164151"
"chr10","27733217","27733518","GL873530","16647228","16647517","84","11085989"
"chr10","27886679","27886911","GL873564","8360716","8360913","83","19525963"
"chr10","27965617","27965901","GL873547","2222074","2222356","85","25743543"
"chr10","29161569","29161885","GL873541","16268070","16268366","100","12893499"
"chr10","29167842","29168112","GL873607","1418062","1418355","87","27749780"
"chr10","29235668","29235977","GL873541","16268070","16268366","93","12967598"
"chr10","29894760","29894874","GL873550","5998776","5998900","42","23895984"
"chr10","29894904","29895042","GL873550","5998776","5998900","52","23896128"
"chr10","30034521","30034828","GL873541","16268070","16268366","97","13766451"
"chr10","30268895","30269196","GL873541","16268070","16268366","85","14000825"
"chr10","30600940","30601066","GL873550","5998776","5998900","40","24602164"
"chr10","30601093","30601265","GL873530","5593486","5593649","49","25007607"
"chr10","31368233","31368450","GL873531","3555300","3555500","60","27812933"
"chr10","31789353","31789654","GL873541","16268070","16268366","90","15521283"
"chr10","32385671","32385963","GL873541","16268070","16268366","89","16117601"
"chr10","34048860","34049145","GL873530","16647228","16647517","87","17401632"
"chr10","34411206","34411482","GL873547","2222074","2222356","86","32189132"
"chr10","35002409","35002551","GL873541","1550303","1550443","56","33452106"
"chr10","35699443","35699712","GL873530","16647228","16647517","90","19052215"
"chr10","35851222","35851530","GL873541","16268070","16268366","95","19583152"
"chr10","36189557","36189879","GL873541","16268070","16268366","103","19921487"
"chr10","36353769","36353875","GL873622","7076274","7076365","32","29277495"
"chr10","36695569","36695738","GL873530","5593486","5593649","48","31102083"
"chr10","36756542","36756841","GL873541","16268070","16268366","80","20488472"
"chr10","36825264","36825567","GL873608","6630366","6630673","94","30194898"
"chr10","36880393","36880679","GL873659","913070","913333","80","35967323"
"chr10","36955948","36956246","GL873547","2222074","2222356","87","34733874"
"chr10","37127384","37127702","GL873528","36697151","36697434","124","430233"
"chr10","37560874","37561092","GL873531","3555300","3555500","69","34005574"
"chr10","37561103","37561177","GL873554","10500008","10500061","26","27061095"
"chr10","37561184","37561370","GL874079","15836","16035","59","37545348"
"chr10","37570328","37570641","GL873547","2222074","2222356","89","35348254"
"chr10","37598393","37598550","GL873619","2497092","2497229","53","35101301"
"chr10","37599601","37599746","GL873550","5998776","5998900","45","31600825"
"chr10","37605288","37605585","GL873607","1418062","1418355","92","36187226"
"chr10","37608567","37608791","GL873680","3005257","3005482","65","34603310"
"chr10","37651658","37651775","GL873587","10002051","10002151","58","27649607"
"chr10","37738161","37738472","GL873541","16268070","16268366","86","21470091"
"chr10","38125277","38125547","GL873547","2222074","2222356","90","35903203"
"chr10","38837051","38837254","GL873558","7532067","7532273","53","31304984"
"chr10","39012436","39012740","GL873541","16268070","16268366","86","22744366"
"chr10","39386471","39386543","GL873603","2092720","2092796","31","37293751"
"chr10","39386554","39386748","GL873823","304319","304508","56","39082235"
"chr10","39409876","39410151","GL873565","12307556","12307825","98","27102320"
"chr10","39880415","39880688","GL873659","913070","913333","96","38967345"
"chr10","40165593","40165891","GL873541","16268070","16268366","94","23897523"
"chr10","40208228","40208448","GL874079","15836","16035","75","40192392"
"chr10","40361232","40361518","GL873547","2222074","2222356","82","38139158"
"chr10","40959869","40960178","GL873528","36697151","36697434","97","4262718"
"chr10","41444706","41445000","GL873607","1418062","1418355","89","40026644"
"chr10","41610159","41610449","GL873530","16647228","16647517","82","24962931"
"chr10","41694742","41694780","GL873691","2903502","2903535","19","38791240"
"chr10","41814994","41815260","GL873547","2222074","2222356","90","39592920"
"chr10","42441757","42441862","GL873622","7076274","7076365","41","35365483"
"chr10","42445632","42445931","GL873541","16268070","16268366","96","26177562"
"chr10","43143698","43143780","GL873526","41481654","41481719","34","1662044"
"chr10","43144027","43144201","GL873535","24407607","24407780","59","18736420"
"chr10","44221705","44222014","GL873530","16647228","16647517","92","27574477"
"chr10","44668601","44668784","GL873530","5593486","5593649","60","39075115"
"chr10","44701475","44701731","GL873535","4830564","4830824","95","39870911"
"chr10","44809026","44809265","GL873528","25203621","25203847","84","19605405"
"chr10","44809282","44809575","GL873530","16647228","16647517","113","28162054"
"chr10","45110078","45110374","GL873528","36697151","36697434","90","8412927"
"chr10","45188788","45189105","GL873541","16268070","16268366","102","28920718"
"chr10","45259644","45259927","GL873667","4451263","4451534","88","40808381"
"chr10","45882085","45882387","GL873530","16647228","16647517","87","29234857"
"chr10","45901179","45901478","GL873528","36697151","36697434","93","9204028"
"chr10","46688546","46688843","GL873541","16268070","16268366","91","30420476"
"chr10","46853643","46853932","GL873530","16647228","16647517","84","30206415"
"chr10","47833518","47833808","GL873530","16647228","16647517","84","31186290"
"chr10","48490165","48490441","GL873562","3299887","3300144","90","45190278"
"chr10","48509160","48509448","GL873547","2222074","2222356","82","46287086"
"chr10","48704743","48705050","GL873752","427788","428097","92","48276955"
"chr10","49103549","49103705","GL873530","5593486","5593649","49","43510063"
"chr10","49278965","49279257","GL873530","16647228","16647517","79","32631737"
"chr10","49425610","49425915","GL873541","16268070","16268366","91","33157540"
"chr10","49546042","49546354","GL873530","16647228","16647517","102","32898814"
"chr10","49673809","49674118","GL873528","36697151","36697434","100","12976658"
"chr10","50250809","50251017","GL873630","2508568","2508753","77","47742241"
"chr10","50486140","50486249","GL873526","41480965","41481045","47","9005175"
"chr10","50537691","50537999","GL873528","36697151","36697434","96","13840540"
"chr10","52051881","52052161","GL873547","2222074","2222356","90","49829807"
"chr10","52087880","52088168","GL873530","16647228","16647517","82","35440652"
"chr10","53737344","53737644","GL873607","1418062","1418355","88","52319282"
"chr10","53785833","53786161","GL873547","2222074","2222356","120","51563759"
"chr10","53802403","53802702","GL873541","16268070","16268366","85","37534333"
"chr10","53836009","53836303","GL873530","16647228","16647517","86","37188781"
"chr10","55092261","55092557","GL873530","16647228","16647517","84","38445033"
"chr10","55103055","55103196","GL873550","5998776","5998900","46","49104279"
"chr10","55103495","55103662","GL873530","5593486","5593649","46","49510009"
"chr10","55141969","55142258","GL873530","16647228","16647517","73","38494741"
"chr10","55314845","55315155","GL873541","16268070","16268366","88","39046775"
"chr10","55387922","55388248","GL873541","16268070","16268366","105","39119852"
"chr10","55415120","55415430","GL873541","16268070","16268366","97","39147050"
"chr10","55562512","55562784","GL873547","2222074","2222356","89","53340438"
"chr10","55600559","55600818","GL873535","4830564","4830824","87","50769995"
"chr10","55600856","55600868","GL873691","2903502","2903535","22","52697354"
"chr10","56204273","56204566","GL873530","16647228","16647517","83","39557045"
"chr10","56215129","56215431","GL873541","16268070","16268366","85","39947059"
"chr10","56448996","56449278","GL873547","2222074","2222356","85","54226922"
"chr10","56449279","56449356","GL873554","10500008","10500061","31","45949271"
"chr10","56449362","56449544","GL873823","304319","304508","61","56145043"
"chr10","56543534","56543675","GL873530","5593486","5593649","55","50950048"
"chr10","56543986","56544118","GL873550","5998776","5998900","33","50545210"
"chr10","56563339","56563485","GL873585","9209559","9209725","59","47353780"
"chr10","56640238","56640512","GL873547","2222074","2222356","93","54418164"
"chr10","56727899","56728203","GL873541","16268070","16268366","91","40459829"
"chr10","56765965","56766265","GL873541","16268070","16268366","80","40497895"
"chr10","56832675","56832970","GL873541","16268070","16268366","83","40564605"
"chr10","57007821","57008047","GL873680","3005257","3005482","88","54002564"
"chr10","57008363","57008642","GL873547","2222074","2222356","91","54786289"
"chr10","57188827","57189097","GL873680","3005257","3005482","94","54183570"
"chr10","57333791","57334094","GL873528","36697151","36697434","89","20636640"
"chr10","57361441","57361488","GL873554","10500008","10500061","16","46861433"
"chr10","57390087","57390291","GL873554","16339732","16339922","61","41050355"
"chr10","57390608","57390714","GL873526","41480965","41481045","36","15909643"
"chr10","57396087","57396375","GL873547","2222074","2222356","86","55174013"
"chr10","57461670","57461973","GL873541","16268070","16268366","84","41193600"
"chr10","57477315","57477606","GL873541","16268070","16268366","86","41209245"
"chr10","57547890","57548186","GL873541","16268070","16268366","79","41279820"
"chr10","57694715","57695024","GL873541","16268070","16268366","94","41426645"
"chr10","58036305","58036593","GL873530","16647228","16647517","97","41389077"
"chr10","58086036","58086274","GL873531","3555300","3555500","72","54530736"
"chr10","58837138","58837272","GL873541","1550303","1550443","54","57286835"
"chr10","58908080","58908380","GL873541","16268070","16268366","86","42640010"
"chr10","59246104","59246394","GL873547","2222074","2222356","84","57024030"
"chr10","59381937","59382244","GL873541","16268070","16268366","90","43113867"
"chr10","59391512","59391815","GL873541","16268070","16268366","90","43123442"
"chr10","59437483","59437798","GL873541","16268070","16268366","97","43169413"
"chr10","59653958","59654257","GL873541","16268070","16268366","82","43385888"
"chr10","59935987","59936305","GL873607","1418062","1418355","97","58517925"
"chr10","60037834","60038127","GL873659","913070","913333","100","59124764"
"chr10","60038144","60038373","GL873680","3005257","3005482","72","57032887"
"chr10","60046425","60046732","GL873541","16268070","16268366","90","43778355"
"chr10","60498284","60498587","GL873541","16268070","16268366","88","44230214"
"chr10","61091762","61092101","GL873608","6630366","6630673","115","54461396"
"chr10","61141491","61141780","GL873528","36697151","36697434","96","24444340"
"chr10","61503423","61503693","GL873562","3299887","3300144","82","58203536"
"chr10","61917097","61917321","GL873630","2508568","2508753","85","59408529"
"chr10","61946373","61946539","GL873530","5593486","5593649","44","56352887"
"chr10","62715909","62716211","GL873541","16268070","16268366","85","46447839"
"chr10","63585093","63585357","GL873659","913070","913333","78","62672023"
"chr10","63748814","63749123","GL873541","16268070","16268366","94","47480744"
"chr10","63841685","63841989","GL873541","16268070","16268366","84","47573615"
"chr10","63884109","63884414","GL873608","6630366","6630673","91","57253743"
"chr10","64531801","64532097","GL873528","36697151","36697434","92","27834650"
"chr10","64760384","64760672","GL873530","16647228","16647517","77","48113156"
"chr10","65391026","65391336","GL873530","16647228","16647517","96","48743798"
"chr10","65806364","65806672","GL873541","16268070","16268366","94","49538294"
"chr10","66128392","66128503","GL873622","7076274","7076365","38","59052118"
"chr10","70052063","70052371","GL873541","16268070","16268366","83","53783993"
"chr10","70166768","70166790","GL873691","2903502","2903535","17","67263266"
"chr10","70166841","70167110","GL873812","559768","560073","98","69607073"
"chr10","70414517","70414733","GL873531","3555300","3555500","62","66859217"
"chr10","70519891","70520197","GL873541","16268070","16268366","94","54251821"
"chr10","70850890","70851182","GL873547","2222074","2222356","83","68628816"
"chr10","71113452","71113728","GL873562","3299887","3300144","86","67813565"
"chr10","72358900","72359198","GL873530","16647228","16647517","85","55711672"
"chr10","72495505","72495796","GL873659","913070","913333","79","71582435"
"chr10","72537998","72538289","GL873547","2222074","2222356","93","70315924"
"chr10","73450470","73450762","GL873530","16647228","16647517","89","56803242"
"chr10","73786629","73786934","GL873528","36697151","36697434","90","37089478"
"chr10","73792040","73792329","GL873547","2222074","2222356","84","71569966"
"chr10","74072043","74072330","GL873547","2222074","2222356","80","71849969"
"chr10","74618237","74618530","GL873530","16647228","16647517","81","57971009"
"chr10","74750624","74750931","GL873528","36697151","36697434","92","38053473"
"chr10","75070547","75070849","GL873541","16268070","16268366","90","58802477"
"chr10","75404599","75404761","GL873530","5593486","5593649","53","69811113"
"chr10","75475335","75475550","GL873640","6426205","6426399","70","69049130"
"chr10","75740191","75740486","GL873541","16268070","16268366","92","59472121"
"chr10","75901598","75901887","GL873528","36697151","36697434","96","39204447"
"chr10","76016820","76017107","GL873659","913070","913333","89","75103750"
"chr10","76125498","76125800","GL873541","16268070","16268366","80","59857428"
"chr10","76770405","76770708","GL873530","16647228","16647517","89","60123177"
"chr10","77202412","77202718","GL873607","1418062","1418355","95","75784350"
"chr10","78278041","78278370","GL873608","6630366","6630673","108","71647675"
"chr10","78743702","78744008","GL873541","16268070","16268366","101","62475632"
"chr10","78944088","78944385","GL873607","1418062","1418355","93","77526026"
"chr10","79624934","79625163","GL873680","3005257","3005482","83","76619677"
"chr10","79682474","79682695","GL873538","2567037","2567262","81","77115437"
"chr10","81011898","81012046","GL873541","1550303","1550443","51","79461595"
"chr10","81249173","81249437","GL873535","4830564","4830824","90","76418609"
"chr10","81269444","81269788","GL873541","16268070","16268366","125","65001374"
"chr10","81609954","81610233","GL873547","2222074","2222356","86","79387880"
"chr10","81709556","81709863","GL873541","16268070","16268366","90","65441486"
"chr10","82223974","82224279","GL873541","16268070","16268366","87","65955904"
"chr10","82421989","82422214","GL873680","3005257","3005482","66","79416732"
"chr10","82516168","82516441","GL873565","12307556","12307825","97","70208612"
"chr10","82609947","82610224","GL873547","2222074","2222356","102","80387873"
"chr10","82860078","82860143","GL873603","2092652","2092704","31","80767426"
"chr10","82955938","82956240","GL873541","16268070","16268366","87","66687868"
"chr10","82963214","82963322","GL873546","7627047","7627148","31","75336167"
"chr10","83009655","83009950","GL873547","2222074","2222356","86","80787581"
"chr10","83091676","83091982","GL873541","16268070","16268366","89","66823606"
"chr10","83124898","83125081","GL873530","5593486","5593649","62","77531412"
"chr10","84048177","84048499","GL873541","16268070","16268366","112","67780107"
"chr10","84071206","84071512","GL873541","16268070","16268366","92","67803136"
"chr10","84502923","84503216","GL873530","16647228","16647517","82","67855695"
"chr10","85056318","85056623","GL873528","36697151","36697434","91","48359167"
"chr10","85283682","85283779","GL873541","15100979","15101074","27","70182703"
"chr10","85456712","85457001","GL873530","16647228","16647517","82","68809484"
"chr10","86457433","86457738","GL873541","16268070","16268366","92","70189363"
"chr10","86802755","86803046","GL873530","16647228","16647517","83","70155527"
"chr10","87456165","87456474","GL873608","6630366","6630673","92","80825799"
"chr10","87858402","87858702","GL873541","16268070","16268366","89","71590332"
"chr10","87920761","87921058","GL873530","16647228","16647517","82","71273533"
"chr10","87926341","87926632","GL873530","16647228","16647517","81","71279113"
"chr10","87962380","87962675","GL873530","16647228","16647517","100","71315152"
"chr10","87962683","87962818","GL873550","5998776","5998900","41","81963907"
"chr10","87966947","87967243","GL873608","6630366","6630673","90","81336581"
"chr10","88093487","88093732","GL873543","13038674","13038909","97","75054813"
"chr10","88097615","88097749","GL873550","5998776","5998900","37","82098839"
"chr10","88108429","88108733","GL873528","36697151","36697434","96","51411278"
"chr10","88122626","88122919","GL873752","427788","428097","83","87694838"
"chr10","88195911","88196204","GL873530","16647228","16647517","87","71548683"
"chr10","88224804","88224966","GL873691","508903","509045","54","87715901"
"chr10","88228013","88228321","GL873541","16268070","16268366","89","71959943"
"chr10","88241995","88242287","GL873547","2222074","2222356","84","86019921"
"chr10","88277475","88277771","GL873530","16647228","16647517","73","71630247"
"chr10","88288814","88289117","GL873541","16268070","16268366","86","72020744"
"chr10","88294099","88294387","GL873541","16268070","16268366","85","72026029"
"chr10","88377981","88378281","GL873530","16647228","16647517","100","71730753"
"chr10","88627183","88627485","GL873541","16268070","16268366","88","72359113"
"chr10","88746594","88746679","GL873764","716399","716485","37","88030195"
"chr10","88746680","88746875","GL873531","3555300","3555500","58","85191380"
"chr10","88981387","88981670","GL873562","3299887","3300144","101","85681500"
"chr10","89006976","89007181","GL873557","3858721","3858924","57","85148255"
"chr10","89176844","89177133","GL873530","16647228","16647517","89","72529616"
"chr10","89318076","89318373","GL873547","2222074","2222356","80","87096002"
"chr10","89398002","89398293","GL873607","1418062","1418355","83","87979940"
"chr10","89425933","89426226","GL873530","16647228","16647517","88","72778705"
"chr10","89968309","89968588","GL873528","36697151","36697434","79","53271158"
"chr10","90803166","90803470","GL873541","16268070","16268366","88","74535096"
"chr10","91728462","91728760","GL873541","16268070","16268366","87","75460392"
"chr10","91737432","91737490","GL873550","5998911","5998963","30","85738521"
"chr10","91758304","91758599","GL873607","1418062","1418355","84","90340242"
"chr10","91828650","91828947","GL873659","913070","913333","85","90915580"
"chr10","91907169","91907441","GL873565","12307556","12307825","100","79599613"
"chr10","91968644","91968940","GL873541","16268070","16268366","91","75700574"
"chr10","92316264","92316540","GL873547","2222074","2222356","90","90094190"
"chr10","92373753","92374046","GL873547","2222074","2222356","76","90151679"
"chr10","92839454","92839761","GL873541","16268070","16268366","93","76571384"
"chr10","93046387","93046686","GL873547","2222074","2222356","86","90824313"
"chr10","93246616","93246918","GL873530","16647228","16647517","90","76599388"
"chr10","93321183","93321422","GL873538","2567037","2567262","83","90754146"
"chr10","93452866","93453165","GL873528","36697151","36697434","95","56755715"
"chr10","93456897","93457204","GL873812","559768","560073","96","92897129"
"chr10","93505199","93505495","GL873541","16268070","16268366","80","77237129"
"chr10","93571043","93571332","GL873547","2222074","2222356","81","91348969"
"chr10","93660216","93660534","GL873541","16268070","16268366","97","77392146"
"chr10","93857116","93857194","GL873643","6205658","6205743","36","87651458"
"chr10","93857219","93857287","GL873554","10500008","10500061","34","83357211"
"chr10","93859926","93860235","GL873530","16647228","16647517","89","77212698"
"chr10","93863919","93863967","GL873691","2903502","2903535","27","90960417"
"chr10","93895653","93895962","GL873530","16647228","16647517","90","77248425"
"chr10","93947922","93948219","GL873528","36697151","36697434","97","57250771"
"chr10","94012577","94012864","GL873547","2222074","2222356","78","91790503"
"chr10","94020388","94020642","GL873680","3005257","3005482","88","91015131"
"chr10","94104509","94104789","GL873528","36697151","36697434","90","57407358"
"chr10","94455021","94455185","GL873585","9209559","9209725","55","85245462"
"chr10","94455223","94455247","GL873731","2008517","2008552","17","92446706"
"chr10","94677717","94678006","GL873530","16647228","16647517","88","78030489"
"chr10","95610573","95610874","GL873541","16268070","16268366","98","79342503"
"chr10","95924260","95924518","GL873640","6426205","6426399","100","89498055"
"chr10","95924559","95924577","GL873691","2903502","2903535","21","93021057"
"chr10","96343740","96344004","GL873680","3005257","3005482","87","93338483"
"chr10","97260354","97260495","GL873541","1550303","1550443","60","95710051"
"chr10","97869814","97870118","GL873541","16268070","16268366","85","81601744"
"chr10","98216152","98216239","GL873521","9884269","9884347","37","88331883"
"chr10","98940569","98940870","GL873547","2222074","2222356","86","96718495"
"chr10","99022351","99022661","GL873541","16268070","16268366","99","82754281"
"chr10","99155677","99155874","GL874079","15836","16035","73","99139841"
"chr10","99464348","99464633","GL873530","16647228","16647517","89","82817120"
"chr10","100143125","100143331","GL873554","16339732","16339922","60","83803393"
"chr10","100143342","100143384","GL873731","2008517","2008552","21","98134825"
"chr10","100170135","100170437","GL873528","36697151","36697434","85","63472984"
"chr10","100317523","100317819","GL873530","16647228","16647517","88","83670295"
"chr10","100754282","100754583","GL873530","16647228","16647517","88","84107054"
"chr10","101635559","101635865","GL873541","16268070","16268366","96","85367489"
"chr10","101934613","101934921","GL873541","16268070","16268366","91","85666543"
"chr10","102332242","102332544","GL873607","1418062","1418355","84","100914180"
"chr10","102390409","102390561","GL873541","1550303","1550443","47","100840106"
"chr10","102474090","102474388","GL873530","16647228","16647517","87","85826862"
"chr10","102994960","102995276","GL873659","913070","913333","106","102081890"
"chr10","103943451","103943533","GL873526","41481654","41481719","43","62461797"
"chr10","103943544","103943665","GL873622","7076274","7076365","46","96867270"
"chr10","103972130","103972329","GL873823","304319","304508","57","103667811"
"chr10","103972356","103972633","GL873528","36697151","36697434","94","67275205"
"chr10","104064558","104064860","GL873547","2222074","2222356","82","101842484"
"chr10","104150273","104150586","GL873541","16268070","16268366","96","87882203"
"chr10","104234263","104234563","GL873530","16647228","16647517","90","87587035"
"chr10","104247264","104247564","GL873530","16647228","16647517","83","87600036"
"chr10","104330612","104330907","GL873530","16647228","16647517","78","87683384"
"chr10","104506113","104506306","GL873521","1458597","1458764","58","103047516"
"chr10","104599756","104600053","GL873530","16647228","16647517","92","87952528"
"chr10","104604093","104604274","GL873585","9209559","9209725","54","95394534"
"chr10","104632102","104632471","GL873559","3737111","3737481","119","100894991"
"chr10","105094340","105094638","GL873528","36697151","36697434","89","68397189"
"chr10","105254047","105254345","GL873541","16268070","16268366","84","88985977"
"chr10","105268238","105268296","GL873527","37742071","37742124","23","67526167"
"chr10","105270766","105270888","GL873622","7076274","7076365","46","98194492"
"chr10","105496928","105497224","GL873530","16647228","16647517","84","88849700"
"chr10","105566815","105567106","GL873547","2222074","2222356","81","103344741"
"chr10","105580133","105580401","GL873547","5449763","5449997","85","100130370"
"chr10","105644843","105645137","GL873530","16647228","16647517","87","88997615"
"chr10","105868797","105869096","GL873541","16268070","16268366","91","89600727"
"chr10","106138132","106138427","GL873528","36697151","36697434","91","69440981"
"chr10","106400684","106400962","GL873547","2222074","2222356","87","104178610"
"chr10","106504190","106504252","GL873554","10500008","10500061","20","96004182"
"chr10","106504253","106504561","GL873541","16268070","16268366","104","90236183"
"chr10","106766454","106766533","GL873554","10500008","10500061","38","96266446"
"chr10","107407586","107407873","GL873752","427788","428097","97","106979798"
"chr10","107591835","107592142","GL873541","16268070","16268366","92","91323765"
"chr10","107992287","107992588","GL873541","16268070","16268366","90","91724217"
"chr10","108353574","108353873","GL873541","16268070","16268366","86","92085504"
"chr10","108728202","108728501","GL873608","6630366","6630673","87","102097836"
"chr10","108745454","108745705","GL873543","13038674","13038909","101","95706780"
"chr10","108912674","108912972","GL873530","16647228","16647517","91","92265446"
"chr10","110305067","110305188","GL873550","5998776","5998900","50","104306291"
"chr10","110366848","110367136","GL873528","36697151","36697434","99","73669697"
"chr10","110800532","110800647","GL873622","7076274","7076365","43","103724258"
"chr10","111018242","111018509","GL873680","3005257","3005482","93","108012985"
"chr10","111520366","111520672","GL873659","913070","913333","93","110607296"
"chr10","112215671","112215775","GL873622","7076274","7076365","41","105139397"
"chr10","112298163","112298459","GL873607","1418062","1418355","91","110880101"
"chr10","112871146","112871443","GL873541","16268070","16268366","84","96603076"
"chr10","113050222","113050344","GL873622","7076274","7076365","49","105973948"
"chr10","113084712","113085016","GL873541","16268070","16268366","86","96816642"
"chr10","113669647","113669956","GL873541","16268070","16268366","93","97401577"
"chr10","113778750","113778868","GL873622","7076274","7076365","52","106702476"
"chr10","113971484","113971784","GL873541","16268070","16268366","85","97703414"
"chr10","114261837","114262126","GL873530","16647228","16647517","92","97614609"
"chr10","114771985","114772256","GL873562","3299887","3300144","95","111472098"
"chr10","115019004","115019300","GL873547","2222074","2222356","78","112796930"
"chr10","115060730","115061040","GL873528","36697151","36697434","99","78363579"
"chr10","115413660","115413806","GL873550","5998776","5998900","46","109414884"
"chr10","115555729","115556012","GL873547","2222074","2222356","89","113333655"
"chr10","115848650","115848821","GL873524","23693028","23693185","65","92155622"
"chr10","115888216","115888496","GL873562","3299887","3300144","85","112588329"
"chr10","115914484","115914778","GL873547","2222074","2222356","77","113692410"
"chr10","116055181","116055460","GL873547","2222074","2222356","87","113833107"
"chr10","116097668","116097838","GL873530","5593486","5593649","50","110504182"
"chr10","116507433","116507737","GL873541","16268070","16268366","93","100239363"
"chr10","116698909","116699187","GL873547","2222074","2222356","94","114476835"
"chr10","116796877","116797173","GL873607","1418062","1418355","91","115378815"
"chr10","116871819","116871952","GL873550","5998776","5998900","36","110873043"
"chr10","117007658","117007955","GL873528","36697151","36697434","84","80310507"
"chr10","117276725","117277019","GL873530","16647228","16647517","81","100629497"
"chr10","117347458","117347702","GL873547","5449763","5449997","86","111897695"
"chr10","117357103","117357401","GL873541","16268070","16268366","87","101089033"
"chr10","117669978","117670254","GL873562","3299887","3300144","88","114370091"
"chr10","117671648","117671953","GL873541","16268070","16268366","91","101403578"
"chr10","117711495","117711794","GL873528","36697151","36697434","87","81014344"
"chr10","117906466","117906611","GL873529","2453810","2453957","53","115452656"
"chr10","118170959","118171264","GL873541","16268070","16268366","89","101902889"
"chr10","118215467","118215750","GL873547","2222074","2222356","84","115993393"
"chr10","118586250","118586535","GL873547","2222074","2222356","86","116364176"
"chr10","118606299","118606602","GL873541","16268070","16268366","88","102338229"
"chr10","118697199","118697503","GL873541","16268070","16268366","95","102429129"
"chr10","118747331","118747652","GL873608","6630366","6630673","101","112116965"
"chr10","119103850","119104131","GL873547","2222074","2222356","87","116881776"
"chr10","119350464","119350773","GL873608","6630366","6630673","101","112720098"
"chr10","119868571","119868860","GL873530","16647228","16647517","85","103221343"
"chr10","119989338","119989702","GL873608","6630366","6630673","135","113358972"
"chr10","119989713","119990022","GL873547","2222074","2222356","93","117767639"
"chr10","120377960","120378271","GL873541","16268070","16268366","96","104109890"
"chr10","120453024","120453319","GL873541","16268070","16268366","91","104184954"
"chr10","120888122","120888431","GL873541","16268070","16268366","94","104620052"
"chr10","121869978","121870271","GL873547","2222074","2222356","83","119647904"
"chr10","122089559","122089840","GL873659","913070","913333","84","121176489"
"chr10","122162923","122163232","GL873528","36697151","36697434","95","85465772"
"chr10","122812616","122812920","GL873530","16647228","16647517","90","106165388"
"chr10","123373326","123373626","GL873541","16268070","16268366","88","107105256"
"chr10","124088384","124088672","GL873547","2222074","2222356","86","121866310"
"chr10","124205743","124206047","GL873541","16268070","16268366","87","107937673"
"chr10","124214454","124214736","GL873541","16268070","16268366","95","107946384"
"chr10","124242114","124242350","GL873557","3858721","3858924","81","120383393"
"chr10","124439364","124439659","GL873530","16647228","16647517","82","107792136"
"chr10","124841993","124842296","GL873541","16268070","16268366","90","108573923"
"chr10","125031698","125031825","GL873552","12711845","12711956","54","112319853"
"chr10","125499664","125499970","GL873541","16268070","16268366","95","109231594"
"chr10","127186856","127187158","GL873541","16268070","16268366","88","110918786"
"chr10","127275049","127275356","GL873541","16268070","16268366","93","111006979"
"chr10","127363133","127363419","GL873547","2222074","2222356","82","125141059"
"chr10","127587035","127587285","GL873680","3005257","3005482","78","124581778"
"chr10","127591408","127591668","GL873528","25203621","25203847","81","102387787"
"chr10","127711501","127711795","GL873752","427788","428097","84","127283713"
"chr10","127739472","127739771","GL873607","1418062","1418355","83","126321410"
"chr10","127805653","127805958","GL873541","16268070","16268366","96","111537583"
"chr10","127864170","127864326","GL873574","7318344","7318500","59","120545826"
"chr11","49414122","49414418","GL873659","913070","913333","88","48501052"
"chr11","118751066","118751239","GL873530","5593486","5593649","55","113157580"
"chr11","349227","349530","GL873541","16268070","16268366","91","15918843"
"chr11","354666","354958","GL873530","16647228","16647517","82","16292562"
"chr11","491375","491542","GL873585","9209559","9209725","62","8718184"
"chr11","750708","751005","GL873541","16268070","16268366","81","15517362"
"chr11","936260","936559","GL873541","16268070","16268366","83","15331810"
"chr11","1110489","1110777","GL873530","16647228","16647517","78","15536739"
"chr11","1283430","1283724","GL873541","16268070","16268366","91","14984640"
"chr11","1336438","1336740","GL873547","2222074","2222356","89","885636"
"chr11","1373833","1374133","GL873541","16268070","16268366","77","14894237"
"chr11","1413948","1414243","GL873547","2222074","2222356","83","808126"
"chr11","1519922","1520223","GL873541","16268070","16268366","80","14748148"
"chr11","1721443","1721703","GL873543","13038674","13038909","90","11317231"
"chr11","2813896","2814082","GL873535","8592877","8593062","63","5778981"
"chr11","2947613","2947910","GL873541","16268070","16268366","83","13320457"
"chr11","2960929","2961224","GL873547","2222074","2222356","86","738855"
"chr11","3146472","3146575","GL873550","5998776","5998900","42","2852304"
"chr11","3460490","3460793","GL873541","16268070","16268366","93","12807580"
"chr11","3463080","3463210","GL873550","5998776","5998900","36","2535696"
"chr11","3499482","3499755","GL873562","3299887","3300144","79","199595"
"chr11","3836596","3836903","GL873547","2222074","2222356","93","1614522"
"chr11","3972276","3972569","GL873530","16647228","16647517","84","12674952"
"chr11","4332732","4332996","GL873562","3299887","3300144","82","1032845"
"chr11","4698390","4698676","GL873547","2222074","2222356","85","2476316"
"chr11","4736089","4736385","GL873541","16268070","16268366","83","11531981"
"chr11","5659614","5659906","GL873530","16647228","16647517","94","10987614"
"chr11","5965335","5965637","GL873541","16268070","16268366","80","10302735"
"chr11","6231722","6232019","GL873541","16268070","16268366","82","10036348"
"chr11","6345760","6346060","GL873547","2222074","2222356","88","4123686"
"chr11","6506714","6506863","GL873530","5593486","5593649","50","913228"
"chr11","6630303","6630595","GL873752","427788","428097","84","6202515"
"chr11","6748311","6748386","GL873554","10500008","10500061","31","3751697"
"chr11","6772448","6772741","GL873547","2222074","2222356","83","4550374"
"chr11","6974034","6974322","GL873541","16268070","16268366","93","9294036"
"chr11","7060535","7060822","GL873530","16647228","16647517","91","9586693"
"chr11","7351874","7352144","GL873659","913070","913333","95","6438804"
"chr11","7687297","7687565","GL873547","5449763","5449997","89","2237534"
"chr11","7693107","7693428","GL873541","16268070","16268366","103","8574963"
"chr11","7738207","7738510","GL873530","16647228","16647517","96","8909021"
"chr11","7774263","7774487","GL873680","3005257","3005482","65","4769006"
"chr11","7868591","7868807","GL873538","2567037","2567262","80","5301554"
"chr11","7899521","7899820","GL873541","16268070","16268366","83","8368549"
"chr11","7901419","7901733","GL873541","16268070","16268366","96","8366651"
"chr11","7990715","7991019","GL873530","16647228","16647517","102","8656513"
"chr11","7991963","7992210","GL873538","2567037","2567262","80","5424926"
"chr11","8023686","8023988","GL873541","16268070","16268366","92","8244384"
"chr11","8046165","8046471","GL873528","36697151","36697434","103","28650986"
"chr11","8050829","8051125","GL873530","16647228","16647517","88","8596399"
"chr11","8081815","8081903","GL873554","10500008","10500061","45","2418193"
"chr11","8100251","8100533","GL873659","913070","913333","85","7187181"
"chr11","8392467","8392726","GL873565","12307556","12307825","83","3915089"
"chr11","8509431","8509738","GL873541","16268070","16268366","95","7758639"
"chr11","8562411","8562711","GL873659","913070","913333","92","7649341"
"chr11","8562715","8563011","GL873608","6630366","6630673","101","1932349"
"chr11","8669143","8669456","GL873541","16268070","16268366","96","7598927"
"chr11","8690825","8691132","GL873541","16268070","16268366","96","7577245"
"chr11","9127911","9128217","GL873541","16268070","16268366","94","7140159"
"chr11","9514786","9515074","GL873541","16268070","16268366","95","6753284"
"chr11","9736123","9736423","GL873530","16647228","16647517","82","6911105"
"chr11","9859424","9859606","GL873524","42560728","42560902","55","32701304"
"chr11","9923400","9923670","GL873659","913070","913333","92","9010330"
"chr11","10360177","10360470","GL873528","36697151","36697434","92","26336974"
"chr11","10494556","10494832","GL873547","2222074","2222356","91","8272482"
"chr11","10588969","10589269","GL873541","16268070","16268366","78","5679101"
"chr11","10842249","10842550","GL873547","2222074","2222356","88","8620175"
"chr11","10914556","10914858","GL873541","16268070","16268366","90","5353514"
"chr11","11446252","11446549","GL873541","16268070","16268366","84","4821818"
"chr11","11491109","11491405","GL873530","16647228","16647517","82","5156119"
"chr11","11821527","11821819","GL873547","2222074","2222356","88","9599453"
"chr11","11981319","11981615","GL873541","16268070","16268366","87","4286751"
"chr11","12136411","12136592","GL873524","42560728","42560902","56","30424317"
"chr11","12262408","12262699","GL873547","2222074","2222356","84","10040334"
"chr11","12286875","12287171","GL873547","2222074","2222356","83","10064801"
"chr11","12336976","12337195","GL873680","3005257","3005482","75","9331719"
"chr11","12381046","12381327","GL873667","4451263","4451534","89","7929783"
"chr11","12552639","12552924","GL873547","2222074","2222356","79","10330565"
"chr11","12552972","12552993","GL873691","2903502","2903535","19","9649470"
"chr11","12671563","12671856","GL873547","2222074","2222356","78","10449489"
"chr11","12762554","12762839","GL873547","2222074","2222356","88","10540480"
"chr11","12764241","12764538","GL873608","6630366","6630673","97","6133875"
"chr11","12823862","12824009","GL873550","5998776","5998900","51","6825086"
"chr11","13718961","13719277","GL873541","16268070","16268366","94","2549109"
"chr11","13880374","13880674","GL873541","16268070","16268366","82","2387696"
"chr11","14114130","14114435","GL873541","16268070","16268366","84","2153940"
"chr11","14145561","14145705","GL873611","3799989","3800137","58","10345572"
"chr11","14160929","14161229","GL873528","36697151","36697434","94","22536222"
"chr11","14215361","14215649","GL873530","16647228","16647517","85","2431867"
"chr11","14324939","14325111","GL873530","5593486","5593649","51","8731453"
"chr11","14450440","14450714","GL873562","3299887","3300144","83","11150553"
"chr11","14801282","14801572","GL873547","2222074","2222356","88","12579208"
"chr11","15603408","15603620","GL873557","3858721","3858924","68","11744687"
"chr11","15851263","15851564","GL873541","16268070","16268366","92","416807"
"chr11","16389033","16389339","GL873541","16268070","16268366","91","120963"
"chr11","16879629","16879915","GL873547","2222074","2222356","93","14657555"
"chr11","17027645","17027931","GL873547","2222074","2222356","90","14805571"
"chr11","17648392","17648692","GL873547","2222074","2222356","89","15426318"
"chr11","18041892","18042224","GL873541","16268070","16268366","123","1773822"
"chr11","18949814","18950044","GL873538","2567037","2567262","72","16382777"
"chr11","19205848","19206157","GL873528","36697151","36697434","92","17491303"
"chr11","19313894","19314195","GL873608","6630366","6630673","88","12683528"
"chr11","19350249","19350543","GL873547","2222074","2222356","86","17128175"
"chr11","19536102","19536388","GL873547","2222074","2222356","75","17314028"
"chr11","19618707","19619010","GL873659","913070","913333","84","18705637"
"chr11","19714655","19714953","GL873541","16268070","16268366","83","3446585"
"chr11","20273766","20274067","GL873541","16268070","16268366","93","4005696"
"chr11","20663179","20663482","GL873752","427788","428097","90","20235391"
"chr11","20666695","20667001","GL873541","16268070","16268366","90","4398625"
"chr11","20670367","20670662","GL873530","16647228","16647517","87","4023139"
"chr11","20987820","20988096","GL873530","16647228","16647517","82","4340592"
"chr11","21519472","21519780","GL873530","16647228","16647517","94","4872244"
"chr11","22042323","22042625","GL873541","16268070","16268366","95","5774253"
"chr11","22870164","22870473","GL873541","16268070","16268366","91","6602094"
"chr11","22874498","22874787","GL873528","36697151","36697434","99","13822653"
"chr11","23276450","23276742","GL873530","16647228","16647517","84","6629222"
"chr11","24710077","24710199","GL873550","5998776","5998900","36","18711301"
"chr11","24876645","24876927","GL873547","2222074","2222356","82","22654571"
"chr11","26291826","26292124","GL873530","16647228","16647517","84","9644598"
"chr11","26502420","26502719","GL873541","16268070","16268366","89","10234350"
"chr11","27284489","27284784","GL873541","16268070","16268366","85","11016419"
"chr11","27415567","27415860","GL873530","16647228","16647517","81","10768339"
"chr11","27666406","27666713","GL873541","16268070","16268366","90","11398336"
"chr11","28184814","28185070","GL873680","3005257","3005482","81","25179557"
"chr11","28926440","28926714","GL873667","4451263","4451534","101","24475177"
"chr11","29186332","29186607","GL873607","1418062","1418355","91","27768270"
"chr11","29369699","29369992","GL873547","2222074","2222356","79","27147625"
"chr11","29396564","29396830","GL873562","3299887","3300144","83","26096677"
"chr11","29582782","29583071","GL873528","36697151","36697434","91","7114369"
"chr11","29998142","29998432","GL873541","16268070","16268366","86","13730072"
"chr11","30456081","30456386","GL873541","16268070","16268366","93","14188011"
"chr11","30833030","30833319","GL873547","2222074","2222356","88","28610956"
"chr11","30864360","30864655","GL873530","16647228","16647517","80","14217132"
"chr11","30870228","30870525","GL873752","427788","428097","80","30442440"
"chr11","31027426","31027734","GL873607","1418062","1418355","93","29609364"
"chr11","31157102","31157398","GL873547","2222074","2222356","77","28935028"
"chr11","31166342","31166516","GL873574","7318344","7318500","57","23847998"
"chr11","31167407","31167723","GL873812","559768","560073","104","30607639"
"chr11","31189578","31189838","GL873528","36697151","36697434","93","5507573"
"chr11","31226401","31226700","GL873608","6630366","6630673","89","24596035"
"chr11","31356092","31356252","GL873530","5593486","5593649","45","25762606"
"chr11","31385000","31385296","GL873541","16268070","16268366","80","15116930"
"chr11","31391242","31391476","GL873680","3005257","3005482","72","28385985"
"chr11","31442421","31442709","GL873530","16647228","16647517","82","14795193"
"chr11","31529674","31529969","GL873547","2222074","2222356","85","29307600"
"chr11","31836879","31837143","GL873547","2222074","2222356","98","29614805"
"chr11","31876186","31876503","GL873528","36697151","36697434","108","4820965"
"chr11","32089491","32089788","GL873547","2222074","2222356","87","29867417"
"chr11","32121217","32121515","GL873530","16647228","16647517","93","15473989"
"chr11","32138671","32138911","GL873680","3005257","3005482","67","29133414"
"chr11","32267743","32268040","GL873547","2222074","2222356","90","30045669"
"chr11","32384029","32384340","GL873528","36697151","36697434","91","4313122"
"chr11","32572841","32573128","GL873530","16647228","16647517","78","15925613"
"chr11","33194145","33194447","GL873541","16268070","16268366","95","16926075"
"chr11","33441548","33441753","GL873521","1458597","1458764","74","31982951"
"chr11","33502906","33503207","GL873541","16268070","16268366","84","17234836"
"chr11","33703074","33703379","GL873541","16268070","16268366","93","17435004"
"chr11","33923822","33924124","GL873608","6630366","6630673","88","27293456"
"chr11","33999286","33999594","GL873607","1418062","1418355","94","32581224"
"chr11","35642970","35643270","GL873541","16268070","16268366","95","19374900"
"chr11","35710534","35710826","GL873528","36697151","36697434","89","986617"
"chr11","36292782","36293071","GL873607","1418062","1418355","90","34874720"
"chr11","37102965","37103269","GL873530","16647228","16647517","90","20455737"
"chr11","37231505","37231768","GL873562","3299887","3300144","86","33931618"
"chr11","38654438","38654609","GL873574","7318344","7318500","56","31336094"
"chr11","38654611","38654843","GL873557","3858721","3858924","77","34795890"
"chr11","38848172","38848470","GL873530","16647228","16647517","84","22200944"
"chr11","39118588","39118892","GL873541","16268070","16268366","88","22850518"
"chr11","39383497","39383798","GL873541","16268070","16268366","87","23115427"
"chr11","39769596","39769874","GL873659","913070","913333","86","38856526"
"chr11","39966061","39966349","GL873547","2222074","2222356","76","37743987"
"chr11","40043815","40044105","GL873528","36697151","36697434","93","3346664"
"chr11","40045558","40045858","GL873541","16268070","16268366","93","23777488"
"chr11","40362198","40362503","GL873528","36697151","36697434","91","3665047"
"chr11","40995487","40995745","GL873680","3005257","3005482","92","37990230"
"chr11","41803129","41803428","GL873530","16647228","16647517","89","25155901"
"chr11","41883322","41883633","GL873547","2222074","2222356","97","39661248"
"chr11","42101160","42101440","GL873547","2222074","2222356","82","39879086"
"chr11","42708500","42708788","GL873547","2222074","2222356","75","40486426"
"chr11","43450069","43450286","GL873557","3858721","3858924","68","39591348"
"chr11","44088678","44088969","GL873530","16647228","16647517","84","27441450"
"chr11","44314125","44314403","GL873607","1418062","1418355","88","42896063"
"chr11","44527332","44527624","GL873547","2222074","2222356","80","42305258"
"chr11","44783395","44783687","GL873547","2222074","2222356","84","42561321"
"chr11","44843300","44843474","GL873691","508903","509045","66","44334397"
"chr11","44928549","44928862","GL873541","16268070","16268366","97","28660479"
"chr11","44998691","44998982","GL873530","16647228","16647517","74","28351463"
"chr11","45232287","45232576","GL873530","16647228","16647517","79","28585059"
"chr11","45402271","45402550","GL873562","3299887","3300144","91","42102384"
"chr11","45449325","45449632","GL873547","2222074","2222356","93","43227251"
"chr11","45526318","45526502","GL873530","5593486","5593649","55","39932832"
"chr11","45606608","45606909","GL873541","16268070","16268366","87","29338538"
"chr11","45663341","45663632","GL873530","16647228","16647517","84","29016113"
"chr11","45968050","45968179","GL873550","5998776","5998900","34","39969274"
"chr11","46605785","46606101","GL873541","16268070","16268366","103","30337715"
"chr11","46628544","46628841","GL873752","427788","428097","89","46200756"
"chr11","46710114","46710288","GL873530","5593486","5593649","62","41116628"
"chr11","46870539","46870831","GL873530","16647228","16647517","80","30223311"
"chr11","46971403","46971701","GL873752","427788","428097","84","46543615"
"chr11","47030150","47030445","GL873547","2222074","2222356","86","44808076"
"chr11","47241315","47241613","GL873541","16268070","16268366","87","30973245"
"chr11","47267698","47267990","GL873547","2222074","2222356","85","45045624"
"chr11","47411625","47411934","GL873530","16647228","16647517","93","30764397"
"chr11","47431553","47431699","GL873619","2497092","2497229","43","44934461"
"chr11","47698619","47698910","GL873530","16647228","16647517","80","31051391"
"chr11","47855567","47855846","GL873565","12307556","12307825","96","35548011"
"chr11","47946756","47947023","GL873659","913070","913333","92","47033686"
"chr11","48117376","48117685","GL873541","16268070","16268366","91","31849306"
"chr11","48209133","48209422","GL873547","2222074","2222356","82","45987059"
"chr11","48430165","48430477","GL873547","2222074","2222356","95","46208091"
"chr11","49162083","49162371","GL873530","16647228","16647517","86","32514855"
"chr11","49226350","49226650","GL873541","16268070","16268366","86","32958280"
"chr11","49290783","49291087","GL873530","16647228","16647517","93","32643555"
"chr11","49402131","49402427","GL873659","913070","913333","88","48489061"
"chr11","49405861","49406141","GL873562","3299887","3300144","99","46105974"
"chr11","49408812","49409103","GL873530","16647228","16647517","85","32761584"
"chr11","49417839","49417971","GL873550","5998776","5998900","35","43419063"
"chr11","49418270","49418433","GL873530","5593486","5593649","49","43824784"
"chr11","49429013","49429294","GL873667","4451263","4451534","81","44977750"
"chr11","49489197","49489497","GL873541","16268070","16268366","84","33221127"
"chr11","49582470","49582757","GL873530","16647228","16647517","82","32935242"
"chr11","49670266","49670574","GL873547","2222074","2222356","97","47448192"
"chr11","49878973","49879273","GL873530","16647228","16647517","89","33231745"
"chr11","49945902","49945941","GL873691","2903502","2903535","11","47042400"
"chr11","50453490","50453787","GL873541","16268070","16268366","87","34185420"
"chr11","50664321","50664614","GL873530","16647228","16647517","89","34017093"
"chr11","50776380","50776523","GL873628","6402015","6402153","55","44374365"
"chr11","51757591","51757891","GL873541","16268070","16268366","86","35489521"
"chr11","51779739","51780048","GL873541","16268070","16268366","88","35511669"
"chr11","51903238","51903537","GL873541","16268070","16268366","81","35635168"
"chr11","52241747","52242030","GL873547","2222074","2222356","83","50019673"
"chr11","52256103","52256219","GL873622","7076274","7076365","44","45179829"
"chr11","52400982","52401220","GL873680","3005257","3005482","66","49395725"
"chr11","52621059","52621341","GL873530","16647228","16647517","88","35973831"
"chr11","52631878","52632163","GL873547","2222074","2222356","81","50409804"
"chr11","52642972","52643266","GL873547","2222074","2222356","82","50420898"
"chr11","52713394","52713691","GL873528","36697151","36697434","89","16016243"
"chr11","52766353","52766512","GL873529","2453810","2453957","60","50312543"
"chr11","52774613","52774907","GL873530","16647228","16647517","78","36127385"
"chr11","53164231","53164531","GL873528","36697151","36697434","87","16467080"
"chr11","53236031","53236327","GL873607","1418062","1418355","86","51817969"
"chr11","53379037","53379335","GL873541","16268070","16268366","83","37110967"
"chr11","53710956","53711245","GL873530","16647228","16647517","81","37063728"
"chr11","53718572","53718864","GL873530","16647228","16647517","84","37071344"
"chr11","54483656","54483985","GL873528","36697151","36697434","120","17786505"
"chr11","55249962","55250240","GL873547","2222074","2222356","95","53027888"
"chr11","55813998","55814273","GL873667","4451263","4451534","96","51362735"
"chr11","56406545","56406831","GL873547","2222074","2222356","96","54184471"
"chr11","56926660","56926953","GL873530","16647228","16647517","85","40279432"
"chr11","58867866","58868166","GL873541","16268070","16268366","85","42599796"
"chr11","59418250","59418559","GL873541","16268070","16268366","91","43150180"
"chr11","59599243","59599531","GL873541","16268070","16268366","84","43331173"
"chr11","59842406","59842695","GL873547","2222074","2222356","80","57620332"
"chr11","59867158","59867285","GL873698","1314482","1314610","41","58552676"
"chr11","59958718","59959018","GL873541","16268070","16268366","82","43690648"
"chr11","60552837","60553124","GL873530","16647228","16647517","84","43905609"
"chr11","61155330","61155517","GL873697","3111225","3111427","59","58044105"
"chr11","61438183","61438485","GL873530","16647228","16647517","88","44790955"
"chr11","62921553","62921824","GL873562","3299887","3300144","89","59621666"
"chr11","62989555","62989860","GL873607","1418062","1418355","89","61571493"
"chr11","63205515","63205821","GL873541","16268070","16268366","91","46937445"
"chr11","63248707","63249012","GL873530","16647228","16647517","93","46601479"
"chr11","63386527","63386812","GL873541","16268070","16268366","97","47118457"
"chr11","63970392","63970657","GL873667","4451263","4451534","93","59519129"
"chr11","64062235","64062532","GL873607","1418062","1418355","90","62644173"
"chr11","64076342","64076515","GL873530","5593486","5593649","53","58482856"
"chr11","64263593","64263887","GL873547","2222074","2222356","80","62041519"
"chr11","64340740","64341032","GL873530","16647228","16647517","87","47693512"
"chr11","64427644","64427919","GL873530","16647228","16647517","98","47780416"
"chr11","64446537","64446826","GL873547","2222074","2222356","78","62224463"
"chr11","64818660","64818969","GL873541","16268070","16268366","84","48550590"
"chr11","64950384","64950668","GL873547","2222074","2222356","74","62728310"
"chr11","65223996","65224264","GL873547","2222074","2222356","88","63001922"
"chr11","65329738","65330027","GL873530","16647228","16647517","80","48682510"
"chr11","65599756","65599911","GL873541","1550303","1550443","73","64049453"
"chr11","66073016","66073318","GL873541","16268070","16268366","94","49804946"
"chr11","67241106","67241384","GL873547","2222074","2222356","88","65019032"
"chr11","67282796","67283111","GL873528","36697151","36697434","98","30585645"
"chr11","67439351","67439527","GL873530","5593486","5593649","49","61845865"
"chr11","67594349","67594643","GL873607","1418062","1418355","90","66176287"
"chr11","68149617","68149895","GL873530","16647228","16647517","86","51502389"
"chr11","69064475","69064771","GL873541","16268070","16268366","94","52796405"
"chr11","69300745","69301043","GL873541","16268070","16268366","84","53032675"
"chr11","69959532","69959819","GL873547","2222074","2222356","83","67737458"
"chr11","70038685","70038999","GL873607","1418062","1418355","105","68620623"
"chr11","70562610","70562926","GL873541","16268070","16268366","95","54294540"
"chr11","70893746","70894054","GL873528","36697151","36697434","96","34196595"
"chr11","71457338","71457645","GL873541","16268070","16268366","93","55189268"
"chr11","71457812","71458118","GL873541","16268070","16268366","87","55189742"
"chr11","71776445","71776757","GL873528","36697151","36697434","112","35079294"
"chr11","72041420","72041714","GL873530","16647228","16647517","84","55394192"
"chr11","72060777","72061101","GL873812","559768","560073","108","71501009"
"chr11","72229051","72229356","GL873541","16268070","16268366","87","55960981"
"chr11","72331928","72332219","GL873530","16647228","16647517","85","55684700"
"chr11","72406576","72406875","GL873530","16647228","16647517","91","55759348"
"chr11","72768815","72769033","GL873531","3555300","3555500","67","69213515"
"chr11","72791706","72791786","GL873521","9884269","9884347","39","62907437"
"chr11","73973874","73974175","GL873541","16268070","16268366","82","57705804"
"chr11","74305189","74305418","GL873625","6060130","6060345","67","68245059"
"chr11","74723467","74723764","GL873530","16647228","16647517","89","58076239"
"chr11","75071530","75071805","GL873659","913070","913333","94","74158460"
"chr11","76273547","76273835","GL873530","16647228","16647517","86","59626319"
"chr11","76560003","76560296","GL873547","2222074","2222356","89","74337929"
"chr11","76641362","76641636","GL873562","3299887","3300144","81","73341475"
"chr11","76655598","76655738","GL873619","2497092","2497229","45","74158506"
"chr11","76759854","76760132","GL873562","3299887","3300144","93","73459967"
"chr11","77362306","77362584","GL873562","3299887","3300144","97","74062419"
"chr11","78106779","78107076","GL873541","16268070","16268366","83","61838709"
"chr11","78198468","78198769","GL873608","6630366","6630673","92","71568102"
"chr11","78338182","78338451","GL873530","16647228","16647517","97","61690954"
"chr11","78344653","78344897","GL873528","25203621","25203847","80","53141032"
"chr11","78355734","78355758","GL873691","2903502","2903535","19","75452232"
"chr11","78355801","78356082","GL873547","2222074","2222356","76","76133727"
"chr11","78432105","78432383","GL873547","2222074","2222356","83","76210031"
"chr11","78449878","78450062","GL873530","5593486","5593649","64","72856392"
"chr11","79234512","79234756","GL873680","3005257","3005482","80","76229255"
"chr11","79670417","79670710","GL873541","16268070","16268366","93","63402347"
"chr11","80345696","80345999","GL873528","36697151","36697434","98","43648545"
"chr11","80776649","80776951","GL873528","36697151","36697434","94","44079498"
"chr11","81193884","81194183","GL873547","2222074","2222356","88","78971810"
"chr11","81311839","81312136","GL873547","2222074","2222356","86","79089765"
"chr11","81923603","81923902","GL873541","16268070","16268366","85","65655533"
"chr11","82055088","82055361","GL873547","2222074","2222356","92","79833014"
"chr11","83029213","83029529","GL873608","6630366","6630673","110","76398847"
"chr11","83560875","83561170","GL873541","16268070","16268366","81","67292805"
"chr11","84788883","84789160","GL873562","3299887","3300144","88","81488996"
"chr11","85747341","85747626","GL873541","16268070","16268366","86","69479271"
"chr11","86227027","86227327","GL873607","1418062","1418355","88","84808965"
"chr11","87489975","87490267","GL873530","16647228","16647517","95","70842747"
"chr11","87886803","87887101","GL873541","16268070","16268366","81","71618733"
"chr11","87904628","87904927","GL873547","2222074","2222356","96","85682554"
"chr11","88314499","88314794","GL873528","36697151","36697434","94","51617348"
"chr11","88732884","88733184","GL873547","2222074","2222356","88","86510810"
"chr11","88750902","88751199","GL873530","16647228","16647517","88","72103674"
"chr11","88797811","88798032","GL873557","3858721","3858924","75","84939090"
"chr11","89129715","89129866","GL873611","3799989","3800137","54","85329726"
"chr11","90158270","90158550","GL873562","3299887","3300144","89","86858383"
"chr11","90412159","90412469","GL873541","16268070","16268366","93","74144089"
"chr11","90535443","90535733","GL873547","2222074","2222356","81","88313369"
"chr11","90698200","90698479","GL873562","3299887","3300144","86","87398313"
"chr11","90871278","90871568","GL873528","36697151","36697434","89","54174127"
"chr11","90955909","90956196","GL873530","16647228","16647517","79","74308681"
"chr11","90984879","90985172","GL873547","2222074","2222356","84","88762805"
"chr11","91191847","91192155","GL873541","16268070","16268366","85","74923777"
"chr11","91388468","91388769","GL873541","16268070","16268366","91","75120398"
"chr11","91564914","91565194","GL873562","3299887","3300144","85","88265027"
"chr11","91727117","91727410","GL873530","16647228","16647517","85","75079889"
"chr11","91732058","91732363","GL873607","1418062","1418355","95","90313996"
"chr11","91831880","91832174","GL873607","1418062","1418355","90","90413818"
"chr11","91874121","91874402","GL873547","2222074","2222356","87","89652047"
"chr11","91887378","91887674","GL873547","2222074","2222356","81","89665304"
"chr11","92743034","92743343","GL873541","16268070","16268366","88","76474964"
"chr11","93237676","93237957","GL873547","2222074","2222356","83","91015602"
"chr11","93699684","93699857","GL873530","5593486","5593649","46","88106198"
"chr11","93726594","93726883","GL873607","1418062","1418355","79","92308532"
"chr11","93884015","93884025","GL873691","2903502","2903535","24","90980513"
"chr11","93884336","93884407","GL873550","5998911","5998963","37","87885425"
"chr11","94378504","94378813","GL873667","4451263","4451534","89","89927241"
"chr11","94470603","94470894","GL873541","16268070","16268366","86","78202533"
"chr11","95498272","95498559","GL873565","12307556","12307825","90","83190716"
"chr11","95541622","95541929","GL873541","16268070","16268366","96","79273552"
"chr11","95624494","95624802","GL873541","16268070","16268366","98","79356424"
"chr11","95966040","95966340","GL873547","2222074","2222356","99","93743966"
"chr11","96237698","96237981","GL873562","3299887","3300144","84","92937811"
"chr11","96504810","96505060","GL873538","2567037","2567262","79","93937773"
"chr11","96687047","96687346","GL873547","2222074","2222356","83","94464973"
"chr11","96699055","96699163","GL873587","10002051","10002151","38","86697004"
"chr11","97068434","97068732","GL873530","16647228","16647517","81","80421206"
"chr11","98103309","98103596","GL873547","2222074","2222356","80","95881235"
"chr11","99440874","99441165","GL873530","16647228","16647517","86","82793646"
"chr11","99444303","99444612","GL873608","6630366","6630673","94","92813937"
"chr11","99592063","99592356","GL873547","2222074","2222356","80","97369989"
"chr11","99938823","99939111","GL873547","2222074","2222356","81","97716749"
"chr11","100213611","100213836","GL873680","3005257","3005482","74","97208354"
"chr11","100225388","100225600","GL873680","3005257","3005482","67","97220131"
"chr11","100564299","100564589","GL873547","2222074","2222356","78","98342225"
"chr11","100617915","100618202","GL873528","36697151","36697434","91","63920764"
"chr11","100647364","100647655","GL873530","16647228","16647517","77","84000136"
"chr11","100832309","100832548","GL873557","3858721","3858924","84","96973588"
"chr11","101102116","101102421","GL873541","16268070","16268366","93","84834046"
"chr11","101562712","101563001","GL873547","2222074","2222356","80","99340638"
"chr11","101824241","101824540","GL873541","16268070","16268366","81","85556171"
"chr11","101833145","101833283","GL873541","1550303","1550443","50","100282842"
"chr11","102065439","102065716","GL873547","2222074","2222356","86","99843365"
"chr11","102107428","102107713","GL873547","2222074","2222356","86","99885354"
"chr11","102252652","102252950","GL873530","16647228","16647517","89","85605424"
"chr11","102258872","102259154","GL873659","913070","913333","82","101345802"
"chr11","102915301","102915590","GL873547","2222074","2222356","76","100693227"
"chr11","103249802","103250109","GL873541","16268070","16268366","88","86981732"
"chr11","103577566","103577755","GL873535","8592877","8593062","66","94984689"
"chr11","103739687","103739983","GL873530","16647228","16647517","82","87092459"
"chr11","103970099","103970395","GL873541","16268070","16268366","81","87702029"
"chr11","104243370","104243679","GL873541","16268070","16268366","93","87975300"
"chr11","104824667","104824944","GL873659","913070","913333","87","103911597"
"chr11","105189869","105190146","GL873562","3299887","3300144","91","101889982"
"chr11","105253725","105254027","GL873547","2222074","2222356","89","103031651"
"chr11","105269557","105269836","GL873547","2222074","2222356","90","103047483"
"chr11","105284823","105285134","GL873541","16268070","16268366","95","89016753"
"chr11","105334664","105334897","GL873557","3858721","3858924","78","101475943"
"chr11","105537115","105537252","GL873541","1550303","1550443","61","103986812"
"chr11","105616047","105616167","GL873623","513318","513444","44","105102729"
"chr11","105632842","105633159","GL873541","16268070","16268366","99","89364772"
"chr11","105658183","105658481","GL873541","16268070","16268366","85","89390113"
"chr11","105696730","105697042","GL873541","16268070","16268366","91","89428660"
"chr11","105728142","105728455","GL873541","16268070","16268366","92","89460072"
"chr11","105821367","105821671","GL873528","36697151","36697434","99","69124216"
"chr11","105858746","105858992","GL873680","3005257","3005482","77","102853489"
"chr11","106017350","106017657","GL873541","16268070","16268366","90","89749280"
"chr11","106526746","106527057","GL873547","2222074","2222356","91","104304672"
"chr11","106604266","106604430","GL873524","42560728","42560902","61","64043538"
"chr11","106655120","106655411","GL873541","16268070","16268366","77","90387050"
"chr11","106691321","106691504","GL873585","9209559","9209725","58","97481762"
"chr11","106691803","106691936","GL873550","5998776","5998900","37","100693027"
"chr11","106717603","106717895","GL873547","2222074","2222356","81","104495529"
"chr11","106804417","106804703","GL873547","2222074","2222356","83","104582343"
"chr11","106821554","106821854","GL873530","16647228","16647517","89","90174326"
"chr11","106844601","106844869","GL873680","3005257","3005482","93","103839344"
"chr11","106872347","106872677","GL873547","2222074","2222356","109","104650273"
"chr11","106903918","106904206","GL873547","2222074","2222356","72","104681844"
"chr11","106962014","106962299","GL873547","2222074","2222356","102","104739940"
"chr11","106973007","106973312","GL873541","16268070","16268366","88","90704937"
"chr11","107047751","107047972","GL873531","3555300","3555500","70","103492451"
"chr11","107128445","107128753","GL873562","3299887","3300144","108","103828558"
"chr11","107180879","107181171","GL873680","3005257","3005482","116","104175622"
"chr11","107320256","107320549","GL873547","2222074","2222356","84","105098182"
"chr11","107357399","107357697","GL873528","36697151","36697434","97","70660248"
"chr11","107368147","107368303","GL873529","2453810","2453957","53","104914337"
"chr11","107469251","107469553","GL873541","16268070","16268366","85","91201181"
"chr11","107752079","107752361","GL873547","2222074","2222356","81","105530005"
"chr11","108472881","108473009","GL873552","12711845","12711956","53","95761036"
"chr11","108524665","108524967","GL873541","16268070","16268366","90","92256595"
"chr11","108829966","108830273","GL873541","16268070","16268366","90","92561896"
"chr11","109266199","109266476","GL873541","16268070","16268366","99","92998129"
"chr11","109658362","109658668","GL873530","16647228","16647517","84","93011134"
"chr11","109800806","109801115","GL873607","1418062","1418355","95","108382744"
"chr11","110092176","110092395","GL873557","3858721","3858924","67","106233455"
"chr11","111219175","111219476","GL873530","16647228","16647517","91","94571947"
"chr11","111394520","111394825","GL873607","1418062","1418355","91","109976458"
"chr11","111452777","111452942","GL873521","1458597","1458764","51","109994180"
"chr11","111628593","111628897","GL873528","36697151","36697434","98","74931442"
"chr11","111689076","111689370","GL873528","36697151","36697434","100","74991925"
"chr11","111707559","111707859","GL873547","2222074","2222356","87","109485485"
"chr11","111794464","111794630","GL873585","9209559","9209725","53","102584905"
"chr11","112699608","112699900","GL873565","12307556","12307825","114","100392052"
"chr11","112865767","112866066","GL873530","16647228","16647517","82","96218539"
"chr11","113426178","113426467","GL873547","2222074","2222356","80","111204104"
"chr11","113482431","113482497","GL873554","10500008","10500061","26","102982423"
"chr11","113532021","113532301","GL873562","3299887","3300144","92","110232134"
"chr11","113554805","113554938","GL873550","5998776","5998900","38","107556029"
"chr11","113615804","113616083","GL873659","913070","913333","88","112702734"
"chr11","113683313","113683616","GL873528","36697151","36697434","90","76986162"
"chr11","113864913","113865208","GL873541","16268070","16268366","84","97596843"
"chr11","114174661","114174964","GL873528","36697151","36697434","91","77477510"
"chr11","114193380","114193669","GL873530","16647228","16647517","91","97546152"
"chr11","114221931","114222247","GL873528","36697151","36697434","92","77524780"
"chr11","114689046","114689345","GL873541","16268070","16268366","85","98420976"
"chr11","114930921","114931227","GL873528","36697151","36697434","102","78233770"
"chr11","115343919","115344250","GL873528","36697151","36697434","115","78646768"
"chr11","115608615","115608899","GL873565","12307556","12307825","102","103301059"
"chr11","115637551","115637851","GL873541","16268070","16268366","80","99369481"
"chr11","115755663","115755966","GL873541","16268070","16268366","97","99487593"
"chr11","115884757","115885066","GL873530","16647228","16647517","94","99237529"
"chr11","115887567","115887625","GL873691","1645655","1645707","24","114241912"
"chr11","115907806","115908158","GL873607","1418062","1418355","119","114489744"
"chr11","116063765","116064073","GL873530","16647228","16647517","94","99416537"
"chr11","116249716","116249990","GL873530","16647228","16647517","94","99602488"
"chr11","116486433","116486736","GL873541","16268070","16268366","86","100218363"
"chr11","116558393","116558699","GL873541","16268070","16268366","80","100290323"
"chr11","116599131","116599218","GL873643","6205658","6205743","39","110393473"
"chr11","116618009","116618296","GL873528","36697151","36697434","104","79920858"
"chr11","116704241","116704542","GL873541","16268070","16268366","81","100436171"
"chr11","116715165","116715363","GL873531","3555300","3555500","64","113159865"
"chr11","116752829","116753137","GL873541","16268070","16268366","90","100484759"
"chr11","116795416","116795705","GL873547","2222074","2222356","96","114573342"
"chr11","116840266","116840551","GL873667","4451263","4451534","86","112389003"
"chr11","117387838","117388135","GL873608","6630366","6630673","84","110757472"
"chr11","117615871","117616166","GL873608","6630366","6630673","92","110985505"
"chr11","117624471","117624761","GL873530","16647228","16647517","85","100977243"
"chr11","117671037","117671314","GL873562","3299887","3300144","96","114371150"
"chr11","117671614","117671661","GL873603","2092652","2092704","27","115578962"
"chr11","117718811","117718965","GL873530","5593486","5593649","45","112125325"
"chr11","117722922","117723099","GL873530","5593486","5593649","49","112129436"
"chr11","117728260","117728562","GL873541","16268070","16268366","92","101460190"
"chr11","117728569","117728887","GL873541","16268070","16268366","106","101460499"
"chr11","117776902","117777207","GL873608","6630366","6630673","100","111146536"
"chr11","117936192","117936498","GL873607","1418062","1418355","97","116518130"
"chr11","118007838","118008130","GL873752","427788","428097","84","117580050"
"chr11","118051716","118052029","GL873541","16268070","16268366","99","101783646"
"chr11","118118909","118119164","GL873680","3005257","3005482","83","115113652"
"chr11","118119165","118119441","GL873528","36697151","36697434","102","81422014"
"chr11","118119482","118119794","GL873528","36697151","36697434","96","81422331"
"chr11","118167443","118167750","GL873528","36697151","36697434","96","81470292"
"chr11","118646513","118646693","GL873585","9209559","9209725","55","109436954"
"chr11","118699798","118700089","GL873547","2222074","2222356","76","116477724"
"chr11","118736085","118736392","GL873541","16268070","16268366","95","102468015"
"chr11","118747276","118747574","GL873530","16647228","16647517","93","102100048"
"chr11","118824409","118824706","GL873541","16268070","16268366","86","102556339"
"chr11","118892467","118892729","GL873547","2222074","2222356","97","116670393"
"chr11","118896248","118896556","GL873541","16268070","16268366","89","102628178"
"chr11","118929535","118929827","GL873541","16268070","16268366","87","102661465"
"chr11","118990538","118990827","GL873547","2222074","2222356","79","116768464"
"chr11","119452155","119452432","GL873528","36697151","36697434","104","82755004"
"chr11","119513427","119513736","GL873530","16647228","16647517","92","102866199"
"chr11","120238700","120238748","GL873527","37742071","37742124","22","82496629"
"chr11","120396815","120397109","GL873541","16268070","16268366","90","104128745"
"chr11","120527507","120527805","GL873541","16268070","16268366","82","104259437"
"chr11","121383016","121383283","GL873543","13038674","13038909","109","108344342"
"chr11","121539693","121539979","GL873547","2222074","2222356","78","119317619"
"chr11","121543939","121544205","GL873565","12307556","12307825","98","109236383"
"chr11","122071500","122071809","GL873752","427788","428097","97","121643712"
"chr11","122288018","122288310","GL873547","2222074","2222356","85","120065944"
"chr11","122296790","122297072","GL873547","2222074","2222356","82","120074716"
"chr11","123087510","123087625","GL873524","43272658","43272747","47","79814852"
"chr11","123089754","123090042","GL873528","36697151","36697434","100","86392603"
"chr11","123182652","123182885","GL873528","25203621","25203847","85","97979031"
"chr11","123230081","123230365","GL873547","2222074","2222356","80","121008007"
"chr11","123635562","123635717","GL873530","5593486","5593649","55","118042076"
"chr11","123730691","123730986","GL873541","16268070","16268366","95","107462621"
"chr11","124123042","124123351","GL873528","36697151","36697434","93","87425891"
"chr11","124332228","124332527","GL873530","16647228","16647517","90","107685000"
"chr11","124701162","124701460","GL873530","16647228","16647517","88","108053934"
"chr11","124866281","124866588","GL873541","16268070","16268366","95","108598211"
"chr11","125157538","125157713","GL873524","42560728","42560902","59","82596810"
"chr11","125927693","125928007","GL873541","16268070","16268366","97","109659623"
"chr11","127266408","127266714","GL873541","16268070","16268366","88","110998338"
"chr11","127415663","127415952","GL873530","16647228","16647517","83","110768435"
"chr11","127416029","127416256","GL873557","3858721","3858924","75","123557308"
"chr11","127620340","127620648","GL873607","1418062","1418355","94","126202278"
"chr11","128074148","128074393","GL873640","6426205","6426399","91","121647943"
"chr11","128234779","128235055","GL873547","2222074","2222356","87","126012705"
"chr11","128397007","128397323","GL873530","16647228","16647517","102","111749779"
"chr12","64094104","64094397","GL873530","16647228","16647517","86","47446876"
"chr12","339435","339585","GL873530","5593486","5593649","56","5254051"
"chr12","858462","858758","GL873530","16647228","16647517","85","15788766"
"chr12","1037076","1037307","GL873680","3005257","3005482","75","1968181"
"chr12","1315949","1316252","GL873541","16268070","16268366","89","14952121"
"chr12","1813414","1813714","GL873541","16268070","16268366","87","14454656"
"chr12","1819427","1819772","GL873547","2222074","2222356","118","402647"
"chr12","2036491","2036781","GL873530","16647228","16647517","80","14610737"
"chr12","2300800","2301092","GL873541","16268070","16268366","89","13967270"
"chr12","3898076","3898379","GL873541","16268070","16268366","85","12369994"
"chr12","4118527","4118758","GL873680","3005257","3005482","89","1113270"
"chr12","4392942","4393236","GL873530","16647228","16647517","89","12254286"
"chr12","5414878","5415186","GL873530","16647228","16647517","92","11232350"
"chr12","5447091","5447204","GL873764","716399","716485","46","4730692"
"chr12","5872576","5872638","GL873524","36505249","36505303","31","30632673"
"chr12","5884290","5884585","GL873607","1418062","1418355","85","4466228"
"chr12","6203118","6203386","GL873547","2222074","2222356","90","3981044"
"chr12","6514500","6514558","GL873527","37742071","37742124","24","31227571"
"chr12","6726552","6726831","GL873547","2222074","2222356","92","4504478"
"chr12","6966725","6967015","GL873607","1418062","1418355","87","5548663"
"chr12","7038703","7039008","GL873547","2222074","2222356","91","4816629"
"chr12","7042722","7042864","GL873524","43272770","43272878","66","36230048"
"chr12","7325040","7325337","GL873541","16268070","16268366","87","8943030"
"chr12","8152965","8153257","GL873547","2222074","2222356","76","5930891"
"chr12","8273638","8273938","GL873541","16268070","16268366","99","7994432"
"chr12","8502372","8502674","GL873541","16268070","16268366","90","7765698"
"chr12","8629822","8630144","GL873541","16268070","16268366","99","7638248"
"chr12","8771885","8772189","GL873528","36697151","36697434","95","27925266"
"chr12","8817431","8817741","GL873530","16647228","16647517","93","7829797"
"chr12","9055134","9055416","GL873659","913070","913333","90","8142064"
"chr12","9091402","9091532","GL873550","5998776","5998900","27","3092626"
"chr12","9153260","9153569","GL873541","16268070","16268366","99","7114810"
"chr12","9159368","9159662","GL873541","16268070","16268366","87","7108702"
"chr12","9224924","9225215","GL873547","2222074","2222356","80","7002850"
"chr12","9394703","9394838","GL873550","5998776","5998900","34","3395927"
"chr12","9465072","9465366","GL873547","2222074","2222356","86","7242998"
"chr12","9482811","9483133","GL873528","36697151","36697434","103","27214340"
"chr12","9576279","9576532","GL873562","3299887","3300144","86","6276392"
"chr12","9627495","9627562","GL873603","2092720","2092796","36","7534775"
"chr12","9644695","9644990","GL873541","16268070","16268366","93","6623375"
"chr12","9749124","9749323","GL873630","2508568","2508753","67","7240556"
"chr12","9845091","9845372","GL873547","2222074","2222356","85","7623017"
"chr12","9898617","9898926","GL873541","16268070","16268366","92","6369453"
"chr12","9901731","9902040","GL873541","16268070","16268366","92","6366339"
"chr12","9982374","9982661","GL873530","16647228","16647517","77","6664854"
"chr12","10047022","10047316","GL873530","16647228","16647517","73","6600206"
"chr12","10348016","10348298","GL873547","2222074","2222356","69","8125942"
"chr12","10526476","10526757","GL873530","16647228","16647517","94","6120752"
"chr12","10554091","10554400","GL873541","16268070","16268366","96","5713979"
"chr12","10615350","10615639","GL873547","2222074","2222356","89","8393276"
"chr12","10778259","10778552","GL873608","6630366","6630673","95","4147893"
"chr12","10948504","10948743","GL873680","3005257","3005482","77","7943247"
"chr12","11159558","11159849","GL873547","2222074","2222356","90","8937484"
"chr12","11323068","11323359","GL873547","2222074","2222356","78","9100994"
"chr12","11339768","11340058","GL873528","36697151","36697434","101","25357383"
"chr12","11358861","11359163","GL873547","2222074","2222356","87","9136787"
"chr12","11809573","11809864","GL873547","2222074","2222356","83","9587499"
"chr12","12264148","12264455","GL873547","2222074","2222356","92","10042074"
"chr12","12271819","12272108","GL873541","16268070","16268366","91","3996251"
"chr12","12357674","12357969","GL873547","2222074","2222356","82","10135600"
"chr12","12886609","12886914","GL873541","16268070","16268366","93","3381461"
"chr12","12904425","12904719","GL873547","2222074","2222356","84","10682351"
"chr12","13143084","13143366","GL873530","16647228","16647517","83","3504144"
"chr12","13186092","13186213","GL873622","7076274","7076365","49","6109818"
"chr12","13230888","13230915","GL873691","2903502","2903535","22","10327386"
"chr12","13230944","13231221","GL873547","2222074","2222356","83","11008870"
"chr12","13303721","13304018","GL873528","36697151","36697434","86","23393430"
"chr12","13370066","13370307","GL873538","2567037","2567262","85","10803029"
"chr12","13414518","13414810","GL873547","2222074","2222356","79","11192444"
"chr12","15293737","15294044","GL873541","16268070","16268366","87","974333"
"chr12","15320158","15320403","GL873528","25203621","25203847","80","9883463"
"chr12","15404462","15404584","GL873550","5998776","5998900","49","9405686"
"chr12","15404619","15404816","GL873697","3111225","3111427","54","12293394"
"chr12","15483737","15484028","GL873530","16647228","16647517","78","1163491"
"chr12","17356175","17356289","GL873552","12711845","12711956","40","4644330"
"chr12","17626289","17626556","GL873680","3005257","3005482","92","14621032"
"chr12","18047579","18047857","GL873547","2222074","2222356","90","15825505"
"chr12","18148605","18148902","GL873752","427788","428097","85","17720817"
"chr12","18148903","18149203","GL873752","427788","428097","89","17721115"
"chr12","18358405","18358704","GL873541","16268070","16268366","78","2090335"
"chr12","18495531","18495845","GL873541","16268070","16268366","98","2227461"
"chr12","18593801","18594102","GL873530","16647228","16647517","87","1946573"
"chr12","18688691","18688994","GL873607","1418062","1418355","88","17270629"
"chr12","18705494","18705782","GL873547","2222074","2222356","78","16483420"
"chr12","19277707","19278020","GL873530","16647228","16647517","96","2630479"
"chr12","19763059","19763365","GL873541","16268070","16268366","87","3494989"
"chr12","20158995","20159217","GL873680","3005257","3005482","72","17153738"
"chr12","20178407","20178693","GL873530","16647228","16647517","88","3531179"
"chr12","20322318","20322619","GL873812","559768","560073","110","19762550"
"chr12","20579517","20579818","GL873530","16647228","16647517","89","3932289"
"chr12","20615425","20615706","GL873547","2222074","2222356","91","18393351"
"chr12","21589054","21589349","GL873541","16268070","16268366","98","5320984"
"chr12","21984962","21985274","GL873608","6630366","6630673","92","15354596"
"chr12","22298851","22299145","GL873607","1418062","1418355","84","20880789"
"chr12","22933210","22933388","GL873530","5593486","5593649","57","17339724"
"chr12","23102848","23103154","GL873541","16268070","16268366","94","6834778"
"chr12","24308963","24309274","GL873530","16647228","16647517","100","7661735"
"chr12","25001370","25001681","GL873541","16268070","16268366","95","8733300"
"chr12","25030968","25031277","GL873541","16268070","16268366","87","8762898"
"chr12","25210001","25210293","GL873541","16268070","16268366","88","8941931"
"chr12","25475364","25475676","GL873541","16268070","16268366","100","9207294"
"chr12","25753297","25753594","GL873608","6630366","6630673","87","19122931"
"chr12","26030603","26030901","GL873541","16268070","16268366","93","9762533"
"chr12","26127298","26127607","GL873547","2222074","2222356","98","23905224"
"chr12","26195505","26195804","GL873541","16268070","16268366","83","9927435"
"chr12","26420509","26420805","GL873547","2222074","2222356","83","24198435"
"chr12","26726937","26727234","GL873541","16268070","16268366","89","10458867"
"chr12","26735897","26736153","GL873680","3005257","3005482","88","23730640"
"chr12","27147509","27147798","GL873752","427788","428097","80","26719721"
"chr12","27209569","27209834","GL873535","4830564","4830824","87","22379005"
"chr12","28576176","28576467","GL873530","16647228","16647517","78","11928948"
"chr12","29282503","29282791","GL873530","16647228","16647517","87","12635275"
"chr12","29549649","29549958","GL873541","16268070","16268366","90","13281579"
"chr12","29582559","29582861","GL873541","16268070","16268366","89","13314489"
"chr12","29710369","29710662","GL873547","2222074","2222356","81","27488295"
"chr12","30007268","30007557","GL873547","2222074","2222356","85","27785194"
"chr12","30449003","30449293","GL873547","2222074","2222356","76","28226929"
"chr12","30705428","30705733","GL873608","6630366","6630673","89","24075062"
"chr12","30991256","30991540","GL873528","36697151","36697434","88","5705895"
"chr12","31643889","31644198","GL873541","16268070","16268366","94","15375819"
"chr12","31899150","31899427","GL873547","2222074","2222356","90","29677076"
"chr12","31941379","31941656","GL873547","2222074","2222356","85","29719305"
"chr12","32034400","32034701","GL873530","16647228","16647517","84","15387172"
"chr12","32039026","32039282","GL873547","5449763","5449997","90","26589263"
"chr12","32254564","32254857","GL873547","2222074","2222356","78","30032490"
"chr12","34143053","34143343","GL873530","16647228","16647517","75","17495825"
"chr12","34371825","34372130","GL873541","16268070","16268366","86","18103755"
"chr12","34512467","34512766","GL873547","2222074","2222356","90","32290393"
"chr12","34826945","34827241","GL873659","913070","913333","85","33913875"
"chr12","35011347","35011634","GL873530","16647228","16647517","88","18364119"
"chr12","37029209","37029477","GL873562","3299887","3300144","94","33729322"
"chr12","37660390","37660680","GL873541","16268070","16268366","88","21392320"
"chr12","38000885","38001168","GL873565","12307556","12307825","92","25693329"
"chr12","38109773","38110070","GL873541","16268070","16268366","77","21841703"
"chr12","38116785","38117090","GL873607","1418062","1418355","92","36698723"
"chr12","38810271","38810574","GL873528","36697151","36697434","98","2113120"
"chr12","39114189","39114476","GL873547","2222074","2222356","72","36892115"
"chr12","39125555","39125840","GL873530","16647228","16647517","78","22478327"
"chr12","39501414","39501723","GL873547","2222074","2222356","101","37279340"
"chr12","40164000","40164280","GL873530","16647228","16647517","89","23516772"
"chr12","40165141","40165464","GL873541","16268070","16268366","105","23897071"
"chr12","40197438","40197748","GL873541","16268070","16268366","98","23929368"
"chr12","40476434","40476728","GL873667","4451263","4451534","93","36025171"
"chr12","40504913","40505212","GL873541","16268070","16268366","86","24236843"
"chr12","40670097","40670407","GL873541","16268070","16268366","92","24402027"
"chr12","41019638","41019945","GL873547","2222074","2222356","87","38797564"
"chr12","41086556","41086842","GL873547","2222074","2222356","78","38864482"
"chr12","41367876","41368167","GL873547","2222074","2222356","75","39145802"
"chr12","41423727","41424032","GL873541","16268070","16268366","90","25155657"
"chr12","41757497","41757783","GL873530","16647228","16647517","83","25110269"
"chr12","41857205","41857507","GL873541","16268070","16268366","88","25589135"
"chr12","41907219","41907542","GL873541","16268070","16268366","102","25639149"
"chr12","42420731","42421034","GL873541","16268070","16268366","89","26152661"
"chr12","42805712","42806002","GL873530","16647228","16647517","91","26158484"
"chr12","42859340","42859549","GL873531","3555300","3555500","59","39304040"
"chr12","42929084","42929393","GL873528","36697151","36697434","94","6231933"
"chr12","43144686","43144976","GL873528","36697151","36697434","95","6447535"
"chr12","43161561","43161851","GL873547","2222074","2222356","78","40939487"
"chr12","43231649","43231830","GL873524","42560728","42560902","54","670921"
"chr12","43490651","43490947","GL873530","16647228","16647517","98","26843423"
"chr12","43716743","43717019","GL873547","2222074","2222356","88","41494669"
"chr12","43926668","43926967","GL873541","16268070","16268366","77","27658598"
"chr12","43957933","43958104","GL873530","5593486","5593649","52","38364447"
"chr12","43962243","43962428","GL873535","8592877","8593062","58","35369366"
"chr12","43975332","43975640","GL873541","16268070","16268366","83","27707262"
"chr12","44011261","44011469","GL873531","3555300","3555500","62","40455961"
"chr12","44044379","44044682","GL873541","16268070","16268366","87","27776309"
"chr12","44095188","44095494","GL873541","16268070","16268366","90","27827118"
"chr12","44174718","44174990","GL873659","913070","913333","90","43261648"
"chr12","44196878","44197168","GL873659","913070","913333","90","43283808"
"chr12","44262154","44262468","GL873607","1418062","1418355","101","42844092"
"chr12","44290728","44291019","GL873530","16647228","16647517","84","27643500"
"chr12","44448177","44448481","GL873812","559768","560073","95","43888409"
"chr12","44472354","44472624","GL873528","36697151","36697434","101","7775203"
"chr12","44563620","44563920","GL873528","36697151","36697434","95","7866469"
"chr12","44923871","44923975","GL873520","23895808","23895898","39","21028063"
"chr12","44975344","44975625","GL873547","2222074","2222356","82","42753270"
"chr12","45144950","45145252","GL873547","2222074","2222356","91","42922876"
"chr12","45183970","45184264","GL873530","16647228","16647517","80","28536742"
"chr12","45713220","45713341","GL873622","7076274","7076365","48","38636946"
"chr12","45962018","45962309","GL873530","16647228","16647517","75","29314790"
"chr12","46401378","46401668","GL873547","2222074","2222356","81","44179304"
"chr12","46480630","46480935","GL873541","16268070","16268366","88","30212560"
"chr12","46518761","46519058","GL873530","16647228","16647517","87","29871533"
"chr12","46524023","46524325","GL873541","16268070","16268366","90","30255953"
"chr12","46616697","46616968","GL873562","3299887","3300144","87","43316810"
"chr12","46626405","46626700","GL873547","2222074","2222356","78","44404331"
"chr12","46697134","46697430","GL873541","16268070","16268366","86","30429064"
"chr12","46778552","46778849","GL873541","16268070","16268366","86","30510482"
"chr12","47268444","47268694","GL873680","3005257","3005482","79","44263187"
"chr12","47770476","47770777","GL873541","16268070","16268366","80","31502406"
"chr12","48400062","48400366","GL873541","16268070","16268366","96","32131992"
"chr12","49653019","49653294","GL873547","2222074","2222356","86","47430945"
"chr12","50297044","50297358","GL873541","16268070","16268366","94","34028974"
"chr12","51180060","51180341","GL873562","3299887","3300144","86","47880173"
"chr12","52210979","52211286","GL873530","16647228","16647517","99","35563751"
"chr12","52562723","52563030","GL873541","16268070","16268366","88","36294653"
"chr12","53028614","53028923","GL873541","16268070","16268366","96","36760544"
"chr12","53064977","53065283","GL873528","36697151","36697434","95","16367826"
"chr12","53066097","53066226","GL873560","5855436","5855580","50","47210661"
"chr12","53677728","53678031","GL873541","16268070","16268366","90","37409658"
"chr12","53814051","53814354","GL873659","913070","913333","90","52900981"
"chr12","54339229","54339556","GL873528","36697151","36697434","110","17642078"
"chr12","54487374","54487663","GL873547","2222074","2222356","84","52265300"
"chr12","55392197","55392480","GL873547","2222074","2222356","95","53170123"
"chr12","55880382","55880714","GL873541","16268070","16268366","123","39612312"
"chr12","56695260","56695549","GL873530","16647228","16647517","91","40048032"
"chr12","56981284","56981548","GL873547","2222074","2222356","94","54759210"
"chr12","57055279","57055576","GL873667","4451263","4451534","96","52604016"
"chr12","57534337","57534645","GL873530","16647228","16647517","92","40887109"
"chr12","57864011","57864204","GL873823","304319","304508","56","57559692"
"chr12","57921869","57922071","GL873630","2508568","2508753","77","55413301"
"chr12","58479390","58479687","GL873607","1418062","1418355","93","57061328"
"chr12","58894730","58895011","GL873659","913070","913333","84","57981660"
"chr12","59088220","59088487","GL873547","2222074","2222356","93","56866146"
"chr12","59517537","59517848","GL873541","16268070","16268366","94","43249467"
"chr12","60012633","60012929","GL873547","2222074","2222356","82","57790559"
"chr12","60335014","60335313","GL873530","16647228","16647517","94","43687786"
"chr12","60486617","60486911","GL873530","16647228","16647517","81","43839389"
"chr12","60560363","60560658","GL873541","16268070","16268366","87","44292293"
"chr12","60616134","60616423","GL873547","2222074","2222356","81","58394060"
"chr12","62090467","62090763","GL873541","16268070","16268366","85","45822397"
"chr12","62505268","62505568","GL873541","16268070","16268366","83","46237198"
"chr12","62843629","62843921","GL873530","16647228","16647517","84","46196401"
"chr12","62888465","62888751","GL873541","16268070","16268366","88","46620395"
"chr12","62950190","62950459","GL873667","4451263","4451534","88","58498927"
"chr12","63087917","63088219","GL873541","16268070","16268366","88","46819847"
"chr12","64183477","64183775","GL873530","16647228","16647517","76","47536249"
"chr12","64262895","64262984","GL873526","41480965","41481045","43","22781930"
"chr12","64371628","64372017","GL873559","3737111","3737481","132","60634517"
"chr12","64669703","64669981","GL873547","2222074","2222356","92","62447629"
"chr12","65240745","65241036","GL873547","2222074","2222356","93","63018671"
"chr12","65356809","65357103","GL873530","16647228","16647517","81","48709581"
"chr12","65444654","65444939","GL873547","2222074","2222356","85","63222580"
"chr12","65894368","65894537","GL873530","5593486","5593649","46","60300882"
"chr12","66036135","66036442","GL873547","2222074","2222356","88","63814061"
"chr12","67316319","67316629","GL873541","16268070","16268366","104","51048249"
"chr12","68869870","68870035","GL873574","7318344","7318500","49","61551526"
"chr12","69185187","69185466","GL873547","2222074","2222356","82","66963113"
"chr12","69986810","69987116","GL873541","16268070","16268366","90","53718740"
"chr12","70810173","70810475","GL873541","16268070","16268366","89","54542103"
"chr12","70877890","70878107","GL873557","3858721","3858924","65","67019169"
"chr12","71008479","71008773","GL873547","2222074","2222356","85","68786405"
"chr12","71415707","71415997","GL873667","4451263","4451534","88","66964444"
"chr12","72022342","72022614","GL873562","3299887","3300144","88","68722455"
"chr12","72676796","72677114","GL873541","16268070","16268366","103","56408726"
"chr12","72711719","72712012","GL873530","16647228","16647517","79","56064491"
"chr12","72756184","72756452","GL873607","1418062","1418355","89","71338122"
"chr12","72775091","72775338","GL873680","3005257","3005482","78","69769834"
"chr12","72899340","72899646","GL873541","16268070","16268366","88","56631270"
"chr12","72908333","72908636","GL873541","16268070","16268366","86","56640263"
"chr12","72917138","72917453","GL873541","16268070","16268366","107","56649068"
"chr12","72996428","72996729","GL873541","16268070","16268366","83","56728358"
"chr12","73059021","73059310","GL873547","2222074","2222356","78","70836947"
"chr12","73233764","73234041","GL873562","3299887","3300144","79","69933877"
"chr12","73372231","73372515","GL873530","16647228","16647517","86","56725003"
"chr12","73698729","73698870","GL873541","1550303","1550443","66","72148426"
"chr12","73889016","73889323","GL873547","2222074","2222356","92","71666942"
"chr12","75099436","75099709","GL873659","913070","913333","90","74186366"
"chr12","75559642","75559895","GL873640","6426205","6426399","103","69133437"
"chr12","76222744","76223043","GL873541","16268070","16268366","87","59954674"
"chr12","76345647","76345939","GL873547","2222074","2222356","82","74123573"
"chr12","76473447","76473749","GL873547","2222074","2222356","94","74251373"
"chr12","76643355","76643659","GL873541","16268070","16268366","91","60375285"
"chr12","76728291","76728591","GL873530","16647228","16647517","86","60081063"
"chr12","77199038","77199345","GL873541","16268070","16268366","92","60930968"
"chr12","77402660","77402958","GL873541","16268070","16268366","83","61134590"
"chr12","77422235","77422530","GL873547","2222074","2222356","88","75200161"
"chr12","78702042","78702334","GL873530","16647228","16647517","79","62054814"
"chr12","78722890","78723173","GL873547","2222074","2222356","86","76500816"
"chr12","79663159","79663453","GL873530","16647228","16647517","80","63015931"
"chr12","80191587","80191741","GL873628","6402015","6402153","42","73789572"
"chr12","80192534","80192831","GL873755","463833","464092","103","79728701"
"chr12","80263417","80263718","GL873530","16647228","16647517","82","63616189"
"chr12","80356744","80357030","GL873530","16647228","16647517","83","63709516"
"chr12","80513942","80514219","GL873528","36697151","36697434","96","43816791"
"chr12","81862904","81863207","GL873541","16268070","16268366","86","65594834"
"chr12","82494251","82494546","GL873530","16647228","16647517","87","65847023"
"chr12","82648127","82648418","GL873541","16268070","16268366","81","66380057"
"chr12","83023490","83023800","GL873541","16268070","16268366","93","66755420"
"chr12","83070817","83071048","GL873557","3858721","3858924","80","79212096"
"chr12","83105821","83106119","GL873530","16647228","16647517","89","66458593"
"chr12","83139546","83139821","GL873562","3299887","3300144","86","79839659"
"chr12","83448937","83449207","GL873538","2567037","2567262","97","80881900"
"chr12","83640985","83641286","GL873541","16268070","16268366","82","67372915"
"chr12","84813782","84813905","GL873622","7076274","7076365","49","77737508"
"chr12","85279282","85279566","GL873541","16268070","16268366","86","69011212"
"chr12","85611195","85611506","GL873541","16268070","16268366","98","69343125"
"chr12","85828396","85828698","GL873541","16268070","16268366","95","69560326"
"chr12","85940062","85940417","GL873607","1418062","1418355","132","84522000"
"chr12","86891380","86891688","GL873541","16268070","16268366","87","70623310"
"chr12","87411788","87412081","GL873541","16268070","16268366","90","71143718"
"chr12","87863309","87863533","GL873538","2567037","2567262","66","85296272"
"chr12","87864616","87864703","GL873526","41481654","41481719","31","46382962"
"chr12","87869674","87869963","GL873547","2222074","2222356","94","85647600"
"chr12","88016127","88016434","GL873541","16268070","16268366","96","71748057"
"chr12","88023342","88023653","GL873752","427788","428097","87","87595554"
"chr12","88099693","88099989","GL873547","2222074","2222356","81","85877619"
"chr12","88320366","88320488","GL873550","5998776","5998900","41","82321590"
"chr12","88346471","88346778","GL873541","16268070","16268366","90","72078401"
"chr12","89453941","89454253","GL873541","16268070","16268366","96","73185871"
"chr12","89549388","89549667","GL873528","36697151","36697434","97","52852237"
"chr12","90141614","90141912","GL873541","16268070","16268366","90","73873544"
"chr12","90313251","90313543","GL873547","2222074","2222356","88","88091177"
"chr12","91269439","91269722","GL873530","16647228","16647517","86","74622211"
"chr12","92457383","92457692","GL873541","16268070","16268366","88","76189313"
"chr12","92642459","92642767","GL873541","16268070","16268366","90","76374389"
"chr12","92749371","92749683","GL873541","16268070","16268366","90","76481301"
"chr12","93162982","93163267","GL873547","2222074","2222356","79","90940908"
"chr12","93230250","93230542","GL873530","16647228","16647517","83","76583022"
"chr12","93898695","93898987","GL873547","2222074","2222356","81","91676621"
"chr12","94396651","94396934","GL873547","2222074","2222356","92","92174577"
"chr12","94619792","94620083","GL873547","2222074","2222356","77","92397718"
"chr12","94757779","94758083","GL873541","16268070","16268366","85","78489709"
"chr12","94801950","94802245","GL873528","36697151","36697434","88","58104799"
"chr12","94873489","94873795","GL873541","16268070","16268366","89","78605419"
"chr12","95131098","95131407","GL873752","427788","428097","95","94703310"
"chr12","95743369","95743669","GL873608","6630366","6630673","88","89113003"
"chr12","95942935","95943239","GL873541","16268070","16268366","87","79674865"
"chr12","95985046","95985163","GL873622","7076274","7076365","42","88908772"
"chr12","96226170","96226462","GL873530","16647228","16647517","79","79578942"
"chr12","96489987","96490266","GL873547","2222074","2222356","87","94267913"
"chr12","96725214","96725502","GL873530","16647228","16647517","94","80077986"
"chr12","96764480","96764780","GL873530","16647228","16647517","91","80117252"
"chr12","96862634","96862846","GL873531","3555300","3555500","67","93307334"
"chr12","96877336","96877630","GL873667","4451263","4451534","80","92426073"
"chr12","97059446","97059754","GL873541","16268070","16268366","95","80791376"
"chr12","97392320","97392622","GL873541","16268070","16268366","86","81124250"
"chr12","97581984","97582286","GL873547","2222074","2222356","93","95359910"
"chr12","97971780","97972088","GL873541","16268070","16268366","89","81703710"
"chr12","98075663","98075941","GL873541","16268070","16268366","93","81807593"
"chr12","98081610","98081924","GL873608","6630366","6630673","99","91451244"
"chr12","98103782","98104083","GL873530","16647228","16647517","91","81456554"
"chr12","98343816","98344086","GL873562","3299887","3300144","84","95043929"
"chr12","98589635","98589766","GL873550","5998776","5998900","35","92590859"
"chr12","98816856","98817165","GL873530","16647228","16647517","98","82169628"
"chr12","98848739","98849050","GL873528","36697151","36697434","100","62151588"
"chr12","98888759","98888937","GL873535","24407607","24407780","58","74481152"
"chr12","98967322","98967635","GL873541","16268070","16268366","90","82699252"
"chr12","98975612","98975905","GL873530","16647228","16647517","89","82328384"
"chr12","98993596","98993907","GL873541","16268070","16268366","98","82725526"
"chr12","99010868","99011156","GL873530","16647228","16647517","80","82363640"
"chr12","99186820","99187113","GL873530","16647228","16647517","83","82539592"
"chr12","99225811","99226117","GL873541","16268070","16268366","90","82957741"
"chr12","99311330","99311635","GL873530","16647228","16647517","99","82664102"
"chr12","100145465","100145751","GL873541","16268070","16268366","90","83877395"
"chr12","100928964","100929265","GL873541","16268070","16268366","82","84660894"
"chr12","100933867","100934156","GL873530","16647228","16647517","84","84286639"
"chr12","101407003","101407308","GL873541","16268070","16268366","92","85138933"
"chr12","101542036","101542236","GL873823","304319","304508","61","101237717"
"chr12","101617700","101618003","GL873541","16268070","16268366","90","85349630"
"chr12","101706953","101707248","GL873541","16268070","16268366","79","85438883"
"chr12","102357104","102357415","GL873530","16647228","16647517","101","85709876"
"chr12","102667116","102667414","GL873530","16647228","16647517","91","86019888"
"chr12","102686940","102687188","GL873680","3005257","3005482","90","99681683"
"chr12","102861611","102861920","GL873528","36697151","36697434","95","66164460"
"chr12","102957552","102957847","GL873530","16647228","16647517","88","86310324"
"chr12","103057737","103058035","GL873541","16268070","16268366","81","86789667"
"chr12","103143939","103144227","GL873528","36697151","36697434","92","66446788"
"chr12","103186024","103186315","GL873547","2222074","2222356","78","100963950"
"chr12","103187743","103188048","GL873541","16268070","16268366","90","86919673"
"chr12","103198428","103198609","GL873823","304319","304508","60","102894109"
"chr12","103199473","103199775","GL873541","16268070","16268366","86","86931403"
"chr12","103212985","103213292","GL873607","1418062","1418355","96","101794923"
"chr12","103288213","103288515","GL873530","16647228","16647517","83","86640985"
"chr12","103295914","103296047","GL873550","5998776","5998900","37","97297138"
"chr12","103312481","103312777","GL873541","16268070","16268366","84","87044411"
"chr12","103432598","103432902","GL873530","16647228","16647517","86","86785370"
"chr12","103454217","103454511","GL873547","2222074","2222356","83","101232143"
"chr12","103810770","103811053","GL873607","1418062","1418355","86","102392708"
"chr12","104165778","104166085","GL873541","16268070","16268366","89","87897708"
"chr12","104500606","104500909","GL873541","16268070","16268366","93","88232536"
"chr12","104514105","104514420","GL873541","16268070","16268366","101","88246035"
"chr12","104676697","104677003","GL873541","16268070","16268366","88","88408627"
"chr12","104873618","104873913","GL873528","36697151","36697434","102","68176467"
"chr12","105270430","105270737","GL873541","16268070","16268366","93","89002360"
"chr12","105441407","105441709","GL873541","16268070","16268366","89","89173337"
"chr12","105453650","105453957","GL873541","16268070","16268366","94","89185580"
"chr12","105659951","105660007","GL873554","10500008","10500061","17","95159943"
"chr12","106006709","106006991","GL873541","16268070","16268366","85","89738639"
"chr12","106505552","106505846","GL873530","16647228","16647517","83","89858324"
"chr12","107168465","107168755","GL873530","16647228","16647517","86","90521237"
"chr12","107181745","107182033","GL873547","2222074","2222356","84","104959671"
"chr12","107258713","107259023","GL873541","16268070","16268366","86","90990643"
"chr12","107433617","107433908","GL873530","16647228","16647517","85","90786389"
"chr12","107724576","107724867","GL873547","2222074","2222356","82","105502502"
"chr12","107783081","107783374","GL873667","4451263","4451534","108","103331818"
"chr12","107997885","107998157","GL873565","12307556","12307825","97","95690329"
"chr12","108110464","108110757","GL873528","36697151","36697434","98","71413313"
"chr12","108171343","108171621","GL873562","3299887","3300144","83","104871456"
"chr12","108426995","108427121","GL873550","5998776","5998900","38","102428219"
"chr12","108518404","108518625","GL873538","2567037","2567262","64","105951367"
"chr13","45612801","45613095","GL873541","16268070","16268366","91","29344731"
"chr13","385523","385830","GL873541","16268070","16268366","90","15882547"
"chr13","491068","491347","GL873530","16647228","16647517","89","16156160"
"chr13","792822","793122","GL873541","16268070","16268366","83","15475248"
"chr13","1849691","1849841","GL873611","3799989","3800137","63","1950298"
"chr13","2829746","2830033","GL873667","4451263","4451534","87","1621517"
"chr13","3055217","3055496","GL873547","2222074","2222356","91","833143"
"chr13","3621262","3621581","GL873541","16268070","16268366","100","12646808"
"chr13","4304193","4304303","GL873587","10002051","10002151","46","5697858"
"chr13","5187915","5188189","GL873562","3299887","3300144","94","1888028"
"chr13","5579347","5579641","GL873541","16268070","16268366","86","10688723"
"chr13","5763559","5763846","GL873547","2222074","2222356","85","3541485"
"chr13","6509678","6509967","GL873547","2222074","2222356","79","4287604"
"chr13","7060006","7060057","GL873527","37742071","37742124","23","30682065"
"chr13","7434309","7434624","GL873541","16268070","16268366","99","8833761"
"chr13","7869740","7870047","GL873541","16268070","16268366","94","8398330"
"chr13","7924883","7925190","GL873541","16268070","16268366","92","8343187"
"chr13","8089163","8089459","GL873528","36697151","36697434","90","28607988"
"chr13","8201872","8202188","GL873528","36697151","36697434","105","28495279"
"chr13","8915789","8915834","GL873731","2008517","2008552","24","6907272"
"chr13","10244512","10244687","GL873527","37742145","37742300","65","27497633"
"chr13","10244688","10244932","GL873680","3005257","3005482","76","7239431"
"chr13","10334686","10334998","GL873541","16268070","16268366","96","5933384"
"chr13","11593531","11593814","GL873562","3299887","3300144","86","8293644"
"chr13","11970942","11971217","GL873547","2222074","2222356","88","9748868"
"chr13","11997736","11998031","GL873530","16647228","16647517","86","4649492"
"chr13","12193150","12193464","GL873541","16268070","16268366","93","4074920"
"chr13","13224113","13224402","GL873547","2222074","2222356","86","11002039"
"chr13","13267143","13267363","GL873531","3555300","3555500","67","9711843"
"chr13","13578144","13578422","GL873530","16647228","16647517","88","3069084"
"chr13","13879559","13879858","GL873541","16268070","16268366","85","2388511"
"chr13","14137779","14138067","GL873530","16647228","16647517","86","2509449"
"chr13","14621045","14621347","GL873528","36697151","36697434","93","22076106"
"chr13","17024451","17024731","GL873562","3299887","3300144","93","13724564"
"chr13","17633109","17633178","GL873691","1645655","1645707","34","15987454"
"chr13","18479953","18480263","GL873541","16268070","16268366","98","2211883"
"chr13","18635337","18635646","GL873607","1418062","1418355","100","17217275"
"chr13","18890224","18890517","GL873530","16647228","16647517","84","2242996"
"chr13","19105097","19105395","GL873541","16268070","16268366","95","2837027"
"chr13","19164575","19164905","GL873812","559768","560073","101","18604807"
"chr13","19227948","19228256","GL873541","16268070","16268366","93","2959878"
"chr13","20142235","20142496","GL873547","5449763","5449997","88","14692472"
"chr13","21026408","21026708","GL873530","16647228","16647517","85","4379180"
"chr13","21872201","21872493","GL873667","4451263","4451534","89","17420938"
"chr13","21872508","21872816","GL873547","2222074","2222356","93","19650434"
"chr13","21908954","21909170","GL873630","2508568","2508753","77","19400386"
"chr13","21909171","21909415","GL873640","6426205","6426399","86","15482966"
"chr13","21909416","21909538","GL873550","5998776","5998900","49","15910640"
"chr13","22113644","22113915","GL873547","2222074","2222356","91","19891570"
"chr13","22138982","22139213","GL873680","3005257","3005482","69","19133725"
"chr13","22161884","22162188","GL873607","1418062","1418355","93","20743822"
"chr13","22294904","22295209","GL873541","16268070","16268366","90","6026834"
"chr13","22775549","22775632","GL873603","2092720","2092796","39","20682829"
"chr13","23142221","23142512","GL873530","16647228","16647517","79","6494993"
"chr13","23399547","23399853","GL873530","16647228","16647517","98","6752319"
"chr13","23404732","23404894","GL873550","5998776","5998900","58","17405956"
"chr13","23414803","23415054","GL873565","12307556","12307825","83","11107247"
"chr13","23437891","23438191","GL873608","6630366","6630673","89","16807525"
"chr13","23538206","23538505","GL873541","16268070","16268366","93","7270136"
"chr13","23720772","23721073","GL873541","16268070","16268366","90","7452702"
"chr13","23729542","23729661","GL873552","12711845","12711956","44","11017697"
"chr13","25694282","25694382","GL873587","10002051","10002151","30","15692231"
"chr13","25825965","25826257","GL873547","2222074","2222356","81","23603891"
"chr13","26232955","26233143","GL873530","5593486","5593649","57","20639469"
"chr13","27976595","27976814","GL873538","2567037","2567262","81","25409558"
"chr13","28820458","28820757","GL873607","1418062","1418355","91","27402396"
"chr13","28995363","28995642","GL873562","3299887","3300144","82","25695476"
"chr13","29466830","29467109","GL873547","2222074","2222356","85","27244756"
"chr13","29467151","29467162","GL873691","2903502","2903535","23","26563649"
"chr13","29722270","29722425","GL873585","9209559","9209725","49","20512711"
"chr13","30736181","30736487","GL873541","16268070","16268366","90","14468111"
"chr13","31105472","31105767","GL873528","36697151","36697434","102","5591679"
"chr13","31937844","31938032","GL873535","24407607","24407780","60","7530237"
"chr13","31938058","31938077","GL873691","2903502","2903535","20","29034556"
"chr13","32590972","32591246","GL873562","3299887","3300144","85","29291085"
"chr13","32599088","32599346","GL873528","25203621","25203847","88","7395467"
"chr13","32623743","32623916","GL874079","15836","16035","75","32607907"
"chr13","33424211","33424473","GL873535","4830564","4830824","94","28593647"
"chr13","33537588","33537921","GL873541","16268070","16268366","119","17269518"
"chr13","33797575","33797877","GL873541","16268070","16268366","90","17529505"
"chr13","33847146","33847437","GL873530","16647228","16647517","80","17199918"
"chr13","34193393","34193703","GL873608","6630366","6630673","94","27563027"
"chr13","34333227","34333520","GL873541","16268070","16268366","81","18065157"
"chr13","34406931","34407219","GL873528","36697151","36697434","100","2290220"
"chr13","34528554","34528853","GL873547","2222074","2222356","85","32306480"
"chr13","34536414","34536712","GL873541","16268070","16268366","85","18268344"
"chr13","34539616","34539925","GL873541","16268070","16268366","97","18271546"
"chr13","35085161","35085424","GL873565","12307556","12307825","99","22777605"
"chr13","35233003","35233304","GL873541","16268070","16268366","83","18964933"
"chr13","35347253","35347568","GL873541","16268070","16268366","100","19079183"
"chr13","35435040","35435342","GL873541","16268070","16268366","91","19166970"
"chr13","35625228","35625522","GL873541","16268070","16268366","90","19357158"
"chr13","35951985","35952284","GL873607","1418062","1418355","94","34533923"
"chr13","36191782","36192048","GL873562","3299887","3300144","92","32891895"
"chr13","37106265","37106544","GL873562","3299887","3300144","83","33806378"
"chr13","37121390","37121603","GL873557","3858721","3858924","64","33262669"
"chr13","37122865","37123165","GL873752","427788","428097","94","36695077"
"chr13","37127275","37127575","GL873541","16268070","16268366","93","20859205"
"chr13","37137688","37137977","GL873667","4451263","4451534","95","32686425"
"chr13","37771995","37772297","GL873530","16647228","16647517","85","21124767"
"chr13","38083272","38083563","GL873528","36697151","36697434","92","1386121"
"chr13","38703830","38704121","GL873565","12307556","12307825","101","26396274"
"chr13","38731809","38732113","GL873530","16647228","16647517","86","22084581"
"chr13","38751877","38752190","GL873541","16268070","16268366","100","22483807"
"chr13","38785311","38785603","GL873530","16647228","16647517","87","22138083"
"chr13","38809728","38810035","GL873541","16268070","16268366","89","22541658"
"chr13","39283406","39283714","GL873541","16268070","16268366","93","23015336"
"chr13","39560912","39561221","GL873541","16268070","16268366","92","23292842"
"chr13","39680251","39680406","GL873530","5593486","5593649","51","34086765"
"chr13","40121242","40121537","GL873547","2222074","2222356","81","37899168"
"chr13","40698442","40698749","GL873528","36697151","36697434","97","4001291"
"chr13","41724361","41724668","GL873541","16268070","16268366","90","25456291"
"chr13","42307862","42308143","GL873547","2222074","2222356","89","40085788"
"chr13","42580749","42580988","GL873531","3555300","3555500","92","39025449"
"chr13","42869038","42869335","GL873541","16268070","16268366","94","26600968"
"chr13","43892001","43892146","GL873550","5998776","5998900","49","37893225"
"chr13","43892448","43892592","GL873619","2497092","2497229","50","41395356"
"chr13","43935455","43935755","GL873541","16268070","16268366","86","27667385"
"chr13","44387871","44388183","GL873541","16268070","16268366","104","28119801"
"chr13","44755147","44755269","GL873619","2497092","2497229","51","42258055"
"chr13","44950549","44950845","GL873528","36697151","36697434","89","8253398"
"chr13","45133548","45133846","GL873541","16268070","16268366","82","28865478"
"chr13","45363712","45364047","GL873541","16268070","16268366","122","29095642"
"chr13","45390748","45391082","GL873541","16268070","16268366","120","29122678"
"chr13","45996335","45996637","GL873541","16268070","16268366","100","29728265"
"chr13","45998775","45999050","GL873565","12307556","12307825","87","33691219"
"chr13","46106132","46106403","GL873528","36697151","36697434","102","9408981"
"chr13","46210225","46210476","GL873755","463833","464092","101","45746392"
"chr13","46226128","46226400","GL873562","3299887","3300144","81","42926241"
"chr13","46364648","46364945","GL873541","16268070","16268366","88","30096578"
"chr13","46900732","46901039","GL873541","16268070","16268366","94","30632662"
"chr13","48534413","48534692","GL873562","3299887","3300144","91","45234526"
"chr13","49150710","49150772","GL873527","37742071","37742124","36","11408639"
"chr13","49150794","49150887","GL873521","9884269","9884347","52","39266525"
"chr13","49430837","49431108","GL873547","2222074","2222356","91","47208763"
"chr13","49606045","49606333","GL873667","4451263","4451534","93","45154782"
"chr13","49642611","49642917","GL873541","16268070","16268366","87","33374541"
"chr13","49730977","49731264","GL873528","36697151","36697434","98","13033826"
"chr13","51045247","51045524","GL873659","913070","913333","88","50132177"
"chr13","51045689","51045945","GL873528","25203621","25203847","88","25842068"
"chr13","51281024","51281331","GL873541","16268070","16268366","86","35012954"
"chr13","51581630","51581824","GL873823","304319","304508","61","51277311"
"chr13","51581866","51582145","GL873562","3299887","3300144","85","48281979"
"chr13","51582187","51582201","GL873691","2903502","2903535","22","48678685"
"chr13","51956297","51956599","GL873530","16647228","16647517","107","35309069"
"chr13","52002732","52003012","GL873547","2222074","2222356","95","49780658"
"chr13","52238581","52238886","GL873547","2222074","2222356","91","50016507"
"chr13","52438669","52438995","GL873608","6630366","6630673","111","45808303"
"chr13","52554772","52555073","GL873530","16647228","16647517","91","35907544"
"chr13","52578737","52579050","GL873541","16268070","16268366","96","36310667"
"chr13","53327362","53327656","GL873547","2222074","2222356","86","51105288"
"chr13","53937281","53937463","GL873535","24407607","24407780","59","29529674"
"chr13","55045744","55046051","GL873608","6630366","6630673","97","48415378"
"chr13","55235930","55236211","GL873547","2222074","2222356","90","53013856"
"chr13","55236222","55236271","GL873554","10500008","10500061","20","44736214"
"chr13","55332489","55332795","GL873530","16647228","16647517","92","38685261"
"chr13","56673996","56674287","GL873547","2222074","2222356","86","54451922"
"chr13","57139627","57139918","GL873547","2222074","2222356","77","54917553"
"chr13","57444098","57444409","GL873528","36697151","36697434","114","20746947"
"chr13","57444426","57444552","GL873550","5998776","5998900","31","51445650"
"chr13","57700238","57700522","GL873547","2222074","2222356","84","55478164"
"chr13","58281675","58281948","GL873565","12307556","12307825","100","45974119"
"chr13","58487908","58488197","GL873530","16647228","16647517","84","41840680"
"chr13","60154028","60154308","GL873562","3299887","3300144","91","56854141"
"chr13","60486477","60486756","GL873547","2222074","2222356","77","58264403"
"chr13","61044596","61044698","GL873520","23895808","23895898","37","37148788"
"chr13","61564391","61564541","GL873541","1550303","1550443","49","60014088"
"chr13","61568534","61568831","GL873541","16268070","16268366","93","45300464"
"chr13","62320987","62321286","GL873541","16268070","16268366","87","46052917"
"chr13","62440899","62441196","GL873541","16268070","16268366","91","46172829"
"chr13","62561569","62561858","GL873541","16268070","16268366","94","46293499"
"chr13","62644522","62644815","GL873530","16647228","16647517","80","45997294"
"chr13","62781204","62781489","GL873541","16268070","16268366","90","46513134"
"chr13","63037034","63037329","GL873547","2222074","2222356","87","60814960"
"chr13","63080365","63080655","GL873547","2222074","2222356","91","60858291"
"chr13","63138736","63139042","GL873541","16268070","16268366","84","46870666"
"chr13","63189207","63189509","GL873541","16268070","16268366","86","46921137"
"chr13","63390521","63390804","GL873547","2222074","2222356","85","61168447"
"chr13","63471952","63472154","GL873557","3858721","3858924","59","59613231"
"chr13","63945970","63946266","GL873541","16268070","16268366","83","47677900"
"chr13","64444998","64445291","GL873530","16647228","16647517","80","47797770"
"chr13","64951567","64951860","GL873547","2222074","2222356","80","62729493"
"chr13","65500305","65500602","GL873530","16647228","16647517","88","48853077"
"chr13","65616240","65616511","GL873528","36697151","36697434","86","28919089"
"chr13","65755815","65756123","GL873541","16268070","16268366","90","49487745"
"chr13","65916557","65916859","GL873607","1418062","1418355","87","64498495"
"chr13","66007235","66007542","GL873541","16268070","16268366","89","49739165"
"chr13","66393589","66393893","GL873530","16647228","16647517","87","49746361"
"chr13","66724644","66724918","GL873528","36697151","36697434","97","30027493"
"chr13","67161051","67161331","GL873667","4451263","4451534","91","62709788"
"chr13","67171008","67171184","GL873530","5593486","5593649","61","61577522"
"chr13","67198097","67198382","GL873547","2222074","2222356","81","64976023"
"chr13","67260326","67260640","GL873530","16647228","16647517","101","50613098"
"chr13","67430762","67430902","GL873541","1550303","1550443","52","65880459"
"chr13","67664836","67665130","GL873528","36697151","36697434","96","30967685"
"chr13","67891703","67891927","GL873557","3858721","3858924","77","64032982"
"chr13","68244408","68244709","GL873547","2222074","2222356","94","66022334"
"chr13","68257751","68258056","GL873541","16268070","16268366","94","51989681"
"chr13","68823926","68824225","GL873541","16268070","16268366","89","52555856"
"chr13","69677038","69677347","GL873541","16268070","16268366","97","53408968"
"chr13","69891872","69892169","GL873541","16268070","16268366","90","53623802"
"chr13","71215936","71216244","GL873547","2222074","2222356","98","68993862"
"chr13","72096695","72096978","GL873547","2222074","2222356","92","69874621"
"chr13","72872804","72873097","GL873547","2222074","2222356","94","70650730"
"chr13","74637389","74637687","GL873541","16268070","16268366","86","58369319"
"chr13","76844294","76844447","GL873628","6402015","6402153","51","70442279"
"chr13","76874734","76875023","GL873530","16647228","16647517","91","60227506"
"chr13","77859006","77859323","GL873528","36697151","36697434","130","41161855"
"chr13","78101478","78101780","GL873541","16268070","16268366","94","61833408"
"chr13","78222866","78223185","GL873667","4451263","4451534","117","73771603"
"chr13","78261272","78261553","GL873562","3299887","3300144","89","74961385"
"chr13","78312332","78312634","GL873608","6630366","6630673","90","71681966"
"chr13","78315592","78315893","GL873541","16268070","16268366","96","62047522"
"chr13","78355454","78355760","GL873608","6630366","6630673","88","71725088"
"chr13","78402073","78402386","GL873528","36697151","36697434","97","41704922"
"chr13","78931450","78931745","GL873547","2222074","2222356","93","76709376"
"chr13","79437538","79437833","GL873530","16647228","16647517","85","62790310"
"chr13","79608258","79608550","GL873547","2222074","2222356","81","77386184"
"chr13","79733727","79734014","GL873530","16647228","16647517","86","63086499"
"chr13","79755325","79755609","GL873547","2222074","2222356","82","77533251"
"chr13","79765152","79765450","GL873541","16268070","16268366","79","63497082"
"chr13","80405244","80405376","GL873619","2497092","2497229","48","77908152"
"chr13","82090322","82090621","GL873541","16268070","16268366","85","65822252"
"chr13","82147749","82147918","GL873524","42560728","42560902","58","39587021"
"chr13","82263272","82263574","GL873608","6630366","6630673","94","75632906"
"chr13","82379955","82380225","GL873562","3299887","3300144","91","79080068"
"chr13","82494221","82494525","GL873541","16268070","16268366","83","66226151"
"chr13","82514972","82515275","GL873530","16647228","16647517","105","65867744"
"chr13","82612030","82612077","GL873524","36505249","36505303","27","46106781"
"chr13","83056565","83056722","GL873585","9209559","9209725","68","73847006"
"chr13","83056745","83056887","GL873524","43272770","43272878","59","39783975"
"chr13","83738147","83738479","GL873812","559768","560073","116","83178379"
"chr13","83885586","83885779","GL873530","5593486","5593649","66","78292100"
"chr13","83958859","83959184","GL873541","16268070","16268366","110","67690789"
"chr13","84309475","84309786","GL873530","16647228","16647517","101","67662247"
"chr13","84489833","84490137","GL873547","2222074","2222356","91","82267759"
"chr13","84595707","84595997","GL873530","16647228","16647517","81","67948479"
"chr13","84939124","84939440","GL873541","16268070","16268366","97","68671054"
"chr13","85479826","85480102","GL873680","3005257","3005482","101","82474569"
"chr13","85659100","85659378","GL873547","2222074","2222356","90","83437026"
"chr13","85821031","85821333","GL873541","16268070","16268366","85","69552961"
"chr13","86071059","86071351","GL873530","16647228","16647517","83","69423831"
"chr13","86109025","86109305","GL873528","36697151","36697434","98","49411874"
"chr13","86116145","86116434","GL873547","2222074","2222356","83","83894071"
"chr13","86174250","86174557","GL873528","36697151","36697434","93","49477099"
"chr13","86281126","86281228","GL873524","43272658","43272747","39","43008468"
"chr13","86323276","86323561","GL873547","2222074","2222356","76","84101202"
"chr13","86456723","86457023","GL873608","6630366","6630673","94","79826357"
"chr13","86658963","86659276","GL873608","6630366","6630673","110","80028597"
"chr13","86923785","86924086","GL873541","16268070","16268366","90","70655715"
"chr13","87302641","87302947","GL873530","16647228","16647517","91","70655413"
"chr13","87375702","87376030","GL873541","16268070","16268366","112","71107632"
"chr13","87383345","87383634","GL873547","2222074","2222356","89","85161271"
"chr13","87605946","87606255","GL873530","16647228","16647517","92","70958718"
"chr13","87744238","87744371","GL873619","2497092","2497229","58","85247146"
"chr13","87744402","87744511","GL873587","10002051","10002151","50","77742351"
"chr13","87867339","87867650","GL873541","16268070","16268366","90","71599269"
"chr13","88518726","88519023","GL873659","913070","913333","92","87605656"
"chr13","88890694","88890812","GL873622","7076274","7076365","46","81814420"
"chr13","89017456","89017756","GL873541","16268070","16268366","92","72749386"
"chr13","89187148","89187443","GL873530","16647228","16647517","80","72539920"
"chr13","89359887","89360120","GL873557","3858721","3858924","82","85501166"
"chr13","89737695","89738009","GL873541","16268070","16268366","96","73469625"
"chr13","90084906","90085084","GL873530","5593486","5593649","56","84491420"
"chr13","90350143","90350271","GL873622","7076274","7076365","56","83273869"
"chr13","90749493","90749789","GL873541","16268070","16268366","83","74481423"
"chr13","91017016","91017294","GL873562","3299887","3300144","86","87717129"
"chr13","91021339","91021645","GL873541","16268070","16268366","87","74753269"
"chr13","91053101","91053384","GL873530","16647228","16647517","94","74405873"
"chr13","92133593","92133890","GL873528","36697151","36697434","100","55436442"
"chr13","93307214","93307520","GL873541","16268070","16268366","89","77039144"
"chr13","93802350","93802544","GL873535","24407607","24407780","61","69394743"
"chr13","93848759","93849059","GL873541","16268070","16268366","83","77580689"
"chr13","93936933","93937062","GL873619","2497092","2497229","47","91439841"
"chr13","93964542","93964823","GL873547","2222074","2222356","89","91742468"
"chr13","93995141","93995438","GL873541","16268070","16268366","83","77727071"
"chr13","94840723","94841029","GL873608","6630366","6630673","90","88210357"
"chr13","95100695","95100991","GL873607","1418062","1418355","88","93682633"
"chr13","96152624","96152716","GL873526","41480965","41481045","59","54671659"
"chr13","96152783","96152983","GL873630","2508568","2508753","69","93644215"
"chr13","96482557","96482669","GL873622","7076274","7076365","34","89406283"
"chr13","96701762","96702071","GL873608","6630366","6630673","96","90071396"
"chr13","97525904","97526191","GL873547","2222074","2222356","79","95303830"
"chr13","97697573","97697875","GL873541","16268070","16268366","82","81429503"
"chr13","98077391","98077669","GL873562","3299887","3300144","85","94777504"
"chr14","46399426","46399569","GL873628","6402015","6402153","55","39997411"
"chr14","358366","358646","GL873530","16647228","16647517","87","16288862"
"chr14","830467","830573","GL873550","5998776","5998900","46","5168309"
"chr14","830872","831067","GL873697","3111225","3111427","55","2280353"
"chr14","842619","842916","GL873541","16268070","16268366","92","15425451"
"chr14","885388","885684","GL873541","16268070","16268366","85","15382682"
"chr14","947149","947293","GL873619","2497092","2497229","40","1549943"
"chr14","953562","953838","GL873541","16268070","16268366","96","15314508"
"chr14","1152102","1152358","GL873547","5449763","5449997","88","4297661"
"chr14","1186035","1186334","GL873541","16268070","16268366","97","15082035"
"chr14","2503001","2503287","GL873528","36697151","36697434","104","34194150"
"chr14","2686191","2686497","GL873528","36697151","36697434","96","34010960"
"chr14","3080768","3081079","GL873541","16268070","16268366","87","13187302"
"chr14","3111155","3111464","GL873541","16268070","16268366","86","13156915"
"chr14","3260195","3260311","GL873552","12711845","12711956","42","9451650"
"chr14","3273365","3273488","GL873619","2497092","2497229","46","776273"
"chr14","3458930","3459230","GL873547","2222074","2222356","84","1236856"
"chr14","4037682","4037841","GL873611","3799989","3800137","56","237693"
"chr14","4037874","4038019","GL873550","5998776","5998900","45","1960902"
"chr14","4757490","4757690","GL873531","3555300","3555500","64","1202190"
"chr14","4816431","4816719","GL873562","3299887","3300144","97","1516544"
"chr14","5056789","5057086","GL873530","16647228","16647517","86","11590439"
"chr14","5386724","5387004","GL873562","3299887","3300144","88","2086837"
"chr14","5397258","5397568","GL873541","16268070","16268366","93","10870812"
"chr14","5412498","5412797","GL873541","16268070","16268366","91","10855572"
"chr14","5494369","5494528","GL873530","5593486","5593649","49","99117"
"chr14","5494556","5494675","GL873550","5998776","5998900","45","504220"
"chr14","6650149","6650431","GL873565","12307556","12307825","111","5657407"
"chr14","6977903","6978176","GL873541","16268070","16268366","92","9290167"
"chr14","7020092","7020385","GL873530","16647228","16647517","92","9627136"
"chr14","7231854","7231999","GL873550","5998776","5998900","50","1233078"
"chr14","7740969","7741247","GL873528","36697151","36697434","98","28956182"
"chr14","8029494","8029806","GL873541","16268070","16268366","90","8238576"
"chr14","8214995","8215295","GL873667","4451263","4451534","104","3763732"
"chr14","8408006","8408236","GL873659","913070","913333","88","7494936"
"chr14","8479713","8480037","GL873608","6630366","6630673","99","1849347"
"chr14","8578842","8579133","GL873547","2222074","2222356","80","6356768"
"chr14","9346341","9346512","GL873530","5593486","5593649","42","3752855"
"chr14","9379693","9379995","GL873541","16268070","16268366","91","6888377"
"chr14","9660390","9660688","GL873530","16647228","16647517","87","6986838"
"chr14","9848029","9848146","GL873520","23895808","23895898","54","14047779"
"chr14","9881556","9881741","GL873697","3111225","3111427","56","6770331"
"chr14","9884502","9884801","GL873547","2222074","2222356","86","7662428"
"chr14","10071448","10071731","GL873565","12307556","12307825","92","2236108"
"chr14","10326097","10326351","GL873538","2567037","2567262","85","7759060"
"chr14","11542461","11542763","GL873547","2222074","2222356","92","9320387"
"chr14","11669912","11670204","GL873547","2222074","2222356","83","9447838"
"chr14","12038537","12038844","GL873541","16268070","16268366","89","4229533"
"chr14","12100793","12101086","GL873530","16647228","16647517","81","4546435"
"chr14","12392276","12392580","GL873541","16268070","16268366","87","3875794"
"chr14","12539386","12539667","GL873547","2222074","2222356","86","10317312"
"chr14","12540115","12540410","GL873541","16268070","16268366","89","3727955"
"chr14","12590517","12590833","GL873752","427788","428097","99","12162729"
"chr14","12666846","12667152","GL873541","16268070","16268366","96","3601224"
"chr14","12717469","12717730","GL873680","3005257","3005482","87","9712212"
"chr14","13065915","13066214","GL873541","16268070","16268366","81","3202155"
"chr14","13154936","13155232","GL873530","16647228","16647517","80","3492292"
"chr14","13159160","13159458","GL873541","16268070","16268366","81","3108910"
"chr14","13279572","13279881","GL873607","1418062","1418355","94","11861510"
"chr14","13682210","13682484","GL873565","12307556","12307825","79","1374654"
"chr14","14082396","14082726","GL873541","16268070","16268366","112","2185674"
"chr14","14584773","14585068","GL873752","427788","428097","80","14156985"
"chr14","15320229","15320546","GL873608","6630366","6630673","103","8689863"
"chr14","15383288","15383583","GL873530","16647228","16647517","90","1263940"
"chr14","15590307","15590598","GL873528","36697151","36697434","96","21106844"
"chr14","15634983","15635291","GL873541","16268070","16268366","94","633087"
"chr14","18178373","18178659","GL873565","12307556","12307825","96","5870817"
"chr14","18471809","18472103","GL873547","2222074","2222356","83","16249735"
"chr14","18688841","18689163","GL873528","36697151","36697434","109","18008310"
"chr14","18787069","18787376","GL873541","16268070","16268366","85","2518999"
"chr14","18956776","18957072","GL873608","6630366","6630673","88","12326410"
"chr14","18982507","18982803","GL873541","16268070","16268366","89","2714437"
"chr14","20590623","20590929","GL873607","1418062","1418355","92","19172561"
"chr14","21025906","21026176","GL873659","913070","913333","94","20112836"
"chr14","21563888","21564193","GL873541","16268070","16268366","99","5295818"
"chr14","21784683","21784951","GL873659","913070","913333","78","20871613"
"chr14","22051098","22051406","GL873541","16268070","16268366","91","5783028"
"chr14","22096587","22096882","GL873530","16647228","16647517","80","5449359"
"chr14","22221325","22221460","GL873550","5998776","5998900","41","16222549"
"chr14","22227181","22227481","GL873528","36697151","36697434","92","14469970"
"chr14","22244356","22244659","GL873541","16268070","16268366","80","5976286"
"chr14","22253666","22253969","GL873541","16268070","16268366","94","5985596"
"chr14","22324093","22324369","GL873547","2222074","2222356","83","20102019"
"chr14","23983718","23983993","GL873528","36697151","36697434","98","12713433"
"chr14","24033475","24033757","GL873547","2222074","2222356","90","21811401"
"chr14","24071203","24071477","GL873562","3299887","3300144","82","20771316"
"chr14","24383975","24384288","GL873608","6630366","6630673","96","17753609"
"chr14","25471748","25472055","GL873541","16268070","16268366","101","9203678"
"chr14","26687611","26687901","GL873530","16647228","16647517","94","10040383"
"chr14","26689485","26689612","GL873552","12711845","12711956","50","13977640"
"chr14","26741966","26742270","GL873541","16268070","16268366","91","10473896"
"chr14","26760751","26761028","GL873562","3299887","3300144","82","23460864"
"chr14","27222601","27222875","GL873535","4830564","4830824","95","22392037"
"chr14","27748542","27748824","GL873528","36697151","36697434","93","8948609"
"chr14","28039435","28039584","GL873628","6402015","6402153","49","21637420"
"chr14","28764849","28765136","GL873530","16647228","16647517","83","12117621"
"chr14","29095607","29095869","GL873659","913070","913333","89","28182537"
"chr14","29546991","29547240","GL873680","3005257","3005482","85","26541734"
"chr14","30200501","30200810","GL873528","36697151","36697434","89","6496650"
"chr14","31453652","31453954","GL873541","16268070","16268366","92","15185582"
"chr14","32127757","32128068","GL873541","16268070","16268366","93","15859687"
"chr14","33067112","33067242","GL873619","2497092","2497229","43","30570020"
"chr14","33189767","33190072","GL873541","16268070","16268366","90","16921697"
"chr14","33225810","33226106","GL873530","16647228","16647517","87","16578582"
"chr14","33587014","33587323","GL873659","913070","913333","92","32673944"
"chr14","33667315","33667632","GL873541","16268070","16268366","94","17399245"
"chr14","33956242","33956544","GL873541","16268070","16268366","90","17688172"
"chr14","33961792","33962060","GL873541","16268070","16268366","88","17693722"
"chr14","33993071","33993339","GL873565","12307556","12307825","89","21685515"
"chr14","34731348","34731643","GL873541","16268070","16268366","80","18463278"
"chr14","34781921","34782248","GL873541","16268070","16268366","108","18513851"
"chr14","35916188","35916490","GL873541","16268070","16268366","85","19648118"
"chr14","35929842","35930148","GL873541","16268070","16268366","89","19661772"
"chr14","36951646","36951952","GL873528","36697151","36697434","92","254495"
"chr14","37840547","37840721","GL873530","5593486","5593649","43","32247061"
"chr14","38912326","38912620","GL873530","16647228","16647517","81","22265098"
"chr14","38971811","38972093","GL873607","1418062","1418355","87","37553749"
"chr14","39585131","39585427","GL873541","16268070","16268366","86","23317061"
"chr14","40698447","40698686","GL873680","3005257","3005482","73","37693190"
"chr14","41449088","41449389","GL873607","1418062","1418355","92","40031026"
"chr14","41598706","41599001","GL873541","16268070","16268366","85","25330636"
"chr14","41607680","41607971","GL873541","16268070","16268366","86","25339610"
"chr14","41993342","41993631","GL873547","2222074","2222356","87","39771268"
"chr14","42208060","42208263","GL873531","3555300","3555500","58","38652760"
"chr14","42540084","42540191","GL873550","5998776","5998900","45","36541308"
"chr14","42702336","42702640","GL873608","6630366","6630673","88","36071970"
"chr14","42981101","42981429","GL873530","16647228","16647517","116","26333873"
"chr14","42998902","42999196","GL873659","913070","913333","86","42085832"
"chr14","43002675","43002965","GL873547","2222074","2222356","89","40780601"
"chr14","43204801","43205107","GL873528","36697151","36697434","87","6507650"
"chr14","43658881","43659173","GL873530","16647228","16647517","82","27011653"
"chr14","43804663","43804967","GL873667","4451263","4451534","90","39353400"
"chr14","43933328","43933625","GL873607","1418062","1418355","86","42515266"
"chr14","43996401","43996691","GL873541","16268070","16268366","88","27728331"
"chr14","44458088","44458367","GL873547","2222074","2222356","92","42236014"
"chr14","44614649","44614875","GL873538","2567037","2567262","72","42047612"
"chr14","44793823","44794118","GL873530","16647228","16647517","84","28146595"
"chr14","44852060","44852332","GL873562","3299887","3300144","83","41552173"
"chr14","44892179","44892372","GL873823","304319","304508","56","44587860"
"chr14","44953493","44953595","GL873524","43272658","43272747","44","1680835"
"chr14","44953625","44953794","GL873530","5593486","5593649","55","39360139"
"chr14","44963225","44963522","GL873530","16647228","16647517","84","28315997"
"chr14","44990628","44990709","GL873603","2092720","2092796","32","42897908"
"chr14","45091020","45091328","GL873528","36697151","36697434","98","8393869"
"chr14","45157271","45157575","GL873547","2222074","2222356","88","42935197"
"chr14","45165063","45165374","GL873607","1418062","1418355","102","43747001"
"chr14","45185162","45185388","GL873680","3005257","3005482","70","42179905"
"chr14","45335131","45335263","GL873550","5998776","5998900","36","39336355"
"chr14","45357407","45357730","GL873608","6630366","6630673","99","38727041"
"chr14","45488615","45488958","GL873608","6630366","6630673","119","38858249"
"chr14","45495476","45495783","GL873541","16268070","16268366","93","29227406"
"chr14","45516246","45516500","GL873562","3299887","3300144","96","42216359"
"chr14","45519471","45519763","GL873565","12307556","12307825","100","33211915"
"chr14","45538560","45538861","GL873541","16268070","16268366","87","29270490"
"chr14","45592971","45593246","GL873530","16647228","16647517","85","28945743"
"chr14","45719341","45719401","GL873550","5998911","5998963","31","39720430"
"chr14","45719979","45720143","GL873530","5593486","5593649","46","40126493"
"chr14","45897063","45897190","GL873619","2497092","2497229","45","43399971"
"chr14","45938739","45939044","GL873541","16268070","16268366","89","29670669"
"chr14","46117545","46117675","GL873550","5998776","5998900","33","40118769"
"chr14","46303347","46303612","GL873680","3005257","3005482","89","43298090"
"chr14","47016027","47016259","GL873538","2567037","2567262","69","44448990"
"chr14","48826130","48826421","GL873547","2222074","2222356","83","46604056"
"chr14","49444702","49444985","GL873547","2222074","2222356","87","47222628"
"chr14","49482958","49483244","GL873528","36697151","36697434","95","12785807"
"chr14","49931995","49932285","GL873528","36697151","36697434","92","13234844"
"chr14","50607863","50608047","GL873530","5593486","5593649","61","45014377"
"chr14","51148753","51149059","GL873541","16268070","16268366","89","34880683"
"chr14","51174162","51174453","GL873541","16268070","16268366","81","34906092"
"chr14","51243444","51243750","GL873541","16268070","16268366","92","34975374"
"chr14","51251769","51252080","GL873528","36697151","36697434","89","14554618"
"chr14","51257347","51257602","GL873528","25203621","25203847","93","26053726"
"chr14","51369099","51369395","GL873608","6630366","6630673","87","44738733"
"chr14","51479355","51479569","GL873557","3858721","3858924","64","47620634"
"chr14","52374599","52374775","GL873530","5593486","5593649","52","46781113"
"chr14","52418707","52418979","GL873565","12307556","12307825","93","40111151"
"chr14","52418990","52419165","GL873527","37742145","37742300","57","14676845"
"chr14","52817028","52817317","GL873528","36697151","36697434","88","16119877"
"chr14","52887649","52887821","GL873560","5855436","5855580","64","47032213"
"chr14","52958399","52958502","GL873524","43272658","43272747","43","9685741"
"chr14","52996483","52996698","GL873538","2567037","2567262","63","50429446"
"chr14","52997499","52997815","GL873530","16647228","16647517","96","36350271"
"chr14","53644088","53644388","GL873541","16268070","16268366","95","37376018"
"chr14","53650197","53650475","GL873562","3299887","3300144","79","50350310"
"chr14","54156150","54156456","GL873541","16268070","16268366","92","37888080"
"chr14","54712832","54713131","GL873541","16268070","16268366","85","38444762"
"chr14","55279019","55279323","GL873541","16268070","16268366","97","39010949"
"chr14","55684103","55684411","GL873607","1418062","1418355","93","54266041"
"chr14","56801070","56801369","GL873607","1418062","1418355","89","55383008"
"chr14","57070656","57070827","GL873585","9209559","9209725","46","47861097"
"chr14","57768344","57768640","GL873541","16268070","16268366","90","41500274"
"chr14","58579114","58579247","GL873550","5998776","5998900","42","52580338"
"chr14","58579248","58579550","GL873547","2222074","2222356","105","56357174"
"chr14","58582806","58583111","GL873528","36697151","36697434","94","21885655"
"chr14","58666428","58666733","GL873530","16647228","16647517","90","42019200"
"chr14","58882355","58882655","GL873541","16268070","16268366","78","42614285"
"chr14","59387955","59388263","GL873541","16268070","16268366","86","43119885"
"chr14","59429504","59429785","GL873547","2222074","2222356","85","57207430"
"chr14","59465512","59465650","GL873541","1550303","1550443","60","57915209"
"chr14","59814792","59815100","GL873541","16268070","16268366","88","43546722"
"chr14","59825541","59825829","GL873547","2222074","2222356","79","57603467"
"chr14","59828733","59829018","GL873607","1418062","1418355","76","58410671"
"chr14","59852779","59853076","GL873530","16647228","16647517","80","43205551"
"chr14","60098187","60098470","GL873547","2222074","2222356","84","57876113"
"chr14","60501630","60501919","GL873547","2222074","2222356","84","58279556"
"chr14","60637040","60637339","GL873541","16268070","16268366","93","44368970"
"chr14","60637405","60637720","GL873607","1418062","1418355","111","59219343"
"chr14","60699079","60699387","GL873608","6630366","6630673","88","54068713"
"chr14","60740033","60740297","GL873562","3299887","3300144","88","57440146"
"chr14","60778125","60778267","GL873550","5998776","5998900","53","54779349"
"chr14","61007261","61007536","GL873562","3299887","3300144","83","57707374"
"chr14","61349438","61349746","GL873541","16268070","16268366","91","45081368"
"chr14","61387831","61388124","GL873541","16268070","16268366","84","45119761"
"chr14","61499082","61499381","GL873541","16268070","16268366","87","45231012"
"chr14","61597253","61597561","GL873541","16268070","16268366","93","45329183"
"chr14","61597585","61597855","GL873562","3299887","3300144","84","58297698"
"chr14","61847438","61847620","GL873823","304319","304508","57","61543119"
"chr14","62647997","62648216","GL873557","3858721","3858924","67","58789276"
"chr14","62852245","62852552","GL873541","16268070","16268366","91","46584175"
"chr14","62962590","62962886","GL873667","4451263","4451534","88","58511327"
"chr14","62978844","62979146","GL873547","2222074","2222356","90","60756770"
"chr14","62993175","62993473","GL873541","16268070","16268366","77","46725105"
"chr14","63187388","63187693","GL873752","427788","428097","86","62759600"
"chr14","63352153","63352302","GL873530","5593486","5593649","48","57758667"
"chr14","63498451","63498612","GL873530","5593486","5593649","44","57904965"
"chr14","63605219","63605526","GL873541","16268070","16268366","92","47337149"
"chr14","63687139","63687201","GL873554","10500008","10500061","22","53187131"
"chr14","64139596","64139811","GL873531","3555300","3555500","66","60584296"
"chr14","64605391","64605505","GL873622","7076274","7076365","43","57529117"
"chr14","64676022","64676320","GL873607","1418062","1418355","80","63257960"
"chr14","64727351","64727643","GL873530","16647228","16647517","78","48080123"
"chr14","64778087","64778393","GL873541","16268070","16268366","101","48510017"
"chr14","65601161","65601448","GL873547","2222074","2222356","94","63379087"
"chr14","65601553","65601668","GL873550","5998776","5998900","44","59602777"
"chr14","65920033","65920342","GL873752","427788","428097","101","65492245"
"chr14","66068936","66069241","GL873541","16268070","16268366","94","49800866"
"chr14","67029759","67029860","GL873643","6205658","6205743","38","60824101"
"chr14","67231489","67231783","GL873547","2222074","2222356","77","65009415"
"chr14","67782475","67782602","GL873552","12711845","12711956","50","55070630"
"chr14","67795061","67795345","GL873547","2222074","2222356","83","65572987"
"chr14","68019477","68019770","GL873547","2222074","2222356","86","65797403"
"chr14","68029332","68029639","GL873541","16268070","16268366","89","51761262"
"chr14","68059462","68059545","GL873524","36505249","36505303","42","31554213"
"chr14","68059559","68059712","GL873541","1550303","1550443","47","66509256"
"chr14","68359125","68359423","GL873530","16647228","16647517","81","51711897"
"chr14","68456576","68456893","GL873541","16268070","16268366","102","52188506"
"chr14","68489088","68489386","GL873541","16268070","16268366","81","52221018"
"chr14","68867660","68867957","GL873541","16268070","16268366","87","52599590"
"chr14","69005235","69005530","GL873541","16268070","16268366","81","52737165"
"chr14","69348698","69348991","GL873547","2222074","2222356","86","67126624"
"chr14","70363691","70363985","GL873530","16647228","16647517","84","53716463"
"chr14","70799536","70799834","GL873541","16268070","16268366","88","54531466"
"chr14","71255308","71255441","GL873550","5998776","5998900","36","65256532"
"chr14","71255442","71255773","GL873752","427788","428097","115","70827654"
"chr14","71373223","71373333","GL873524","43272658","43272747","50","28100565"
"chr14","71567377","71567599","GL873680","3005257","3005482","73","68562120"
"chr14","72553615","72553920","GL873541","16268070","16268366","93","56285545"
"chr14","73316216","73316519","GL873547","2222074","2222356","90","71094142"
"chr14","73449016","73449297","GL873547","2222074","2222356","86","71226942"
"chr14","73575403","73575684","GL873755","463833","464092","92","73111570"
"chr14","73627770","73628044","GL873547","2222074","2222356","84","71405696"
"chr14","73682311","73682621","GL873541","16268070","16268366","94","57414241"
"chr14","73945081","73945372","GL873530","16647228","16647517","79","57297853"
"chr14","73989765","73990058","GL873541","16268070","16268366","97","57721695"
"chr14","74021868","74022082","GL873531","3555300","3555500","64","70466568"
"chr14","74080496","74080760","GL873535","4830564","4830824","86","69249932"
"chr14","74088582","74088864","GL873530","16647228","16647517","83","57441354"
"chr14","74093747","74093936","GL873521","1458597","1458764","59","72635150"
"chr14","74169959","74170234","GL873547","2222074","2222356","84","71947885"
"chr14","74304120","74304295","GL873574","7318344","7318500","61","66985776"
"chr14","74395230","74395537","GL873541","16268070","16268366","87","58127160"
"chr14","74418681","74418989","GL873608","6630366","6630673","92","67788315"
"chr14","74491530","74491679","GL873550","5998776","5998900","54","68492754"
"chr14","74524744","74525054","GL873608","6630366","6630673","108","67894378"
"chr14","74812303","74812494","GL873524","42560728","42560902","66","32251575"
"chr14","74839860","74839992","GL873622","7076274","7076365","65","67763586"
"chr14","74914130","74914256","GL873622","7076274","7076365","54","67837856"
"chr14","75159045","75159335","GL873565","12307556","12307825","94","62851489"
"chr14","75212630","75212921","GL873530","16647228","16647517","79","58565402"
"chr14","75250425","75250685","GL873562","3299887","3300144","82","71950538"
"chr14","75265708","75265813","GL873524","43272658","43272747","44","31993050"
"chr14","75321390","75321697","GL873530","16647228","16647517","97","58674162"
"chr14","75439111","75439283","GL873530","5593486","5593649","53","69845625"
"chr14","75453210","75453507","GL873541","16268070","16268366","83","59185140"
"chr14","75463116","75463410","GL873541","16268070","16268366","95","59195046"
"chr14","75472416","75472708","GL873562","3299887","3300144","100","72172529"
"chr14","75484486","75484775","GL873565","12307556","12307825","89","63176930"
"chr14","75696241","75696252","GL873691","2903502","2903535","22","72792739"
"chr14","75696406","75696528","GL873622","7076274","7076365","49","68620132"
"chr14","75996449","75996748","GL873530","16647228","16647517","88","59349221"
"chr14","76233827","76234125","GL873541","16268070","16268366","87","59965757"
"chr14","76403064","76403192","GL873529","2453810","2453957","56","73949254"
"chr14","76834198","76834500","GL873541","16268070","16268366","85","60566128"
"chr14","77470813","77471110","GL873541","16268070","16268366","97","61202743"
"chr14","77958132","77958433","GL873541","16268070","16268366","80","61690062"
"chr14","78008203","78008494","GL873547","2222074","2222356","68","75786129"
"chr14","78282101","78282129","GL873691","2903502","2903535","19","75378599"
"chr14","78282196","78282477","GL873547","2222074","2222356","90","76060122"
"chr14","79573829","79574131","GL873541","16268070","16268366","90","63305759"
"chr14","79684474","79684770","GL873530","16647228","16647517","82","63037246"
"chr14","79956017","79956326","GL873530","16647228","16647517","93","63308789"
"chr14","80024012","80024323","GL873541","16268070","16268366","97","63755942"
"chr14","80224772","80225054","GL873528","36697151","36697434","90","43527621"
"chr14","80263093","80263399","GL873541","16268070","16268366","88","63995023"
"chr14","80301164","80301473","GL873530","16647228","16647517","92","63653936"
"chr14","80302905","80303188","GL873659","913070","913333","83","79389835"
"chr14","80328111","80328412","GL873541","16268070","16268366","88","64060041"
"chr14","80378198","80378377","GL873823","304319","304508","66","80073879"
"chr14","80378701","80378996","GL873547","2222074","2222356","85","78156627"
"chr14","80469888","80470183","GL873659","913070","913333","87","79556818"
"chr14","80514087","80514367","GL873562","3299887","3300144","84","77214200"
"chr14","80660762","80661066","GL873541","16268070","16268366","86","64392692"
"chr14","80779962","80780266","GL873528","36697151","36697434","88","44082811"
"chr14","80790879","80791173","GL873547","2222074","2222356","94","78568805"
"chr14","80915347","80915557","GL873558","7532067","7532273","51","73383280"
"chr14","81078166","81078460","GL873528","36697151","36697434","91","44381015"
"chr14","81084867","81085173","GL873541","16268070","16268366","90","64816797"
"chr14","81312045","81312302","GL873562","3299887","3300144","92","78012158"
"chr14","81458250","81458541","GL873547","2222074","2222356","82","79236176"
"chr14","81581589","81581913","GL873541","16268070","16268366","112","65313519"
"chr14","81615373","81615672","GL873541","16268070","16268366","93","65347303"
"chr14","81687671","81687971","GL873530","16647228","16647517","83","65040443"
"chr14","81949074","81949372","GL873530","16647228","16647517","87","65301846"
"chr14","82116893","82117014","GL873622","7076274","7076365","49","75040619"
"chr14","82243520","82243806","GL873547","2222074","2222356","87","80021446"
"chr14","82262560","82262696","GL873541","1550303","1550443","58","80712257"
"chr14","82292283","82292541","GL873528","25203621","25203847","91","57088662"
"chr14","82631866","82632048","GL873530","5593486","5593649","56","77038380"
"chr14","83189091","83189322","GL873557","3858721","3858924","78","79330370"
"chr14","83288480","83288767","GL873530","16647228","16647517","77","66641252"
"chr14","83290795","83291045","GL873640","6426205","6426399","97","76864590"
"chr14","83318631","83318916","GL873565","12307556","12307825","97","71011075"
"chr14","83358780","83359073","GL873530","16647228","16647517","93","66711552"
"chr14","83432914","83433211","GL873547","2222074","2222356","93","81210840"
"chr14","83559925","83560226","GL873541","16268070","16268366","93","67291855"
"chr14","83761665","83761957","GL873547","2222074","2222356","87","81539591"
"chr14","83809945","83810238","GL873547","2222074","2222356","82","81587871"
"chr14","83810431","83810721","GL873528","36697151","36697434","84","47113280"
"chr14","85235728","85236007","GL873659","913070","913333","87","84322658"
"chr14","85298085","85298375","GL873565","12307556","12307825","92","72990529"
"chr14","86092101","86092148","GL873691","1645655","1645707","27","84446446"
"chr14","86517889","86518031","GL873550","5998776","5998900","46","80519113"
"chr14","86997958","86998245","GL873607","1418062","1418355","79","85579896"
"chr14","87326339","87326631","GL873547","2222074","2222356","88","85104265"
"chr14","87430912","87431115","GL873558","7532067","7532273","55","79898845"
"chr14","87475119","87475421","GL873607","1418062","1418355","100","86057057"
"chr14","87605582","87605911","GL873667","4451263","4451534","117","83154319"
"chr14","87615841","87616137","GL873528","36697151","36697434","92","50918690"
"chr14","88780485","88780747","GL873562","3299887","3300144","89","85480598"
"chr14","88929267","88929566","GL873530","16647228","16647517","94","72282039"
"chr14","89454375","89454680","GL873541","16268070","16268366","97","73186305"
"chr14","89802144","89802429","GL873547","2222074","2222356","78","87580070"
"chr14","89868413","89868719","GL873667","4451263","4451534","92","85417150"
"chr14","89921524","89921822","GL873530","16647228","16647517","93","73274296"
"chr14","90340530","90340831","GL873608","6630366","6630673","88","83710164"
"chr14","90428877","90429168","GL873547","2222074","2222356","89","88206803"
"chr14","90765346","90765650","GL873541","16268070","16268366","89","74497276"
"chr14","91273565","91273873","GL873541","16268070","16268366","102","75005495"
"chr14","91339441","91339739","GL873547","2222074","2222356","86","89117367"
"chr14","92169283","92169582","GL873541","16268070","16268366","87","75901213"
"chr14","92269975","92270264","GL873530","16647228","16647517","86","75622747"
"chr14","92561800","92561972","GL873550","5998776","5998900","72","86563024"
"chr14","92572390","92572685","GL873541","16268070","16268366","82","76304320"
"chr14","92719851","92720140","GL873547","2222074","2222356","89","90497777"
"chr14","92797882","92798190","GL873541","16268070","16268366","92","76529812"
"chr14","93044030","93044195","GL873530","5593486","5593649","55","87450544"
"chr14","93084013","93084281","GL873535","4830564","4830824","82","88253449"
"chr14","94608531","94608825","GL873547","2222074","2222356","82","92386457"
"chr14","96227602","96227779","GL873530","5593486","5593649","56","90634116"
"chr14","96508187","96508503","GL873541","16268070","16268366","100","80240117"
"chr14","96848203","96848481","GL873659","913070","913333","89","95935133"
"chr14","96914064","96914362","GL873530","16647228","16647517","86","80266836"
"chr14","96919311","96919607","GL873530","16647228","16647517","88","80272083"
"chr14","97150643","97150831","GL873697","3111225","3111427","56","94039418"
"chr14","97429297","97429606","GL873528","36697151","36697434","92","60732146"
"chr14","97712594","97712893","GL873541","16268070","16268366","99","81444524"
"chr14","97755318","97755609","GL873530","16647228","16647517","80","81108090"
"chr14","97789449","97789748","GL873528","36697151","36697434","92","61092298"
"chr14","98072379","98072670","GL873547","2222074","2222356","82","95850305"
"chr14","98077510","98077611","GL873622","7076274","7076365","27","91001236"
"chr14","98179703","98180009","GL873530","16647228","16647517","96","81532475"
"chr14","98273730","98273907","GL873693","2625207","2625379","59","95648523"
"chr14","98354569","98354839","GL873547","2222074","2222356","87","96132495"
"chr14","98364212","98364518","GL873541","16268070","16268366","91","82096142"
"chr14","98403772","98404061","GL873528","36697151","36697434","86","61706621"
"chr14","98558760","98559065","GL873530","16647228","16647517","89","81911532"
"chr14","98830940","98831233","GL873547","2222074","2222356","73","96608866"
"chr14","99085390","99085687","GL873608","6630366","6630673","86","92455024"
"chr14","99207960","99208028","GL873554","10500008","10500061","23","88707952"
"chr14","99230692","99230988","GL873607","1418062","1418355","89","97812630"
"chr14","99777717","99777974","GL873680","3005257","3005482","95","96772460"
"chr14","100400441","100400734","GL873547","2222074","2222356","98","98178367"
"chr14","100400838","100400972","GL873550","5998776","5998900","39","94402062"
"chr14","101528814","101528970","GL873574","7318344","7318500","57","94210470"
"chr14","101528986","101529061","GL873554","10500008","10500061","35","91028978"
"chr14","102171791","102172098","GL873541","16268070","16268366","93","85903721"
"chr14","102443530","102443833","GL873541","16268070","16268366","83","86175460"
"chr14","102685720","102685915","GL873823","304319","304508","57","102381401"
"chr14","102973311","102973637","GL873541","16268070","16268366","108","86705241"
"chr14","104088241","104088539","GL873659","913070","913333","101","103175171"
"chr14","104108396","104108696","GL873530","16647228","16647517","91","87461168"
"chr14","104343196","104343498","GL873752","427788","428097","92","103915408"
"chr14","104951838","104952139","GL873541","16268070","16268366","85","88683768"
"chr14","105798744","105798876","GL873619","2497092","2497229","45","103301652"
"chr14","105903893","105904176","GL873547","2222074","2222356","88","103681819"
"chr14","106217283","106217591","GL873541","16268070","16268366","96","89949213"
"chr14","107016841","107017142","GL873530","16647228","16647517","94","90369613"
"chr15","40053","40356","GL873541","16268070","16268366","88","16228017"
"chr15","908203","908506","GL873608","6630366","6630673","88","5722163"
"chr15","1257636","1257942","GL873541","16268070","16268366","94","15010434"
"chr15","1318494","1318783","GL873547","2222074","2222356","76","903580"
"chr15","1552213","1552490","GL873562","3299887","3300144","80","1747674"
"chr15","1760255","1760567","GL873541","16268070","16268366","92","14507815"
"chr15","2000778","2001083","GL873541","16268070","16268366","86","14267292"
"chr15","2098052","2098310","GL873680","3005257","3005482","90","907205"
"chr15","2142156","2142465","GL873541","16268070","16268366","93","14125914"
"chr15","2240033","2240341","GL873541","16268070","16268366","87","14028037"
"chr15","2279579","2279874","GL873541","16268070","16268366","78","13988491"
"chr15","2796797","2797075","GL873528","36697151","36697434","87","33900354"
"chr15","2922493","2922776","GL873547","2222074","2222356","85","700419"
"chr15","3139700","3139989","GL873547","2222074","2222356","83","917626"
"chr15","3270501","3270790","GL873530","16647228","16647517","87","13376727"
"chr15","3469141","3469444","GL873541","16268070","16268366","88","12798929"
"chr15","3568818","3569090","GL873562","3299887","3300144","91","268931"
"chr15","3596083","3596386","GL873541","16268070","16268366","89","12671987"
"chr15","3660577","3660865","GL873547","2222074","2222356","90","1438503"
"chr15","3695173","3695473","GL873547","2222074","2222356","90","1473099"
"chr15","3731837","3732139","GL873541","16268070","16268366","91","12536233"
"chr15","3847452","3847756","GL873528","36697151","36697434","93","32849699"
"chr15","3966185","3966484","GL873541","16268070","16268366","83","12301885"
"chr15","4018587","4018866","GL873562","3299887","3300144","87","718700"
"chr15","4394936","4395226","GL873565","12307556","12307825","104","7912620"
"chr15","4483196","4483329","GL873550","5998776","5998900","37","1515580"
"chr15","4483744","4483754","GL873691","2903502","2903535","23","1580242"
"chr15","4518124","4518415","GL873530","16647228","16647517","76","12129104"
"chr15","4769595","4769876","GL873562","3299887","3300144","90","1469708"
"chr15","4769909","4769933","GL873691","2903502","2903535","19","1866407"
"chr15","4986082","4986355","GL873562","3299887","3300144","83","1686195"
"chr15","5007900","5008197","GL873607","1418062","1418355","83","3589838"
"chr15","5313243","5313539","GL873607","1418062","1418355","86","3895181"
"chr15","5313540","5313671","GL873550","5998776","5998900","29","685236"
"chr15","5366624","5366919","GL873541","16268070","16268366","87","10901446"
"chr15","5373147","5373447","GL873547","2222074","2222356","92","3151073"
"chr15","5487201","5487494","GL873659","913070","913333","84","4574131"
"chr15","5551421","5551715","GL873530","16647228","16647517","84","11095807"
"chr15","5724314","5724611","GL873528","36697151","36697434","98","30972837"
"chr15","5798467","5798739","GL873562","3299887","3300144","87","2498580"
"chr15","5906786","5906843","GL873527","37742071","37742124","26","31835285"
"chr15","5942101","5942407","GL873541","16268070","16268366","89","10325969"
"chr15","5955672","5955970","GL873530","16647228","16647517","88","10691556"
"chr15","6287177","6287478","GL873541","16268070","16268366","83","9980893"
"chr15","6449816","6450113","GL873541","16268070","16268366","77","9818254"
"chr15","6670278","6670575","GL873607","1418062","1418355","84","5252216"
"chr15","7039749","7040053","GL873528","36697151","36697434","99","29657402"
"chr15","7151986","7152279","GL873530","16647228","16647517","87","9495242"
"chr15","7590327","7590628","GL873541","16268070","16268366","87","8677743"
"chr15","7720397","7720527","GL873552","12711845","12711956","59","4991448"
"chr15","8140237","8140426","GL873630","2508568","2508753","62","5631669"
"chr15","8304039","8304331","GL873547","2222074","2222356","87","6081965"
"chr15","8445450","8445765","GL873541","16268070","16268366","96","7822620"
"chr15","8473619","8473907","GL873547","2222074","2222356","81","6251545"
"chr15","8479049","8479332","GL873530","16647228","16647517","90","8168179"
"chr15","8522564","8522866","GL873541","16268070","16268366","88","7745506"
"chr15","8527023","8527310","GL873607","1418062","1418355","93","7108961"
"chr15","8959006","8959303","GL873659","913070","913333","88","8045936"
"chr15","9081357","9081671","GL873530","16647228","16647517","104","7565871"
"chr15","9771214","9771427","GL873640","6426205","6426399","70","3345009"
"chr15","9772866","9773157","GL873547","2222074","2222356","76","7550792"
"chr15","9857831","9858135","GL873541","16268070","16268366","88","6410239"
"chr15","10307470","10307765","GL873541","16268070","16268366","82","5960600"
"chr15","10987896","10988189","GL873530","16647228","16647517","92","5659332"
"chr15","11267141","11267450","GL873541","16268070","16268366","105","5000929"
"chr15","11794614","11794821","GL873531","3555300","3555500","71","8239314"
"chr15","12113452","12113468","GL873691","2903502","2903535","20","9209950"
"chr15","12113505","12113802","GL873530","16647228","16647517","92","4533723"
"chr15","12206575","12206879","GL873530","16647228","16647517","90","4440653"
"chr15","12291111","12291389","GL873667","4451263","4451534","78","7839848"
"chr15","12475433","12475740","GL873541","16268070","16268366","85","3792637"
"chr15","12521859","12522155","GL873541","16268070","16268366","84","3746211"
"chr15","12991370","12991418","GL873731","2008517","2008552","23","10982853"
"chr15","12991733","12991913","GL873524","42560728","42560902","53","29568995"
"chr15","13253141","13253436","GL873541","16268070","16268366","88","3014929"
"chr15","14653383","14653681","GL873530","16647228","16647517","97","1993845"
"chr15","15436077","15436386","GL873541","16268070","16268366","93","831993"
"chr15","15999747","16000000","GL873680","3005257","3005482","73","12994490"
"chr15","16663616","16663838","GL873531","3555300","3555500","71","13108316"
"chr15","16835291","16835596","GL873608","6630366","6630673","92","10204925"
"chr15","16914648","16914947","GL873541","16268070","16268366","91","646578"
"chr15","17007116","17007468","GL873530","16647228","16647517","129","359888"
"chr15","17453693","17453997","GL873541","16268070","16268366","91","1185623"
"chr15","17458573","17458862","GL873547","2222074","2222356","93","15236499"
"chr15","17608381","17608699","GL873541","16268070","16268366","95","1340311"
"chr15","17765495","17765795","GL873752","427788","428097","93","17337707"
"chr15","17911634","17911924","GL873752","427788","428097","87","17483846"
"chr15","18904139","18904441","GL873541","16268070","16268366","86","2636069"
"chr15","19017955","19018264","GL873541","16268070","16268366","99","2749885"
"chr15","19038821","19039131","GL873541","16268070","16268366","89","2770751"
"chr15","19573923","19574219","GL873541","16268070","16268366","89","3305853"
"chr15","19716277","19716418","GL873619","2497092","2497229","41","17219185"
"chr15","20179755","20180025","GL873562","3299887","3300144","85","16879868"
"chr15","20365929","20366206","GL873562","3299887","3300144","85","17066042"
"chr15","20966299","20966574","GL873562","3299887","3300144","82","17666412"
"chr15","21276418","21276632","GL873530","5593486","5593649","83","15682932"
"chr15","21505985","21506275","GL873547","2222074","2222356","78","19283911"
"chr15","21882638","21882933","GL873530","16647228","16647517","87","5235410"
"chr15","23272278","23272546","GL873547","2222074","2222356","94","21050204"
"chr15","23885371","23885477","GL873524","43272658","43272747","48","19387287"
"chr15","23914623","23914933","GL873541","16268070","16268366","118","7646553"
"chr15","23974751","23975045","GL873530","16647228","16647517","80","7327523"
"chr15","24116937","24117238","GL873541","16268070","16268366","101","7848867"
"chr15","24218412","24218721","GL873541","16268070","16268366","92","7950342"
"chr15","24304928","24305091","GL873565","1666380","1666535","59","22638548"
"chr15","24414600","24414884","GL873528","36697151","36697434","103","12282551"
"chr15","25991687","25991988","GL873541","16268070","16268366","95","9723617"
"chr15","28559006","28559310","GL873541","16268070","16268366","94","12290936"
"chr15","29638218","29638512","GL873530","16647228","16647517","86","12990990"
"chr15","29777234","29777519","GL873547","2222074","2222356","82","27555160"
"chr15","30506606","30506900","GL873541","16268070","16268366","89","14238536"
"chr15","30784259","30784475","GL873680","3005257","3005482","71","27779002"
"chr15","30821384","30821677","GL873541","16268070","16268366","88","14553314"
"chr15","30822586","30822904","GL873547","2222074","2222356","106","28600512"
"chr15","32077675","32078023","GL873607","1418062","1418355","119","30659613"
"chr15","32215989","32216272","GL873547","5449763","5449997","104","26766226"
"chr15","32264319","32264639","GL873541","16268070","16268366","106","15996249"
"chr15","33322368","33322676","GL873608","6630366","6630673","94","26692002"
"chr15","33541193","33541502","GL873541","16268070","16268366","86","17273123"
"chr15","33553797","33554106","GL873528","36697151","36697434","91","3143354"
"chr15","33656996","33657312","GL873528","36697151","36697434","100","3040155"
"chr15","33997322","33997420","GL873524","43272658","43272747","40","9275336"
"chr15","34323205","34323513","GL873541","16268070","16268366","93","18055135"
"chr15","34630138","34630432","GL873541","16268070","16268366","92","18362068"
"chr15","34751292","34751622","GL873541","16268070","16268366","113","18483222"
"chr15","34764921","34765226","GL873541","16268070","16268366","88","18496851"
"chr15","34844782","34845116","GL873528","36697151","36697434","126","1852369"
"chr15","34850462","34850772","GL873541","16268070","16268366","91","18582392"
"chr15","35421211","35421492","GL873530","16647228","16647517","82","18773983"
"chr15","36046808","36047115","GL873541","16268070","16268366","94","19778738"
"chr15","37052691","37052912","GL873557","3858721","3858924","69","33193970"
"chr15","37138623","37138917","GL873530","16647228","16647517","95","20491395"
"chr15","37376384","37376686","GL873528","36697151","36697434","96","679233"
"chr15","37417129","37417421","GL873607","1418062","1418355","93","35999067"
"chr15","37955060","37955342","GL873530","16647228","16647517","88","21307832"
"chr15","38653579","38653884","GL873608","6630366","6630673","89","32023213"
"chr15","38670735","38671057","GL873541","16268070","16268366","101","22402665"
"chr15","40030495","40030777","GL873547","2222074","2222356","84","37808421"
"chr15","40678252","40678443","GL873535","8592877","8593062","62","32085375"
"chr15","40678593","40678775","GL873574","7318344","7318500","62","33360249"
"chr15","41028937","41029228","GL873541","16268070","16268366","86","24760867"
"chr15","41111855","41112163","GL873541","16268070","16268366","95","24843785"
"chr15","41225508","41225807","GL873541","16268070","16268366","94","24957438"
"chr15","41493858","41494157","GL873541","16268070","16268366","81","25225788"
"chr15","41575001","41575132","GL873543","18789325","18789460","58","22785676"
"chr15","41700023","41700317","GL873530","16647228","16647517","78","25052795"
"chr15","41834967","41835273","GL873541","16268070","16268366","91","25566897"
"chr15","42718050","42718336","GL873530","16647228","16647517","88","26070822"
"chr15","43966407","43966704","GL873541","16268070","16268366","82","27698337"
"chr15","44170427","44170658","GL873538","2567037","2567262","74","41603390"
"chr15","44177747","44178039","GL873530","16647228","16647517","85","27530519"
"chr15","44316787","44317094","GL873541","16268070","16268366","89","28048717"
"chr15","44623431","44623719","GL873547","2222074","2222356","80","42401357"
"chr15","45489672","45489975","GL873530","16647228","16647517","93","28842444"
"chr15","45679367","45679671","GL873530","16647228","16647517","84","29032139"
"chr15","45735518","45735805","GL873547","2222074","2222356","87","43513444"
"chr15","45794830","45795109","GL873667","4451263","4451534","99","41343567"
"chr15","46438767","46439068","GL873547","2222074","2222356","96","44216693"
"chr15","46582440","46582761","GL873541","16268070","16268366","105","30314370"
"chr15","46761648","46761956","GL873667","4451263","4451534","103","42310385"
"chr15","47377794","47378078","GL873565","12307556","12307825","101","35070238"
"chr15","47627456","47627568","GL873550","5998776","5998900","44","41628680"
"chr15","47627624","47627769","GL873619","2497092","2497229","44","45130532"
"chr15","48150978","48151285","GL873541","16268070","16268366","89","31882908"
"chr15","48254261","48254558","GL873528","36697151","36697434","83","11557110"
"chr15","48441591","48441882","GL873530","16647228","16647517","83","31794363"
"chr15","48628824","48629115","GL873528","36697151","36697434","94","11931673"
"chr15","48644530","48644838","GL873541","16268070","16268366","96","32376460"
"chr15","48652339","48652634","GL873530","16647228","16647517","88","32005111"
"chr15","48770304","48770593","GL873530","16647228","16647517","88","32123076"
"chr15","48771415","48771692","GL873547","2222074","2222356","82","46549341"
"chr15","48990116","48990429","GL873608","6630366","6630673","94","42359750"
"chr15","49027586","49027883","GL873541","16268070","16268366","94","32759516"
"chr15","49088342","49088573","GL873557","3858721","3858924","73","45229621"
"chr15","49405690","49406015","GL873541","16268070","16268366","108","33137620"
"chr15","49450161","49450465","GL873608","6630366","6630673","91","42819795"
"chr15","50507326","50507635","GL873541","16268070","16268366","93","34239256"
"chr15","51574719","51574807","GL873622","7076274","7076365","32","44498445"
"chr15","51661987","51662056","GL873554","10500008","10500061","24","41161979"
"chr15","51701338","51701639","GL873541","16268070","16268366","89","35433268"
"chr15","51724502","51724795","GL873530","16647228","16647517","88","35077274"
"chr15","51773180","51773322","GL873619","2497092","2497229","44","49276088"
"chr15","51805125","51805413","GL873547","2222074","2222356","75","49583051"
"chr15","52279638","52279945","GL873528","36697151","36697434","99","15582487"
"chr15","52586959","52587266","GL873528","36697151","36697434","107","15889808"
"chr15","53302017","53302329","GL873530","16647228","16647517","102","36654789"
"chr15","53573071","53573347","GL873562","3299887","3300144","84","50273184"
"chr15","53627462","53627748","GL873530","16647228","16647517","93","36980234"
"chr15","53844522","53844788","GL873565","12307556","12307825","91","41536966"
"chr15","54045640","54045919","GL873547","2222074","2222356","84","51823566"
"chr15","54052209","54052508","GL873530","16647228","16647517","85","37404981"
"chr15","54366235","54366523","GL873530","16647228","16647517","93","37719007"
"chr15","55078118","55078404","GL873607","1418062","1418355","84","53660056"
"chr15","55282165","55282478","GL873608","6630366","6630673","87","48651799"
"chr15","55636537","55636844","GL873541","16268070","16268366","96","39368467"
"chr15","56674818","56675117","GL873541","16268070","16268366","83","40406748"
"chr15","56779052","56779367","GL873530","16647228","16647517","112","40131824"
"chr15","56846890","56847178","GL873547","2222074","2222356","80","54624816"
"chr15","57102906","57103198","GL873541","16268070","16268366","85","40834836"
"chr15","57161795","57162102","GL873541","16268070","16268366","90","40893725"
"chr15","57645136","57645424","GL873667","4451263","4451534","87","53193873"
"chr15","57647767","57648050","GL873565","12307556","12307825","105","45340211"
"chr15","57702183","57702468","GL873547","2222074","2222356","81","55480109"
"chr15","57792292","57792548","GL873528","25203621","25203847","88","32588671"
"chr15","57964606","57964915","GL873528","36697151","36697434","96","21267455"
"chr15","57995053","57995355","GL873541","16268070","16268366","86","41726983"
"chr15","58110280","58110572","GL873607","1418062","1418355","96","56692218"
"chr15","58145892","58146179","GL873547","2222074","2222356","75","55923818"
"chr15","58809309","58809600","GL873547","2222074","2222356","93","56587235"
"chr15","59023101","59023405","GL873528","36697151","36697434","101","22325950"
"chr15","60115201","60115501","GL873607","1418062","1418355","91","58697139"
"chr15","60195960","60196263","GL873541","16268070","16268366","86","43927890"
"chr15","60251049","60251322","GL873562","3299887","3300144","85","56951162"
"chr15","60397717","60398018","GL873541","16268070","16268366","85","44129647"
"chr15","60476666","60476967","GL873530","16647228","16647517","84","43829438"
"chr15","61071885","61072201","GL873541","16268070","16268366","98","44803815"
"chr15","62362878","62363187","GL873528","36697151","36697434","94","25665727"
"chr15","62977156","62977449","GL873541","16268070","16268366","83","46709086"
"chr15","63096897","63097174","GL873659","913070","913333","89","62183827"
"chr15","63327528","63327822","GL873547","2222074","2222356","95","61105454"
"chr15","63543612","63543920","GL873541","16268070","16268366","88","47275542"
"chr15","64695801","64696094","GL873607","1418062","1418355","100","63277739"
"chr15","64823687","64823986","GL873541","16268070","16268366","88","48555617"
"chr15","65012411","65012687","GL873562","3299887","3300144","87","61712524"
"chr15","65112687","65112989","GL873547","2222074","2222356","100","62890613"
"chr15","66003036","66003326","GL873547","2222074","2222356","85","63780962"
"chr15","66150457","66150762","GL873528","36697151","36697434","94","29453306"
"chr15","66276586","66276849","GL873562","3299887","3300144","83","62976699"
"chr15","66867086","66867350","GL873680","3005257","3005482","93","63861829"
"chr15","67612582","67612782","GL873535","24407607","24407780","55","43204975"
"chr15","68073590","68073751","GL873530","5593486","5593649","52","62480104"
"chr15","68143767","68144071","GL873541","16268070","16268366","81","51875697"
"chr15","68464575","68464881","GL873541","16268070","16268366","86","52196505"
"chr15","68537186","68537411","GL873538","2567037","2567262","69","65970149"
"chr15","68547669","68547979","GL873607","1418062","1418355","97","67129607"
"chr15","68558940","68559232","GL873530","16647228","16647517","87","51911712"
"chr15","68993102","68993395","GL873530","16647228","16647517","80","52345874"
"chr15","69910051","69910333","GL873547","2222074","2222356","88","67687977"
"chr15","70016506","70016815","GL873528","36697151","36697434","95","33319355"
"chr15","70072401","70072685","GL873547","2222074","2222356","82","67850327"
"chr15","70108512","70108830","GL873752","427788","428097","104","69680724"
"chr15","70591024","70591316","GL873530","16647228","16647517","89","53943796"
"chr15","71031737","71031970","GL873543","13038674","13038909","92","57993063"
"chr15","71906977","71907286","GL873541","16268070","16268366","90","55638907"
"chr15","72133927","72134220","GL873530","16647228","16647517","93","55486699"
"chr15","72153583","72153858","GL873547","2222074","2222356","86","69931509"
"chr15","72161983","72162197","GL873528","25203621","25203847","82","46958362"
"chr15","73589456","73589712","GL873680","3005257","3005482","92","70584199"
"chr15","73612766","73613063","GL873541","16268070","16268366","74","57344696"
"chr15","73634035","73634315","GL873547","2222074","2222356","89","71411961"
"chr15","74678009","74678326","GL873547","2222074","2222356","103","72455935"
"chr15","74758225","74758550","GL873541","16268070","16268366","107","58490155"
"chr15","74808241","74808535","GL873541","16268070","16268366","91","58540171"
"chr15","76091978","76092101","GL873619","2497092","2497229","40","73594886"
"chr15","76326616","76326912","GL873541","16268070","16268366","81","60058546"
"chr15","76348013","76348300","GL873530","16647228","16647517","94","59700785"
"chr15","76465178","76465474","GL873541","16268070","16268366","83","60197108"
"chr15","77042320","77042620","GL873541","16268070","16268366","92","60774250"
"chr15","77133154","77133462","GL873608","6630366","6630673","84","70502788"
"chr15","77242301","77242589","GL873607","1418062","1418355","91","75824239"
"chr15","77279006","77279299","GL873608","6630366","6630673","91","70648640"
"chr15","77346433","77346603","GL873530","5593486","5593649","55","71752947"
"chr15","77346906","77347043","GL873550","5998776","5998900","37","71348130"
"chr15","77401757","77402052","GL873528","36697151","36697434","95","40704606"
"chr15","77409314","77409608","GL873541","16268070","16268366","93","61141244"
"chr15","77410945","77411121","GL873530","5593486","5593649","48","71817459"
"chr15","77411123","77411337","GL873697","3111225","3111427","92","74299898"
"chr15","77411647","77411778","GL873550","5998776","5998900","32","71412871"
"chr15","77626315","77626616","GL873541","16268070","16268366","95","61358245"
"chr15","77683127","77683423","GL873541","16268070","16268366","84","61415057"
"chr15","78928706","78928925","GL873680","3005257","3005482","75","75923449"
"chr15","79799682","79799698","GL873691","2903502","2903535","20","76896180"
"chr15","79799727","79800006","GL873547","2222074","2222356","88","77577653"
"chr15","81041969","81042262","GL873541","16268070","16268366","82","64773899"
"chr15","81086568","81086876","GL873541","16268070","16268366","90","64818498"
"chr15","81146851","81147131","GL873547","2222074","2222356","83","78924777"
"chr15","81171502","81171802","GL873530","16647228","16647517","80","64524274"
"chr15","81539546","81539843","GL873541","16268070","16268366","80","65271476"
"chr15","82222346","82222645","GL873541","16268070","16268366","87","65954276"
"chr15","82607878","82608186","GL873541","16268070","16268366","94","66339808"
"chr15","82784488","82784714","GL873531","3555300","3555500","72","79229188"
"chr15","82843158","82843468","GL873541","16268070","16268366","93","66575088"
"chr15","82976131","82976454","GL873541","16268070","16268366","105","66708061"
"chr15","83162468","83162774","GL873541","16268070","16268366","100","66894398"
"chr15","83706180","83706488","GL873541","16268070","16268366","93","67438110"
"chr15","83808779","83809064","GL873547","2222074","2222356","90","81586705"
"chr15","84104970","84105270","GL873541","16268070","16268366","89","67836900"
"chr15","84207502","84207792","GL873530","16647228","16647517","85","67560274"
"chr15","84356385","84356687","GL873541","16268070","16268366","86","68088315"
"chr15","84372439","84372561","GL873552","12711845","12711956","46","71660594"
"chr15","84829093","84829304","GL873531","3555300","3555500","66","81273793"
"chr15","85188345","85188639","GL873608","6630366","6630673","86","78557979"
"chr15","85426269","85426571","GL873541","16268070","16268366","91","69158199"
"chr15","85697679","85697897","GL873557","3858721","3858924","73","81838958"
"chr15","87135813","87136103","GL873659","913070","913333","88","86222743"
"chr15","87252531","87252833","GL873541","16268070","16268366","95","70984461"
"chr15","87677532","87677777","GL873543","13038674","13038909","86","74638858"
"chr15","87765710","87766005","GL873530","16647228","16647517","88","71118482"
"chr15","87991806","87992108","GL873530","16647228","16647517","92","71344578"
"chr15","88634731","88635027","GL873541","16268070","16268366","79","72366661"
"chr15","89123366","89123669","GL873541","16268070","16268366","92","72855296"
"chr15","89845984","89846294","GL873541","16268070","16268366","98","73577914"
"chr15","89859220","89859519","GL873541","16268070","16268366","82","73591150"
"chr15","89899350","89899641","GL873547","2222074","2222356","83","87677276"
"chr15","90041093","90041396","GL873541","16268070","16268366","86","73773023"
"chr15","90173087","90173400","GL873530","16647228","16647517","97","73525859"
"chr15","90289278","90289569","GL873530","16647228","16647517","86","73642050"
"chr15","90337579","90337879","GL873541","16268070","16268366","94","74069509"
"chr15","90468926","90469226","GL873530","16647228","16647517","86","73821698"
"chr15","90472246","90472553","GL873667","4451263","4451534","116","86020983"
"chr15","90522564","90522693","GL873550","5998776","5998900","40","84523788"
"chr15","90715776","90716082","GL873608","6630366","6630673","93","84085410"
"chr15","90902132","90902432","GL873541","16268070","16268366","93","74634062"
"chr15","91048798","91049105","GL873541","16268070","16268366","96","74780728"
"chr15","91073579","91073873","GL873667","4451263","4451534","94","86622316"
"chr15","91094478","91094763","GL873547","2222074","2222356","80","88872404"
"chr15","91109858","91110156","GL873541","16268070","16268366","87","74841788"
"chr15","91234224","91234530","GL873541","16268070","16268366","81","74966154"
"chr15","91346953","91347252","GL873530","16647228","16647517","89","74699725"
"chr15","91719458","91719759","GL873541","16268070","16268366","79","75451388"
"chr16","52166373","52166679","GL873607","1418062","1418355","94","50748311"
"chr16","31785","32089","GL873541","16268070","16268366","94","16236285"
"chr16","244220","244532","GL873528","36697151","36697434","100","36452931"
"chr16","350699","351009","GL873541","16268070","16268366","95","15917371"
"chr16","433294","433583","GL873547","2222074","2222356","81","1788780"
"chr16","1150044","1150347","GL873541","16268070","16268366","92","15118026"
"chr16","1335263","1335392","GL873550","5998776","5998900","40","4663513"
"chr16","1335474","1335752","GL873562","3299887","3300144","93","1964413"
"chr16","1495798","1496086","GL873547","2222074","2222356","83","726276"
"chr16","1555372","1555680","GL873541","16268070","16268366","94","14712698"
"chr16","1685909","1686081","GL873530","5593486","5593649","56","3907577"
"chr16","1896601","1896909","GL873541","16268070","16268366","97","14371469"
"chr16","1953413","1953705","GL873530","16647228","16647517","82","14693815"
"chr16","2087413","2087544","GL873550","5998776","5998900","35","3911363"
"chr16","2140618","2140908","GL873547","2222074","2222356","85","81456"
"chr16","2150928","2151195","GL873680","3005257","3005482","94","854329"
"chr16","2208392","2208703","GL873541","16268070","16268366","93","14059678"
"chr16","2277361","2277596","GL873680","3005257","3005482","69","727896"
"chr16","2309757","2310062","GL873608","6630366","6630673","93","4320609"
"chr16","2310611","2310895","GL873547","2222074","2222356","91","88537"
"chr16","2690640","2690888","GL873528","25203621","25203847","80","22512981"
"chr16","3107721","3108018","GL873530","16647228","16647517","89","13539507"
"chr16","3117549","3117845","GL873541","16268070","16268366","94","13150521"
"chr16","3147244","3147293","GL873527","37742071","37742124","22","34594827"
"chr16","3147514","3147524","GL873691","2903502","2903535","25","244012"
"chr16","3270493","3270621","GL873552","12711845","12711956","52","9441352"
"chr16","3279077","3279364","GL873547","2222074","2222356","83","1057003"
"chr16","3325467","3325655","GL873524","23693028","23693185","68","20367561"
"chr16","3338106","3338404","GL873541","16268070","16268366","88","12929964"
"chr16","3567017","3567315","GL873541","16268070","16268366","83","12701053"
"chr16","3721633","3721925","GL873530","16647228","16647517","88","12925595"
"chr16","3827613","3827918","GL873541","16268070","16268366","89","12440457"
"chr16","3847958","3848262","GL873541","16268070","16268366","91","12420112"
"chr16","3904060","3904367","GL873541","16268070","16268366","94","12364010"
"chr16","4145016","4145316","GL873541","16268070","16268366","87","12123054"
"chr16","4264009","4264141","GL873550","5998776","5998900","48","1734767"
"chr16","4436610","4436903","GL873530","16647228","16647517","85","12210618"
"chr16","4465586","4465883","GL873541","16268070","16268366","84","11802484"
"chr16","4472870","4473177","GL873541","16268070","16268366","91","11795200"
"chr16","4539586","4539887","GL873530","16647228","16647517","87","12107642"
"chr16","4541268","4541389","GL873524","43272770","43272878","43","38731502"
"chr16","4542687","4542983","GL873541","16268070","16268366","87","11725383"
"chr16","4674363","4674655","GL873530","16647228","16647517","82","11972865"
"chr16","4785053","4785358","GL873541","16268070","16268366","85","11483017"
"chr16","4810879","4811189","GL873541","16268070","16268366","91","11457191"
"chr16","4933721","4934017","GL873667","4451263","4451534","88","482458"
"chr16","5164517","5164812","GL873541","16268070","16268366","86","11103553"
"chr16","5677944","5678237","GL873530","16647228","16647517","83","10969284"
"chr16","6045979","6046283","GL873541","16268070","16268366","98","10222091"
"chr16","6093139","6093421","GL873547","2222074","2222356","85","3871065"
"chr16","6110815","6110932","GL873550","5998776","5998900","42","112039"
"chr16","6272773","6273062","GL873547","2222074","2222356","79","4050699"
"chr16","6422819","6423112","GL873530","16647228","16647517","85","10224409"
"chr16","6454783","6454917","GL873550","5998776","5998900","35","456007"
"chr16","6528379","6528669","GL873530","16647228","16647517","78","10118849"
"chr16","6621471","6621790","GL873752","427788","428097","99","6193683"
"chr16","6757028","6757326","GL873607","1418062","1418355","89","5338966"
"chr16","6833105","6833407","GL873541","16268070","16268366","85","9434965"
"chr16","6877040","6877189","GL873541","1550303","1550443","59","5326737"
"chr16","7000749","7001052","GL873659","913070","913333","104","6087679"
"chr16","7138296","7138449","GL873611","3799989","3800137","58","3338307"
"chr16","7201552","7201854","GL873541","16268070","16268366","91","9066518"
"chr16","7724560","7724862","GL873659","913070","913333","96","6811490"
"chr16","7746162","7746454","GL873541","16268070","16268366","82","8521908"
"chr16","7888226","7888516","GL873547","2222074","2222356","79","5666152"
"chr16","7898915","7899191","GL873565","12307556","12307825","100","4408641"
"chr16","8056026","8056187","GL873530","5593486","5593649","52","2462540"
"chr16","8254554","8254859","GL873541","16268070","16268366","84","8013516"
"chr16","8399786","8400081","GL873541","16268070","16268366","84","7868284"
"chr16","8468476","8468785","GL873530","16647228","16647517","92","8178752"
"chr16","8570504","8570794","GL873547","2222074","2222356","84","6348430"
"chr16","8694664","8694973","GL873607","1418062","1418355","92","7276602"
"chr16","8702252","8702541","GL873530","16647228","16647517","73","7944976"
"chr16","9005892","9006101","GL873531","3555300","3555500","62","5450592"
"chr16","9200820","9201117","GL873541","16268070","16268366","87","7067250"
"chr16","9205907","9206206","GL873530","16647228","16647517","88","7441321"
"chr16","9262398","9262654","GL873680","3005257","3005482","81","6257141"
"chr16","9390383","9390692","GL873541","16268070","16268366","88","6877687"
"chr16","9687728","9688011","GL873528","36697151","36697434","85","27009423"
"chr16","9750967","9751256","GL873530","16647228","16647517","85","6896261"
"chr16","9901761","9902051","GL873547","2222074","2222356","82","7679687"
"chr16","9959467","9959756","GL873530","16647228","16647517","86","6687761"
"chr16","10073695","10074011","GL873528","36697151","36697434","96","26623456"
"chr16","10457488","10457797","GL873528","36697151","36697434","97","26239663"
"chr16","10478315","10478615","GL873607","1418062","1418355","86","9060253"
"chr16","10702414","10702717","GL873528","36697151","36697434","89","25994737"
"chr16","10760463","10760759","GL873528","36697151","36697434","94","25936688"
"chr16","10795330","10795551","GL873557","3858721","3858924","79","6936609"
"chr16","10796606","10796904","GL873541","16268070","16268366","89","5471464"
"chr16","11015749","11016046","GL873541","16268070","16268366","80","5252321"
"chr16","11136625","11136915","GL873547","2222074","2222356","81","8914551"
"chr16","11136916","11137214","GL873530","16647228","16647517","89","5510312"
"chr16","11292856","11292989","GL873550","5998776","5998900","37","5294080"
"chr16","11442527","11442813","GL873541","16268070","16268366","88","4825543"
"chr16","11818932","11819233","GL873541","16268070","16268366","86","4449138"
"chr16","11994566","11994827","GL873667","4451263","4451534","86","7543303"
"chr16","12085942","12086229","GL873547","2222074","2222356","71","9863868"
"chr16","12087409","12087726","GL873607","1418062","1418355","99","10669347"
"chr16","12172717","12173013","GL873541","16268070","16268366","89","4095353"
"chr16","12221363","12221670","GL873541","16268070","16268366","88","4046707"
"chr16","12615652","12615942","GL873528","36697151","36697434","97","24081499"
"chr16","12955116","12955426","GL873541","16268070","16268366","93","3312954"
"chr16","13075121","13075385","GL873538","2567037","2567262","90","10508084"
"chr16","13151712","13151997","GL873530","16647228","16647517","92","3495516"
"chr16","14254928","14255222","GL873547","2222074","2222356","82","12032854"
"chr16","14257861","14258165","GL873530","16647228","16647517","94","2389367"
"chr16","14392359","14392667","GL873541","16268070","16268366","92","1875711"
"chr16","14422338","14422632","GL873541","16268070","16268366","80","1845732"
"chr16","14482255","14482552","GL873541","16268070","16268366","75","1785815"
"chr16","14506098","14506387","GL873547","2222074","2222356","84","12284024"
"chr16","14658708","14659007","GL873608","6630366","6630673","92","8028342"
"chr16","15068747","15069047","GL873541","16268070","16268366","90","1199323"
"chr16","15121498","15121716","GL873531","3555300","3555500","62","11566198"
"chr16","15126975","15127250","GL873562","3299887","3300144","91","11827088"
"chr16","15211905","15212180","GL873562","3299887","3300144","95","11912018"
"chr16","15344440","15344737","GL873530","16647228","16647517","88","1302788"
"chr16","15362610","15362905","GL873752","427788","428097","82","14934822"
"chr16","15391228","15391532","GL873541","16268070","16268366","83","876842"
"chr16","15401896","15402200","GL873541","16268070","16268366","87","866174"
"chr16","15441072","15441353","GL873547","2222074","2222356","87","13218998"
"chr16","15639288","15639594","GL873608","6630366","6630673","89","9008922"
"chr16","15663776","15664068","GL873530","16647228","16647517","87","983452"
"chr16","15668985","15669113","GL873550","5998776","5998900","33","9670209"
"chr16","15682328","15682620","GL873547","2222074","2222356","78","13460254"
"chr16","15722041","15722341","GL873547","2222074","2222356","89","13499967"
"chr16","15927094","15927394","GL873667","4451263","4451534","96","11475831"
"chr16","16014522","16014813","GL873530","16647228","16647517","82","632706"
"chr16","16057029","16057320","GL873547","2222074","2222356","84","13834955"
"chr16","16254155","16254418","GL873565","12307556","12307825","91","3946599"
"chr16","16375000","16375014","GL873691","2903502","2903535","22","13471498"
"chr16","16375198","16375371","GL873524","42560728","42560902","54","26185530"
"chr16","16583135","16583399","GL873547","2222074","2222356","95","14361061"
"chr16","16614617","16614889","GL873528","36697151","36697434","91","20082534"
"chr16","16617157","16617448","GL873667","4451263","4451534","88","12165894"
"chr16","16675412","16675694","GL873562","3299887","3300144","87","13375525"
"chr16","17077687","17077987","GL873528","36697151","36697434","100","19619464"
"chr16","17102812","17103083","GL873547","2222074","2222356","88","14880738"
"chr16","17103242","17103520","GL873562","3299887","3300144","85","13803355"
"chr16","17377903","17378147","GL873680","3005257","3005482","86","14372646"
"chr16","17380313","17380622","GL873530","16647228","16647517","92","733085"
"chr16","17404502","17404811","GL873541","16268070","16268366","95","1136432"
"chr16","17637152","17637343","GL873530","5593486","5593649","66","12043666"
"chr16","17750373","17750650","GL873547","2222074","2222356","86","15528299"
"chr16","17780314","17780616","GL873541","16268070","16268366","89","1512244"
"chr16","17793476","17793782","GL873547","2222074","2222356","92","15571402"
"chr16","17814656","17814958","GL873541","16268070","16268366","85","1546586"
"chr16","18257374","18257671","GL873547","2222074","2222356","80","16035300"
"chr16","18299936","18300237","GL873530","16647228","16647517","83","1652708"
"chr16","18362408","18362690","GL873547","2222074","2222356","87","16140334"
"chr16","18416934","18417219","GL873547","2222074","2222356","83","16194860"
"chr16","18758199","18758505","GL873530","16647228","16647517","87","2110971"
"chr16","18780434","18780718","GL873667","4451263","4451534","88","14329171"
"chr16","18785684","18785956","GL873565","12307556","12307825","98","6478128"
"chr16","18976168","18976451","GL873547","2222074","2222356","84","16754094"
"chr16","19052562","19052856","GL873607","1418062","1418355","85","17634500"
"chr16","19057921","19058214","GL873541","16268070","16268366","93","2789851"
"chr16","19278140","19278448","GL873541","16268070","16268366","85","3010070"
"chr16","19439016","19439294","GL873562","3299887","3300144","83","16139129"
"chr16","19467431","19467735","GL873541","16268070","16268366","95","3199361"
"chr16","19600593","19600900","GL873530","16647228","16647517","94","2953365"
"chr16","20867297","20867590","GL873530","16647228","16647517","83","4220069"
"chr16","21200870","21201148","GL873667","4451263","4451534","89","16749607"
"chr16","21461047","21461354","GL873541","16268070","16268366","90","5192977"
"chr16","21684603","21684890","GL873547","2222074","2222356","74","19462529"
"chr16","21698158","21698439","GL873528","36697151","36697434","86","14998993"
"chr16","21749240","21749535","GL873752","427788","428097","82","21321452"
"chr16","21967690","21967939","GL873680","3005257","3005482","88","18962433"
"chr16","21985689","21985986","GL873547","2222074","2222356","89","19763615"
"chr16","22214035","22214341","GL873608","6630366","6630673","94","15583669"
"chr16","22374579","22374878","GL873541","16268070","16268366","94","6106509"
"chr16","22417116","22417412","GL873541","16268070","16268366","83","6149046"
"chr16","22529204","22529353","GL873619","2497092","2497229","48","20032112"
"chr16","22539303","22539597","GL873752","427788","428097","86","22111515"
"chr16","22616350","22616639","GL873547","2222074","2222356","85","20394276"
"chr16","22804007","22804299","GL873530","16647228","16647517","77","6156779"
"chr16","23004870","23004934","GL873554","10500008","10500061","18","12504862"
"chr16","23141556","23141852","GL873607","1418062","1418355","87","21723494"
"chr16","23385413","23385720","GL873607","1418062","1418355","92","21967351"
"chr16","23475423","23475738","GL873541","16268070","16268366","87","7207353"
"chr16","23717759","23717888","GL873587","10002051","10002151","57","13715708"
"chr16","23848795","23849104","GL873607","1418062","1418355","100","22430733"
"chr16","24079082","24079377","GL873541","16268070","16268366","89","7811012"
"chr16","24216559","24216859","GL873530","16647228","16647517","87","7569331"
"chr16","24347850","24348164","GL873541","16268070","16268366","95","8079780"
"chr16","24506595","24506894","GL873541","16268070","16268366","84","8238525"
"chr16","24526100","24526404","GL873528","36697151","36697434","87","12171051"
"chr16","24549619","24549911","GL873530","16647228","16647517","77","7902391"
"chr16","24559855","24559969","GL873550","5998776","5998900","35","18561079"
"chr16","24824595","24824890","GL873659","913070","913333","80","23911525"
"chr16","24945851","24946150","GL873530","16647228","16647517","88","8298623"
"chr16","25075783","25076105","GL873608","6630366","6630673","97","18445417"
"chr16","25315669","25315952","GL873562","3299887","3300144","96","22015782"
"chr16","25410314","25410674","GL873559","3737111","3737481","129","21673203"
"chr16","25440546","25440854","GL873530","16647228","16647517","95","8793318"
"chr16","25459533","25459822","GL873541","16268070","16268366","88","9191463"
"chr16","25550034","25550345","GL873541","16268070","16268366","92","9281964"
"chr16","25600382","25600670","GL873547","2222074","2222356","82","23378308"
"chr16","25614452","25614762","GL873541","16268070","16268366","98","9346382"
"chr16","25665933","25666233","GL873541","16268070","16268366","103","9397863"
"chr16","25695234","25695520","GL873547","2222074","2222356","74","23473160"
"chr16","25703656","25703966","GL873530","16647228","16647517","97","9056428"
"chr16","25895398","25895683","GL873547","2222074","2222356","86","23673324"
"chr16","26056824","26057176","GL873812","559768","560073","123","25497056"
"chr16","27667099","27667396","GL873541","16268070","16268366","80","11399029"
"chr16","28626732","28627032","GL873541","16268070","16268366","92","12358662"
"chr16","28726482","28726765","GL873547","2222074","2222356","87","26504408"
"chr16","28761420","28761716","GL873547","2222074","2222356","90","26539346"
"chr16","28761846","28762135","GL873547","2222074","2222356","78","26539772"
"chr16","28914261","28914548","GL873543","13038674","13038909","104","15875587"
"chr16","29045650","29045919","GL873562","3299887","3300144","85","25745763"
"chr16","29392625","29392932","GL873541","16268070","16268366","90","13124555"
"chr16","29527079","29527375","GL873752","427788","428097","83","29099291"
"chr16","30023487","30023769","GL873547","2222074","2222356","87","27801413"
"chr16","30094361","30094670","GL873607","1418062","1418355","93","28676299"
"chr16","30106369","30106489","GL873619","2497092","2497229","49","27609277"
"chr16","30150900","30151195","GL873541","16268070","16268366","84","13882830"
"chr16","30202270","30202522","GL873562","3299887","3300144","92","26902383"
"chr16","30260040","30260349","GL873541","16268070","16268366","91","13991970"
"chr16","30305618","30305917","GL873541","16268070","16268366","88","14037548"
"chr16","30445850","30446151","GL873541","16268070","16268366","80","14177780"
"chr16","30585645","30585939","GL873541","16268070","16268366","80","14317575"
"chr16","30811880","30812185","GL873541","16268070","16268366","90","14543810"
"chr16","30829219","30829535","GL873608","6630366","6630673","99","24198853"
"chr16","31232315","31232594","GL873547","2222074","2222356","76","29010241"
"chr16","31486050","31486333","GL873547","2222074","2222356","84","29263976"
"chr16","31890096","31890230","GL873619","2497092","2497229","46","29393004"
"chr16","31891072","31891352","GL873547","2222074","2222356","84","29668998"
"chr16","31903475","31903787","GL873528","36697151","36697434","94","4793676"
"chr16","31907535","31907666","GL873550","5998776","5998900","39","25908759"
"chr16","31920974","31921148","GL873530","5593486","5593649","57","26327488"
"chr16","31921449","31921491","GL873731","2008517","2008552","21","29912932"
"chr16","31931500","31931801","GL873752","427788","428097","90","31503712"
"chr16","32015719","32015961","GL873547","5449763","5449997","85","26565956"
"chr16","32482378","32482667","GL873547","2222074","2222356","90","30260304"
"chr16","33108917","33109041","GL873622","7076274","7076365","55","26032643"
"chr16","33133637","33133720","GL873524","43272658","43272747","27","10139021"
"chr16","33134026","33134254","GL873680","3005257","3005482","65","30128769"
"chr16","33139486","33139791","GL873541","16268070","16268366","82","16871416"
"chr16","33145406","33145712","GL873528","36697151","36697434","94","3551745"
"chr16","33151210","33151491","GL873547","2222074","2222356","90","30929136"
"chr16","33154260","33154404","GL873628","6402015","6402153","55","26752245"
"chr16","33256478","33256777","GL873530","16647228","16647517","92","16609250"
"chr16","33417645","33417952","GL873541","16268070","16268366","91","17149575"
"chr16","33438205","33438489","GL873547","2222074","2222356","77","31216131"
"chr16","33471388","33471690","GL873541","16268070","16268366","85","17203318"
"chr16","33478818","33479127","GL873541","16268070","16268366","95","17210748"
"chr16","33505898","33506191","GL873667","4451263","4451534","90","29054635"
"chr16","33540006","33540315","GL873528","36697151","36697434","95","3157145"
"chr16","33548706","33548996","GL873547","2222074","2222356","83","31326632"
"chr16","33551674","33551968","GL873530","16647228","16647517","81","16904446"
"chr16","33577246","33577557","GL873541","16268070","16268366","100","17309176"
"chr16","33584957","33585259","GL873530","16647228","16647517","97","16937729"
"chr16","33622086","33622393","GL873528","36697151","36697434","96","3075065"
"chr16","33630650","33630946","GL873607","1418062","1418355","89","32212588"
"chr16","33637132","33637430","GL873541","16268070","16268366","95","17369062"
"chr16","34119599","34119885","GL873547","2222074","2222356","78","31897525"
"chr16","34169864","34170075","GL873557","3858721","3858924","61","30311143"
"chr16","34189179","34189478","GL873541","16268070","16268366","89","17921109"
"chr16","34338627","34338926","GL873541","16268070","16268366","84","18070557"
"chr16","34559933","34560229","GL873530","16647228","16647517","82","17912705"
"chr16","34584225","34584535","GL873541","16268070","16268366","98","18316155"
"chr16","34607173","34607302","GL873550","5998776","5998900","32","28608397"
"chr16","34607573","34607723","GL873619","2497092","2497229","55","32110481"
"chr16","34654141","34654443","GL873547","2222074","2222356","85","32432067"
"chr16","34693947","34694250","GL873541","16268070","16268366","87","18425877"
"chr16","34800356","34800660","GL873541","16268070","16268366","91","18532286"
"chr16","34809540","34809792","GL873543","13038674","13038909","89","21770866"
"chr16","34953642","34953933","GL873530","16647228","16647517","84","18306414"
"chr16","35025348","35025652","GL873547","2222074","2222356","87","32803274"
"chr16","35104042","35104353","GL873530","16647228","16647517","91","18456814"
"chr16","35372182","35372476","GL873541","16268070","16268366","86","19104112"
"chr16","35441111","35441401","GL873659","913070","913333","87","34528041"
"chr16","35465384","35465692","GL873541","16268070","16268366","87","19197314"
"chr16","35893384","35893675","GL873530","16647228","16647517","80","19246156"
"chr16","35974635","35974938","GL873530","16647228","16647517","94","19327407"
"chr16","36007753","36008062","GL873607","1418062","1418355","94","34589691"
"chr16","36101245","36101522","GL873541","16268070","16268366","86","19833175"
"chr16","36242744","36243042","GL873530","16647228","16647517","81","19595516"
"chr16","36333976","36334262","GL873547","2222074","2222356","81","34111902"
"chr16","36499305","36499596","GL873530","16647228","16647517","80","19852077"
"chr16","36567954","36568247","GL873547","2222074","2222356","79","34345880"
"chr16","36783802","36784095","GL873547","2222074","2222356","78","34561728"
"chr16","37583626","37583928","GL873541","16268070","16268366","96","21315556"
"chr16","38006778","38007081","GL873541","16268070","16268366","93","21738708"
"chr16","38022523","38022759","GL873680","3005257","3005482","83","35017266"
"chr16","38422523","38422779","GL873680","3005257","3005482","93","35417266"
"chr16","38693887","38694175","GL873547","2222074","2222356","80","36471813"
"chr16","38814751","38815053","GL873541","16268070","16268366","90","22546681"
"chr16","39447039","39447346","GL873541","16268070","16268366","100","23178969"
"chr16","39861100","39861395","GL873547","2222074","2222356","84","37639026"
"chr16","39939835","39940143","GL873541","16268070","16268366","96","23671765"
"chr16","40375690","40375992","GL873541","16268070","16268366","84","24107620"
"chr16","40576997","40577294","GL873541","16268070","16268366","85","24308927"
"chr16","40626399","40626635","GL873528","25203621","25203847","88","15422778"
"chr16","40809926","40810215","GL873607","1418062","1418355","82","39391864"
"chr16","41360694","41360884","GL873530","5593486","5593649","64","35767208"
"chr16","41764138","41764434","GL873541","16268070","16268366","76","25496068"
"chr16","42090093","42090389","GL873530","16647228","16647517","86","25442865"
"chr16","42128055","42128352","GL873541","16268070","16268366","85","25859985"
"chr16","42171631","42171927","GL873541","16268070","16268366","91","25903561"
"chr16","42197688","42197996","GL873547","2222074","2222356","91","39975614"
"chr16","42234578","42234868","GL873530","16647228","16647517","82","25587350"
"chr16","42332737","42332985","GL873543","13038674","13038909","98","29294063"
"chr16","42347539","42347818","GL873547","2222074","2222356","80","40125465"
"chr16","42353101","42353406","GL873541","16268070","16268366","88","26085031"
"chr16","42400873","42401164","GL873530","16647228","16647517","74","25753645"
"chr16","42433006","42433313","GL873528","36697151","36697434","96","5735855"
"chr16","42490943","42491256","GL873607","1418062","1418355","100","41072881"
"chr16","42524176","42524469","GL873547","2222074","2222356","82","40302102"
"chr16","42904316","42904611","GL873530","16647228","16647517","85","26257088"
"chr16","42986264","42986570","GL873541","16268070","16268366","98","26718194"
"chr16","43028173","43028478","GL873541","16268070","16268366","92","26760103"
"chr16","43282992","43283275","GL873547","2222074","2222356","90","41060918"
"chr16","43500998","43501299","GL873528","36697151","36697434","85","6803847"
"chr16","43703595","43703879","GL873547","2222074","2222356","88","41481521"
"chr16","44179250","44179521","GL873547","2222074","2222356","94","41957176"
"chr16","44211282","44211580","GL873528","36697151","36697434","88","7514131"
"chr16","44225988","44226106","GL873622","7076274","7076365","41","37149714"
"chr16","44305946","44306255","GL873541","16268070","16268366","96","28037876"
"chr16","44433668","44433968","GL873541","16268070","16268366","86","28165598"
"chr16","44467310","44467606","GL873541","16268070","16268366","83","28199240"
"chr16","44503810","44504105","GL873541","16268070","16268366","87","28235740"
"chr16","44546837","44547144","GL873528","36697151","36697434","91","7849686"
"chr16","44548243","44548406","GL873550","5998776","5998900","66","38549467"
"chr16","44598895","44599195","GL873547","2222074","2222356","84","42376821"
"chr16","45311436","45311503","GL873554","10500008","10500061","26","34811428"
"chr16","45321460","45321761","GL873541","16268070","16268366","87","29053390"
"chr16","45338240","45338535","GL873530","16647228","16647517","89","28691012"
"chr16","45339572","45339861","GL873667","4451263","4451534","88","40888309"
"chr16","45605309","45605606","GL873528","36697151","36697434","98","8908158"
"chr16","45729556","45729848","GL873659","913070","913333","88","44816486"
"chr16","46286286","46286582","GL873530","16647228","16647517","84","29639058"
"chr16","46386521","46386822","GL873608","6630366","6630673","85","39756155"
"chr16","46501543","46501832","GL873547","2222074","2222356","81","44279469"
"chr16","46505524","46505818","GL873607","1418062","1418355","85","45087462"
"chr16","46523165","46523236","GL873554","10500008","10500061","30","36023157"
"chr16","46563290","46563600","GL873541","16268070","16268366","93","30295220"
"chr16","46711884","46712172","GL873659","913070","913333","100","45798814"
"chr16","46944449","46944751","GL873607","1418062","1418355","85","45526387"
"chr16","47013940","47014204","GL873543","13038674","13038909","90","33975266"
"chr16","47896396","47896694","GL873530","16647228","16647517","87","31249168"
"chr16","48222488","48222655","GL873530","5593486","5593649","53","42629002"
"chr16","48255968","48256195","GL873531","3555300","3555500","75","44700668"
"chr16","48613948","48614254","GL873608","6630366","6630673","89","41983582"
"chr16","48711683","48711981","GL873541","16268070","16268366","81","32443613"
"chr16","49082105","49082416","GL873541","16268070","16268366","102","32814035"
"chr16","49489396","49489693","GL873530","16647228","16647517","87","32842168"
"chr16","49583308","49583446","GL873541","1550303","1550443","54","48033005"
"chr16","49593730","49594049","GL873528","36697151","36697434","103","12896579"
"chr16","49755190","49755314","GL873552","12711845","12711956","45","37043345"
"chr16","50248026","50248315","GL873530","16647228","16647517","88","33600798"
"chr16","50705999","50706090","GL873520","23895808","23895898","27","26810191"
"chr16","51239723","51239767","GL873691","2903502","2903535","16","48336221"
"chr16","51524710","51525012","GL873528","36697151","36697434","92","14827559"
"chr16","51735925","51736226","GL873530","16647228","16647517","86","35088697"
"chr16","51830210","51830518","GL873608","6630366","6630673","85","45199844"
"chr16","52008178","52008275","GL873526","41480965","41481045","49","10527213"
"chr16","52232194","52232504","GL873547","2222074","2222356","97","50010120"
"chr16","52511585","52511870","GL873530","16647228","16647517","86","35864357"
"chr16","53033143","53033426","GL873547","2222074","2222356","84","50811069"
"chr16","53047614","53047905","GL873547","2222074","2222356","83","50825540"
"chr16","53093548","53093888","GL873541","16268070","16268366","112","36825478"
"chr16","53193224","53193368","GL873585","9209559","9209725","62","43983665"
"chr16","53203080","53203267","GL873530","5593486","5593649","57","47609594"
"chr16","53329772","53330076","GL873608","6630366","6630673","77","46699406"
"chr16","53408116","53408378","GL873562","3299887","3300144","97","50108229"
"chr16","53442837","53443126","GL873530","16647228","16647517","88","36795609"
"chr16","53445295","53445596","GL873541","16268070","16268366","86","37177225"
"chr16","53453515","53453817","GL873541","16268070","16268366","85","37185445"
"chr16","53610241","53610540","GL873541","16268070","16268366","90","37342171"
"chr16","53628094","53628373","GL873547","2222074","2222356","81","51406020"
"chr16","53636147","53636456","GL873541","16268070","16268366","93","37368077"
"chr16","53652507","53652833","GL873541","16268070","16268366","113","37384437"
"chr16","53658008","53658281","GL873530","16647228","16647517","93","37010780"
"chr16","53953916","53954196","GL873547","2222074","2222356","94","51731842"
"chr16","54069213","54069505","GL873541","16268070","16268366","89","37801143"
"chr16","54225979","54226284","GL873541","16268070","16268366","87","37957909"
"chr16","54270286","54270498","GL873531","3555300","3555500","63","50714986"
"chr16","55007730","55008025","GL873530","16647228","16647517","85","38360502"
"chr16","55081905","55082202","GL873607","1418062","1418355","89","53663843"
"chr16","55248531","55248823","GL873530","16647228","16647517","77","38601303"
"chr16","55648889","55649182","GL873547","2222074","2222356","88","53426815"
"chr16","55688100","55688397","GL873667","4451263","4451534","99","51236837"
"chr16","56017015","56017315","GL873607","1418062","1418355","85","54598953"
"chr16","56280259","56280564","GL873541","16268070","16268366","86","40012189"
"chr16","56546189","56546470","GL873541","16268070","16268366","88","40278119"
"chr16","56562960","56563089","GL873550","5998776","5998900","40","50564184"
"chr16","56580108","56580414","GL873608","6630366","6630673","92","49949742"
"chr16","56667682","56667981","GL873541","16268070","16268366","88","40399612"
"chr16","56784147","56784341","GL873693","2625207","2625379","53","54158940"
"chr16","56984674","56984842","GL873530","5593486","5593649","47","51391188"
"chr16","57032948","57033254","GL873528","36697151","36697434","91","20335797"
"chr16","57139176","57139471","GL873547","2222074","2222356","82","54917102"
"chr16","57141596","57141900","GL873541","16268070","16268366","81","40873526"
"chr16","57189024","57189330","GL873541","16268070","16268366","89","40920954"
"chr16","57243419","57243597","GL873628","6402015","6402153","88","50841404"
"chr16","57243960","57244252","GL873547","2222074","2222356","83","55021886"
"chr16","57335675","57335985","GL873528","36697151","36697434","93","20638524"
"chr16","57504298","57504607","GL873528","36697151","36697434","93","20807147"
"chr16","57636223","57636513","GL873547","2222074","2222356","88","55414149"
"chr16","57642435","57642739","GL873541","16268070","16268366","85","41374365"
"chr16","58247487","58247609","GL873550","5998776","5998900","36","52248711"
"chr16","58327777","58328064","GL873547","2222074","2222356","78","56105703"
"chr16","58430081","58430365","GL873547","2222074","2222356","75","56208007"
"chr16","58483029","58483321","GL873530","16647228","16647517","83","41835801"
"chr16","58653260","58653568","GL873528","36697151","36697434","97","21956109"
"chr16","58687137","58687430","GL873547","2222074","2222356","82","56465063"
"chr16","58713196","58713492","GL873530","16647228","16647517","84","42065968"
"chr16","58808359","58808664","GL873528","36697151","36697434","93","22111208"
"chr16","58839580","58839876","GL873530","16647228","16647517","75","42192352"
"chr16","58858793","58859100","GL873530","16647228","16647517","86","42211565"
"chr16","59154431","59154733","GL873541","16268070","16268366","85","42886361"
"chr16","59168518","59168815","GL873528","36697151","36697434","90","22471367"
"chr16","59275520","59275823","GL873541","16268070","16268366","82","43007450"
"chr16","59350178","59350200","GL873691","2903502","2903535","17","56446676"
"chr16","59350503","59350658","GL873611","3799989","3800137","48","55550514"
"chr16","59570852","59571033","GL873530","5593486","5593649","50","53977366"
"chr16","59640465","59640741","GL873547","2222074","2222356","88","57418391"
"chr16","59660034","59660332","GL873541","16268070","16268366","84","43391964"
"chr16","59804803","59805094","GL873541","16268070","16268366","95","43536733"
"chr16","59866300","59866606","GL873608","6630366","6630673","89","53235934"
"chr16","59872035","59872328","GL873541","16268070","16268366","85","43603965"
"chr16","60312871","60312984","GL873622","7076274","7076365","41","53236597"
"chr16","61356844","61357143","GL873541","16268070","16268366","86","45088774"
"chr16","61358868","61359175","GL873541","16268070","16268366","87","45090798"
"chr16","61372279","61372581","GL873608","6630366","6630673","89","54741913"
"chr16","61398557","61398850","GL873541","16268070","16268366","86","45130487"
"chr16","61453170","61453463","GL873547","2222074","2222356","90","59231096"
"chr16","61618989","61619282","GL873530","16647228","16647517","87","44971761"
"chr16","61824626","61824678","GL873524","36505249","36505303","27","25319377"
"chr16","61885882","61886183","GL873541","16268070","16268366","85","45617812"
"chr16","61943605","61943901","GL873547","2222074","2222356","80","59721531"
"chr16","62117476","62117671","GL873823","304319","304508","55","61813157"
"chr16","62140597","62140896","GL873541","16268070","16268366","94","45872527"
"chr16","62336664","62336971","GL873528","36697151","36697434","97","25639513"
"chr16","62339943","62340263","GL873528","36697151","36697434","100","25642792"
"chr16","62500748","62500910","GL873530","5593486","5593649","44","56907262"
"chr16","62501208","62501347","GL873550","5998776","5998900","40","56502432"
"chr16","62614669","62614973","GL873607","1418062","1418355","91","61196607"
"chr16","62832425","62832721","GL873547","2222074","2222356","87","60610351"
"chr16","62949356","62949457","GL873643","6205658","6205743","48","56743698"
"chr16","62997712","62997822","GL873622","7076274","7076365","35","55921438"
"chr16","63020521","63020799","GL873547","2222074","2222356","93","60798447"
"chr16","63078950","63079247","GL873541","16268070","16268366","87","46810880"
"chr16","63172822","63173119","GL873541","16268070","16268366","89","46904752"
"chr16","63177233","63177521","GL873547","2222074","2222356","77","60955159"
"chr16","63241466","63241595","GL873622","7076274","7076365","52","56165192"
"chr16","63286025","63286315","GL873530","16647228","16647517","95","46638797"
"chr16","63315326","63315628","GL873541","16268070","16268366","88","47047256"
"chr16","63342792","63342941","GL873611","3799989","3800137","54","59542803"
"chr16","63383831","63384131","GL873530","16647228","16647517","87","46736603"
"chr16","63399838","63400133","GL873547","2222074","2222356","100","61177764"
"chr16","63595657","63595947","GL873530","16647228","16647517","77","46948429"
"chr16","63734623","63734922","GL873541","16268070","16268366","94","47466553"
"chr16","63801700","63801993","GL873547","2222074","2222356","77","61579626"
"chr16","63880367","63880666","GL873541","16268070","16268366","83","47612297"
"chr16","63906186","63906482","GL873541","16268070","16268366","81","47638116"
"chr16","63942429","63942730","GL873541","16268070","16268366","85","47674359"
"chr16","63994911","63995193","GL873659","913070","913333","90","63081841"
"chr16","64003620","64003877","GL873528","25203621","25203847","88","38799999"
"chr16","64256171","64256304","GL873550","5998776","5998900","34","58257395"
"chr16","64345035","64345324","GL873530","16647228","16647517","88","47697807"
"chr16","64349939","64350230","GL873530","16647228","16647517","87","47702711"
"chr16","64419101","64419399","GL873541","16268070","16268366","84","48151031"
"chr16","64948527","64948797","GL873547","2222074","2222356","92","62726453"
"chr16","65242068","65242378","GL873528","36697151","36697434","102","28544917"
"chr16","65798303","65798603","GL873530","16647228","16647517","84","49151075"
"chr16","65842123","65842429","GL873541","16268070","16268366","95","49574053"
"chr16","65956272","65956564","GL873530","16647228","16647517","89","49309044"
"chr16","65987476","65987737","GL873680","3005257","3005482","83","62982219"
"chr16","66129192","66129477","GL873547","2222074","2222356","76","63907118"
"chr16","66139074","66139369","GL873530","16647228","16647517","83","49491846"
"chr16","66373684","66373974","GL873547","2222074","2222356","78","64151610"
"chr16","66582351","66582647","GL873530","16647228","16647517","88","49935123"
"chr16","66677900","66678130","GL873625","6060130","6060345","90","60617770"
"chr16","66747810","66748101","GL873530","16647228","16647517","92","50100582"
"chr16","66798507","66798791","GL873547","2222074","2222356","79","64576433"
"chr16","67227295","67227433","GL873541","1550303","1550443","59","65676992"
"chr16","67300709","67301023","GL873528","36697151","36697434","98","30603558"
"chr16","67368946","67369214","GL873562","3299887","3300144","78","64069059"
"chr16","67373658","67373837","GL873530","5593486","5593649","61","61780172"
"chr16","67374139","67374281","GL873550","5998776","5998900","45","61375363"
"chr16","67380648","67380950","GL873530","16647228","16647517","89","50733420"
"chr16","67498945","67499239","GL873547","2222074","2222356","92","65276871"
"chr16","67880193","67880455","GL873659","913070","913333","96","66967123"
"chr16","67881176","67881462","GL873547","2222074","2222356","82","65659102"
"chr16","67890371","67890676","GL873607","1418062","1418355","89","66472309"
"chr16","67921512","67921804","GL873547","2222074","2222356","83","65699438"
"chr16","68008658","68008949","GL873530","16647228","16647517","83","51361430"
"chr16","68030374","68030585","GL873538","2567037","2567262","65","65463337"
"chr16","68160513","68160821","GL873541","16268070","16268366","91","51892443"
"chr16","68386196","68386485","GL873659","913070","913333","94","67473126"
"chr16","68481091","68481389","GL873547","2222074","2222356","83","66259017"
"chr16","68502587","68502890","GL873541","16268070","16268366","81","52234517"
"chr16","68545193","68545485","GL873530","16647228","16647517","86","51897965"
"chr16","68659221","68659521","GL873541","16268070","16268366","92","52391151"
"chr16","68873108","68873261","GL873541","1550303","1550443","49","67322805"
"chr16","69077847","69078004","GL873529","2453810","2453957","49","66624037"
"chr16","69330581","69330885","GL873541","16268070","16268366","94","53062511"
"chr16","69375614","69375923","GL873541","16268070","16268366","91","53107544"
"chr16","69380549","69380824","GL873562","3299887","3300144","80","66080662"
"chr16","69394017","69394296","GL873562","3299887","3300144","87","66094130"
"chr16","69437951","69438257","GL873812","559768","560073","108","68878183"
"chr16","69518948","69519230","GL873547","2222074","2222356","88","67296874"
"chr16","69531018","69531313","GL873528","36697151","36697434","96","32833867"
"chr16","69856689","69856999","GL873530","16647228","16647517","94","53209461"
"chr16","69978869","69979178","GL873541","16268070","16268366","85","53710799"
"chr16","70215607","70215912","GL873659","913070","913333","91","69302537"
"chr16","70242315","70242624","GL873541","16268070","16268366","91","53974245"
"chr16","70386084","70386375","GL873607","1418062","1418355","89","68968022"
"chr16","70459044","70459205","GL873530","5593486","5593649","51","64865558"
"chr16","70513373","70513671","GL873608","6630366","6630673","83","63883007"
"chr16","70592470","70592772","GL873541","16268070","16268366","87","54324400"
"chr16","70729210","70729502","GL873607","1418062","1418355","80","69311148"
"chr16","70761900","70762196","GL873547","2222074","2222356","79","68539826"
"chr16","71130019","71130298","GL873562","3299887","3300144","82","67830132"
"chr16","71534391","71534686","GL873530","16647228","16647517","86","54887163"
"chr16","71843572","71843697","GL873622","7076274","7076365","51","64767298"
"chr16","72195997","72196301","GL873530","16647228","16647517","92","55548769"
"chr16","72223474","72223764","GL873547","2222074","2222356","89","70001400"
"chr16","72580947","72581238","GL873547","2222074","2222356","80","70358873"
"chr16","72735309","72735612","GL873541","16268070","16268366","88","56467239"
"chr16","73285968","73286102","GL873550","5998776","5998900","37","67287192"
"chr16","73298728","73299018","GL873547","2222074","2222356","80","71076654"
"chr16","73439410","73439673","GL873562","3299887","3300144","92","70139523"
"chr16","73444547","73444845","GL873541","16268070","16268366","89","57176477"
"chr16","73550879","73551193","GL873541","16268070","16268366","93","57282809"
"chr16","73572853","73573150","GL873530","16647228","16647517","88","56925625"
"chr16","73871934","73872239","GL873659","913070","913333","93","72958864"
"chr16","74527352","74527538","GL873697","3111225","3111427","58","71416127"
"chr16","74574690","74574885","GL873535","24407607","24407780","53","50167083"
"chr16","74629299","74629601","GL873541","16268070","16268366","81","58361229"
"chr16","74803076","74803362","GL873528","36697151","36697434","102","38105925"
"chr17","1321716","1322031","GL873607","1418062","1418355","98","96346"
"chr17","1522895","1523186","GL873530","16647228","16647517","83","15124333"
"chr17","1586848","1587152","GL873541","16268070","16268366","84","14681222"
"chr17","1608450","1608742","GL873607","1418062","1418355","98","190388"
"chr17","1659996","1660337","GL873608","6630366","6630673","114","4970370"
"chr17","1678340","1678626","GL873659","913070","913333","82","765270"
"chr17","1796509","1796809","GL873541","16268070","16268366","88","14471561"
"chr17","1803455","1803467","GL873691","2903502","2903535","23","1100047"
"chr17","1803514","1803790","GL873562","3299887","3300144","92","1496373"
"chr17","1833168","1833478","GL873528","36697151","36697434","95","34863983"
"chr17","2716210","2716501","GL873541","16268070","16268366","89","13551860"
"chr17","4212982","4213127","GL873619","2497092","2497229","50","1715890"
"chr17","4428867","4429092","GL873564","8360716","8360913","75","3931849"
"chr17","4564564","4564857","GL873530","16647228","16647517","84","12082664"
"chr17","4634148","4634431","GL873562","3299887","3300144","90","1334261"
"chr17","4742146","4742430","GL873547","2222074","2222356","81","2520072"
"chr17","5223871","5224132","GL873562","3299887","3300144","92","1923984"
"chr17","5796700","5797009","GL873541","16268070","16268366","97","10471370"
"chr17","5960012","5960307","GL873530","16647228","16647517","96","10687216"
"chr17","6642467","6642719","GL873535","4830564","4830824","91","1811903"
"chr17","6987895","6988192","GL873530","16647228","16647517","94","9659333"
"chr17","7928236","7928425","GL873554","16339732","16339922","62","8411496"
"chr17","9573840","9574117","GL873530","16647228","16647517","92","7073388"
"chr17","9883575","9883861","GL873547","2222074","2222356","99","7661501"
"chr17","10114805","10115105","GL873607","1418062","1418355","87","8696743"
"chr17","11179120","11179285","GL873530","5593486","5593649","54","5585634"
"chr17","11194536","11194836","GL873541","16268070","16268366","87","5073534"
"chr17","11239322","11239619","GL873547","2222074","2222356","89","9017248"
"chr17","11297603","11297899","GL873547","2222074","2222356","92","9075529"
"chr17","12238612","12238852","GL873557","3858721","3858924","93","8379891"
"chr17","15218212","15218513","GL873530","16647228","16647517","87","1429016"
"chr17","15735353","15735506","GL873541","1550303","1550443","58","14185050"
"chr17","16580478","16580635","GL873530","5593486","5593649","53","10986992"
"chr17","16685119","16685410","GL873547","2222074","2222356","84","14463045"
"chr17","16693959","16694262","GL873530","16647228","16647517","81","46731"
"chr17","18586706","18587005","GL873607","1418062","1418355","88","17168644"
"chr17","18817417","18817728","GL873541","16268070","16268366","90","2549347"
"chr17","18864767","18864901","GL873541","1550303","1550443","58","17314464"
"chr17","19329630","19329857","GL873557","3858721","3858924","76","15470909"
"chr17","19340621","19340911","GL873541","16268070","16268366","93","3072551"
"chr17","19447440","19447747","GL873541","16268070","16268366","89","3179370"
"chr17","19652954","19653256","GL873530","16647228","16647517","92","3005726"
"chr17","20179990","20180235","GL873680","3005257","3005482","75","17174733"
"chr17","20780276","20780572","GL873607","1418062","1418355","87","19362214"
"chr17","22605049","22605342","GL873530","16647228","16647517","79","5957821"
"chr17","23531829","23532090","GL873535","4830564","4830824","89","18701265"
"chr17","23804076","23804374","GL873541","16268070","16268366","90","7536006"
"chr17","24441227","24441518","GL873530","16647228","16647517","86","7793999"
"chr17","24468408","24468643","GL873531","3555300","3555500","78","20913108"
"chr17","24551236","24551511","GL873547","2222074","2222356","86","22329162"
"chr17","25506627","25506907","GL873562","3299887","3300144","91","22206740"
"chr17","25639035","25639313","GL873607","1418062","1418355","86","24220973"
"chr17","25887979","25888295","GL873528","36697151","36697434","101","10809172"
"chr17","25986431","25986714","GL873547","2222074","2222356","78","23764357"
"chr17","26318701","26319003","GL873541","16268070","16268366","82","10050631"
"chr17","26921535","26921831","GL873541","16268070","16268366","83","10653465"
"chr17","27039242","27039550","GL873607","1418062","1418355","94","25621180"
"chr17","27040134","27040434","GL873528","36697151","36697434","87","9657017"
"chr17","28034215","28034492","GL873547","2222074","2222356","82","25812141"
"chr17","28470292","28470597","GL873528","36697151","36697434","91","8226859"
"chr17","28504407","28504573","GL873585","9209559","9209725","56","19294848"
"chr17","28943174","28943477","GL873608","6630366","6630673","95","22312808"
"chr17","28995964","28996258","GL873530","16647228","16647517","90","12348736"
"chr17","29134847","29135151","GL873541","16268070","16268366","91","12866777"
"chr17","29211723","29211916","GL873640","6426205","6426399","65","22785518"
"chr17","29306106","29306387","GL873667","4451263","4451534","84","24854843"
"chr17","29831247","29831537","GL873528","36697151","36697434","89","6865904"
"chr17","30084715","30085008","GL873547","2222074","2222356","85","27862641"
"chr17","30139139","30139432","GL873607","1418062","1418355","84","28721077"
"chr17","30155508","30155777","GL873562","3299887","3300144","83","26855621"
"chr17","30173106","30173243","GL873541","1550303","1550443","48","28622803"
"chr17","30287639","30287933","GL873530","16647228","16647517","90","13640411"
"chr17","31068189","31068485","GL873528","36697151","36697434","91","5628962"
"chr17","31248011","31248302","GL873547","2222074","2222356","81","29025937"
"chr17","31346768","31347061","GL873547","2222074","2222356","85","29124694"
"chr17","31793076","31793364","GL873541","16268070","16268366","83","15525006"
"chr17","32611670","32611955","GL873547","2222074","2222356","78","30389596"
"chr17","32790740","32791038","GL873541","16268070","16268366","80","16522670"
"chr17","33157535","33157833","GL873530","16647228","16647517","86","16510307"
"chr17","33280317","33280602","GL873659","913070","913333","99","32367247"
"chr17","33625519","33625818","GL873528","36697151","36697434","90","3071632"
"chr17","33633273","33633578","GL873541","16268070","16268366","92","17365203"
"chr17","33920750","33921050","GL873541","16268070","16268366","83","17652680"
"chr17","34129649","34129945","GL873607","1418062","1418355","85","32711587"
"chr17","34393114","34393415","GL873541","16268070","16268366","86","18125044"
"chr17","34618434","34618733","GL873541","16268070","16268366","87","18350364"
"chr17","34631327","34631632","GL873530","16647228","16647517","87","17984099"
"chr17","34711144","34711405","GL873565","12307556","12307825","88","22403588"
"chr17","34737171","34737447","GL873547","2222074","2222356","85","32515097"
"chr17","34746845","34746962","GL873550","5998776","5998900","38","28748069"
"chr17","34994879","34995188","GL873607","1418062","1418355","91","33576817"
"chr17","35025255","35025503","GL873564","8360716","8360913","94","26664539"
"chr17","35101740","35102031","GL873530","16647228","16647517","87","18454512"
"chr17","35141380","35141489","GL873524","43272658","43272747","43","8131278"
"chr17","35406623","35406921","GL873541","16268070","16268366","95","19138553"
"chr17","35465209","35465517","GL873541","16268070","16268366","91","19197139"
"chr17","35512843","35513153","GL873541","16268070","16268366","91","19244773"
"chr17","35543039","35543313","GL873547","2222074","2222356","94","33320965"
"chr17","35595762","35595954","GL873697","3111225","3111427","48","32484537"
"chr17","35608634","35608917","GL873547","2222074","2222356","82","33386560"
"chr17","35741754","35742054","GL873530","16647228","16647517","89","19094526"
"chr17","35948412","35948639","GL873531","3555300","3555500","70","32393112"
"chr17","36107859","36108154","GL873667","4451263","4451534","91","31656596"
"chr17","36159363","36159664","GL873541","16268070","16268366","84","19891293"
"chr17","36163555","36163856","GL873541","16268070","16268366","86","19895485"
"chr17","36342605","36342780","GL873560","5855436","5855580","60","30487169"
"chr17","36613783","36613962","GL873524","23693028","23693185","53","12920755"
"chr17","36669235","36669526","GL873659","913070","913333","91","35756165"
"chr17","36678048","36678335","GL873528","36697151","36697434","97","19103"
"chr17","36795271","36795585","GL873541","16268070","16268366","89","20527201"
"chr17","36857924","36858166","GL873680","3005257","3005482","84","33852667"
"chr17","37016457","37016771","GL873608","6630366","6630673","96","30386091"
"chr17","37331543","37331594","GL873554","10500008","10500061","19","26831535"
"chr17","37363181","37363484","GL873547","2222074","2222356","84","35141107"
"chr17","37597760","37598069","GL873541","16268070","16268366","93","21329690"
"chr17","37687672","37687814","GL873524","43272770","43272878","61","5585098"
"chr17","37721556","37721848","GL873547","2222074","2222356","84","35499482"
"chr17","37808573","37808868","GL873607","1418062","1418355","82","36390511"
"chr17","37869051","37869348","GL873541","16268070","16268366","94","21600981"
"chr17","37930773","37930949","GL873585","9209559","9209725","62","28721214"
"chr17","38276987","38277273","GL873541","16268070","16268366","87","22008917"
"chr17","38277362","38277375","GL873691","2903502","2903535","22","35373860"
"chr17","38305843","38306098","GL873680","3005257","3005482","82","35300586"
"chr17","38432190","38432497","GL873541","16268070","16268366","92","22164120"
"chr17","38569856","38570151","GL873528","36697151","36697434","92","1872705"
"chr17","38577074","38577372","GL873541","16268070","16268366","93","22309004"
"chr17","38710941","38711220","GL873562","3299887","3300144","88","35411054"
"chr17","38749593","38749886","GL873547","2222074","2222356","79","36527519"
"chr17","38793864","38794165","GL873541","16268070","16268366","93","22525794"
"chr17","38855533","38855845","GL873541","16268070","16268366","95","22587463"
"chr17","39027745","39028045","GL873752","427788","428097","97","38599957"
"chr17","39459121","39459404","GL873547","2222074","2222356","84","37237047"
"chr17","39600142","39600456","GL873541","16268070","16268366","99","23332072"
"chr17","39688881","39689189","GL873541","16268070","16268366","92","23420811"
"chr17","39906210","39906320","GL873622","7076274","7076365","43","32829936"
"chr17","39914498","39914781","GL873680","3005257","3005482","106","36909241"
"chr17","40106599","40106905","GL873541","16268070","16268366","84","23838529"
"chr17","40127835","40128007","GL873530","5593486","5593649","49","34534349"
"chr17","40164028","40164318","GL873530","16647228","16647517","80","23516800"
"chr17","40180457","40180754","GL873541","16268070","16268366","105","23912387"
"chr17","41270462","41270765","GL873541","16268070","16268366","85","25002392"
"chr17","41657157","41657445","GL873607","1418062","1418355","79","40239095"
"chr17","41805511","41805810","GL873547","2222074","2222356","83","39583437"
"chr17","41816726","41816966","GL873538","2567037","2567262","74","39249689"
"chr17","41824107","41824399","GL873547","2222074","2222356","80","39602033"
"chr17","41836303","41836590","GL873547","2222074","2222356","81","39614229"
"chr17","42200797","42201101","GL873541","16268070","16268366","91","25932727"
"chr17","42271997","42272288","GL873530","16647228","16647517","83","25624769"
"chr17","42385542","42385814","GL873565","12307556","12307825","98","30077986"
"chr17","43034949","43035237","GL873667","4451263","4451534","94","38583686"
"chr17","43423355","43423651","GL873530","16647228","16647517","91","26776127"
"chr17","43589248","43589549","GL873530","16647228","16647517","93","26942020"
"chr17","43596617","43596928","GL873541","16268070","16268366","97","27328547"
"chr17","43720108","43720402","GL873752","427788","428097","88","43292320"
"chr17","43813695","43813987","GL873530","16647228","16647517","87","27166467"
"chr17","43994556","43994844","GL873530","16647228","16647517","79","27347328"
"chr17","44623311","44623610","GL873528","36697151","36697434","98","7926160"
"chr17","44636809","44637090","GL873565","12307556","12307825","99","32329253"
"chr17","44760815","44760949","GL873550","5998776","5998900","44","38762039"
"chr17","44792077","44792375","GL873528","36697151","36697434","94","8094926"
"chr17","44797436","44797665","GL873640","6426205","6426399","87","38371231"
"chr17","45045914","45046229","GL873530","16647228","16647517","106","28398686"
"chr17","45288872","45289170","GL873530","16647228","16647517","86","28641644"
"chr17","45336545","45336772","GL873538","2567037","2567262","69","42769508"
"chr17","45396848","45396997","GL873550","5998776","5998900","49","39398072"
"chr17","45599767","45600035","GL873565","12307556","12307825","97","33292211"
"chr17","45898197","45898209","GL873691","2903502","2903535","23","42994695"
"chr17","45898482","45898658","GL873530","5593486","5593649","63","40304996"
"chr17","46059497","46059816","GL873530","16647228","16647517","102","29412269"
"chr17","46070772","46071041","GL873547","2222074","2222356","94","43848698"
"chr17","46085982","46086266","GL873528","36697151","36697434","92","9388831"
"chr17","46123657","46123967","GL873607","1418062","1418355","107","44705595"
"chr17","46154916","46155210","GL873541","16268070","16268366","89","29886846"
"chr17","46623583","46623890","GL873541","16268070","16268366","94","30355513"
"chr17","47068983","47069276","GL873541","16268070","16268366","95","30800913"
"chr17","47632017","47632308","GL873547","2222074","2222356","85","45409943"
"chr17","47781730","47782028","GL873541","16268070","16268366","87","31513660"
"chr17","47805481","47805753","GL873659","913070","913333","89","46892411"
"chr17","47816933","47817238","GL873541","16268070","16268366","92","31548863"
"chr17","48124549","48124857","GL873608","6630366","6630673","89","41494183"
"chr17","48282564","48282871","GL873528","36697151","36697434","97","11585413"
"chr17","48303775","48304070","GL873547","2222074","2222356","81","46081701"
"chr17","48961894","48962190","GL873530","16647228","16647517","82","32314666"
"chr17","49898426","49898587","GL873574","7318344","7318500","66","42580082"
"chr17","49925720","49926022","GL873607","1418062","1418355","90","48507658"
"chr17","50272212","50272504","GL873530","16647228","16647517","73","33624984"
"chr17","50312022","50312314","GL873547","2222074","2222356","83","48089948"
"chr17","50350054","50350350","GL873541","16268070","16268366","86","34081984"
"chr17","50422759","50423050","GL873541","16268070","16268366","86","34154689"
"chr17","50480721","50481028","GL873530","16647228","16647517","94","33833493"
"chr17","50566918","50567200","GL873547","2222074","2222356","94","48344844"
"chr17","50570712","50571012","GL873608","6630366","6630673","81","43940346"
"chr17","50641426","50641718","GL873530","16647228","16647517","79","33994198"
"chr17","50662239","50662525","GL873530","16647228","16647517","88","34015011"
"chr17","50840539","50840839","GL873547","2222074","2222356","85","48618465"
"chr17","51394187","51394479","GL873530","16647228","16647517","89","34746959"
"chr17","51415912","51416220","GL873541","16268070","16268366","88","35147842"
"chr17","51416800","51417109","GL873541","16268070","16268366","91","35148730"
"chr17","51807451","51807736","GL873530","16647228","16647517","79","35160223"
"chr17","52102206","52102500","GL873541","16268070","16268366","84","35834136"
"chr17","52516798","52517080","GL873607","1418062","1418355","88","51098736"
"chr17","52564409","52564715","GL873541","16268070","16268366","94","36296339"
"chr17","53582686","53582976","GL873530","16647228","16647517","75","36935458"
"chr17","54039387","54039698","GL873530","16647228","16647517","93","37392159"
"chr17","54539130","54539423","GL873530","16647228","16647517","84","37891902"
"chr17","54772908","54773211","GL873541","16268070","16268366","87","38504838"
"chr17","55492320","55492632","GL873530","16647228","16647517","94","38845092"
"chr17","56879400","56879710","GL873607","1418062","1418355","99","55461338"
"chr17","56936607","56936906","GL873530","16647228","16647517","83","40289379"
"chr17","57117195","57117498","GL873541","16268070","16268366","89","40849125"
"chr17","57606159","57606468","GL873541","16268070","16268366","94","41338089"
"chr17","58021281","58021577","GL873541","16268070","16268366","91","41753211"
"chr17","58282213","58282513","GL873530","16647228","16647517","85","41634985"
"chr17","58367838","58368141","GL873541","16268070","16268366","77","42099768"
"chr17","59073456","59073755","GL873541","16268070","16268366","92","42805386"
"chr17","59172426","59172715","GL873547","2222074","2222356","69","56950352"
"chr17","59393962","59394233","GL873562","3299887","3300144","88","56094075"
"chr17","59482816","59483124","GL873541","16268070","16268366","94","43214746"
"chr17","59523170","59523476","GL873528","36697151","36697434","88","22826019"
"chr17","59824268","59824553","GL873530","16647228","16647517","86","43177040"
"chr17","60356415","60356704","GL873530","16647228","16647517","86","43709187"
"chr17","60805462","60805756","GL873547","2222074","2222356","76","58583388"
"chr17","60889293","60889599","GL873667","4451263","4451534","98","56438030"
"chr17","60953943","60954243","GL873541","16268070","16268366","89","44685873"
"chr17","60993694","60993991","GL873541","16268070","16268366","102","44725624"
"chr17","61330768","61331074","GL873541","16268070","16268366","88","45062698"
"chr17","61421115","61421390","GL873530","16647228","16647517","92","44773887"
"chr17","61617836","61618146","GL873541","16268070","16268366","98","45349766"
"chr17","61823129","61823273","GL873541","1550303","1550443","56","60272826"
"chr17","61825982","61826287","GL873607","1418062","1418355","108","60407920"
"chr17","61994715","61995005","GL873528","36697151","36697434","100","25297564"
"chr17","62065130","62065422","GL873530","16647228","16647517","87","45417902"
"chr17","62074159","62074455","GL873541","16268070","16268366","85","45806089"
"chr17","62180424","62180724","GL873607","1418062","1418355","93","60762362"
"chr17","62202297","62202577","GL873528","36697151","36697434","99","25505146"
"chr17","63074281","63074514","GL873557","3858721","3858924","80","59215560"
"chr17","63504399","63504690","GL873530","16647228","16647517","81","46857171"
"chr17","63673410","63673529","GL873552","12711845","12711956","48","50961565"
"chr17","63732160","63732329","GL873530","5593486","5593649","53","58138674"
"chr17","63732980","63733286","GL873541","16268070","16268366","91","47464910"
"chr17","64117052","64117358","GL873547","2222074","2222356","90","61894978"
"chr17","64118191","64118422","GL873557","3858721","3858924","74","60259470"
"chr17","64608906","64609208","GL873541","16268070","16268366","89","48340836"
"chr17","64649688","64649979","GL873547","2222074","2222356","84","62427614"
"chr17","64812252","64812533","GL873530","16647228","16647517","99","48165024"
"chr17","64872066","64872371","GL873541","16268070","16268366","93","48603996"
"chr17","64912955","64913249","GL873530","16647228","16647517","96","48265727"
"chr17","64916096","64916399","GL873541","16268070","16268366","89","48648026"
"chr17","65125009","65125291","GL873547","2222074","2222356","85","62902935"
"chr17","65238498","65238783","GL873547","2222074","2222356","85","63016424"
"chr17","65433325","65433577","GL873543","13038674","13038909","93","52394651"
"chr17","65443351","65443653","GL873541","16268070","16268366","90","49175281"
"chr17","65551708","65551980","GL873659","913070","913333","94","64638638"
"chr17","66671991","66672181","GL873524","42560728","42560902","72","24111263"
"chr17","66672225","66672238","GL873691","2903502","2903535","21","63768723"
"chr17","66910465","66910730","GL873565","12307556","12307825","90","54602909"
"chr17","67005740","67006028","GL873530","16647228","16647517","76","50358512"
"chr17","67011454","67011582","GL873552","12711845","12711956","53","54299609"
"chr17","67063342","67063647","GL873541","16268070","16268366","96","50795272"
"chr17","67094016","67094308","GL873530","16647228","16647517","91","50446788"
"chr17","67473342","67473631","GL873547","2222074","2222356","76","65251268"
"chr17","68279735","68280042","GL873541","16268070","16268366","88","52011665"
"chr17","68310453","68310724","GL873562","3299887","3300144","90","65010566"
"chr17","68673910","68674205","GL873530","16647228","16647517","87","52026682"
"chr17","68897315","68897615","GL873530","16647228","16647517","87","52250087"
"chr17","69235025","69235308","GL873547","2222074","2222356","83","67012951"
"chr17","70130752","70131077","GL873541","16268070","16268366","107","53862682"
"chr17","70268065","70268367","GL873541","16268070","16268366","87","53999995"
"chr17","70894636","70894929","GL873530","16647228","16647517","85","54247408"
"chr18","226577","226886","GL873752","427788","428097","92","201211"
"chr18","253186","253482","GL873752","427788","428097","86","174602"
"chr18","995515","995795","GL873530","16647228","16647517","86","15651713"
"chr18","1589382","1589711","GL873541","16268070","16268366","124","14678688"
"chr18","2518213","2518517","GL873608","6630366","6630673","88","4112153"
"chr18","2725758","2726046","GL873547","2222074","2222356","78","503684"
"chr18","2915079","2915350","GL873659","913070","913333","82","2002009"
"chr18","3239806","3240108","GL873530","16647228","16647517","81","13407422"
"chr18","3356277","3356582","GL873541","16268070","16268366","87","12911793"
"chr18","3754416","3754723","GL873608","6630366","6630673","91","2875950"
"chr18","4579119","4579426","GL873530","16647228","16647517","96","12068109"
"chr18","5040726","5040951","GL873531","3555300","3555500","69","1485426"
"chr18","5577621","5577920","GL873547","2222074","2222356","87","3355547"
"chr18","6024340","6024599","GL873659","913070","913333","88","5111270"
"chr18","6704079","6704382","GL873659","913070","913333","97","5791009"
"chr18","6977924","6978229","GL873541","16268070","16268366","90","9290146"
"chr18","7330324","7330631","GL873541","16268070","16268366","98","8937746"
"chr18","7435992","7436296","GL873541","16268070","16268366","86","8832078"
"chr18","7728807","7729092","GL873565","12307556","12307825","106","4578749"
"chr18","7791711","7792010","GL873607","1418062","1418355","88","6373649"
"chr18","7998108","7998376","GL873680","3005257","3005482","100","4992851"
"chr18","8405945","8406246","GL873541","16268070","16268366","92","7862125"
"chr18","8587007","8587306","GL873752","427788","428097","87","8159219"
"chr18","8947915","8948183","GL873680","3005257","3005482","93","5942658"
"chr18","8967848","8968147","GL873541","16268070","16268366","95","7300222"
"chr18","9075863","9076159","GL873541","16268070","16268366","88","7192207"
"chr18","9261960","9262265","GL873541","16268070","16268366","93","7006110"
"chr18","9766335","9766615","GL873547","2222074","2222356","98","7544261"
"chr18","9807880","9808181","GL873530","16647228","16647517","95","6839348"
"chr18","9905435","9905663","GL873680","3005257","3005482","54","6900178"
"chr18","10093386","10093693","GL873607","1418062","1418355","95","8675324"
"chr18","10703861","10704219","GL873559","3737111","3737481","135","6966750"
"chr18","11003396","11003665","GL873562","3299887","3300144","89","7703509"
"chr18","11190558","11190847","GL873547","2222074","2222356","74","8968484"
"chr18","11547924","11548236","GL873541","16268070","16268366","95","4720146"
"chr18","11626629","11626908","GL873659","913070","913333","86","10713559"
"chr18","12235884","12236179","GL873547","2222074","2222356","90","10013810"
"chr18","13011129","13011432","GL873541","16268070","16268366","96","3256941"
"chr18","13036844","13037148","GL873541","16268070","16268366","90","3231226"
"chr18","13216852","13217162","GL873530","16647228","16647517","100","3430376"
"chr18","14014172","14014467","GL873530","16647228","16647517","84","2633056"
"chr18","14662070","14662348","GL873562","3299887","3300144","93","11362183"
"chr18","14662387","14662410","GL873691","2903502","2903535","21","11758885"
"chr18","15450930","15451207","GL873562","3299887","3300144","85","12151043"
"chr18","15843397","15843695","GL873541","16268070","16268366","86","424673"
"chr18","16330996","16331307","GL873541","16268070","16268366","93","62926"
"chr18","16597038","16597344","GL873541","16268070","16268366","101","328968"
"chr18","16894083","16894397","GL873547","2222074","2222356","91","14672009"
"chr18","16939411","16939688","GL873547","2222074","2222356","90","14717337"
"chr18","17698045","17698332","GL873547","2222074","2222356","86","15475971"
"chr18","18373255","18373537","GL873541","16268070","16268366","88","2105185"
"chr18","18696664","18696962","GL873547","2222074","2222356","79","16474590"
"chr18","18915153","18915452","GL873541","16268070","16268366","85","2647083"
"chr18","19207800","19208083","GL873530","16647228","16647517","85","2560572"
"chr18","19208915","19209223","GL873547","2222074","2222356","99","16986841"
"chr18","19681143","19681417","GL873528","36697151","36697434","97","17016008"
"chr18","20640672","20640953","GL873530","16647228","16647517","84","3993444"
"chr18","20744303","20744608","GL873528","36697151","36697434","100","15952848"
"chr18","21169838","21170126","GL873659","913070","913333","86","20256768"
"chr18","21758831","21759080","GL873697","3111225","3111427","85","18647606"
"chr18","22102012","22102319","GL873541","16268070","16268366","85","5833942"
"chr18","22111128","22111436","GL873541","16268070","16268366","90","5843058"
"chr18","22772283","22772466","GL873697","3111225","3111427","60","19661058"
"chr18","22901985","22902281","GL873608","6630366","6630673","86","16271619"
"chr18","23503519","23503815","GL873530","16647228","16647517","81","6856291"
"chr18","23579411","23579694","GL873547","2222074","2222356","87","21357337"
"chr18","23735352","23735620","GL873562","3299887","3300144","84","20435465"
"chr18","24493650","24493947","GL873541","16268070","16268366","81","8225580"
"chr18","24749973","24750253","GL873547","2222074","2222356","84","22527899"
"chr18","26717615","26717912","GL873541","16268070","16268366","84","10449545"
"chr18","27748509","27748794","GL873562","3299887","3300144","94","24448622"
"chr18","28088798","28089105","GL873528","36697151","36697434","94","8608353"
"chr18","28678372","28678676","GL873530","16647228","16647517","92","12031144"
"chr18","29315898","29316202","GL873528","36697151","36697434","95","7381253"
"chr18","29389352","29389661","GL873541","16268070","16268366","97","13121282"
"chr18","29711688","29711970","GL873547","2222074","2222356","88","27489614"
"chr18","30861905","30862199","GL873530","16647228","16647517","84","14214677"
"chr18","31363233","31363513","GL873562","3299887","3300144","86","28063346"
"chr18","31452973","31453088","GL873552","12711845","12711956","42","18741128"
"chr18","31461630","31461936","GL873607","1418062","1418355","95","30043568"
"chr18","31464231","31464522","GL873547","2222074","2222356","79","29242157"
"chr18","31474443","31474741","GL873528","36697151","36697434","93","5222708"
"chr18","31493690","31493879","GL873530","5593486","5593649","52","25900204"
"chr18","31677712","31677990","GL873562","3299887","3300144","87","28377825"
"chr18","33283985","33284269","GL873547","2222074","2222356","86","31061911"
"chr18","33422516","33422822","GL873541","16268070","16268366","93","17154446"
"chr18","33547985","33548248","GL873659","913070","913333","80","32634915"
"chr18","33949622","33949932","GL873530","16647228","16647517","93","17302394"
"chr18","33960224","33960403","GL873530","5593486","5593649","60","28366738"
"chr18","34662898","34663202","GL873659","913070","913333","92","33749828"
"chr18","34718763","34719063","GL873528","36697151","36697434","106","1978388"
"chr18","34727676","34727971","GL873530","16647228","16647517","83","18080448"
"chr18","34762772","34763071","GL873607","1418062","1418355","85","33344710"
"chr18","34767428","34767727","GL873607","1418062","1418355","87","33349366"
"chr18","34789717","34790027","GL873541","16268070","16268366","96","18521647"
"chr18","34811309","34811615","GL873541","16268070","16268366","92","18543239"
"chr18","34852642","34852922","GL873562","3299887","3300144","89","31552755"
"chr18","35039565","35039862","GL873530","16647228","16647517","75","18392337"
"chr18","35063960","35064256","GL873541","16268070","16268366","102","18795890"
"chr18","35690097","35690391","GL873541","16268070","16268366","85","19422027"
"chr18","35871333","35871611","GL873547","2222074","2222356","81","33649259"
"chr18","36985249","36985556","GL873608","6630366","6630673","95","30354883"
"chr18","37042480","37042789","GL873667","4451263","4451534","102","32591217"
"chr18","37084909","37085195","GL873547","2222074","2222356","83","34862835"
"chr18","37109673","37109981","GL873541","16268070","16268366","92","20841603"
"chr18","37963963","37964254","GL873667","4451263","4451534","82","33512700"
"chr18","38027241","38027538","GL873541","16268070","16268366","86","21759171"
"chr18","38534181","38534472","GL873530","16647228","16647517","88","21886953"
"chr18","40323946","40324236","GL873541","16268070","16268366","85","24055876"
"chr18","40465282","40465583","GL873541","16268070","16268366","84","24197212"
"chr18","40545336","40545624","GL873547","2222074","2222356","79","38323262"
"chr18","41891395","41891674","GL873547","2222074","2222356","81","39669321"
"chr18","42605815","42606126","GL873528","36697151","36697434","100","5908664"
"chr18","42916223","42916500","GL873562","3299887","3300144","87","39616336"
"chr18","43718859","43719161","GL873607","1418062","1418355","93","42300797"
"chr18","43840011","43840319","GL873541","16268070","16268366","93","27571941"
"chr18","44016665","44016956","GL873530","16647228","16647517","74","27369437"
"chr18","44693649","44693911","GL873562","3299887","3300144","90","41393762"
"chr18","44730857","44731152","GL873530","16647228","16647517","82","28083629"
"chr18","45579140","45579432","GL873667","4451263","4451534","92","41127877"
"chr18","45864219","45864526","GL873547","2222074","2222356","97","43642145"
"chr18","45933723","45934001","GL873547","2222074","2222356","82","43711649"
"chr18","46602661","46602964","GL873530","16647228","16647517","90","29955433"
"chr18","46685337","46685391","GL873527","37742071","37742124","23","8943266"
"chr18","46790740","46791047","GL873541","16268070","16268366","94","30522670"
"chr18","47379651","47379956","GL873530","16647228","16647517","93","30732423"
"chr18","47444253","47444436","GL873574","7318344","7318500","60","40125909"
"chr18","48078873","48079197","GL873541","16268070","16268366","100","31810803"
"chr18","48372580","48372868","GL873530","16647228","16647517","79","31725352"
"chr18","48374388","48374692","GL873608","6630366","6630673","94","41744022"
"chr18","48422122","48422424","GL873541","16268070","16268366","86","32154052"
"chr18","48451500","48451793","GL873530","16647228","16647517","82","31804272"
"chr18","48664324","48664457","GL873550","5998776","5998900","40","42665548"
"chr18","48757995","48758274","GL873562","3299887","3300144","89","45458108"
"chr18","48766597","48766883","GL873547","2222074","2222356","84","46544523"
"chr18","48797105","48797395","GL873530","16647228","16647517","80","32149877"
"chr18","48843999","48844257","GL873528","25203621","25203847","90","23640378"
"chr18","48953277","48953567","GL873530","16647228","16647517","82","32306049"
"chr18","50480888","50481183","GL873752","427788","428097","84","50053100"
"chr18","50541266","50541575","GL873541","16268070","16268366","100","34273196"
"chr18","50692277","50692584","GL873541","16268070","16268366","96","34424207"
"chr18","51117684","51117913","GL873531","3555300","3555500","79","47562384"
"chr18","51305857","51306142","GL873547","2222074","2222356","77","49083783"
"chr18","52129503","52129615","GL873622","7076274","7076365","41","45053229"
"chr18","52346389","52346698","GL873541","16268070","16268366","90","36078319"
"chr18","52470314","52470423","GL873587","10002051","10002151","46","42468263"
"chr18","52637479","52637751","GL873528","36697151","36697434","98","15940328"
"chr18","52888108","52888407","GL873530","16647228","16647517","84","36240880"
"chr18","53139086","53139381","GL873607","1418062","1418355","87","51721024"
"chr18","53369128","53369429","GL873528","36697151","36697434","95","16671977"
"chr18","53447084","53447389","GL873607","1418062","1418355","87","52029022"
"chr18","53847958","53848252","GL873547","2222074","2222356","82","51625884"
"chr18","53919638","53919947","GL873607","1418062","1418355","91","52501576"
"chr18","54015920","54016212","GL873541","16268070","16268366","98","37747850"
"chr18","54069495","54069763","GL873659","913070","913333","86","53156425"
"chr18","55332902","55333218","GL873541","16268070","16268366","94","39064832"
"chr18","55709578","55709871","GL873541","16268070","16268366","95","39441508"
"chr18","55842191","55842463","GL873562","3299887","3300144","86","52542304"
"chr18","56250403","56250708","GL873528","36697151","36697434","96","19553252"
"chr18","56422673","56422972","GL873541","16268070","16268366","85","40154603"
"chr18","56511205","56511496","GL873530","16647228","16647517","84","39863977"
"chr18","56643082","56643274","GL873630","2508568","2508753","71","54134514"
"chr18","56777325","56777608","GL873547","2222074","2222356","82","54555251"
"chr18","57008389","57008679","GL873530","16647228","16647517","78","40361161"
"chr18","57095672","57095978","GL873667","4451263","4451534","93","52644409"
"chr18","57121227","57121526","GL873607","1418062","1418355","88","55703165"
"chr18","57336811","57337111","GL873541","16268070","16268366","88","41068741"
"chr18","57557636","57557933","GL873530","16647228","16647517","87","40910408"
"chr18","57613383","57613665","GL873530","16647228","16647517","86","40966155"
"chr18","57627982","57628265","GL873547","2222074","2222356","80","55405908"
"chr18","57944067","57944358","GL873607","1418062","1418355","84","56526005"
"chr18","58360894","58361171","GL873562","3299887","3300144","88","55061007"
"chr18","58384417","58384706","GL873562","3299887","3300144","93","55084530"
"chr18","58491433","58491716","GL873547","2222074","2222356","76","56269359"
"chr18","58803152","58803403","GL873528","25203621","25203847","92","33599531"
"chr18","58836864","58837013","GL873550","5998776","5998900","49","52838088"
"chr18","58895458","58895765","GL873541","16268070","16268366","93","42627388"
"chr18","58946337","58946628","GL873530","16647228","16647517","82","42299109"
"chr18","59087951","59088242","GL873565","12307556","12307825","106","46780395"
"chr18","59131562","59131861","GL873528","36697151","36697434","85","22434411"
"chr18","59212343","59212630","GL873530","16647228","16647517","82","42565115"
"chr18","59336926","59337219","GL873547","2222074","2222356","80","57114852"
"chr18","59406361","59406649","GL873547","2222074","2222356","81","57184287"
"chr18","59659868","59660147","GL873547","2222074","2222356","85","57437794"
"chr18","59834146","59834452","GL873530","16647228","16647517","92","43186918"
"chr18","59850632","59850929","GL873530","16647228","16647517","85","43203404"
"chr18","59887230","59887528","GL873547","2222074","2222356","90","57665156"
"chr18","60006901","60007191","GL873541","16268070","16268366","89","43738831"
"chr18","60104533","60104744","GL873531","3555300","3555500","71","56549233"
"chr18","60106939","60107219","GL873547","2222074","2222356","91","57884865"
"chr18","60273888","60274151","GL873562","3299887","3300144","86","56974001"
"chr18","61038979","61039288","GL873541","16268070","16268366","94","44770909"
"chr18","61784480","61784788","GL873541","16268070","16268366","90","45516410"
"chr18","61812763","61813070","GL873528","36697151","36697434","94","25115612"
"chr18","61865572","61865865","GL873547","2222074","2222356","84","59643498"
"chr18","61943690","61943989","GL873547","2222074","2222356","89","59721616"
"chr18","62022139","62022304","GL873530","5593486","5593649","39","56428653"
"chr18","62085302","62085612","GL873547","2222074","2222356","95","59863228"
"chr18","62626281","62626580","GL873530","16647228","16647517","85","45979053"
"chr18","62793664","62793960","GL873530","16647228","16647517","82","46146436"
"chr18","62796034","62796330","GL873541","16268070","16268366","80","46527964"
"chr18","62969000","62969302","GL873547","2222074","2222356","94","60746926"
"chr18","63000447","63000743","GL873547","2222074","2222356","80","60778373"
"chr18","63015245","63015360","GL873552","12711845","12711956","39","50303400"
"chr18","63667667","63667974","GL873530","16647228","16647517","90","47020439"
"chr18","63833457","63833758","GL873541","16268070","16268366","81","47565387"
"chr18","63855086","63855381","GL873541","16268070","16268366","84","47587016"
"chr18","65454613","65454918","GL873541","16268070","16268366","92","49186543"
"chr18","65492271","65492578","GL873541","16268070","16268366","90","49224201"
"chr18","65923490","65923797","GL873541","16268070","16268366","93","49655420"
"chr18","66159968","66160280","GL873608","6630366","6630673","91","59529602"
"chr18","66241210","66241505","GL873530","16647228","16647517","87","49593982"
"chr18","66277752","66278059","GL873541","16268070","16268366","92","50009682"
"chr18","66358038","66358323","GL873541","16268070","16268366","86","50089968"
"chr18","66416378","66416670","GL873547","2222074","2222356","80","64194304"
"chr18","67004562","67004871","GL873547","2222074","2222356","98","64782488"
"chr18","67256154","67256451","GL873541","16268070","16268366","85","50988084"
"chr18","68029598","68029875","GL873565","12307556","12307825","92","55722042"
"chr18","68076040","68076170","GL873622","7076274","7076365","55","60999766"
"chr18","68668421","68668651","GL873680","3005257","3005482","72","65663164"
"chr18","68672926","68673221","GL873608","6630366","6630673","84","62042560"
"chr18","69416301","69416587","GL873530","16647228","16647517","88","52769073"
"chr18","70053265","70053548","GL873547","2222074","2222356","89","67831191"
"chr18","70514987","70515276","GL873530","16647228","16647517","83","53867759"
"chr18","70844520","70844839","GL873530","16647228","16647517","101","54197292"
"chr18","70941881","70942195","GL873607","1418062","1418355","92","69523819"
"chr18","71127519","71127809","GL873547","2222074","2222356","82","68905445"
"chr19","14679876","14680182","GL873607","1418062","1418355","94","13261814"
"chr19","1342889","1343180","GL873530","16647228","16647517","78","15304339"
"chr19","1360160","1360394","GL873528","25203621","25203847","84","23843461"
"chr19","1399966","1400272","GL873541","16268070","16268366","83","14868104"
"chr19","1420753","1421050","GL873547","2222074","2222356","87","801321"
"chr19","1443891","1444179","GL873530","16647228","16647517","84","15203337"
"chr19","1463318","1463615","GL873547","2222074","2222356","83","758756"
"chr19","1538482","1538767","GL873547","2222074","2222356","80","683592"
"chr19","1544623","1544917","GL873530","16647228","16647517","80","15102605"
"chr19","1572490","1572787","GL873530","16647228","16647517","85","15074738"
"chr19","1619677","1619982","GL873608","6630366","6630673","92","5010689"
"chr19","1667927","1668212","GL873812","559768","560073","99","1108159"
"chr19","1845336","1845629","GL873547","2222074","2222356","90","376738"
"chr19","1906987","1907283","GL873541","16268070","16268366","78","14361083"
"chr19","2639598","2639884","GL873530","16647228","16647517","88","14007630"
"chr19","2749303","2749611","GL873547","2222074","2222356","91","527229"
"chr19","3054442","3054736","GL873530","16647228","16647517","80","13592786"
"chr19","3780530","3780843","GL873541","16268070","16268366","101","12487540"
"chr19","3824747","3825090","GL873608","6630366","6630673","115","2805619"
"chr19","3829007","3829310","GL873541","16268070","16268366","86","12439063"
"chr19","3869969","3870272","GL873541","16268070","16268366","88","12398101"
"chr19","4180398","4180669","GL873562","3299887","3300144","81","880511"
"chr19","4224754","4225049","GL873547","2222074","2222356","81","2002680"
"chr19","4243520","4243825","GL873541","16268070","16268366","92","12024550"
"chr19","4337028","4337312","GL873547","2222074","2222356","98","2114954"
"chr19","4455651","4455943","GL873547","2222074","2222356","82","2233577"
"chr19","4670484","4670791","GL873608","6630366","6630673","92","1959882"
"chr19","4774539","4774847","GL873541","16268070","16268366","87","11493531"
"chr19","4826515","4826812","GL873530","16647228","16647517","86","11820713"
"chr19","4851890","4852182","GL873547","2222074","2222356","78","2629816"
"chr19","5046304","5046574","GL873680","3005257","3005482","94","2041047"
"chr19","5175701","5176005","GL873541","16268070","16268366","87","11092369"
"chr19","5299709","5300020","GL873528","36697151","36697434","97","31397442"
"chr19","5788914","5789210","GL873547","2222074","2222356","98","3566840"
"chr19","6060552","6060849","GL873530","16647228","16647517","91","10586676"
"chr19","6145571","6145870","GL873530","16647228","16647517","84","10501657"
"chr19","6645939","6646246","GL873541","16268070","16268366","96","9622131"
"chr19","6722225","6722513","GL873528","36697151","36697434","101","29974926"
"chr19","7311327","7311613","GL873541","16268070","16268366","92","8956743"
"chr19","7438706","7439011","GL873541","16268070","16268366","89","8829364"
"chr19","7470089","7470269","GL873530","5593486","5593649","51","1876603"
"chr19","7506313","7506447","GL873552","12711845","12711956","59","5205532"
"chr19","7551087","7551362","GL873547","2222074","2222356","86","5329013"
"chr19","7560297","7560596","GL873541","16268070","16268366","89","8707773"
"chr19","7637482","7637779","GL873607","1418062","1418355","86","6219420"
"chr19","7868066","7868380","GL873541","16268070","16268366","108","8400004"
"chr19","7984494","7984775","GL873667","4451263","4451534","80","3533231"
"chr19","8835705","8836005","GL873541","16268070","16268366","89","7432365"
"chr19","8893838","8893978","GL873524","43272770","43272878","62","34378932"
"chr19","8894278","8894413","GL873550","5998776","5998900","36","2895502"
"chr19","9183176","9183468","GL873541","16268070","16268366","82","7084894"
"chr19","9484517","9484808","GL873541","16268070","16268366","90","6783553"
"chr19","9646806","9647109","GL873607","1418062","1418355","86","8228744"
"chr19","9988194","9988371","GL873530","5593486","5593649","56","4394708"
"chr19","11055461","11055750","GL873547","2222074","2222356","82","8833387"
"chr19","11220843","11221122","GL873547","2222074","2222356","83","8998769"
"chr19","11544687","11544855","GL873530","5593486","5593649","39","5951201"
"chr19","11545173","11545248","GL873554","10500008","10500061","30","1045165"
"chr19","11596437","11596508","GL873524","36505249","36505303","38","24908812"
"chr19","11640355","11640634","GL873528","36697151","36697434","94","25056796"
"chr19","11648137","11648414","GL873547","2222074","2222356","92","9426063"
"chr19","11666836","11667125","GL873530","16647228","16647517","85","4980392"
"chr19","11685568","11685863","GL873541","16268070","16268366","83","4582502"
"chr19","12267489","12267722","GL873564","8360716","8360913","83","3906773"
"chr19","12483703","12484011","GL873541","16268070","16268366","91","3784367"
"chr19","12716375","12716670","GL873547","2222074","2222356","84","10494301"
"chr19","12819456","12819705","GL873543","13038674","13038909","87","219218"
"chr19","12992619","12992824","GL873558","7532067","7532273","51","5460552"
"chr19","13280446","13280590","GL873550","5998776","5998900","48","7281670"
"chr19","13280888","13280967","GL873622","7076274","7076365","35","6204614"
"chr19","13469698","13470007","GL873752","427788","428097","92","13041910"
"chr19","13476428","13476720","GL873530","16647228","16647517","86","3170800"
"chr19","13608773","13609025","GL873528","25203621","25203847","83","11594848"
"chr19","13647282","13647444","GL873574","7318344","7318500","58","6328938"
"chr19","13653636","13653901","GL873680","3005257","3005482","94","10648379"
"chr19","13688603","13688716","GL873552","12711845","12711956","40","976758"
"chr19","13740077","13740374","GL873547","2222074","2222356","88","11518003"
"chr19","13834726","13835013","GL873530","16647228","16647517","90","2812502"
"chr19","14152924","14153058","GL873550","5998776","5998900","38","8154148"
"chr19","14189758","14190064","GL873541","16268070","16268366","88","2078312"
"chr19","14277492","14277793","GL873541","16268070","16268366","83","1990578"
"chr19","14293538","14293834","GL873547","2222074","2222356","84","12071464"
"chr19","14294461","14294751","GL873547","2222074","2222356","90","12072387"
"chr19","14320614","14320747","GL873550","5998776","5998900","39","8321838"
"chr19","14410428","14410724","GL873541","16268070","16268366","94","1857642"
"chr19","14499102","14499393","GL873530","16647228","16647517","82","2148126"
"chr19","14573843","14573905","GL873554","10500008","10500061","24","4073835"
"chr19","14574275","14574579","GL873608","6630366","6630673","87","7943909"
"chr19","14589344","14589638","GL873547","2222074","2222356","87","12367270"
"chr19","14590355","14590645","GL873530","16647228","16647517","88","2056873"
"chr19","14623177","14623470","GL873607","1418062","1418355","83","13205115"
"chr19","14641039","14641163","GL873550","5998776","5998900","43","8642263"
"chr19","14678330","14678623","GL873530","16647228","16647517","83","1968898"
"chr19","15214670","15214974","GL873547","2222074","2222356","87","12992596"
"chr19","15314187","15314563","GL873559","3737111","3737481","114","11577076"
"chr19","15400824","15401133","GL873528","36697151","36697434","93","21296327"
"chr19","15438849","15439143","GL873530","16647228","16647517","83","1208379"
"chr19","15464805","15465074","GL873565","12307556","12307825","96","3157249"
"chr19","15840693","15840998","GL873528","36697151","36697434","91","20856458"
"chr19","16377115","16377447","GL873752","427788","428097","108","15949327"
"chr19","16574920","16575197","GL873528","36697151","36697434","93","20122231"
"chr19","16794960","16795269","GL873541","16268070","16268366","100","526890"
"chr19","16893479","16893663","GL873823","304319","304508","51","16589160"
"chr19","17362399","17362633","GL873543","13038674","13038909","89","4323725"
"chr19","17666137","17666438","GL873608","6630366","6630673","87","11035771"
"chr19","17725155","17725469","GL873541","16268070","16268366","96","1457085"
"chr19","18052906","18053205","GL873541","16268070","16268366","83","1784836"
"chr19","18073568","18073846","GL873530","16647228","16647517","86","1426340"
"chr19","18124784","18124958","GL873524","42560728","42560902","50","24435944"
"chr19","18125223","18125238","GL873691","2903502","2903535","21","15221721"
"chr19","18231589","18231878","GL873607","1418062","1418355","82","16813527"
"chr19","18430234","18430538","GL873541","16268070","16268366","92","2162164"
"chr19","18488433","18488740","GL873541","16268070","16268366","92","2220363"
"chr19","18980878","18981173","GL873547","2222074","2222356","84","16758804"
"chr19","19203666","19203967","GL873530","16647228","16647517","85","2556438"
"chr19","19336208","19336496","GL873547","2222074","2222356","73","17114134"
"chr19","20171476","20171751","GL873547","5449763","5449997","88","14721713"
"chr19","20543714","20544018","GL873541","16268070","16268366","81","4275644"
"chr19","20545323","20545613","GL873530","16647228","16647517","79","3898095"
"chr19","20561177","20561475","GL873541","16268070","16268366","90","4293107"
"chr19","20678144","20678174","GL873691","2903502","2903535","20","17774642"
"chr19","20678473","20678556","GL873526","41481654","41481719","29","20803181"
"chr19","20750091","20750380","GL873530","16647228","16647517","81","4102863"
"chr19","20911044","20911339","GL873541","16268070","16268366","84","4642974"
"chr19","20956765","20956929","GL873530","5593486","5593649","57","15363279"
"chr19","20965127","20965452","GL873541","16268070","16268366","102","4697057"
"chr19","20968873","20969172","GL873541","16268070","16268366","83","4700803"
"chr19","21057723","21058000","GL873562","3299887","3300144","86","17757836"
"chr19","21107721","21107998","GL873562","3299887","3300144","82","17807834"
"chr19","21331770","21332052","GL873547","2222074","2222356","92","19109696"
"chr19","21625770","21626065","GL873547","2222074","2222356","89","19403696"
"chr19","21833869","21834165","GL873541","16268070","16268366","88","5565799"
"chr19","21852620","21852921","GL873541","16268070","16268366","90","5584550"
"chr19","21959879","21960044","GL873530","5593486","5593649","40","16366393"
"chr19","21981413","21981712","GL873547","2222074","2222356","84","19759339"
"chr19","22110792","22111089","GL873541","16268070","16268366","86","5842722"
"chr19","22145953","22146248","GL873607","1418062","1418355","84","20727891"
"chr19","22626676","22626983","GL873541","16268070","16268366","88","6358606"
"chr19","22874254","22874549","GL873541","16268070","16268366","86","6606184"
"chr19","22970264","22970562","GL873541","16268070","16268366","77","6702194"
"chr19","23032019","23032313","GL873547","2222074","2222356","82","20809945"
"chr19","23222637","23222949","GL873528","36697151","36697434","106","13474514"
"chr19","23277736","23277747","GL873691","2903502","2903535","24","20374234"
"chr19","23277795","23278074","GL873547","2222074","2222356","84","21055721"
"chr19","23425164","23425442","GL873659","913070","913333","78","22512094"
"chr19","23436290","23436596","GL873541","16268070","16268366","93","7168220"
"chr19","23482943","23483259","GL873528","36697151","36697434","107","13214208"
"chr19","23568570","23568839","GL873565","12307556","12307825","92","11261014"
"chr19","23612725","23612996","GL873547","2222074","2222356","89","21390651"
"chr19","23653981","23654254","GL873659","913070","913333","85","22740911"
"chr19","23677129","23677223","GL873622","7076274","7076365","36","16600855"
"chr19","23855744","23856050","GL873541","16268070","16268366","89","7587674"
"chr19","24011555","24011845","GL873547","2222074","2222356","75","21789481"
"chr19","24016143","24016436","GL873530","16647228","16647517","85","7368915"
"chr19","24190814","24191113","GL873752","427788","428097","88","23763026"
"chr19","24215041","24215262","GL873680","3005257","3005482","73","21209784"
"chr19","24264162","24264461","GL873541","16268070","16268366","83","7996092"
"chr19","24275439","24275569","GL873550","5998776","5998900","36","18276663"
"chr19","24289380","24289508","GL873552","12711845","12711956","51","11577535"
"chr19","24473267","24473575","GL873547","2222074","2222356","93","22251193"
"chr19","24558592","24558901","GL873547","2222074","2222356","94","22336518"
"chr19","24560038","24560332","GL873752","427788","428097","81","24132250"
"chr19","24767212","24767509","GL873528","36697151","36697434","103","11929939"
"chr19","25007864","25008194","GL873541","16268070","16268366","112","8739794"
"chr19","25219106","25219401","GL873667","4451263","4451534","89","20767843"
"chr19","25246421","25246725","GL873541","16268070","16268366","90","8978351"
"chr19","25294199","25294490","GL873530","16647228","16647517","81","8646971"
"chr19","25619987","25620097","GL873526","41480965","41481045","44","15860978"
"chr19","26059027","26059331","GL873541","16268070","16268366","90","9790957"
"chr19","27584635","27584934","GL873541","16268070","16268366","80","11316565"
"chr19","27597125","27597435","GL873541","16268070","16268366","97","11329055"
"chr19","27770146","27770436","GL873547","2222074","2222356","90","25548072"
"chr19","27973655","27973942","GL873530","16647228","16647517","89","11326427"
"chr19","28006594","28006900","GL873752","427788","428097","90","27578806"
"chr19","28076723","28077030","GL873528","36697151","36697434","94","8620428"
"chr19","28144135","28144428","GL873530","16647228","16647517","79","11496907"
"chr19","28145373","28145669","GL873547","2222074","2222356","83","25923299"
"chr19","28617342","28617634","GL873530","16647228","16647517","85","11970114"
"chr19","28790804","28791063","GL873528","25203621","25203847","84","3587183"
"chr19","28965984","28966286","GL873530","16647228","16647517","89","12318756"
"chr19","29005487","29005766","GL873547","2222074","2222356","93","26783413"
"chr19","29005790","29005923","GL873550","5998776","5998900","39","23007014"
"chr19","29098996","29099298","GL873541","16268070","16268366","88","12830926"
"chr19","29117482","29117789","GL873541","16268070","16268366","94","12849412"
"chr19","29618607","29618903","GL873528","36697151","36697434","97","7078544"
"chr19","30452217","30452526","GL873541","16268070","16268366","95","14184147"
"chr19","30566231","30566499","GL873547","5449763","5449997","90","25116468"
"chr19","32109724","32110007","GL873562","3299887","3300144","100","28809837"
"chr19","32408780","32409083","GL873541","16268070","16268366","85","16140710"
"chr19","32537919","32538213","GL873541","16268070","16268366","90","16269849"
"chr19","32620355","32620659","GL873541","16268070","16268366","84","16352285"
"chr19","32627075","32627382","GL873541","16268070","16268366","92","16359005"
"chr19","32846424","32846722","GL873541","16268070","16268366","86","16578354"
"chr20","92274401","92274692","GL873607","1418062","1418355","85","90856339"
"chr20","89259957","89260237","GL873547","2222074","2222356","80","87037883"
"chr20","1542840","1543146","GL873607","1418062","1418355","94","124778"
"chr20","1575953","1576241","GL873541","16268070","16268366","90","14692117"
"chr20","2055087","2055380","GL873547","2222074","2222356","83","166987"
"chr20","2373193","2373503","GL873530","16647228","16647517","95","14274035"
"chr20","2572853","2572988","GL873550","5998776","5998900","37","3425923"
"chr20","2776708","2776868","GL873530","5593486","5593649","55","2816778"
"chr20","2854395","2854680","GL873547","2222074","2222356","77","632321"
"chr20","2863501","2863806","GL873541","16268070","16268366","91","13404569"
"chr20","2957027","2957333","GL873541","16268070","16268366","91","13311043"
"chr20","2980917","2981208","GL873541","16268070","16268366","87","13287153"
"chr20","3027129","3027428","GL873541","16268070","16268366","91","13240941"
"chr20","3039251","3039543","GL873565","12307556","12307825","103","9268305"
"chr20","3617265","3617567","GL873607","1418062","1418355","86","2199203"
"chr20","4202694","4202981","GL873530","16647228","16647517","93","12444534"
"chr20","4278487","4278750","GL873547","5449763","5449997","89","1171276"
"chr20","4711180","4711489","GL873528","36697151","36697434","102","31985971"
"chr20","5697394","5697580","GL873823","304319","304508","62","5393075"
"chr20","5754915","5755208","GL873547","2222074","2222356","87","3532841"
"chr20","5788534","5788836","GL873528","36697151","36697434","87","30908617"
"chr20","5874216","5874521","GL873752","427788","428097","102","5446428"
"chr20","5894961","5895262","GL873608","6630366","6630673","90","735405"
"chr20","6744991","6745295","GL873528","36697151","36697434","89","29952160"
"chr20","6799163","6799446","GL873659","913070","913333","88","5886093"
"chr20","7088271","7088433","GL873530","5593486","5593649","56","1494785"
"chr20","7351639","7351940","GL873530","16647228","16647517","94","9295589"
"chr20","7353494","7353791","GL873541","16268070","16268366","88","8914576"
"chr20","7645500","7645790","GL873547","2222074","2222356","87","5423426"
"chr20","7668107","7668299","GL873554","16339732","16339922","57","8671625"
"chr20","7782493","7782644","GL873628","6402015","6402153","53","1380478"
"chr20","7803297","7803595","GL873541","16268070","16268366","89","8464773"
"chr20","7876234","7876541","GL873541","16268070","16268366","84","8391836"
"chr20","7992575","7992723","GL873529","2453810","2453957","52","5538765"
"chr20","8022853","8023159","GL873541","16268070","16268366","87","8245217"
"chr20","8155131","8155440","GL873541","16268070","16268366","92","8112939"
"chr20","8290377","8290669","GL873667","4451263","4451534","93","3839114"
"chr20","8310069","8310365","GL873530","16647228","16647517","97","8337159"
"chr20","8475141","8475436","GL873541","16268070","16268366","89","7792929"
"chr20","8500225","8500441","GL873531","3555300","3555500","65","4944925"
"chr20","8697119","8697417","GL873530","16647228","16647517","86","7950109"
"chr20","8711683","8711994","GL873659","913070","913333","124","7798613"
"chr20","8775747","8775906","GL873585","9209559","9209725","56","433812"
"chr20","9177171","9177460","GL873528","36697151","36697434","104","27519980"
"chr20","9221409","9221703","GL873547","2222074","2222356","87","6999335"
"chr20","9391794","9392104","GL873608","6630366","6630673","95","2761428"
"chr20","9447551","9447844","GL873530","16647228","16647517","85","7199677"
"chr20","9448039","9448298","GL873535","4830564","4830824","85","4617475"
"chr20","9585418","9585722","GL873541","16268070","16268366","94","6682652"
"chr20","9645293","9645416","GL873550","5998776","5998900","37","3646517"
"chr20","9715731","9715887","GL873585","9209559","9209725","58","506172"
"chr20","9842411","9842688","GL873562","3299887","3300144","77","6542524"
"chr20","9904240","9904456","GL873538","2567037","2567262","70","7337203"
"chr20","9932490","9932798","GL873541","16268070","16268366","93","6335580"
"chr20","9945006","9945308","GL873530","16647228","16647517","94","6702222"
"chr20","10081208","10081344","GL873550","5998776","5998900","39","4082432"
"chr20","10113525","10113796","GL873562","3299887","3300144","89","6813638"
"chr20","10246109","10246234","GL873550","5998776","5998900","41","4247333"
"chr20","10398464","10398793","GL873541","16268070","16268366","107","5869606"
"chr20","10416743","10417002","GL873680","3005257","3005482","89","7411486"
"chr20","10816544","10816837","GL873530","16647228","16647517","87","5830684"
"chr20","11734118","11734411","GL873541","16268070","16268366","91","4533952"
"chr20","11809234","11809359","GL873552","12711845","12711956","47","902611"
"chr20","11899342","11899624","GL873547","2222074","2222356","81","9677268"
"chr20","11958525","11958823","GL873547","2222074","2222356","91","9736451"
"chr20","12046078","12046376","GL873608","6630366","6630673","91","5415712"
"chr20","12227642","12227920","GL873562","3299887","3300144","87","8927755"
"chr20","12317777","12318085","GL873541","16268070","16268366","87","3950293"
"chr20","12355010","12355158","GL873521","1458597","1458764","54","10896413"
"chr20","12441664","12441997","GL873547","2222074","2222356","116","10219590"
"chr20","12536630","12536915","GL873528","36697151","36697434","87","24160521"
"chr20","12564292","12564582","GL873547","2222074","2222356","82","10342218"
"chr20","13016005","13016304","GL873547","2222074","2222356","79","10793931"
"chr20","13058406","13058680","GL873667","4451263","4451534","79","8607143"
"chr20","13211807","13212087","GL873547","2222074","2222356","88","10989733"
"chr20","13734549","13734823","GL873530","16647228","16647517","94","2912679"
"chr20","13784113","13784421","GL873752","427788","428097","89","13356325"
"chr20","14485624","14485926","GL873541","16268070","16268366","86","1782446"
"chr20","14658462","14658743","GL873528","36697151","36697434","89","22038689"
"chr20","14698104","14698386","GL873547","2222074","2222356","87","12476030"
"chr20","14825008","14825336","GL873528","36697151","36697434","102","21872143"
"chr20","14911932","14912241","GL873541","16268070","16268366","101","1356138"
"chr20","15047400","15047694","GL873659","913070","913333","90","14134330"
"chr20","15141410","15141714","GL873530","16647228","16647517","95","1505818"
"chr20","15412966","15413244","GL873528","36697151","36697434","91","21284185"
"chr20","15459981","15460260","GL873547","2222074","2222356","87","13237907"
"chr20","15681789","15682075","GL873530","16647228","16647517","84","965439"
"chr20","16264148","16264271","GL873622","7076274","7076365","49","9187874"
"chr20","16464290","16464599","GL873528","36697151","36697434","90","20232861"
"chr20","16704211","16704502","GL873607","1418062","1418355","85","15286149"
"chr20","16829288","16829594","GL873528","36697151","36697434","94","19867863"
"chr20","17662966","17663263","GL873530","16647228","16647517","90","1015738"
"chr20","17765416","17765720","GL873541","16268070","16268366","89","1497346"
"chr20","18819408","18819706","GL873547","2222074","2222356","81","16597334"
"chr20","18960245","18960549","GL873530","16647228","16647517","91","2313017"
"chr20","19696823","19697119","GL873547","2222074","2222356","84","17474749"
"chr20","19842108","19842392","GL873530","16647228","16647517","87","3194880"
"chr20","19843709","19844017","GL873541","16268070","16268366","85","3575639"
"chr20","20056181","20056476","GL873530","16647228","16647517","92","3408953"
"chr20","20423204","20423493","GL873547","2222074","2222356","82","18201130"
"chr20","20494786","20495064","GL873607","1418062","1418355","88","19076724"
"chr20","20528335","20528616","GL873547","2222074","2222356","79","18306261"
"chr20","20540590","20540902","GL873547","2222074","2222356","108","18318516"
"chr20","20611182","20611356","GL873574","7318344","7318500","66","13292838"
"chr20","20635550","20635688","GL873628","6402015","6402153","53","14233535"
"chr20","20635699","20635837","GL873628","6402015","6402153","53","14233684"
"chr20","20647041","20647170","GL873550","5998776","5998900","32","14648265"
"chr20","20665222","20665528","GL873541","16268070","16268366","92","4397152"
"chr20","20756309","20756612","GL873608","6630366","6630673","88","14125943"
"chr20","21864397","21864722","GL873528","36697151","36697434","141","14832754"
"chr20","22975602","22975903","GL873608","6630366","6630673","93","16345236"
"chr20","23291015","23291325","GL873530","16647228","16647517","94","6643787"
"chr20","24124614","24124902","GL873530","16647228","16647517","86","7477386"
"chr20","24379895","24380200","GL873541","16268070","16268366","91","8111825"
"chr20","24582017","24582239","GL873531","3555300","3555500","68","21026717"
"chr20","24901179","24901477","GL873541","16268070","16268366","84","8633109"
"chr20","25260614","25260895","GL873547","2222074","2222356","86","23038540"
"chr20","25260925","25260981","GL873603","2092652","2092704","31","23168273"
"chr20","25466877","25467184","GL873541","16268070","16268366","94","9198807"
"chr20","26050879","26051186","GL873541","16268070","16268366","92","9782809"
"chr20","26242242","26242540","GL873541","16268070","16268366","82","9974172"
"chr20","26472952","26473227","GL873565","12307556","12307825","95","14165396"
"chr20","27499106","27499181","GL873526","41481654","41481719","37","13982548"
"chr20","27895657","27895916","GL873680","3005257","3005482","95","24890400"
"chr20","28739337","28739626","GL873530","16647228","16647517","78","12092109"
"chr20","28974656","28974938","GL873547","2222074","2222356","91","26752582"
"chr20","29201830","29202108","GL873562","3299887","3300144","93","25901943"
"chr20","29659326","29659632","GL873607","1418062","1418355","96","28241264"
"chr20","30945437","30945563","GL873550","5998776","5998900","54","24946661"
"chr20","32126996","32127295","GL873541","16268070","16268366","86","15858926"
"chr20","32982274","32982577","GL873541","16268070","16268366","102","16714204"
"chr20","33278984","33279121","GL873552","12711845","12711956","54","20567139"
"chr20","33382196","33382501","GL873541","16268070","16268366","83","17114126"
"chr20","33400582","33400870","GL873547","2222074","2222356","92","31178508"
"chr20","34116873","34117141","GL873528","36697151","36697434","92","2580278"
"chr20","34260294","34260566","GL873607","1418062","1418355","87","32842232"
"chr20","34728052","34728331","GL873562","3299887","3300144","82","31428165"
"chr20","35024371","35024549","GL873585","9209559","9209725","64","25814812"
"chr20","36468992","36469298","GL873541","16268070","16268366","83","20200922"
"chr20","36534759","36535038","GL873547","2222074","2222356","88","34312685"
"chr20","39089189","39089491","GL873547","2222074","2222356","84","36867115"
"chr20","39310180","39310301","GL873550","5998776","5998900","40","33311404"
"chr20","39310331","39310504","GL873530","5593486","5593649","51","33716845"
"chr20","40157817","40158104","GL873530","16647228","16647517","76","23510589"
"chr20","40340235","40340528","GL873547","2222074","2222356","81","38118161"
"chr20","40429594","40429887","GL873547","2222074","2222356","88","38207520"
"chr20","41033339","41033649","GL873608","6630366","6630673","94","34402973"
"chr20","41174014","41174315","GL873541","16268070","16268366","90","24905944"
"chr20","42262438","42262732","GL873528","36697151","36697434","89","5565287"
"chr20","42329826","42330132","GL873530","16647228","16647517","92","25682598"
"chr20","42537731","42537742","GL873691","2903502","2903535","23","39634229"
"chr20","42538049","42538218","GL873530","5593486","5593649","51","36944563"
"chr20","42587405","42587705","GL873541","16268070","16268366","92","26319335"
"chr20","42589070","42589368","GL873541","16268070","16268366","85","26321000"
"chr20","42774949","42775237","GL873547","2222074","2222356","76","40552875"
"chr20","42801402","42801689","GL873547","2222074","2222356","74","40579328"
"chr20","43481001","43481299","GL873541","16268070","16268366","87","27212931"
"chr20","43492147","43492445","GL873547","2222074","2222356","83","41270073"
"chr20","43764497","43764799","GL873541","16268070","16268366","85","27496427"
"chr20","43816721","43817051","GL873541","16268070","16268366","115","27548651"
"chr20","43886824","43887060","GL873680","3005257","3005482","61","40881567"
"chr20","44432930","44433204","GL873755","463833","464092","92","43969097"
"chr20","44512838","44513119","GL873565","12307556","12307825","83","32205282"
"chr20","44522560","44522855","GL873547","2222074","2222356","91","42300486"
"chr20","44573701","44573841","GL873628","6402015","6402153","53","38171686"
"chr20","44712657","44712957","GL873530","16647228","16647517","88","28065429"
"chr20","44796247","44796534","GL873547","2222074","2222356","84","42574173"
"chr20","45126846","45127152","GL873541","16268070","16268366","90","28858776"
"chr20","45847601","45847908","GL873541","16268070","16268366","86","29579531"
"chr20","46628219","46628515","GL873530","16647228","16647517","82","29980991"
"chr20","47354024","47354316","GL873530","16647228","16647517","83","30706796"
"chr20","47857311","47857622","GL873541","16268070","16268366","88","31589241"
"chr20","48012586","48012885","GL873541","16268070","16268366","81","31744516"
"chr20","48280093","48280388","GL873541","16268070","16268366","83","32012023"
"chr20","48407400","48407687","GL873547","2222074","2222356","78","46185326"
"chr20","48765885","48766171","GL873547","2222074","2222356","72","46543811"
"chr20","49682146","49682454","GL873608","6630366","6630673","98","43051780"
"chr20","49698370","49698675","GL873607","1418062","1418355","95","48280308"
"chr20","49737449","49737727","GL873541","16268070","16268366","94","33469379"
"chr20","50446925","50447235","GL873528","36697151","36697434","94","13749774"
"chr20","50996029","50996304","GL873565","12307556","12307825","94","38688473"
"chr20","51533848","51534144","GL873541","16268070","16268366","90","35265778"
"chr20","51764610","51764916","GL873541","16268070","16268366","89","35496540"
"chr20","51886718","51887019","GL873541","16268070","16268366","93","35618648"
"chr20","53248333","53248612","GL873547","2222074","2222356","90","51026259"
"chr20","53248651","53248663","GL873691","2903502","2903535","22","50345149"
"chr20","53677256","53677541","GL873528","36697151","36697434","96","16980105"
"chr20","55424167","55424474","GL873541","16268070","16268366","99","39156097"
"chr20","55515001","55515284","GL873543","13038674","13038909","87","42476327"
"chr20","55561644","55561953","GL873528","36697151","36697434","91","18864493"
"chr20","55600303","55600591","GL873541","16268070","16268366","100","39332233"
"chr20","56267469","56267750","GL873530","16647228","16647517","85","39620241"
"chr20","56741880","56742188","GL873541","16268070","16268366","92","40473810"
"chr20","57295029","57295176","GL873530","5593486","5593649","57","51701543"
"chr20","57388894","57389202","GL873541","16268070","16268366","84","41120824"
"chr20","57400657","57400941","GL873530","16647228","16647517","83","40753429"
"chr20","58024576","58024866","GL873607","1418062","1418355","90","56606514"
"chr20","58290418","58290662","GL873528","25203621","25203847","88","33086797"
"chr20","58772540","58772825","GL873547","2222074","2222356","86","56550466"
"chr20","59050121","59050422","GL873530","16647228","16647517","86","42402893"
"chr20","59121749","59122069","GL873528","36697151","36697434","115","22424598"
"chr20","59846671","59846943","GL873562","3299887","3300144","88","56546784"
"chr20","62674846","62675051","GL873697","3111225","3111427","76","59563621"
"chr20","62789171","62789474","GL873530","16647228","16647517","95","46141943"
"chr20","62806353","62806648","GL873530","16647228","16647517","86","46159125"
"chr20","63151890","63152199","GL873528","36697151","36697434","91","26454739"
"chr20","63242684","63242954","GL873565","12307556","12307825","85","50935128"
"chr20","63573267","63573575","GL873541","16268070","16268366","100","47305197"
"chr20","64427947","64428256","GL873528","36697151","36697434","112","27730796"
"chr20","64476995","64477043","GL873731","2008517","2008552","22","62468478"
"chr20","64718615","64718914","GL873541","16268070","16268366","84","48450545"
"chr20","64738958","64739251","GL873528","36697151","36697434","99","28041807"
"chr20","65537991","65538291","GL873541","16268070","16268366","90","49269921"
"chr20","65724233","65724526","GL873541","16268070","16268366","90","49456163"
"chr20","66129888","66130179","GL873530","16647228","16647517","87","49482660"
"chr20","66135531","66135828","GL873530","16647228","16647517","88","49488303"
"chr20","66207240","66207531","GL873547","2222074","2222356","82","63985166"
"chr20","66225020","66225327","GL873541","16268070","16268366","88","49956950"
"chr20","66704830","66705118","GL873547","2222074","2222356","80","64482756"
"chr20","67913721","67913907","GL874079","15836","16035","53","67897885"
"chr20","67919534","67919832","GL873541","16268070","16268366","89","51651464"
"chr20","67962984","67963278","GL873530","16647228","16647517","82","51315756"
"chr20","68076677","68076989","GL873528","36697151","36697434","109","31379526"
"chr20","68385003","68385285","GL873528","36697151","36697434","100","31687852"
"chr20","68387995","68388288","GL873659","913070","913333","102","67474925"
"chr20","68991672","68991930","GL873547","5449763","5449997","84","63541909"
"chr20","69549135","69549464","GL873608","6630366","6630673","107","62918769"
"chr20","69572248","69572548","GL873541","16268070","16268366","90","53304178"
"chr20","69645625","69645931","GL873530","16647228","16647517","89","52998397"
"chr20","69775384","69775695","GL873528","36697151","36697434","109","33078233"
"chr20","69887560","69887870","GL873541","16268070","16268366","95","53619490"
"chr20","70096105","70096396","GL873530","16647228","16647517","85","53448877"
"chr20","70273835","70274029","GL873530","5593486","5593649","70","64680349"
"chr20","70396820","70397122","GL873541","16268070","16268366","89","54128750"
"chr20","70630958","70631252","GL873547","2222074","2222356","85","68408884"
"chr20","70868860","70869044","GL873823","304319","304508","55","70564541"
"chr20","70905611","70905774","GL873574","7318344","7318500","53","63587267"
"chr20","71250856","71251020","GL873530","5593486","5593649","51","65657370"
"chr20","71356227","71356358","GL873552","12711845","12711956","50","58644382"
"chr20","71622940","71623234","GL873547","2222074","2222356","83","69400866"
"chr20","72022334","72022667","GL873530","16647228","16647517","121","55375106"
"chr20","72458088","72458365","GL873562","3299887","3300144","93","69158201"
"chr20","72594439","72594710","GL873562","3299887","3300144","84","69294552"
"chr20","72949086","72949362","GL873528","36697151","36697434","93","36251935"
"chr20","73415938","73416228","GL873547","2222074","2222356","83","71193864"
"chr20","73455960","73456258","GL873541","16268070","16268366","86","57187890"
"chr20","73604908","73605140","GL873640","6426205","6426399","75","67178703"
"chr20","73921736","73921930","GL873535","24407607","24407780","52","49514129"
"chr20","74233827","74234107","GL873562","3299887","3300144","84","70933940"
"chr20","74306891","74307190","GL873541","16268070","16268366","89","58038821"
"chr20","74424969","74425077","GL873587","10002051","10002151","46","64422918"
"chr20","75574710","75575008","GL873530","16647228","16647517","86","58927482"
"chr20","75579562","75579861","GL873528","36697151","36697434","92","38882411"
"chr20","75650890","75651194","GL873547","2222074","2222356","97","73428816"
"chr20","77676897","77677178","GL873547","2222074","2222356","77","75454823"
"chr20","77736245","77736497","GL873680","3005257","3005482","85","74730988"
"chr20","77796937","77797236","GL873541","16268070","16268366","82","61528867"
"chr20","78433258","78433570","GL873541","16268070","16268366","98","62165188"
"chr20","78459553","78459854","GL873528","36697151","36697434","90","41762402"
"chr20","78791369","78791657","GL873547","2222074","2222356","78","76569295"
"chr20","78878063","78878365","GL873608","6630366","6630673","93","72247697"
"chr20","78903029","78903335","GL873541","16268070","16268366","82","62634959"
"chr20","78995008","78995313","GL873541","16268070","16268366","95","62726938"
"chr20","79056074","79056384","GL873541","16268070","16268366","88","62788004"
"chr20","79113807","79113972","GL873524","42560728","42560902","53","36553079"
"chr20","79189002","79189302","GL873752","427788","428097","81","78761214"
"chr20","79223125","79223429","GL873541","16268070","16268366","90","62955055"
"chr20","79320827","79321119","GL873541","16268070","16268366","83","63052757"
"chr20","79769199","79769507","GL873541","16268070","16268366","90","63501129"
"chr20","80015270","80015379","GL873587","10002051","10002151","35","70013219"
"chr20","80045924","80046226","GL873607","1418062","1418355","91","78627862"
"chr20","80098449","80098745","GL873547","2222074","2222356","87","77876375"
"chr20","80178770","80179019","GL873640","6426205","6426399","87","73752565"
"chr20","80223686","80223976","GL873541","16268070","16268366","85","63955616"
"chr20","80226440","80226734","GL873541","16268070","16268366","85","63958370"
"chr20","80433143","80433297","GL873611","3799989","3800137","46","76633154"
"chr20","80552940","80553249","GL873530","16647228","16647517","107","63905712"
"chr20","80617936","80618232","GL873530","16647228","16647517","90","63970708"
"chr20","80621483","80621774","GL873547","2222074","2222356","79","78399409"
"chr20","80727402","80727700","GL873541","16268070","16268366","85","64459332"
"chr20","80805508","80805741","GL873640","6426205","6426399","79","74379303"
"chr20","80842005","80842245","GL873524","42560728","42560902","99","38281277"
"chr20","81101451","81101744","GL873541","16268070","16268366","92","64833381"
"chr20","81109545","81109831","GL873562","3299887","3300144","95","77809658"
"chr20","81425913","81426201","GL873547","2222074","2222356","83","79203839"
"chr20","81497334","81497635","GL873541","16268070","16268366","88","65229264"
"chr20","82208929","82209230","GL873541","16268070","16268366","85","65940859"
"chr20","82278808","82279127","GL873541","16268070","16268366","101","66010738"
"chr20","82281276","82281574","GL873541","16268070","16268366","84","66013206"
"chr20","82358227","82358505","GL873562","3299887","3300144","86","79058340"
"chr20","82513308","82513587","GL873659","913070","913333","81","81600238"
"chr20","82765824","82766121","GL873547","2222074","2222356","87","80543750"
"chr20","83109188","83109482","GL873541","16268070","16268366","92","66841118"
"chr20","83471426","83471731","GL873541","16268070","16268366","89","67203356"
"chr20","84336462","84336766","GL873541","16268070","16268366","94","68068392"
"chr20","84837463","84837671","GL873531","3555300","3555500","61","81282163"
"chr20","85565471","85565768","GL873607","1418062","1418355","87","84147409"
"chr20","85656834","85657133","GL873541","16268070","16268366","87","69388764"
"chr20","85893423","85893664","GL873528","25203621","25203847","85","60689802"
"chr20","86288884","86289200","GL873541","16268070","16268366","93","70020814"
"chr20","86559804","86560090","GL873530","16647228","16647517","75","69912576"
"chr20","86668125","86668264","GL873619","2497092","2497229","47","84171033"
"chr20","86695324","86695632","GL873607","1418062","1418355","92","85277262"
"chr20","86713580","86713883","GL873530","16647228","16647517","88","70066352"
"chr20","86981632","86981932","GL873541","16268070","16268366","89","70713562"
"chr20","87036350","87036638","GL873530","16647228","16647517","80","70389122"
"chr20","87067988","87068154","GL873530","5593486","5593649","48","81474502"
"chr20","87171294","87171599","GL873547","2222074","2222356","92","84949220"
"chr20","87182185","87182490","GL873541","16268070","16268366","95","70914115"
"chr20","87189224","87189525","GL873541","16268070","16268366","88","70921154"
"chr20","87198969","87199278","GL873541","16268070","16268366","95","70930899"
"chr20","87237041","87237319","GL873528","36697151","36697434","90","50539890"
"chr20","87241411","87241591","GL873560","5855436","5855580","64","81385975"
"chr20","87325944","87326160","GL873531","3555300","3555500","58","83770644"
"chr20","87363053","87363347","GL873541","16268070","16268366","86","71094983"
"chr20","87797971","87798258","GL873547","2222074","2222356","80","85575897"
"chr20","87928737","87928908","GL873530","5593486","5593649","45","82335251"
"chr20","88040100","88040408","GL873541","16268070","16268366","97","71772030"
"chr20","88046981","88047266","GL873547","2222074","2222356","83","85824907"
"chr20","88060071","88060350","GL873659","913070","913333","94","87147001"
"chr20","88745542","88745849","GL873541","16268070","16268366","82","72477472"
"chr20","88864288","88864576","GL873547","2222074","2222356","81","86642214"
"chr20","89005143","89005452","GL873528","36697151","36697434","92","52307992"
"chr20","89047795","89047990","GL873630","2508568","2508753","63","86539227"
"chr20","89184330","89184629","GL873541","16268070","16268366","83","72916260"
"chr20","89418422","89418589","GL873530","5593486","5593649","42","83824936"
"chr20","89432869","89433043","GL873693","2625207","2625379","57","86807662"
"chr20","89878764","89879039","GL873530","16647228","16647517","91","73231536"
"chr20","90256699","90257010","GL873541","16268070","16268366","94","73988629"
"chr20","90303203","90303504","GL873541","16268070","16268366","88","74035133"
"chr20","90491182","90491314","GL873550","5998776","5998900","37","84492406"
"chr20","90491555","90491793","GL873664","1986243","1986439","89","88505312"
"chr20","90676967","90677264","GL873541","16268070","16268366","94","74408897"
"chr20","91101774","91101885","GL873587","10002051","10002151","42","81099723"
"chr20","91801143","91801448","GL873528","36697151","36697434","95","55103992"
"chr20","91901080","91901373","GL873547","2222074","2222356","91","89679006"
"chr20","91940791","91941094","GL873541","16268070","16268366","89","75672721"
"chr20","91948769","91949036","GL873562","3299887","3300144","93","88648882"
"chr20","92163347","92163636","GL873547","2222074","2222356","82","89941273"
"chr20","92249941","92250224","GL873530","16647228","16647517","87","75602713"
"chr20","92517572","92517879","GL873541","16268070","16268366","93","76249502"
"chr20","92560237","92560542","GL873547","2222074","2222356","94","90338163"
"chr20","92813266","92813569","GL873541","16268070","16268366","78","76545196"
"chr20","92858284","92858582","GL873528","36697151","36697434","89","56161133"
"chr20","92942908","92943201","GL873547","2222074","2222356","87","90720834"
"chr20","92950108","92950404","GL873541","16268070","16268366","87","76682038"
"chr20","93201648","93201945","GL873530","16647228","16647517","87","76554420"
"chr20","93227674","93227983","GL873541","16268070","16268366","90","76959604"
"chr20","93451768","93452074","GL873541","16268070","16268366","91","77183698"
"chr20","93661670","93661987","GL873608","6630366","6630673","104","87031304"
"chr20","93694818","93695111","GL873530","16647228","16647517","78","77047590"
"chr20","93850432","93850741","GL873541","16268070","16268366","91","77582362"
"chr20","93853909","93854194","GL873547","2222074","2222356","84","91631835"
"chr20","93880807","93881104","GL873608","6630366","6630673","100","87250441"
"chr20","93941390","93941702","GL873547","2222074","2222356","94","91719316"
"chr20","93976523","93976777","GL873680","3005257","3005482","98","90971266"
"chr20","93979343","93979574","GL873823","304319","304508","82","93675024"
"chr20","94863070","94863382","GL873608","6630366","6630673","94","88232704"
"chr20","94929624","94929925","GL873541","16268070","16268366","88","78661554"
"chr20","95246651","95246931","GL873565","12307556","12307825","97","82939095"
"chr20","95293921","95294211","GL873530","16647228","16647517","92","78646693"
"chr20","95381824","95382122","GL873607","1418062","1418355","85","93963762"
"chr20","95420838","95420974","GL873550","5998776","5998900","36","89422062"
"chr20","95421238","95421414","GL873524","42560728","42560902","54","52860510"
"chr20","95938099","95938408","GL873541","16268070","16268366","93","79670029"
"chr20","96049852","96050109","GL873547","5449763","5449997","79","90600089"
"chr20","96337373","96337666","GL873547","2222074","2222356","85","94115299"
"chr20","96641784","96642086","GL873541","16268070","16268366","98","80373714"
"chr20","96720267","96720567","GL873528","36697151","36697434","93","60023116"
"chr20","96733245","96733553","GL873528","36697151","36697434","101","60036094"
"chr20","96790132","96790439","GL873541","16268070","16268366","90","80522062"
"chr20","96860810","96861100","GL873607","1418062","1418355","102","95442748"
"chr20","96950171","96950469","GL873528","36697151","36697434","89","60253020"
"chr20","96975870","96976166","GL873752","427788","428097","80","96548082"
"chr20","96988544","96988826","GL873562","3299887","3300144","88","93688657"
"chr20","97043806","97044100","GL873547","2222074","2222356","81","94821732"
"chr20","97098637","97098929","GL873752","427788","428097","79","96670849"
"chr20","97357640","97357935","GL873530","16647228","16647517","80","80710412"
"chr20","97382193","97382475","GL873562","3299887","3300144","88","94082306"
"chr20","97452495","97452796","GL873528","36697151","36697434","92","60755344"
"chr20","97634578","97634865","GL873530","16647228","16647517","81","80987350"
"chr20","97685286","97685575","GL873528","36697151","36697434","98","60988135"
"chr20","97724628","97724927","GL873541","16268070","16268366","88","81456558"
"chr20","97840797","97841095","GL873541","16268070","16268366","92","81572727"
"chr20","97872595","97872898","GL873541","16268070","16268366","86","81604525"
"chr20","97877636","97877945","GL873541","16268070","16268366","94","81609566"
"chr20","97928139","97928435","GL873547","2222074","2222356","87","95706065"
"chr20","98262246","98262533","GL873547","2222074","2222356","73","96040172"
"chr20","98646375","98646671","GL873530","16647228","16647517","86","81999147"
"chr20","98663727","98664022","GL873541","16268070","16268366","81","82395657"
"chr20","99454006","99454301","GL873530","16647228","16647517","81","82806778"
"chr20","99741211","99741546","GL873528","36697151","36697434","125","63044060"
"chr20","99896409","99896696","GL873530","16647228","16647517","77","83249181"
"chr20","100126729","100127053","GL873667","4451263","4451534","112","95675466"
"chr20","100179677","100179977","GL873541","16268070","16268366","98","83911607"
"chr20","100207551","100207857","GL873541","16268070","16268366","91","83939481"
"chr20","100245190","100245477","GL873530","16647228","16647517","90","83597962"
"chr20","100329342","100329648","GL873541","16268070","16268366","98","84061272"
"chr20","100399354","100399526","GL873530","5593486","5593649","44","94805868"
"chr20","100625206","100625511","GL873541","16268070","16268366","99","84357136"
"chr20","100681763","100682069","GL873541","16268070","16268366","98","84413693"
"chr20","101023460","101023762","GL873541","16268070","16268366","95","84755390"
"chr20","101373166","101373273","GL873524","43272658","43272747","45","58100508"
"chr20","101475449","101475770","GL873541","16268070","16268366","102","85207379"
"chr20","101550593","101550885","GL873530","16647228","16647517","95","84903365"
"chr20","101676702","101676992","GL873530","16647228","16647517","85","85029474"
"chr20","101736430","101736840","GL873559","3737111","3737481","147","97999319"
"chr20","101753609","101753904","GL873659","913070","913333","92","100840539"
"chr20","101777107","101777339","GL873557","3858721","3858924","88","97918386"
"chr20","101840355","101840539","GL873530","5593486","5593649","62","96246869"
"chr20","102003909","102004157","GL873528","25203621","25203847","92","76800288"
"chr20","102900901","102901190","GL873530","16647228","16647517","85","86253673"
"chr20","103051984","103052267","GL873530","16647228","16647517","92","86404756"
"chr20","103688848","103689154","GL873541","16268070","16268366","95","87420778"
"chr20","103713615","103713791","GL873530","5593486","5593649","50","98120129"
"chr20","103714803","103715096","GL873547","2222074","2222356","88","101492729"
"chr20","103790962","103791149","GL873823","304319","304508","60","103486643"
"chr20","103871063","103871349","GL873547","2222074","2222356","90","101648989"
"chr20","103885017","103885310","GL873528","36697151","36697434","88","67187866"
"chr20","103890222","103890516","GL873752","427788","428097","87","103462434"
"chr20","103935663","103935958","GL873541","16268070","16268366","79","87667593"
"chr20","103977456","103977746","GL873659","913070","913333","83","103064386"
"chr20","104083311","104083627","GL873608","6630366","6630673","96","97452945"
"chr20","104185583","104185667","GL873524","43272658","43272747","29","60912925"
"chr20","104185965","104186185","GL873680","3005257","3005482","66","101180708"
"chr20","104209836","104210090","GL873659","913070","913333","93","103296766"
"chr20","104282159","104282378","GL873535","24407607","24407780","76","79874552"
"chr20","104293209","104293496","GL873547","2222074","2222356","78","102071135"
"chr20","104307574","104307852","GL873530","16647228","16647517","93","87660346"
"chr20","104477833","104478070","GL873680","3005257","3005482","71","101472576"
"chr20","104564767","104565070","GL873541","16268070","16268366","80","88296697"
"chr20","104570112","104570410","GL873528","36697151","36697434","91","67872961"
"chr20","104580869","104581092","GL873538","2567037","2567262","66","102013832"
"chr20","104581399","104581491","GL873524","43272658","43272747","37","61308741"
"chr20","104614661","104614956","GL873547","2222074","2222356","89","102392587"
"chr20","104653040","104653338","GL873541","16268070","16268366","87","88384970"
"chr20","104985298","104985598","GL873541","16268070","16268366","80","88717228"
"chr20","105164930","105165236","GL873541","16268070","16268366","88","88896860"
"chr20","105343236","105343533","GL873541","16268070","16268366","96","89075166"
"chr20","105521428","105521726","GL873607","1418062","1418355","88","104103366"
"chr20","105532975","105533307","GL873528","36697151","36697434","109","68835824"
"chr20","105561395","105561692","GL873541","16268070","16268366","82","89293325"
"chr20","105585607","105585916","GL873541","16268070","16268366","93","89317537"
"chr20","105708807","105709105","GL873752","427788","428097","78","105281019"
"chr20","105715190","105715330","GL873541","1550303","1550443","54","104164887"
"chr20","105726951","105727127","GL873530","5593486","5593649","49","100133465"
"chr20","105731292","105731520","GL873538","2567037","2567262","74","103164255"
"chr20","105749777","105750164","GL873559","3737111","3737481","126","102012666"
"chr20","105830981","105831256","GL873659","913070","913333","93","104917911"
"chr20","105947798","105948085","GL873547","2222074","2222356","81","103725724"
"chr20","106144136","106144435","GL873530","16647228","16647517","90","89496908"
"chr20","106249001","106249298","GL873530","16647228","16647517","85","89601773"
"chr20","106252780","106252912","GL873550","5998776","5998900","33","100254004"
"chr20","106253243","106253424","GL873530","5593486","5593649","54","100659757"
"chr20","106255259","106255557","GL873667","4451263","4451534","83","101803996"
"chr20","106275946","106276236","GL873530","16647228","16647517","94","89628718"
"chr20","106321679","106321981","GL873528","36697151","36697434","102","69624528"
"chr20","106348541","106348837","GL873541","16268070","16268366","86","90080471"
"chr20","106414741","106415045","GL873541","16268070","16268366","93","90146671"
"chr20","106452914","106453195","GL873547","2222074","2222356","81","104230840"
"chr20","106542786","106543068","GL873547","2222074","2222356","93","104320712"
"chr20","106911391","106911675","GL873547","2222074","2222356","80","104689317"
"chr20","106931799","106932102","GL873530","16647228","16647517","84","90284571"
"chr20","107113629","107113932","GL873541","16268070","16268366","92","90845559"
"chr20","107170001","107170228","GL873680","3005257","3005482","69","104164744"
"chr20","107360601","107360913","GL873528","36697151","36697434","99","70663450"
"chr20","107496841","107497135","GL873541","16268070","16268366","97","91228771"
"chr20","107872642","107872935","GL873547","2222074","2222356","81","105650568"
"chr20","107897561","107897862","GL873541","16268070","16268366","88","91629491"
"chr20","107912516","107912811","GL873547","2222074","2222356","80","105690442"
"chr20","107925558","107925844","GL873528","36697151","36697434","83","71228407"
"chr20","107981176","107981334","GL873550","5998776","5998900","58","101982400"
"chr20","107988008","107988302","GL873547","2222074","2222356","88","105765934"
"chr20","107997025","107997264","GL873680","3005257","3005482","64","104991768"
"chr20","108008275","108008436","GL873530","5593486","5593649","47","102414789"
"chr20","108074796","108075092","GL873547","2222074","2222356","78","105852722"
"chr20","108109098","108109398","GL873541","16268070","16268366","82","91841028"
"chr20","108795294","108795598","GL873541","16268070","16268366","90","92527224"
"chr20","108844666","108844964","GL873541","16268070","16268366","90","92576596"
"chr20","108914232","108914397","GL873530","5593486","5593649","43","103320746"
"chr20","108914992","108915125","GL873550","5998776","5998900","35","102916216"
"chr20","108953446","108953684","GL873538","2567037","2567262","73","106386409"
"chr20","109116689","109116998","GL873541","16268070","16268366","88","92848619"
"chr20","109170448","109170752","GL873541","16268070","16268366","93","92902378"
"chr20","109309565","109309789","GL873680","3005257","3005482","71","106304308"
"chr20","109349327","109349627","GL873541","16268070","16268366","86","93081257"
"chr20","109459996","109460006","GL873691","2903502","2903535","24","106556494"
"chr20","109460035","109460277","GL873535","4830564","4830824","96","104629471"
"chr20","109521624","109521923","GL873530","16647228","16647517","87","92874396"
"chr20","109832125","109832436","GL873608","6630366","6630673","94","103201759"
"chr20","110226921","110227236","GL873541","16268070","16268366","97","93958851"
"chr20","110237369","110237671","GL873528","36697151","36697434","94","73540218"
"chr20","110447680","110447988","GL873541","16268070","16268366","88","94179610"
"chr20","110501365","110501674","GL873547","2222074","2222356","96","108279291"
"chr20","110591391","110591682","GL873541","16268070","16268366","94","94323321"
"chr20","110609707","110610013","GL873547","2222074","2222356","94","108387633"
"chr20","110642932","110643228","GL873530","16647228","16647517","79","93995704"
"chr20","110867549","110867766","GL873680","3005257","3005482","74","107862292"
"chr20","110950894","110951190","GL873607","1418062","1418355","86","109532832"
"chr20","110954122","110954416","GL873530","16647228","16647517","86","94306894"
"chr20","111428019","111428322","GL873541","16268070","16268366","87","95159949"
"chr20","111450859","111450917","GL873527","37742071","37742124","25","73708788"
"chr20","111548650","111548931","GL873528","36697151","36697434","98","74851499"
"chr20","111549126","111549432","GL873530","16647228","16647517","88","94901898"
"chr20","111770346","111770564","GL873557","3858721","3858924","67","107911625"
"chr20","111946438","111946738","GL873547","2222074","2222356","85","109724364"
"chr20","111949525","111949783","GL873547","2222074","2222356","100","109727451"
"chr20","112579557","112579866","GL873541","16268070","16268366","93","96311487"
"chr20","112616095","112616388","GL873530","16647228","16647517","84","95968867"
"chr20","112674267","112674443","GL873560","5855436","5855580","61","106818831"
"chr20","112711530","112711812","GL873547","2222074","2222356","87","110489456"
"chr20","112716615","112716890","GL873562","3299887","3300144","84","109416728"
"chr20","112750727","112751034","GL873541","16268070","16268366","99","96482657"
"chr20","113004830","113004978","GL873619","2497092","2497229","53","110507738"
"chr20","113211027","113211326","GL873528","36697151","36697434","89","76513876"
"chr20","113342426","113342612","GL873585","9209559","9209725","58","104132867"
"chr20","113381135","113381444","GL873541","16268070","16268366","90","97113065"
"chr20","114123789","114124091","GL873547","2222074","2222356","87","111901715"
"chr20","114617669","114617966","GL873607","1418062","1418355","104","113199607"
"chr20","114767367","114767667","GL873607","1418062","1418355","90","113349305"
"chr20","115099783","115100087","GL873541","16268070","16268366","89","98831713"
"chr20","115101766","115102097","GL873530","16647228","16647517","116","98454538"
"chr20","115106743","115107050","GL873541","16268070","16268366","95","98838673"
"chr20","115107547","115107844","GL873812","559768","560073","96","114547779"
"chr20","115111513","115111805","GL873667","4451263","4451534","94","110660250"
"chr20","115148235","115148474","GL873528","25203621","25203847","79","89944614"
"chr20","115225004","115225156","GL873585","9209559","9209725","52","106015445"
"chr20","115487637","115487936","GL873528","36697151","36697434","85","78790486"
"chr20","115495240","115495548","GL873541","16268070","16268366","90","99227170"
"chr20","115974996","115975245","GL873538","2567037","2567262","80","113407959"
"chr20","115980575","115980870","GL873530","16647228","16647517","86","99333347"
"chr20","116013153","116013451","GL873547","2222074","2222356","87","113791079"
"chr20","116113796","116113932","GL873524","43272770","43272878","52","72841026"
"chr20","116326027","116326326","GL873530","16647228","16647517","98","99678799"
"chr20","116376251","116376549","GL873541","16268070","16268366","77","100108181"
"chr20","116444903","116445125","GL873531","3555300","3555500","78","112889603"
"chr20","116617181","116617490","GL873541","16268070","16268366","90","100349111"
"chr20","116629660","116629953","GL873607","1418062","1418355","79","115211598"
"chr20","116736583","116736880","GL873541","16268070","16268366","81","100468513"
"chr20","116894726","116895021","GL873530","16647228","16647517","84","100247498"
"chr20","116911985","116912285","GL873530","16647228","16647517","93","100264757"
"chr20","117005664","117005963","GL873547","2222074","2222356","80","114783590"
"chr20","117035994","117036278","GL873547","2222074","2222356","89","114813920"
"chr20","117286598","117286893","GL873541","16268070","16268366","82","101018528"
"chr20","118001146","118001448","GL873541","16268070","16268366","105","101733076"
"chr20","118094039","118094347","GL873541","16268070","16268366","87","101825969"
"chr20","118159009","118159308","GL873541","16268070","16268366","84","101890939"
"chr20","118200959","118201264","GL873541","16268070","16268366","88","101932889"
"chr20","118344955","118345193","GL873680","3005257","3005482","80","115339698"
"chr20","118517281","118517567","GL873530","16647228","16647517","90","101870053"
"chr20","118676017","118676323","GL873659","913070","913333","89","117762947"
"chr20","118736380","118736663","GL873547","2222074","2222356","87","116514306"
"chr20","119031477","119031787","GL873528","36697151","36697434","97","82334326"
"chr20","119136193","119136516","GL873528","36697151","36697434","122","82439042"
"chr20","119275773","119276050","GL873659","913070","913333","87","118362703"
"chr20","119284279","119284575","GL873607","1418062","1418355","91","117866217"
"chr20","120125581","120125887","GL873541","16268070","16268366","95","103857511"
"chr20","120203418","120203695","GL873547","2222074","2222356","75","117981344"
"chr20","121217439","121217741","GL873547","2222074","2222356","89","118995365"
"chr20","121411487","121411783","GL873659","913070","913333","86","120498417"
"chr20","121542754","121543058","GL873528","36697151","36697434","88","84845603"
"chr20","121563464","121563759","GL873530","16647228","16647517","84","104916236"
"chr20","121738201","121738484","GL873547","2222074","2222356","81","119516127"
"chr20","121871765","121872064","GL873547","2222074","2222356","87","119649691"
"chr20","122239975","122240145","GL873574","7318344","7318500","54","114921631"
"chr20","122332826","122333119","GL873530","16647228","16647517","79","105685598"
"chr20","122358616","122358918","GL873541","16268070","16268366","87","106090546"
"chr20","122819149","122819438","GL873547","2222074","2222356","71","120597075"
"chr20","122868198","122868502","GL873541","16268070","16268366","94","106600128"
"chr20","122985692","122985827","GL873550","5998776","5998900","39","116986916"
"chr20","123070552","123070861","GL873541","16268070","16268366","99","106802482"
"chr20","123356592","123356887","GL873530","16647228","16647517","87","106709364"
"chr20","123556192","123556483","GL873541","16268070","16268366","93","107288122"
"chr20","123712084","123712386","GL873607","1418062","1418355","85","122294022"
"chr20","123836938","123837237","GL873541","16268070","16268366","79","107568868"
"chr20","123849458","123849760","GL873541","16268070","16268366","87","107581388"
"chr20","124228642","124228943","GL873547","2222074","2222356","88","122006568"
"chr20","124803449","124803753","GL873541","16268070","16268366","86","108535379"
"chr20","124969410","124969698","GL873547","2222074","2222356","78","122747336"
"chr20","125041520","125041815","GL873547","2222074","2222356","82","122819446"
"chr20","125218344","125218601","GL873680","3005257","3005482","96","122213087"
"chr20","125310913","125311084","GL873530","5593486","5593649","51","119717427"
"chr20","125311377","125311387","GL873691","2903502","2903535","24","122407875"
"chr20","125311859","125311992","GL873550","5998776","5998900","33","119313083"
"chr20","125330831","125331126","GL873541","16268070","16268366","86","109062761"
"chr20","125396777","125397074","GL873541","16268070","16268366","85","109128707"
"chr20","125782941","125783258","GL873541","16268070","16268366","103","109514871"
"chr20","126210368","126210661","GL873541","16268070","16268366","91","109942298"
"chr20","127719898","127720187","GL873547","2222074","2222356","93","125497824"
"chr20","127931216","127931373","GL873541","1550303","1550443","56","126380913"
"chr20","129287862","129288155","GL873541","16268070","16268366","92","113019792"
"chr20","129603401","129603700","GL873541","16268070","16268366","88","113335331"
"chr20","129762991","129763290","GL873528","36697151","36697434","103","93065840"
"chr20","129893174","129893474","GL873541","16268070","16268366","95","113625104"
"chr20","129984304","129984518","GL873538","2567037","2567262","73","127417267"
"chr20","130028139","130028296","GL873619","2497092","2497229","53","127531047"
"chr20","130091484","130091686","GL873558","7532067","7532273","58","122559417"
"chr20","130327568","130327872","GL873547","2222074","2222356","95","128105494"
"chr21","122027774","122028081","GL873607","1418062","1418355","94","120609712"
"chr21","1379824","1380130","GL873528","36697151","36697434","103","35317327"
"chr21","1444870","1445162","GL873530","16647228","16647517","87","15202358"
"chr21","1683088","1683396","GL873547","2222074","2222356","86","538986"
"chr21","1689638","1689930","GL873541","16268070","16268366","84","14578432"
"chr21","1968912","1969212","GL873541","16268070","16268366","88","14299158"
"chr21","2046321","2046633","GL873528","36697151","36697434","97","34650830"
"chr21","2172215","2172522","GL873528","36697151","36697434","97","34524936"
"chr21","2191881","2192174","GL873547","2222074","2222356","90","30193"
"chr21","2194845","2195092","GL873680","3005257","3005482","88","810412"
"chr21","2248053","2248350","GL873541","16268070","16268366","82","14020017"
"chr21","2508889","2509006","GL873552","12711845","12711956","43","10202956"
"chr21","2544126","2544404","GL873547","2222074","2222356","87","322052"
"chr21","2752929","2753072","GL873628","6402015","6402153","63","3649086"
"chr21","2768461","2768756","GL873530","16647228","16647517","91","13878767"
"chr21","2823485","2823604","GL873552","12711845","12711956","46","9888360"
"chr21","2832460","2832733","GL873547","2222074","2222356","85","610386"
"chr21","2835888","2836175","GL873547","2222074","2222356","80","613814"
"chr21","2867251","2867543","GL873530","16647228","16647517","83","13779977"
"chr21","2875546","2875844","GL873530","16647228","16647517","90","13771682"
"chr21","3002493","3002804","GL873541","16268070","16268366","95","13265577"
"chr21","3009664","3009798","GL873550","5998776","5998900","40","2989112"
"chr21","3255371","3255664","GL873659","913070","913333","99","2342301"
"chr21","3272624","3272932","GL873530","16647228","16647517","89","13374604"
"chr21","3464886","3465179","GL873752","427788","428097","84","3037098"
"chr21","3476256","3476448","GL873535","24407607","24407780","55","20931351"
"chr21","4194980","4195272","GL873530","16647228","16647517","83","12452248"
"chr21","4410978","4411273","GL873547","2222074","2222356","82","2188904"
"chr21","4619644","4619942","GL873541","16268070","16268366","92","11648426"
"chr21","4748712","4749012","GL873541","16268070","16268366","103","11519358"
"chr21","4799868","4800175","GL873608","6630366","6630673","87","1830498"
"chr21","5030296","5030584","GL873547","2222074","2222356","85","2808222"
"chr21","5063551","5063842","GL873607","1418062","1418355","84","3645489"
"chr21","5300611","5300909","GL873528","36697151","36697434","97","31396540"
"chr21","5607084","5607393","GL873528","36697151","36697434","98","31090067"
"chr21","6005263","6005553","GL873547","2222074","2222356","85","3783189"
"chr21","6766064","6766367","GL873541","16268070","16268366","92","9502006"
"chr21","6925853","6926147","GL873659","913070","913333","87","6012783"
"chr21","7018452","7018748","GL873541","16268070","16268366","87","9249618"
"chr21","7328929","7329233","GL873607","1418062","1418355","94","5910867"
"chr21","7708918","7709215","GL873530","16647228","16647517","89","8938310"
"chr21","7991233","7991491","GL873680","3005257","3005482","90","4985976"
"chr21","8247902","8248209","GL873541","16268070","16268366","89","8020168"
"chr21","8463813","8464131","GL873608","6630366","6630673","91","1833447"
"chr21","8921616","8921919","GL873541","16268070","16268366","85","7346454"
"chr21","10587511","10587822","GL873547","2222074","2222356","103","8365437"
"chr21","10937733","10938050","GL873541","16268070","16268366","100","5330337"
"chr21","11082110","11082403","GL873541","16268070","16268366","87","5185960"
"chr21","11124790","11125091","GL873541","16268070","16268366","92","5143280"
"chr21","11148283","11148579","GL873547","2222074","2222356","86","8926209"
"chr21","11272260","11272559","GL873541","16268070","16268366","85","4995810"
"chr21","11287496","11287724","GL873538","2567037","2567262","69","8720459"
"chr21","11469249","11469537","GL873547","2222074","2222356","87","9247175"
"chr21","11476508","11476808","GL873541","16268070","16268366","90","4791562"
"chr21","12327043","12327381","GL873667","4451263","4451534","131","7875780"
"chr21","12559766","12560078","GL873752","427788","428097","99","12131978"
"chr21","12950925","12951223","GL873528","36697151","36697434","98","23746226"
"chr21","13146718","13147023","GL873528","36697151","36697434","96","23550433"
"chr21","13267712","13268008","GL873528","36697151","36697434","89","23429439"
"chr21","13696826","13697126","GL873541","16268070","16268366","86","2571244"
"chr21","13808236","13808552","GL873528","36697151","36697434","93","22888915"
"chr21","13945073","13945376","GL873607","1418062","1418355","97","12527011"
"chr21","13947118","13947412","GL873541","16268070","16268366","90","2320952"
"chr21","13984829","13985126","GL873547","2222074","2222356","91","11762755"
"chr21","14005943","14006240","GL873608","6630366","6630673","86","7375577"
"chr21","14093278","14093561","GL873547","2222074","2222356","80","11871204"
"chr21","14192987","14193192","GL873531","3555300","3555500","75","10637687"
"chr21","14324194","14324503","GL873528","36697151","36697434","92","22372957"
"chr21","14578304","14578604","GL873541","16268070","16268366","82","1689766"
"chr21","14667705","14668010","GL873530","16647228","16647517","92","1979523"
"chr21","14733313","14733598","GL873547","2222074","2222356","87","12511239"
"chr21","15072561","15072861","GL873541","16268070","16268366","87","1195509"
"chr21","15091162","15091464","GL873541","16268070","16268366","90","1176908"
"chr21","15336797","15337103","GL873528","36697151","36697434","93","21360354"
"chr21","15384290","15384594","GL873607","1418062","1418355","90","13966228"
"chr21","15570769","15571064","GL873530","16647228","16647517","85","1076459"
"chr21","16306933","16307228","GL873530","16647228","16647517","88","340295"
"chr21","16639270","16639547","GL873755","463833","464092","91","16175437"
"chr21","17625480","17625789","GL873541","16268070","16268366","90","1357410"
"chr21","17724003","17724298","GL873541","16268070","16268366","89","1455933"
"chr21","17929640","17929948","GL873541","16268070","16268366","95","1661570"
"chr21","17935061","17935359","GL873547","2222074","2222356","83","15712987"
"chr21","18376763","18377071","GL873541","16268070","16268366","94","2108693"
"chr21","18426369","18426681","GL873752","427788","428097","91","17998581"
"chr21","18451357","18451661","GL873541","16268070","16268366","85","2183287"
"chr21","18454452","18454759","GL873541","16268070","16268366","92","2186382"
"chr21","18488502","18488804","GL873547","2222074","2222356","97","16266428"
"chr21","18631422","18631717","GL873530","16647228","16647517","87","1984194"
"chr21","18672750","18673031","GL873547","2222074","2222356","82","16450676"
"chr21","18873994","18874311","GL873541","16268070","16268366","108","2605924"
"chr21","18967230","18967419","GL873521","1458597","1458764","53","17508633"
"chr21","19405208","19405479","GL873562","3299887","3300144","88","16105321"
"chr21","19596766","19597067","GL873541","16268070","16268366","89","3328696"
"chr21","19920396","19920505","GL873587","10002051","10002151","48","9918345"
"chr21","20144246","20144541","GL873530","16647228","16647517","87","3497018"
"chr21","20205944","20206248","GL873547","2222074","2222356","93","17983870"
"chr21","20427397","20427676","GL873528","36697151","36697434","99","16269754"
"chr21","20724253","20724550","GL873752","427788","428097","85","20296465"
"chr21","21076161","21076457","GL873547","2222074","2222356","86","18854087"
"chr21","21224283","21224578","GL873530","16647228","16647517","91","4577055"
"chr21","21236149","21236451","GL873541","16268070","16268366","94","4968079"
"chr21","21776829","21777161","GL873608","6630366","6630673","110","15146463"
"chr21","22070013","22070309","GL873541","16268070","16268366","91","5801943"
"chr21","22598605","22598900","GL873530","16647228","16647517","88","5951377"
"chr21","23483520","23483796","GL873659","913070","913333","90","22570450"
"chr21","23798419","23798714","GL873541","16268070","16268366","86","7530349"
"chr21","23914731","23915050","GL873541","16268070","16268366","119","7646661"
"chr21","23915110","23915124","GL873691","2903502","2903535","22","21011608"
"chr21","24016769","24017028","GL873680","3005257","3005482","87","21011512"
"chr21","24086666","24086981","GL873541","16268070","16268366","102","7818596"
"chr21","24538857","24539153","GL873541","16268070","16268366","85","8270787"
"chr21","24649382","24649696","GL873528","36697151","36697434","96","12047769"
"chr21","25378112","25378415","GL873541","16268070","16268366","83","9110042"
"chr21","26051038","26051355","GL873541","16268070","16268366","103","9782968"
"chr21","26125266","26125576","GL873541","16268070","16268366","93","9857196"
"chr21","28275805","28276094","GL873530","16647228","16647517","89","11628577"
"chr21","28276441","28276585","GL873619","2497092","2497229","50","25779349"
"chr21","28585098","28585401","GL873530","16647228","16647517","81","11937870"
"chr21","28597764","28598072","GL873528","36697151","36697434","96","8099387"
"chr21","29485302","29485578","GL873547","2222074","2222356","90","27263228"
"chr21","29624625","29624948","GL873607","1418062","1418355","113","28206563"
"chr21","29709244","29709551","GL873547","2222074","2222356","93","27487170"
"chr21","30242098","30242374","GL873562","3299887","3300144","85","26942211"
"chr21","30252005","30252291","GL873659","913070","913333","84","29338935"
"chr21","30745613","30745756","GL873628","6402015","6402153","56","24343598"
"chr21","30978856","30979153","GL873541","16268070","16268366","87","14710786"
"chr21","30995353","30995653","GL873608","6630366","6630673","91","24364987"
"chr21","31150735","31151041","GL873541","16268070","16268366","96","14882665"
"chr21","32051304","32051613","GL873541","16268070","16268366","97","15783234"
"chr21","32073678","32073906","GL873557","3858721","3858924","76","28214957"
"chr21","32130605","32130915","GL873528","36697151","36697434","100","4566546"
"chr21","32152235","32152526","GL873547","2222074","2222356","81","29930161"
"chr21","32153251","32153547","GL873541","16268070","16268366","92","15885181"
"chr21","32217920","32218198","GL873547","2222074","2222356","87","29995846"
"chr21","32229368","32229583","GL873531","3555300","3555500","67","28674068"
"chr21","32263328","32263616","GL873547","2222074","2222356","82","30041254"
"chr21","33007551","33007856","GL873541","16268070","16268366","89","16739481"
"chr21","33222038","33222338","GL873547","2222074","2222356","89","30999964"
"chr21","33541267","33541563","GL873541","16268070","16268366","90","17273197"
"chr21","33639618","33639929","GL873530","16647228","16647517","97","16992390"
"chr21","34206416","34206710","GL873530","16647228","16647517","82","17559188"
"chr21","34330891","34331073","GL873530","5593486","5593649","62","28737405"
"chr21","34768132","34768441","GL873541","16268070","16268366","97","18500062"
"chr21","34825691","34825993","GL873547","2222074","2222356","96","32603617"
"chr21","35196281","35196446","GL873530","5593486","5593649","54","29602795"
"chr21","35594447","35594717","GL873667","4451263","4451534","87","31143184"
"chr21","36139006","36139322","GL873541","16268070","16268366","95","19870936"
"chr21","36212427","36212646","GL873557","3858721","3858924","69","32353706"
"chr21","36372372","36372694","GL873541","16268070","16268366","100","20104302"
"chr21","36407228","36407537","GL873541","16268070","16268366","97","20139158"
"chr21","36629057","36629366","GL873541","16268070","16268366","94","20360987"
"chr21","36743585","36743894","GL873667","4451263","4451534","100","32292322"
"chr21","38086321","38086601","GL873607","1418062","1418355","89","36668259"
"chr21","39101365","39101669","GL873528","36697151","36697434","99","2404214"
"chr21","39387304","39387592","GL873547","2222074","2222356","83","37165230"
"chr21","41302672","41302935","GL873680","3005257","3005482","96","38297415"
"chr21","41804528","41804728","GL873630","2508568","2508753","72","39295960"
"chr21","42122216","42122470","GL873659","913070","913333","80","41209146"
"chr21","42325959","42326085","GL873550","5998776","5998900","35","36327183"
"chr21","43052854","43053159","GL873530","16647228","16647517","96","26405626"
"chr21","43208875","43209156","GL873547","2222074","2222356","93","40986801"
"chr21","43930811","43931109","GL873547","2222074","2222356","86","41708737"
"chr21","44539876","44540139","GL873535","4830564","4830824","93","39709312"
"chr21","45012523","45012821","GL873528","36697151","36697434","87","8315372"
"chr21","45112879","45113169","GL873547","2222074","2222356","80","42890805"
"chr21","45224795","45225081","GL873547","2222074","2222356","86","43002721"
"chr21","45461410","45461721","GL873541","16268070","16268366","94","29193340"
"chr21","45661611","45661899","GL873547","2222074","2222356","84","43439537"
"chr21","46300723","46301030","GL873530","16647228","16647517","96","29653495"
"chr21","46675825","46676137","GL873530","16647228","16647517","97","30028597"
"chr21","46936802","46937109","GL873541","16268070","16268366","89","30668732"
"chr21","47059443","47059703","GL873535","4830564","4830824","91","42228879"
"chr21","47096414","47096720","GL873530","16647228","16647517","92","30449186"
"chr21","48106444","48106729","GL873752","427788","428097","86","47678656"
"chr21","48383825","48384136","GL873528","36697151","36697434","98","11686674"
"chr21","49370408","49370706","GL873565","12307556","12307825","100","37062852"
"chr21","50399400","50399706","GL873541","16268070","16268366","92","34131330"
"chr21","50754937","50755240","GL873530","16647228","16647517","87","34107709"
"chr21","51313648","51313694","GL873691","2903502","2903535","16","48410146"
"chr21","51636446","51636746","GL873528","36697151","36697434","93","14939295"
"chr21","52258005","52258304","GL873541","16268070","16268366","93","35989935"
"chr21","52676230","52676531","GL873607","1418062","1418355","84","51258168"
"chr21","54059410","54059717","GL873607","1418062","1418355","88","52641348"
"chr21","54066983","54067128","GL873541","1550303","1550443","50","52516680"
"chr21","54743458","54743775","GL873541","16268070","16268366","100","38475388"
"chr21","55549223","55549531","GL873541","16268070","16268366","90","39281153"
"chr21","56587691","56587984","GL873530","16647228","16647517","82","39940463"
"chr21","56703965","56704247","GL873547","2222074","2222356","85","54481891"
"chr21","56776388","56776684","GL873607","1418062","1418355","86","55358326"
"chr21","56847486","56847775","GL873530","16647228","16647517","85","40200258"
"chr21","56951498","56951751","GL873543","13038674","13038909","99","43912824"
"chr21","57223537","57223847","GL873541","16268070","16268366","89","40955467"
"chr21","58133217","58133377","GL873628","6402015","6402153","53","51731202"
"chr21","58279476","58279784","GL873547","2222074","2222356","100","56057402"
"chr21","58525877","58526009","GL873550","5998776","5998900","40","52527101"
"chr21","59003530","59003822","GL873541","16268070","16268366","78","42735460"
"chr21","59644453","59644730","GL873565","12307556","12307825","90","47336897"
"chr21","59851909","59852185","GL873565","12307556","12307825","98","47544353"
"chr21","60834617","60834916","GL873530","16647228","16647517","84","44187389"
"chr21","61303720","61304003","GL873541","16268070","16268366","101","45035650"
"chr21","61356008","61356310","GL873608","6630366","6630673","89","54725642"
"chr21","62727751","62728058","GL873530","16647228","16647517","98","46080523"
"chr21","62803930","62804220","GL873547","2222074","2222356","84","60581856"
"chr21","63308512","63308806","GL873528","36697151","36697434","100","26611361"
"chr21","63760124","63760408","GL873547","2222074","2222356","97","61538050"
"chr21","64493767","64493871","GL873520","23895808","23895898","45","40597959"
"chr21","65403902","65404122","GL873531","3555300","3555500","67","61848602"
"chr21","65405045","65405338","GL873547","2222074","2222356","72","63182971"
"chr21","65644826","65645077","GL873528","25203621","25203847","84","40441205"
"chr21","66366898","66367024","GL873552","12711845","12711956","51","53655053"
"chr21","66609676","66609978","GL873530","16647228","16647517","99","49962448"
"chr21","67008124","67008407","GL873565","12307556","12307825","96","54700568"
"chr21","67644927","67645222","GL873547","2222074","2222356","89","65422853"
"chr21","67794874","67795156","GL873547","2222074","2222356","88","65572800"
"chr21","67938784","67939079","GL873541","16268070","16268366","87","51670714"
"chr21","68719216","68719515","GL873541","16268070","16268366","85","52451146"
"chr21","68749549","68749851","GL873541","16268070","16268366","84","52481479"
"chr21","68835354","68835487","GL873622","7076274","7076365","59","61759080"
"chr21","70723180","70723490","GL873530","16647228","16647517","95","54075952"
"chr21","71025303","71025598","GL873541","16268070","16268366","92","54757233"
"chr21","71159820","71160122","GL873541","16268070","16268366","85","54891750"
"chr21","71269622","71269884","GL873565","12307556","12307825","92","58962066"
"chr21","71306860","71307162","GL873541","16268070","16268366","84","55038790"
"chr21","71497628","71497935","GL873667","4451263","4451534","92","67046365"
"chr21","71854295","71854586","GL873547","2222074","2222356","88","69632221"
"chr21","71920418","71920725","GL873541","16268070","16268366","86","55652348"
"chr21","72278722","72279000","GL873541","16268070","16268366","81","56010652"
"chr21","72296693","72296993","GL873541","16268070","16268366","85","56028623"
"chr21","72762050","72762359","GL873541","16268070","16268366","94","56493980"
"chr21","72873879","72874173","GL873530","16647228","16647517","91","56226651"
"chr21","73623269","73623555","GL873547","2222074","2222356","81","71401195"
"chr21","73735740","73735834","GL873524","43272770","43272878","41","30462970"
"chr21","73781344","73781646","GL873541","16268070","16268366","90","57513274"
"chr21","73834890","73835234","GL873812","559768","560073","109","73275122"
"chr21","73874260","73874368","GL873587","10002051","10002151","37","63872209"
"chr21","73925909","73926212","GL873530","16647228","16647517","89","57278681"
"chr21","74074068","74074358","GL873547","2222074","2222356","74","71851994"
"chr21","74139912","74140141","GL873680","3005257","3005482","68","71134655"
"chr21","74236021","74236328","GL873541","16268070","16268366","87","57967951"
"chr21","74279109","74279421","GL873541","16268070","16268366","94","58011039"
"chr21","74289527","74289833","GL873541","16268070","16268366","98","58021457"
"chr21","74307427","74307720","GL873541","16268070","16268366","89","58039357"
"chr21","74375373","74375666","GL873547","2222074","2222356","85","72153299"
"chr21","74458426","74458722","GL873659","913070","913333","83","73545356"
"chr21","74530888","74531179","GL873528","36697151","36697434","86","37833737"
"chr21","74602347","74602497","GL873550","5998776","5998900","52","68603571"
"chr21","74784456","74784760","GL873541","16268070","16268366","85","58516386"
"chr21","75146945","75147245","GL873659","913070","913333","83","74233875"
"chr21","76154720","76155002","GL873547","2222074","2222356","86","73932646"
"chr21","76273836","76274142","GL873607","1418062","1418355","88","74855774"
"chr21","76462253","76462539","GL873528","36697151","36697434","87","39765102"
"chr21","76648555","76648837","GL873547","2222074","2222356","85","74426481"
"chr21","76728924","76729229","GL873530","16647228","16647517","92","60081696"
"chr21","76739387","76739705","GL873541","16268070","16268366","107","60471317"
"chr21","76811983","76812293","GL873541","16268070","16268366","100","60543913"
"chr21","76871187","76871489","GL873541","16268070","16268366","93","60603117"
"chr21","77273281","77273577","GL873530","16647228","16647517","86","60626053"
"chr21","77433578","77433885","GL873541","16268070","16268366","91","61165508"
"chr21","77968211","77968510","GL873530","16647228","16647517","93","61320983"
"chr21","79596613","79596747","GL873529","2453810","2453957","55","77142803"
"chr21","80323891","80324081","GL873823","304319","304508","57","80019572"
"chr21","80633833","80634117","GL873547","2222074","2222356","93","78411759"
"chr21","81118089","81118188","GL873622","7076274","7076365","37","74041815"
"chr21","81623551","81623841","GL873547","2222074","2222356","84","79401477"
"chr21","83591322","83591639","GL873530","16647228","16647517","104","66944094"
"chr21","83631366","83631648","GL873530","16647228","16647517","93","66984138"
"chr21","84327987","84328283","GL873541","16268070","16268366","85","68059917"
"chr21","84373739","84374013","GL873547","2222074","2222356","88","82151665"
"chr21","85572898","85573208","GL873541","16268070","16268366","95","69304828"
"chr21","85642900","85643169","GL873565","12307556","12307825","89","73335344"
"chr21","85744018","85744329","GL873607","1418062","1418355","97","84325956"
"chr21","85766443","85766731","GL873541","16268070","16268366","75","69498373"
"chr21","87120545","87120842","GL873541","16268070","16268366","87","70852475"
"chr21","87735237","87735542","GL873547","2222074","2222356","100","85513163"
"chr21","88439408","88439715","GL873541","16268070","16268366","98","72171338"
"chr21","88901781","88902037","GL873562","3299887","3300144","93","85601894"
"chr21","88943563","88943865","GL873541","16268070","16268366","90","72675493"
"chr21","88999802","88999999","GL873520","40003955","40004123","81","48995847"
"chr21","89675951","89676255","GL873607","1418062","1418355","84","88257889"
"chr21","89949810","89950103","GL873528","36697151","36697434","112","53252659"
"chr21","90013284","90013576","GL873541","16268070","16268366","93","73745214"
"chr21","90778881","90779170","GL873547","2222074","2222356","83","88556807"
"chr21","90927368","90927677","GL873607","1418062","1418355","93","89509306"
"chr21","91366419","91366720","GL873541","16268070","16268366","91","75098349"
"chr21","91662183","91662482","GL873659","913070","913333","101","90749113"
"chr21","91932627","91932790","GL873530","5593486","5593649","58","86339141"
"chr21","92300880","92301163","GL873530","16647228","16647517","80","75653652"
"chr21","92444763","92445054","GL873541","16268070","16268366","78","76176693"
"chr21","93011202","93011573","GL873559","3737111","3737481","130","89274091"
"chr21","93618239","93618523","GL873607","1418062","1418355","90","92200177"
"chr21","94014649","94014960","GL873541","16268070","16268366","95","77746579"
"chr21","94026724","94027025","GL873607","1418062","1418355","86","92608662"
"chr21","94740111","94740399","GL873547","2222074","2222356","90","92518037"
"chr21","95374770","95375065","GL873541","16268070","16268366","83","79106700"
"chr21","95391912","95392218","GL873541","16268070","16268366","97","79123842"
"chr21","95504805","95505108","GL873659","913070","913333","93","94591735"
"chr21","95715640","95715946","GL873528","36697151","36697434","92","59018489"
"chr21","96326496","96326762","GL873565","12307556","12307825","93","84018940"
"chr21","97222519","97222803","GL873547","2222074","2222356","82","95000445"
"chr21","97269750","97269963","GL873531","3555300","3555500","62","93714450"
"chr21","97285786","97286089","GL873530","16647228","16647517","85","80638558"
"chr21","97469770","97470066","GL873547","2222074","2222356","81","95247696"
"chr21","97674378","97674683","GL873547","2222074","2222356","86","95452304"
"chr21","97829786","97830069","GL873547","2222074","2222356","86","95607712"
"chr21","98003335","98003635","GL873547","2222074","2222356","86","95781261"
"chr21","98008317","98008550","GL873680","3005257","3005482","73","95003060"
"chr21","98017170","98017478","GL873541","16268070","16268366","98","81749100"
"chr21","98045181","98045445","GL873659","913070","913333","81","97132111"
"chr21","98141079","98141378","GL873547","2222074","2222356","90","95919005"
"chr21","98208034","98208273","GL873680","3005257","3005482","88","95202777"
"chr21","98296763","98297008","GL873680","3005257","3005482","74","95291506"
"chr21","98354752","98355060","GL873547","2222074","2222356","94","96132678"
"chr21","98385810","98385904","GL873520","23895808","23895898","34","74490002"
"chr21","98464732","98465027","GL873541","16268070","16268366","82","82196662"
"chr21","99053778","99054110","GL873812","559768","560073","123","98494010"
"chr21","99379072","99379367","GL873541","16268070","16268366","85","83111002"
"chr21","99460334","99460473","GL873541","1550303","1550443","45","97910031"
"chr21","99814323","99814618","GL873547","2222074","2222356","86","97592249"
"chr21","99815888","99816179","GL873547","2222074","2222356","89","97593814"
"chr21","99831582","99831970","GL873559","3737111","3737481","167","96094471"
"chr21","100655766","100656018","GL873680","3005257","3005482","88","97650509"
"chr21","101245262","101245543","GL873562","3299887","3300144","88","97945375"
"chr21","101356223","101356495","GL873680","3005257","3005482","104","98350966"
"chr21","101727772","101728069","GL873608","6630366","6630673","77","95097406"
"chr21","101858070","101858371","GL873607","1418062","1418355","90","100440008"
"chr21","101876759","101877061","GL873541","16268070","16268366","95","85608689"
"chr21","102132051","102132356","GL873541","16268070","16268366","90","85863981"
"chr21","102556538","102556828","GL873547","2222074","2222356","92","100334464"
"chr21","102865599","102865905","GL873547","2222074","2222356","91","100643525"
"chr21","102968328","102968627","GL873541","16268070","16268366","81","86700258"
"chr21","103512848","103512947","GL873622","7076274","7076365","31","96436574"
"chr21","103650269","103650560","GL873530","16647228","16647517","80","87003041"
"chr21","104133294","104133432","GL873541","1550303","1550443","60","102582991"
"chr21","104137077","104137268","GL873630","2508568","2508753","76","101628509"
"chr21","104210680","104210937","GL873680","3005257","3005482","82","101205423"
"chr21","104210949","104211063","GL873550","5998776","5998900","41","98212173"
"chr21","104442504","104442807","GL873541","16268070","16268366","86","88174434"
"chr21","105814695","105814817","GL873622","7076274","7076365","51","98738421"
"chr21","106582007","106582232","GL873680","3005257","3005482","65","103576750"
"chr21","106763857","106764155","GL873541","16268070","16268366","90","90495787"
"chr21","107006609","107006909","GL873541","16268070","16268366","96","90738539"
"chr21","107068313","107068535","GL873680","3005257","3005482","65","104063056"
"chr21","107097205","107097502","GL873541","16268070","16268366","92","90829135"
"chr21","107613399","107613563","GL873530","5593486","5593649","51","102019913"
"chr21","107863880","107864190","GL873541","16268070","16268366","89","91595810"
"chr21","107944582","107944691","GL873550","5998776","5998900","50","101945806"
"chr21","107945154","107945348","GL873535","24407607","24407780","58","83537547"
"chr21","107947381","107947678","GL873547","2222074","2222356","78","105725307"
"chr21","108141366","108141538","GL873530","5593486","5593649","56","102547880"
"chr21","108265099","108265261","GL873565","1666380","1666535","67","106598719"
"chr21","108327330","108327618","GL873530","16647228","16647517","83","91680102"
"chr21","108474892","108475142","GL873547","2222074","2222356","89","106252818"
"chr21","108556201","108556382","GL873530","5593486","5593649","53","102962715"
"chr21","108593430","108593710","GL873562","3299887","3300144","82","105293543"
"chr21","108956483","108956786","GL873541","16268070","16268366","92","92688413"
"chr21","109017773","109018058","GL873528","36697151","36697434","88","72320622"
"chr21","109076960","109077083","GL873691","508903","509045","48","108568057"
"chr21","109329185","109329327","GL873628","6402015","6402153","65","102927170"
"chr21","109613092","109613392","GL873607","1418062","1418355","87","108195030"
"chr21","109668578","109668856","GL873562","3299887","3300144","88","106368691"
"chr21","110295903","110296200","GL873541","16268070","16268366","92","94027833"
"chr21","110378403","110378680","GL873562","3299887","3300144","88","107078516"
"chr21","110476819","110477125","GL873547","2222074","2222356","92","108254745"
"chr21","110795922","110796208","GL873547","2222074","2222356","94","108573848"
"chr21","110804728","110805012","GL873547","2222074","2222356","95","108582654"
"chr21","112020078","112020375","GL873530","16647228","16647517","84","95372850"
"chr21","112181470","112181772","GL873541","16268070","16268366","85","95913400"
"chr21","112210016","112210325","GL873607","1418062","1418355","98","110791954"
"chr21","112491352","112491641","GL873547","2222074","2222356","94","110269278"
"chr21","112802864","112803153","GL873530","16647228","16647517","84","96155636"
"chr21","114248735","114249040","GL873541","16268070","16268366","89","97980665"
"chr21","114460306","114460578","GL873667","4451263","4451534","105","110009043"
"chr21","114480834","114481129","GL873541","16268070","16268366","91","98212764"
"chr21","117026591","117026890","GL873541","16268070","16268366","87","100758521"
"chr21","117412051","117412346","GL873528","36697151","36697434","88","80714900"
"chr21","117519079","117519372","GL873547","2222074","2222356","84","115297005"
"chr21","117595382","117595675","GL873530","16647228","16647517","84","100948154"
"chr21","117631845","117632107","GL873535","4830564","4830824","98","112801281"
"chr21","117643811","117644045","GL873680","3005257","3005482","83","114638554"
"chr21","117652942","117653044","GL873524","43272658","43272747","44","74380284"
"chr21","117751109","117751372","GL873680","3005257","3005482","90","114745852"
"chr21","117798686","117798979","GL873530","16647228","16647517","83","101151458"
"chr21","117823013","117823310","GL873541","16268070","16268366","83","101554943"
"chr21","118175603","118175908","GL873541","16268070","16268366","93","101907533"
"chr21","118205496","118205788","GL873530","16647228","16647517","81","101558268"
"chr21","118221906","118222118","GL873554","16339732","16339922","72","101882174"
"chr21","118467126","118467418","GL873530","16647228","16647517","99","101819898"
"chr21","119050608","119050872","GL873562","3299887","3300144","88","115750721"
"chr21","119213700","119214004","GL873541","16268070","16268366","89","102945630"
"chr21","119598276","119598573","GL873607","1418062","1418355","90","118180214"
"chr21","119845377","119845648","GL873680","3005257","3005482","96","116840120"
"chr21","120197471","120197770","GL873752","427788","428097","87","119769683"
"chr21","120305782","120306099","GL873608","6630366","6630673","93","113675416"
"chr21","120335911","120336216","GL873528","36697151","36697434","95","83638760"
"chr21","120543120","120543382","GL873659","913070","913333","94","119630050"
"chr21","120560056","120560335","GL873547","2222074","2222356","92","118337982"
"chr21","120595449","120595754","GL873541","16268070","16268366","86","104327379"
"chr21","120597406","120597713","GL873541","16268070","16268366","88","104329336"
"chr21","120639987","120640168","GL873530","5593486","5593649","56","115046501"
"chr21","120640477","120640607","GL873550","5998776","5998900","36","114641701"
"chr21","120650407","120650648","GL873680","3005257","3005482","92","117645150"
"chr21","120787813","120788057","GL873547","5449763","5449997","94","115338050"
"chr21","120806727","120806867","GL873550","5998776","5998900","48","114807951"
"chr21","120828867","120829168","GL873541","16268070","16268366","86","104560797"
"chr21","120833680","120833742","GL873554","10500008","10500061","26","110333672"
"chr21","120849980","120850279","GL873530","16647228","16647517","85","104202752"
"chr21","121668261","121668572","GL873528","36697151","36697434","94","84971110"
"chr21","122629582","122629858","GL873547","2222074","2222356","91","120407508"
"chr21","122693272","122693565","GL873541","16268070","16268366","83","106425202"
"chr21","123338126","123338434","GL873541","16268070","16268366","89","107070056"
"chr21","123830201","123830497","GL873541","16268070","16268366","84","107562131"
"chr21","124183438","124183744","GL873541","16268070","16268366","92","107915368"
"chr21","124417271","124417562","GL873530","16647228","16647517","84","107770043"
"chr21","124458886","124459120","GL873564","8360716","8360913","79","116098170"
"chr21","124481383","124481673","GL873530","16647228","16647517","88","107834155"
"chr21","124764715","124764961","GL873528","25203621","25203847","79","99561094"
"chr21","125096530","125096824","GL873530","16647228","16647517","87","108449302"
"chr21","125287731","125288011","GL873562","3299887","3300144","84","121987844"
"chr21","125357410","125357717","GL873528","36697151","36697434","91","88660259"
"chr21","125373692","125373921","GL873680","3005257","3005482","69","122368435"
"chr21","125436020","125436308","GL873607","1418062","1418355","89","124017958"
"chr21","125448935","125449073","GL873541","1550303","1550443","59","123898632"
"chr21","125813352","125813599","GL873547","5449763","5449997","81","120363589"
"chr21","126135742","126135874","GL873550","5998776","5998900","54","120136966"
"chr21","126969960","126970241","GL873528","36697151","36697434","95","90272809"
"chr22","9699271","9699573","GL873541","16268070","16268366","86","6568799"
"chr22","1019013","1019323","GL873541","16268070","16268366","87","15249057"
"chr22","1205364","1205670","GL873547","2222074","2222356","95","1016710"
"chr22","2609490","2609778","GL873528","36697151","36697434","101","34087661"
"chr22","3180119","3180245","GL873622","7076274","7076365","53","3896155"
"chr22","3432000","3432159","GL873619","2497092","2497229","63","934908"
"chr22","5814787","5815092","GL873607","1418062","1418355","85","4396725"
"chr22","6188403","6188548","GL873619","2497092","2497229","50","3691311"
"chr22","7138029","7138318","GL873530","16647228","16647517","85","9509199"
"chr22","7481424","7481721","GL873541","16268070","16268366","80","8786646"
"chr22","7715181","7715503","GL873608","6630366","6630673","98","1084815"
"chr22","7975953","7976251","GL873541","16268070","16268366","86","8292117"
"chr22","8017862","8018148","GL873530","16647228","16647517","88","8629366"
"chr22","8041448","8041757","GL873528","36697151","36697434","99","28655703"
"chr22","8374352","8374668","GL873528","36697151","36697434","101","28322799"
"chr22","8462076","8462378","GL873541","16268070","16268366","84","7805994"
"chr22","8608706","8608984","GL873547","2222074","2222356","79","6386632"
"chr22","8900175","8900470","GL873530","16647228","16647517","89","7747053"
"chr22","8999497","8999785","GL873528","36697151","36697434","85","27697654"
"chr22","9062581","9062889","GL873530","16647228","16647517","91","7584647"
"chr22","9119652","9119940","GL873528","36697151","36697434","83","27577499"
"chr22","9145375","9145505","GL873550","5998776","5998900","38","3146599"
"chr22","9183381","9183596","GL873697","3111225","3111427","58","6072156"
"chr22","9209853","9210152","GL873541","16268070","16268366","88","7058217"
"chr22","9226203","9226481","GL873562","3299887","3300144","80","5926316"
"chr22","9333867","9334177","GL873528","36697151","36697434","97","27363284"
"chr22","9520134","9520352","GL873538","2567037","2567262","66","6953097"
"chr22","9615366","9615663","GL873541","16268070","16268366","84","6652704"
"chr22","9714838","9715138","GL873541","16268070","16268366","83","6553232"
"chr22","9742202","9742510","GL873530","16647228","16647517","96","6905026"
"chr22","9754823","9755101","GL873530","16647228","16647517","85","6892405"
"chr22","9894476","9894740","GL873562","3299887","3300144","87","6594589"
"chr22","9929073","9929380","GL873528","36697151","36697434","88","26768078"
"chr22","10008679","10008986","GL873541","16268070","16268366","92","6259391"
"chr22","10200012","10200317","GL873541","16268070","16268366","91","6068058"
"chr22","10288692","10289000","GL873541","16268070","16268366","96","5979378"
"chr22","10314777","10314973","GL873557","3858721","3858924","59","6456056"
"chr22","10488101","10488403","GL873530","16647228","16647517","99","6159127"
"chr22","10606644","10606950","GL873541","16268070","16268366","98","5661426"
"chr22","10640811","10641110","GL873541","16268070","16268366","85","5627259"
"chr22","10665491","10665654","GL873611","3799989","3800137","53","6865502"
"chr22","10736810","10737110","GL873541","16268070","16268366","90","5531260"
"chr22","10853052","10853344","GL873659","913070","913333","92","9939982"
"chr22","10891387","10891688","GL873530","16647228","16647517","87","5755841"
"chr22","11013889","11014152","GL873680","3005257","3005482","88","8008632"
"chr22","11241699","11241867","GL873530","5593486","5593649","50","5648213"
"chr22","11258829","11259120","GL873547","2222074","2222356","79","9036755"
"chr22","11362456","11362743","GL873530","16647228","16647517","82","5284772"
"chr22","11372766","11372980","GL873531","3555300","3555500","65","7817466"
"chr22","11406719","11407027","GL873541","16268070","16268366","98","4861351"
"chr22","11416175","11416303","GL873550","5998776","5998900","44","5417399"
"chr22","11459490","11459799","GL873530","16647228","16647517","108","5187738"
"chr22","11470385","11470694","GL873541","16268070","16268366","92","4797685"
"chr22","11610292","11610600","GL873541","16268070","16268366","96","4657778"
"chr22","11696147","11696444","GL873547","2222074","2222356","83","9474073"
"chr22","11696875","11697168","GL873752","427788","428097","90","11269087"
"chr22","12586145","12586451","GL873541","16268070","16268366","81","3681925"
"chr22","12759710","12760008","GL873541","16268070","16268366","86","3508360"
"chr22","12801052","12801351","GL873541","16268070","16268366","96","3467018"
"chr22","12826103","12826394","GL873530","16647228","16647517","84","3821125"
"chr22","12832734","12833034","GL873541","16268070","16268366","83","3435336"
"chr22","13085305","13085586","GL873547","2222074","2222356","88","10863231"
"chr22","13085631","13085646","GL873691","2903502","2903535","21","10182129"
"chr22","13374214","13374273","GL873550","5998911","5998963","29","7375303"
"chr22","13612240","13612528","GL873659","913070","913333","89","12699170"
"chr22","13908203","13908488","GL873528","36697151","36697434","83","22788948"
"chr22","13989142","13989247","GL873524","43272658","43272747","44","29283516"
"chr22","14015881","14016150","GL873530","16647228","16647517","95","2631347"
"chr22","14092070","14092370","GL873607","1418062","1418355","87","12674008"
"chr22","14429521","14429813","GL873547","2222074","2222356","86","12207447"
"chr22","14666916","14667224","GL873541","16268070","16268366","95","1601154"
"chr22","14674897","14675177","GL873547","2222074","2222356","85","12452823"
"chr22","14725489","14725798","GL873541","16268070","16268366","89","1542581"
"chr22","14741177","14741489","GL873541","16268070","16268366","96","1526893"
"chr22","14892648","14892954","GL873541","16268070","16268366","87","1375422"
"chr22","15613419","15613715","GL873530","16647228","16647517","94","1033809"
"chr22","16042165","16042455","GL873547","2222074","2222356","94","13820091"
"chr22","16898849","16899142","GL873541","16268070","16268366","100","630779"
"chr22","17000094","17000387","GL873530","16647228","16647517","79","352866"
"chr22","17486211","17486491","GL873547","2222074","2222356","88","15264137"
"chr22","17694908","17695179","GL873547","2222074","2222356","83","15472834"
"chr22","17851952","17852263","GL873528","36697151","36697434","87","18845199"
"chr22","17935429","17935598","GL873585","9209559","9209725","81","8725870"
"chr22","18034163","18034467","GL873528","36697151","36697434","90","18662988"
"chr22","18168216","18168519","GL873541","16268070","16268366","95","1900146"
"chr22","18362469","18362628","GL873550","5998776","5998900","58","12363693"
"chr22","18529123","18529262","GL873541","1550303","1550443","56","16978820"
"chr22","18531844","18532118","GL873547","2222074","2222356","86","16309770"
"chr22","18787578","18787885","GL873541","16268070","16268366","89","2519508"
"chr22","18861482","18861528","GL873550","5998911","5998963","26","12862571"
"chr22","19211021","19211318","GL873541","16268070","16268366","85","2942951"
"chr22","19339982","19340188","GL873535","24407607","24407780","71","5067625"
"chr22","19367458","19367724","GL873547","2222074","2222356","96","17145384"
"chr22","19511407","19511527","GL873622","7076274","7076365","47","12435133"
"chr22","19754015","19754323","GL873541","16268070","16268366","90","3485945"
"chr22","19783145","19783405","GL873680","3005257","3005482","83","16777888"
"chr22","20474535","20474834","GL873752","427788","428097","82","20046747"
"chr22","20837771","20838069","GL873541","16268070","16268366","87","4569701"
"chr22","22346206","22346509","GL873607","1418062","1418355","87","20928144"
"chr22","23000077","23000354","GL873562","3299887","3300144","94","19700190"
"chr22","23177183","23177474","GL873547","2222074","2222356","77","20955109"
"chr22","23310986","23311266","GL873530","16647228","16647517","86","6663758"
"chr22","23810714","23811009","GL873530","16647228","16647517","84","7163486"
"chr22","25058423","25058728","GL873541","16268070","16268366","85","8790353"
"chr22","25345603","25345886","GL873547","2222074","2222356","80","23123529"
"chr22","25383537","25383842","GL873541","16268070","16268366","85","9115467"
"chr22","26156068","26156373","GL873541","16268070","16268366","88","9887998"
"chr22","26416905","26417205","GL873541","16268070","16268366","90","10148835"
"chr22","26589266","26589560","GL873547","2222074","2222356","90","24367192"
"chr22","26862868","26863137","GL873562","3299887","3300144","86","23562981"
"chr22","27074075","27074227","GL873541","1550303","1550443","48","25523772"
"chr22","28610463","28610771","GL873541","16268070","16268366","92","12342393"
"chr22","28969873","28970168","GL873528","36697151","36697434","87","7727278"
"chr22","30234167","30234462","GL873541","16268070","16268366","80","13966097"
"chr22","30270640","30270808","GL873530","5593486","5593649","61","24677154"
"chr22","30353668","30353844","GL873530","5593486","5593649","52","24760182"
"chr22","30354126","30354136","GL873691","2903502","2903535","23","27450624"
"chr22","30730992","30731298","GL873541","16268070","16268366","90","14462922"
"chr22","31041182","31041486","GL873541","16268070","16268366","107","14773112"
"chr22","31386790","31386954","GL873530","5593486","5593649","59","25793304"
"chr22","31705293","31705573","GL873547","2222074","2222356","86","29483219"
"chr22","31951671","31951949","GL873565","12307556","12307825","90","19644115"
"chr22","32169665","32169962","GL873608","6630366","6630673","90","25539299"
"chr22","32394522","32394825","GL873547","2222074","2222356","97","30172448"
"chr22","33837479","33837773","GL873530","16647228","16647517","104","17190251"
"chr22","33905031","33905333","GL873541","16268070","16268366","97","17636961"
"chr22","33946284","33946571","GL873530","16647228","16647517","90","17299056"
"chr22","34122676","34122960","GL873547","2222074","2222356","87","31900602"
"chr22","34201969","34202268","GL873541","16268070","16268366","83","17933899"
"chr22","34312589","34312883","GL873547","2222074","2222356","88","32090515"
"chr22","34825845","34826137","GL873528","36697151","36697434","89","1871306"
"chr22","34834307","34834609","GL873541","16268070","16268366","94","18566237"
"chr22","35150131","35150445","GL873528","36697151","36697434","100","1547020"
"chr22","35245367","35245667","GL873541","16268070","16268366","94","18977297"
"chr22","35824900","35825194","GL873547","2222074","2222356","83","33602826"
"chr22","36426191","36426290","GL873524","43272658","43272747","43","6846467"
"chr22","36488559","36488857","GL873541","16268070","16268366","83","20220489"
"chr22","36793001","36793310","GL873608","6630366","6630673","89","30162635"
"chr22","38119461","38119749","GL873547","2222074","2222356","84","35897387"
"chr22","38557420","38557718","GL873541","16268070","16268366","85","22289350"
"chr22","38846050","38846343","GL873530","16647228","16647517","81","22198822"
"chr22","38931323","38931631","GL873541","16268070","16268366","89","22663253"
"chr22","39804462","39804752","GL873530","16647228","16647517","84","23157234"
"chr22","40068244","40068533","GL873547","2222074","2222356","86","37846170"
"chr22","40432524","40432849","GL873608","6630366","6630673","117","33802158"
"chr22","40854360","40854660","GL873541","16268070","16268366","91","24586290"
"chr22","41165428","41165723","GL873547","2222074","2222356","88","38943354"
"chr22","41174753","41174858","GL873524","43272658","43272747","42","2097905"
"chr22","41185894","41186186","GL873541","16268070","16268366","80","24917824"
"chr22","41272196","41272486","GL873547","2222074","2222356","82","39050122"
"chr22","43048919","43049201","GL873562","3299887","3300144","96","39749032"
"chr22","43121836","43122138","GL873530","16647228","16647517","91","26474608"
"chr22","43407731","43408031","GL873541","16268070","16268366","91","27139661"
"chr22","43830057","43830316","GL873543","13038674","13038909","100","30791383"
"chr22","44868771","44869068","GL873541","16268070","16268366","92","28600701"
"chr22","45364580","45364873","GL873608","6630366","6630673","85","38734214"
"chr22","45531342","45531633","GL873547","2222074","2222356","81","43309268"
"chr22","45546705","45547014","GL873541","16268070","16268366","95","29278635"
"chr22","45865078","45865276","GL873558","7532067","7532273","57","38333011"
"chr22","45992941","45993256","GL873547","2222074","2222356","101","43770867"
"chr22","46276056","46276360","GL873547","2222074","2222356","88","44053982"
"chr22","46279181","46279452","GL873562","3299887","3300144","92","42979294"
"chr22","46463445","46463548","GL873546","7627047","7627148","42","38836398"
"chr22","46619862","46620158","GL873547","2222074","2222356","82","44397788"
"chr22","47240034","47240339","GL873541","16268070","16268366","89","30971964"
"chr22","47344176","47344477","GL873659","913070","913333","89","46431106"
"chr22","47544388","47544685","GL873541","16268070","16268366","87","31276318"
"chr22","47921147","47921435","GL873547","2222074","2222356","75","45699073"
"chr22","48035770","48036066","GL873541","16268070","16268366","88","31767700"
"chr22","48314402","48314693","GL873530","16647228","16647517","75","31667174"
"chr22","48566753","48567059","GL873607","1418062","1418355","90","47148691"
"chr22","48675315","48675608","GL873530","16647228","16647517","83","32028087"
"chr22","48723618","48723929","GL873541","16268070","16268366","94","32455548"
"chr22","49402212","49402491","GL873547","2222074","2222356","89","47180138"
"chr22","49445421","49445729","GL873541","16268070","16268366","97","33177351"
"chr22","49787436","49787727","GL873547","2222074","2222356","86","47565362"
"chr22","50844230","50844533","GL873541","16268070","16268366","86","34576160"
"chr22","51282171","51282291","GL873622","7076274","7076365","47","44205897"
"chr22","51367641","51367917","GL873547","2222074","2222356","89","49145567"
"chr22","51593558","51593861","GL873528","36697151","36697434","89","14896407"
"chr22","51803732","51804029","GL873530","16647228","16647517","85","35156504"
"chr22","51830050","51830341","GL873530","16647228","16647517","91","35182822"
"chr22","51935182","51935476","GL873547","2222074","2222356","87","49713108"
"chr22","52015872","52016167","GL873530","16647228","16647517","84","35368644"
"chr22","52177924","52178221","GL873659","913070","913333","83","51264854"
"chr22","52341420","52341721","GL873528","36697151","36697434","88","15644269"
"chr22","52349622","52349921","GL873541","16268070","16268366","87","36081552"
"chr22","52355055","52355313","GL873680","3005257","3005482","81","49349798"
"chr22","52379511","52379797","GL873541","16268070","16268366","91","36111441"
"chr22","52402772","52402906","GL873550","5998776","5998900","51","46403996"
"chr22","52441231","52441522","GL873607","1418062","1418355","91","51023169"
"chr22","53710553","53710837","GL873547","2222074","2222356","92","51488479"
"chr22","54422526","54422759","GL873557","3858721","3858924","77","50563805"
"chr22","54435598","54435914","GL873541","16268070","16268366","103","38167528"
"chr22","54612189","54612490","GL873541","16268070","16268366","95","38344119"
"chr22","55340272","55340402","GL873550","5998776","5998900","34","49341496"
"chr22","55367691","55367979","GL873547","2222074","2222356","84","53145617"
"chr22","55846995","55847293","GL873530","16647228","16647517","86","39199767"
"chr22","56826752","56827051","GL873530","16647228","16647517","85","40179524"
"chr22","57029627","57029931","GL873530","16647228","16647517","92","40382399"
"chr22","57467619","57467765","GL873550","5998776","5998900","54","51468843"
"chr22","57794820","57795110","GL873547","2222074","2222356","82","55572746"
"chr22","58181828","58182112","GL873541","16268070","16268366","83","41913758"
"chr22","58550388","58550705","GL873541","16268070","16268366","97","42282318"
"chr22","58559388","58559692","GL873541","16268070","16268366","84","42291318"
"chr22","59004223","59004526","GL873541","16268070","16268366","88","42736153"
"chr22","59235799","59236107","GL873541","16268070","16268366","91","42967729"
"chr22","59313204","59313418","GL873630","2508568","2508753","63","56804636"
"chr22","60500152","60500460","GL873528","36697151","36697434","92","23803001"
"chr22","60702805","60703036","GL873538","2567037","2567262","77","58135768"
"chr22","60712414","60712713","GL873541","16268070","16268366","80","44444344"
"chr22","61255457","61255677","GL873538","2567037","2567262","65","58688420"
"chr22","62191786","62192071","GL873547","2222074","2222356","84","59969712"
"chr22","62519851","62519996","GL873628","6402015","6402153","61","56117836"
"chr22","65760377","65760684","GL873607","1418062","1418355","96","64342315"
"chr22","66604733","66604858","GL873622","7076274","7076365","50","59528459"
"chr22","66780834","66781126","GL873541","16268070","16268366","87","50512764"
"chr22","67133140","67133407","GL873680","3005257","3005482","94","64127883"
"chr22","67153955","67154223","GL873562","3299887","3300144","86","63854068"
"chr22","67269399","67269538","GL873550","5998776","5998900","44","61270623"
"chr22","67435237","67435541","GL873541","16268070","16268366","89","51167167"
"chr22","67731592","67731898","GL873541","16268070","16268366","80","51463522"
"chr22","67789803","67790100","GL873541","16268070","16268366","89","51521733"
"chr22","68342074","68342386","GL873530","16647228","16647517","104","51694846"
"chr22","68381507","68381734","GL873538","2567037","2567262","72","65814470"
"chr22","69421429","69421506","GL873603","2092652","2092704","40","67328777"
"chr22","70384752","70385069","GL873541","16268070","16268366","97","54116682"
"chr22","70978181","70978471","GL873547","2222074","2222356","81","68756107"
"chr22","71176002","71176299","GL873530","16647228","16647517","80","54528774"
"chr22","71294931","71295062","GL873550","5998776","5998900","57","65296155"
"chr22","71385332","71385600","GL873547","2222074","2222356","87","69163258"
"chr22","71392479","71392763","GL873547","2222074","2222356","85","69170405"
"chr22","71413407","71413642","GL873528","25203621","25203847","75","46209786"
"chr22","71514392","71514689","GL873541","16268070","16268366","88","55246322"
"chr22","71874724","71874995","GL873562","3299887","3300144","82","68574837"
"chr22","72729148","72729493","GL873528","36697151","36697434","132","36031997"
"chr22","73085737","73086028","GL873547","2222074","2222356","84","70863663"
"chr22","73095152","73095451","GL873547","2222074","2222356","84","70873078"
"chr22","73890472","73890806","GL873528","36697151","36697434","122","37193321"
"chr22","73897555","73897860","GL873541","16268070","16268366","96","57629485"
"chr22","73908519","73908809","GL873547","2222074","2222356","84","71686445"
"chr22","74065039","74065314","GL873565","12307556","12307825","94","61757483"
"chr22","74065325","74065376","GL873554","10500008","10500061","18","63565317"
"chr22","74213722","74214001","GL873547","2222074","2222356","85","71991648"
"chr22","74214102","74214239","GL873550","5998776","5998900","42","68215326"
"chr22","74227320","74227626","GL873541","16268070","16268366","87","57959250"
"chr22","74857230","74857409","GL873524","42560728","42560902","53","32296502"
"chr22","74857410","74857671","GL873528","25203621","25203847","86","49653789"
"chr22","75145785","75146086","GL873541","16268070","16268366","86","58877715"
"chr22","75202034","75202080","GL873527","37742071","37742124","23","37459963"
"chr22","76208854","76209160","GL873528","36697151","36697434","97","39511703"
"chr22","76270009","76270186","GL873521","1458597","1458764","64","74811412"
"chr22","76298710","76299005","GL873528","36697151","36697434","91","39601559"
"chr22","77871788","77871921","GL873550","5998776","5998900","39","71873012"
"chr22","78180940","78181212","GL873562","3299887","3300144","89","74881053"
"chr22","78181272","78181577","GL873607","1418062","1418355","101","76763210"
"chr22","79035729","79036038","GL873541","16268070","16268366","97","62767659"
"chr22","79130288","79130561","GL873528","36697151","36697434","91","42433137"
"chr22","79859477","79859748","GL873565","12307556","12307825","94","67551921"
"chr22","80043816","80044092","GL873530","16647228","16647517","92","63396588"
"chr22","80196525","80196828","GL873541","16268070","16268366","91","63928455"
"chr22","80650473","80650752","GL873530","16647228","16647517","83","64003245"
"chr22","80679179","80679483","GL873541","16268070","16268366","85","64411109"
"chr22","81370851","81371151","GL873541","16268070","16268366","88","65102781"
"chr22","81783868","81784167","GL873541","16268070","16268366","92","65515798"
"chr22","81901669","81901950","GL873530","16647228","16647517","104","65254441"
"chr22","81901952","81902085","GL873550","5998776","5998900","33","75903176"
"chr22","82391296","82391600","GL873541","16268070","16268366","96","66123226"
"chr22","83461646","83461954","GL873530","16647228","16647517","95","66814418"
"chr22","83673783","83674098","GL873541","16268070","16268366","96","67405713"
"chr22","84773295","84773594","GL873541","16268070","16268366","87","68505225"
"chr22","86316089","86316223","GL873698","1314482","1314610","69","85001607"
"chr22","86682929","86683222","GL873530","16647228","16647517","85","70035701"
"chr22","86768040","86768266","GL873640","6426205","6426399","77","80341835"
"chr22","86828139","86828312","GL873530","5593486","5593649","54","81234653"
"chr22","86828313","86828618","GL873541","16268070","16268366","84","70560243"
"chr22","88301946","88302229","GL873530","16647228","16647517","91","71654718"
"chr22","89351948","89352234","GL873547","2222074","2222356","82","87129874"
"chr22","89616315","89616618","GL873541","16268070","16268366","85","73348245"
"chr22","90892491","90892760","GL873562","3299887","3300144","89","87592604"
"chr22","91264999","91265311","GL873607","1418062","1418355","97","89846937"
"chr22","91349723","91350016","GL873547","2222074","2222356","76","89127649"
"chr22","92414737","92415010","GL873547","2222074","2222356","87","90192663"
"chr22","94574472","94574572","GL873603","2092720","2092796","41","92481752"
"chr22","94574583","94574800","GL873538","2567037","2567262","59","92007546"
"chr22","95239299","95239587","GL873547","2222074","2222356","78","93017225"
"chr22","95328648","95328964","GL873528","36697151","36697434","100","58631497"
"chr22","95765134","95765436","GL873541","16268070","16268366","91","79497064"
"chr22","96707922","96708214","GL873547","2222074","2222356","88","94485848"
"chr22","97758089","97758345","GL873680","3005257","3005482","87","94752832"
"chr22","99094220","99094505","GL873547","2222074","2222356","80","96872146"
"chr22","99688459","99688586","GL873541","1550303","1550443","55","98138156"
"chr22","99768771","99769071","GL873541","16268070","16268366","86","83500701"
"chr22","100694448","100694738","GL873547","2222074","2222356","83","98472374"
"chr23","81395673","81395962","GL873530","16647228","16647517","80","64748445"
"chr23","1425575","1425859","GL873547","2222074","2222356","85","796499"
"chr23","2154678","2154981","GL873528","36697151","36697434","88","34542473"
"chr23","2585941","2586110","GL873524","23693028","23693185","63","21107087"
"chr23","2921677","2921974","GL873541","16268070","16268366","83","13346393"
"chr23","2982829","2983115","GL873547","2222074","2222356","82","760755"
"chr23","3123018","3123241","GL873538","2567037","2567262","71","555981"
"chr23","3797499","3797794","GL873530","16647228","16647517","84","12849729"
"chr23","5545466","5545700","GL873531","3555300","3555500","72","1990166"
"chr23","6191139","6191448","GL873541","16268070","16268366","94","10076931"
"chr23","6539800","6540082","GL873547","2222074","2222356","89","4317726"
"chr23","6881836","6882101","GL873680","3005257","3005482","98","3876579"
"chr23","7334731","7335011","GL873565","12307556","12307825","97","4972825"
"chr23","7369266","7369565","GL873547","2222074","2222356","88","5147192"
"chr23","8035052","8035349","GL873530","16647228","16647517","82","8612176"
"chr23","8050460","8050740","GL873547","2222074","2222356","89","5828386"
"chr23","9240605","9240908","GL873541","16268070","16268366","95","7027465"
"chr23","9902971","9903200","GL873538","2567037","2567262","72","7335934"
"chr23","12799637","12799937","GL873541","16268070","16268366","85","3468433"
"chr23","13914464","13914773","GL873541","16268070","16268366","96","2353606"
"chr23","14133211","14133472","GL873680","3005257","3005482","91","11127954"
"chr23","14421159","14421466","GL873541","16268070","16268366","89","1846911"
"chr23","14748177","14748480","GL873528","36697151","36697434","85","21948974"
"chr23","14890088","14890386","GL873541","16268070","16268366","94","1377982"
"chr23","14987843","14988055","GL873530","5593486","5593649","83","9394357"
"chr23","15632865","15633015","GL873530","5593486","5593649","54","10039379"
"chr23","15746217","15746498","GL873547","2222074","2222356","90","13524143"
"chr23","15780758","15781067","GL873528","36697151","36697434","93","20916393"
"chr23","15788053","15788352","GL873541","16268070","16268366","87","480017"
"chr23","15947986","15948283","GL873528","36697151","36697434","96","20749165"
"chr23","16078498","16078800","GL873659","913070","913333","94","15165428"
"chr23","16185233","16185534","GL873607","1418062","1418355","97","14767171"
"chr23","16346527","16346792","GL873565","12307556","12307825","90","4038971"
"chr23","16381004","16381314","GL873541","16268070","16268366","98","112934"
"chr23","16885528","16885821","GL873547","2222074","2222356","81","14663454"
"chr23","19522217","19522509","GL873541","16268070","16268366","88","3254147"
"chr23","20058490","20058786","GL873530","16647228","16647517","86","3411262"
"chr23","21194674","21194981","GL873541","16268070","16268366","94","4926604"
"chr23","21230153","21230353","GL873530","5593486","5593649","79","15636667"
"chr23","21500132","21500258","GL873550","5998776","5998900","32","15501356"
"chr23","21500312","21500482","GL873530","5593486","5593649","53","15906826"
"chr23","21686833","21686949","GL873552","12711845","12711956","47","8974988"
"chr23","22080242","22080537","GL873530","16647228","16647517","83","5433014"
"chr23","22274894","22275180","GL873752","427788","428097","87","21847106"
"chr23","22353875","22354136","GL873680","3005257","3005482","88","19348618"
"chr23","22497939","22498216","GL873680","3005257","3005482","104","19492682"
"chr23","23283800","23284075","GL873547","2222074","2222356","90","21061726"
"chr23","25570629","25570915","GL873528","36697151","36697434","91","11126522"
"chr23","25636902","25637132","GL873680","3005257","3005482","67","22631645"
"chr23","25863901","25864185","GL873565","12307556","12307825","96","13556345"
"chr23","25993752","25994034","GL873547","2222074","2222356","88","23771678"
"chr23","27243161","27243449","GL873608","6630366","6630673","91","20612795"
"chr23","27251779","27252096","GL873528","36697151","36697434","97","9445372"
"chr23","27813152","27813464","GL873541","16268070","16268366","93","11545082"
"chr23","28206373","28206687","GL873541","16268070","16268366","89","11938303"
"chr23","28500115","28500409","GL873541","16268070","16268366","85","12232045"
"chr23","29412409","29412715","GL873541","16268070","16268366","94","13144339"
"chr23","29559825","29560111","GL873530","16647228","16647517","91","12912597"
"chr23","29726953","29727218","GL873562","3299887","3300144","83","26427066"
"chr23","29750557","29750835","GL873565","12307556","12307825","96","17443001"
"chr23","29830788","29831081","GL873530","16647228","16647517","79","13183560"
"chr23","30518743","30519029","GL873528","36697151","36697434","103","6178408"
"chr23","30715158","30715464","GL873541","16268070","16268366","87","14447088"
"chr23","30902783","30903068","GL873530","16647228","16647517","86","14255555"
"chr23","31175837","31176140","GL873528","36697151","36697434","97","5521314"
"chr23","31653121","31653420","GL873547","2222074","2222356","86","29431047"
"chr23","32206161","32206469","GL873541","16268070","16268366","91","15938091"
"chr23","32226999","32227325","GL873541","16268070","16268366","109","15958929"
"chr23","34060209","34060496","GL873547","2222074","2222356","70","31838135"
"chr23","34339374","34339682","GL873530","16647228","16647517","93","17692146"
"chr23","35247326","35247634","GL873530","16647228","16647517","96","18600098"
"chr23","35560373","35560665","GL873607","1418062","1418355","96","34142311"
"chr23","35735447","35735750","GL873541","16268070","16268366","85","19467377"
"chr23","35812465","35812765","GL873541","16268070","16268366","86","19544395"
"chr23","35824891","35825192","GL873541","16268070","16268366","96","19556821"
"chr23","35857978","35858261","GL873565","12307556","12307825","104","23550422"
"chr23","35918739","35919019","GL873562","3299887","3300144","83","32618852"
"chr23","36800370","36800653","GL873528","36697151","36697434","102","103219"
"chr23","36825870","36826165","GL873541","16268070","16268366","79","20557800"
"chr23","36874985","36875122","GL873550","5998776","5998900","39","30876209"
"chr23","37041331","37041446","GL873550","5998776","5998900","37","31042555"
"chr23","37043050","37043157","GL873550","5998776","5998900","37","31044274"
"chr23","37044351","37044654","GL873528","36697151","36697434","96","347200"
"chr23","37087327","37087607","GL873547","2222074","2222356","81","34865253"
"chr23","37088897","37089015","GL873587","10002051","10002151","49","27086846"
"chr23","37263176","37263318","GL873619","2497092","2497229","49","34766084"
"chr23","37281955","37282090","GL873550","5998776","5998900","37","31283179"
"chr23","37388023","37388329","GL873541","16268070","16268366","85","21119953"
"chr23","37472216","37472522","GL873607","1418062","1418355","93","36054154"
"chr23","37481428","37481516","GL873622","7076274","7076365","42","30405154"
"chr23","37577028","37577162","GL873550","5998776","5998900","38","31578252"
"chr23","37594659","37594963","GL873541","16268070","16268366","96","21326589"
"chr23","37622829","37623120","GL873608","6630366","6630673","89","30992463"
"chr23","37641049","37641343","GL873530","16647228","16647517","84","20993821"
"chr23","37797083","37797393","GL873541","16268070","16268366","90","21529013"
"chr23","38922269","38922564","GL873530","16647228","16647517","81","22275041"
"chr23","39001740","39002032","GL873541","16268070","16268366","77","22733670"
"chr23","39587784","39588095","GL873541","16268070","16268366","94","23319714"
"chr23","40664623","40664894","GL873562","3299887","3300144","82","37364736"
"chr23","40806316","40806598","GL873547","2222074","2222356","85","38584242"
"chr23","40826185","40826479","GL873547","2222074","2222356","90","38604111"
"chr23","40832755","40833005","GL873528","25203621","25203847","100","15629134"
"chr23","40876209","40876503","GL873547","2222074","2222356","86","38654135"
"chr23","40918051","40918350","GL873607","1418062","1418355","86","39499989"
"chr23","40996685","40996984","GL873541","16268070","16268366","85","24728615"
"chr23","41058601","41058888","GL873547","2222074","2222356","89","38836527"
"chr23","41108818","41109109","GL873530","16647228","16647517","80","24461590"
"chr23","41245604","41245855","GL873659","913070","913333","92","40332534"
"chr23","41377810","41378117","GL873528","36697151","36697434","94","4680659"
"chr23","41454856","41455159","GL873541","16268070","16268366","83","25186786"
"chr23","41519793","41520099","GL873541","16268070","16268366","93","25251723"
"chr23","41750102","41750409","GL873541","16268070","16268366","90","25482032"
"chr23","41937596","41937890","GL873528","36697151","36697434","103","5240445"
"chr23","42225613","42225900","GL873607","1418062","1418355","86","40807551"
"chr23","42376076","42376272","GL873697","3111225","3111427","74","39264851"
"chr23","42922019","42922224","GL873524","42560728","42560902","68","361291"
"chr23","42927144","42927446","GL873541","16268070","16268366","93","26659074"
"chr23","43057311","43057600","GL873547","2222074","2222356","90","40835237"
"chr23","43083511","43083801","GL873547","2222074","2222356","83","40861437"
"chr23","43174395","43174688","GL873547","2222074","2222356","92","40952321"
"chr23","43291039","43291346","GL873528","36697151","36697434","85","6593888"
"chr23","43351949","43352255","GL873541","16268070","16268366","94","27083879"
"chr23","43371419","43371719","GL873530","16647228","16647517","86","26724191"
"chr23","43611135","43611328","GL873524","42560728","42560902","71","1050407"
"chr23","43781643","43781924","GL873562","3299887","3300144","90","40481756"
"chr23","44015679","44015974","GL873530","16647228","16647517","84","27368451"
"chr23","44065431","44065711","GL873547","2222074","2222356","87","41843357"
"chr23","44072365","44072498","GL873550","5998776","5998900","38","38073589"
"chr23","44105128","44105398","GL873565","12307556","12307825","108","31797572"
"chr23","44127786","44128088","GL873541","16268070","16268366","98","27859716"
"chr23","44164359","44164660","GL873541","16268070","16268366","76","27896289"
"chr23","44175545","44175716","GL873530","5593486","5593649","57","38582059"
"chr23","44204699","44205001","GL873547","2222074","2222356","89","41982625"
"chr23","44728798","44729060","GL873565","12307556","12307825","88","32421242"
"chr23","44781225","44781390","GL873530","5593486","5593649","46","39187739"
"chr23","44797757","44797907","GL873619","2497092","2497229","58","42300665"
"chr23","44807941","44808237","GL873547","2222074","2222356","83","42585867"
"chr23","44842799","44842925","GL873541","15100979","15101074","52","29741820"
"chr23","45007949","45008252","GL873541","16268070","16268366","90","28739879"
"chr23","45120745","45121067","GL873541","16268070","16268366","105","28852675"
"chr23","45383243","45383541","GL873530","16647228","16647517","83","28736015"
"chr23","45509143","45509430","GL873530","16647228","16647517","81","28861915"
"chr23","45768027","45768333","GL873530","16647228","16647517","85","29120799"
"chr23","46626246","46626546","GL873530","16647228","16647517","88","29979018"
"chr23","46965763","46966071","GL873541","16268070","16268366","91","30697693"
"chr23","47269842","47270135","GL873530","16647228","16647517","80","30622614"
"chr23","48046093","48046389","GL873608","6630366","6630673","86","41415727"
"chr23","48102482","48102766","GL873528","36697151","36697434","93","11405331"
"chr23","48648713","48649015","GL873547","2222074","2222356","90","46426639"
"chr23","48781772","48782073","GL873541","16268070","16268366","91","32513702"
"chr23","48867787","48868091","GL873541","16268070","16268366","92","32599717"
"chr23","48995816","48996012","GL873535","24407607","24407780","69","24588209"
"chr23","49074472","49074713","GL873528","25203621","25203847","83","23870851"
"chr23","49183004","49183254","GL873659","913070","913333","87","48269934"
"chr23","49444775","49445081","GL873541","16268070","16268366","93","33176705"
"chr23","49548546","49548845","GL873541","16268070","16268366","79","33280476"
"chr23","49845432","49845639","GL873538","2567037","2567262","70","47278395"
"chr23","50149627","50149920","GL873541","16268070","16268366","89","33881557"
"chr23","50229116","50229391","GL873562","3299887","3300144","94","46929229"
"chr23","50724929","50725237","GL873541","16268070","16268366","92","34456859"
"chr23","50939741","50940022","GL873562","3299887","3300144","88","47639854"
"chr23","51149623","51149911","GL873547","2222074","2222356","78","48927549"
"chr23","51878662","51878948","GL873530","16647228","16647517","77","35231434"
"chr23","52148083","52148392","GL873541","16268070","16268366","96","35880013"
"chr23","52171314","52171614","GL873541","16268070","16268366","86","35903244"
"chr23","52188598","52188932","GL873812","559768","560073","103","51628830"
"chr23","52347020","52347312","GL873530","16647228","16647517","80","35699792"
"chr23","52506499","52506722","GL873538","2567037","2567262","63","49939462"
"chr23","52521673","52521952","GL873528","36697151","36697434","84","15824522"
"chr23","52695116","52695403","GL873812","559768","560073","94","52135348"
"chr23","53096015","53096312","GL873541","16268070","16268366","85","36827945"
"chr23","53913635","53913771","GL873691","508903","509045","62","53404732"
"chr23","53954681","53954953","GL873562","3299887","3300144","89","50654794"
"chr23","53966813","53967123","GL873528","36697151","36697434","97","17269662"
"chr23","54197226","54197503","GL873547","2222074","2222356","87","51975152"
"chr23","55163642","55163933","GL873547","2222074","2222356","85","52941568"
"chr23","56272918","56273221","GL873541","16268070","16268366","90","40004848"
"chr23","56956718","56956928","GL873531","3555300","3555500","69","53401418"
"chr23","56999091","56999384","GL873530","16647228","16647517","79","40351863"
"chr23","57002695","57002826","GL873550","5998776","5998900","31","51003919"
"chr23","57101042","57101187","GL873541","1550303","1550443","56","55550739"
"chr23","57288405","57288717","GL873528","36697151","36697434","99","20591254"
"chr23","57298426","57298716","GL873667","4451263","4451534","91","52847163"
"chr23","57308796","57309046","GL873680","3005257","3005482","77","54303539"
"chr23","57612824","57613126","GL873541","16268070","16268366","80","41344754"
"chr23","57759830","57760117","GL873547","2222074","2222356","82","55537756"
"chr23","57971220","57971527","GL873541","16268070","16268366","87","41703150"
"chr23","59026421","59026726","GL873541","16268070","16268366","90","42758351"
"chr23","59388525","59388825","GL873530","16647228","16647517","89","42741297"
"chr23","59579536","59579807","GL873565","12307556","12307825","92","47271980"
"chr23","59582610","59582778","GL873529","2453810","2453957","66","57128800"
"chr23","59622743","59623065","GL873608","6630366","6630673","92","52992377"
"chr23","59947543","59947659","GL873622","7076274","7076365","41","52871269"
"chr23","60066478","60066800","GL873541","16268070","16268366","103","43798408"
"chr23","60150739","60150971","GL873564","8360716","8360913","77","51790023"
"chr23","60298399","60298573","GL873524","42560728","42560902","57","17737671"
"chr23","60305444","60305722","GL873547","2222074","2222356","82","58083370"
"chr23","60371285","60371593","GL873541","16268070","16268366","91","44103215"
"chr23","61329702","61330007","GL873541","16268070","16268366","88","45061632"
"chr23","61603235","61603511","GL873562","3299887","3300144","92","58303348"
"chr23","61628974","61629290","GL873752","427788","428097","99","61201186"
"chr23","62385682","62385982","GL873541","16268070","16268366","81","46117612"
"chr23","62410837","62411144","GL873541","16268070","16268366","96","46142767"
"chr23","62536996","62537276","GL873562","3299887","3300144","90","59237109"
"chr23","62626129","62626405","GL873667","4451263","4451534","88","58174866"
"chr23","62683290","62683571","GL873547","2222074","2222356","91","60461216"
"chr23","62727050","62727358","GL873541","16268070","16268366","96","46458980"
"chr23","62849063","62849242","GL873530","5593486","5593649","55","57255577"
"chr23","63036814","63037090","GL873562","3299887","3300144","88","59736927"
"chr23","63097278","63097570","GL873530","16647228","16647517","81","46450050"
"chr23","64155397","64155733","GL873530","16647228","16647517","115","47508169"
"chr23","64321256","64321499","GL873680","3005257","3005482","80","61315999"
"chr23","64360468","64360765","GL873541","16268070","16268366","86","48092398"
"chr23","65059093","65059390","GL873530","16647228","16647517","84","48411865"
"chr23","66790883","66791182","GL873607","1418062","1418355","88","65372821"
"chr23","67686738","67687045","GL873547","2222074","2222356","94","65464664"
"chr23","67778659","67778959","GL873541","16268070","16268366","89","51510589"
"chr23","68204267","68204559","GL873667","4451263","4451534","92","63753004"
"chr23","68419972","68420260","GL873547","2222074","2222356","72","66197898"
"chr23","68749220","68749513","GL873547","2222074","2222356","88","66527146"
"chr23","69314146","69314436","GL873530","16647228","16647517","86","52666918"
"chr23","70547778","70548073","GL873541","16268070","16268366","86","54279708"
"chr23","71162019","71162306","GL873547","2222074","2222356","74","68939945"
"chr23","71828245","71828547","GL873541","16268070","16268366","87","55560175"
"chr23","71906236","71906536","GL873541","16268070","16268366","82","55638166"
"chr23","72898795","72899092","GL873547","2222074","2222356","85","70676721"
"chr23","73443707","73444001","GL873607","1418062","1418355","77","72025645"
"chr23","73792593","73792805","GL873625","6060130","6060345","59","67732463"
"chr23","73943186","73943520","GL873541","16268070","16268366","115","57675116"
"chr23","73993482","73993792","GL873752","427788","428097","98","73565694"
"chr23","74233023","74233321","GL873541","16268070","16268366","88","57964953"
"chr23","74239821","74240125","GL873541","16268070","16268366","91","57971751"
"chr23","74322396","74322703","GL873752","427788","428097","102","73894608"
"chr23","74349864","74350142","GL873547","2222074","2222356","80","72127790"
"chr23","74350222","74350527","GL873607","1418062","1418355","96","72932160"
"chr23","74365338","74365633","GL873530","16647228","16647517","83","57718110"
"chr23","74370038","74370324","GL873547","2222074","2222356","82","72147964"
"chr23","74449751","74450046","GL873530","16647228","16647517","85","57802523"
"chr23","74492423","74492703","GL873659","913070","913333","87","73579353"
"chr23","74687797","74688087","GL873530","16647228","16647517","80","58040569"
"chr23","74876437","74876752","GL873608","6630366","6630673","98","68246071"
"chr23","74977414","74977720","GL873541","16268070","16268366","90","58709344"
"chr23","75075445","75075691","GL873680","3005257","3005482","77","72070188"
"chr23","75776725","75777008","GL873547","2222074","2222356","89","73554651"
"chr23","75939727","75940036","GL873530","16647228","16647517","93","59292499"
"chr23","76077886","76078182","GL873541","16268070","16268366","80","59809816"
"chr23","76307669","76307973","GL873528","36697151","36697434","89","39610518"
"chr23","76506735","76507048","GL873530","16647228","16647517","94","59859507"
"chr23","76640346","76640649","GL873541","16268070","16268366","91","60372276"
"chr23","76772939","76773247","GL873528","36697151","36697434","87","40075788"
"chr23","76938560","76938855","GL873752","427788","428097","85","76510772"
"chr23","77412682","77412987","GL873541","16268070","16268366","86","61144612"
"chr23","77711216","77711506","GL873659","913070","913333","91","76798146"
"chr23","77795214","77795523","GL873541","16268070","16268366","86","61527144"
"chr23","77806185","77806493","GL873541","16268070","16268366","93","61538115"
"chr23","78084416","78084726","GL873541","16268070","16268366","85","61816346"
"chr23","78163047","78163380","GL873530","16647228","16647517","113","61515819"
"chr23","78227620","78227929","GL873541","16268070","16268366","92","61959550"
"chr23","78457493","78457790","GL873667","4451263","4451534","88","74006230"
"chr23","78468799","78469078","GL873530","16647228","16647517","90","61821571"
"chr23","79036882","79037174","GL873547","2222074","2222356","84","76814808"
"chr23","79133871","79134164","GL873530","16647228","16647517","79","62486643"
"chr23","79161633","79161730","GL873622","7076274","7076365","38","72085359"
"chr23","79162002","79162016","GL873691","2903502","2903535","21","76258500"
"chr23","79620999","79621277","GL873565","12307556","12307825","91","67313443"
"chr23","79650541","79650766","GL873528","25203621","25203847","85","54446920"
"chr23","79882920","79883023","GL873524","43272658","43272747","43","36610262"
"chr23","79884796","79885070","GL873659","913070","913333","85","78971726"
"chr23","79889988","79890259","GL873562","3299887","3300144","88","76590101"
"chr23","80014640","80014946","GL873541","16268070","16268366","89","63746570"
"chr23","80040682","80040974","GL873547","2222074","2222356","83","77818608"
"chr23","80225356","80225652","GL873541","16268070","16268366","82","63957286"
"chr23","80316086","80316382","GL873530","16647228","16647517","83","63668858"
"chr23","80397235","80397521","GL873528","36697151","36697434","104","43700084"
"chr23","80642893","80643191","GL873541","16268070","16268366","76","64374823"
"chr23","81021887","81022201","GL873541","16268070","16268366","102","64753817"
"chr23","81233541","81233847","GL873547","2222074","2222356","92","79011467"
"chr23","81285499","81285798","GL873607","1418062","1418355","88","79867437"
"chr23","81402491","81402780","GL873547","2222074","2222356","84","79180417"
"chr23","81593932","81594226","GL873541","16268070","16268366","92","65325862"
"chr23","82158504","82158780","GL873562","3299887","3300144","85","78858617"
"chr23","82232734","82233050","GL873541","16268070","16268366","104","65964664"
"chr23","82252718","82252995","GL873547","2222074","2222356","82","80030644"
"chr23","82261846","82262129","GL873562","3299887","3300144","100","78961959"
"chr24","1789870","1790165","GL873541","16268070","16268366","84","14478200"
"chr24","1850992","1851282","GL873547","2222074","2222356","77","371082"
"chr24","3164063","3164352","GL873530","16647228","16647517","86","13483165"
"chr24","4050478","4050751","GL873680","3005257","3005482","100","1045221"
"chr24","4202930","4203215","GL873530","16647228","16647517","83","12444298"
"chr24","4735802","4735962","GL873574","7318344","7318500","49","2582542"
"chr24","5315356","5315632","GL873565","12307556","12307825","98","6992200"
"chr24","5801480","5801779","GL873541","16268070","16268366","102","10466590"
"chr24","6358469","6358751","GL873547","2222074","2222356","92","4136395"
"chr24","6466580","6466820","GL873680","3005257","3005482","66","3461323"
"chr24","7079417","7079718","GL873541","16268070","16268366","92","9188653"
"chr24","7463814","7463992","GL873530","5593486","5593649","57","1870328"
"chr24","7868501","7868778","GL873562","3299887","3300144","84","4568614"
"chr24","7917866","7918178","GL873547","2222074","2222356","91","5695792"
"chr24","7989911","7990199","GL873547","2222074","2222356","75","5767837"
"chr24","8060134","8060427","GL873530","16647228","16647517","86","8587094"
"chr24","8158889","8159185","GL873541","16268070","16268366","86","8109181"
"chr24","8218231","8218539","GL873541","16268070","16268366","87","8049839"
"chr24","8409455","8409743","GL873530","16647228","16647517","79","8237773"
"chr24","8460797","8461115","GL873608","6630366","6630673","97","1830431"
"chr24","8525577","8525865","GL873530","16647228","16647517","87","8121651"
"chr24","8586775","8587066","GL873547","2222074","2222356","80","6364701"
"chr24","8961553","8961850","GL873530","16647228","16647517","90","7685675"
"chr24","10677968","10678270","GL873528","36697151","36697434","88","26019183"
"chr24","11315061","11315356","GL873541","16268070","16268366","85","4953009"
"chr24","11444747","11445032","GL873547","2222074","2222356","83","9222673"
"chr24","11645754","11646057","GL873608","6630366","6630673","94","5015388"
"chr24","11772242","11772524","GL873547","2222074","2222356","88","9550168"
"chr24","11781500","11781793","GL873530","16647228","16647517","83","4865728"
"chr24","11839307","11839591","GL873547","2222074","2222356","88","9617233"
"chr24","11934563","11934862","GL873667","4451263","4451534","102","7483300"
"chr24","11947136","11947332","GL873554","16339732","16339922","63","4392596"
"chr24","12034231","12034525","GL873530","16647228","16647517","87","4612997"
"chr24","12072239","12072545","GL873541","16268070","16268366","97","4195831"
"chr24","12126609","12126914","GL873541","16268070","16268366","92","4141461"
"chr24","12135786","12136089","GL873541","16268070","16268366","86","4132284"
"chr24","12136203","12136467","GL873538","2567037","2567262","91","9569166"
"chr24","12322206","12322499","GL873680","3005257","3005482","114","9316949"
"chr24","12435412","12435710","GL873607","1418062","1418355","92","11017350"
"chr24","12675678","12676002","GL873530","16647228","16647517","105","3971550"
"chr24","12756182","12756539","GL873541","16268070","16268366","146","3511888"
"chr24","12759876","12760175","GL873541","16268070","16268366","86","3508194"
"chr24","13369019","13369322","GL873541","16268070","16268366","95","2899051"
"chr24","13513993","13514283","GL873547","2222074","2222356","77","11291919"
"chr24","14771924","14772236","GL873541","16268070","16268366","106","1496146"
"chr24","14892780","14893082","GL873752","427788","428097","91","14464992"
"chr24","15448606","15448908","GL873547","2222074","2222356","92","13226532"
"chr24","15875932","15876254","GL873530","16647228","16647517","105","771296"
"chr24","15916650","15916954","GL873541","16268070","16268366","83","351420"
"chr24","15924027","15924317","GL873541","16268070","16268366","87","344043"
"chr24","16065199","16065468","GL873562","3299887","3300144","88","12765312"
"chr24","16133323","16133579","GL873535","4830564","4830824","78","11302759"
"chr24","16136526","16136782","GL873535","4830564","4830824","79","11305962"
"chr24","16508354","16508661","GL873530","16647228","16647517","86","138874"
"chr24","16585499","16585784","GL873541","16268070","16268366","88","317429"
"chr24","16758420","16758559","GL873628","6402015","6402153","53","10356405"
"chr24","17393801","17394097","GL873752","427788","428097","89","16966013"
"chr24","17739661","17739970","GL873528","36697151","36697434","95","18957490"
"chr24","18227287","18227572","GL873547","2222074","2222356","85","16005213"
"chr24","18689816","18690109","GL873541","16268070","16268366","98","2421746"
"chr24","19012011","19012316","GL873667","4451263","4451534","99","14560748"
"chr24","19495489","19495799","GL873608","6630366","6630673","93","12865123"
"chr24","20020356","20020608","GL873680","3005257","3005482","99","17015099"
"chr24","21289548","21289696","GL873550","5998776","5998900","49","15290772"
"chr24","22306383","22306690","GL873547","2222074","2222356","96","20084309"
"chr24","22356155","22356521","GL873559","3737111","3737481","142","18619044"
"chr24","25286714","25287022","GL873541","16268070","16268366","97","9018644"
"chr24","26360086","26360391","GL873541","16268070","16268366","87","10092016"
"chr24","26634927","26635230","GL873541","16268070","16268366","82","10366857"
"chr24","26760384","26760704","GL873608","6630366","6630673","98","20130018"
"chr24","26800770","26801075","GL873541","16268070","16268366","92","10532700"
"chr24","26821576","26821642","GL873554","10500008","10500061","33","16321568"
"chr24","26855604","26855893","GL873608","6630366","6630673","95","20225238"
"chr24","26872400","26872686","GL873547","2222074","2222356","88","24650326"
"chr24","26945644","26945946","GL873541","16268070","16268366","88","10677574"
"chr24","26958611","26958801","GL873535","24407607","24407780","50","2551004"
"chr24","26958812","26959012","GL873697","3111225","3111427","54","23847587"
"chr24","27045031","27045322","GL873547","2222074","2222356","80","24822957"
"chr24","27102636","27102932","GL873547","2222074","2222356","95","24880562"
"chr24","27110583","27110876","GL873547","2222074","2222356","82","24888509"
"chr24","27199478","27199663","GL873530","5593486","5593649","71","21605992"
"chr24","27328071","27328449","GL873607","1418062","1418355","167","25910009"
"chr24","27353133","27353244","GL873524","43272658","43272747","45","15919525"
"chr24","27353240","27353332","GL873526","41480965","41481045","51","14127725"
"chr24","27566121","27566399","GL873547","2222074","2222356","84","25344047"
"chr24","27736219","27736329","GL873520","23895808","23895898","52","3840411"
"chr24","27814571","27814877","GL873528","36697151","36697434","87","8882580"
"chr24","28044175","28044469","GL873530","16647228","16647517","86","11396947"
"chr24","28053576","28053799","GL873640","6426205","6426399","70","21627371"
"chr24","28053813","28054113","GL873541","16268070","16268366","86","11785743"
"chr24","28121713","28122011","GL873607","1418062","1418355","80","26703651"
"chr24","28147960","28148255","GL873528","36697151","36697434","92","8549191"
"chr24","28202839","28203147","GL873530","16647228","16647517","93","11555611"
"chr24","28909811","28910118","GL873608","6630366","6630673","90","22279445"
"chr24","28917859","28918135","GL873562","3299887","3300144","81","25617972"
"chr24","29267094","29267410","GL873541","16268070","16268366","99","12999024"
"chr24","29600726","29601030","GL873608","6630366","6630673","79","22970360"
"chr24","29638979","29639281","GL873530","16647228","16647517","87","12991751"
"chr24","29701260","29701571","GL873541","16268070","16268366","90","13433190"
"chr24","29890338","29890646","GL873541","16268070","16268366","88","13622268"
"chr24","29899965","29900231","GL873680","3005257","3005482","86","26894708"
"chr24","30016068","30016377","GL873528","36697151","36697434","95","6681083"
"chr24","30048671","30048927","GL873528","25203621","25203847","88","4845050"
"chr24","31344252","31344598","GL873541","16268070","16268366","139","15076182"
"chr24","32065949","32066124","GL873585","9209559","9209725","62","22856390"
"chr24","32093572","32093879","GL873541","16268070","16268366","93","15825502"
"chr24","32290956","32291263","GL873541","16268070","16268366","91","16022886"
"chr24","32397575","32397881","GL873541","16268070","16268366","92","16129505"
"chr24","32438913","32439053","GL873541","1550303","1550443","61","30888610"
"chr24","32483988","32484123","GL873550","5998776","5998900","47","26485212"
"chr24","32488496","32488795","GL873547","2222074","2222356","92","30266422"
"chr24","32542409","32542707","GL873530","16647228","16647517","94","15895181"
"chr24","32586079","32586185","GL873550","5998776","5998900","42","26587303"
"chr24","32757532","32757815","GL873547","2222074","2222356","92","30535458"
"chr24","33252032","33252271","GL873640","6426205","6426399","96","26825827"
"chr24","33752047","33752360","GL873541","16268070","16268366","103","17483977"
"chr24","34153271","34153597","GL873547","2222074","2222356","103","31931197"
"chr24","35211260","35211491","GL873538","2567037","2567262","70","32644223"
"chr24","35474212","35474505","GL873541","16268070","16268366","87","19206142"
"chr24","36436227","36436544","GL873541","16268070","16268366","114","20168157"
"chr24","37139006","37139314","GL873541","16268070","16268366","95","20870936"
"chr24","37285238","37285435","GL873823","304319","304508","58","36980919"
"chr24","37504248","37504545","GL873530","16647228","16647517","90","20857020"
"chr24","38017313","38017618","GL873541","16268070","16268366","87","21749243"
"chr24","38095036","38095345","GL873541","16268070","16268366","98","21826966"
"chr24","38970570","38970863","GL873530","16647228","16647517","83","22323342"
"chr24","39199065","39199366","GL873541","16268070","16268366","92","22930995"
"chr24","39432165","39432454","GL873547","2222074","2222356","82","37210091"
"chr24","40072459","40072748","GL873547","2222074","2222356","80","37850385"
"chr24","40097023","40097161","GL873619","2497092","2497229","43","37599931"
"chr24","40571200","40571487","GL873547","2222074","2222356","86","38349126"
"chr24","40691769","40692028","GL873535","4830564","4830824","103","35861205"
"chr24","40776089","40776382","GL873547","2222074","2222356","87","38554015"
"chr24","40805092","40805388","GL873541","16268070","16268366","84","24537022"
"chr24","40869921","40870127","GL873697","3111225","3111427","63","37758696"
"chr24","40980063","40980363","GL873530","16647228","16647517","92","24332835"
"chr24","41015674","41015968","GL873530","16647228","16647517","80","24368446"
"chr24","41083345","41083640","GL873530","16647228","16647517","88","24436117"
"chr24","41149263","41149514","GL873562","3299887","3300144","83","37849376"
"chr24","41250872","41251183","GL873541","16268070","16268366","89","24982802"
"chr24","41265280","41265583","GL873547","2222074","2222356","87","39043206"
"chr24","41685935","41686236","GL873541","16268070","16268366","90","25417865"
"chr24","41871595","41871780","GL873823","304319","304508","62","41567276"
"chr24","41871804","41871840","GL873691","2903502","2903535","20","38968302"
"chr24","41871851","41872124","GL873538","2567037","2567262","99","39304814"
"chr24","42245392","42245678","GL873547","2222074","2222356","80","40023318"
"chr24","42327716","42328024","GL873541","16268070","16268366","96","26059646"
"chr24","42507481","42507786","GL873541","16268070","16268366","92","26239411"
"chr24","42511128","42511419","GL873547","2222074","2222356","79","40289054"
"chr24","42589698","42590007","GL873608","6630366","6630673","99","35959332"
"chr24","42610394","42610688","GL873530","16647228","16647517","80","25963166"
"chr24","42639656","42639923","GL873680","3005257","3005482","90","39634399"
"chr24","42824289","42824580","GL873530","16647228","16647517","73","26177061"
"chr24","43826707","43826998","GL873530","16647228","16647517","83","27179479"
"chr24","43953809","43954084","GL873547","2222074","2222356","90","41731735"
"chr24","44261921","44262200","GL873562","3299887","3300144","83","40962034"
"chr24","44311718","44312017","GL873530","16647228","16647517","92","27664490"
"chr24","44636700","44636990","GL873530","16647228","16647517","80","27989472"
"chr24","44895426","44895602","GL873530","5593486","5593649","61","39301940"
"chr24","45128509","45128809","GL873547","2222074","2222356","84","42906435"
"chr24","45142909","45143196","GL873547","2222074","2222356","72","42920835"
"chr24","45335754","45336056","GL873752","427788","428097","85","44907966"
"chr24","45514092","45514400","GL873547","2222074","2222356","96","43292018"
"chr24","46043895","46044208","GL873608","6630366","6630673","95","39413529"
"chr24","46084136","46084424","GL873547","2222074","2222356","86","43862062"
"chr24","46168345","46168668","GL873528","36697151","36697434","108","9471194"
"chr24","46259560","46259863","GL873541","16268070","16268366","86","29991490"
"chr24","46838734","46839020","GL873530","16647228","16647517","94","30191506"
"chr24","47558800","47559017","GL873531","3555300","3555500","61","44003500"
"chr24","47620528","47620831","GL873547","2222074","2222356","83","45398454"
"chr24","47776371","47776565","GL873535","24407607","24407780","57","23368764"
"chr24","47776566","47776612","GL873554","10500008","10500061","18","37276558"
"chr24","48042322","48042618","GL873530","16647228","16647517","87","31395094"
"chr24","48084896","48085173","GL873547","2222074","2222356","86","45862822"
"chr24","48183168","48183452","GL873530","16647228","16647517","86","31535940"
"chr24","48390276","48390485","GL873531","3555300","3555500","57","44834976"
"chr24","48391938","48392335","GL873559","3737111","3737481","147","44654827"
"chr24","48478266","48478556","GL873547","2222074","2222356","88","46256192"
"chr24","48480913","48481212","GL873541","16268070","16268366","91","32212843"
"chr24","48680133","48680412","GL873547","2222074","2222356","92","46458059"
"chr24","48719029","48719222","GL873823","304319","304508","61","48414710"
"chr24","48743485","48743753","GL873530","16647228","16647517","92","32096257"
"chr24","48773002","48773103","GL873541","15100979","15101074","38","33672023"
"chr24","48803007","48803311","GL873541","16268070","16268366","86","32534937"
"chr24","49206306","49206378","GL873521","9884269","9884347","31","39322037"
"chr24","50181761","50182001","GL873564","8360716","8360913","82","41821045"
"chr24","50342065","50342358","GL873530","16647228","16647517","87","33694837"
"chr24","50397507","50397819","GL873530","16647228","16647517","94","33750279"
"chr24","50401342","50401634","GL873547","2222074","2222356","83","48179268"
"chr24","50442624","50442917","GL873607","1418062","1418355","86","49024562"
"chr24","50525152","50525462","GL873541","16268070","16268366","93","34257082"
"chr24","50545181","50545478","GL873530","16647228","16647517","77","33897953"
"chr24","50657419","50657693","GL873547","2222074","2222356","83","48435345"
"chr24","50907274","50907551","GL873547","2222074","2222356","84","48685200"
"chr24","51084056","51084348","GL873547","2222074","2222356","86","48861982"
"chr24","51243330","51243619","GL873530","16647228","16647517","78","34596102"
"chr24","51327022","51327249","GL873538","2567037","2567262","70","48759985"
"chr24","51392476","51392759","GL873528","36697151","36697434","106","14695325"
"chr24","51521386","51521673","GL873667","4451263","4451534","89","47070123"
"chr24","51584132","51584183","GL873527","37742071","37742124","19","13842061"
"chr24","51892668","51892962","GL873541","16268070","16268366","95","35624598"
"chr24","52062002","52062293","GL873530","16647228","16647517","86","35414774"
"chr24","52063960","52064267","GL873541","16268070","16268366","93","35795890"
"chr24","52233973","52234282","GL873530","16647228","16647517","92","35586745"
"chr24","52301103","52301405","GL873528","36697151","36697434","95","15603952"
"chr24","52311091","52311393","GL873541","16268070","16268366","93","36043021"
"chr24","52414538","52414832","GL873530","16647228","16647517","84","35767310"
"chr24","52437950","52438235","GL873659","913070","913333","86","51524880"
"chr24","52715350","52715638","GL873547","2222074","2222356","76","50493276"
"chr24","52883761","52884068","GL873541","16268070","16268366","93","36615691"
"chr24","53098067","53098375","GL873528","36697151","36697434","94","16400916"
"chr24","53112049","53112337","GL873565","12307556","12307825","104","40804493"
"chr24","53766731","53767041","GL873607","1418062","1418355","93","52348669"
"chr24","53779722","53780014","GL873541","16268070","16268366","89","37511652"
"chr24","54021514","54021649","GL873541","1550303","1550443","56","52471211"
"chr24","54113121","54113416","GL873541","16268070","16268366","90","37845051"
"chr24","54403057","54403337","GL873547","2222074","2222356","89","52180983"
"chr24","54605539","54605839","GL873541","16268070","16268366","89","38337469"
"chr24","54626185","54626495","GL873541","16268070","16268366","83","38358115"
"chr24","54850128","54850299","GL873530","5593486","5593649","52","49256642"
"chr24","54894985","54895195","GL873531","3555300","3555500","64","51339685"
"chr24","55092295","55092413","GL873526","41480965","41481045","53","13611330"
"chr24","55092920","55093127","GL873554","16339732","16339922","64","38753188"
"chr24","55109631","55109893","GL873528","36697151","36697434","90","18412480"
"chr24","55110169","55110477","GL873530","16647228","16647517","91","38462941"
"chr24","55231105","55231397","GL873530","16647228","16647517","81","38583877"
"chr24","55260626","55260933","GL873541","16268070","16268366","92","38992556"
"chr24","55921514","55921800","GL873547","2222074","2222356","80","53699440"
"chr24","57740552","57740684","GL873550","5998776","5998900","33","51741776"
"chr24","57740685","57740965","GL873659","913070","913333","94","56827615"
"chr24","58059703","58059993","GL873547","2222074","2222356","84","55837629"
"chr24","59027565","59027857","GL873530","16647228","16647517","83","42380337"
"chr24","59281723","59282028","GL873541","16268070","16268366","85","43013653"
"chr24","60036462","60036754","GL873667","4451263","4451534","103","55585199"
"chr24","60036755","60036927","GL873574","7318344","7318500","50","52718411"
"chr24","60120262","60120575","GL873541","16268070","16268366","103","43852192"
"chr24","60145810","60146107","GL873547","2222074","2222356","87","57923736"
"chr24","60250454","60250579","GL873550","5998776","5998900","42","54251678"
"chr24","60270799","60270880","GL873603","2092720","2092796","36","58178079"
"chr24","60869181","60869248","GL873554","10500008","10500061","33","50369173"
"chr24","60949328","60949623","GL873530","16647228","16647517","86","44302100"
"chr24","61625902","61626210","GL873541","16268070","16268366","93","45357832"
"chr24","62528991","62529273","GL873541","16268070","16268366","95","46260921"
"chr24","62832161","62832395","GL873557","3858721","3858924","77","58973440"
"chr24","62832408","62832491","GL873524","43272658","43272747","44","19559750"
"chr24","62832502","62832627","GL873552","12711845","12711956","50","50120657"
"chr24","63277245","63277305","GL873554","10500008","10500061","21","52777237"
"chr24","64166525","64166805","GL873547","2222074","2222356","88","61944451"
"chr24","64663042","64663338","GL873541","16268070","16268366","82","48394972"
"chr24","65051791","65052097","GL873528","36697151","36697434","92","28354640"
"chr24","65276028","65276318","GL873530","16647228","16647517","81","48628800"
"chr24","65394558","65394850","GL873547","2222074","2222356","83","63172484"
"chr24","65904734","65904875","GL873560","5855436","5855580","46","60049298"
"chr24","66069922","66070221","GL873541","16268070","16268366","96","49801852"
"chr24","66210314","66210612","GL873607","1418062","1418355","94","64792252"
"chr24","66260907","66261193","GL873547","2222074","2222356","83","64038833"
"chr24","66283049","66283267","GL873531","3555300","3555500","67","62727749"
"chr24","66368253","66368315","GL873603","2092720","2092796","29","64275533"
"chr24","66696961","66697260","GL873541","16268070","16268366","95","50428891"
"chr24","67071902","67072077","GL873530","5593486","5593649","63","61478416"
"chr24","67119598","67119901","GL873541","16268070","16268366","92","50851528"
"chr24","67319758","67319887","GL873550","5998776","5998900","33","61320982"
"chr24","67319898","67320148","GL873680","3005257","3005482","78","64314641"
"chr24","67723052","67723353","GL873547","2222074","2222356","89","65500978"
"chr24","67787945","67788241","GL873608","6630366","6630673","92","61157579"
"chr24","67873207","67873287","GL873554","10500008","10500061","36","57373199"
"chr24","68171701","68171993","GL873547","2222074","2222356","85","65949627"
"chr24","68612580","68612873","GL873541","16268070","16268366","87","52344510"
"chr24","68758364","68758667","GL873547","2222074","2222356","84","66536290"
"chr24","68834416","68834714","GL873541","16268070","16268366","83","52566346"
"chr24","68878046","68878321","GL873659","913070","913333","81","67964976"
"chr24","68979146","68979377","GL873538","2567037","2567262","66","66412109"
"chr24","69261035","69261327","GL873547","2222074","2222356","81","67038961"
"chr24","69673448","69673733","GL873530","16647228","16647517","92","53026220"
"chr24","69778555","69778746","GL873697","3111225","3111427","57","66667330"
"chr24","69932407","69932715","GL873607","1418062","1418355","94","68514345"
"chr24","70166237","70166538","GL873541","16268070","16268366","82","53898167"
"chr24","70883208","70883509","GL873608","6630366","6630673","88","64252842"
"chr24","70944367","70944665","GL873541","16268070","16268366","84","54676297"
"chr24","70960884","70961175","GL873547","2222074","2222356","85","68738810"
"chr24","71358855","71359139","GL873547","2222074","2222356","87","69136781"
"chr24","71658540","71658819","GL873528","36697151","36697434","98","34961389"
"chr24","73112801","73113086","GL873530","16647228","16647517","90","56465573"
"chr24","73251065","73251360","GL873752","427788","428097","92","72823277"
"chr24","73466015","73466346","GL873812","559768","560073","110","72906247"
"chr24","73712255","73712550","GL873530","16647228","16647517","82","57065027"
"chr24","73988484","73988793","GL873607","1418062","1418355","92","72570422"
"chr24","75166080","75166378","GL873541","16268070","16268366","89","58898010"
"chr24","75239105","75239390","GL873530","16647228","16647517","87","58591877"
"chr24","75737228","75737529","GL873541","16268070","16268366","86","59469158"
"chr24","76223984","76224100","GL873550","5998776","5998900","44","70225208"
"chr24","76523592","76523762","GL873524","42560728","42560902","51","33962864"
"chr24","76523773","76524039","GL873547","5449763","5449997","91","71074010"
"chr24","76542036","76542297","GL873607","1418062","1418355","94","75123974"
"chr24","77054122","77054458","GL873541","16268070","16268366","128","60786052"
"chr24","77070905","77070979","GL873603","2092652","2092704","38","74978253"
"chr24","77070982","77071093","GL873622","7076274","7076365","45","69994708"
"chr24","77364334","77364641","GL873530","16647228","16647517","93","60717106"
"chr24","77505714","77506018","GL873528","36697151","36697434","91","40808563"
"chr24","77596626","77596927","GL873541","16268070","16268366","81","61328556"
"chr24","77600312","77600370","GL873527","37742071","37742124","24","39858241"
"chr24","77863315","77863484","GL873524","42560728","42560902","56","35302587"
"chr24","78152668","78152967","GL873541","16268070","16268366","84","61884598"
"chr24","78167209","78167497","GL873530","16647228","16647517","87","61519981"
"chr24","78209180","78209477","GL873541","16268070","16268366","86","61941110"
"chr24","78290488","78290787","GL873541","16268070","16268366","88","62022418"
"chr24","79793559","79793837","GL873562","3299887","3300144","90","76493672"
"chr24","79814927","79815060","GL873541","1550303","1550443","56","78264624"
"chr24","79892238","79892525","GL873547","2222074","2222356","77","77670164"
"chr24","80060255","80060437","GL873693","2625207","2625379","60","77435048"
"chr24","80076993","80077280","GL873667","4451263","4451534","94","75625730"
"chr24","80217023","80217326","GL873541","16268070","16268366","86","63948953"
"chr24","80299811","80300120","GL873528","36697151","36697434","87","43602660"
"chr24","80445348","80445522","GL873574","7318344","7318500","51","73127004"
"chr24","80508974","80509233","GL873543","13038674","13038909","90","67470300"
"chr24","80534407","80534717","GL873659","913070","913333","111","79621337"
"chr24","80664407","80664696","GL873530","16647228","16647517","79","64017179"
"chr24","80695956","80696237","GL873530","16647228","16647517","92","64048728"
"chr24","80781453","80781757","GL873608","6630366","6630673","89","74151087"
"chr24","81038930","81039229","GL873547","2222074","2222356","91","78816856"
"chr24","81076953","81077264","GL873608","6630366","6630673","96","74446587"
"chr24","81183238","81183535","GL873547","2222074","2222356","89","78961164"
"chr24","81271080","81271377","GL873528","36697151","36697434","93","44573929"
"chr24","81291752","81292065","GL873752","427788","428097","110","80863964"
"chr24","81299652","81299821","GL873691","508903","509045","59","80790749"
"chr24","81300488","81300790","GL873667","4451263","4451534","96","76849225"
"chr24","81346619","81346931","GL873530","16647228","16647517","97","64699391"
"chr24","81375274","81375576","GL873541","16268070","16268366","95","65107204"
"chr24","81459620","81459869","GL873680","3005257","3005482","87","78454363"
"chr24","81501428","81501586","GL873527","37742145","37742300","55","43759283"
"chr24","81538086","81538392","GL873541","16268070","16268366","92","65270016"
"chr24","81682492","81682769","GL873659","913070","913333","89","80769422"
"chr24","81689171","81689480","GL873541","16268070","16268366","90","65421101"
"chr24","81707804","81708095","GL873752","427788","428097","89","81280016"
"chr24","81709219","81709515","GL873530","16647228","16647517","83","65061991"
"chr24","81727240","81727351","GL873587","10002051","10002151","39","71725189"
"chr24","81739431","81739732","GL873541","16268070","16268366","89","65471361"
"chr24","81754036","81754334","GL873530","16647228","16647517","81","65106808"
"chr24","81801163","81801466","GL873607","1418062","1418355","89","80383101"
"chr24","82878393","82878691","GL873541","16268070","16268366","82","66610323"
"chr24","82945407","82945716","GL873607","1418062","1418355","90","81527345"
"chr24","83189226","83189532","GL873607","1418062","1418355","91","81771164"
"chr24","83412597","83412905","GL873607","1418062","1418355","94","81994535"
"chr24","84069660","84069943","GL873562","3299887","3300144","92","80769773"
"chr25","6684455","6684736","GL873547","2222074","2222356","88","4462381"
"chr25","25558841","25559144","GL873541","16268070","16268366","86","9290771"
"chr25","1339748","1340038","GL873541","16268070","16268366","86","14928322"
"chr25","1528051","1528339","GL873608","6630366","6630673","86","5102315"
"chr25","1847213","1847501","GL873547","2222074","2222356","84","374861"
"chr25","1940008","1940305","GL873541","16268070","16268366","90","14328062"
"chr25","2397448","2397753","GL873541","16268070","16268366","86","13870622"
"chr25","2485509","2485801","GL873530","16647228","16647517","81","14161719"
"chr25","2698917","2699229","GL873528","36697151","36697434","104","33998234"
"chr25","2836702","2836985","GL873547","2222074","2222356","88","614628"
"chr25","3359926","3360212","GL873547","2222074","2222356","83","1137852"
"chr25","3471112","3471423","GL873547","2222074","2222356","96","1249038"
"chr25","3473316","3473621","GL873607","1418062","1418355","86","2055254"
"chr25","3519602","3519897","GL873752","427788","428097","90","3091814"
"chr25","3726859","3727158","GL873541","16268070","16268366","84","12541211"
"chr25","3836415","3836720","GL873528","36697151","36697434","94","32860736"
"chr25","3983003","3983294","GL873530","16647228","16647517","80","12664225"
"chr25","4232846","4233150","GL873528","36697151","36697434","102","32464305"
"chr25","5314486","5314661","GL873527","37742145","37742300","68","32427659"
"chr25","5328687","5328992","GL873541","16268070","16268366","98","10939383"
"chr25","5344209","5344516","GL873530","16647228","16647517","90","11303019"
"chr25","5393473","5393779","GL873607","1418062","1418355","92","3975411"
"chr25","5453301","5453595","GL873547","2222074","2222356","87","3231227"
"chr25","5553273","5553569","GL873541","16268070","16268366","85","10714797"
"chr25","5632353","5632646","GL873530","16647228","16647517","84","11014875"
"chr25","5632785","5633079","GL873541","16268070","16268366","88","10635285"
"chr25","5686981","5686997","GL873691","2903502","2903535","19","2783479"
"chr25","5687502","5687663","GL873585","9209559","9209725","59","3522057"
"chr25","5821995","5822278","GL873547","2222074","2222356","82","3599921"
"chr25","6277317","6277611","GL873547","2222074","2222356","77","4055243"
"chr25","6369752","6369893","GL873619","2497092","2497229","41","3872660"
"chr25","6660097","6660393","GL873541","16268070","16268366","93","9607973"
"chr25","6702337","6702632","GL873547","2222074","2222356","91","4480263"
"chr25","7570447","7570723","GL873562","3299887","3300144","90","4270560"
"chr25","7747767","7747941","GL873530","5593486","5593649","60","2154281"
"chr25","9051902","9052185","GL873547","2222074","2222356","86","6829828"
"chr25","9068094","9068229","GL873550","5998776","5998900","40","3069318"
"chr25","9203836","9204132","GL873607","1418062","1418355","83","7785774"
"chr25","9296548","9296856","GL873541","16268070","16268366","88","6971522"
"chr25","9561001","9561284","GL873547","2222074","2222356","85","7338927"
"chr25","10348227","10348529","GL873541","16268070","16268366","83","5919843"
"chr25","11033953","11034258","GL873541","16268070","16268366","87","5234117"
"chr25","11123790","11124070","GL873547","2222074","2222356","91","8901716"
"chr25","11244764","11245063","GL873541","16268070","16268366","84","5023306"
"chr25","11940518","11940832","GL873541","16268070","16268366","94","4327552"
"chr25","12712961","12713239","GL873528","36697151","36697434","99","23984190"
"chr25","13615876","13616171","GL873547","2222074","2222356","91","11393802"
"chr25","14010386","14010685","GL873541","16268070","16268366","87","2257684"
"chr25","14371016","14371245","GL873528","25203621","25203847","86","10832605"
"chr25","14633905","14634207","GL873541","16268070","16268366","86","1634165"
"chr25","15334905","15335206","GL873547","2222074","2222356","85","13112831"
"chr25","16525807","16526071","GL873535","4830564","4830824","84","11695243"
"chr25","16690641","16690933","GL873535","4830564","4830824","101","11860077"
"chr25","16708032","16708162","GL873550","5998776","5998900","34","10709256"
"chr25","16827455","16827717","GL873547","2222074","2222356","95","14605381"
"chr25","17257821","17258119","GL873541","16268070","16268366","86","989751"
"chr25","17311856","17312158","GL873659","913070","913333","93","16398786"
"chr25","17368661","17368839","GL873521","1458597","1458764","58","15910064"
"chr25","17601824","17602097","GL873547","2222074","2222356","84","15379750"
"chr25","17679183","17679487","GL873541","16268070","16268366","85","1411113"
"chr25","17812543","17812843","GL873541","16268070","16268366","94","1544473"
"chr25","18415051","18415339","GL873547","2222074","2222356","79","16192977"
"chr25","18532202","18532481","GL873547","2222074","2222356","81","16310128"
"chr25","18817843","18818127","GL873547","2222074","2222356","87","16595769"
"chr25","19201795","19202089","GL873547","2222074","2222356","80","16979721"
"chr25","19270221","19270449","GL873528","25203621","25203847","75","5933400"
"chr25","19470335","19470548","GL873531","3555300","3555500","71","15915035"
"chr25","19956609","19956908","GL873607","1418062","1418355","88","18538547"
"chr25","20374226","20374509","GL873547","2222074","2222356","92","18152152"
"chr25","20552556","20552850","GL873541","16268070","16268366","91","4284486"
"chr25","21043290","21043580","GL873530","16647228","16647517","85","4396062"
"chr25","21072100","21072388","GL873530","16647228","16647517","83","4424872"
"chr25","21192173","21192479","GL873667","4451263","4451534","91","16740910"
"chr25","21654048","21654336","GL873528","36697151","36697434","102","15043103"
"chr25","22101877","22102180","GL873541","16268070","16268366","86","5833807"
"chr25","22389767","22390070","GL873530","16647228","16647517","90","5742539"
"chr25","22751466","22751616","GL873530","5593486","5593649","52","17157980"
"chr25","23119517","23119817","GL873541","16268070","16268366","93","6851447"
"chr25","23269972","23270119","GL873585","9209559","9209725","62","14060413"
"chr25","23325140","23325428","GL873547","2222074","2222356","80","21103066"
"chr25","23334126","23334409","GL873659","913070","913333","85","22421056"
"chr25","23655877","23656180","GL873541","16268070","16268366","93","7387807"
"chr25","23711725","23712026","GL873541","16268070","16268366","88","7443655"
"chr25","24055489","24055622","GL873628","6402015","6402153","56","17653474"
"chr25","24074222","24074399","GL873530","5593486","5593649","56","18480736"
"chr25","24168664","24168969","GL873530","16647228","16647517","85","7521436"
"chr25","24645788","24646060","GL873659","913070","913333","89","23732718"
"chr25","24738219","24738508","GL873547","2222074","2222356","69","22516145"
"chr25","24748710","24749001","GL873528","36697151","36697434","105","11948441"
"chr25","25304757","25304965","GL873531","3555300","3555500","66","21749457"
"chr25","25309224","25309501","GL873562","3299887","3300144","90","22009337"
"chr25","25362038","25362345","GL873541","16268070","16268366","92","9093968"
"chr25","25485107","25485403","GL873530","16647228","16647517","81","8837879"
"chr25","25585319","25585615","GL873530","16647228","16647517","93","8938091"
"chr25","25676917","25677217","GL873528","36697151","36697434","86","11020234"
"chr25","25810029","25810359","GL873541","16268070","16268366","109","9541959"
"chr25","25882485","25882774","GL873547","2222074","2222356","82","23660411"
"chr25","26011103","26011400","GL873530","16647228","16647517","88","9363875"
"chr25","26344109","26344398","GL873547","2222074","2222356","82","24122035"
"chr25","26476157","26476446","GL873530","16647228","16647517","77","9828929"
"chr25","26478370","26478680","GL873541","16268070","16268366","94","10210300"
"chr25","26617701","26617991","GL873565","12307556","12307825","94","14310145"
"chr25","26624224","26624510","GL873530","16647228","16647517","93","9976996"
"chr25","26671022","26671246","GL873557","3858721","3858924","71","22812301"
"chr25","27172863","27173143","GL873528","36697151","36697434","89","9524288"
"chr25","27352828","27353131","GL873541","16268070","16268366","87","11084758"
"chr25","27417646","27417941","GL873607","1418062","1418355","86","25999584"
"chr25","27434732","27435030","GL873547","2222074","2222356","85","25212658"
"chr25","27438416","27438716","GL873608","6630366","6630673","88","20808050"
"chr25","27448957","27449249","GL873547","2222074","2222356","92","25226883"
"chr25","27453211","27453490","GL873562","3299887","3300144","87","24153324"
"chr25","27466483","27466787","GL873528","36697151","36697434","95","9230668"
"chr25","27839006","27839308","GL873541","16268070","16268366","86","11570936"
"chr25","27889216","27889522","GL873541","16268070","16268366","90","11621146"
"chr25","27962220","27962395","GL873574","7318344","7318500","60","20643876"
"chr25","27994473","27994768","GL873541","16268070","16268366","86","11726403"
"chr25","28383450","28383752","GL873541","16268070","16268366","95","12115380"
"chr25","28405484","28405762","GL873547","2222074","2222356","85","26183410"
"chr25","28462602","28462910","GL873607","1418062","1418355","95","27044540"
"chr25","28547301","28547582","GL873547","2222074","2222356","82","26325227"
"chr25","28558869","28559160","GL873547","2222074","2222356","81","26336795"
"chr25","28574075","28574388","GL873530","16647228","16647517","104","11926847"
"chr25","28687525","28687834","GL873528","36697151","36697434","92","8009626"
"chr25","28732748","28733009","GL873680","3005257","3005482","81","25727491"
"chr25","28848075","28848388","GL873541","16268070","16268366","95","12580005"
"chr25","28864990","28865114","GL873552","12711845","12711956","49","16153145"
"chr25","28915252","28915552","GL873541","16268070","16268366","88","12647182"
"chr25","29090176","29090470","GL873541","16268070","16268366","87","12822106"
"chr25","29151717","29152022","GL873541","16268070","16268366","90","12883647"
"chr25","29262672","29262972","GL873541","16268070","16268366","83","12994602"
"chr25","29458811","29458944","GL873550","5998776","5998900","35","23460035"
"chr25","29465301","29465434","GL873550","5998776","5998900","35","23466525"
"chr25","31758047","31758351","GL873541","16268070","16268366","85","15489977"
"chr25","33126324","33126609","GL873547","2222074","2222356","91","30904250"
"chr25","34174359","34174663","GL873607","1418062","1418355","100","32756297"
"chr25","34180746","34181015","GL873547","2222074","2222356","93","31958672"
"chr25","34440849","34441119","GL873680","3005257","3005482","103","31435592"
"chr25","34717333","34717623","GL873528","36697151","36697434","101","1979818"
"chr25","34786834","34786850","GL873691","2903502","2903535","21","31883332"
"chr25","34786884","34787160","GL873562","3299887","3300144","98","31486997"
"chr25","34851489","34851792","GL873530","16647228","16647517","100","18204261"
"chr25","35021773","35022074","GL873541","16268070","16268366","89","18753703"
"chr25","35092147","35092445","GL873541","16268070","16268366","88","18824077"
"chr25","36505974","36506256","GL873547","2222074","2222356","85","34283900"
"chr25","36640525","36640836","GL873608","6630366","6630673","99","30010159"
"chr25","36773448","36773744","GL873530","16647228","16647517","93","20126220"
"chr25","36841373","36841658","GL873547","2222074","2222356","76","34619299"
"chr25","36916264","36916545","GL873547","2222074","2222356","87","34694190"
"chr25","36923615","36923901","GL873530","16647228","16647517","93","20276387"
"chr25","37394500","37394783","GL873565","12307556","12307825","97","25086944"
"chr25","37711695","37711877","GL873530","5593486","5593649","52","32118209"
"chr25","38190719","38191009","GL873530","16647228","16647517","82","21543491"
"chr25","38767114","38767395","GL873547","2222074","2222356","93","36545040"
"chr25","38830619","38830903","GL873530","16647228","16647517","84","22183391"
"chr25","39143607","39143687","GL873643","6205658","6205743","38","32937949"
"chr25","39378903","39379057","GL873585","9209559","9209725","56","30169344"
"chr25","39535823","39536115","GL873530","16647228","16647517","85","22888595"
"chr25","39664031","39664310","GL873547","2222074","2222356","88","37441957"
"chr25","39826754","39827031","GL873562","3299887","3300144","88","36526867"
"chr25","40580231","40580524","GL873541","16268070","16268366","98","24312161"
"chr25","40906216","40906510","GL873530","16647228","16647517","101","24258988"
"chr25","41061133","41061325","GL873823","304319","304508","57","40756814"
"chr25","41534513","41534766","GL873680","3005257","3005482","82","38529256"
"chr25","42166390","42166679","GL873541","16268070","16268366","82","25898320"
"chr25","43477682","43477798","GL873550","5998776","5998900","41","37478906"
"chr25","43801712","43801988","GL873562","3299887","3300144","89","40501825"
"chr25","43989793","43990117","GL873528","36697151","36697434","114","7292642"
"chr25","44297469","44297750","GL873547","2222074","2222356","81","42075395"
"chr25","44446843","44447111","GL873547","5449763","5449997","90","38997080"
"chr25","44546946","44547236","GL873530","16647228","16647517","82","27899718"
"chr25","45283305","45283370","GL873554","10500008","10500061","24","34783297"
"chr25","45471574","45471885","GL873541","16268070","16268366","97","29203504"
"chr25","45598359","45598667","GL873541","16268070","16268366","93","29330289"
"chr25","46078841","46079138","GL873541","16268070","16268366","84","29810771"
"chr25","46120542","46120851","GL873541","16268070","16268366","96","29852472"
"chr25","46342377","46342667","GL873547","2222074","2222356","83","44120303"
"chr25","47047804","47048093","GL873547","2222074","2222356","89","44825730"
"chr25","47320538","47320822","GL873530","16647228","16647517","87","30673310"
"chr25","47378702","47378994","GL873530","16647228","16647517","85","30731474"
"chr25","47405221","47405532","GL873541","16268070","16268366","99","31137151"
"chr25","47762368","47762658","GL873530","16647228","16647517","83","31115140"
"chr25","47810176","47810471","GL873667","4451263","4451534","89","43358913"
"chr25","48388637","48388910","GL873562","3299887","3300144","82","45088750"
"chr25","49444160","49444454","GL873541","16268070","16268366","83","33176090"
"chr25","49465186","49465522","GL873607","1418062","1418355","110","48047124"
"chr25","49550004","49550295","GL873530","16647228","16647517","86","32902776"
"chr25","49655907","49656174","GL873528","36697151","36697434","94","12958756"
"chr25","49833994","49834285","GL873752","427788","428097","87","49406206"
"chr25","50012387","50012690","GL873547","2222074","2222356","84","47790313"
"chr25","50135597","50135848","GL873528","25203621","25203847","82","24931976"
"chr25","50285882","50286189","GL873530","16647228","16647517","91","33638654"
"chr25","50391631","50391918","GL873541","16268070","16268366","93","34123561"
"chr25","50668923","50669216","GL873547","2222074","2222356","78","48446849"
"chr25","51083496","51083799","GL873541","16268070","16268366","90","34815426"
"chr25","51276073","51276371","GL873541","16268070","16268366","76","35008003"
"chr25","52676226","52676525","GL873547","2222074","2222356","92","50454152"
"chr25","52943933","52944226","GL873547","2222074","2222356","87","50721859"
"chr25","52946162","52946411","GL873680","3005257","3005482","70","49940905"
"chr25","53220645","53220939","GL873530","16647228","16647517","92","36573417"
"chr25","53234711","53234996","GL873528","36697151","36697434","89","16537560"
"chr25","53330117","53330402","GL873547","2222074","2222356","84","51108043"
"chr25","53980358","53980580","GL873680","3005257","3005482","76","50975101"
"chr25","54112225","54112534","GL873541","16268070","16268366","95","37844155"
"chr25","54334996","54335282","GL873530","16647228","16647517","75","37687768"
"chr25","54386032","54386295","GL873659","913070","913333","86","53472962"
"chr25","54386438","54386743","GL873541","16268070","16268366","95","38118368"
"chr25","54646046","54646339","GL873541","16268070","16268366","94","38377976"
"chr25","54930545","54930841","GL873541","16268070","16268366","82","38662475"
"chr25","54960700","54960990","GL873530","16647228","16647517","83","38313472"
"chr25","55203429","55203580","GL873585","9209559","9209725","53","45993870"
"chr25","55705826","55706122","GL873607","1418062","1418355","90","54287764"
"chr25","55784493","55784786","GL873530","16647228","16647517","102","39137265"
"chr25","57464777","57465094","GL873547","2222074","2222356","98","55242703"
"chr25","57661747","57662049","GL873541","16268070","16268366","84","41393677"
"chr25","57776206","57776540","GL873541","16268070","16268366","108","41508136"
"chr25","58296086","58296390","GL873541","16268070","16268366","81","42028016"
"chr25","58481653","58481834","GL873524","42560728","42560902","52","15920925"
"chr25","58903526","58903832","GL873541","16268070","16268366","84","42635456"
"chr25","59364582","59364933","GL873812","559768","560073","116","58804814"
"chr25","59876382","59876671","GL873547","2222074","2222356","83","57654308"
"chr25","59916300","59916595","GL873541","16268070","16268366","86","43648230"
"chr25","60258078","60258386","GL873541","16268070","16268366","89","43990008"
"chr25","60744251","60744550","GL873541","16268070","16268366","87","44476181"
"chr25","60871024","60871303","GL873659","913070","913333","84","59957954"
"chr25","61141049","61141353","GL873528","36697151","36697434","97","24443898"
"chr25","61170573","61170867","GL873530","16647228","16647517","77","44523345"
"chr25","61178302","61178588","GL873547","2222074","2222356","80","58956228"
"chr25","61305684","61305984","GL873541","16268070","16268366","86","45037614"
"chr25","61576363","61576652","GL873547","2222074","2222356","86","59354289"
"chr25","62966000","62966296","GL873541","16268070","16268366","88","46697930"
"chr25","63133696","63134000","GL873528","36697151","36697434","89","26436545"
"chr25","63163456","63163753","GL873547","2222074","2222356","88","60941382"
"chr25","63371744","63372040","GL873547","2222074","2222356","87","61149670"
"chr25","63844862","63845173","GL873541","16268070","16268366","91","47576792"
"chr25","64061979","64062283","GL873541","16268070","16268366","93","47793909"
"chr25","64295552","64295846","GL873547","2222074","2222356","86","62073478"
"chr25","64549756","64550047","GL873530","16647228","16647517","87","47902528"
"chr25","65185768","65186029","GL873755","463833","464092","88","64721935"
"chr25","65203539","65203825","GL873530","16647228","16647517","83","48556311"
"chr25","65476178","65476469","GL873547","2222074","2222356","84","63254104"
"chr25","65601441","65601724","GL873530","16647228","16647517","85","48954213"
"chr25","65687984","65688298","GL873528","36697151","36697434","94","28990833"
"chr25","66001366","66001652","GL873547","2222074","2222356","81","63779292"
"chr25","66031139","66031447","GL873528","36697151","36697434","97","29333988"
"chr25","66714488","66714753","GL873680","3005257","3005482","94","63709231"
"chr25","66781617","66781923","GL873547","2222074","2222356","91","64559543"
"chr25","67320414","67320710","GL873541","16268070","16268366","90","51052344"
"chr25","67580740","67581031","GL873547","2222074","2222356","72","65358666"
"chr25","68074445","68074754","GL873541","16268070","16268366","85","51806375"
"chr25","68286683","68286989","GL873547","2222074","2222356","93","66064609"
"chr25","68510643","68510929","GL873547","2222074","2222356","83","66288569"
"chr25","68577978","68578267","GL873530","16647228","16647517","82","51930750"
"chr25","68829328","68829577","GL873528","25203621","25203847","87","43625707"
"chr25","68855529","68855838","GL873547","2222074","2222356","94","66633455"
"chr25","68938032","68938339","GL873541","16268070","16268366","84","52669962"
"chr25","69226019","69226312","GL873530","16647228","16647517","85","52578791"
"chr25","69404655","69404951","GL873541","16268070","16268366","88","53136585"
"chr25","69889359","69889660","GL873541","16268070","16268366","88","53621289"
"chr25","70053508","70053805","GL873547","2222074","2222356","80","67831434"
"chr25","70806870","70807163","GL873547","2222074","2222356","82","68584796"
"chr25","70813721","70813962","GL873640","6426205","6426399","89","64387516"
"chr25","71337715","71337844","GL873619","2497092","2497229","48","68840623"
"chr25","72031741","72032007","GL873562","3299887","3300144","86","68731854"
"chr25","72258378","72258675","GL873607","1418062","1418355","86","70840316"
"chr25","72276541","72276674","GL873550","5998776","5998900","37","66277765"
"chr25","72332321","72332593","GL873530","16647228","16647517","96","55685093"
"chr25","72520453","72520740","GL873547","2222074","2222356","79","70298379"
"chr25","72572806","72573094","GL873530","16647228","16647517","87","55925578"
"chr25","72792787","72793088","GL873528","36697151","36697434","86","36095636"
"chr25","72844886","72845016","GL873550","5998776","5998900","41","66846110"
"chr25","73344213","73344513","GL873541","16268070","16268366","84","57076143"
"chr25","73596158","73596459","GL873541","16268070","16268366","86","57328088"
"chr25","73775552","73775854","GL873528","36697151","36697434","90","37078401"
"chr25","73849624","73849923","GL873530","16647228","16647517","82","57202396"
"chr25","74108305","74108598","GL873752","427788","428097","86","73680517"
"chr25","74344693","74344987","GL873530","16647228","16647517","77","57697465"
"chr25","74544052","74544325","GL873543","13038674","13038909","88","61505378"
"chr25","75019281","75019589","GL873541","16268070","16268366","91","58751211"
"chr25","75024452","75024630","GL873530","5593486","5593649","56","69430966"
"chr25","75080303","75080607","GL873530","16647228","16647517","92","58433075"
"chr25","75497986","75498294","GL873541","16268070","16268366","89","59229916"
"chr25","75539496","75539765","GL873562","3299887","3300144","87","72239609"
"chr25","75564241","75564295","GL873527","37742071","37742124","23","37822170"
"chr25","75578375","75578687","GL873541","16268070","16268366","102","59310305"
"chr25","75589120","75589419","GL873541","16268070","16268366","88","59321050"
"chr25","75648123","75648411","GL873530","16647228","16647517","87","59000895"
"chr25","76626263","76626528","GL873528","36697151","36697434","89","39929112"
"chr25","76712891","76713171","GL873562","3299887","3300144","89","73413004"
"chr25","77023211","77023523","GL873547","2222074","2222356","97","74801137"
"chr25","77527290","77527576","GL873659","913070","913333","81","76614220"
"chr25","77568079","77568382","GL873541","16268070","16268366","88","61300009"
"chr25","77768522","77768646","GL873550","5998776","5998900","38","71769746"
"chr25","77773108","77773371","GL873547","5449763","5449997","84","72323345"
"chr25","77793035","77793334","GL873541","16268070","16268366","82","61524965"
"chr25","78074043","78074338","GL873530","16647228","16647517","84","61426815"
"chr25","78857790","78858095","GL873528","36697151","36697434","89","42160639"
"chr25","78907072","78907333","GL873535","4830564","4830824","87","74076508"
"chr25","79338948","79339251","GL873541","16268070","16268366","86","63070878"
"chr25","79801971","79802266","GL873608","6630366","6630673","83","73171605"
"chr25","79806416","79806724","GL873607","1418062","1418355","92","78388354"
"chr25","79837338","79837635","GL873528","36697151","36697434","81","43140187"
"chr25","79931373","79931672","GL873541","16268070","16268366","78","63663303"
"chr25","80283636","80283915","GL873530","16647228","16647517","87","63636408"
"chr25","80290280","80290579","GL873607","1418062","1418355","83","78872218"
"chr25","80525739","80525930","GL873530","5593486","5593649","61","74932253"
"chr25","80868137","80868436","GL873541","16268070","16268366","85","64600067"
"chr25","81210688","81210989","GL873541","16268070","16268366","87","64942618"
"chr25","81577948","81578245","GL873607","1418062","1418355","84","80159886"
"chr25","81776433","81776605","GL873530","5593486","5593649","56","76182947"
"chr25","82024341","82024643","GL873547","2222074","2222356","96","79802267"
"chr25","82820672","82820979","GL873541","16268070","16268366","92","66552602"
"chr25","82854139","82854451","GL873547","2222074","2222356","101","80632065"
"chr25","82986391","82986624","GL873531","3555300","3555500","77","79431091"
"chr25","83235490","83235791","GL873530","16647228","16647517","88","66588262"
"chr25","83725421","83725694","GL873565","12307556","12307825","102","71417865"
"chr25","83957326","83957569","GL873528","25203621","25203847","79","58753705"
"chr25","84096492","84096761","GL873562","3299887","3300144","86","80796605"
"chr25","84363698","84364002","GL873541","16268070","16268366","87","68095628"
"chr25","84446494","84446778","GL873547","2222074","2222356","85","82224420"
"chr25","84555535","84555818","GL873607","1418062","1418355","90","83137473"
"chr25","84920539","84920826","GL873530","16647228","16647517","84","68273311"
"chr25","85120398","85120707","GL873541","16268070","16268366","97","68852328"
"chr25","85169491","85169762","GL873547","2222074","2222356","85","82947417"
"chr26","1303623","1303927","GL873541","16268070","16268366","85","14964447"
"chr26","1398589","1398900","GL873528","36697151","36697434","94","35298562"
"chr26","1434280","1434561","GL873530","16647228","16647517","85","15212948"
"chr26","1445729","1446039","GL873541","16268070","16268366","93","14822341"
"chr26","2021667","2021972","GL873607","1418062","1418355","98","603605"
"chr26","2028130","2028430","GL873541","16268070","16268366","81","14239940"
"chr26","3338209","3338507","GL873547","2222074","2222356","85","1116135"
"chr26","3368101","3368400","GL873541","16268070","16268366","86","12899969"
"chr26","3381800","3382108","GL873541","16268070","16268366","90","12886270"
"chr26","3494770","3495064","GL873659","913070","913333","91","2581700"
"chr26","4439436","4439727","GL873530","16647228","16647517","78","12207792"
"chr26","4458411","4458686","GL873528","36697151","36697434","91","32238740"
"chr26","4493721","4494016","GL873547","2222074","2222356","87","2271647"
"chr26","4536697","4537051","GL873607","1418062","1418355","132","3118635"
"chr26","4539993","4540267","GL873562","3299887","3300144","90","1240106"
"chr26","4574785","4575094","GL873541","16268070","16268366","92","11693285"
"chr26","4750693","4750985","GL873547","2222074","2222356","80","2528619"
"chr26","4857130","4857421","GL873547","2222074","2222356","86","2635056"
"chr26","5218962","5219177","GL873680","3005257","3005482","69","2213705"
"chr26","5717070","5717377","GL873528","36697151","36697434","91","30980081"
"chr26","6230137","6230444","GL873547","2222074","2222356","95","4008063"
"chr26","6704388","6704686","GL873541","16268070","16268366","89","9563682"
"chr26","6977281","6977523","GL873531","3555300","3555500","81","3421981"
"chr26","7486195","7486497","GL873541","16268070","16268366","89","8781875"
"chr26","7819843","7820145","GL873541","16268070","16268366","88","8448227"
"chr26","7831060","7831358","GL873541","16268070","16268366","83","8437010"
"chr26","7900437","7900739","GL873541","16268070","16268366","95","8367633"
"chr26","7901672","7901968","GL873608","6630366","6630673","87","1271306"
"chr26","7923754","7924066","GL873541","16268070","16268366","103","8344316"
"chr26","8333871","8334082","GL873531","3555300","3555500","72","4778571"
"chr26","8334093","8334303","GL873531","3555300","3555500","74","4778793"
"chr26","8360531","8360833","GL873541","16268070","16268366","88","7907539"
"chr26","8385695","8385983","GL873547","2222074","2222356","75","6163621"
"chr26","8556047","8556335","GL873530","16647228","16647517","80","8091181"
"chr26","8925177","8925478","GL873607","1418062","1418355","95","7507115"
"chr26","8935799","8935936","GL873541","1550303","1550443","60","7385496"
"chr26","8945607","8945911","GL873541","16268070","16268366","89","7322463"
"chr26","8953512","8953815","GL873547","2222074","2222356","94","6731438"
"chr26","8959953","8960246","GL873547","2222074","2222356","85","6737879"
"chr26","8970369","8970646","GL873530","16647228","16647517","82","7676859"
"chr26","9194643","9194968","GL873541","16268070","16268366","112","7073427"
"chr26","9219402","9219713","GL873541","16268070","16268366","94","7048668"
"chr26","9457341","9457507","GL873530","5593486","5593649","44","3863855"
"chr26","9462288","9462599","GL873528","36697151","36697434","95","27234863"
"chr26","9484061","9484366","GL873607","1418062","1418355","87","8065999"
"chr26","9886362","9886670","GL873541","16268070","16268366","95","6381708"
"chr26","10164127","10164438","GL873530","16647228","16647517","89","6483101"
"chr26","10373727","10374014","GL873530","16647228","16647517","82","6273501"
"chr26","10786290","10786585","GL873530","16647228","16647517","89","5860938"
"chr26","10847725","10848011","GL873659","913070","913333","86","9934655"
"chr26","10851849","10852016","GL873535","24407607","24407780","62","13555758"
"chr26","10924057","10924348","GL873530","16647228","16647517","82","5723171"
"chr26","10924909","10925055","GL873550","5998776","5998900","49","4926133"
"chr26","11126640","11126755","GL873550","5998776","5998900","44","5127864"
"chr26","11209053","11209344","GL873530","16647228","16647517","77","5438175"
"chr26","11268579","11268887","GL873541","16268070","16268366","93","4999491"
"chr26","11319916","11320217","GL873541","16268070","16268366","87","4948154"
"chr26","11326193","11326298","GL873587","10002051","10002151","41","1324142"
"chr26","11354204","11354323","GL873622","7076274","7076365","46","4277930"
"chr26","11580350","11580645","GL873547","2222074","2222356","87","9358276"
"chr26","11695780","11696056","GL873547","2222074","2222356","87","9473706"
"chr26","12073822","12074110","GL873565","12307556","12307825","93","233734"
"chr26","12176753","12177056","GL873541","16268070","16268366","92","4091317"
"chr26","12611030","12611301","GL873547","2222074","2222356","92","10388956"
"chr26","12639965","12640235","GL873547","2222074","2222356","91","10417891"
"chr26","12716746","12717014","GL873607","1418062","1418355","96","11298684"
"chr26","13844204","13844483","GL873547","2222074","2222356","88","11622130"
"chr26","14897423","14897726","GL873541","16268070","16268366","90","1370647"
"chr26","15074738","15074972","GL873538","2567037","2567262","80","12507701"
"chr26","15280964","15281257","GL873547","2222074","2222356","77","13058890"
"chr26","15469436","15469746","GL873541","16268070","16268366","100","798634"
"chr26","15496275","15496581","GL873541","16268070","16268366","93","771795"
"chr26","15826243","15826540","GL873541","16268070","16268366","87","441827"
"chr26","15899386","15899677","GL873659","913070","913333","84","14986316"
"chr26","15926902","15927201","GL873607","1418062","1418355","90","14508840"
"chr26","16065185","16065476","GL873530","16647228","16647517","76","582043"
"chr26","16423084","16423376","GL873530","16647228","16647517","80","224144"
"chr26","16495326","16495665","GL873541","16268070","16268366","114","227256"
"chr26","16829634","16829921","GL873530","16647228","16647517","92","182406"
"chr26","16994565","16994847","GL873530","16647228","16647517","94","347337"
"chr26","17028394","17028688","GL873530","16647228","16647517","80","381166"
"chr26","17040288","17040464","GL873530","5593486","5593649","53","11446802"
"chr26","17176341","17176638","GL873530","16647228","16647517","86","529113"
"chr26","17278505","17278809","GL873541","16268070","16268366","90","1010435"
"chr26","17352679","17352998","GL873608","6630366","6630673","96","10722313"
"chr26","17724333","17724627","GL873547","2222074","2222356","91","15502259"
"chr26","17747436","17747746","GL873528","36697151","36697434","91","18949715"
"chr26","17821231","17821532","GL873541","16268070","16268366","89","1553161"
"chr26","17971351","17971645","GL873530","16647228","16647517","83","1324123"
"chr26","17978604","17978909","GL873541","16268070","16268366","93","1710534"
"chr26","18031269","18031555","GL873541","16268070","16268366","97","1763199"
"chr26","18098336","18098383","GL873527","37742071","37742124","23","19643735"
"chr26","18622414","18622713","GL873541","16268070","16268366","85","2354344"
"chr26","18748625","18748915","GL873547","2222074","2222356","93","16526551"
"chr26","18753009","18753318","GL873541","16268070","16268366","88","2484939"
"chr26","18771064","18771356","GL873547","2222074","2222356","82","16548990"
"chr26","18794536","18794836","GL873541","16268070","16268366","82","2526466"
"chr26","18874787","18875086","GL873530","16647228","16647517","77","2227559"
"chr26","18930263","18930542","GL873562","3299887","3300144","86","15630376"
"chr26","18989917","18990130","GL873630","2508568","2508753","71","16481349"
"chr26","19110919","19111217","GL873541","16268070","16268366","84","2842849"
"chr26","19193764","19194049","GL873541","16268070","16268366","89","2925694"
"chr26","19284280","19284583","GL873541","16268070","16268366","89","3016210"
"chr26","19335362","19335653","GL873547","2222074","2222356","84","17113288"
"chr26","19485506","19485798","GL873530","16647228","16647517","81","2838278"
"chr26","19790629","19790935","GL873547","2222074","2222356","90","17568555"
"chr26","19855711","19856014","GL873608","6630366","6630673","90","13225345"
"chr26","19957908","19958208","GL873530","16647228","16647517","88","3310680"
"chr26","20999796","21000000","GL873535","24407607","24407780","66","3407811"
"chr26","21040444","21040735","GL873667","4451263","4451534","88","16589181"
"chr26","21068568","21068876","GL873528","36697151","36697434","90","15628583"
"chr26","21150200","21150503","GL873541","16268070","16268366","90","4882130"
"chr26","21190519","21190790","GL873547","2222074","2222356","93","18968445"
"chr26","21208206","21208506","GL873530","16647228","16647517","89","4560978"
"chr26","21702683","21702988","GL873541","16268070","16268366","86","5434613"
"chr26","21732571","21732803","GL873531","3555300","3555500","74","18177271"
"chr26","21794938","21795249","GL873541","16268070","16268366","87","5526868"
"chr26","22625895","22626211","GL873530","16647228","16647517","110","5978667"
"chr26","23589496","23589793","GL873541","16268070","16268366","80","7321426"
"chr26","23608631","23608918","GL873547","2222074","2222356","90","21386557"
"chr26","23611192","23611487","GL873541","16268070","16268366","98","7343122"
"chr26","23706061","23706356","GL873608","6630366","6630673","89","17075695"
"chr26","23827315","23827611","GL873547","2222074","2222356","82","21605241"
"chr26","23833531","23833842","GL873541","16268070","16268366","95","7565461"
"chr26","23886350","23886647","GL873547","2222074","2222356","92","21664276"
"chr26","24008650","24008959","GL873541","16268070","16268366","97","7740580"
"chr26","24023805","24024105","GL873530","16647228","16647517","91","7376577"
"chr26","24027927","24028229","GL873541","16268070","16268366","84","7759857"
"chr26","24574016","24574311","GL873530","16647228","16647517","81","7926788"
"chr26","25366635","25366934","GL873607","1418062","1418355","86","23948573"
"chr26","25624812","25624827","GL873691","2903502","2903535","21","22721310"
"chr26","25624947","25625225","GL873547","2222074","2222356","88","23402873"
"chr26","26147166","26147342","GL873560","5855436","5855580","57","20291730"
"chr26","26332187","26332475","GL873543","13038674","13038909","100","13293513"
"chr26","26655471","26655740","GL873562","3299887","3300144","93","23355584"
"chr26","26669887","26670220","GL873528","36697151","36697434","122","10027264"
"chr26","26868700","26868994","GL873530","16647228","16647517","75","10221472"
"chr26","27028278","27028574","GL873541","16268070","16268366","82","10760208"
"chr26","27219250","27219514","GL873562","3299887","3300144","110","23919363"
"chr26","27705032","27705304","GL873562","3299887","3300144","90","24405145"
"chr26","27832139","27832435","GL873528","36697151","36697434","82","8865012"
"chr26","27837960","27838268","GL873541","16268070","16268366","93","11569890"
"chr26","27840309","27840431","GL873560","5855436","5855580","52","21984873"
"chr26","27967785","27968081","GL873541","16268070","16268366","96","11699715"
"chr26","27974295","27974588","GL873528","36697151","36697434","87","8722856"
"chr26","28040480","28040778","GL873541","16268070","16268366","92","11772410"
"chr26","28078336","28078638","GL873541","16268070","16268366","89","11810266"
"chr26","28505257","28505558","GL873541","16268070","16268366","77","12237187"
"chr26","29588042","29588339","GL873541","16268070","16268366","83","13319972"
"chr26","30780285","30780580","GL873530","16647228","16647517","87","14133057"
"chr26","30829052","30829349","GL873530","16647228","16647517","78","14181824"
"chr26","30873736","30874029","GL873530","16647228","16647517","77","14226508"
"chr26","31191187","31191500","GL873541","16268070","16268366","94","14923117"
"chr26","31324738","31324893","GL873585","9209559","9209725","58","22115179"
"chr26","31350615","31350897","GL873530","16647228","16647517","91","14703387"
"chr26","31371282","31371567","GL873547","2222074","2222356","80","29149208"
"chr26","31383868","31384161","GL873530","16647228","16647517","85","14736640"
"chr26","31593489","31593788","GL873541","16268070","16268366","84","15325419"
"chr26","31658170","31658463","GL873530","16647228","16647517","85","15010942"
"chr26","32393132","32393438","GL873541","16268070","16268366","93","16125062"
"chr26","32432226","32432519","GL873547","2222074","2222356","88","30210152"
"chr26","32646814","32647120","GL873530","16647228","16647517","93","15999586"
"chr26","32730244","32730488","GL873528","25203621","25203847","86","7526623"
"chr26","32886480","32886783","GL873607","1418062","1418355","93","31468418"
"chr26","33024367","33024673","GL873608","6630366","6630673","86","26394001"
"chr26","33229932","33230233","GL873541","16268070","16268366","88","16961862"
"chr26","33231815","33232149","GL873541","16268070","16268366","112","16963745"
"chr26","33717836","33718134","GL873541","16268070","16268366","91","17449766"
"chr26","34059465","34059757","GL873547","2222074","2222356","83","31837391"
"chr26","34566400","34566699","GL873547","2222074","2222356","88","32344326"
"chr26","34666126","34666431","GL873541","16268070","16268366","85","18398056"
"chr26","34783112","34783417","GL873541","16268070","16268366","86","18515042"
"chr26","35795525","35795803","GL873562","3299887","3300144","81","32495638"
"chr26","36593658","36593950","GL873530","16647228","16647517","85","19946430"
"chr26","36757831","36758145","GL873752","427788","428097","99","36330043"
"chr26","36760207","36760499","GL873541","16268070","16268366","94","20492137"
"chr26","36852543","36852839","GL873547","2222074","2222356","85","34630469"
"chr26","37511524","37511826","GL873547","2222074","2222356","96","35289450"
"chr26","37658547","37658856","GL873530","16647228","16647517","90","21011319"
"chr26","37713050","37713081","GL873691","2903502","2903535","20","34809548"
"chr26","37713108","37713384","GL873547","2222074","2222356","94","35491034"
"chr26","37830957","37831211","GL873543","13038674","13038909","91","24792283"
"chr26","37860069","37860375","GL873541","16268070","16268366","86","21591999"
"chr26","38451951","38452254","GL873530","16647228","16647517","90","21804723"
"chr26","38560601","38560902","GL873530","16647228","16647517","87","21913373"
"chr26","38595395","38595663","GL873562","3299887","3300144","82","35295508"
"chr26","38607269","38607546","GL873562","3299887","3300144","89","35307382"
"chr26","38619715","38619844","GL873550","5998776","5998900","31","32620939"
"chr26","38620138","38620298","GL873530","5593486","5593649","52","33026652"
"chr26","38788025","38788334","GL873541","16268070","16268366","91","22519955"
"chr26","38909472","38909755","GL873607","1418062","1418355","84","37491410"
"chr26","39186623","39186754","GL873550","5998776","5998900","52","33187847"
"chr26","39192633","39192746","GL873550","5998776","5998900","41","33193857"
"chr26","39193039","39193069","GL873691","2903502","2903535","18","36289537"
"chr26","39284282","39284538","GL873535","4830564","4830824","95","34453718"
"chr26","39383496","39383795","GL873528","36697151","36697434","99","2686345"
"chr26","39387110","39387445","GL873547","2222074","2222356","128","37165036"
"chr26","39492264","39492556","GL873541","16268070","16268366","81","23224194"
"chr26","39679835","39679961","GL873550","5998776","5998900","35","33681059"
"chr26","39818849","39819147","GL873547","2222074","2222356","83","37596775"
"chr26","39943185","39943503","GL873528","36697151","36697434","100","3246034"
"chr26","40055862","40056153","GL873547","2222074","2222356","83","37833788"
"chr26","40127559","40127851","GL873547","2222074","2222356","80","37905485"
"chr26","40178421","40178556","GL873550","5998776","5998900","43","34179645"
"chr26","40178880","40179052","GL873530","5593486","5593649","42","34585394"
"chr26","40262933","40263211","GL873562","3299887","3300144","90","36963046"
"chr26","40434273","40434569","GL873530","16647228","16647517","84","23787045"
"chr26","40451378","40451675","GL873547","2222074","2222356","88","38229304"
"chr26","40471207","40471527","GL873541","16268070","16268366","95","24203137"
"chr26","40480365","40480498","GL873550","5998776","5998900","39","34481589"
"chr26","40480799","40480953","GL873530","5593486","5593649","61","34887313"
"chr26","40502446","40502735","GL873547","2222074","2222356","78","38280372"
"chr26","40522316","40522625","GL873541","16268070","16268366","94","24254246"
"chr26","40585333","40585622","GL873530","16647228","16647517","81","23938105"
"chr26","41158686","41158981","GL873541","16268070","16268366","97","24890616"
"chr26","41264327","41264588","GL873528","36697151","36697434","96","4567176"
"chr26","41378200","41378497","GL873547","2222074","2222356","84","39156126"
"chr26","41461037","41461347","GL873541","16268070","16268366","104","25192967"
"chr26","41480906","41481210","GL873607","1418062","1418355","88","40062844"
"chr26","41494295","41494605","GL873541","16268070","16268366","90","25226225"
"chr26","41632412","41632706","GL873547","2222074","2222356","78","39410338"
"chr26","41639009","41639308","GL873530","16647228","16647517","84","24991781"
"chr26","41833948","41834244","GL873530","16647228","16647517","88","25186720"
"chr26","41962595","41962888","GL873541","16268070","16268366","87","25694525"
"chr26","42194777","42195089","GL873547","2222074","2222356","95","39972703"
"chr26","42304956","42305257","GL873530","16647228","16647517","93","25657728"
"chr26","42306145","42306344","GL873531","3555300","3555500","58","38750845"
"chr26","42309594","42309891","GL873659","913070","913333","86","41396524"
"chr26","42362243","42362420","GL873585","9209559","9209725","71","33152684"
"chr26","42372142","42372415","GL873562","3299887","3300144","79","39072255"
"chr26","42437123","42437309","GL873697","3111225","3111427","55","39325898"
"chr26","42462718","42463022","GL873541","16268070","16268366","86","26194648"
"chr26","42500760","42501016","GL873565","12307556","12307825","94","30193204"
"chr26","42502707","42503004","GL873541","16268070","16268366","90","26234637"
"chr26","42515621","42515785","GL873585","9209559","9209725","69","33306062"
"chr26","42587299","42587597","GL873659","913070","913333","87","41674229"
"chr26","43124629","43124931","GL873528","36697151","36697434","95","6427478"
"chr26","44146331","44146539","GL873625","6060130","6060345","50","38086201"
"chr26","44363469","44363786","GL873541","16268070","16268366","95","28095399"
"chr26","44700454","44700746","GL873530","16647228","16647517","84","28053226"
"chr26","44937686","44937989","GL873530","16647228","16647517","90","28290458"
"chr26","45215052","45215339","GL873565","12307556","12307825","100","32907496"
"chr26","45493442","45493721","GL873562","3299887","3300144","83","42193555"
"chr26","45503080","45503379","GL873541","16268070","16268366","88","29235010"
"chr26","46377005","46377310","GL873752","427788","428097","91","45949217"
"chr26","46379913","46380067","GL873550","5998776","5998900","61","40381137"
"chr26","47451086","47451377","GL873530","16647228","16647517","86","30803858"
"chr26","47486189","47486489","GL873528","36697151","36697434","83","10789038"
"chr26","48124880","48125173","GL873547","2222074","2222356","85","45902806"
"chr26","48681956","48682245","GL873530","16647228","16647517","77","32034728"
"chr26","48710898","48711193","GL873547","2222074","2222356","87","46488824"
"chr26","48793661","48793958","GL873541","16268070","16268366","84","32525591"
"chr26","48811822","48812111","GL873547","2222074","2222356","80","46589748"
"chr26","49687225","49687517","GL873530","16647228","16647517","91","33039997"
"chr26","49744087","49744224","GL873619","2497092","2497229","52","47246995"
"chr26","50133530","50133834","GL873541","16268070","16268366","92","33865460"
"chr26","50208850","50209157","GL873547","2222074","2222356","96","47986776"
"chr26","50244826","50244958","GL873550","5998776","5998900","35","44246050"
"chr26","50245289","50245468","GL873530","5593486","5593649","51","44651803"
"chr26","50369162","50369376","GL873557","3858721","3858924","65","46510441"
"chr26","50672148","50672443","GL873530","16647228","16647517","84","34024920"
"chr26","50876060","50876344","GL873547","2222074","2222356","95","48653986"
"chr26","51401156","51401451","GL873541","16268070","16268366","82","35133086"
"chr26","51519168","51519469","GL873541","16268070","16268366","90","35251098"
"chr26","51791432","51791721","GL873541","16268070","16268366","99","35523362"
"chr26","52013862","52014160","GL873541","16268070","16268366","83","35745792"
"chr26","52357492","52357801","GL873541","16268070","16268366","88","36089422"
"chr26","52629602","52629887","GL873547","2222074","2222356","82","50407528"
"chr26","52751315","52751622","GL873541","16268070","16268366","89","36483245"
"chr26","52919364","52919667","GL873541","16268070","16268366","91","36651294"
"chr26","53514723","53514995","GL873565","12307556","12307825","91","41207167"
"chr26","53520335","53520500","GL873524","42560728","42560902","51","10959607"
"chr26","53520800","53520928","GL873550","5998776","5998900","36","47522024"
"chr26","53622352","53622641","GL873547","2222074","2222356","77","51400278"
"chr26","53714925","53715226","GL873541","16268070","16268366","86","37446855"
"chr26","53756983","53757272","GL873547","2222074","2222356","81","51534909"
"chr26","53800042","53800328","GL873530","16647228","16647517","79","37152814"
"chr26","55105373","55105640","GL873565","12307556","12307825","95","42797817"
"chr26","55563230","55563531","GL873752","427788","428097","90","55135442"
"chr26","56681585","56681693","GL873524","43272658","43272747","47","13408927"
"chr26","56728191","56728492","GL873528","36697151","36697434","93","20031040"
"chr26","56794761","56794985","GL873680","3005257","3005482","69","53789504"
"chr26","57020633","57020926","GL873541","16268070","16268366","90","40752563"
"chr26","57070585","57070883","GL873541","16268070","16268366","88","40802515"
"chr26","57106560","57106840","GL873547","2222074","2222356","77","54884486"
"chr26","57118503","57118812","GL873541","16268070","16268366","94","40850433"
"chr26","57241824","57242103","GL873547","2222074","2222356","92","55019750"
"chr26","57518237","57518520","GL873547","2222074","2222356","89","55296163"
"chr26","57678536","57678834","GL873541","16268070","16268366","82","41410466"
"chr26","57911437","57911597","GL873530","5593486","5593649","48","52317951"
"chr26","58010528","58010826","GL873541","16268070","16268366","81","41742458"
"chr27","48234432","48234724","GL873547","2222074","2222356","81","46012358"
"chr27","10223454","10223751","GL873541","16268070","16268366","90","6044616"
"chr27","1282425","1282717","GL873541","16268070","16268366","90","14985645"
"chr27","1495726","1495880","GL873541","1550303","1550443","49","54577"
"chr27","2055361","2055656","GL873541","16268070","16268366","94","14212709"
"chr27","2425017","2425316","GL873667","4451263","4451534","93","2026246"
"chr27","2530148","2530418","GL873547","2222074","2222356","75","308074"
"chr27","2883087","2883383","GL873541","16268070","16268366","101","13384983"
"chr27","3534993","3535336","GL873528","36697151","36697434","125","33162158"
"chr27","4642368","4642674","GL873541","16268070","16268366","94","11625702"
"chr27","4822000","4822275","GL873562","3299887","3300144","85","1522113"
"chr27","5447935","5448211","GL873547","2222074","2222356","82","3225861"
"chr27","5747484","5747786","GL873541","16268070","16268366","88","10520586"
"chr27","5957641","5957923","GL873547","2222074","2222356","71","3735567"
"chr27","6281138","6281438","GL873541","16268070","16268366","90","9986932"
"chr27","6657683","6657995","GL873608","6630366","6630673","93","27317"
"chr27","7296849","7297157","GL873541","16268070","16268366","100","8971221"
"chr27","8093041","8093342","GL873541","16268070","16268366","86","8175029"
"chr27","8096233","8096521","GL873547","2222074","2222356","93","5874159"
"chr27","8181096","8181392","GL873541","16268070","16268366","81","8086974"
"chr27","8247376","8247668","GL873530","16647228","16647517","84","8399852"
"chr27","8257952","8258258","GL873541","16268070","16268366","93","8010118"
"chr27","8379128","8379426","GL873530","16647228","16647517","92","8268100"
"chr27","8882319","8882611","GL873530","16647228","16647517","83","7764909"
"chr27","8944756","8945056","GL873541","16268070","16268366","82","7323314"
"chr27","9022840","9023138","GL873541","16268070","16268366","90","7245230"
"chr27","9306592","9306869","GL873562","3299887","3300144","98","6006705"
"chr27","9332621","9332762","GL873691","508903","509045","60","8823718"
"chr27","9581168","9581467","GL873547","2222074","2222356","94","7359094"
"chr27","9631738","9632037","GL873547","2222074","2222356","87","7409664"
"chr27","9643377","9643537","GL873611","3799989","3800137","47","5843388"
"chr27","9660504","9660555","GL873527","37742071","37742124","21","28081567"
"chr27","9710911","9711212","GL873541","16268070","16268366","93","6557159"
"chr27","9782133","9782429","GL873607","1418062","1418355","87","8364071"
"chr27","9783787","9784055","GL873528","36697151","36697434","97","26913364"
"chr27","9987411","9987714","GL873541","16268070","16268366","90","6280659"
"chr27","10060385","10060692","GL873541","16268070","16268366","89","6207685"
"chr27","10235700","10235996","GL873752","427788","428097","81","9807912"
"chr27","10258593","10258867","GL873541","16268070","16268366","90","6009477"
"chr27","10269642","10269959","GL873541","16268070","16268366","95","5998428"
"chr27","10278726","10279012","GL873659","913070","913333","81","9365656"
"chr27","10317709","10317877","GL873530","5593486","5593649","39","4724223"
"chr27","10331344","10331647","GL873541","16268070","16268366","94","5936726"
"chr27","10331967","10332145","GL873530","5593486","5593649","60","4738481"
"chr27","10336529","10336634","GL873524","43272658","43272747","45","32936129"
"chr27","10399337","10399640","GL873541","16268070","16268366","93","5868733"
"chr27","10493136","10493423","GL873530","16647228","16647517","81","6154092"
"chr27","10494904","10495201","GL873530","16647228","16647517","89","6152324"
"chr27","10516504","10516810","GL873541","16268070","16268366","92","5751566"
"chr27","10526763","10527062","GL873541","16268070","16268366","92","5741307"
"chr27","10775419","10775657","GL873680","3005257","3005482","78","7770162"
"chr27","10913415","10913740","GL873541","16268070","16268366","103","5354655"
"chr27","11058238","11058542","GL873547","2222074","2222356","91","8836164"
"chr27","11102885","11103178","GL873530","16647228","16647517","86","5544343"
"chr27","11295804","11296100","GL873547","2222074","2222356","78","9073730"
"chr27","11307380","11307681","GL873528","36697151","36697434","87","25389771"
"chr27","11571180","11571474","GL873541","16268070","16268366","84","4696890"
"chr27","11586464","11586763","GL873541","16268070","16268366","83","4681606"
"chr27","11593824","11594123","GL873541","16268070","16268366","83","4674246"
"chr27","12027923","12028221","GL873541","16268070","16268366","85","4240147"
"chr27","12407225","12407522","GL873752","427788","428097","88","11979437"
"chr27","12589355","12589656","GL873541","16268070","16268366","88","3678715"
"chr27","13518144","13518412","GL873562","3299887","3300144","89","10218257"
"chr27","13556844","13557127","GL873530","16647228","16647517","95","3090384"
"chr27","13663281","13663579","GL873547","2222074","2222356","80","11441207"
"chr27","13835984","13836285","GL873608","6630366","6630673","87","7205618"
"chr27","14083985","14084276","GL873562","3299887","3300144","92","10784098"
"chr27","14690277","14690407","GL873622","7076274","7076365","52","7614003"
"chr27","14865751","14866028","GL873565","12307556","12307825","100","2558195"
"chr27","15145176","15145447","GL873565","12307556","12307825","99","2837620"
"chr27","15236650","15236789","GL873628","6402015","6402153","63","8834635"
"chr27","17163912","17164052","GL873552","12711845","12711956","56","4452067"
"chr27","17195001","17195294","GL873607","1418062","1418355","94","15776939"
"chr27","18578116","18578433","GL873541","16268070","16268366","94","2310046"
"chr27","18959548","18959829","GL873547","2222074","2222356","84","16737474"
"chr27","19178941","19179244","GL873530","16647228","16647517","91","2531713"
"chr27","19458692","19458976","GL873530","16647228","16647517","87","2811464"
"chr27","20444085","20444096","GL873691","2903502","2903535","24","17540583"
"chr27","20444154","20444439","GL873547","2222074","2222356","88","18222080"
"chr27","20912869","20913031","GL873530","5593486","5593649","54","15319383"
"chr27","20913076","20913193","GL873550","5998776","5998900","44","14914300"
"chr27","20955456","20955747","GL873547","2222074","2222356","99","18733382"
"chr27","21673517","21673624","GL873524","43272658","43272747","45","21599141"
"chr27","21750026","21750291","GL873562","3299887","3300144","106","18450139"
"chr27","21968637","21968939","GL873541","16268070","16268366","92","5700567"
"chr27","22220302","22220603","GL873547","2222074","2222356","80","19998228"
"chr27","22232932","22233034","GL873622","7076274","7076365","34","15156658"
"chr27","22252340","22252632","GL873541","16268070","16268366","88","5984270"
"chr27","23981718","23982016","GL873541","16268070","16268366","85","7713648"
"chr27","23984235","23984549","GL873541","16268070","16268366","104","7716165"
"chr27","24267322","24267503","GL873530","5593486","5593649","55","18673836"
"chr27","24409985","24410154","GL873574","7318344","7318500","55","17091641"
"chr27","24607158","24607315","GL873550","5998776","5998900","60","18608382"
"chr27","24621702","24621985","GL873530","16647228","16647517","94","7974474"
"chr27","24630977","24631278","GL873541","16268070","16268366","90","8362907"
"chr27","24896939","24897237","GL873530","16647228","16647517","88","8249711"
"chr27","25698612","25698909","GL873530","16647228","16647517","88","9051384"
"chr27","26691118","26691272","GL873550","5998776","5998900","55","20692342"
"chr27","26793068","26793373","GL873541","16268070","16268366","99","10524998"
"chr27","27535846","27536142","GL873547","2222074","2222356","85","25313772"
"chr27","27537333","27537628","GL873530","16647228","16647517","84","10890105"
"chr27","28234277","28234564","GL873547","2222074","2222356","84","26012203"
"chr27","28509248","28509540","GL873530","16647228","16647517","85","11862020"
"chr27","28806414","28806710","GL873541","16268070","16268366","88","12538344"
"chr27","29343362","29343676","GL873541","16268070","16268366","101","13075292"
"chr27","29531939","29532247","GL873541","16268070","16268366","86","13263869"
"chr27","29738106","29738395","GL873547","2222074","2222356","78","27516032"
"chr27","30314521","30314828","GL873541","16268070","16268366","93","14046451"
"chr27","30586673","30586966","GL873547","2222074","2222356","84","28364599"
"chr27","30756311","30756619","GL873607","1418062","1418355","88","29338249"
"chr27","30807215","30807520","GL873541","16268070","16268366","100","14539145"
"chr27","31210325","31210587","GL873680","3005257","3005482","90","28205068"
"chr27","31369370","31369664","GL873530","16647228","16647517","100","14722142"
"chr27","32538896","32539202","GL873547","2222074","2222356","99","30316822"
"chr27","32681295","32681602","GL873608","6630366","6630673","92","26050929"
"chr27","33515476","33515722","GL873680","3005257","3005482","82","30510219"
"chr27","33704842","33705150","GL873528","36697151","36697434","94","2992309"
"chr27","33864159","33864484","GL873541","16268070","16268366","109","17596089"
"chr27","34039445","34039506","GL873691","1645655","1645707","22","32393790"
"chr27","34173912","34174217","GL873541","16268070","16268366","88","17905842"
"chr27","34294131","34294270","GL873691","508903","509045","72","33785228"
"chr27","34463781","34464075","GL873541","16268070","16268366","91","18195711"
"chr27","34512765","34513037","GL873562","3299887","3300144","86","31212878"
"chr27","34608629","34608938","GL873541","16268070","16268366","92","18340559"
"chr27","35375439","35375733","GL873547","2222074","2222356","87","33153365"
"chr27","35442510","35442807","GL873541","16268070","16268366","79","19174440"
"chr27","35891602","35891905","GL873547","2222074","2222356","91","33669528"
"chr27","35893010","35893301","GL873530","16647228","16647517","96","19245782"
"chr27","36691701","36692009","GL873541","16268070","16268366","88","20423631"
"chr27","37352669","37352970","GL873541","16268070","16268366","85","21084599"
"chr27","38068036","38068200","GL873535","24407607","24407780","54","13660429"
