"chr1","148897500","148897807","chr5","152110395","152110709","80","3212895"
"chr1","186646252","186646542","chr12","108179452","108179746","72","78466800"
"chr1","786377","786507","chr9","47045786","47045941","54","46259409"
"chr1","23592887","23593018","chr5","32595015","32595178","57","9002128"
"chr1","26869750","26869867","chr8","58489091","58489211","64","31619341"
"chr1","35520400","35520652","chr1","205290793","205291030","72","169770393"
"chr1","54656906","54657037","chr9","47045786","47045941","55","7611120"
"chr1","57016300","57016613","chr9","57029965","57030284","85","13665"
"chr1","91619144","91619442","chr3","180847740","180848052","72","89228596"
"chr1","151650188","151650326","chr9","47045786","47045941","53","104604402"
"chr1","167378927","167379230","chr1","207218281","207218584","79","39839354"
"chr1","192282568","192282866","chrX","16155635","16155942","73","176126933"
"chr1","197656557","197656825","chr12","118411877","118412164","84","79244680"
"chr1","226099040","226099333","chr8","25360790","25361095","75","200738250"
"chr1","234749818","234750137","chr14","31798968","31799292","74","202950850"
"chr1","35367","35499","chr5","32595015","32595178","47","32559648"
"chr1","78286","78421","chr1","217544386","217544536","49","217466100"
"chr1","101404","101690","chr19","13342110","13342403","67","13240706"
"chr1","141668","141970","chrX","46692258","46692555","81","46550590"
"chr1","143306","143430","chr1","217544386","217544536","63","217401080"
"chr1","144987","145294","chr6","44061836","44062146","79","43916849"
"chr1","146229","146522","chr4","112106023","112106320","82","111959794"
"chr1","146776","147047","chr15","26873577","26873832","74","26726801"
"chr1","148792","149093","chr16","18367809","18368125","82","18219017"
"chr1","150478","150612","chr19","6391716","6391877","59","6241238"
"chr1","152276","152566","chr5","104248312","104248604","77","104096036"
"chr1","156828","157135","chrX","41633837","41634142","79","41477009"
"chr1","205883","206015","chr5","32595015","32595178","48","32389132"
"chr1","277970","278255","chr19","13342110","13342403","69","13064140"
"chr1","360496","360784","chr4","74884752","74885058","81","74524256"
"chr1","411816","412098","chr19","13342110","13342403","71","12930294"
"chr1","424236","424397","chr9","47045786","47045941","71","46621550"
"chr1","495752","496027","chr1","20214247","20214541","85","19718495"
"chr1","496629","496928","chr18","16899958","16900260","77","16403329"
"chr1","497906","498062","chr5","32595015","32595178","65","32097109"
"chr1","500277","500579","chrX","46692258","46692555","81","46191981"
"chr1","501915","502039","chr1","217544386","217544536","63","217042471"
"chr1","503581","503888","chr6","44061836","44062146","78","43558255"
"chr1","504823","505116","chr4","112106023","112106320","82","111601200"
"chr1","505370","505644","chr15","26873577","26873832","77","26368207"
"chr1","507389","507690","chr16","18367809","18368125","82","17860420"
"chr1","509075","509206","chr19","6391716","6391877","59","5882641"
"chr1","510867","511157","chr5","104248312","104248604","77","103737445"
"chr1","515420","515727","chrX","41633837","41634142","79","41118417"
"chr1","589269","589555","chr5","76704926","76705232","81","76115657"
"chr1","647570","647853","chr19","13342110","13342403","70","12694540"
"chr1","659977","660138","chr9","47045786","47045941","71","46385809"
"chr1","730658","730941","chr5","63802202","63802507","86","63071544"
"chr1","731535","731834","chr18","16899958","16900260","78","16168423"
"chr1","732836","732969","chr8","58489091","58489211","61","57756255"
"chr1","734066","734358","chr1","20316183","20316483","80","19582117"
"chr1","734943","735242","chr18","16899958","16900260","77","16165015"
"chr1","736220","736376","chr5","32595015","32595178","65","31858795"
"chr1","737473","737756","chr5","63802202","63802507","86","63064729"
"chr1","738352","738651","chr18","16899958","16900260","78","16161606"
"chr1","739636","739792","chr5","32595015","32595178","66","31855379"
"chr1","742007","742309","chrX","46692258","46692555","81","45950251"
"chr1","743645","743769","chr1","217544386","217544536","63","216800741"
"chr1","745296","745603","chr6","44061836","44062146","79","43316540"
"chr1","746538","746831","chr4","112106023","112106320","82","111359485"
"chr1","747086","747357","chr15","26873577","26873832","74","26126491"
"chr1","749101","749402","chr16","18367809","18368125","81","17618708"
"chr1","750787","750918","chr19","6391716","6391877","59","5640929"
"chr1","752584","752875","chr5","104248312","104248604","78","103495728"
"chr1","757135","757444","chrX","41633837","41634142","81","40876702"
"chr1","860215","860497","chr1","47533839","47534134","76","46673624"
"chr1","892184","892456","chr7","116200737","116201028","77","115308553"
"chr1","1092807","1093048","chr10","96412023","96412287","94","95319216"
"chr1","1096201","1096464","chr1","164929853","164930117","71","163833652"
"chr1","1103723","1103975","chr12","95325313","95325577","103","94221590"
"chr1","1105238","1105529","chr1","196006286","196006594","87","194901048"
"chr1","1193880","1194167","chr7_NW_019937272v1_random","2134063","2134360","80","940183"
"chr1","1229191","1229511","chr9","57029965","57030284","86","55800774"
"chr1","1230995","1231070","chr20","87144","87254","63","1143851"
"chr1","1268696","1268965","chrX","3592780","3593062","84","2324084"
"chr1","1301257","1301558","chr2A","65797088","65797395","64","64495831"
"chr1","1316950","1317093","chr8","58489091","58489211","75","57172141"
"chr1","1368467","1368747","chr20","52489594","52489869","78","51121127"
"chr1","1369475","1369758","chr8","15910614","15910909","82","14541139"
"chr1","1379482","1379610","chr9","47045786","47045941","54","45666304"
"chr1","1379929","1380041","chr8","58489091","58489211","64","57109162"
"chr1","1389551","1389678","chr15","37343640","37343763","61","35954089"
"chr1","1389969","1390133","chr18","55799233","55799394","69","54409264"
"chr1","1463626","1463926","chr6","44061836","44062146","80","42598210"
"chr1","1530253","1530546","chr8","25360790","25361095","81","23830537"
"chr1","1555716","1556003","chr8","15910614","15910909","80","14354898"
"chr1","1560706","1560836","chr1","217544386","217544536","58","215983680"
"chr1","1568643","1568886","chr12","95325313","95325577","84","93756670"
"chr1","1579201","1579266","chr20","87144","87254","61","1492057"
"chr1","1579553","1579625","chr20","87144","87254","63","1492409"
"chr1","1658198","1658328","chr20","87144","87254","65","1571054"
"chr1","1695906","1696160","chr14","82014462","82014729","107","80318556"
"chr1","1723542","1723672","chr20","87144","87254","65","1636398"
"chr1","1748137","1748391","chr14","82014462","82014729","107","80266325"
"chr1","1766713","1766909","chr1","9000895","9001091","55","7234182"
"chr1","1773469","1773604","chr19","6391716","6391877","54","4618247"
"chr1","1773766","1774034","chr6","123112293","123112576","87","121338527"
"chr1","1803317","1803580","chr1","20214247","20214541","85","18410930"
"chr1","1814525","1814827","chr14","31798968","31799292","79","29984443"
"chr1","1831191","1831340","chr5","32595015","32595178","63","30763824"
"chr1","1836388","1836559","chr12","4864673","4864880","64","3028285"
"chr1","1836850","1836986","chr9","47045786","47045941","51","45208936"
"chr1","1852138","1852238","chr20","87144","87254","59","1764994"
"chr1","1852530","1852700","chr19","13525969","13526165","79","11673439"
"chr1","1856022","1856284","chr1","25778769","25779058","83","23922747"
"chr1","1876332","1876452","chr20","87144","87254","65","1789188"
"chr1","1877504","1877637","chr5","32595015","32595178","53","30717511"
"chr1","1936623","1936928","chr9","68878569","68878883","74","66941946"
"chr1","1948278","1948560","chr20","52489594","52489869","85","50541316"
"chr1","1992168","1992466","chr8","25360790","25361095","79","23368622"
"chr1","2017088","2017387","chr9","68878569","68878883","71","66861481"
"chr1","2044368","2044679","chr9","68878569","68878883","82","66834201"
"chr1","2057584","2057708","chr9","47045786","47045941","58","44988202"
"chr1","2058303","2058488","chr14","51003183","51003398","72","48944880"
"chr1","2084724","2085028","chr19","48171503","48171823","71","46086779"
"chr1","2102898","2103136","chr10","96412023","96412287","83","94309125"
"chr1","2151670","2151819","chr1","217544386","217544536","62","215392716"
"chr1","2166143","2166425","chr8","15910614","15910909","71","13744471"
"chr1","2202776","2202883","chr15","37343640","37343763","64","35140864"
"chr1","2268937","2269246","chr19","48171503","48171823","84","45902566"
"chr1","2297115","2297270","chr1","217544386","217544536","64","215247271"
"chr1","2325306","2325623","chr1","94172177","94172465","103","91846871"
"chr1","2423356","2423399","chr20","87144","87254","74","2336212"
"chr1","2423981","2424025","chr20","87144","87254","76","2336837"
"chr1","2610039","2610326","chr19","13342110","13342403","79","10732071"
"chr1","2646399","2646685","chr1","47533839","47534134","71","44887440"
"chr1","3240153","3240437","chr2A","65797088","65797395","83","62556935"
"chr1","3301049","3301361","chrX_NW_019937303v1_random","2630481","2630786","69","670568"
"chr1","3344055","3344322","chr7","40153069","40153361","92","36809014"
"chr1","3406456","3406765","chr1","136656911","136657239","84","133250455"
"chr1","3552421","3552714","chrUn_NW_019938566v1","98142","98430","79","3454279"
"chr1","3661909","3662072","chr2A","60286019","60286209","64","56624110"
"chr1","3677691","3678004","chr9","68878569","68878883","78","65200878"
"chr1","3705034","3705182","chr19","6391716","6391877","73","2686682"
"chr1","3810401","3810618","chr14","51003183","51003398","49","47192782"
"chr1","3864546","3864848","chr17","23262608","23262910","75","19398062"
"chr1","3893618","3893917","chr9","68878569","68878883","78","64984951"
"chr1","3917382","3917506","chr20","87144","87254","68","3830238"
"chr1","3950830","3951079","chr10","96412023","96412287","67","92461193"
"chr1","4087899","4088072","chr18","55799233","55799394","60","51711334"
"chr1","4154911","4155076","chr2A","60286019","60286209","62","56131108"
"chr1","4155381","4155520","chr5","32595015","32595178","52","28439634"
"chr1","4208096","4208400","chr9","68878569","68878883","74","64670473"
"chr1","4402470","4402773","chrUn_NW_019938566v1","98142","98430","77","4304328"
"chr1","4563311","4563601","chr18","16899958","16900260","67","12336647"
"chr1","4610841","4611130","chr4","139746214","139746515","68","135135373"
"chr1","4793839","4794131","chr18","16899958","16900260","74","12106119"
"chr1","4944218","4944534","chr1","198858437","198858754","79","193914219"
"chr1","4958497","4958782","chr8","37744776","37745066","67","32786279"
"chr1","5003256","5003563","chr16","18367809","18368125","66","13364553"
"chr1","5084120","5084394","chr7","49832421","49832722","77","44748301"
"chr1","5772595","5772895","chr16","32352979","32353289","69","26580384"
"chr1","5919738","5919950","chr14","51003183","51003398","64","45083445"
"chr1","5920231","5920360","chr18","55799233","55799394","57","49879002"
"chr1","5962179","5962343","chr18","55799233","55799394","59","49837054"
"chr1","5964943","5965231","chr8","25360790","25361095","64","19395847"
"chr1","5973411","5973600","chr14","51003183","51003398","65","45029772"
"chr1","6019010","6019320","chr12","41584147","41584465","78","35565137"
"chr1","6023763","6023939","chr12","4864673","4864880","63","1159090"
"chr1","6024241","6024383","chr9","47045786","47045941","40","41021545"
"chr1","6137509","6137632","chr9","47045786","47045941","64","40908277"
"chr1","6189415","6189578","chr5","32595015","32595178","64","26405600"
"chr1","6194605","6194893","chr4","112106023","112106320","74","105911418"
"chr1","6255485","6255642","chr18","55799233","55799394","68","49543748"
"chr1","6255951","6256094","chr19","6391716","6391877","43","135765"
"chr1","6318065","6318355","chr8","25360790","25361095","67","19042725"
"chr1","6342458","6342639","chr19","13525969","13526165","74","7183511"
"chr1","6402115","6402257","chr9","47045786","47045941","47","40643671"
"chr1","6402560","6402736","chr2A","60286019","60286209","63","53883459"
"chr1","6483466","6483681","chr14","51003183","51003398","53","44519717"
"chr1","6499808","6500000","chr14","51003183","51003398","60","44503375"
"chr1","6525145","6525301","chr9","47045786","47045941","58","40520641"
"chr1","6542904","6543193","chr8","25360790","25361095","62","18817886"
"chr1","6594748","6595069","chr7","12886919","12887228","77","6292171"
"chr1","6604961","6605166","chr22","26696703","26696888","81","20091742"
"chr1","6631009","6631316","chr1","207218281","207218584","70","200587272"
"chr1","6642558","6642686","chr9","47045786","47045941","57","40403228"
"chr1","6668610","6668731","chr15","37343640","37343763","65","30675030"
"chr1","6676398","6676666","chr10","28570518","28570799","69","21894120"
"chr1","6677293","6677594","chr19","44841372","44841689","77","38164079"
"chr1","6678673","6678947","chrX","3592780","3593062","79","3085893"
"chr1","6684986","6685165","chr9","47045786","47045941","59","40360800"
"chr1","6704662","6704972","chr12","94594421","94594744","84","87889759"
"chr1","6717242","6717406","chr19","6391716","6391877","62","325526"
"chr1","6733916","6734083","chr19","13525969","13526165","72","6792053"
"chr1","6734318","6734418","chr8","58489091","58489211","64","51754773"
"chr1","6749842","6750136","chrX","46692258","46692555","74","39942416"
"chr1","6750816","6751129","chr14","31798968","31799292","72","25048152"
"chr1","6756876","6757216","chrX","16472440","16472771","85","9715564"
"chr1","6759142","6759270","chr9","47045786","47045941","60","40286644"
"chr1","6759572","6759736","chr5","32595015","32595178","64","25835443"
"chr1","6773169","6773474","chr1","136656911","136657239","80","129883742"
"chr1","6773494","6773655","chr5","32595015","32595178","64","25821521"
"chr1","6773719","6774017","chr8","25360790","25361095","71","18587071"
"chr1","6799086","6799367","chr8","15910614","15910909","78","9111528"
"chr1","6802741","6803048","chr8","25360790","25361095","82","18558049"
"chr1","6834638","6834930","chr1","213591659","213591963","81","206757021"
"chr1","6838774","6839056","chr8","15910614","15910909","74","9071840"
"chr1","6848163","6848448","chr8","15910614","15910909","90","9062451"
"chr1","6880076","6880373","chr12","22057795","22058093","94","15177719"
"chr1","6942388","6942688","chr19","13342110","13342403","67","6399722"
"chr1","6981429","6981735","chr9","57029965","57030284","75","50048536"
"chr1","7118291","7118514","chr14","51003183","51003398","59","43884892"
"chr1","7137977","7138291","chr19","48171503","48171823","72","41033526"
"chr1","7159534","7159848","chr16","34390584","34390900","73","27231050"
"chr1","7167762","7168034","chr3","83975049","83975347","71","76807287"
"chr1","7392142","7392256","chr20","87144","87254","65","7304998"
"chr1","7392555","7392596","chr20","87144","87254","81","7305411"
"chr1","7392898","7393069","chr18","55799233","55799394","68","48406335"
"chr1","7532292","7532563","chr3","9052682","9052970","79","1520390"
"chr1","7710328","7710625","chr1","80364799","80365106","74","72654471"
"chr1","7822777","7823077","chr1","88859712","88859991","94","81036935"
"chr1","7834450","7834757","chr6","157423301","157423612","75","149588851"
"chr1","7855718","7855998","chr1","88859712","88859991","87","81003994"
"chr1","7865656","7865953","chr1","213591659","213591963","75","205726003"
"chr1","7882055","7882350","chr5","63802202","63802507","78","55920147"
"chr1","7890648","7890812","chr16","46964977","46965105","67","39074329"
"chr1","7902600","7902720","chr18","55799233","55799394","64","47896633"
"chr1","7919576","7919736","chr2B","7187318","7187503","78","732258"
"chr1","7923559","7923849","chr16","32352979","32353289","73","24429420"
"chr1","7935550","7935768","chr11","89572983","89573210","64","81637433"
"chr1","7957471","7957738","chr1","94172177","94172465","93","86214706"
"chr1","7969909","7970209","chr3","83975049","83975347","81","76005140"
"chr1","7972180","7972469","chrX","46692258","46692555","73","38720078"
"chr1","7974028","7974345","chr2B","83001661","83001979","79","75027633"
"chr1","7985505","7985811","chr16","32352979","32353289","70","24367474"
"chr1","8059760","8059882","chr15","37343640","37343763","63","29283880"
"chr1","8093163","8093480","chr7","7056350","7056674","75","1036813"
"chr1","8115066","8115344","chr4","187957937","187958223","88","179842871"
"chr1","8127694","8128012","chr13","29223313","29223640","78","21095619"
"chr1","8132901","8132989","chr8","58489091","58489211","64","50356190"
"chr1","8141375","8141658","chr4","112106023","112106320","73","103964648"
"chr1","8164937","8165107","chr18","55799233","55799394","72","47634296"
"chr1","8165367","8165504","chr9","47045786","47045941","49","38880419"
"chr1","8172623","8172784","chr5","32595015","32595178","62","24422392"
"chr1","8186036","8186257","chr14","51003183","51003398","64","42817147"
"chr1","8197457","8197737","chr3","180847740","180848052","85","172650283"
"chr1","8208183","8208476","chr3","65159963","65160267","74","56951780"
"chr1","8219307","8219423","chr20","87144","87254","61","8132163"
"chr1","8236709","8237005","chr12","108570006","108570305","70","100333297"
"chr1","8304828","8305009","chr1","9000895","9001091","55","696067"
"chr1","8334465","8334726","chr13","85095450","85095684","80","76760985"
"chr1","8342699","8342928","chr7","119744984","119745215","51","111402285"
"chr1","8368920","8369235","chr19","48171503","48171823","93","39802583"
"chr1","8400274","8400551","chrX","3592780","3593062","76","4807494"
"chr1","8404445","8404546","chr20","87144","87254","61","8317301"
"chr1","8461840","8462067","chr7","119744984","119745215","53","111283144"
"chr1","8465406","8465535","chr19","6391716","6391877","67","2073690"
"chr1","8479104","8479227","chr19","6391716","6391877","59","2087388"
"chr1","8495893","8496169","chr3","173091221","173091509","85","164595328"
"chr1","8496282","8496518","chr5","132198669","132198902","72","123702387"
"chr1","8542541","8542657","chr20","87144","87254","62","8455397"
"chr1","8569610","8569905","chrUn_NW_019938566v1","98142","98430","83","8471468"
"chr1","8582214","8582533","chr8","16648876","16649161","105","8066662"
"chr1","8594876","8595175","chr20","46003702","46004015","71","37408826"
"chr1","8630606","8630717","chr20","87144","87254","61","8543462"
"chr1","8633138","8633422","chr1","20214247","20214541","75","11581109"
"chr1","8651820","8651979","chr18","55799233","55799394","56","47147413"
"chr1","8656831","8656959","chr9","47045786","47045941","61","38388955"
"chr1","8671989","8672123","chr1","217544386","217544536","62","208872397"
"chr1","8688160","8688283","chr20","87144","87254","63","8601016"
"chr1","8688574","8688674","chr20","87144","87254","58","8601430"
"chr1","8769490","8769777","chrX","46692258","46692555","72","37922768"
"chr1","8775290","8775602","chr1","196006286","196006594","75","187230996"
"chr1","8791940","8792117","chr2A","60286019","60286209","62","51494079"
"chr1","8794748","8794824","chrX","45395975","45396094","68","36601227"
"chr1","8797977","8798101","chr1","217544386","217544536","61","208746409"
"chr1","8807057","8807352","chr5","83677678","83677973","70","74870621"
"chr1","8824088","8824210","chr1","217544386","217544536","61","208720298"
"chr1","8841498","8841629","chr1","217544386","217544536","70","208702888"
"chr1","8841799","8841809","chr20","87144","87254","100","8754655"
"chr1","8852608","8852764","chr19","6391716","6391877","55","2460892"
"chr1","8854874","8855016","chr19","6391716","6391877","53","2463158"
"chr1","8855329","8855475","chr1","217544386","217544536","65","208689057"
"chr1","8857560","8857715","chr1","217544386","217544536","81","208686826"
"chr1","8887712","8888002","chr8","15910614","15910909","70","7022902"
"chr1","8913418","8913553","chr15","37343640","37343763","67","28430222"
"chr1","8918545","8918866","chr1","88859712","88859991","102","79941167"
"chr1","8929246","8929414","chr12","4864673","4864880","65","4064573"
"chr1","8929698","8929841","chr9","47045786","47045941","48","38116088"
"chr1","8942846","8943023","chr2A","60286019","60286209","75","51343173"
"chr1","8966999","8967122","chr19","6391716","6391877","57","2575283"
"chr1","8972050","8972350","chr5","63802202","63802507","68","54830152"
"chr1","8990885","8991154","chrUn_NW_019938566v1","98142","98430","74","8892743"
"chr1","8992201","8992487","chr8","25360790","25361095","74","16368589"
"chr1","9023628","9023749","chr9","47045786","47045941","61","38022158"
"chr1","9049856","9049989","chr5","32595015","32595178","53","23545159"
"chr1","9050305","9050486","chr2A","60286019","60286209","64","51235714"
"chr1","9052736","9052974","chr15","26873577","26873832","75","17820841"
"chr1","9061320","9061619","chr1","213591659","213591963","76","204530339"
"chr1","9066699","9067009","chr1","135236320","135236644","83","126169621"
"chr1","9102913","9103072","chr5","32595015","32595178","71","23492102"
"chr1","9116749","9117040","chr18","16899958","16900260","73","7783209"
"chr1","9126907","9127178","chr3","83975049","83975347","86","74848142"
"chr1","9131082","9131230","chr1","217544386","217544536","68","208413304"
"chr1","9131533","9131651","chr1","217544386","217544536","56","208412853"
"chr1","9133186","9133311","chr5","32595015","32595178","61","23461829"
"chr1","9145696","9146002","chr3","99347730","99348048","73","90202034"
"chr1","9152127","9152267","chr9","47045786","47045941","49","37893659"
"chr1","9154735","9154880","chr1","217544386","217544536","65","208389651"
"chr1","9168118","9168412","chr17","50238409","50238704","72","41070291"
"chr1","9194533","9194660","chr18","55799233","55799394","54","46604700"
"chr1","9220905","9221212","chr10","125157322","125157641","71","115936417"
"chr1","9267972","9268266","chr3","99347730","99348048","78","90079758"
"chr1","9283011","9283290","chrX","6298217","6298515","86","2984794"
"chr1","9299357","9299468","chr20","87144","87254","61","9212213"
"chr1","9299777","9299982","chr14","51003183","51003398","72","41703406"
"chr1","9304769","9304955","chr8","53067733","53067939","71","43762964"
"chr1","9309338","9309532","chr14","51003183","51003398","63","41693845"
"chr1","9312016","9312326","chr17","49042955","49043238","92","39730939"
"chr1","9492041","9492157","chr9","47045786","47045941","62","37553745"
"chr1","9498631","9498930","chr5","152110395","152110709","73","142611764"
"chr1","9586161","9586412","chr1","164929853","164930117","81","155343692"
"chr1","9607966","9608255","chr2A","88638728","88639031","72","79030762"
"chr1","9631990","9632001","chr20","87144","87254","99","9544846"
"chr1","9632311","9632489","chr18","55799233","55799394","71","46166922"
"chr1","9649231","9649532","chr14","35729192","35729503","76","26079961"
"chr1","9667177","9667312","chr20","87144","87254","71","9580033"
"chr1","9669162","9669321","chr19","6391716","6391877","70","3277446"
"chr1","9681255","9681402","chr1","217544386","217544536","68","207863131"
"chr1","9686258","9686498","chr7","49845301","49845560","68","40159043"
"chr1","9688572","9688838","chr10","96412023","96412287","78","86723451"
"chr1","9696813","9697084","chr15","79057692","79057974","77","69360879"
"chr1","9706805","9707114","chr14","31798968","31799292","69","22092163"
"chr1","9713597","9713770","chr19","13525969","13526165","70","3812372"
"chr1","9753809","9754106","chr8","25360790","25361095","75","15606981"
"chr1","9797353","9797657","chr19","36137286","36137590","80","26339933"
"chr1","9802814","9803121","chr2B","83001661","83001979","71","73198847"
"chr1","9814629","9814918","chrUn_NW_019938566v1","98142","98430","77","9716487"
"chr1","9833319","9833609","chr1","84037299","84037592","69","74203980"
"chr1","9855726","9855907","chr12","23162528","23162744","74","13306802"
"chr1","9856178","9856309","chr9","47045786","47045941","58","37189608"
"chr1","9873744","9874001","chr10","96412023","96412287","66","86538279"
"chr1","9874288","9874551","chr3","98206950","98207200","84","88332662"
"chr1","9881035","9881323","chr12","108570006","108570305","80","98688971"
"chr1","9891664","9891781","chr5","32595015","32595178","64","22703351"
"chr1","9892105","9892142","chr20","87144","87254","76","9804961"
"chr1","9892440","9892611","chr12","4864673","4864880","67","5027767"
"chr1","9931086","9931249","chr16","46964977","46965105","85","37033891"
"chr1","9931562","9931640","chr8","58489091","58489211","58","48557529"
"chr1","9936686","9936820","chr9","47045786","47045941","54","37109100"
"chr1","9947186","9947318","chr20","87144","87254","69","9860042"
"chr1","9954224","9954508","chr3","90264983","90265291","76","80310759"
"chr1","9960136","9960313","chr2A","60286019","60286209","58","50325883"
"chr1","9960380","9960506","chr1","217544386","217544536","56","207584006"
"chr1","9971681","9971982","chr8","25360790","25361095","78","15389109"
"chr1","9979186","9979484","chr1","213591659","213591963","75","203612473"
"chr1","10001318","10001563","chr10","96412023","96412287","64","86410705"
"chr1","10023403","10023486","chr20","87144","87254","60","9936259"
"chr1","10024242","10024522","chr19","13342110","13342403","74","3317868"
"chr1","10027456","10027625","chr5","32595015","32595178","70","22567559"
"chr1","10027920","10028075","chr18","55799233","55799394","51","45771313"
"chr1","10036504","10036600","chr15","37343640","37343763","65","27307136"
"chr1","10047869","10048148","chr1","213591659","213591963","95","203543790"
"chr1","10053060","10053138","chr20","87144","87254","65","9965916"
"chr1","10053449","10053504","chr20","87144","87254","68","9966305"
"chr1","10071300","10071588","chrX","46692258","46692555","69","36620958"
"chr1","10078836","10079101","chr12","82298322","82298589","85","72219486"
"chr1","10091443","10091607","chr19","6391716","6391877","69","3699727"
"chr1","10091904","10092038","chr19","6391716","6391877","52","3700188"
"chr1","10133766","10134077","chr14","31798968","31799292","74","21665202"
"chr1","10153224","10153518","chr14","31798968","31799292","82","21645744"
"chr1","10156898","10157028","chr9","47045786","47045941","47","36888888"
"chr1","10157321","10157496","chr2A","60286019","60286209","67","50128698"
"chr1","10164374","10164515","chr5","32595015","32595178","67","22430641"
"chr1","10177503","10177659","chr9","47045786","47045941","69","36868283"
"chr1","10212605","10212811","chr17","17826312","17826529","60","7613707"
"chr1","10224431","10224723","chr7","49832421","49832722","80","39607990"
"chr1","10229911","10230154","chr9","79131976","79132248","80","68902065"
"chr1","10250573","10250824","chr10","22344248","22344507","82","12093675"
"chr1","10327925","10328215","chr16","18746194","18746482","83","8418269"
"chr1","10334943","10335245","chrX","46692258","46692555","82","36357315"
"chr1","10356931","10357179","chr7","49845301","49845560","76","39488370"
"chr1","10362793","10363079","chr8","15910614","15910909","75","5547821"
"chr1","10369347","10369616","chr2A","75514615","75514896","83","65145268"
"chr1","10371663","10371959","chr10","125157322","125157641","82","114785659"
"chr1","10387162","10387458","chr2B","83001661","83001979","73","72614499"
"chr1","10389720","10389848","chr18","55799233","55799394","63","45409513"
"chr1","10391887","10392196","chr8","40540954","40541273","76","30149067"
"chr1","10397475","10397636","chr5","32595015","32595178","67","22197540"
"chr1","10407167","10407455","chrX","46692258","46692555","75","36285091"
"chr1","10409466","10409618","chr1","217544386","217544536","70","207134920"
"chr1","10416087","10416257","chr10","32749231","32749409","59","22333144"
"chr1","10422744","10423042","chr5","63802202","63802507","67","53379458"
"chr1","10429571","10429880","chr2B","83001661","83001979","71","72572090"
"chr1","10457916","10458020","chr20","87144","87254","63","10370772"
"chr1","10459750","10459931","chr22","26696703","26696888","67","16236953"
"chr1","10473215","10473344","chr15","37343640","37343763","68","26870425"
"chr1","10479095","10479375","chr1","20214247","20214541","75","9735152"
"chr1","10481434","10481697","chr3","9052682","9052970","84","1428752"
"chr1","10491386","10491659","chr15","50439849","50440151","90","39948463"
"chr1","10497998","10498280","chrX","3592780","3593062","69","6905218"
"chr1","10498320","10498338","chr20","87144","87254","92","10411176"
"chr1","10502786","10503100","chr16","9702460","9702783","76","800326"
"chr1","10543642","10543899","chr3","15191824","15192108","86","4648182"
"chr1","10565734","10565937","chr13","83255168","83255404","71","72689434"
"chr1","10574829","10575100","chr10","28570518","28570799","93","17995689"
"chr1","10604354","10604632","chr11","34622326","34622621","76","24017972"
"chr1","10740671","10740986","chr9","68878569","68878883","71","58137898"
"chr1","10750263","10750567","chr11","113329688","113329999","91","102579425"
"chr1","10833383","10833686","chr9","68878569","68878883","73","58045186"
"chr1","10843258","10843541","chrX","3592780","3593062","69","7250478"
"chr1","10845006","10845208","chr12","105257502","105257717","66","94412496"
"chr1","10887049","10887340","chr4","187957937","187958223","74","177070888"
"chr1","10923940","10924232","chr19","13342110","13342403","63","2418170"
"chr1","10962838","10963067","chr13","83255168","83255404","61","72292330"
"chr1","10970864","10971165","chr8","25360790","25361095","84","14389926"
"chr1","10978428","10978724","chr5","63802202","63802507","67","52823774"
"chr1","10982466","10982762","chr5","152110395","152110709","71","141127929"
"chr1","11003607","11003904","chr7_NW_019937272v1_random","2134063","2134360","79","8869544"
"chr1","11010235","11010531","chr6","32649583","32649885","77","21639348"
"chr1","11016266","11016454","chr2A","60286019","60286209","67","49269753"
"chr1","11017774","11017875","chr20","87144","87254","63","10930630"
"chr1","11021586","11021916","chr5","152110395","152110709","88","141088809"
"chr1","11030952","11031110","chr16","46964977","46965105","66","35934025"
"chr1","11048635","11048932","chr7_NW_019937272v1_random","2134063","2134360","66","8914572"
"chr1","11056875","11057156","chr16","18746194","18746482","87","7689319"
"chr1","11065890","11066136","chr12","95325313","95325577","70","84259423"
"chr1","11069954","11070285","chr7","40732565","40732896","90","29662611"
"chr1","11070308","11070543","chr7","119744984","119745215","66","108674676"
"chr1","11093785","11094099","chr10","65849492","65849800","83","54755707"
"chr1","11096464","11096778","chr13","11426887","11427206","76","330423"
"chr1","11154646","11154863","chr14","51003183","51003398","55","39848537"
"chr1","11177276","11177573","chr1","49763974","49764279","79","38586698"
"chr1","11179915","11180204","chrUn_NW_019938566v1","98142","98430","68","11081773"
"chr1","11201818","11202105","chr7_NW_019937272v1_random","2134063","2134360","76","9067755"
"chr1","11207408","11207794","chr1","89503424","89503784","113","78296016"
"chr1","11211383","11211665","chr1","88859712","88859991","79","77648329"
"chr1","11216401","11216671","chr10","101970539","101970842","87","90754138"
"chr1","11243410","11243711","chr16","32352979","32353289","77","21109569"
"chr1","11275459","11275747","chr3","83975049","83975347","68","72699590"
"chr1","11288626","11288934","chr9","68878569","68878883","64","57589943"
"chr1","11294333","11294445","chr20","87144","87254","64","11207189"
"chr1","11311193","11311492","chr10","65849492","65849800","72","54538299"
"chr1","11313053","11313357","chr10","125157322","125157641","64","113844269"
"chr1","11317091","11317403","chr14","31798968","31799292","80","20481877"
"chr1","11332132","11332441","chr9","2736689","2737010","75","8595443"
"chr1","11336326","11336609","chrX_NW_019937303v1_random","2630481","2630786","89","8705845"
"chr1","11341339","11341621","chr1","88859712","88859991","82","77518373"
"chr1","11377538","11377835","chr12","108570006","108570305","80","97192468"
"chr1","11378440","11378566","chr9","47045786","47045941","67","35667346"
"chr1","11394366","11394666","chr7","93103409","93103731","71","81709043"
"chr1","11470155","11470318","chr5","32595015","32595178","60","21124860"
"chr1","11506795","11507073","chr3","9052682","9052970","74","2454113"
"chr1","11508141","11508434","chr3","1995447","1995752","73","9512694"
"chr1","11510690","11510800","chr20","87144","87254","63","11423546"
"chr1","11513110","11513306","chr12","23162528","23162744","63","11649418"
"chr1","11525793","11526026","chr7","137245286","137245521","60","125719493"
"chr1","11548404","11548696","chr9","68878569","68878883","70","57330165"
"chr1","11551745","11552043","chr8","25360790","25361095","70","13809045"
"chr1","11589096","11589370","chrX","3592780","3593062","74","7996316"
"chr1","11595756","11595992","chr16","14564705","14564970","82","2968949"
"chr1","11645463","11645747","chr18","16899958","16900260","67","5254495"
"chr1","11659522","11659795","chrX","46692258","46692555","77","35032736"
"chr1","11666194","11666365","chr22","26696703","26696888","69","15030509"
"chr1","11687056","11687232","chr2A","60286019","60286209","54","48598963"
"chr1","11687538","11687675","chr5","32595015","32595178","48","20907477"
"chr1","11716672","11716791","chr20","87144","87254","68","11629528"
"chr1","11718462","11718763","chr12","108570006","108570305","81","96851544"
"chr1","11725120","11725343","chr7","119744984","119745215","57","108019864"
"chr1","11731262","11731433","chr5","32595015","32595178","69","20863753"
"chr1","11769304","11769577","chr5","6598042","6598342","75","5171262"
"chr1","11773922","11774203","chr1","20214247","20214541","72","8440325"
"chr1","11797293","11797612","chr1","199907800","199908113","69","188110507"
"chr1","11831687","11831966","chr13","82343527","82343808","86","70511840"
"chr1","11852518","11852834","chr14","31798968","31799292","73","19946450"
"chr1","11864231","11864553","chr1","216791060","216791385","27","204926829"
"chr1","11866364","11866651","chr5","63802202","63802507","71","51935838"
"chr1","11872192","11872490","chr3","75083989","75084283","78","63211797"
"chr1","11891628","11891934","chr11","113329688","113329999","76","101438060"
"chr1","11911916","11912193","chr5","83677678","83677973","66","71765762"
"chr1","11914345","11914657","chr20","46003702","46004015","75","34089357"
"chr1","11921853","11922147","chr12","62126102","62126415","74","50204249"
"chr1","11922188","11922353","chr18","55799233","55799394","61","43877045"
"chr1","11930250","11930566","chr10","125157322","125157641","78","113227072"
"chr1","11940077","11940318","chr2A","34453871","34454129","80","22513794"
"chr1","11961102","11961411","chr1","213591659","213591963","78","201630557"
"chr1","11961608","11961786","chr12","4864673","4864880","67","7096935"
"chr1","11962087","11962227","chr19","6391716","6391877","43","5570371"
"chr1","11978983","11979257","chr10","96412023","96412287","94","84433040"
"chr1","11992813","11992979","chr2A","60286019","60286209","69","48293206"
"chr1","11994966","11995297","chr14","31798968","31799292","95","19804002"
"chr1","12018278","12018483","chr14","51003183","51003398","80","38984905"
"chr1","12051709","12051860","chr9","47045786","47045941","73","34994077"
"chr1","12053254","12053421","chr9","47045786","47045941","64","34992532"
"chr1","12092189","12092469","chr4","187957937","187958223","75","175865748"
"chr1","12101144","12101447","chr16","32352979","32353289","67","20251835"
"chr1","12166293","12166585","chrX","61799705","61800010","94","49633412"
"chr1","12193291","12193596","chr2A","88638728","88639031","79","76445437"
"chr1","12212126","12212276","chr18","55799233","55799394","62","43587107"
"chr1","12213568","12213858","chr3","56709786","56710088","83","44496218"
"chr1","12218393","12218518","chr9","47045786","47045941","59","34827393"
"chr1","12227616","12227899","chr1","88859712","88859991","82","76632096"
"chr1","12237537","12237839","chr1","49763974","49764279","65","37526437"
"chr1","12243510","12243608","chr20","87144","87254","57","12156366"
"chr1","12289672","12289953","chr8","25360790","25361095","78","13071118"
"chr1","12291352","12291624","chr12","99989922","99990215","84","87698570"
"chr1","12312476","12312742","chr17","56439745","56440021","69","44127269"
"chr1","12323080","12323364","chr18","16899958","16900260","75","4576878"
"chr1","12326322","12326634","chr14","31798968","31799292","74","19472646"
"chr1","12334485","12334787","chr8","25360790","25361095","85","13026305"
"chr1","12354382","12354547","chr9","47045786","47045941","67","34691404"
"chr1","12515296","12515617","chr16","9702460","9702783","75","2812836"
"chr1","12516373","12516652","chr19","13342110","13342403","74","825737"
"chr1","12535826","12535936","chr20","87144","87254","63","12448682"
"chr1","12539620","12539921","chr16","9702460","9702783","82","2837160"
"chr1","12544221","12544496","chr15","26873577","26873832","86","14329356"
"chr1","12550198","12550430","chr14","51003183","51003398","58","38452985"
"chr1","12565678","12565917","chr10","96412023","96412287","71","83846345"
"chr1","12589702","12589818","chr18","55799233","55799394","66","43209531"
"chr1","12593376","12593503","chr5","32595015","32595178","56","20001639"
"chr1","12647091","12647398","chr9","68878569","68878883","68","56231478"
"chr1","12753783","12753899","chr8","58489091","58489211","63","45735308"
"chr1","12829424","12829708","chr1","47533839","47534134","81","34704415"
"chr1","12841683","12841825","chr18","55799233","55799394","47","42957550"
"chr1","12884029","12884315","chr3","83975049","83975347","82","71091020"
"chr1","12896169","12896310","chr9","47045786","47045941","51","34149617"
"chr1","12943187","12943473","chr8","15910614","15910909","82","2967427"
"chr1","13054294","13054580","chr3","83975049","83975347","79","70920755"
"chr1","13105989","13106131","chr18","55799233","55799394","47","42693244"
"chr1","13174360","13174646","chr3","83975049","83975347","79","70800689"
"chr1","13227309","13227443","chr9","47045786","47045941","55","33818477"
"chr1","13227755","13227939","chr19","13525969","13526165","80","298214"
"chr1","13258314","13258600","chr8","15910614","15910909","81","2652300"
"chr1","13305492","13305633","chr9","47045786","47045941","51","33740294"
"chr1","13317487","13317773","chr3","83975049","83975347","82","70657562"
"chr1","13323075","13323365","chr3","54066100","54066414","85","40743025"
"chr1","13373406","13373540","chr9","47045786","47045941","58","33672380"
"chr1","13374154","13374330","chr18","55799233","55799394","73","42425079"
"chr1","13397837","13398143","chr16","32352979","32353289","76","18955142"
"chr1","13480480","13480515","chr20","87144","87254","77","13393336"
"chr1","13480864","13480957","chr20","87144","87254","62","13393720"
"chr1","13540393","13540503","chr20","87144","87254","68","13453249"
"chr1","13542662","13542797","chr9","47045786","47045941","48","33503124"
"chr1","13574425","13574545","chr15","37343640","37343763","65","23769215"
"chr1","13579433","13579559","chr19","6391716","6391877","54","7187717"
"chr1","13580670","13580942","chrX","3592780","3593062","72","9987890"
"chr1","13597724","13597981","chr10","96412023","96412287","67","82814299"
"chr1","13606521","13606710","chr2A","60286019","60286209","59","46679498"
"chr1","13631539","13631693","chr18","55799233","55799394","61","42167694"
"chr1","13633346","13633653","chr9","68878569","68878883","68","55245223"
"chr1","13712019","13712239","chr14","51003183","51003398","50","37291164"
"chr1","13773430","13773725","chr8","25360790","25361095","67","11587360"
"chr1","13895992","13896117","chr15","37343640","37343763","68","23447648"
"chr1","13896331","13896590","chr9","79131976","79132248","68","65235645"
"chr1","13929048","13929206","chr2A","60286019","60286209","62","46356971"
"chr1","14145161","14145452","chr8","25360790","25361095","64","11215629"
"chr1","14445915","14446212","chr5","152110395","152110709","68","137664480"
"chr1","14619203","14619498","chr8","25360790","25361095","77","10741587"
"chr1","14669463","14669775","chr14","31798968","31799292","72","17129505"
"chr1","14674778","14675005","chr13","1430460","1430706","68","13244318"
"chr1","14701125","14701430","chr8","15910614","15910909","68","1209489"
"chr1","14703626","14703909","chr11","34622326","34622621","89","19918700"
"chr1","14710902","14711192","chr1","47533839","47534134","63","32822937"
"chr1","14738891","14739195","chr1","213591659","213591963","20","198852768"
"chr1","14744447","14744742","chrX","16155635","16155942","69","1411188"
"chr1","14758186","14758455","chr1","213572383","213572661","24","198814197"
"chr1","14772200","14772479","chr1","20214247","20214541","68","5442047"
"chr1","14812516","14812811","chr12","108570006","108570305","74","93757490"
"chr1","14837551","14837853","chr20","46003702","46004015","67","31166151"
"chr1","14847703","14848002","chr9","68878569","68878883","77","54030866"
"chr1","14908121","14908258","chr5","32595015","32595178","43","17686894"
"chr1","14908572","14908725","chr5","32595015","32595178","73","17686443"
"chr1","14916639","14916926","chr2A","88638728","88639031","71","73722089"
"chr1","14939274","14939572","chr8","15910614","15910909","66","971340"
"chr1","15031602","15031907","chr10","65849492","65849800","74","50817890"
"chr1","15130471","15130556","chr20","87144","87254","58","15043327"
"chr1","15132585","15132702","chr20","87144","87254","62","15045441"
"chr1","15147497","15147717","chr17","17826312","17826529","62","2678815"
"chr1","15148810","15149109","chr8","15910614","15910909","66","761804"
"chr1","15208341","15208582","chr12","71868675","71868924","59","56660334"
"chr1","15295327","15295606","chr1","164929853","164930117","75","149634526"
"chr1","15319481","15319606","chr19","6391716","6391877","50","8927765"
"chr1","15332427","15332728","chr5","177155309","177155607","75","161822882"
"chr1","15342667","15342959","chr19","36137286","36137590","74","20794619"
"chr1","15342960","15343094","chr5","32595015","32595178","52","17252055"
"chr1","15373571","15373839","chrX","3592780","3593062","79","11780791"
"chr1","15387467","15387603","chr5","32595015","32595178","49","17207548"
"chr1","15399285","15399579","chr10","100799003","100799317","70","85399718"
"chr1","15416816","15417110","chr8","25360790","25361095","63","9943974"
"chr1","15431540","15431662","chr9","47045786","47045941","56","31614246"
"chr1","15434056","15434367","chr14","31798968","31799292","73","16364912"
"chr1","15441695","15442041","chr20","48305651","48305992","112","32863956"
"chr1","15443979","15444288","chr14","43050155","43050466","77","27606176"
"chr1","15468525","15468801","chr5","63802202","63802507","85","48333677"
"chr1","15488105","15488395","chr8","15910614","15910909","72","422509"
"chr1","15522436","15522716","chrX","46692258","46692555","81","31169822"
"chr1","15535764","15536026","chr7","7616254","7616509","85","7919510"
"chr1","15561749","15561846","chr20","87144","87254","61","15474605"
"chr1","15589107","15589408","chr6","157423301","157423612","73","141834194"
"chr1","15589905","15590212","chr9","68878569","68878883","62","53288664"
"chr1","15602106","15602429","chr7","7056350","7056674","84","8545756"
"chr1","15614973","15615349","chr1","112998725","112999079","105","97383752"
"chr1","15622074","15622323","chr15","26873577","26873832","84","11251503"
"chr1","15623382","15623557","chr12","4864673","4864880","60","10758709"
"chr1","15623584","15623701","chr20","87144","87254","65","15536440"
"chr1","15632913","15633228","chr9","68878569","68878883","77","53245656"
"chr1","15634978","15635249","chr11","117289294","117289598","80","101654316"
"chr1","15639481","15639699","chr10","102878352","102878592","74","87238871"
"chr1","15645587","15645884","chr8","25360790","25361095","75","9715203"
