"chr1","148897500","148897807","chr5","152110395","152110709","80","3212895","GGCCTGGCATGTTGGCGCATGTCAGTAATCCCAGCACTTCGCAAGGCCAAGGTGGGAGGATCACTTGAGCCCAGGAGTTTGAGACCAGCCTGGGAAACATAGCAAGACTGCATCTCTGTAAATTTTTTTTTTTTTAATTAGCTGACATAGTGGTGTGTGGCTGTGGTACCAGCTACTTGGGAGGCTGAGGTGGGAGGATTGCTTGAGCCCAGAAGGTTGAGGCTGCAGTGAGCCATGATTGTGCTCCTGCATTCTAGCCTGGGTGACAGAGTGAGACCCCATCTCACACATACACACAGAAAAAAAAA","GGCTGGGAGTGGTGGCTCATGCCTATAATACCAGCACTTTGGGAGGCCAAGGTGGGAAGATCACTTGAGGCCAGGAGTTCAAGATCAGCCTAGGCAACATAGCAAGACCCTGTCTCTACAAAACAAACAAACAAACAAACAAACAAAATTAGCTGGGCATGGCGGTATGCACCTGTAGTCCCAGCTACTTGGGAGGCTGAGGCAGGAGGATTGTTTGAGCCCAGAAGGTTGAGGCTGCATTGAGCCATGATTATGCCACTTTACTCCAGCCTGGGCAACAGAGGGAGACCCCATTCTCAAAAACAAAACAAAAAA"
"chr1","186646252","186646542","chr12","108179452","108179746","72","78466800","CTGGGTGTGGAGGCTCATGTCTATAATATCAGTACTTTGGGAAGCCAAGGTGAAAGGATCACTTGAGGCCAGGAGTTTGAGACTAGCCTGGGCAACATAGTAAGACTCCATTTCTACAAAAAAAAAAAAAAAAAAATTAGCCAGGTGTTGTGACATGCGCCTGTAGTCTTAGCTACTCAAGAGGTGAAAGGATTGCTTAAGCCGAGGAATTTGAGGCTGTGGTGAGCTAGGATAGTGCCACTGCACTGCAACTTGCATGACAGTGAGACCCTGTCTCTAAGAAACTAAAAA","GGCTGAGTGCGGTGGCTCTTGCCCATAATCCTGACACGTTGGGAGGCCAAAGCGGGAGGGTCACTTGAGGCCAGGAGTTTGAGATCAGCCTGGGCAACATAGTGAGACCCTGTTTCTTAAAAAAAAAAAAAAAAAAAAAAAAAGCCCAGGATTGATGTGCGCACCTGTAGTCCCAGCTACTCAAGACTGAGGTGAAAAGGTCGCTTGAGCCCAGGAGCTCGAGGCCAAGTGAGCTAGGATCGTGCCACTGCACTCCAGACCGGGCAACAAAGCGAGACCCTGTCTCAAAAACAAA"
"chr1","786377","786507","chr9","47045786","47045941","54","46259409","GACTGGGTGTGGTAGTTCACATCTGTAATCCCAGCACTTTGGGAGACCAAGGTTGGAGGATCACTTGAGGCCAGGAGATCAAGGATCACCCTGGGCAACATAATGAGATCTGTCTCTATAAAATAAATAAA","GCTGGGCGCAGCAGCTCACACCTGTAATCCCAGTGCTTTGGAGGTCCAAGGTAGGAGGATTGCTTAAGACTAGGTGTTCAAGACCAGTCTTGGCAACATAGTGAGAACTCATCTCTACAATAAATAAATAAATAAATAAATAAATGAAAATAAAAA"
"chr1","23592887","23593018","chr5","32595015","32595178","57","9002128","GCTGGGCATGGTGGCTCATGCCTGTAATTTCAGCACTCTGGGAGACTGAGGTGGGAGCATCACTTGAGGCCAGGAGTTGGATACCAGCCTAGATAACATAGTGAGGCCCCCATCTCTATAAAAATAATAAAA","GGCCGGGTGTGGTCCCTCATGCCTGTAATCCCAACACTTTGGGAGGCTGAGATAGGAGGACTGCTTGAGGCCAGGAGTTCAAGACCAGCCTGGTCAACATAGTGAGACCCCATCTCTATAAAATAATAATAATAATAATAATAATAATAATAAATAAATAAATA"
"chr1","26869750","26869867","chr8","58489091","58489211","64","31619341","GGCCAGGTGCAGTAGCTCACACCTGTAATCCCAACACTTTAGGAGGCTGAGGCTGGAGAATCACCTGAGGCCAGGAGTTCAAGACCAACCTGGACAACATAGCGAGAACCTGTCTCTA","TTGAGACCAGGAGTTTGAGACCAGCTTGGACAACATAGTGAGACCCTGTCTAAAAGAAAGAAAGAAAGAAAAGAAAGAAAGAAAGATGTAGCCAAGTGTGGTGGTGCACATCTGTGTCTCA"
"chr1","35520400","35520652","chr1","205290793","205291030","72","169770393","GAGGCAGCAGAACCATTAAAGGGCAGAAGTTCAAGACCAGCCTAGGCAAAATAGTGAGACCTCATCTCTACAAAAAAATAAAACATAAAAAAATAGCTGGGTGTAGTGGCACACATGTGTAGTCCCAGCTATTTGGGAGGCTAAGGTGGGAGGATTGCTTGAGCCTAGGAATTTGAGGCTGCAGTGAGCTATGATTGCACCACTGCACTTCAGTGTGGGTGACAGGATGAGACCCTGTCTTAAAGAAAAAAAA","CCAGCCTGGGCAACAGAATGAAACCCTGTCTCAAAAAAATATATATATATATATATATATAAAAATATATATAAATTAGCTGGGTGTGGTGATGCATGCTTGTAGTTCCAGCTACTAGGGAGGCTGAGGTGGGAAGATCACTTGAGCCTAGGGGTTCTAGGCTGCAGTGAGCTATGATTGCACCAGTGCACTCCAGCCTGGGCAACAGAGTGAGACCCTGTCTCAAGAGAAAAAAAAA"
"chr1","54656906","54657037","chr9","47045786","47045941","55","7611120","GGCCAGCACAATGACTCATGCCTGTAATACCAGTGCTTTGAGAAGCCAAGGCAGGAGGATCACTTGAAGTCAGGAGTTTGGGACCAGCTTGAGCAACATAGCAAGACTCTGTCTATATAAAAAACAAAAAAA","GCTGGGCGCAGCAGCTCACACCTGTAATCCCAGTGCTTTGGAGGTCCAAGGTAGGAGGATTGCTTAAGACTAGGTGTTCAAGACCAGTCTTGGCAACATAGTGAGAACTCATCTCTACAATAAATAAATAAATAAATAAATAAATGAAAATAAAAA"
"chr1","57016300","57016613","chr9","57029965","57030284","85","13665","GGCCAGATGTGGTGGCTTATGCTTGTAATCCTAGCACTTTGGGAGGTCCAGGTGGGAGGATTGCTTGAGGCTTGGAGTTTGAGACCAGCTTTAGCAACATAACAAGACCTCTTCTCTACCAAAAATTTTAAAAAATTAGTCAGGAATGGTGGCACATGCTCAGAGTTCCATAGTCTCGGCACTCAGGAGGCTGAGGCGGGAGGATCACTTGAGCCCAAGAGTTTGAAGCAGCACTGAGCTATGATCACCCTACTGCACTTCAGCCTGGGTAATAGAGTGAGACACTTGTCTCTAAAAAAAAAAAAAGAAAGAAA","GGCTGGGCATGGTGGTTCATGCGTGTAGTCCCAGCACTTTTTCAGGCCAACGTAGGAGGATCACTTGAGGCCTGGAGTTTGAGACCAGCCTGGGCAACAAAGGGAGACCTTGTCTTTACAAATAAATAAATAAATAAATAAATAAAAATTTAGCTGGGCATGGTGGTGCACACCTGTGGTCTCAGCTACTCAGGAGGCTGATGTGGGAGGATCACTTGAGCCCCAGAAGTTTGAGGCTTGCGGTGAGCTATGATCATACCACAGCACTCCAGCCTGGGTGACAGAGCAAAACCCTGTCTCTAAAATTAAAAAAAAAAAAA"
"chr1","91619144","91619442","chr3","180847740","180848052","72","89228596","GGCTGGGCATGGTGGCTCACGCCTGTAATCCCAGAAGGTGGGTGAATCGCTTGAGCCCAGGAGTTCAAGACCAGCCTGGGCAACATGGCGAAAACCTAGCTCTACAAAAAAATGAAAATAAAAATTGCTGGGCGTAGTGGTGGATGCCTGTAGTCCCAGCTATTCAGGAGGCTGAGGTGGGAGGATCACTTGAGCCCAGGAGTTCGAGGCTGCAGTGAGCCATGATCATGCCACTGCACTCCAGCCTAGGTGACAGAATGAGACCCTGTCTCAAAAAAAAAAAAAATCAAAAATGAAAA","GCCGTGGGCCGTGGCTTACACCTGTAATCCCAATGGTTGGCTAACGCAGGAGGATCGTTTGAAGCCAGGAACTCGAGACCAGCCTGGGCAACACAGTGAGACCTCCTCTCTACATAAAATAAAATAAAATAAAATAAAATAGCTGGGTGTGGTGGCACGCGCCTTTGGTCCCAGCTACTCAGGAGGCTGAGGTGGGAGACTCACTTGAGGCCAGGAGGTCGAAGTTGCAGTGAGCCGAGATCACGCCACTGCACTCCAGCCTGGGTGACAGAGCGAGACCCTGACTCCAAAAAAAAAAAAAAAAAAAAAAAAA"
"chr1","151650188","151650326","chr9","47045786","47045941","53","104604402","GGCCAGGTGCAGTGGTTCAGGCCTGTAATCTCAGTGCTTTGGGAGTCTGAGGAAGGAGGATTGCTGAGGCTGAGAGTGTGAGAATAGCCTGGGGAACATAGCAAGACCCCATCTCTACTAAAAATTTTTAAAATTAGGT","GCTGGGCGCAGCAGCTCACACCTGTAATCCCAGTGCTTTGGAGGTCCAAGGTAGGAGGATTGCTTAAGACTAGGTGTTCAAGACCAGTCTTGGCAACATAGTGAGAACTCATCTCTACAATAAATAAATAAATAAATAAATAAATGAAAATAAAAA"
"chr1","167378927","167379230","chr1","207218281","207218584","79","39839354","CCAGATACAGTGGCTCATGCCTATAATCCCAGCACTTTGGGAGGCTGATGCAAGAGGATCGCTTGAACCCAGGAGTTCAAGACCAGCCTGCGCAACCACAGCAAGACATGTCTCTATAAAAAACTTTTTTTTTTTTCTCAATTAGCCAGGTGAGGTAGTACACACTGTACTCCCAGCTGCTTTGAAGGCTAAGGTGGGAGGACTGCTTGATCCCAAGAGGCTGGGACTGCAGTGAGCCATGATTGTGCCACTGCACTCCAGCCTGGGTGACAGAGCAAGACTCTGTCTCAAAAAAAAAAAAAAA","GCCAGGCACAGAGGCTCATGCCTGTAATCCCAACACTTTGGGAGGCCGAGACAGGAGGATCACTTCAGGCTAGGAGTTGAGACCAGTCTGGGCAATATAGTAAGACCCTATCTCTATTAAAAAAAAAAAAAAAAAAAAAAAAAAGCTGGGTATGGTGGCACATGCCTGTGTTCCCAGCTACCTGGGAGACTAAGGTGGGAGGACTGCTTGATCCCAAGAATTTGAGGCTGCAGTAAGCTATGACTGCACCACTGCACTCCAGCATGGGCGACAGAGCGAGACCTTGTCTCAAGAAAACAAAAAA"
"chr1","192282568","192282866","chrX","16155635","16155942","73","176126933","GGCTAGGAACCATGGCCCACATCTGTAATCCCAGCACTTTGGAAGGCTGACACAGGAGGATTGCTTGAACCTGGGAGTTCAAGACCAGTCTGGACAACATAGCAAGATCCTGTCTCTACAAAAAAAAAAAAAAAAAATTAAAAATTAGCTAGGTGTGATGTTGCAAACCTCCAATCCCAGCTACTTAGGAGGCTGAGGTGGAAGGATCACTTGAGCCCAGGAATTTGAGGCTGATTGGATGACTGTACTCTAACCTGGGCAACACAGCAAGACTTTTTGTCAGAAAAAAAAAAAAAAAA","GGCCAGGCACAGTGGCTCACACCTGTAATCCCGGTACTTTGGGAGGCTGAGGCGGGAGGATCACTTGAGCCCAGGAGTTCAAGACCAGCCTGGGCAACATAACAAGACCCTGTCTCTACCAAAAAAAAAAAAAAAAAAAAAAAAAATAGCCAGGCCTGGTGGCCTGTGTCCATAGTCCCAGCTACTTTGGGAGACTGAGGTGGAAGGATCACTTGAGTCTGGAAATCAAGACTGCTGTGAGCTGTGATCATGCCACTGTACTCCAGCCTGAGCAACAGAGTGAGACCCTGTCTAAAAAAAAAAAAAAA"
"chr1","197656557","197656825","chr12","118411877","118412164","84","79244680","TGGGAAGCAGAGGCAGGAAGATCCCTTGAGGCCAAGAATTTGAGACCAGCCTAAGCAACATAGTGAGACTCTATCTGTACAAAAAAAAATTAAAAAATTAGCTATTTGTGGTGGCACACACCCATAGTTCCAGCTAATTGGGAGACTGAGGTGAGTGGATTGCTTGATCCTAGGAGGCTGAGGCTGCAGTGAGTGATGATTGTACCACAGTGCTCCACCTCTGGGCAACAGAGCAAGACTCTGTCTCCAAAAAAAATTTAAAAAAAAAA","TGGGTGGCTGAGGCGTGAGGATTGCTTGAGGCCGAGAGTTTGAGACCAATCTAGGCAACATAGTGAGACCCCATCTCTACAAAAAAAAAAAAAAAAAAAAAAAAAAAAATTAGCCAAGTATGGTGGTGTGCACTTCTAGTCCCATCTACTCAGGAGGCTGAGGTGGGAGGATCACTTGAGCCCAGGTGTTTGAGGCTGCATTGAGCTCTGGTGGTACCACTGCACTATAGCCTGGGTGACAGAGTAAGAGCCTGTCTCAAAATAAAAATGAAAAATTAAAACGAAAAA"
"chr1","226099040","226099333","chr8","25360790","25361095","75","200738250","GGCACAGTGGCTTACACTTGTAATCCCAGCACTTTGGGAGTCTGGGGTGGGAAGGTTGCTTGAGGCCAGGAGTTCCAGACCAGCCTGGGCAACATAAGCAAGATCCCGCCGTCTCTATAAAAAGTTAAAAAAATTAGCCAGGCATGGTAGCACATGCCTATAGTTCCAGCTTCTTTGGAGGCTGAAGTGGTAGGATTGCCTGAGCCCAGGAGTTCAAGGCTGCAGTGAGCCCTGACTGCACTACAGCACTCCAACTTGGGTGATACAGCAAAACCCTATCTCCAGAAAAAAAAA","GGCTGGGAGCAGTGGCTCATACCTGTAAGCCCAGCACTTTGGGAGGCTGAGGTGGGAGGATTGCTGAAGCCCAGGAGTTTGAGACCAACCTGGGCAATGTAGGGAGACCCCGTCTCTACTAAATAAATAAATAAATAAATAAATAAAGTCGGGCATGGTGGCATGTGCCCTGTAGTCCCAGCTTCTTGGGAGGCTGAGGTGGGAGGATTGCTTGGGCCCAGGAATCAAGGCTGCAGTGAGCTGTGATTGTGCCACTGTACTACAGCCTGGGTGACAGTGCAAGACTGTCTCAAAAGAAAAACAAAA"
"chr1","234749818","234750137","chr14","31798968","31799292","74","202950850","GGCTGGGTGCAGTGGGTCACACCTGTCATTCCAGTGCTTTGGGAGGCTAAGGCAGGAGAATCCCTTGAAGCCAGGAGCTGGAGATCAGCCAGGGCAACATAGCGAGACCCTGTCTCTACAAAAAAAATTTTTAAAATTATCCAGGTGTGGTGGCATGTACCTGTACTCCCAGCTGCTGTGGAACCTGAGATGGGAGGATGGCTTGACCCCAGGAGGTTGAGGCTGCAGTGAGCTATGATCCAGCCATTGCACTCCAGCCTGGGTGACAAAGCAAGACCCTGTCTCTAAAAGAAAAAGGGGGAAAAAAAAGGAAAAGAAAA","GGCTGGGCACAGTAGCTTACACCTGTAATCCCAGTACTTTGGAAGGCTGAAGTGGGAGGATCCCTTGAGGCCAGGAGTTTGAGACCAGCCTGGGCAACATAGTGAGACCCTGTCTCTACAACAAACAAACAAACAAACAAACAAAACTTAGCCAGTTGTGGTGGCACATCCTATAGTCCCAGCTACTCAGGAGGCTGAGGAGGGAGGATCTCTTGAGCCCAGGAGTTTGAGGCTGCAGTGAGCTATGATCATGACACTGCACTCCAGCCTGGATAACACAGCAAAATCCTGTCTCAAAAAAAAAAAAAAAAAAAAAAAAAAAGAA"
"chr1","35367","35499","chr5","32595015","32595178","47","32559648","GGCCAGGTGCAGTGGCTCATGTCTATAATCCCAACACTTTGGGAGGCTGAGGTGGGAGGATCGCTTGAGGCCAGGAGTTCAAGACCAGCCTGAGCAACATAGTGAGACTTTGTCTCTATAAAAAATAAATAAA","GGCCGGGTGTGGTCCCTCATGCCTGTAATCCCAACACTTTGGGAGGCTGAGATAGGAGGACTGCTTGAGGCCAGGAGTTCAAGACCAGCCTGGTCAACATAGTGAGACCCCATCTCTATAAAATAATAATAATAATAATAATAATAATAATAAATAAATAAATA"
"chr1","78286","78421","chr1","217544386","217544536","49","217466100","GGCTGGGTGTGGTGGCTCATGACTATAATTCCAGCACTTTGGGAGGCCAAGGCAGAAGGATTGCTTGAGGTCAGAGGTTCAAGTGCAGCCTGGTCAACACAGTGAAACCCTATCTCTACAAAAAACAAACAAAAAT","GGCTGGGCGTGGTGGCTCATGCCTCTAATCCCAGCACTTTAGGAGGCCAAGGCAGGAGGATAACTTAAGACCAGGCTGGGTGACACAGTGAGACTTTGTCTCTAAAAAAAAAAAAAAAAAAAAAAAAAAAAAAAACCTACAAAAACATATA"
"chr1","101404","101690","chr19","13342110","13342403","67","13240706","CACATGTGTAATCCCAGCATTTTGAGATGCCAAGGTGGCAGGATCACTTGAGACCAGGAGTTCGCAACCAGCCTGGACAACATAGGGAGACTCCATCTCCACACACGCCAAAAAAAATTTTAAATAGCCAGGTATAGTGGTACTTCCTGTAATCCCATCTACTTGGGAGGCTAAGGTGGGAGAATCACCCAACCTCAGGAGTTCAGGGCTTCAGCAAGCCATGATCATATCACTGCACTCCAGCCTCAGCAACAGAGCAAGATCCTATCTCAAAAAAAAAAAAAAAA","TCATGCCTGTAATCCCAGCACTTTGGGAAGCCAGGGCAGGAGGATCACTTGAGACCAGGAGTTTGAGACCAGCCTGGGCAACATAGCCAGACCCCCATCTCAACAACAACATCAACAACAACAACAACAAATTAGCTGGGTGTGGTGGTGCCTGTAGTCCCAGCTACTTGGGAGGCTAAGCTGGGAGGATCGCTTGAGCCCAGGAGCTCCAGGCTGCAGAGAGCTATGATCATATCACTGCACTCCAGCCTGAGTGACAGAGCAAGAACCTGCCTCTAAAAACAATAAACAAAA"
"chr1","141668","141970","chrX","46692258","46692555","81","46550590","GGCCAGATGTGGTGGCTCACATCTGTAATCCCAGCACTTTCAGAGGCTGAGGTGGGAGGATCACTTGAGACCAGGAATTTGTGGCCAGCCTGGCCAACACAACAAGACCCCATCTATACAAAAAATAAAAGAAACTAGCCAGATGTGGTGGTGCAGGCATGTAGTCTCAGCTACTAGGGAGGCTGAGGTGGGAGAACCACTGGAACCCAGACAATCAAGGCTGCAATGAGCTATGACTGCACCATTGCACACCAGCCTGGGCAACAAAATAAGACCCTCTCTCTCAGAAAAAAAGAAAATAAA","GGCCAGGCATGGTGGCTCATGCCTGTAATCCCAGCACTTTGGGAGGCTGAGGAAAGATGATCACTTGAGCCAGGAGTTTGAGCCCAGTCTGGGTAACATAGTGAGACCTCCATCTCTACAAAAAAAAAAAAAAAAAAAAAAAAAAGCTGGGCATGGTAGCACACATCTGTAGTGTCAGCTACTCAGGAGGCTGAGGTAGGAGGATTGCTTGGGCCCAGGAGATCAAGACTGCAGTGAGCTATGACTGCACCACTGCACTCCAGCCTGGGCAATGGAGTGAGACCCTGTCTCAAAAAAA"
"chr1","143306","143430","chr1","217544386","217544536","63","217401080","GGTTGAGGGTGGTGGCTTATGCCTGTAATCTCAGCACTTTGGGAGGCTGAGAGAGGTATATTACTTGAGGCCAGGAGTTTGAGATCAGACTGGGCAATATATTAAGACCCTGCCTCTACCAAAAA","GGCTGGGCGTGGTGGCTCATGCCTCTAATCCCAGCACTTTAGGAGGCCAAGGCAGGAGGATAACTTAAGACCAGGCTGGGTGACACAGTGAGACTTTGTCTCTAAAAAAAAAAAAAAAAAAAAAAAAAAAAAAAACCTACAAAAACATATA"
"chr1","144987","145294","chr6","44061836","44062146","79","43916849","GGCCAGGCATTGTGGCTCATGCCTGTAATCCCAGCAATTTGGGAAGCCTAGGCAGGAGGATCGCTTGAGGCCAGGAGTTGGAGACCAATCAGTGCTAAATAGTGAGACTCTGTGTCTACCAAAAAAAAGAGACATTAGCCAGGTGTGGTGGTGGTGCACACCCGTAGTTCCAGCTACTTGGGAGTCTGGGGTGGGAGAAATCCCTTGAGCCTGGGAAGTCTACACTACAGTGAGCCAAGATTGTGCCACTGCACTCCAGCCTGGGCGACAGAGTGAGACCCTGTCTTAGAAAGAAAAAAGAAAAGAAA","GGCCAGGCATGGTAGCTCATGCCTGTAATCTCAGCACTTTGGAGGCTGAGGCATGAGGATCAGTTGAGGCCAGGAGTTTGAGACCAGCCTGGATAACATAGTGAGACCCCATTCAACAACAACAACAACAACAACAACAAATTTAAAATTAGCTGGGCATGGTGGTGCATGCCTGTAGTCTTACGTACTTGGGAGGCTGAGGTGGGAGAATCTCTTGAGCCTAGGAGGTTGAGGCCTCAGTGAGCTGTGATTGTGCCACCACTCCAGCCTGGGTGACAGAGTGAGACCTTGTCTTTAAAAAAAATAAATAA"
"chr1","146229","146522","chr4","112106023","112106320","82","111959794","GGGCACAATGGCTCATGCCTGTAATACCAATACTTTGGGAGGCCAGGGTAGGAAAATCCCTTGAGTGCAGGAGTTCAAGGTCAGCCATGGCAACATACTGAGGTCCCATCTCTACAACAAAATAAAAACAAAATTCACTGAGTGTCACGATGCTTACCTGTAGTCCCAGCTACTGGGAAGGCTGACATGGTAGGATTGCTTGAGCCTGGGAGTTTGAGGCTATAATGAGCCATGATAGGACCACTGAACTCCATCCTGAGTGACAGGGCAAGGTCCTGTTTCTGAAGAAAAAAA","GACCAGTTGCAGTGGCTCAAGCCTGTAATCCCAGCACTTTGGGAGGCCAAGGCAGGAGTAATGATTGAAGCCAAGCATTCAAGACCAGCGTGGGAGACATGGCAAGATCTCTTCTCTAAATAAATAAATAAATAAATAAATAAGCATGGTGATGCATGCCTGTAGTTCCAGCTACTTGGAAGGCTGAAGCAGGAGGATATCCTGTGCCTAGGAGGTTGAGGCTGCAGTGAGCCATGATCTTGCCCACTGTACTCCAGCTTGGGTGACAGGGCAAGGTCGTGTCTCAGAAAAACAAAAA"
"chr1","146776","147047","chr15","26873577","26873832","74","26726801","GGCCAGGCATGGTGGCTCATACCTGTAATCCTTGCACTGTGGGGGGCCAAGGTGAGAGGATTGCTTGAGGCCAGGAGCTCAAGACCAGCCTGGACAACATAGCAAGACCTGGGTGGCACACACCTGTGGTCCCTACTACTTGGTAGGATGAGGTGGGAGGATTGATCACTTGATCCCAGGAGTTTCAGGCTGCAGTGAGCCATGATCACACCACTGCACTTCAGCCTGGGTGACAGAGCCAGACCATGTCACAAAAAGTTAGAAAAAAAAAA","GGTCAGGCACAGTGGCTCACTCCTGTAATCCCAGCACTTTGGGAGGCCAAAGCAGGAGGATTATTTGAGCCCAGGAGTTCAAGGCCAGCCTGGCCAACATAGTGAGATCTTGTCTCTAAATAAATAAATAAATAAATAAATAAATAAATGAGGTGGGAGGATTGCTTGAGTCCCAGGAGGTTGAGGCTGCAGTGAGCCAGGATCATACCACTGCACTTCCACCTGGGTGTCAGAGCAAGACCTTGTCTTAAAAAAA"
"chr1","148792","149093","chr16","18367809","18368125","82","18219017","GGCTGGGCACAGGTGGTCATGCCTGCCTGTAATCCCAGCACTTTGGGAGGCTGAGGCAGGAGGATCACTTGAGGTCAGGAGTTTTGAGCCCAGTCGGAGCAACATGGCAAGATCCCGTCTCTATGATAAAAAATTAGCTGGACATGGTGGCACATGTCTGTAGTCCCAGCTACTTGGGAGACTGAAGTGAGAGAACCACTTGAGCCCAGGAGTTTGAGGCTACAGTGAACCATGATCATGTCACTGTACTGTAGCCTAAGCAACAGAGCAAGACGCTGTCTCTGAAAAGGAAAGAAAACAAA","GGCCAGGCGCAGCAGCTCATGCCTGTAATCCCAGCACTTTGGGAGGTTGAGGCAGGAGGATCACTTGAGCCAGGAGTTTGAGACCAGCCTGGGCAATAAAGCAAGACCTTGTCTCTCAAAAATAAATAAATAAATAAATAAATAATTAGCTGGACATGGTGGCACGTACCTGTAACCCCAGCTACTTGGGAGGCTGAGGTGGGAGGATCACTAGAGCCCAGGAGTTCAAAGCCGCAGTGATCCATGATTGCACCACTGTATTCTAGCCTGGGAGACAGAGCAAGACTCCATCTCTTTAAACAAACAAACAAACAAAA"
"chr1","150478","150612","chr19","6391716","6391877","59","6241238","GGCCAGGTACAGTGGCTCACACCTATAGTTCCAACAGTTTGAGAGGCAGAGGAGATGGGAGTATGTTTTAAGGCCATGAGTTTGAGAGCAGCCTGGGCAACACAGCAAGACCTCCTCTCTACAAAAATAAAAAAA","CCAGGCGCAATGGCTCACGCCTGTAATCCCAACACTTTGAGAGGCCGAGGCAAGAGGATTGCTTGAGGCCAGGAGTCCGAGACCAGCCTGGGCAACACAGCGAGGCCTCATTCTCTACAAAAAATAAATATATAAATAAATAAATAAATAAGAAGAAGAAAA"
"chr1","152276","152566","chr5","104248312","104248604","77","104096036","GGGTATGGGGGCTCCCATCTGTAATCCCAACATTTTGGGAGGCCAAAGAGGAAGGATTGCTTGAGGCCAAGAGTTAGAGATCAGCCTGGGGAAAATAGGAAGATCCTGCCTTTACAAAATTAAAATCAGCTGGACATGGTGATGCATGCCTGTAGTTCCAGCTACTGGAGAGGCTAAGGTGGGAGGATTGCTTTAGCCTAGGAGGTCAAGGCTGCAGTGAGCTATGATCACATCACTGCACTCCAGCCTCAGTGGCAGAGTGAGACTCTGTCTCCGATATAAGAAAAGAAA","GGCACAGTGCCTCACACCTATAATCCCAGCAATTTGAGAGGCTGAGAGGGTGGATTGCTTGAGGCTAAGAGTTTGAGACCAACCTGGACAACACTGTGAAACCTTGTCTTTACCAAAAAAAAAAAAAAAAAAAAAAAAAGTGGTGTGTGTGCCTTTAGTCTCAGCTACTTGGGAGACTGAAGTGGGAGGATTGCTTAAGCCCAGGAGTTCAAGGCTACAGTGAGCTATGATCACGCCACTGCACTCCATCCTGGGTGACAGAGCAAGATTCTGTCTCTAAGAAGAGAGAGAAA"
"chr1","156828","157135","chrX","41633837","41634142","79","41477009","CCAGGCATGGTGGCTCATGCTTATAATACCAGTACTTTGGGAGGGGGTGGTGGGGGGATTGCTTGAGGCCAGGAGTTCCAGACCAGCCTAAGAAACAAAGCAAGACCTCCTCTCTAGTAAAAATAAAAAAATAAAAATAATTGGCCAGGCATAGTGGCATGTGCCTATAGTCCCAACTACTGAGGTGGAAGGATCACCTGAGCCTAGGAGGTCAAGGCTGCAGTGAGTTGAGACTGTGCCACTACACTGAAGCCTAGGAGACAGAGCGAGACTTCATCTCAAAAAAAAAAAAAAGGACAATAAAGAAA","GGCCAGGCACAATGGCTCATGCCTGTAATCCCAGCACTTTGGAGGCCAAGGCCAGAAAATCACTTGTGTTCCAGAGTTCAAGACCAGCCTGGGCAACACAGCAGGACCTCCTCTCTAAAAAAAAAAAAAAAAAAAAAAAAATTAGCCGCACGTGCTGGCACATGCCTATAGTCCCACGTAGCTGGAGTGGGAGGATCCACTTGAGCCTGGGAGGTCAGGCTGTAGTGAGCAGTGATCATGCCAATGCACTCAGCCTGGGTAACAAAGTGAGACTTTGTCTCAAAAAAAAAAAAAAAAAAATAGAAA"
"chr1","205883","206015","chr5","32595015","32595178","48","32389132","GGCCAGGTGCAGTGGCTCATGTCTATAATCCCAACACTTTGGGAGGCTAAGGTGGGAGGATCGCTTGAGGCCAGGAGTTCAAGACCAGCCTGAGCAACATAGTGAGACTTTGTCTCTATAAAAAATAAATAAA","GGCCGGGTGTGGTCCCTCATGCCTGTAATCCCAACACTTTGGGAGGCTGAGATAGGAGGACTGCTTGAGGCCAGGAGTTCAAGACCAGCCTGGTCAACATAGTGAGACCCCATCTCTATAAAATAATAATAATAATAATAATAATAATAATAAATAAATAAATA"
"chr1","277970","278255","chr19","13342110","13342403","69","13064140","CACATGTGTAATCCCAGCATTTTGAGATGCCAAGGTGGCAGGATCACTTGAGACCAGGAGTTCGCAACCAGCCTGGACAACATAGGGAGACTCCATCTCCACACATGCCAAAAAAATTTTTAAATAGCCAGGTATAGTGGTACTTCTTGTAATCCCATCTACTTGGGAGGCTAAGGTGGGAGAATCACCCAACCTCAGGAGTTCAGGGCTTCAGCAAGCCATGATCATATCACTGCACTCCAGCCTCAGCAACAGAGCAAGATCCTATCTCAAAAAAAAAAAAAAA","TCATGCCTGTAATCCCAGCACTTTGGGAAGCCAGGGCAGGAGGATCACTTGAGACCAGGAGTTTGAGACCAGCCTGGGCAACATAGCCAGACCCCCATCTCAACAACAACATCAACAACAACAACAACAAATTAGCTGGGTGTGGTGGTGCCTGTAGTCCCAGCTACTTGGGAGGCTAAGCTGGGAGGATCGCTTGAGCCCAGGAGCTCCAGGCTGCAGAGAGCTATGATCATATCACTGCACTCCAGCCTGAGTGACAGAGCAAGAACCTGCCTCTAAAAACAATAAACAAAA"
"chr1","360496","360784","chr4","74884752","74885058","81","74524256","TGGCTCATGCCTGTAATCCCAGTACCTTTGGAGGCCCAGGTGGGAGGATCACTTGAAGCCAGGACTTCAAAACCAGCCTGGGCAACAAAGCAGGACCCCATCTCTACAATGTTTTAAAAAATTATTTGGTGCAGTGGCATACACCTGTAGTCCCAACTACGCAGGAGGCTGAGGTGGGAGGATCCTTTGAGCCTAGGAGTTTGAGGCTGCTCTGAGCTGTGATTGTGCTACTGCACTCCAGCCTGGTTGACAGAGCAAGGCCCTGTCTCTTAAAAAAAAAAAAAAAAAA","CAGTGGCTGACACCTTAATCCCAGTGTTTTGGGAGGCCAAGGTGGGAGGATCACTTGAGGCCAGGAATTTGAGACCAGTCTGGGCAACACAGTGAGACCTCATCTCTTACCAAAAATAAAAATAAAAATAAAAATAAATTAGCTGGGTGTGGTGGCATGTGCCTGTGGTCCTAGCTACTCAGGAAGCTGAGGTGGGAGGATTGTTTGAGCCCAGAAGTTCGAGGTCGTGGTGAGATATGATTGCACCACTGCACCCCACTTGGGCAACAGAACAAGACCCTGTCTCTTATAAAAACAACAACAAAAA"
"chr1","411816","412098","chr19","13342110","13342403","71","12930294","TGTAATCCCAGCATTTTGAGATGCCAAGGTGGCAGGATCACTTGAGACCAGGAGTTCGCAACCAGCCTGGACAACATAGGGAGACTCCATCTCCACACACGCCAAAAAAAAATTTTAAATAGCCAGGTATAGTGGTACTTCTTGTAATCCCATCTACTTGAGAGGCTAAGGTGGGAGAATCACCCAACCTCAGGAGTTCAGGGCTTCAGCAAGCCATGATCATATCACTGCACTCCAGCCTCAGCAACAGAGCAAGATCCTATCTCAAAAAAAAAAAAAAAAA","TCATGCCTGTAATCCCAGCACTTTGGGAAGCCAGGGCAGGAGGATCACTTGAGACCAGGAGTTTGAGACCAGCCTGGGCAACATAGCCAGACCCCCATCTCAACAACAACATCAACAACAACAACAACAAATTAGCTGGGTGTGGTGGTGCCTGTAGTCCCAGCTACTTGGGAGGCTAAGCTGGGAGGATCGCTTGAGCCCAGGAGCTCCAGGCTGCAGAGAGCTATGATCATATCACTGCACTCCAGCCTGAGTGACAGAGCAAGAACCTGCCTCTAAAAACAATAAACAAAA"
"chr1","424236","424397","chr9","47045786","47045941","71","46621550","AAATAGAACATTTGCCGGCCATGGTGGCTCACACCTGTAATCCCAGTACTTTGGGAGGCCGAGGTGGGAGGATCACTTAAGCCCAGGACACAGGTTGCAGTGAGCCAAGATCACACTATCGTACTCCAGCCTGGGCCACCATGTCTCAGAAAAATAAAAAAA","GCTGGGCGCAGCAGCTCACACCTGTAATCCCAGTGCTTTGGAGGTCCAAGGTAGGAGGATTGCTTAAGACTAGGTGTTCAAGACCAGTCTTGGCAACATAGTGAGAACTCATCTCTACAATAAATAAATAAATAAATAAATAAATGAAAATAAAAA"
"chr1","495752","496027","chr1","20214247","20214541","85","19718495","GGCCAGGCATGGTGGCTCATGCCTGAAATTCCAGTAATTTCAGAAGCTAATGCAGGAGGATTGCTTAAGGCCAGGAGCTAGAGACCGGTCTGGACAACAGAGTGAGACCCTGTCTCTATCCAAAAGAAGAAAAAAGTTAGCTGGGGGTGGTGGTGCACACTTGTAGTCCCAGCTACTCGGAATGCTGAAGTTTGAGCCTGGGAGGTCAAGGCTGCAGTGAGGCATGATTATGCCACTACAGTCCAGCCTGGTGACAGAGCAAGACCCTGTCTCAAA","GACTGGGCGTGGTGGCTCACACGTGTAATGTCAACACTTTGGGAGGCCGAGGTGGAGGATTGCTTATGACCAGGAGTTTGAGACCAGCTGGGCAACATAGTGAGACCCCATCTCTACCACACACACACACACACACACACACAAATTAGCTGGGTGTGGTGGCAAGCCCCTGTAGTCCCAGCTACTCAGGAGGCTGAGGTGGGAGGATCACTTGAGCCTGGGATGTTGAGGCTGCAGTGAATCATGATTGCACCATCGCATTCTAGCCTGGGAGACAGAGCAAGACCTTGTCTCA"
"chr1","496629","496928","chr18","16899958","16900260","77","16403329","GGCCAGGTGTGGTGGCTCACACTGGTAATCGCAACACTTTGGGAGGCTGAGGCAGGAGGATGGCTTGAGGCCAAGAGTTTGCGATAGGCCTTGGAAACAAAGGGGGAGTCACCATCCCTACAGAAAAATACATGAATTAGCCTAGTGTGGTGGCATGTTCCTGTAGTCCCAGCTACTTGGGAGGCTGAGGTGGGAGGATCACTTGAGCCCAGGGAGGCTGAGACTGCAGTGAGTCATGATCAGGCCTCTGCACTCCAGCCTGGGTGACAGAGTGAGACCCTGTCTCAAAACAACAAAAAA","GTCAGGCGCGGTGGCTCACACCTGTAATCCCAGCACTTTGGGAAGCCGAGGCAGACGGATCACCTGAGGCCAGGAGTTCAAGACCAACCCCGGGCAACAAAGCAAGACCCTGTCTCTATAAAAAAAAAAAAAAAAAAAAAAAAATTAGCCGAGCATGATGGCAAGTGCCTGTAGTCCCAGCTACCTAGGATGTTGAGGTAGGAGGATTGCTTGAGCCCAAGAGGTTGAGGCTGCAGTGAGCCATGATCTCACCACTGCACTCCAGCCTGGGTGACAGAGCGAGACCCTGTCTCAAAAAATAAA"
"chr1","497906","498062","chr5","32595015","32595178","65","32097109","GTGGTGGCACATGCCTCGAGGATGGGAGGCAGGGGTGGAAGGGTCACTTGAGGCCATTAGTTTGACACCAGCCTGGCCAACAAAGTGAGACCCCGTGTCTACAAAACAATTTAAAAATTAGCCAAGTATCATCATGTATACCTACAGTCCCAGCTAC","GGCCGGGTGTGGTCCCTCATGCCTGTAATCCCAACACTTTGGGAGGCTGAGATAGGAGGACTGCTTGAGGCCAGGAGTTCAAGACCAGCCTGGTCAACATAGTGAGACCCCATCTCTATAAAATAATAATAATAATAATAATAATAATAATAAATAAATAAATA"
"chr1","500277","500579","chrX","46692258","46692555","81","46191981","GGCCAGATGTGGTGGCTCACATCTGTAATCCCAGCACTTTCAGAGGCTGAGGTGGGAGGATCACTTGAGACCAGGAATTTGTGGCCAGCCTGGCCAACACAACAAGACCCCATCTATACAAAAAATAAAAGAAACTAGCCAGATGTGGTGGTGCAGGCATGTAGTCTCAGCTACTAGGGAGGCTGAGGTGGGAGAACCACTGGAACCCAGACAATCAAGGCTGCAATGAGCTATGACTGCACCATTGCACACCAGCCTGGGCAACAAAATAAGACCCTCTCTCTCAGAAAAAAAGAAAATAAA","GGCCAGGCATGGTGGCTCATGCCTGTAATCCCAGCACTTTGGGAGGCTGAGGAAAGATGATCACTTGAGCCAGGAGTTTGAGCCCAGTCTGGGTAACATAGTGAGACCTCCATCTCTACAAAAAAAAAAAAAAAAAAAAAAAAAAGCTGGGCATGGTAGCACACATCTGTAGTGTCAGCTACTCAGGAGGCTGAGGTAGGAGGATTGCTTGGGCCCAGGAGATCAAGACTGCAGTGAGCTATGACTGCACCACTGCACTCCAGCCTGGGCAATGGAGTGAGACCCTGTCTCAAAAAAA"
"chr1","501915","502039","chr1","217544386","217544536","63","217042471","GGTTGAGGGTGGTGGCTTATGCCTGTAATCTCAGCACTTTGGGAGGCTGAGAGAGGTATATTACTTGAGGCCAGGAGTTTGAGATCAGACTGGGCAATATATTAAGACCCTGCCTCTACCAAAAA","GGCTGGGCGTGGTGGCTCATGCCTCTAATCCCAGCACTTTAGGAGGCCAAGGCAGGAGGATAACTTAAGACCAGGCTGGGTGACACAGTGAGACTTTGTCTCTAAAAAAAAAAAAAAAAAAAAAAAAAAAAAAAACCTACAAAAACATATA"
"chr1","503581","503888","chr6","44061836","44062146","78","43558255","GGCCAGGCATTGTGGCTCATGCCTGTAATCCCAGCAATTTGGGAAGCCTAGGCAGGAGGATCGCTTGAGGCCAGGAGTTGGAGACCAATCAGTGCTAAATAGTGAGACTCTGTGTCTACCAAAAAAAAGAGACATTAGCCAGGTGTGGTGGTGGTGCACACCCGTAGTTCCAGCTACTTGGGAGTCTGGGGTGGGAGAAATCCCTTGAGCCTGGGAAGTCTACACTACAGTGAGCCAAGATTGTGCCACTGCACTCCAGCCTGGGTGACAGAGTGAGACCCTGTCTTAGAAAGAAAAAAGAAAAGAAA","GGCCAGGCATGGTAGCTCATGCCTGTAATCTCAGCACTTTGGAGGCTGAGGCATGAGGATCAGTTGAGGCCAGGAGTTTGAGACCAGCCTGGATAACATAGTGAGACCCCATTCAACAACAACAACAACAACAACAACAAATTTAAAATTAGCTGGGCATGGTGGTGCATGCCTGTAGTCTTACGTACTTGGGAGGCTGAGGTGGGAGAATCTCTTGAGCCTAGGAGGTTGAGGCCTCAGTGAGCTGTGATTGTGCCACCACTCCAGCCTGGGTGACAGAGTGAGACCTTGTCTTTAAAAAAAATAAATAA"
"chr1","504823","505116","chr4","112106023","112106320","82","111601200","GGGCACAATGGCTCATGCCTGTAATACCAATACTTTGGGAGGCCAGGGTAGGAAAATCCCTTGAGTGCAGGAGTTCAAGGTCAGCCATGGCAACATACTGAGGTCCCATCTCTACAACAAAATAAAAACAAAATTCACTGAGTGTCACGATGCTTACCTGTAGTCCCAGCTACTGGGAAGGCTGACATGGTAGGATTGCTTGAGCCTGGGAGTTTGAGGCTATAATGAGCCATGATAGGACCACTGAACTCCATCCTGAGTGACAGGGCAAGGTCCTGTTTCTGAAGAAAAAAA","GACCAGTTGCAGTGGCTCAAGCCTGTAATCCCAGCACTTTGGGAGGCCAAGGCAGGAGTAATGATTGAAGCCAAGCATTCAAGACCAGCGTGGGAGACATGGCAAGATCTCTTCTCTAAATAAATAAATAAATAAATAAATAAGCATGGTGATGCATGCCTGTAGTTCCAGCTACTTGGAAGGCTGAAGCAGGAGGATATCCTGTGCCTAGGAGGTTGAGGCTGCAGTGAGCCATGATCTTGCCCACTGTACTCCAGCTTGGGTGACAGGGCAAGGTCGTGTCTCAGAAAAACAAAAA"
"chr1","505370","505644","chr15","26873577","26873832","77","26368207","GGCCAGGCATGGTGGCTCATACCTGTAATCCTTGCACTGTGGGGGGCCAAGGTGAGAGGATTGCTTGAGGCCAGGAGCTCAAGACCAGCCTGGACAACATAGCAAGACCTGGGTGGCATACACCTGTGGTCCCTACTACTTGGTAGGATGAGGTGGGAGGATTGATCACTTGATCCCAGGAGTTTCAGGCTGCAGTGAGCCATGATCACACCACTGCACTTCAGCCTGGGTGACAGAGCCAGACCATGTCACAAAAAGTTAGAAAAAAAAAAAAA","GGTCAGGCACAGTGGCTCACTCCTGTAATCCCAGCACTTTGGGAGGCCAAAGCAGGAGGATTATTTGAGCCCAGGAGTTCAAGGCCAGCCTGGCCAACATAGTGAGATCTTGTCTCTAAATAAATAAATAAATAAATAAATAAATAAATGAGGTGGGAGGATTGCTTGAGTCCCAGGAGGTTGAGGCTGCAGTGAGCCAGGATCATACCACTGCACTTCCACCTGGGTGTCAGAGCAAGACCTTGTCTTAAAAAAA"
"chr1","507389","507690","chr16","18367809","18368125","82","17860420","GGCTGGGCACAGGTGGTCATGCCTGCCTGTAATCCCAGCACTTTGGGAGGCTGAGGCAGGAGGATCACTTGAGGTCAGGAGTTTTGAGCCCAGTCGGAGCAACATGGCAAGATCCCGTCTCTATGATAAAAAATTAGCTGGACATGGTGGCACATGTCTGTAGTCCCAGCTACTTGGGAGACTGAAGTGAGAGAACCACTTGAGCCCAGGAGTTTGAGGCTACAGTGAACCATGATCATGTCACTGTACTGTAGCCTAAGCAACAGAGCAAGACGCTGTCTCTGAAAAGGAAAGAAAACAAA","GGCCAGGCGCAGCAGCTCATGCCTGTAATCCCAGCACTTTGGGAGGTTGAGGCAGGAGGATCACTTGAGCCAGGAGTTTGAGACCAGCCTGGGCAATAAAGCAAGACCTTGTCTCTCAAAAATAAATAAATAAATAAATAAATAATTAGCTGGACATGGTGGCACGTACCTGTAACCCCAGCTACTTGGGAGGCTGAGGTGGGAGGATCACTAGAGCCCAGGAGTTCAAAGCCGCAGTGATCCATGATTGCACCACTGTATTCTAGCCTGGGAGACAGAGCAAGACTCCATCTCTTTAAACAAACAAACAAACAAAA"
"chr1","509075","509206","chr19","6391716","6391877","59","5882641","GGCCAGGTACAGTGGCTCACACCTATAGTTCCAACAGTTTGAGAGGCAGAGATGGGAGTATGTTTTAAGGCCATGAGTTTGAGAGCAGCCTGGGCAACACAGCAAGACCTCCTCTCTACAAAAATAAAAAAA","CCAGGCGCAATGGCTCACGCCTGTAATCCCAACACTTTGAGAGGCCGAGGCAAGAGGATTGCTTGAGGCCAGGAGTCCGAGACCAGCCTGGGCAACACAGCGAGGCCTCATTCTCTACAAAAAATAAATATATAAATAAATAAATAAATAAGAAGAAGAAAA"
"chr1","510867","511157","chr5","104248312","104248604","77","103737445","GGGTATGGGGGCTCCCATCTGTAATCCCAACATTTTGGGAGGCCAAAGAGGAAGGATTGCTTGAGGCCAAGAGTTAGAGATCAGCCTGGGGAAAATAGGAAGATCCTGCCTTTACAAAATTAAAATCAGCTGGACATGGTGATGCATGCCTGTAGTTCCAGCTACTGGAGAGGCTAAGGTGGGAGGATTGCTTTAGCCTAGGAGGTCAAGGCTGCAGTGAGCTATGATCACATCACTGCACTCCAGCCTCAGTGGCAGAGTGAGACTCTGTCTCCGATATAAGAAAAGAAA","GGCACAGTGCCTCACACCTATAATCCCAGCAATTTGAGAGGCTGAGAGGGTGGATTGCTTGAGGCTAAGAGTTTGAGACCAACCTGGACAACACTGTGAAACCTTGTCTTTACCAAAAAAAAAAAAAAAAAAAAAAAAAGTGGTGTGTGTGCCTTTAGTCTCAGCTACTTGGGAGACTGAAGTGGGAGGATTGCTTAAGCCCAGGAGTTCAAGGCTACAGTGAGCTATGATCACGCCACTGCACTCCATCCTGGGTGACAGAGCAAGATTCTGTCTCTAAGAAGAGAGAGAAA"
"chr1","515420","515727","chrX","41633837","41634142","79","41118417","CCAGGCATGGTGGCTCATGCTTATAATACCAGTACTTTGGGAGGGGGTGGTGGGGGGATTGCTTGAGGCCAGGAGTTCCAGACCAGCCTAAGAAACAAAGCAAGACCTCCTCTCTAGTAAAAATAAAAAAATAAAAATAATTGGCCAGGCATAGTGGCATGTGCCTATAGTCCCAACTACTGAGGTGGAAGGATCACCTGAGCCTAGGAGGTCAAGGCTGCAGTGAGTTGAGACTGTGCCACTACACTGAAGCCTAGGAGACAGAGCGAGACTTCATCTCAAAAAAAAAAAAAAGGACAATAAAGAAA","GGCCAGGCACAATGGCTCATGCCTGTAATCCCAGCACTTTGGAGGCCAAGGCCAGAAAATCACTTGTGTTCCAGAGTTCAAGACCAGCCTGGGCAACACAGCAGGACCTCCTCTCTAAAAAAAAAAAAAAAAAAAAAAAAATTAGCCGCACGTGCTGGCACATGCCTATAGTCCCACGTAGCTGGAGTGGGAGGATCCACTTGAGCCTGGGAGGTCAGGCTGTAGTGAGCAGTGATCATGCCAATGCACTCAGCCTGGGTAACAAAGTGAGACTTTGTCTCAAAAAAAAAAAAAAAAAAATAGAAA"
"chr1","589269","589555","chr5","76704926","76705232","81","76115657","TGGCTCATGCCTGTAATCCCAGTACCTTTGGAGGCCCAGGTGGGAGGATCACTTGAAGCCAGGACTTCAAAACCAGCCTTGGCAACAAAGCAGGACCCCATCTCTACAATGTTTTAAAAAATTATTTGGTGCAGTGGCACACACCTGTAGTCCCAACTACGCAGGAGGCTGAGGTGGGAGGATCCTTTGAGCCTAGGAGTTTGAGGCTGCTGTGAGCTGTGATTGTGCTACTGCACTCCAACCTGGTTGACAGAGCAAGGCCCTGTCTCTTAAAAAAAAAAAAAAAA","GGTGGCTTACACTTGTAATTCCAGCAATTTGGGAGGCCATGGGAGGAGAATCACTTGAAGCCAGGAGTTCAAGACCAGCTTGGGCAAGAAAGTGAGAACCTGTCTCTACAATAAATAAATAAATAAATAAATAAATAACTGAGGGTGGTGGTGTGTGCCTATAGTCCCAGCTACTCAGGAGGCTGAGGCAGAAGAATCATTTGATTGCCCAGGAGTTCGAGGCTGCAGTGAGCTATGATCATGTGACTGCACTCTAACCTGGGTGATAGAGCAAGACCCTGTTGCTTAAAAAAAGGACTTAAAAAAA"
"chr1","647570","647853","chr19","13342110","13342403","70","12694540","TGTAATCCCAGCATTTTGAGATGCCAAGGTGGCAGGATCACTTGAGACCAGGAGTTCGCAACCAGCCTGGACAACATAGGGAGACTCCATCTCCACACACGCCAAAAAAAAATTTTAAATAGCCAGGTATAGTGGTACTTCTTGTAATCCCATCTACTTGGGAGGCTAAGGTGGGAGAATCACCCAACCTCAGGAGTTCAGGGCTTCAGCAAGCCATGATCATATCACTGCACTCCAGCCTCAGCAACAGAGCAAGATCCTATCTCAAAAAAAAAAAAAAAAAA","TCATGCCTGTAATCCCAGCACTTTGGGAAGCCAGGGCAGGAGGATCACTTGAGACCAGGAGTTTGAGACCAGCCTGGGCAACATAGCCAGACCCCCATCTCAACAACAACATCAACAACAACAACAACAAATTAGCTGGGTGTGGTGGTGCCTGTAGTCCCAGCTACTTGGGAGGCTAAGCTGGGAGGATCGCTTGAGCCCAGGAGCTCCAGGCTGCAGAGAGCTATGATCATATCACTGCACTCCAGCCTGAGTGACAGAGCAAGAACCTGCCTCTAAAAACAATAAACAAAA"
"chr1","659977","660138","chr9","47045786","47045941","71","46385809","AAATAGAACATTTGCCGGCCATGGTGGCTCACACCTGTAATCCCAGTACTTTGGGAGGCCGAGGTGGGAGGATCACTTAAGCCCAGGACACAGGTTGCAGTGAGCCAAGATCACACTATTGTACTCCAGCCTGGGCCACCATGTCTCAGAAAAATAAAAAAA","GCTGGGCGCAGCAGCTCACACCTGTAATCCCAGTGCTTTGGAGGTCCAAGGTAGGAGGATTGCTTAAGACTAGGTGTTCAAGACCAGTCTTGGCAACATAGTGAGAACTCATCTCTACAATAAATAAATAAATAAATAAATAAATGAAAATAAAAA"
"chr1","730658","730941","chr5","63802202","63802507","86","63071544","GGCCAGGCATGGTGGCTCATGCCTGAAATTCCAGCCATTACAGAAGCTAATGCAGGAGGATTGCTTAAGGCCAGGAGCTAGAGACCGGTCTGGACGACACAGTGAGACCCTGTCTCTATCCAAAAGAAGAAAAAAGTTAGCTGGGGGTGGTGGTGCACACTTGTAGTCCCAGCTACTCAGAATGCTGAAGTTTGAGCCTGGGAGGTCAAGGCTGCAGTGAGGCATGATTATGCCACTACAGTCCAGCCGGATGACAGAGCAAGACCCTGTCTCAAAGAACAAAA","GACTAGGGGTGGTGGCTCATGCCTGTAATCCCAGCACTTTGGGAGGCTGAGCTGGGAGGATTGCTTGAGCCCAGAAGTTCAAGACCAGCCTGGGCAACATAGCAAGACTCCATCTCTAAAAAAAAAAAAAAAAAAAAAAAAAAAAAATTAGCCCCGAGTGGTGGTGTGCACTTGTAGTCCCAGCTACTCAGGAGGCTGAGGTGGGAGGATCTCTTGAGCCTGGGAGGTCCAGGCTGCAGTGAACCATGATTGTGCCACTGGACTCCAGCCTAGGCAATAGAGTGAGACCTTGTCTCAAAAATAAAA"
"chr1","731535","731834","chr18","16899958","16900260","78","16168423","GGCCAGGTGTGGTGGCTCACACTGGTAATCACAACACTTTGGGAGGCTGAGGCAGGAGGATGGCTCGAGGCCAAGAGTTTGCGATAGGCCTTGGAAACAAAGGGGGAGTCACCATCCCTACAGAAAAATACATGAATTAGCCTAGTGTGGTGGCATGTTCCTGTAGTCCCAGCTACTTGGGAGGCTGAGGTGGGAGGATCACTTGAGCCCAGGGAGGCTGAGACTGCAGTGAGTCATGATCAGGCCTCTGCACTCCAGCCTGGGTGACAGAGTGAGACCCTGTCTCAAAACAACAAAAAA","GTCAGGCGCGGTGGCTCACACCTGTAATCCCAGCACTTTGGGAAGCCGAGGCAGACGGATCACCTGAGGCCAGGAGTTCAAGACCAACCCCGGGCAACAAAGCAAGACCCTGTCTCTATAAAAAAAAAAAAAAAAAAAAAAAAATTAGCCGAGCATGATGGCAAGTGCCTGTAGTCCCAGCTACCTAGGATGTTGAGGTAGGAGGATTGCTTGAGCCCAAGAGGTTGAGGCTGCAGTGAGCCATGATCTCACCACTGCACTCCAGCCTGGGTGACAGAGCGAGACCCTGTCTCAAAAAATAAA"
"chr1","732836","732969","chr8","58489091","58489211","61","57756255","TGGGAGGCAGGGGTGGAAGGGTCACTTGAGGCCATTAGTTTGACACCAGCCTGGCCAACAAAGTGAGACCCCGTGTCTACAAAACAATTTAAAAATTAGCCAAGTATCGTCATGTATACCTACAGTCCCAGCTA","TTGAGACCAGGAGTTTGAGACCAGCTTGGACAACATAGTGAGACCCTGTCTAAAAGAAAGAAAGAAAGAAAAGAAAGAAAGAAAGATGTAGCCAAGTGTGGTGGTGCACATCTGTGTCTCA"
"chr1","734066","734358","chr1","20316183","20316483","80","19582117","GGCCAGGCATGGTGGCTCAGGCCTGAAATTCCAGCAATTTGAGAAGCTAATGCAGGAGGATTGCTTAAGGCCAGGAGCTAGAGACCGGTCTGGACGACACAGTGAGACCCTGTCTCTATCCAAAAGAAGAAAAAAGTTAGCTGGGGGTGGTAGTGCACACTTGTAGTCCCAGCTACTCGGAATGCGGAAGTTTGAGCCTGGGAGGTCAAGGCTGCAGTGAGGCATGATTATGCCACTACAGTCCAGCCTGGTGACAGAGCAAGACCCTGTCTCAAAGAACAAAACAACAACAA","GCTGGGTGTGGTGGCTCACATCTGTAATCCTAGCAATTTGGAAGCTGAAGTGAGAGAATTGCTTGAGGCCAGGAGTCGGAGACAGACTGGGCAACACAGTGAGATGCTGTTTCTAAAAAAAAAAAAAAAAAAAAAAAAAAATCAGCCAGGCGTGGTGGTGCACATCTACAGTCCTAGCTTCTCAGGAAGCTGAGGCGGGAGCCCAGAAGTTCAAGGCTGCAGTGAGCTATGATCATGCCACTGCACTCCAGCCTGGGTGACAGAGCAAGACTTAGACTCTTAAGAAAACAAATAACAACAA"
"chr1","734943","735242","chr18","16899958","16900260","77","16165015","GGCCAGGTGTGGTGGCTCACACTGGTAATCGCAACACTTTGGGAGGCTGAGGCAGGAGGATGGCTTGAGGCCAAGAGTTTGCGATAGGCCTTGGAAACAAAGGGGGAGTCACCATCCCTACAGAAAAATACATGAATTAGCCTAGTGTGGTGGCATGTTCCTGTAGTCCCAGCTACTTGGGAGGCTGAGGTGGGAGGATCACTTGAGCCCAGGGAGGCTGAGACTGCAGTGAGTCATGATCAGGCCTCTGCACTCCAGCCTGGGTGACAGAGTGAGACCCTGTCTCAAAACAACAAAAAA","GTCAGGCGCGGTGGCTCACACCTGTAATCCCAGCACTTTGGGAAGCCGAGGCAGACGGATCACCTGAGGCCAGGAGTTCAAGACCAACCCCGGGCAACAAAGCAAGACCCTGTCTCTATAAAAAAAAAAAAAAAAAAAAAAAAATTAGCCGAGCATGATGGCAAGTGCCTGTAGTCCCAGCTACCTAGGATGTTGAGGTAGGAGGATTGCTTGAGCCCAAGAGGTTGAGGCTGCAGTGAGCCATGATCTCACCACTGCACTCCAGCCTGGGTGACAGAGCGAGACCCTGTCTCAAAAAATAAA"
"chr1","736220","736376","chr5","32595015","32595178","65","31858795","GTGGTGGCACATGCCTCGAGGATGGGAGGCAGGGGTGGAAGGGTCACTTGAGGCCATTAGTTTGACACCAGCCTGGCCAACAAAGTGAGACCCCGTGTCTACAAAACAATTTAAAAATTAGCCAAGTATCATCATGTATACCTACAGTCCCAGCTAC","GGCCGGGTGTGGTCCCTCATGCCTGTAATCCCAACACTTTGGGAGGCTGAGATAGGAGGACTGCTTGAGGCCAGGAGTTCAAGACCAGCCTGGTCAACATAGTGAGACCCCATCTCTATAAAATAATAATAATAATAATAATAATAATAATAAATAAATAAATA"
"chr1","737473","737756","chr5","63802202","63802507","86","63064729","GGCCAGGCATGGTGGCTCATGCCTGAAATTCCAGTAATTTCAGAAGCTAATGCAGGAGGATTGCTTAAGGCCAGGAGCTAGAGACCGGTCTGGACGACACAGTGAGACCCTGTCTCTATCCAAAAGAAGAAAAAAGTTAGCTGGGGGTGGTGGTGCACACTTGTAGTCCCAGCTACTCGGAATGCTGAAGTTTGAGCCTGGGAGGTCAAGGCTGCAGTGAGGCATGATTATGCCACTACAGTCCAGCCTGGTGACAGAGCAAGATCCTGTCTCAAAGACCAAAA","GACTAGGGGTGGTGGCTCATGCCTGTAATCCCAGCACTTTGGGAGGCTGAGCTGGGAGGATTGCTTGAGCCCAGAAGTTCAAGACCAGCCTGGGCAACATAGCAAGACTCCATCTCTAAAAAAAAAAAAAAAAAAAAAAAAAAAAAATTAGCCCCGAGTGGTGGTGTGCACTTGTAGTCCCAGCTACTCAGGAGGCTGAGGTGGGAGGATCTCTTGAGCCTGGGAGGTCCAGGCTGCAGTGAACCATGATTGTGCCACTGGACTCCAGCCTAGGCAATAGAGTGAGACCTTGTCTCAAAAATAAAA"
"chr1","738352","738651","chr18","16899958","16900260","78","16161606","GGCCAGGTGTGGTGGCTCACACTGGTAATCACAACACTTTGGGAGGCTGAGGCAGGAGGATGGCTCGAGGCCAAGAGTTTGCGATAGGCCTTGGAAACAAAGGGGGAGTCACCATCCCTACAGAAAAATACATGAATTAGCCTAGTGTGGTGGCATGTTCCTGTAGTCCCAGCTACTTGGGAGGCTGAGGTGGGAGGATCACTTGAGCCCAGGGAGGCTGAGACTGCAGTGAGTCATGATCAGGCCTCTGCACTCCAGCCTGGGTGACAGAGTGAGACCCTGTCTCAAAACAACAAAAAA","GTCAGGCGCGGTGGCTCACACCTGTAATCCCAGCACTTTGGGAAGCCGAGGCAGACGGATCACCTGAGGCCAGGAGTTCAAGACCAACCCCGGGCAACAAAGCAAGACCCTGTCTCTATAAAAAAAAAAAAAAAAAAAAAAAAATTAGCCGAGCATGATGGCAAGTGCCTGTAGTCCCAGCTACCTAGGATGTTGAGGTAGGAGGATTGCTTGAGCCCAAGAGGTTGAGGCTGCAGTGAGCCATGATCTCACCACTGCACTCCAGCCTGGGTGACAGAGCGAGACCCTGTCTCAAAAAATAAA"
"chr1","739636","739792","chr5","32595015","32595178","66","31855379","GTGGTGGCACATGCCTCGAGGATGGGAGGCAGGGGTGGAAGGGTCACTTGAGGCCATTAGTTTGACACCAGCCTGGCCAACAAAGTGAGACCCCGTGTCTACAAAACAATTTAAAAATTAGCCAAGTATCGTCATGTATACCTACAGTCCCAGCTAC","GGCCGGGTGTGGTCCCTCATGCCTGTAATCCCAACACTTTGGGAGGCTGAGATAGGAGGACTGCTTGAGGCCAGGAGTTCAAGACCAGCCTGGTCAACATAGTGAGACCCCATCTCTATAAAATAATAATAATAATAATAATAATAATAATAAATAAATAAATA"
"chr1","742007","742309","chrX","46692258","46692555","81","45950251","GGCCAGATGTGGTGGCTCACATCTGTAATCCCAGCACTTTCAGAGGCTGAGGTGGGAGGATCACTTGAGACCAGGAATTTGTGGCCAGCCTGGCCAACACAACAAGACCCCATCTATACAAAAAATAAAAGAAACTAGCCAGATGTGGTGGTGCAGGCATGTAGTCTCAGCTACTAGGGAGGCTGAGGTGGGAGAACCACTGGAACCCAGACAATCAAGGCTGCAATGAGCTATGACTGCACCATTGCACACCAGCCTGGGCAACAAAATAAGACCCTCTCTCTCAGAAAAAAAGAAAATAAA","GGCCAGGCATGGTGGCTCATGCCTGTAATCCCAGCACTTTGGGAGGCTGAGGAAAGATGATCACTTGAGCCAGGAGTTTGAGCCCAGTCTGGGTAACATAGTGAGACCTCCATCTCTACAAAAAAAAAAAAAAAAAAAAAAAAAAGCTGGGCATGGTAGCACACATCTGTAGTGTCAGCTACTCAGGAGGCTGAGGTAGGAGGATTGCTTGGGCCCAGGAGATCAAGACTGCAGTGAGCTATGACTGCACCACTGCACTCCAGCCTGGGCAATGGAGTGAGACCCTGTCTCAAAAAAA"
"chr1","743645","743769","chr1","217544386","217544536","63","216800741","GGTTGAGGGTGGTGGCTTATGCCTGTAATCTCAGCACTTTGGGAGGCTGAGAGAGGTATATTACTTGAGGCCAGGAGTTTGAGATCAGACTGGGCAATATATTAAGACCCTGCCTCTACCAAAAA","GGCTGGGCGTGGTGGCTCATGCCTCTAATCCCAGCACTTTAGGAGGCCAAGGCAGGAGGATAACTTAAGACCAGGCTGGGTGACACAGTGAGACTTTGTCTCTAAAAAAAAAAAAAAAAAAAAAAAAAAAAAAAACCTACAAAAACATATA"
"chr1","745296","745603","chr6","44061836","44062146","79","43316540","GGCCAGGCATTGTGGCTCATGCCTGTAATCCCAGCAATTTGGGAAGCCTAGGCAGGAGGATCGCTTGAGGCCAGGAGTTGGAGACCAATCAGTGCTAAATAGTGAGACTCTGTGTCTACCAAAAAAAAGAGACATTAGCCAGGTGTGGTGGTGGTGCACACCCGTAGTTCCAGCTACTTGGGAGTCTGGGGTGGGAGAAATCCCTTGAGCCTGGGAAGTCTACACTACAGTGAGCCAAGATTGTGCCACTGCACTCCAGCCTGGGCGACAGAGTGAGACCCTGTCTTAGAAAGAAAAAAGAAAAGAAA","GGCCAGGCATGGTAGCTCATGCCTGTAATCTCAGCACTTTGGAGGCTGAGGCATGAGGATCAGTTGAGGCCAGGAGTTTGAGACCAGCCTGGATAACATAGTGAGACCCCATTCAACAACAACAACAACAACAACAACAAATTTAAAATTAGCTGGGCATGGTGGTGCATGCCTGTAGTCTTACGTACTTGGGAGGCTGAGGTGGGAGAATCTCTTGAGCCTAGGAGGTTGAGGCCTCAGTGAGCTGTGATTGTGCCACCACTCCAGCCTGGGTGACAGAGTGAGACCTTGTCTTTAAAAAAAATAAATAA"
"chr1","746538","746831","chr4","112106023","112106320","82","111359485","GGGCACAATGGCTCATGCCTGTAATACCAATACTTTGGGAGGCCAGGGTAGGAAAATCCCTTGAGTGCAGGAGTTCAAGGTCAGCCATGGCAACATACTGAGGTCCCATCTCTACAACAAAATAAAAACAAAATTCACTGAGTGTCACGATGCTTACCTGTAGTCCCAGCTACTGGGAAGGCTGACATGGTAGGATTGCTTGAGCCTGGGAGTTTGAGGCTATAATGAGCCATGATAGGACCACTGAACTCCATCCTGAGTGACAGGGCAAGGTCCTGTTTCTGAAGAAAAAAA","GACCAGTTGCAGTGGCTCAAGCCTGTAATCCCAGCACTTTGGGAGGCCAAGGCAGGAGTAATGATTGAAGCCAAGCATTCAAGACCAGCGTGGGAGACATGGCAAGATCTCTTCTCTAAATAAATAAATAAATAAATAAATAAGCATGGTGATGCATGCCTGTAGTTCCAGCTACTTGGAAGGCTGAAGCAGGAGGATATCCTGTGCCTAGGAGGTTGAGGCTGCAGTGAGCCATGATCTTGCCCACTGTACTCCAGCTTGGGTGACAGGGCAAGGTCGTGTCTCAGAAAAACAAAAA"
"chr1","747086","747357","chr15","26873577","26873832","74","26126491","GGCCAGGCATGGTGGCTCATACCTGTAATCCTTGCACTGTGGGGGGCCAAGGTGAGAGGATTGCTTGAGGCCAGGAGCTCAAGACCAGCCTGGACAACATAGCAAGACCTGGGTGGCATACACCTGTGGTCCCTACTACTTGGTAGGATGAGGTGGGAGGATTGATCACTTGATCCCAGGAGTTTCAGGCTGCAGTGAGCCATGATCACACCACTGCACTTCAGCCTGGGTGACAGAGCCAGACCATGTCACAAAAAGTTAGAAAAAAAAAA","GGTCAGGCACAGTGGCTCACTCCTGTAATCCCAGCACTTTGGGAGGCCAAAGCAGGAGGATTATTTGAGCCCAGGAGTTCAAGGCCAGCCTGGCCAACATAGTGAGATCTTGTCTCTAAATAAATAAATAAATAAATAAATAAATAAATGAGGTGGGAGGATTGCTTGAGTCCCAGGAGGTTGAGGCTGCAGTGAGCCAGGATCATACCACTGCACTTCCACCTGGGTGTCAGAGCAAGACCTTGTCTTAAAAAAA"
"chr1","749101","749402","chr16","18367809","18368125","81","17618708","GGCTGGGCACAGGTGGTCATGCCTGCCTGTAATCCCAGCACTTTGGGAGGCTGAGGCAGGAGGATCACTTGAGGTCAGGAGTTTTGAGCCCAGTCGGAGCAACATGGCAAGATCTCGTCTCTATGATAAAAAATTACCTGGACATGGTGGCACATGTCTGTAGTCCCAGCTACTTGGGAGACTGAAGTGAGAGAACCACTTGAGCCCAGGAGTTTGAGGCTACAGTGAACCATGATCATGTCACTGTACTGTAGCCTAAGCAACAGAGCAAGATGCCATCTCTGAAAAGGAAAGAAAACAAA","GGCCAGGCGCAGCAGCTCATGCCTGTAATCCCAGCACTTTGGGAGGTTGAGGCAGGAGGATCACTTGAGCCAGGAGTTTGAGACCAGCCTGGGCAATAAAGCAAGACCTTGTCTCTCAAAAATAAATAAATAAATAAATAAATAATTAGCTGGACATGGTGGCACGTACCTGTAACCCCAGCTACTTGGGAGGCTGAGGTGGGAGGATCACTAGAGCCCAGGAGTTCAAAGCCGCAGTGATCCATGATTGCACCACTGTATTCTAGCCTGGGAGACAGAGCAAGACTCCATCTCTTTAAACAAACAAACAAACAAAA"
"chr1","750787","750918","chr19","6391716","6391877","59","5640929","GGCCAGGTACAGTGGCTCACACCTATAGTTCCAACAGTTTGAGAGGCAGAGATGGGAGTATGTTTTAAGGCCATGAGTTTGAGAGCAGCCTGGGCAACACAGCAAGACCTCCTCTCTACAAAAATAAAAAAA","CCAGGCGCAATGGCTCACGCCTGTAATCCCAACACTTTGAGAGGCCGAGGCAAGAGGATTGCTTGAGGCCAGGAGTCCGAGACCAGCCTGGGCAACACAGCGAGGCCTCATTCTCTACAAAAAATAAATATATAAATAAATAAATAAATAAGAAGAAGAAAA"
"chr1","752584","752875","chr5","104248312","104248604","78","103495728","GGGTATGGGGGCTCCCATCTGTAATCCCAACATTTTGGGAGGCCAAAGAGGAAGGATTGCTTGAGGCCAAGAGTTAGAGATCAGCCTGGGGAAAAAAAGGAAGATCCTGCCTTTACAAAATTAAAATCAGCTGGACATGGTGATGCATGCCTGTAGTTCCAGCTACTGGAGAGGCTAAGGTGGGAGGATTGCTTTAGCCTAGGAGGTCAAGGCTGCAGTGAGCTATGATCACATCACTGCACTCCAGCCTCAGTGGCAGAGTGAGACTCTGTCTCCGATATAAGAAAAGAAA","GGCACAGTGCCTCACACCTATAATCCCAGCAATTTGAGAGGCTGAGAGGGTGGATTGCTTGAGGCTAAGAGTTTGAGACCAACCTGGACAACACTGTGAAACCTTGTCTTTACCAAAAAAAAAAAAAAAAAAAAAAAAAGTGGTGTGTGTGCCTTTAGTCTCAGCTACTTGGGAGACTGAAGTGGGAGGATTGCTTAAGCCCAGGAGTTCAAGGCTACAGTGAGCTATGATCACGCCACTGCACTCCATCCTGGGTGACAGAGCAAGATTCTGTCTCTAAGAAGAGAGAGAAA"
"chr1","757135","757444","chrX","41633837","41634142","81","40876702","CCAGGCATGGTGGCTCATGCTTATAATACCAGTACTTTGGGAGGGGGTGGTGGGGGGATTGCTTGAGGCCAGGAGTTCCAGACCAGCCTAAGAAACAAAGCAAGACCTCCTCTCTAGTAAAAATAAAAAAATAAAAATAATTGGCCAGGCATAGTGGCATGTGCCTATAGTCCCAACTACTGAGGTGGAAGGATCACCTGAGCCTAGGAGGTCAAGGCTGCAGTGAGTTGAGACTGTGCCACTACACTGAAGCCTAGGAGACAGAGCGAGACTTCATCTCAAAAAAAAAAAAAGGACAATAAAGAAATAA","GGCCAGGCACAATGGCTCATGCCTGTAATCCCAGCACTTTGGAGGCCAAGGCCAGAAAATCACTTGTGTTCCAGAGTTCAAGACCAGCCTGGGCAACACAGCAGGACCTCCTCTCTAAAAAAAAAAAAAAAAAAAAAAAAATTAGCCGCACGTGCTGGCACATGCCTATAGTCCCACGTAGCTGGAGTGGGAGGATCCACTTGAGCCTGGGAGGTCAGGCTGTAGTGAGCAGTGATCATGCCAATGCACTCAGCCTGGGTAACAAAGTGAGACTTTGTCTCAAAAAAAAAAAAAAAAAAATAGAAA"
"chr1","860215","860497","chr1","47533839","47534134","76","46673624","GGCCAGGTACAGTGGCTCCTGCCTGGAATGCCAGCATTTTGGGAGGCCAAGGCGGGACGATTGTTTGAGCCCAGGAGTCCAAGACCAGCCTGGGCAACATAGTGAGACCTTGTTGCTACAAAAAGGTTTAAAAATTAGCTGGGCACAGTGGCGTTTGCCTGTGGTCCCAGCTACTCAGGAAGCTGAGGTGGGAGGATCGCTTGAGCCCCTGGAGGTGGAGGTTGTAGTGAGCCAAGATTGTACCACTGCACTGCAGCCTGGGTGAAGAGCAAGACCCTGTCTC","GGCTGGGCACGGTAGCTCACACCTGCAATCCCACCACTTTGGGAGGCTGAGGTGGGTGGATTGCTTGAGCCCAGGAGTTCTAGACCAGCCTGGGTGATACAGGCAGACCCTATCTCTACCAAAAAAAAAAAAAAAAAAAAAAAAAAAGGCTGGGCATGGTGGCATGTGCCTGTGGGCTCAGCTACTTAGGAGGCTGAGGTGGGAGGATCAGTTGAGCCCAGGAGGAGTTGAGGCTGCAGTGAGCCTAGATCCTGCCACTGCACTCCAATCTGGGCAACAGAGCGAGACCCTGTCTC"
"chr1","892184","892456","chr7","116200737","116201028","77","115308553","GGCTGGGCATGGTGGCTCACACCTGTAATCCCAACACTTTAGGAGGCCAAGGCAGGAGTATCATGAGACCAGCCTGAGCAAAATAGTGAGATGCTAACTCTACAAAAAAAATAAAAATTAGCTGAGCATGGTGGTGCATGCCTGTAATTACAGCTACTTGGGAGGCTGAGGTGGGAGGATCCCTTGAGGGCAGGAGGTCAAGGTTGCAGTGAGCTGTGATCATACCACTGTACTTCAGCCTGGGTGACAGACAGAGACACTATCTCAAAAAAA","GGCAGGGCATGGTGACTCAGGCCCGTGATCCCAGCACTTTGGGAGGCTGAGGTGAGAGGATCAGGAGTTTGAGATCAGCCTGAGCAACACAGTGAGACCCCATCTGTACAAAAACAAAACAAAACAAAACAAAACACCTGTCATGGTGGCAAACATCTTTAGTCTCAGCTACTTGGGAGGCTAAGTTGGGAGGATCACTTGAGCTCAAGAGTTTGAGACTTCAGTGAGCTATGATCACACCACTGTACTCCAGCCTGGTCGACAGAGTGAGACCCTGTCTCAAAAAAACAAA"
"chr1","1092807","1093048","chr10","96412023","96412287","94","95319216","AGGACTCTGGAAGGTGGGGGTGGTCGGAATGCTTGAGCTCAGGAGTTGGAGACCCACCTGGGCAACACAGCCCGTCTTTACAAAAAGTTTAAAATTAGTCGAGCCTGGTGGTGGGAGCCTGAGGTCCCAGCTACTCAGGAGGCTGAGGTGGGATGATCACCTGAGCCCAGAAGGTGGAGGCTGCAGTGAACGGAGACTGCACTCCAGCCTGTGCAAGGGGAACTCCGTCTCAAAAAAAAAAA","CTTTGAGAGGAAGACGTAGGAGGATTGCTTGAGCCCAGCAGTTTGAGACTAGCCTGGGCAACATAGGAAGACTCCCATCTCTACACACACACACACACACACACACACACAATTATCCAGGGTGGTGGTGCATGCCTGTGGTCCCAGCTACTTGGGAGGTTGAGGTGGGAGGATTGCTTGAGCCCAGGAGGTCCAGGCTGTAGTGAGCCATGATCATACCGCTGCACTCCAGCCTGGGCAACAGAGTGAGACCCTGTCTCAAAAA"
"chr1","1096201","1096464","chr1","164929853","164930117","71","163833652","CGGGTGCTGTGGCTCCCACGTGTAATCCCAGCACTTTGGGAGGCTGAGGCAGGAGGATCACCTGAGGCCAGGAGTTCGAGACCAGCCTGGACAATATAGTGAGACCCTGTGTACAAAAAAAATTATACCTGTAGCCCCAGCTACTTGGGAGGCTGAGGTGGGAGGATCCCTTGATCCCAGGAGCTCAAGGCGGCAGTGAGCCATGATCGCACCACTACACTCCAGCCTGGCAACAGAGTGAGACCCTGTCTCTCTTTAAAAAAA","GGCCAGGTGTAGTGGCTCACACCTGTAATCCCAGCACTTTGGGAGGCTGTGGCGTCAGGATCACTTAGAGTCAGGAGTTTGAGACCAGTCTGCACAACATAGCCAGACCCATCTCTACAAAAAAAAAAAAAAAAAAAAAAAAAATCCTAGCTACTTGGGAGGCCGAGATGAGAGGATCACTTGAGTCCAGGAGTTCAAGGCTGCAGTGAGCTATGATCCTGCCACTGCACTCCGGCCTAGGTGACAGAGTGAGACCAAAAAAAAA"
"chr1","1103723","1103975","chr12","95325313","95325577","103","94221590","GGCAGGGCAGCTCACTCCTGTAATCCCAGGATTTTGGGAGGCTGAGACGGAGAATTGCTTGAGGCCAGGCATTTGAGACCAGCCTGGACAACACAGTCTCTACAAAAGAAAAGGACGTTACCTGGGTGTAATGGTGTGCACCTGAGGTCCCAACTATTCAGGAGGCCGGGGTGAGAGGATCGCTGCCACTGCATTTCTGCCTGGGCGACAGAGGGAGAATGTGTCTCCAGAAAACAAACAAGCAAAAAAGAAA","GCTGGGTGTGGCGGCTCATGCCTGTAATCCCAGCACTTTGGGAGACTGAGGCAGGAGGATCACTTGAGGCCAGGAGTTAAAGACCTGCCTGGACAACATACTGAGACCCTGTCTCTCATATTTAAAAAAAAAAAAAAAAAAAAAAAAAATTAGCCAAGCTCCTGCTTGAGCCCAGGAGTTGGGGCTGCAGTGAGCCATGATCATTCCCCTGCACTCCAGCATGGGCAATAGAGTAAGACTCTGTCTCTAAGAAAGAAAAAAAAAA"
"chr1","1105238","1105529","chr1","196006286","196006594","87","194901048","GGCCAGGAGCAGTGGCTCACACCTGTAATCCCAGCACTTTGGAAGGCTGAGGCTGGAGGATCGCTTGAGGGCAGGAGTTTTAAGACCGGCCTGGGCAATACACCGAAACCCCTTACAGAAATCAGCCAGGCGTGATGGCACATGCCTGTGATCCCAGCTACTTGGGAGGGAGGTGGGAGGATCGCTTGAGTCCAGGAGGTTGAGGCTGCAGTGAGCCGAGATCGCGCCACCACACCCTAGCCTGGATGACAGAGTAAGACCCCATCTCAAAAAAAAATAAATAAAAAGTAAA","GGCCAGGCGCAGTGGCTCACACCTGTAATCCCAGCACTTTGGCAGGCTAAGGCGGGGGAGTCGCTTTAGCACAGGAGTTTGAGACCAGCCTGGGTAACAAAGCAAGACCCTATCTCTACAAAAAAAAAAAAAAAAAAAAAAAAAAAATTAGACAGGTGTGGTGGCACACGCCTGTGGTCCCAGCTACTTGGGGGCCGAGGTGAGAGGATAGCTTGAGCCGAGGAGGTCAAGGCTGCAGTGAGCTATGATCACACCACTGCACTCCAGCCTGGAGCAAGCAAGAATTTCATTCTAAAAAAAAAAAAAAAA"
"chr1","1193880","1194167","chr7_NW_019937272v1_random","2134063","2134360","80","940183","GAGTGTGGTGGCTTATGCCTGTAATCCCAGTGCTTTGGGAGGCTGAGGCAAGAAGATCATATGAGGCCAGGCATTTGAAAGCAGCCTGGGCAACATAGTGAGACCCCATCTCTAAAAAACAAAATTAGCTCAGCATGGGAGTGTGCACCTGTAGTCCTCCTAGCTATTTAGGGGGCTGAGATGGGAGGATCACTTGAGCCCAGGAGGTCAAGGCTGCAGTGAGCCACAATCAAACCACATTACCCCAGCCTAGGTGACAGAACAAGACCCTGTTTCTAAAATAAAAAA","GCTGGGCTGGTCTTGCACCTATAATCTCAGCACTTTGGGAGGCCGAGGCAGGAGGATCACTTGAGCCTGGAAGTTCAAGACCGGCCTGGGCAACATAGCAAGACCTTATTTCTAAAAAAAAAAAAAAAAAAAAAAAAATTAGCCAGGCATGGTGGCATGCACCTGTAGTCCCAGCTACTCAGCAGGCTGAGGTGGGAGGATCACTTGAGCCAGGGAGGTCAAGGCTGCAGTGAGCCATGATCATGCCGCTGCACTCCAAACTGGGGGACAGAATGAGACCCTATATCAAAAAAAAAAA"
"chr1","1229191","1229511","chr9","57029965","57030284","86","55800774","GACCGGGCACAGTGGCTCACGCCTGTAATCCCAGCACGTTGGGAGACTGAGGCAAGAGGATCGCTTGAAGCCAGGAGTTTGAGACCAGCCTGAGCAATACAGCGAGACCCGTCTCTACAAAGAGTAAAATAAAAATAAATTACTGGGCGTGGGGGTGCACGCCTGTGGTCGCAGCTGCTCCGGTGGCTGAGGCGAGAGCATCACCTGAGCCCAGAGCATCACCTGAGCCCAGGAGTTCGTGGTCACGGTGAGCTGTGGTCACCGCTGTACTCCAGCCTGGGTGACAGAGCAAGACCCTGTTTCTAAAAATAAAGAAAAAAA","GGCTGGGCATGGTGGTTCATGCGTGTAGTCCCAGCACTTTTTCAGGCCAACGTAGGAGGATCACTTGAGGCCTGGAGTTTGAGACCAGCCTGGGCAACAAAGGGAGACCTTGTCTTTACAAATAAATAAATAAATAAATAAATAAAAATTTAGCTGGGCATGGTGGTGCACACCTGTGGTCTCAGCTACTCAGGAGGCTGATGTGGGAGGATCACTTGAGCCCCAGAAGTTTGAGGCTTGCGGTGAGCTATGATCATACCACAGCACTCCAGCCTGGGTGACAGAGCAAAACCCTGTCTCTAAAATTAAAAAAAAAAAAA"
"chr1","1230995","1231070","chr20","87144","87254","63","1143851","GGTTTACTTGAGGCAGGAGGATCGTGAGACCAGCCTGGGCAACACAGTGAGACTGCGTCTCTTTAAAAAACAAAAA","CCTGGGCAACATAGTGAGACTACATCTCTACACTCACGCACACACACACACACACACACACACCCCCCAAATTAGCCAGGCATGCTGATGTGCACCCATAGTCTCAGCAAC"
"chr1","1268696","1268965","chrX","3592780","3593062","84","2324084","GTGGCTCCTGCCTGTGATTCCAGCACTTCCGGAGGCTGAGGCCTGAGAATCAGTTGAGGCCAGGAGTTTGAGACCACCTTGGGCAACATAGTGAGATCCCAGCTCTACAAAAAAAAAAAAATTAGCTAGGCGTGGTGGCATGCGTCTGTAGTCTCAGCTACTCAGGAGGCTGAGGTGGGAGGATTGCTTGAGCCGAGGTGGTCAAGGCCACAGTGACTCCAGCCTGGGCGACAGAGCAAGACCCTGTCTCACGAAAAATAAGTAAATAAA","GTGGTGGCTCATGTCTGTAATCCCAGCACTTCAGGGGGCCAAAGCGAGAGGACTGCTTGAGGCCAGGAGTTTGAGACCAGCCTGCGCAACATAGAAAGACCCCATCTCTATAAATAAATAAATAAATAAATAAATAAGTCAGGCATGGTGGCACATGCCTGTAGTCCCAGCTACTCAGAAGGCTGAGGTCGGAGGATCTCTTGAGCCCAGGGGTTCAAGGCTGCAGTGAACCATGATCACACCAGTGCACTGCAGCCTGGGCAACACAGCAAAACCCTGTCCC"
"chr1","1301257","1301558","chr2A","65797088","65797395","64","64495831","GGCTGGGCATGGTGGCTCACACCTGTAATCCCAGCGTTTGGGAGGCCAAGGCCAGAGAATGCCAGGAGTTTGAGACCAGCCTGGGCAACGTAATGAGACCTCCATCTCTACAAAAAAAAAAAAAAAAAAAAATTAGATGGGCATGGTGGCACGTGCCTATGGTCCCAGCTATTCAGGAGGATGAGGTGGGAGGATCAGTTGAGCCCAGGAGGCGGAGGCAGCAGTGAGCCATGATTGTGCTACTGCACTCCAGCCTGGGTGACAGAGAGAGACTCCATCAAAAAAAAAAAAAAAAAAAAAGA","GGCCAGGCTCGGTGGCTCTTGCCTATAATCCTAGCACTTTGGGAGGCCAAGGATTGCTTGAGCCCTGGAGTTTGAGACCAGCCTGGGCAACATAATGAGACCCTGTGTCTACAAAAAAAAAAAAAAAAAAAAAAAAAAATTGGGTGTGGTGACATGTGCCTGTGGTACCAGCTACTAGGGAGGCTGAGGTGGGAGGATCACTTGAACTCAGGAGGTCGAGGCTGCAGTAAGCCACGATTGCACCACTGCACTCCGGCATGGGTGACAGAGCGAAACCCTGTCTAAAAACAAAAACAAAAACAAAAGAA"
"chr1","1316950","1317093","chr8","58489091","58489211","75","57172141","AAATTAGCCTGGCGTGGTGGGTGCGTGCCTATAGTCCCAGCTATTTGGGAGGCGGAGGTGGAGGCGGGAGGACGCTTGAGCCCAGGAGTTTGAGTGAGCCATGATTGCGCCACTGCAGCCTGGGTGACAGCCCCACCCTGTCTC","TTGAGACCAGGAGTTTGAGACCAGCTTGGACAACATAGTGAGACCCTGTCTAAAAGAAAGAAAGAAAGAAAAGAAAGAAAGAAAGATGTAGCCAAGTGTGGTGGTGCACATCTGTGTCTCA"
"chr1","1368467","1368747","chr20","52489594","52489869","78","51121127","GGCTGGGTGTGGTATCTCACACCTATAATCCCAACACTTTGGGAGGCCAAGGCAGGAGGATCATTTGAGGCCAGGAGTTTGAGACCAGGCTGGGCAACTTAGTGAGACTCCATCTCTGCTGGAAAAAAACATTAGCTGGGCCTGGTGGTGTATGCCTGTAGCCCCAGCTACTTGGGAGGCTGGCTTGAGCCCAGGAGTTACAGGCTGCAGTGAGCTATAATGGCACCACTGCACTGCAGCCTGGGCGACAGAGGGAGACCCTGCCTCTTAAAAAATAAAAA","GGCTGTGTGCAGTAGCTCATGCCTGTAATTCCAACACTTTGGGAGGCCAAGGCAGGAGGATCACTTGTGAGGAGTTTGAGACCAGCCTGTACAACATAATGAGACCTCGTCTCTACAAAAAATAAATAAATAAATAAATAAATAAATAAATAAAAAATAAAAAAATTAGGTGGAAGGATTGCTTGAGCCCAGGAGGTTAAGGCTGCAGTGAATTGTGATAGCACCACTGCACACTAGCCTGGGTGACAGAGCAAGACCCTGCCTCAAAAAAAAAAA"
"chr1","1369475","1369758","chr8","15910614","15910909","82","14541139","CAGGCGCAGTGGCTCACGCCTGTCATCCCAGCACTTTGGGAGCTGGGAGCATCGCATGAAGCCAGGACTCCAAGAGCAGCCTGGGCAACATAGTGAAACCCTGTCTTTACAAAATAAAAAATCAGCTGGGCATGGTGGTGTGTACCTGTAGTCCCAGCTACTCCAGAGGCCGAGGTGACAGGATGCATGAACCCAGGAGTTCGAGGCTGCGGTGAGCTGCCGTTGTGCTAGTGCCCTCCAGCCTGGGTGACAGAGCGAGACCCTGTCTCCAAAAAGAAAAAAGA","GGCCAGGCGAAGTGGCTCACACCTGTAATCCCAGCACTTTGGGAGGCCAAGGCAGGAGGATCATTTGAAGCCAGGAGTTCAAGGCCAGCCAGAGAAACATAGTGAGAACCTGTCTTTACAAAAATTAAAATTAAAATTAAAATTAGCCAGGAGTGGTGGTGCATGCCTGCAGTCCCAGCAGCTCAGGAGGCTGAGGTGGGATGATTGCTTGCACCAGGAGTTCGAGGCTGCAGTGAGCTGTGATCGTGCCACTGCACTCCAGCCCCTGGGTGACAAAGCAAGATCCTCTAAAAAAA"
"chr1","1379482","1379610","chr9","47045786","47045941","54","45666304","GCCGGGCGTGGTGACTCACACCTGTAGTCCCAGCTACTCAGGAGACTGAGGTGGGAGGATCACTTGAGCCCAGGAGTTGAAGACCAGCCTGCAACATAGTGAGGCCCCATCTCTACAAAAAATTAAGAA","GCTGGGCGCAGCAGCTCACACCTGTAATCCCAGTGCTTTGGAGGTCCAAGGTAGGAGGATTGCTTAAGACTAGGTGTTCAAGACCAGTCTTGGCAACATAGTGAGAACTCATCTCTACAATAAATAAATAAATAAATAAATAAATGAAAATAAAAA"
"chr1","1379929","1380041","chr8","58489091","58489211","64","57109162","TTAGCCAGGCATGGAGGCGTGAGCTTGTGGTCTCGGCTACTTGGGAGGCTGAGGTGAGAGGATCGCTTGAGCACATGAGATCACACCACTGCACTCCAGCCTGGGTGACAGAG","TTGAGACCAGGAGTTTGAGACCAGCTTGGACAACATAGTGAGACCCTGTCTAAAAGAAAGAAAGAAAGAAAAGAAAGAAAGAAAGATGTAGCCAAGTGTGGTGGTGCACATCTGTGTCTCA"
"chr1","1389551","1389678","chr15","37343640","37343763","61","35954089","GCCTATGCTCCTAGCACTCTGGGACGCTGAGGCAGGACAATCACTTGAGGCCAGGAAATTCAAGAGCAGCCCGGCCAACATAGCAAGACCCAGACTCAACTAAAAAGATAAAGAATTAGCTAAGCACA","AAGATCCCTGGCCAGGATTTCAAGACCAGCCTGGGCAACACAGTGAGACCATACATACATACATACATACATACATACATCATACATACATACATACATACATACATACACAGTCTTACAAAGA"
"chr1","1389969","1390133","chr18","55799233","55799394","69","54409264","TTAGCCAAGCATGGTGGCATGTGCCTGTAGTCCTAGCTATGCAGAAAGCTGAGGTGGGAGGATCACTTGAATCCAGGAGTTGGAAGCTGCAGTGAGCTGCGATCACACCACCATACTCCAGCCTGGGTGACAGAGACCCTGTCTCAAAAAAAAAAAAAAAAAAAA","GGCTGAGAGAGGTGGCTCATGCTTGTAATCCCAGCACATTGGGAGGCAAAGGTGGGAAGATTGCTTGAGGCCAGGAGTTCAAGACCAGCCTGGGCAACATGAAAACACTTTGTCTCTACAATAAATAAATAAATAAATAAATAAATAAAAGAAACAAGAAAA"
"chr1","1463626","1463926","chr6","44061836","44062146","80","42598210","GGCCGGGCATGGTGGTGGCTGATGCTTGTATTCCCAGCATTTGGGGAGGTCAAGTCAGCCAGATTATTTGAAACCAGGAGTTCAGGACCAGCCTGGAAAGCAAGTCAAGAACCCATCTCTACAAAAAATAAAAAAAATTAGCTAGACCTAGTGGTGCATACCTGTGATGCCAGCTGCTTGGGAGGCTGAGGTGGGAGGATCACTTGAGTCCAGGAGGCGGAGGCTGCAGTGAGCTGTGATTGTGCCACTGCACTCCAGCCTGGGTTACAGAGTGAGACCCTGTCTTAAAAAATAAGAATAA","GGCCAGGCATGGTAGCTCATGCCTGTAATCTCAGCACTTTGGAGGCTGAGGCATGAGGATCAGTTGAGGCCAGGAGTTTGAGACCAGCCTGGATAACATAGTGAGACCCCATTCAACAACAACAACAACAACAACAACAAATTTAAAATTAGCTGGGCATGGTGGTGCATGCCTGTAGTCTTACGTACTTGGGAGGCTGAGGTGGGAGAATCTCTTGAGCCTAGGAGGTTGAGGCCTCAGTGAGCTGTGATTGTGCCACCACTCCAGCCTGGGTGACAGAGTGAGACCTTGTCTTTAAAAAAAATAAATAA"
"chr1","1530253","1530546","chr8","25360790","25361095","81","23830537","GGCCGGGTATGGTGGTGGCTGACGCTTGTATTCCCAGCATTTGGGGAGGCCAAGTTAGATTATTTGAAGCCAGGGGTTTAGGACCAGCCTGGAAAGCAAGGCAAGACCCCATCTCTACAAAAAATGAAAAAATTAGCTGGACCTGGTGGCACATGCCTGTAATGCCAGCTGCTTGGGAGGCTGAGGTGGGAGGATCACTTGAGTCCAGGAGGTGGAGGCTGCAGTGAGCTGTGATTGCCACTGCACTCCAGCCTGGATTACAGAGCAAGACCCTGTCTTAAAAACTAAGAATAA","GGCTGGGAGCAGTGGCTCATACCTGTAAGCCCAGCACTTTGGGAGGCTGAGGTGGGAGGATTGCTGAAGCCCAGGAGTTTGAGACCAACCTGGGCAATGTAGGGAGACCCCGTCTCTACTAAATAAATAAATAAATAAATAAATAAAGTCGGGCATGGTGGCATGTGCCCTGTAGTCCCAGCTTCTTGGGAGGCTGAGGTGGGAGGATTGCTTGGGCCCAGGAATCAAGGCTGCAGTGAGCTGTGATTGTGCCACTGTACTACAGCCTGGGTGACAGTGCAAGACTGTCTCAAAAGAAAAACAAAA"
"chr1","1555716","1556003","chr8","15910614","15910909","80","14354898","GGCCGGGCACAGTGGCTGACACCTGTAATCCCAGCACTCTGGGAGGCCAAGGCAGGCAGACTGCTTGAGTTCAGGAATCCAAGACCAGCCTGGGCAACAGGGCGAAACCTCATTTCTACTAAAAATAAAAAAATCAGGCCAGGTGGGGTGGCTCATGGCTGGAGTCCCAGCTACTCAGGAGGCTGAGGTGGGAGGATTGAGCCCAGGGACATAAGGCTACAGGGAGCTATGATGTTACCACTGAACTCCAGCATCAAAGTCAGAGCGAGACCGTCTCGAAAAAATAAA","GGCCAGGCGAAGTGGCTCACACCTGTAATCCCAGCACTTTGGGAGGCCAAGGCAGGAGGATCATTTGAAGCCAGGAGTTCAAGGCCAGCCAGAGAAACATAGTGAGAACCTGTCTTTACAAAAATTAAAATTAAAATTAAAATTAGCCAGGAGTGGTGGTGCATGCCTGCAGTCCCAGCAGCTCAGGAGGCTGAGGTGGGATGATTGCTTGCACCAGGAGTTCGAGGCTGCAGTGAGCTGTGATCGTGCCACTGCACTCCAGCCCCTGGGTGACAAAGCAAGATCCTCTAAAAAAA"
"chr1","1560706","1560836","chr1","217544386","217544536","58","215983680","GCTGAGAATAGTGGCTCACGCCTCTAATCCAAGTACTCTGGAAGGCCAACATGTGAGGATCACTTGAGGCCAGGAGTTCGAGACAAACCTGGATAACACAGCAAGACCCATATCTAAAAAAATAATAATAA","GGCTGGGCGTGGTGGCTCATGCCTCTAATCCCAGCACTTTAGGAGGCCAAGGCAGGAGGATAACTTAAGACCAGGCTGGGTGACACAGTGAGACTTTGTCTCTAAAAAAAAAAAAAAAAAAAAAAAAAAAAAAAACCTACAAAAACATATA"
"chr1","1568643","1568886","chr12","95325313","95325577","84","93756670","GGCGGGGCATGGTGGCTCACGCCTGTAATCCCAACACTTTGGGAGGCGGAGGAGGACGGATCACTTGAGGTCGGGAGTTTGAGACTAGCCTGACCAACATGGAGAAACCCCGTCTCTACTAAAAATACAAAACTAGCCAGGCGTGGTGGCTCATGCCTGTAATCCCAGCTACTTGGGAGGCCAGGAGTTCAATACCAGCCTGGGCAACACAGTAAGACCCTGTCTGTAAAAATAAATAAATAAA","GCTGGGTGTGGCGGCTCATGCCTGTAATCCCAGCACTTTGGGAGACTGAGGCAGGAGGATCACTTGAGGCCAGGAGTTAAAGACCTGCCTGGACAACATACTGAGACCCTGTCTCTCATATTTAAAAAAAAAAAAAAAAAAAAAAAAAATTAGCCAAGCTCCTGCTTGAGCCCAGGAGTTGGGGCTGCAGTGAGCCATGATCATTCCCCTGCACTCCAGCATGGGCAATAGAGTAAGACTCTGTCTCTAAGAAAGAAAAAAAAAA"
"chr1","1579201","1579266","chr20","87144","87254","61","1492057","GGTCTGGCACATTGGCTCATGCTTGTAATCCCAACACTTTGGGAGGCCAATGTGAGAGAATCTCTG","CCTGGGCAACATAGTGAGACTACATCTCTACACTCACGCACACACACACACACACACACACACCCCCCAAATTAGCCAGGCATGCTGATGTGCACCCATAGTCTCAGCAAC"
"chr1","1579553","1579625","chr20","87144","87254","63","1492409","GAGAGAATCTCTTGAGACCAGGAATTTGAGAGCAAACTGGTCAATATAGCTAGATCCCTCTCTATTTAAAAAA","CCTGGGCAACATAGTGAGACTACATCTCTACACTCACGCACACACACACACACACACACACACCCCCCAAATTAGCCAGGCATGCTGATGTGCACCCATAGTCTCAGCAAC"
"chr1","1658198","1658328","chr20","87144","87254","65","1571054","AGCCAGGCAAGGTGGCGAGCGCCTGTAGTCCCATATACTCTGCAAGCTGAGATGGGAGACCGATTGAGCCCAGGAGTTCCAGGCTGAAGTGCGCTTGTGAACAGCCACTGCGCTGCAGCATGGGCGACAAA","CCTGGGCAACATAGTGAGACTACATCTCTACACTCACGCACACACACACACACACACACACACCCCCCAAATTAGCCAGGCATGCTGATGTGCACCCATAGTCTCAGCAAC"
"chr1","1695906","1696160","chr14","82014462","82014729","107","80318556","GGACATGGTGGCTCACACCTGTAATCCCAACACTTTGGGAGGACGAGGTGGGAGGTCCTTCTGGGGAGAGGAAGAGAGGAAAGCACACAGGCTTCCAGACACTATTCCAAAATCATTAATACGCACACCCCAGGCCCAGCACGGTGACAGCCACCTGCAGACCCAGCTACTCGGGAGGCTGAGGCCAGAGAGCCCTGAGTTTGAGCCCAGCCTGGGCAAAGTAGCGAGATCCCCCATCTCAAAAATAAAATAAAA","GGCCATGTGCAGTGGCTCATACCTGTCATCCCAACAATTTGAGAGACCGAGGCAGGAGGATCGTTTGAGGCCAGCCTGGGCAACATAGTGAGACCCCATCTCTACAAAAAATAAAATAAAATAAAATAAAATAAAAAAATTAGCCAGGCATGGTGGCACACACCTGTAGTTCCAGCTACTTGGGAGGTGTGGCAGGAGGATTGCTTGAGGCTGCAGTGAGCTATCATCATGCTACTGCACTCCAGCCTGGGCAACACAGTGAGAACCT"
"chr1","1723542","1723672","chr20","87144","87254","65","1636398","AGCCAGGCAAGGTGGCGAGCGCCTGTAGTCCCATATACTCTGCAAGCTGAGATGGGAGACCGATTGAGCCCAGGAGTTCCAGGCTGAAGTGCGCTTGTGAACAGCCACTGCGCTGCAGCATGGGCGACAAA","CCTGGGCAACATAGTGAGACTACATCTCTACACTCACGCACACACACACACACACACACACACCCCCCAAATTAGCCAGGCATGCTGATGTGCACCCATAGTCTCAGCAAC"
"chr1","1748137","1748391","chr14","82014462","82014729","107","80266325","GGACATGGTGGCTCACACCTGTAATCCCAACACTTTGGGAGGACGAGGTGGGAGGTCCTTCTGGGGAGAGGAAGAGAGGAAGGCACACAGGCTTCCAGACACTATTCCAAAATCATTAATACGCACACCCCAGGCCCAGCACGGTGACAGCCACCTGCAGACCCAGCTACTCGGGAGGCTGAGGCCAGAGAGCCCTGAGTTTGAGCCCAGCCTGGGCAAAGTAGCGAGATCCCCCATCTCAAAAATAAAATAAAA","GGCCATGTGCAGTGGCTCATACCTGTCATCCCAACAATTTGAGAGACCGAGGCAGGAGGATCGTTTGAGGCCAGCCTGGGCAACATAGTGAGACCCCATCTCTACAAAAAATAAAATAAAATAAAATAAAATAAAAAAATTAGCCAGGCATGGTGGCACACACCTGTAGTTCCAGCTACTTGGGAGGTGTGGCAGGAGGATTGCTTGAGGCTGCAGTGAGCTATCATCATGCTACTGCACTCCAGCCTGGGCAACACAGTGAGAACCT"
"chr1","1766713","1766909","chr1","9000895","9001091","55","7234182","GGCCAGGCATGGTGGCTCATGCCTATAATCCTAGCACTGTGTTGGGAGGCTGAGTTGGGAGGATCACTTGAGGCCAGGAATTGAAGACCAGCCTGGGCAACAGAGCAAGACACCCTGTCTCTACCAAAGGAAAAAAAATTAGCTGGACGTGGTGCTGTACTCCTGTAGTCCCAGCTACTTGGAAGGCTGAGGTGGGA","GGCCAGACGTGGTGGCTCACTCCTGTAATCCTAGCACTTTATGAGCCTGAGGCAGGAGAATCACTTGAGGCTAGGAGTTTGAAACCAGCTGAGGCAACATAGTCAGACTCTGTCTCTACTAAAAAAAAAAAAAAAAAAAAAAAAAGCCAGGCACAGTGGTGCACACCTATAGTCCCAGCTACTTGGAAGGCTGAGGC"
"chr1","1773469","1773604","chr19","6391716","6391877","54","4618247","GGTCAGACACAGTGGCTCACACTTGTAATCCCAGCACTTTGGGAGGCCGAAGCAGGGGAATCACCTGAAGCCAGGAATTGGAGACCAGCCTGGGCAACACAGCAAGACCCCGTCTCTACAAAAACATTAATAAAAA","CCAGGCGCAATGGCTCACGCCTGTAATCCCAACACTTTGAGAGGCCGAGGCAAGAGGATTGCTTGAGGCCAGGAGTCCGAGACCAGCCTGGGCAACACAGCGAGGCCTCATTCTCTACAAAAAATAAATATATAAATAAATAAATAAATAAGAAGAAGAAAA"
"chr1","1773766","1774034","chr6","123112293","123112576","87","121338527","GGCTGGGTGCAGTGGCTCATGCCTGTAATCCCAATGCTTTGGGAGGTCAACACAGGAGGGCCACCAGAGCCCAGGAGTTCAAGGTCAGCCCGTTCAAGGTAGCGAGACCCTGTCTCTACAAAAAATTTAAAAATTAGCTGGACATAGTGGCTCATGCCTGTAGTCTCAGCTACATGGGAGGATCCCTTAAGCCTGGGAGATTGAGGCTGCAGTAAGCTGTAATTGCACCACTGCACTCCAGCTTAGGTGACAGAGCAAGACCCTACCTC","GGCCAGGCACCATGGCTCACCCCTATAATCCCAACACTTTAGGAGGCTAAGGCAGGAGGATTGCTTGAGCCCAGGAGTTGGAGACCAACCTGGGTAACATAGTGAGACCCCATCTCAATAAATAAATAAATAAATAAATAAATAAATAAATAAGTACCTGTAGTCCCAACTGTGTGGGAAGTTGAGGTGGGAGGAACTCTTGGTCCTGGGAAATTGAGGCTGCAGTAAGCTGTGGTCGCACCGCTGCACTCTAGCCTGGGTGACAGAGCAAGACCCTGTCTCAA"
"chr1","1803317","1803580","chr1","20214247","20214541","85","18410930","GCTGGACATGGTGGCTCATGCCTGTAACTGCAACACTCTGGGAGGCCAAGGTAGGAGGATAGCTTGGAGCCAGGGGTTCGAGACCAGCTGGGGCAACAAAGCTAGACCCCTTCTCTACAAAAAATGAAAAACAGCCACGCACAGTGGCACACAACTATGGTCCCAGCTCCTCAGGAGGATGGCTCAAGCCTGGGTGGTTGAGGCTGCAGGGAGCTATGATTGCACCACTGCACTCCAGGCTGGGCGAAAGCGAGACCCTGTCTC","GACTGGGCGTGGTGGCTCACACGTGTAATGTCAACACTTTGGGAGGCCGAGGTGGAGGATTGCTTATGACCAGGAGTTTGAGACCAGCTGGGCAACATAGTGAGACCCCATCTCTACCACACACACACACACACACACACACAAATTAGCTGGGTGTGGTGGCAAGCCCCTGTAGTCCCAGCTACTCAGGAGGCTGAGGTGGGAGGATCACTTGAGCCTGGGATGTTGAGGCTGCAGTGAATCATGATTGCACCATCGCATTCTAGCCTGGGAGACAGAGCAAGACCTTGTCTCA"
"chr1","1814525","1814827","chr14","31798968","31799292","79","29984443","GTGGTGGCTCACACCTATAATCTCAGCACTTTGGGAGGCTGAGGTGGAAGGATCACTTAGGGGCCAGGAGTTTGAGACCAGTGTCAGCAACAAAGGGAGACCCTGTCTCTGTAAAAAACCAAAAAATATTAGCCAGGCATGGTGGCACATGCCTGTGGCCTATGCCACTTGGGAGGCTGAGTAGGAAGGGTTACTGGAGCCTAGGACGTCGAGGCTGCAGTGAGATATGATCACACCACTGCACTCCAGCATGACTGAGTGAGACCCTGTCTCAAAAAAAAAAAAAAAAAAAAAAAGAAAAAA","GGCTGGGCACAGTAGCTTACACCTGTAATCCCAGTACTTTGGAAGGCTGAAGTGGGAGGATCCCTTGAGGCCAGGAGTTTGAGACCAGCCTGGGCAACATAGTGAGACCCTGTCTCTACAACAAACAAACAAACAAACAAACAAAACTTAGCCAGTTGTGGTGGCACATCCTATAGTCCCAGCTACTCAGGAGGCTGAGGAGGGAGGATCTCTTGAGCCCAGGAGTTTGAGGCTGCAGTGAGCTATGATCATGACACTGCACTCCAGCCTGGATAACACAGCAAAATCCTGTCTCAAAAAAAAAAAAAAAAAAAAAAAAAAAGAA"
"chr1","1831191","1831340","chr5","32595015","32595178","63","30763824","GCTGGGTATCGTGGAACGTGCCTGTAGTCCTACCTACTTGGGAGGCTGAGGTGGGAGGATCGCTTGAGTCCAGGAGTTCAAGGCTGCAGTGAGCTATGATAGCACCACTGCACTCCAATCTGGGCAACAGAGCAAGATCCTGTCTCTAAA","GGCCGGGTGTGGTCCCTCATGCCTGTAATCCCAACACTTTGGGAGGCTGAGATAGGAGGACTGCTTGAGGCCAGGAGTTCAAGACCAGCCTGGTCAACATAGTGAGACCCCATCTCTATAAAATAATAATAATAATAATAATAATAATAATAAATAAATAAATA"
"chr1","1836388","1836559","chr12","4864673","4864880","64","3028285","TTTAGCCAGGCATCGTGTTGTGTGTCTGTAGTACCAGCTACTTGGGAGGCTGAGGTGGGAGAATCACTTGAGCCCGGGATGTTGAGGCTGCAGTGAGTCACGATCACACCACTGTACTCCAGCCTGGACAACAGAGCGAGACCCTGTGTCAAAAAAAAAAAAAAAAAAAAAA","AATTAGCCAGGTATGGTGGTGTGCACATGCAGTCCCAGCTGTTTGGGAGGCTGAGGCAGGAGGATCACTTGAGCCCAGGAGTTTGAGGCTGCAGTCAGCTATGATCATGCCACTGCACTCCAGCCTGGACAACAGAACAAGACCCTGTCTCAAAAACAAAACAAAACAAAACAAAACAAAACAAGAACAGAAAACAATCAAACAAAAA"
"chr1","1836850","1836986","chr9","47045786","47045941","51","45208936","GGCTAGGTACTATGGCTAACACCTGTAATCCCAGCACTTTGGGAGGAGGATTGCTTGAAGCCAGTTGTTCGATACCATCCTGGGCAATAAAGTGAGACCCCTGTCTCTTCAAAAAAAAAAAAAAAAAAAAGTTAGCA","GCTGGGCGCAGCAGCTCACACCTGTAATCCCAGTGCTTTGGAGGTCCAAGGTAGGAGGATTGCTTAAGACTAGGTGTTCAAGACCAGTCTTGGCAACATAGTGAGAACTCATCTCTACAATAAATAAATAAATAAATAAATAAATGAAAATAAAAA"
"chr1","1852138","1852238","chr20","87144","87254","59","1764994","GCCAGGCGTGGTGGCTCACGCCTGTAATACCAGGGGGCGATCACTTGAGGCCAGGAGTTTCAGACCAGCCTAGGCAACATAGCAAGATCCTGCCTCTCAAA","CCTGGGCAACATAGTGAGACTACATCTCTACACTCACGCACACACACACACACACACACACACCCCCCAAATTAGCCAGGCATGCTGATGTGCACCCATAGTCTCAGCAAC"
"chr1","1852530","1852700","chr19","13525969","13526165","79","11673439","TCAAAATATTTTTTAAAAAAATTGGCATGGTGGTGCATACCTGTAGTCCTAGCTACTCCAGAGGCTAAGACAGGAGGACTGGTTGAGCCCAGGAGTTGAAGGCAGCAGCGAGCCACTGTATGTCAGCCTGGGCAACAGTGAGACTCTGTCTCTTAAGAAAAAAAAAAAAAA","AAGAAATAAATTAGTTGAGCATGGTGGTGCATGCCTATAGTCCCAGCTACTGGGGAGGCCAAAGTGGGAGGATTGTGTGAGCCCAGGAGTTTGAGGCTGCAATGAGCCAAGATTATGCACACCAGTGTGGGAGACAGTCAAGTCTCAAAAAATAAACAACAACAACAACAACAACAACAAACACATAAAAAGAAAAA"
"chr1","1856022","1856284","chr1","25778769","25779058","83","23922747","TTCAGGAGGTTGTGGCAGGAGGATCACTTGAGGCTGAGAGTTTGAAAACAGCCTGGGCAATGTAGCGAGACCAGCCCATCTCTGAAAATATAAAAGTTAGCCAGGTGTGATGGCACATGCCTTTAGTCCTGGCTGCTCAGGAGACTGAGATGGGAGGATACTTGAGCCCAGGAATTTGAGGCTGCAGTGAGCTATGATGGTGCCACTGCACTCTAGCCTGGGTCACAGAGCAAGATCGCCATCTCTTAAAGAAGAAGAAGAAA","TTGGGAGGCTGAGGCAGGAGGATTATTGAGGCCAGGAGTTCCAGACTAGCCTGGGCAATATAACGAGACCCCAACTCTACACACACACACACACACACACACACATATACACACACAAGTTAGCTTGGCATGGTGGTAAATGCCTGTAGTCCTAACTACTCAGGAGGCTGAGATGGGAGGATCACTTGAGCCCAGGAAACGGAGGCTGCAGTGAGCTATGATCATGCCTCTTACTCCAGCCTGGGTGACAGAGCAAGGTCTTGTCTCTTAAAAAAAATAAAAAATAAAAA"
"chr1","1876332","1876452","chr20","87144","87254","65","1789188","TTAGCTGGGCCTGATGGTGTACACCTGTAGTCCCAGCTATCCAGGAGGCTAAGGTGGGAGGATTGCTTGAACCCAGGAGTTCGAGGCTGCAGTGACCTGATTGTACGACTGCACTCCAGCC","CCTGGGCAACATAGTGAGACTACATCTCTACACTCACGCACACACACACACACACACACACACCCCCCAAATTAGCCAGGCATGCTGATGTGCACCCATAGTCTCAGCAAC"
"chr1","1877504","1877637","chr5","32595015","32595178","53","30717511","GGCTTGGCATGGTGGCTCATGCCTGTAATCTTAGCACTTTGGGAGGCTGAGGCAGGAGAATCACTTGAGGCCAGGAGTTTGAGACCAGCCTGGGCAACACAGCTAGACCCTGTCTCTATTTTTAAAAAAATAAA","GGCCGGGTGTGGTCCCTCATGCCTGTAATCCCAACACTTTGGGAGGCTGAGATAGGAGGACTGCTTGAGGCCAGGAGTTCAAGACCAGCCTGGTCAACATAGTGAGACCCCATCTCTATAAAATAATAATAATAATAATAATAATAATAATAAATAAATAAATA"
"chr1","1936623","1936928","chr9","68878569","68878883","74","66941946","GCCGCGCACAGTGGCTCACGCCTGTCATCCCAGCACGTTGGGAGGCTGAAGCGGGAGGATCGCTTGAGGCTATGAATTCAAGACCAGCTTGGGCAACATAGTGAGACCCCATCTCTACAAAAAATATAAAAGTTAGCCAGGCATGGTGGCGTGTTCCTGTAGTCCTAGCCACACTCAGGAGGCTGAGGTGGGAGGATTGCTTGAACCCGGGAGGTGGAGGCTGCAGTGAGCCGTGATTGCACCCCTTGCATTCAAGCCTGGGTGACAGAGCAAGACCCTGTCTCAAAAAAAAAAAAAAAATTAAAA","GGCTGGGCACGGCAGCTCATGTCTGTAATCCCAGCACTTTGGGAGGCCAAGGTGGGAGGATTGCTTGAGTCCAGGAGTTCAAGACCAGCCTGGGCAACATAGTGAAACCCCAGTCTCTACAAATAAATAAATAAATAAATAAATAATTAGCTGGGCATGTTGATGCATGCCTGTAGTCCTAGCTACTCGGGGGGTGAGGTGAGAGGATTGCTTGAGTCCAGAAGGTGGAGGCTGCAGTGAGCTATGATCACACCACTGCACTCCAGCCTGGAAGACAGGGTGAGACGCTGTCTTTAAAAAAAAAAAAAGAAAAGA"
"chr1","1948278","1948560","chr20","52489594","52489869","85","50541316","GGCCAGGCCATGGTAGCTCATGCCTATAATCCCAATACTTTAGAGGGCCAACGCAGGAGGATCGCTTAAGCAGATGTTTGCGATCAGCCTGGGCAATATAACAAGACCATGTCTCTACCAATATACACATAAATATATATATATATATTTATATATGCCAAGCATGGCTGCATGCATCTGTGGTCACTTGAAACCAGGAGGCCGAGGCTGCAGGGTGCAGTGATCGCACCACTGCACTCCAGCCTGGGCAACAGAGTGAGACCTCGTCTCTAAAAACCAAAAA","GGCTGTGTGCAGTAGCTCATGCCTGTAATTCCAACACTTTGGGAGGCCAAGGCAGGAGGATCACTTGTGAGGAGTTTGAGACCAGCCTGTACAACATAATGAGACCTCGTCTCTACAAAAAATAAATAAATAAATAAATAAATAAATAAATAAAAAATAAAAAAATTAGGTGGAAGGATTGCTTGAGCCCAGGAGGTTAAGGCTGCAGTGAATTGTGATAGCACCACTGCACACTAGCCTGGGTGACAGAGCAAGACCCTGCCTCAAAAAAAAAAA"
"chr1","1992168","1992466","chr8","25360790","25361095","79","23368622","GCCAGATGTAGTGGCTCAAGCTTGTAATCCCAGCACTTTGGGAGGTTGAGGTGGGTGAATCCTGGCTGAGACCAGGAGTTCAAGACTAGCCTGGGCAACAAAGAGAGACCCACCATCTCAACCAATAATTTGAAAATTACCTGGGCATGGCGGCATGTGCGTGTAGTCTTAGCACTTGTGAAGCTGAGGCGGGAAGATTGCTTGAGCCCAGAAGTTTGAGGCTGTAGTAAACTGTGATTGTGTCACTGCACTCCAGCCTGGGCAACAGAGTGAGACCCTGTCACAAAAGAAAACAGAAA","GGCTGGGAGCAGTGGCTCATACCTGTAAGCCCAGCACTTTGGGAGGCTGAGGTGGGAGGATTGCTGAAGCCCAGGAGTTTGAGACCAACCTGGGCAATGTAGGGAGACCCCGTCTCTACTAAATAAATAAATAAATAAATAAATAAAGTCGGGCATGGTGGCATGTGCCCTGTAGTCCCAGCTTCTTGGGAGGCTGAGGTGGGAGGATTGCTTGGGCCCAGGAATCAAGGCTGCAGTGAGCTGTGATTGTGCCACTGTACTACAGCCTGGGTGACAGTGCAAGACTGTCTCAAAAGAAAAACAAAA"
"chr1","2017088","2017387","chr9","68878569","68878883","71","66861481","GGCTGGGCACGGAGGCTCATGCCTGCAATCTCAGCACTTTGGGAGGCCACGGGGGAGGATCCCTTGAGGCCAGGAGTTTGAGACCAGCCTGGGAAACATAGTGAGACCCCATCTCTACAAAAAATAGAAAATTATCTGGGTGCAGTGACATGCCTCTGTGGTCCCAGCTCCTCCAGAAGCTGAGGTGCAAGGATCCCTTGAACCCGGGAGGTGGAGGCTACAGTGAGCTGAGATCGTGCCACTGCACTCCAGCCTGGGCCACAGAGCAAGACCTTGTCTCTTAAAAGAAAAAGAAGAAAA","GGCTGGGCACGGCAGCTCATGTCTGTAATCCCAGCACTTTGGGAGGCCAAGGTGGGAGGATTGCTTGAGTCCAGGAGTTCAAGACCAGCCTGGGCAACATAGTGAAACCCCAGTCTCTACAAATAAATAAATAAATAAATAAATAATTAGCTGGGCATGTTGATGCATGCCTGTAGTCCTAGCTACTCGGGGGGTGAGGTGAGAGGATTGCTTGAGTCCAGAAGGTGGAGGCTGCAGTGAGCTATGATCACACCACTGCACTCCAGCCTGGAAGACAGGGTGAGACGCTGTCTTTAAAAAAAAAAAAAGAAAAGA"
"chr1","2044368","2044679","chr9","68878569","68878883","82","66834201","GGCCGGGCGCGGTGGCTCACGCCTGCATTCCCAGCACTTGGGAAGACCGAGGCGGGCGCATCGCTTGAGGCCTGGAGTTGGAGACAAGCCTGGGCAACATGGTGAAACCCCGTCTCTACAACAAGTTTAAGAATTAGCTGGGTGCGGTGGTGTGTGCTTGTGGTCCCAGCTGCTCAGGAGGCTGAGGTGAGAGGATCACCTGAGCCCAGGAGGTGGAGGCTGCAGTGAGCTGAGATGTGGCACCACTGCACTCTAGCCTGGGCGACAGAGTGAAGCCCAGCCTCTAAAAAAATAATAATAATAACTTAAAAA","GGCTGGGCACGGCAGCTCATGTCTGTAATCCCAGCACTTTGGGAGGCCAAGGTGGGAGGATTGCTTGAGTCCAGGAGTTCAAGACCAGCCTGGGCAACATAGTGAAACCCCAGTCTCTACAAATAAATAAATAAATAAATAAATAATTAGCTGGGCATGTTGATGCATGCCTGTAGTCCTAGCTACTCGGGGGGTGAGGTGAGAGGATTGCTTGAGTCCAGAAGGTGGAGGCTGCAGTGAGCTATGATCACACCACTGCACTCCAGCCTGGAAGACAGGGTGAGACGCTGTCTTTAAAAAAAAAAAAAGAAAAGA"
"chr1","2057584","2057708","chr9","47045786","47045941","58","44988202","GGCCGGGTGCGGTGGCTCACAACTGTAATCCCAGCACTTTGGGAGGTCAAGGTGGGAGGATCGCTTCAGCCTAGGAGTTCAAGACCAACCTGGGCAACATAGTGAGACCCCCCCCTCTCCAAAAC","GCTGGGCGCAGCAGCTCACACCTGTAATCCCAGTGCTTTGGAGGTCCAAGGTAGGAGGATTGCTTAAGACTAGGTGTTCAAGACCAGTCTTGGCAACATAGTGAGAACTCATCTCTACAATAAATAAATAAATAAATAAATAAATGAAAATAAAAA"
"chr1","2058303","2058488","chr14","51003183","51003398","72","48944880","CCAATTTTTTTTTTTTTTTTTTTTTTTGATATTCAGACGTGGTGGTGCACCTGTAGTCCCAGTTACTCGGGAGGCTGAGGTGGGAGGATTCCTTGAGCACAGGAGGTAGAGGCTACAGTGAACTGTGATTATTCCACTGCACTCTAGCCTGAGTGATGGGGCGAAACCCTGTGTCAGATAAATAAA","AGCCTGGGCAAGATAGTGAGACCTCATCTCTTAAAATAAATAAATAAATAAATAAATAGCAGGATGTGGTGGCGTGCATCTGTAGTCCCAGCTACTCAGGAGGCTGAGATGGGAGGATTACTTGAGCTCAGGAGGTCGAGGCTGCAGTGAGCTATGATCACGCCACTGTACTCCAGCCTGGGTGAGAGTGATACCCTGTCTCTAACAAAAAAAAAA"
"chr1","2084724","2085028","chr19","48171503","48171823","71","46086779","GCTGGGCGCAGTGGCTCACGCCTGTCATCCCAGCACTTCGGGAGGCCTAGCCAGGTGGATCGCCTGAGCTCAGGAGTTTTCAAGACCAGCCTGGGCAACATGGCAAAACCCCATCTCTACAAAAAAATGTAAAAATTAGCCTGGTGTAGTGGTGCACACCTGTCGTTCCAGCTCCTCGGGGAGGCTGAGGTGGGAGGATCGCCTGAGCCCAGGAGTTCGAGGCTGCAGTGAGCTGAGATTGTGCCACTTCACTCCAGCCTGGGTGACAGAGTGAGACCCTCTTAAAAAAAGAAAAAAAAAAAAGA","GCTGGGAGTGGTGGCTCACACCTGTAATCCCAACACTTTGGGAGGCTGAGGCAGGAGGATTGCTTGAGCTCAGGAGTTCAAGACCAGCCTGGAGCCTGGGCAACATAGCAAAACTCCATCTCTAAAAAAAAAAAAAAAAAAAAAAAAATTAGCCAGGTGTCGTGGTGCATGCCTGTAATCACAGCTACTCAGGGGGCTGAGGTGGGAAGATCGCTTGAGCCCAGGAGTCGGAGGTTGCAGTGAGCCAAGACTGTGCCACCGCACTCCAGCCTGGGCAACAGGGCAAGACCCTGTCTCCAAAAAATAAAAAGTTAAAAAAAA"
"chr1","2102898","2103136","chr10","96412023","96412287","83","94309125","TCCCAGTACTTTGGGCGGGCGAAGTGGGAGAATCACTTGGGGCATTCCAGACCAGCCTGGGTAACAAATCAAGACCCCCAACTCTACTAAAAATAAAAAATTAGCCAAGCGTGGTGGTGCGCGCCTGAAGTCCCAGCTAGTTGGGAGGCTGAGGTGGGAGGCTTGCTTGAGCCCAGCTGCAGTGAGCCGTGATTGTACCACTGTACTCCAGCCTGGGCGACAGAGCAAGACCCTGTCTC","CTTTGAGAGGAAGACGTAGGAGGATTGCTTGAGCCCAGCAGTTTGAGACTAGCCTGGGCAACATAGGAAGACTCCCATCTCTACACACACACACACACACACACACACACAATTATCCAGGGTGGTGGTGCATGCCTGTGGTCCCAGCTACTTGGGAGGTTGAGGTGGGAGGATTGCTTGAGCCCAGGAGGTCCAGGCTGTAGTGAGCCATGATCATACCGCTGCACTCCAGCCTGGGCAACAGAGTGAGACCCTGTCTCAAAAA"
"chr1","2151670","2151819","chr1","217544386","217544536","62","215392716","GCTGGGGGTGGTGGCTCATGCCTGTAGTCCCAACACTCCAGAGGCTGAAGTGGGAGGATCACCTGAGCTGGGGACTTTGAGGCTATAGTGGGCTGTGATCAAGCCACTCCAGTCTGGGTGACAGAGTAAGACCGTTTCCAAAAAAAAAGA","GGCTGGGCGTGGTGGCTCATGCCTCTAATCCCAGCACTTTAGGAGGCCAAGGCAGGAGGATAACTTAAGACCAGGCTGGGTGACACAGTGAGACTTTGTCTCTAAAAAAAAAAAAAAAAAAAAAAAAAAAAAAAACCTACAAAAACATATA"
"chr1","2166143","2166425","chr8","15910614","15910909","71","13744471","GTGCAGTGGCTCACACCTGTAATCCCAGCCCTTTGGGAGGCTGAGGCCGGAGGATCACTTGAGGCCAGGGGTTCAAGACCAGCCTGGGAAATATCTCGAGACCCTTTCTCTACAAAAAATTTAAAAATTAGCTGGCGGTGGTGGTGCAAGCATGTGGTCCCAGCTCCTCGGGAGGCTGAAGCCGGAGGATTGCCTGAGCCTGGGAGGTCGAGGCTGCAGTGAGCCATGATCACACCACTGCACTCCAGCCTGAGTGACAGAGTGAGATCTTGTCTCAGAAAAA","GGCCAGGCGAAGTGGCTCACACCTGTAATCCCAGCACTTTGGGAGGCCAAGGCAGGAGGATCATTTGAAGCCAGGAGTTCAAGGCCAGCCAGAGAAACATAGTGAGAACCTGTCTTTACAAAAATTAAAATTAAAATTAAAATTAGCCAGGAGTGGTGGTGCATGCCTGCAGTCCCAGCAGCTCAGGAGGCTGAGGTGGGATGATTGCTTGCACCAGGAGTTCGAGGCTGCAGTGAGCTGTGATCGTGCCACTGCACTCCAGCCCCTGGGTGACAAAGCAAGATCCTCTAAAAAAA"
"chr1","2202776","2202883","chr15","37343640","37343763","64","35140864","GCACTTTGGGAGGCCAAGGCAGGAGGATTGCTTGAGGCCAGGAGTTTGACGAGACCAGCCTGGACAATATTATGAGACCCTATCTTTACAAAAAATAAAATTAGCCAG","AAGATCCCTGGCCAGGATTTCAAGACCAGCCTGGGCAACACAGTGAGACCATACATACATACATACATACATACATACATCATACATACATACATACATACATACATACACAGTCTTACAAAGA"
"chr1","2268937","2269246","chr19","48171503","48171823","84","45902566","GGCCAGGCACGGTGGCTCACACCTGTCATCCCAACACTTTGGGAGGCTGAAGCAGGAGGATCGCTTGAGCCCAGGAGTTCTAGACCAGCCTGGACAACATGGCGAGACCCCATCTCTACCCAAAAAATATAAAACGTTAGCCAGATGTAGTGGTGTGTGCCTGTAGTCTCGGCTACTCATGAGGCTGAGGTGGGAGGATCACTTGAACCAACAAGGTTGAGGCCGCAAGACTGTGCTGCTGCACTCCAGCCTGGGTGACAGAGCCAGAGCCAGACCCTGTCGAAAAAAGAAGAGGGAGAGAAGGAGAGAA","GCTGGGAGTGGTGGCTCACACCTGTAATCCCAACACTTTGGGAGGCTGAGGCAGGAGGATTGCTTGAGCTCAGGAGTTCAAGACCAGCCTGGAGCCTGGGCAACATAGCAAAACTCCATCTCTAAAAAAAAAAAAAAAAAAAAAAAAATTAGCCAGGTGTCGTGGTGCATGCCTGTAATCACAGCTACTCAGGGGGCTGAGGTGGGAAGATCGCTTGAGCCCAGGAGTCGGAGGTTGCAGTGAGCCAAGACTGTGCCACCGCACTCCAGCCTGGGCAACAGGGCAAGACCCTGTCTCCAAAAAATAAAAAGTTAAAAAAAA"
"chr1","2297115","2297270","chr1","217544386","217544536","64","215247271","GCCCGGCGTGGTGGCTTATGCCTGTAATGCCAGCTCCTTGGGAGGCTGAGGTGGGAGGATCACTGGACCTCAAAAGGTCGAGGCTGCAGTGAGGTATGATCCCACCACTACACTCCAGCCTGAGCAACACACTGAGACCGTGTCTCCAAACACAAA","GGCTGGGCGTGGTGGCTCATGCCTCTAATCCCAGCACTTTAGGAGGCCAAGGCAGGAGGATAACTTAAGACCAGGCTGGGTGACACAGTGAGACTTTGTCTCTAAAAAAAAAAAAAAAAAAAAAAAAAAAAAAAACCTACAAAAACATATA"
"chr1","2325306","2325623","chr1","94172177","94172465","103","91846871","GTGATCCCAGCACTTTGGGAGGCGGAGGTGGAAGGATTCTCCTGAGCCCAGGAGTTTGAGACCAACCTGGGCAACATAGTGAGACCTCCTCTCTAAAAATTTTTTTAATTATCTGGGCATGGTGGCACACTCCTGTGGTCCCATGGGCATGGTGGCACACTCCACACTCCTGTGGTCCCAGCTCCTTGGAAGGCTAAGGCGAGGGGATTGCTTGCTCGAGCCCAGGAGTTGGAGGCCGCAGTGAGCTGTGATTATGCCGCTGCACTCTAGCCTGGGTCACAGAGCCAGACTCTATCTAGAGAAAGAAAGGAGAGAAAA","GTCTGTAATCCCAACACTTTGGGAAGCCAAGGCAGGAGAATCATTTGAGCTCAGGAGTTTGAGACCATCCTGGGCAACATATCAAAACCCCATCTCAATAATAATAATAATAATAATAATAATAATAATAAGCCAGATGTGGTGGCACATGCCTGTGGTCCCAGCTACTTGGGAGGCTGAGGTGGGAGGATCGATTGAGCCCAGGAGGTAGAGGCTGCAGTGAGCTATGATCATTTAGGCACTTCAGCCTAGATGACAGAGCAAGATTCTGTCTCAAAAAAAAAAACAA"
"chr1","2423356","2423399","chr20","87144","87254","74","2336212","AGAACAGCAGGGACAACAGAGCAAGATCCCATCTCTTTAAAAAA","CCTGGGCAACATAGTGAGACTACATCTCTACACTCACGCACACACACACACACACACACACACCCCCCAAATTAGCCAGGCATGCTGATGTGCACCCATAGTCTCAGCAAC"
"chr1","2423981","2424025","chr20","87144","87254","76","2336837","TGGGAGGCCAGGGTGGGAGCACCACTTGAAGACAGGGTTTGAGGC","CCTGGGCAACATAGTGAGACTACATCTCTACACTCACGCACACACACACACACACACACACACCCCCCAAATTAGCCAGGCATGCTGATGTGCACCCATAGTCTCAGCAAC"
"chr1","2610039","2610326","chr19","13342110","13342403","79","10732071","GACTCATGCCTGAATTCCCAGCAACTCTGGAGGCCGAGGTGGACCACTTGAGCCCAGGAGTTCCAGACCAGCCTGGGCAACACAGCGAGACCCTGTTCTAAAATAAATTTTTTAAAAAGGCATTCGGGAGAGGAGACACACATCTGTTATCCCAGCTACTCAGGAGGCTGAAGTGGGAGGATTGCTTAAGCCCAGGAGTTCAAGGCTGCAGTGAGCTGTGATCACGCCACTGCACTCCAGCCTGGGCAACAGAGTGAGACCCTGTCTCTAAAAATAAATAAGTGAAAA","TCATGCCTGTAATCCCAGCACTTTGGGAAGCCAGGGCAGGAGGATCACTTGAGACCAGGAGTTTGAGACCAGCCTGGGCAACATAGCCAGACCCCCATCTCAACAACAACATCAACAACAACAACAACAAATTAGCTGGGTGTGGTGGTGCCTGTAGTCCCAGCTACTTGGGAGGCTAAGCTGGGAGGATCGCTTGAGCCCAGGAGCTCCAGGCTGCAGAGAGCTATGATCATATCACTGCACTCCAGCCTGAGTGACAGAGCAAGAACCTGCCTCTAAAAACAATAAACAAAA"
"chr1","2646399","2646685","chr1","47533839","47534134","71","44887440","GGCCAGGTGTGGTAGCTCACACCTGTAATGCCAGTACTTTGGGAGGCCAAGGTGGGAGGATGGCTTGAGACCAGAAGTTCCATACCAGCCTGGGCAATATATCAAGACCCCATTTGTACAAAAAGATTTTAAAATGAGCTGGGTGTGGTGGCATGTGCCTGTGGTCCCAGCTACTCCGGAGGCAGAAGTGGGAGGATCACTTAAGCCCAGGAGCTCAAGGTTGCAGTGAACCAAGATCATGCCACTGCACTCCAGCCTGGGCAACAGACAGAGACCCTGTCTCAAAA","GGCTGGGCACGGTAGCTCACACCTGCAATCCCACCACTTTGGGAGGCTGAGGTGGGTGGATTGCTTGAGCCCAGGAGTTCTAGACCAGCCTGGGTGATACAGGCAGACCCTATCTCTACCAAAAAAAAAAAAAAAAAAAAAAAAAAAGGCTGGGCATGGTGGCATGTGCCTGTGGGCTCAGCTACTTAGGAGGCTGAGGTGGGAGGATCAGTTGAGCCCAGGAGGAGTTGAGGCTGCAGTGAGCCTAGATCCTGCCACTGCACTCCAATCTGGGCAACAGAGCGAGACCCTGTCTC"
"chr1","3240153","3240437","chr2A","65797088","65797395","83","62556935","GCTGGGCATGATGGCTCACATCTATAATCACAGAACTTTGGGAGGATTGCTGGAGTCCAGGAGTCCCAGCCTGGGCAACATAGTGAGACCCCATCTCTACAAAAAATAAAACAAATTAGCCGGGATGGTGGTGTGCTTGTTGTCCCAGCTACTCAGGAGGCTGAGTTGAGAGGATCGCTTGAGCTCAGGAGGCTGAGGCTGCAGTGAGCCATGATTGCACCACTGCACTCCAGCCTGGGTGAGACAACCTGTTTCAAAAAAAAAAAAAAAACAGAAAAAGAAGAA","GGCCAGGCTCGGTGGCTCTTGCCTATAATCCTAGCACTTTGGGAGGCCAAGGATTGCTTGAGCCCTGGAGTTTGAGACCAGCCTGGGCAACATAATGAGACCCTGTGTCTACAAAAAAAAAAAAAAAAAAAAAAAAAAATTGGGTGTGGTGACATGTGCCTGTGGTACCAGCTACTAGGGAGGCTGAGGTGGGAGGATCACTTGAACTCAGGAGGTCGAGGCTGCAGTAAGCCACGATTGCACCACTGCACTCCGGCATGGGTGACAGAGCGAAACCCTGTCTAAAAACAAAAACAAAAACAAAAGAA"
"chr1","3301049","3301361","chrX_NW_019937303v1_random","2630481","2630786","69","670568","GGCCGGGCACAGTGGCTCATACCTGTAATCCCAACACTTTGGGAGGATAAAGAGGGCAGATTGCTTGAGTCCAGGAGTTTGAGACCCACCTGGGAAACCTAGCAAGACCCTGTCTCTACAAAAAAATTAAAAATTAGCTGGATGTGATGGCATGTACCTGTAGTCCTAGCTACTCAGGAGGCTGAGGTTGGAGGATTGCTTGAGTTCTGGAGGTCAAGGCTGCAGTGAGCTGTGATATTGCACCACTGCCCTCCAGCCTGGGCAACAGAGCAAGATCCCATCTCAAAAAAAAAAAAAAAAAGAAAAAAAAAAA","GCTGGGCGTGGTGGCTCACGTCTCAAATCCCAGCACTTTGGGAGGTCAAGCAGTGAGGATTACTTAAGGCCAGGAGTTTGAGACCAGTCTGGGAAACATAGTGAGAGTCTGTCTCTACAAAACACACACACACACACACACACACACACACCTGTAGTCCCAGGTACTCAGTAGGCTGAGGCAGGAGGATTGCTTGATCCCAGGAGTTCAAGGCTGCAGTGAGCTGAGATTGCACCACTGCACTCCAGCCTGGGCAACAGAGCGAGACTCCATCTCAAAAAAAAAAAAAAAAAGAAAAGAAAAGAA"
"chr1","3344055","3344322","chr7","40153069","40153361","92","36809014","GGCTGGGTGTGGTGGCTCATGCTGGTGATCCCAGTGCTCTGGGAGGCTGAGCTGGGAGGATCACTTGTGGCCAGGAGTTCTAGACCAGCCTGGACAACATAACAAGACTCCCTCTCTACAAAAACATTAAACAATTAGTCGGTTGCGATGGTGCACCGTCATAGTCCTAGCTACTTGCAAGGCTAAGATGGGAAGATGGTTTGAGCCCAGGATCACGTCACTGCCCTCCAGCCTGGATAACAGAGCAAGATCCCATCTAAAAAAAAAA","GCTGGGAATGATGGCTCATGCCTATAATCCCAACACTTTGGGAGGCTGAGGTCAGAGGATTACTTATAGCCAGGAATTTGTGTCCAGCTTGGGCAACAAAGCAAGACCCTGTCTCTATTAAAACAAAACAAAACAAAACAAAACAAGCCAAGCATGGTGGTACAAATGTGTAGTCCCAGCTACTTGAGAGGCTGAGACAGAAGGATTGCTTGAGTTTGAGGTTGCAGTGAGCTATGAATGTGCCACTGCACTCTAGCCTGGGCAACAGAGCAAGACCCCATCTTTAAAAAAAA"
"chr1","3406456","3406765","chr1","136656911","136657239","84","133250455","GTGGTGGCTCACACCTGTAATCCCAACACTTTGGGCGGCCCAGGCAGGAAGATCACCTGAGGCCAGGAGTTCAAGACCAGCCTGAGCAATGTAGCAAGACACCATTTCTACCAAAAAAAAAAAAATTTTTTTTTTAATTAGCCAACCACGGTAGTGTGTGCCTGTGGTCCCAGCTGCTCAGGGGGCTAAGGGCAAGAGGATGTCCTGAGCCCAGGAATTCGAGGCTGCAGTAAGCCAAGATCACACCACTGCACTCCAGCCTGGGCAACAGAGCAAGACTCTGTAAAGAAATAAAAATAAATAAGAGAAA","GCCAGGCACAGTGGCTCACACCTATAATCCCAACACTTTGGGAGACCAAGGCAGGAGAATCACTTGAGGCCAGGAGTTTGAGACCAGCCTGAGCAACATAGCAAGACCTTGGCTCTACTAAAAAAATAATAAAATAAAATAAAATAAAATAATTAGCCAGGCATGGTGGCATGCACCTGTAGTCCCAGCTACTCAGGAGGCTGAGGCAGGAGGATGGCTTAAGTCCAGGTGTTCAAGGTTGCAGCAAGCTATGATTGCCACTGCACCCCAGCCTGGGTGACAGAGCAAGTCCCTGTCTCAAAAAAATAGATAAATAAATAAAAATAAAA"
"chr1","3552421","3552714","chrUn_NW_019938566v1","98142","98430","79","3454279","GCGTGGCGGCTCACGCCCGTAATCCCAGCACTCTGGGAGGCCCAGGCCGGAGGATCTATTGAGGCCAGGACTTTGAGACCAGCCTGGGCAACATATGAGATCCCGTCTCTACAAAAAATAACAAATTAGCTAGGTGTGGTGGCGCACGCCTGTCATCCCAGCTACTCGGAGGCTAAGGCAGGAGGATCGACGGCCTGAGCCCGGGAGTTCAAGGCTGCAGTACGGTATGGTCACACCACGGCACTCCAGCCTGGGTAGCAAAGCAAGATTCTGTCTCTAAAAAAAGAAAAGAAA","GCTGGGCGTGGTGGCTCACGTCTCAAATCCCAGCACTTTGGGAGGTCAAGCACTGAGGATTGCTTAAGGCCAGGAGTTTGAGACCAGTCTGGGAAACATAGTGAGAGTCTGTCTCTACAAAACACACACACACACACACACACACACACCTGTAGTCCCAGGTACTCAGTAGGCTGAGGCAGGAGGATTGCTTGATCCCAGGAGTTCAAGGCTGCAGTGAGCTGAGATTGCACCACTGCACTCCAGCCTGGGCAACAGAGCAAGACTGCATCTCTAAAAAAAAAAAAAA"
"chr1","3661909","3662072","chr2A","60286019","60286209","64","56624110","AATTAGCTGGGTGTGGTGGTGCCCACCTGTCTCCCAGCTACTCGGGAGGCTGAGGTGGCAGGATCCCTTGAAGCCCAGGAGTTGAGGCTGCGATGAACTATGATGGTGCCACTGCACTCTAGCCTGGGTGACAGAGTGAGACCCTGTCTCAAAAAAAAAAAGAA","AAAATTAGCCAGGTGTGATGGCACCTGTAGTCCTAGCTACTTGGGAGGCTAAGGTGGGAAGAGGGCTTGAGCCCAAGATTGTGAGGCTGTGGTGAGTCATGACTGTGCCATTGCCCTCTGGCCTGGGTGACAGAGTGAGAAGCTGTCTCAAATAAATAAATAAATAAATAAATAAATAAAAATAAACAAAA"
"chr1","3677691","3678004","chr9","68878569","68878883","78","65200878","GGCTGGGTGCAGTGGTTCATAACTGTAATCCCAACACTTTAGGAGGCCAAGGAGGGAGGATTACTTGAGCCCAAGGGCTTGAGACCAGCCTGGGCAACACAGGGAGACCTCAGCTCTCCAAAAACTTAAAAAAATATTAGCTGGGCATGAGGGCGTGATGGCATGTGCCTGCAGTCCAAACCACGCAGGGTGCTGAGGTGGGAGAATCACTTGAGCCCAGGGGCTCGAGGCTGCAGTGAGCCATGATTGCACCACTGCACTCCAGTCTGGGCAACAGAGCTAGACCACAACTCTAAAAAAAAAAAAAAAAAAAA","GGCTGGGCACGGCAGCTCATGTCTGTAATCCCAGCACTTTGGGAGGCCAAGGTGGGAGGATTGCTTGAGTCCAGGAGTTCAAGACCAGCCTGGGCAACATAGTGAAACCCCAGTCTCTACAAATAAATAAATAAATAAATAAATAATTAGCTGGGCATGTTGATGCATGCCTGTAGTCCTAGCTACTCGGGGGGTGAGGTGAGAGGATTGCTTGAGTCCAGAAGGTGGAGGCTGCAGTGAGCTATGATCACACCACTGCACTCCAGCCTGGAAGACAGGGTGAGACGCTGTCTTTAAAAAAAAAAAAAGAAAAGA"
"chr1","3705034","3705182","chr19","6391716","6391877","73","2686682","CGCCCGTAATCCCAGCATTCTGGGGGGCAGAGGCGGGAGGATCTCTTGAGCCCAGGAATCTGAGACGGCAGAGAGCCAAGATCACGCCACTGCCCTCCAGCCTGGGAGACAGGGCAAGACTTTGTCTCAAAAAACGAAACAAAATATAA","CCAGGCGCAATGGCTCACGCCTGTAATCCCAACACTTTGAGAGGCCGAGGCAAGAGGATTGCTTGAGGCCAGGAGTCCGAGACCAGCCTGGGCAACACAGCGAGGCCTCATTCTCTACAAAAAATAAATATATAAATAAATAAATAAATAAGAAGAAGAAAA"
"chr1","3810401","3810618","chr14","51003183","51003398","49","47192782","GCCTGGGCAACATGGTGAGAACCCACCTCTACTATACATATATATACAAAAATTAGCTGGGGGTGGTGGCTTGTGCCTGTAGTCCCAGCTACTCAGGAGACTGACGTGGGAAGATGGCTTGAGCCCTGGAGTTGGAGACTGCAGTGAGTCATGGTAGCACCACTGCACTCCAGCCTGGGCAACAGAGTGAGACCCTGTCTCTGGAATTAAAAAAAAAA","AGCCTGGGCAAGATAGTGAGACCTCATCTCTTAAAATAAATAAATAAATAAATAAATAGCAGGATGTGGTGGCGTGCATCTGTAGTCCCAGCTACTCAGGAGGCTGAGATGGGAGGATTACTTGAGCTCAGGAGGTCGAGGCTGCAGTGAGCTATGATCACGCCACTGTACTCCAGCCTGGGTGAGAGTGATACCCTGTCTCTAACAAAAAAAAAA"
"chr1","3864546","3864848","chr17","23262608","23262910","75","19398062","GGCTGGGCGCGGTGGCTCACGCCTGTAATCCCAGCACTTTCAGAGACCGAGGTGGGAGAATCACTTAAGGGCAGGAGTTTGAGACCAACCTGGCAACCAAGACCCCATCTCTAAAAAAAAAAGCAAGACCCCCATCTCTAAAAAAAATCATAATAATTAGCGGCACATGGGGGTGCACACCTGTAGTCCCAGTTACTTGGGAGGCTGAGGTAGGAGGATCGCTTGAGCCCAGGAGTTCAGGGTTGCAGTGAGCCATGATTGCCACTGCACTCCAACGTGGGCAACAGAGTGAGACCCTGTCTC","GGCTAGGCATAATGGCTCATGCCTGTAATCCCAGCACTTTGGGATGCCGAGGTAGGAGGTTTGCTTGAGTCCAGGAGTTTAAGACCTGCCTGGGCAACCTGGTAAGATCCCATCTCTATTTAAAAAAAAAAAAAAAAAAAAAAAAAACTTTAAAAATAGCCCAGCGTGATGGCATGAAACTGTAGTCCCAGCTACTTGGGAGACTGAGATGAGAGGATCCCCTGAGCCCAGGAGTTCAAGGCTGCAGTGAGCTATGATTGCACCACTGCGCTCCAGCCTGGGCAACAGAGTGAGACCCTGTCT"
"chr1","3893618","3893917","chr9","68878569","68878883","78","64984951","GGTGTGATAGCTCACACCTGTAATCCCAGCTACTTGGGAAGCTGAGGTAGGAGGATCGCTCGAGCCCAGGAGTTCAAGACCAGCCTGGGCAATACAGCGAAAGCCCATCTTTAAAAAATTTTTTTAAAAATTAGCCAGGTGTGGTGGTGTGCACCTGTAGTCCCAGCTATGTGGGAGGCTGAGGTGAGAGGATCACTTGATCCCAGGAGTCTGAGGCTGTAGTGAGCTATGACTGCACCACTGCACTCCACCTGGGTGACAGAGTGAGACAGTGTCTCTGAAAAAATAATAATAATAAAA","GGCTGGGCACGGCAGCTCATGTCTGTAATCCCAGCACTTTGGGAGGCCAAGGTGGGAGGATTGCTTGAGTCCAGGAGTTCAAGACCAGCCTGGGCAACATAGTGAAACCCCAGTCTCTACAAATAAATAAATAAATAAATAAATAATTAGCTGGGCATGTTGATGCATGCCTGTAGTCCTAGCTACTCGGGGGGTGAGGTGAGAGGATTGCTTGAGTCCAGAAGGTGGAGGCTGCAGTGAGCTATGATCACACCACTGCACTCCAGCCTGGAAGACAGGGTGAGACGCTGTCTTTAAAAAAAAAAAAAGAAAAGA"
"chr1","3917382","3917506","chr20","87144","87254","68","3830238","TTGGGAGGCCAACGTGGGAGGATCATTTGAGCCCAGGAGCTCAAGGCTGCAGTGAGCTGGGATTGCACTGCTGCACCCCAGCCTGGGCTACAGAGCAAGACCCTGTCTCTTAAAAAAAAAAAAAA","CCTGGGCAACATAGTGAGACTACATCTCTACACTCACGCACACACACACACACACACACACACCCCCCAAATTAGCCAGGCATGCTGATGTGCACCCATAGTCTCAGCAAC"
"chr1","3950830","3951079","chr10","96412023","96412287","67","92461193","GCTGAGGCAGGAGGATTGCTTCAGGCCAGGAGTTTGAGACTAGCCTGGGCAACATAGCAAGACCTTATCTCTATCAAAAAAAAAAAATAATAAAAAACAGGGCATGGTGGCACATGCCTGTAGTCCCAGCTACAAGAGGCTGAGCAGGGAGGATTGCTTGCACCCAGGAGGTCAAGGCTGCAGTGAGCCGAGATCCTGCCACTGCACTCCAGCCTGGGCCACAGAGTGAGACTGTCTCAAAAAAAAAAAA","CTTTGAGAGGAAGACGTAGGAGGATTGCTTGAGCCCAGCAGTTTGAGACTAGCCTGGGCAACATAGGAAGACTCCCATCTCTACACACACACACACACACACACACACACAATTATCCAGGGTGGTGGTGCATGCCTGTGGTCCCAGCTACTTGGGAGGTTGAGGTGGGAGGATTGCTTGAGCCCAGGAGGTCCAGGCTGTAGTGAGCCATGATCATACCGCTGCACTCCAGCCTGGGCAACAGAGTGAGACCCTGTCTCAAAAA"
"chr1","4087899","4088072","chr18","55799233","55799394","60","51711334","GCTGGGTGTGGTGGCTCACACTTGTAATCCCAGCACTGTGGGAGGCAGAGGTGGGAGGATCTCCCGAGCCTGGGAGTTCAAGACTGCAGTAAGCCTTGATCACACCACTGCACTCCAGCCTGAGGGACAGAGTGAGACCCTAGCTCTAAATAAATACAAAATAGAAGGGAAAAA","GGCTGAGAGAGGTGGCTCATGCTTGTAATCCCAGCACATTGGGAGGCAAAGGTGGGAAGATTGCTTGAGGCCAGGAGTTCAAGACCAGCCTGGGCAACATGAAAACACTTTGTCTCTACAATAAATAAATAAATAAATAAATAAATAAAAGAAACAAGAAAA"
"chr1","4154911","4155076","chr2A","60286019","60286209","62","56131108","TAACCCAGCATGGTGGTGGGCGCCTGTGATCCCAGCTATTCAGGAGACCGAGATGGGAGGATGGCTTAAGCCCAGGTGGTCAAGGCTGCAGTGAGTTGTGACTGTGCCACTGCACTCCAGCCTGGGCAATGGAGCCTGTTAAAAACTAAATAAATAAATAAATAAA","AAAATTAGCCAGGTGTGATGGCACCTGTAGTCCTAGCTACTTGGGAGGCTAAGGTGGGAAGAGGGCTTGAGCCCAAGATTGTGAGGCTGTGGTGAGTCATGACTGTGCCATTGCCCTCTGGCCTGGGTGACAGAGTGAGAAGCTGTCTCAAATAAATAAATAAATAAATAAATAAATAAAAATAAACAAAA"
"chr1","4155381","4155520","chr5","32595015","32595178","52","28439634","GGCTGGGTGCAGTGCCTCATGACTGTAATCCCAGCACTTTGGGAGGCCAAGGCAGAAGGATCACTTGAGGCCTGGAGTTTGAGACCAGCCTGGAATAACATGGCAAAACCCCAGCTCTACAAATAATTTTTTTAAAATGT","GGCCGGGTGTGGTCCCTCATGCCTGTAATCCCAACACTTTGGGAGGCTGAGATAGGAGGACTGCTTGAGGCCAGGAGTTCAAGACCAGCCTGGTCAACATAGTGAGACCCCATCTCTATAAAATAATAATAATAATAATAATAATAATAATAAATAAATAAATA"
"chr1","4208096","4208400","chr9","68878569","68878883","74","64670473","GACCTGGTGCAGTGGCTCACACCTGTAATCCCAATACTTTGGGATGCCAAGGCGGGAGGATTGCTTGAGCCCAGGAGTTCAAGACCAGCCTAGGCAACATAGCATGACTCCATCTCTACAAAAAATTTAAAAAGTAGCCAGGGGTGTTGGTGCATGCCTGTAGTCCCAGCTAGTCAGGAGGTAGAGATGGGAGGATCTCTTGAGCCCAGGAGTTCAAAGCTGAAGGGAACCGTGATCACACCACTGCTCTCCAGCCTAGGTGATAGAGTGAGACTCTGTCTCAAAAAATGAAAACAAAAAACAAA","GGCTGGGCACGGCAGCTCATGTCTGTAATCCCAGCACTTTGGGAGGCCAAGGTGGGAGGATTGCTTGAGTCCAGGAGTTCAAGACCAGCCTGGGCAACATAGTGAAACCCCAGTCTCTACAAATAAATAAATAAATAAATAAATAATTAGCTGGGCATGTTGATGCATGCCTGTAGTCCTAGCTACTCGGGGGGTGAGGTGAGAGGATTGCTTGAGTCCAGAAGGTGGAGGCTGCAGTGAGCTATGATCACACCACTGCACTCCAGCCTGGAAGACAGGGTGAGACGCTGTCTTTAAAAAAAAAAAAAGAAAAGA"
"chr1","4402470","4402773","chrUn_NW_019938566v1","98142","98430","77","4304328","GGCTGTGCACAGTGGCTCACGTCTGTAACCCCAGCACTTTGGGAGGCTGAGGCAGGAGAATTGCTTGAGGCCAGGAGCTTAAGACCAGCCTGGGCAACACAGCAAGAATCCTGTCTCTACAGTAAAATAAAATTAGCCATATATGGTGGCACATACCTGTAGTCATAGCTACTCAAAAGACTGAGGCAGGAAGATCGATTGAGCCCAGGAATTTGAGGCTGCAGTGAGCTACTATCGCACCACTATATGCCAGCCTGGGCAACAGAGCAAGACCTTGTCTCAGAGGGGAAAAAATAAAAGGAAA","GCTGGGCGTGGTGGCTCACGTCTCAAATCCCAGCACTTTGGGAGGTCAAGCACTGAGGATTGCTTAAGGCCAGGAGTTTGAGACCAGTCTGGGAAACATAGTGAGAGTCTGTCTCTACAAAACACACACACACACACACACACACACACCTGTAGTCCCAGGTACTCAGTAGGCTGAGGCAGGAGGATTGCTTGATCCCAGGAGTTCAAGGCTGCAGTGAGCTGAGATTGCACCACTGCACTCCAGCCTGGGCAACAGAGCAAGACTGCATCTCTAAAAAAAAAAAAAA"
"chr1","4563311","4563601","chr18","16899958","16900260","67","12336647","GCCAGGCTCAGTGGCTCCCATCTGTAATCCCAGCACTTTGGGAGGCCGAGGCAGGAAGATTGCTTGAGTCCAGGAGTTCAAGACAAGCCTGGGCAACATAGGGAGACCTCCCAATGTCTACAAAAAATAAAAAATTAGCCGGGCTTGGTGGTGCGTGCCTGTAGTCCCAGCTACTCGGGAGGCTGAGGAGGGAGGATCACTTGAGCCCAGGTGTTAAACGCTGCAATGAGCTATGATCGCACCATTGCATTCCAGCCTGGGTTACAGAGAGAGACCCTGTCTCTAAAAAAA","GTCAGGCGCGGTGGCTCACACCTGTAATCCCAGCACTTTGGGAAGCCGAGGCAGACGGATCACCTGAGGCCAGGAGTTCAAGACCAACCCCGGGCAACAAAGCAAGACCCTGTCTCTATAAAAAAAAAAAAAAAAAAAAAAAAATTAGCCGAGCATGATGGCAAGTGCCTGTAGTCCCAGCTACCTAGGATGTTGAGGTAGGAGGATTGCTTGAGCCCAAGAGGTTGAGGCTGCAGTGAGCCATGATCTCACCACTGCACTCCAGCCTGGGTGACAGAGCGAGACCCTGTCTCAAAAAATAAA"
"chr1","4610841","4611130","chr4","139746214","139746515","68","135135373","GCCGGGGCAGTGGCTCACACCTGTAATCCCAGCACTTTGGGAGGCCAAGACAAAAGAATTGCTTGAGCTCAGGAGATTGGGACCAGCTTGGGCAACATAGTGAGACATCATCTCTACAAACAATAATAATTTAAAAAAAAGCTATGGTGGCACACACCTGTGGTCCTAGCTACACGGGAGGCCGAGGTGGGAGGATTGCTTGAGCCTAGGGTGTCGAAGCTGCAGTGAGCCAAGACCTTGCCACTGCACAACAGCCTGGGTAACACAGAAAGACCCTGTCTCCAAAAAAA","GGCCAGGCACAGTAGTTTATGCCTGTAATCCCAGCACTTTGGAAGGCTGAGGCAGAAAGATCCCTTGAGCTCAGGAGTTTGAGATCAGCTTGGGCAACATAGCGAGACCCCATCTCCTAAAAAAAAAAAAAAAAAAAAAAAAACTAGCTGAGCATGGTACACACACCTGTAGTCCCAGCTATTTGGAGGTGCTGAGGTGGGAGGATCACTTGAGTCCAGGAAGTTGAGGCTGCAGTGAGCCAAGATCATGCCACTGCACTCCAGCCTGCACAACACAGCAAGACTCTGTCTCAAAAAACAAA"
"chr1","4793839","4794131","chr18","16899958","16900260","74","12106119","GACCAGATGTGGTGGCTCATGCTGCTAACCCAGTGCTTTGGGAGGCTGACGCAGGAGGATTGCTTCAGGCCAGGAGTTCAAGACTAGCCTGGGCAACAGAATGAGACCATGTTCGTACAAAAAAATTTAAAAATTAGATGGGCATGGTGCCTACGCCTGTATTCCCAGCTACTCAGGAGGCCGAGGAAGGAGGATTGCTTGAGCCCAGGAGTTTGAGGCTGTAGTGAGCTATGATTGTGCCAATGCACTCCAGCCTGGGTGACAGAGCAAGACCCTGCCTCGAAAGAAAGAAA","GTCAGGCGCGGTGGCTCACACCTGTAATCCCAGCACTTTGGGAAGCCGAGGCAGACGGATCACCTGAGGCCAGGAGTTCAAGACCAACCCCGGGCAACAAAGCAAGACCCTGTCTCTATAAAAAAAAAAAAAAAAAAAAAAAAATTAGCCGAGCATGATGGCAAGTGCCTGTAGTCCCAGCTACCTAGGATGTTGAGGTAGGAGGATTGCTTGAGCCCAAGAGGTTGAGGCTGCAGTGAGCCATGATCTCACCACTGCACTCCAGCCTGGGTGACAGAGCGAGACCCTGTCTCAAAAAATAAA"
"chr1","4944218","4944534","chr1","198858437","198858754","79","193914219","GGCCAGGTGTAGTGGCTTATGCCTATAATCCCAGCACTTTGGGAGGCCAATGTGGGAAGCTAGCTTGAGGCCAGGAATTCAAGACCAGCCTGGGCAACACAGTGAGACCTAGTGTCTACCACAAAAAGCATGAAAATTAGCTGGGCATGGTGGCATGCACCCACAGTCCTAGCTACTCAGGAGGCTGAGGTGGGAAGATCGCTTGAGCCCAGGAGTTCCAAGCTGCAGTGAGCTATACTCTCGCCACTGATCCCCAGCCTCGGTGACAGAGCAAGACCATCTCTAAAAAGAAAGCAAAAGCAAAAAGCAAAACAAAA","GGATGTGGTGGCTCATGCCTATAATCTCAGCACTTTGGGAGGCAAGGTGGGAGGACTGCTTGAGGCCAGGAGCTCAAGACCAGCCTGGGCAACATAGTGAGACCTTGTTTCCACAGAAAAAAAAAAAAAAAAAAAAAAAAAATTAGCTGGGCATAATGCCCTGCAGTCCCGGCTTCTCATGAGGCTGAAGTGGGAAGATTGCTTGAGCCCAGTAATTTAAGGACACAGTGAGCTATGATTGTGTGACTGCACTCCAGCCTCAGTGACACAGCAAGACCCTGTCTCAAAAAAACCCAAAAAACAAAAAACAAACCAAAA"
"chr1","4958497","4958782","chr8","37744776","37745066","67","32786279","GGCCAGTCACAGTGGTTCACGTCTGTAATCCCAGCACTTTGGGAGGTCGAGCGGGGAGGATCACTTGAGGCCAGGAGTTCCAGACCAGCCTGGCCAACACAGCTAGACCCCACCTCTACAAATAAAACAAAACAAACAAAAAAATTAGCCAGGCATGGTGGTGCGTATCTGTAGTCCTAGCTACTAGGAAGGCTGAGGTGGGAGGATCACTGGAGCCCAGGAGTTCAAGGCTGCAATGAGCCATGATTATGCTACTGCACTTCAGCCTGGGCAACAAGGTGAGACC","GGCTGGGTGAGGTAGCTCACGCCTGTAATCCCAGAGCTCTGGGAGGCTGAGGCAGGAGGATTGCTTGAGGCCAGGAGTTCAAGACCATCCTGGGCAACATAGGGAGACCCCCACCTCTACAAAAACAAACAAACAAACAAACAAAAAAACAAACCTGGACATGGTGGTGCTGCCTTTAGTCCTAGCTACCGGGGAGCTGAGTTGGGAGGATTGCTTGAGCCCAGGAGGTGGAGGCTGCAGTGAGCTGCGATTATACCACTGTACTCCAGCCTGGGTGATAGAGCAAGACTC"
"chr1","5003256","5003563","chr16","18367809","18368125","66","13364553","CCAGGCATGGTGACTCATGCCTGTAATCCCAGCAGTTTGGGAGTCTGAGGCAGGAGGATCACTTGAGGCCAGGAGTTCAAGACCAGCCTGGACAACATAGTGAGGCCCCATGTCTACAAAAAATAAAAACAAAGTAGCTGGGCATAGTGGCATGCACCTGTAGCCCCAGCTACTCTGGAGGCTGAGGTGGGAGGATCACTTGAACCCAGGAGTTCGAGGCTGCAGTGAGCTATAATTGCACCATTGCATTCCAGTCTGGGCAACAGAGCAAGACTTCATCTCAAAAACAAACAAACAAACAAACAAAA","GGCCAGGCGCAGCAGCTCATGCCTGTAATCCCAGCACTTTGGGAGGTTGAGGCAGGAGGATCACTTGAGCCAGGAGTTTGAGACCAGCCTGGGCAATAAAGCAAGACCTTGTCTCTCAAAAATAAATAAATAAATAAATAAATAATTAGCTGGACATGGTGGCACGTACCTGTAACCCCAGCTACTTGGGAGGCTGAGGTGGGAGGATCACTAGAGCCCAGGAGTTCAAAGCCGCAGTGATCCATGATTGCACCACTGTATTCTAGCCTGGGAGACAGAGCAAGACTCCATCTCTTTAAACAAACAAACAAACAAAA"
"chr1","5084120","5084394","chr7","49832421","49832722","77","44748301","TGGCTCATTCCTGTAATCCCAGCACTTTGGGAGGCTTAGGTGGAAGGATTGCTTAAGGCCAGGTGTTCAAGTCTAGCCTGGGTAACATAGTGAGACCCCCATTTCTAAAAAAATTTTAAAAATTATCTGGGCATGGTGGTGCATGCCTGTAGTCCCAGCCACTTGGGAGACTGAGGTAGGAGGATTGCTTGAGTCTAGGAGTTTGAGGCTGCAGTGAGCTATGATCTTGACACTGCACTCCAGCAGGACAACAGAGCAAGACCCTGTCAAAAAAA","GGCCAGGCATGGGGGCTCATGCCCGTAATCCCAGCACTTTGGGAGGCCAAGGCAGGAGGATTGGTTGAGGCCAGGAGTTCAAAACCAGTCTTGGGCAACATAGTGAGACCCTGTTTCTACAAAAAAAAAAAAAAAAAAAAAAAAAAAAAATCTAGGTATGGTGTGTGTGCCTGTAGTCCCAGATATTTGGGAGGCTGAGGTGGGAGGATTATGTGAGCCCAGAAGTTTGAGGCTACAGTGAGCTATGATCATGCCACTGCACTCCAGCCTGGACAACAGAGTAAAACCTTATCTCAAAAAAA"
"chr1","5772595","5772895","chr16","32352979","32353289","69","26580384","GGTGGCTCATGCCTGTAACTTCAGCACTCTGGGAGGCTAAGGCAGGAGAATGGCTTGAGACCAGAAGTTCTTGACCAGCCAGGGCAACATAGTGAGACCCTGTCTCTACAAAAAAAACAAAAATTTAATTAAAACATTAGCCAGGCGTGGTGTGCATGCCTATAGTCCTAGCTACTCAAGAGGCTGAGGTGGGAGGGTGGCTTAAGCCCAGGAGTTTGAAGCTACAGTGAGCTATGATCATGCCACTGCAGTCCAACCTGAGTGACAGAGCAAGATCCTGTCCTTTAAAAAAAAAAAAAAA","GGCTGGACACGGTGGCTGCTGCCTGTAATCCCAGCACTTTGGGAGGCCAAGGCAGGAGAATGGCTTGAGCCCAGGAGTTCAAGACCAGCCCGGGCAACAGAGTGAGACCTTGTCTCTACAAAAATAAAAATAGAAATAAAAATAAAAATTAGCCAAGTGTGGTGGCATGCACCTGTGGTCTCAGCTACTCAGGAGACTGAGGTGGGAGGATCCCTTGAGCCCAGGAGGTCGAGGCTGCAGTGAGCTGTGATCATGCCACTACACTCCAGCCTGGGTGACAGAGCTGTCTCAAAAAAATAATAATTAAAAAA"
"chr1","5919738","5919950","chr14","51003183","51003398","64","45083445","TAGATAGATAGGTAGATAGATAGATAAGTAAATAAATGCATGCAGTAGCTGGGTGTGGTAGCATGTGCCTGTAGTCTCAGCTACTTGGGAGGCTGAGGCAGGAGAATTGCTTGAACCCAGGAATTCGAGGCTGCAGTGAACTATGATCACGTCACTGTACTCTAGCCTGGGCATCAGAGCCAGACTTTGCCTCTAAAAAAAAAAACAAAAAAA","AGCCTGGGCAAGATAGTGAGACCTCATCTCTTAAAATAAATAAATAAATAAATAAATAGCAGGATGTGGTGGCGTGCATCTGTAGTCCCAGCTACTCAGGAGGCTGAGATGGGAGGATTACTTGAGCTCAGGAGGTCGAGGCTGCAGTGAGCTATGATCACGCCACTGTACTCCAGCCTGGGTGAGAGTGATACCCTGTCTCTAACAAAAAAAAAA"
"chr1","5920231","5920360","chr18","55799233","55799394","57","49879002","GGCTGGGCGCAGTGGCTCATGCCTATAATCCCAGCATGTTGGGAGGCTGAGGTGGGAGGATGGCTTGAAGCCAAGAGTTCGAGATCAGCCTGGGTAACATAGCAAGGCCCTGACTCTACAAAAAACTTAA","GGCTGAGAGAGGTGGCTCATGCTTGTAATCCCAGCACATTGGGAGGCAAAGGTGGGAAGATTGCTTGAGGCCAGGAGTTCAAGACCAGCCTGGGCAACATGAAAACACTTTGTCTCTACAATAAATAAATAAATAAATAAATAAATAAAAGAAACAAGAAAA"
"chr1","5962179","5962343","chr18","55799233","55799394","59","49837054","GCCGGGCATGGTGTCTCATGCCTGTAATCCCAGCACTTTGGGAGGCCAAGGTGGGAGGATCACTTGAGCCCTGGAGTTTGAGGCTTCAGGAAGCTATGATTACACCACTGCTCTCCAGCCTGGGCAAACAGAGTGGCACCCTGTCTCTAAAAACAAACAAACAAA","GGCTGAGAGAGGTGGCTCATGCTTGTAATCCCAGCACATTGGGAGGCAAAGGTGGGAAGATTGCTTGAGGCCAGGAGTTCAAGACCAGCCTGGGCAACATGAAAACACTTTGTCTCTACAATAAATAAATAAATAAATAAATAAATAAAAGAAACAAGAAAA"
"chr1","5964943","5965231","chr8","25360790","25361095","64","19395847","GCCGGGTGCAGTGGCTCACACCTGTAATCCCAACACTTTGAGAGGCTGAGGTGGGCAGATTGCTTAAGGCCAGGAGTTTGAGACCATCGTGGGCAACATAGTGAGACCCCATCTCTACAAAAAATACAAACATTAACTGGGTATGGCGGTGCGCCCCTGTGGTCATAGCTACTTGGGAGGCTGAGGTGGGAGGATTGCTGAGCCCAGGAGTTTTAGGCTGCAGTGAGCCATGATTGCACCACTGCACTCCAGCCTGGGCGACGGTGAGACCCTGCCTCAAAAAAAAAAA","GGCTGGGAGCAGTGGCTCATACCTGTAAGCCCAGCACTTTGGGAGGCTGAGGTGGGAGGATTGCTGAAGCCCAGGAGTTTGAGACCAACCTGGGCAATGTAGGGAGACCCCGTCTCTACTAAATAAATAAATAAATAAATAAATAAAGTCGGGCATGGTGGCATGTGCCCTGTAGTCCCAGCTTCTTGGGAGGCTGAGGTGGGAGGATTGCTTGGGCCCAGGAATCAAGGCTGCAGTGAGCTGTGATTGTGCCACTGTACTACAGCCTGGGTGACAGTGCAAGACTGTCTCAAAAGAAAAACAAAA"
"chr1","5973411","5973600","chr14","51003183","51003398","65","45029772","ACCCCAGCTCTACCAAAATAAAAACATTTAGCTGGGTCTGGTGATGCATGCCTGTAGTCCCAGCTACTTGGGAGGCTGAGGAGGGAGGATCACTTGAGCCCAGGAGTCCAAGGCTGCAATGAGCTATGATCGCACCATTGCACTCCAGCCTGGGCAACATAGTGAGACCCCATCTCTTAGAAAAGAAAGA","AGCCTGGGCAAGATAGTGAGACCTCATCTCTTAAAATAAATAAATAAATAAATAAATAGCAGGATGTGGTGGCGTGCATCTGTAGTCCCAGCTACTCAGGAGGCTGAGATGGGAGGATTACTTGAGCTCAGGAGGTCGAGGCTGCAGTGAGCTATGATCACGCCACTGTACTCCAGCCTGGGTGAGAGTGATACCCTGTCTCTAACAAAAAAAAAA"
"chr1","6019010","6019320","chr12","41584147","41584465","78","35565137","GACTGGGCACAGTGGTTCACACCTGTAAGCCCAGCACTATGGGAGGCTGAGGCAAGAGGACAGTGTAAGGCCAAGAGTCTGAGACCAGCCTGGGCAACATAACAAGATTCTGTCTCTATAAAAAATTATAAAATTAGCCGGGGGTGGTGGCACACACATGTAGTTCCAGCTACTTGGGAGGCTGAGGCAGACGGATCACTTGAGCCCAGGAGTTCAAGGCTGCAGTGAGCTGTGATCATGCCACTGTACTCCAGCCTGGGCAACAGAGTAAGTTCCCTTCTCCTAAAAAAAATTAAATGAAATAAATAAAA","GGCTGGATGTGGTAGCTCGTGCCTGTAATCTCAACTACCAGGGAGGCTGAGGCAGTAGGATCACTTGAGGCCAGGAGTTCAAGACCAGCCTGTGTAACATAGCAAGACCCTGTCTCTAAAATAAATAAATAAATAAATAAATAATTAACTGGGCATGGTGACACACACTTGTAGTCCAAGCTACTTGGAAGGCTTAGGCAGAAGAATTGCTTGAGCCCAGGAATTCGAGGCTGCAGTGAGCTGTGATTTGTGCCACTGCACTCCAGCCTGGGCAACAGAGCAAACCTATGTCTCTTAAAAAAAAAAAGAAAAGAAAGAA"
"chr1","6023763","6023939","chr12","4864673","4864880","63","1159090","TTAGTCATTCATGGTGGTGCATGCCAGTGGTCCCAGCTATTTAGGAGGCTGAGGTGGGAGGATCCCTTGAACCCAGGAGTTTGAGGCTACAGTGAGTTATGATCATGCCACTGGACTCCAGCCTGGGCAACATAAGAAGACCCACCTCTATAAATAAATAGGTAAAGAAAAATAGAA","AATTAGCCAGGTATGGTGGTGTGCACATGCAGTCCCAGCTGTTTGGGAGGCTGAGGCAGGAGGATCACTTGAGCCCAGGAGTTTGAGGCTGCAGTCAGCTATGATCATGCCACTGCACTCCAGCCTGGACAACAGAACAAGACCCTGTCTCAAAAACAAAACAAAACAAAACAAAACAAAACAAGAACAGAAAACAATCAAACAAAAA"
"chr1","6024241","6024383","chr9","47045786","47045941","40","41021545","GGCTGGGTGCGGTGGCTCACACCTGTAACCCAGCACTTTGGAGGCCAGGGTGGGAGGATTGCTTGAGGCCAGGAGTTCGAGACCAGTCTGGGCAACATAGTGAGACCCAATCTCTAACAAAAAATTTAAAAATTAGCCTGGCA","GCTGGGCGCAGCAGCTCACACCTGTAATCCCAGTGCTTTGGAGGTCCAAGGTAGGAGGATTGCTTAAGACTAGGTGTTCAAGACCAGTCTTGGCAACATAGTGAGAACTCATCTCTACAATAAATAAATAAATAAATAAATAAATGAAAATAAAAA"
"chr1","6137509","6137632","chr9","47045786","47045941","64","40908277","GGCCAGGTGCGGTAGCTCACGCCTGTATTCCCAGTACATTGGGAGACTGAGGCAGGAGGATTGCTTGAGGCCGGGAGTTTGAAGCCAGCCTAGTTAACATAGAGAGATCTCTCTCCAAAAGACA","GCTGGGCGCAGCAGCTCACACCTGTAATCCCAGTGCTTTGGAGGTCCAAGGTAGGAGGATTGCTTAAGACTAGGTGTTCAAGACCAGTCTTGGCAACATAGTGAGAACTCATCTCTACAATAAATAAATAAATAAATAAATAAATGAAAATAAAAA"
"chr1","6189415","6189578","chr5","32595015","32595178","64","26405600","TAGCCGGACATGGTGGGGCACTCGTGTAGTCCCAGCTATTTGGGAGGCTGAGGTAGGACTGTTTGAGCCAGGAGATGGAGGCTAGAGTGAGCTATGATCACCCCACTGCTCTCCAGCCTTGGTGACAGAGTAAGACCCTATCTAAAAAAAAGGAAAAAAAAAAA","GGCCGGGTGTGGTCCCTCATGCCTGTAATCCCAACACTTTGGGAGGCTGAGATAGGAGGACTGCTTGAGGCCAGGAGTTCAAGACCAGCCTGGTCAACATAGTGAGACCCCATCTCTATAAAATAATAATAATAATAATAATAATAATAATAAATAAATAAATA"
"chr1","6194605","6194893","chr4","112106023","112106320","74","105911418","GGCTGGGTGCAGTAGCTCACACCTGTAATCCCGGCACTTTGGGAAGCCAAGGCAGGAAGATTGCTCAAGCCCAGGAGTTCAAGACGAGCCTGGGCAACTTAGGAAGACCCTTCCTCTACAAAAAAATTTAAAAATTAGCTAGGTATGGTGGTGCATGCCTGTGGTGCCAGCTATTCCAGAGGCTGAGGTGGGAGGATCACTTGGGCCTATGAGGTTGAGGCTGCAGTGAGCCAGGATCATGCTACTGCCCTCCAGCCTGGACAACAGACCCTTTCTCAAAAAATAAAAA","GACCAGTTGCAGTGGCTCAAGCCTGTAATCCCAGCACTTTGGGAGGCCAAGGCAGGAGTAATGATTGAAGCCAAGCATTCAAGACCAGCGTGGGAGACATGGCAAGATCTCTTCTCTAAATAAATAAATAAATAAATAAATAAGCATGGTGATGCATGCCTGTAGTTCCAGCTACTTGGAAGGCTGAAGCAGGAGGATATCCTGTGCCTAGGAGGTTGAGGCTGCAGTGAGCCATGATCTTGCCCACTGTACTCCAGCTTGGGTGACAGGGCAAGGTCGTGTCTCAGAAAAACAAAAA"
"chr1","6255485","6255642","chr18","55799233","55799394","68","49543748","CGTAGCCAGGCATAGTGGTGCAGGCCTGTAGTCCCAGCTACTTGGAAGGCTGAGTGGGGAGGATCCCTTGAGCCCAGGAGTTCCATGCCACAGTGAGCTATGATCTCACCACTGCACTCCAGCCTGGGTGATAGATCAAGACCCCATTTCTAAAAAAA","GGCTGAGAGAGGTGGCTCATGCTTGTAATCCCAGCACATTGGGAGGCAAAGGTGGGAAGATTGCTTGAGGCCAGGAGTTCAAGACCAGCCTGGGCAACATGAAAACACTTTGTCTCTACAATAAATAAATAAATAAATAAATAAATAAAAGAAACAAGAAAA"
"chr1","6255951","6256094","chr19","6391716","6391877","43","135765","GGCCAGGCACTATGGCTCACGCCTGTAATCCCAACACTTTGGGAGACCAAGGCGGGAAGACTGCTTGAGGCCAGGAGTTTGAGACCAACCTGGGCAACACTGCAAGACCCCTTCTCTATAATAAAATTAAAATTAGCCAGGCAG","CCAGGCGCAATGGCTCACGCCTGTAATCCCAACACTTTGAGAGGCCGAGGCAAGAGGATTGCTTGAGGCCAGGAGTCCGAGACCAGCCTGGGCAACACAGCGAGGCCTCATTCTCTACAAAAAATAAATATATAAATAAATAAATAAATAAGAAGAAGAAAA"
"chr1","6318065","6318355","chr8","25360790","25361095","67","19042725","GGCCAGGTGCAGTGGCACATGCCTGTAATCCCAGCACTTTGGGAGATGGAGGCGGGAGGATTGCCTGAGCTTAGGAGTTCAAGACCAGCCTGGGCGACATAGGGAGACCCCTGTCTCTACAAAAAAATAAATAATAAGCCGGGCATGGTGGCCTGCACCTGTGATCCCAGCTACTGGGAGGCTGAGGTGGGAGGATCGCTTGAGCCCAGGAGGTCGAAGTTGCAGTGAGCCATGATCGTGCCACTGCACTTCAGCCTGGGCAACAGAACGAGACCCTATCTCAAAAGAAAA","GGCTGGGAGCAGTGGCTCATACCTGTAAGCCCAGCACTTTGGGAGGCTGAGGTGGGAGGATTGCTGAAGCCCAGGAGTTTGAGACCAACCTGGGCAATGTAGGGAGACCCCGTCTCTACTAAATAAATAAATAAATAAATAAATAAAGTCGGGCATGGTGGCATGTGCCCTGTAGTCCCAGCTTCTTGGGAGGCTGAGGTGGGAGGATTGCTTGGGCCCAGGAATCAAGGCTGCAGTGAGCTGTGATTGTGCCACTGTACTACAGCCTGGGTGACAGTGCAAGACTGTCTCAAAAGAAAAACAAAA"
"chr1","6342458","6342639","chr19","13525969","13526165","74","7183511","AAAAAAAAGTTAGGTGTGGTTGCATGTGCCTGTAGTCGCAGCTACTCAGGAGGCTGAGGCTGGAGGATCGCTTGAGCCCAGGAGGAGTTTGAGGCTGCAGTGAGCATGATTGTGCCTGTGAATAGCCATTGCATTCCTGCCTGGGCAACACAGCAAGGTCCTGTCTCTATAAATGATAATAA","AAGAAATAAATTAGTTGAGCATGGTGGTGCATGCCTATAGTCCCAGCTACTGGGGAGGCCAAAGTGGGAGGATTGTGTGAGCCCAGGAGTTTGAGGCTGCAATGAGCCAAGATTATGCACACCAGTGTGGGAGACAGTCAAGTCTCAAAAAATAAACAACAACAACAACAACAACAACAAACACATAAAAAGAAAAA"
"chr1","6402115","6402257","chr9","47045786","47045941","47","40643671","GACCAGGCTCAGTGGCTGACTCCTGGAATCCCAGCACTTTGGGAGGCCAAGGCAGGAGGATCACTTGAGGCCAGGGGTTCAAGACCAGCCTGGGCAACATACAGAGACCCCACCTCCACAAAAAATTAAAAAATTAGCCGAGT","GCTGGGCGCAGCAGCTCACACCTGTAATCCCAGTGCTTTGGAGGTCCAAGGTAGGAGGATTGCTTAAGACTAGGTGTTCAAGACCAGTCTTGGCAACATAGTGAGAACTCATCTCTACAATAAATAAATAAATAAATAAATAAATGAAAATAAAAA"
"chr1","6402560","6402736","chr2A","60286019","60286209","63","53883459","TTAGCCGGTTGTGGTGGCACACACCTGCAGTCCCAGCTACTCTGGAGGCTGAGGTGGGAGGATTGATTGAACCCAGGAAGCAGAAATTGCAGTGAGCCAAGATCACACCAATGCACTCCAGCCTGGGTAACAGAGCGAGACTCCGTCTCAAAAAAAAAAAAAAAAGAAAAAAAGAAA","AAAATTAGCCAGGTGTGATGGCACCTGTAGTCCTAGCTACTTGGGAGGCTAAGGTGGGAAGAGGGCTTGAGCCCAAGATTGTGAGGCTGTGGTGAGTCATGACTGTGCCATTGCCCTCTGGCCTGGGTGACAGAGTGAGAAGCTGTCTCAAATAAATAAATAAATAAATAAATAAATAAAAATAAACAAAA"
"chr1","6483466","6483681","chr14","51003183","51003398","53","44519717","CCAGCCCGGGCCACACAGTGAGATCCTGCCTCTACAAAAAACAAACAAAATTAGCCGGGTGTGGTGGCGCTCTCTTGTAGTCCCAGCTACTTGGGAGGCTGAGGTGGGAAGATTGCTGGAGCCCAGGAGGTTGAGGCTGCAGTGAGCCATGATCACATTGCTGCACTCCAGCCTGGGCGACACAGTGAGACCCCGTCTCAGAAAAAAATTTAAAAA","AGCCTGGGCAAGATAGTGAGACCTCATCTCTTAAAATAAATAAATAAATAAATAAATAGCAGGATGTGGTGGCGTGCATCTGTAGTCCCAGCTACTCAGGAGGCTGAGATGGGAGGATTACTTGAGCTCAGGAGGTCGAGGCTGCAGTGAGCTATGATCACGCCACTGTACTCCAGCCTGGGTGAGAGTGATACCCTGTCTCTAACAAAAAAAAAA"
"chr1","6499808","6500000","chr14","51003183","51003398","60","44503375","GTGAGACCTCCGTTGCTATAAAAAAATTAAAAAGTTAGCCAGGTATGGTGGTGTGCACCGGTGGTCCCAGCTACTCGGTAGGCTGACGTGGGAAGATCACTTGTGCCCAGGAGGTCGAGGCTGCAGTGAGCCCTGATCACAACACTGCACTCCAGCCTGGGTAACAGAGCAAGACCCTGTCTCAAAAAATAAA","AGCCTGGGCAAGATAGTGAGACCTCATCTCTTAAAATAAATAAATAAATAAATAAATAGCAGGATGTGGTGGCGTGCATCTGTAGTCCCAGCTACTCAGGAGGCTGAGATGGGAGGATTACTTGAGCTCAGGAGGTCGAGGCTGCAGTGAGCTATGATCACGCCACTGTACTCCAGCCTGGGTGAGAGTGATACCCTGTCTCTAACAAAAAAAAAA"
"chr1","6525145","6525301","chr9","47045786","47045941","58","40520641","GCTGGGCATGGTGGCTCATGCACACCTGTAATCCTAGCACTTTGGGAGGCTGAGGCGGGAGGATTGCTTGAGCCTCGGAGTTCCAGGCTGGAGTACACCAACTACTCCAGCCTGAGCGACAGAGTAAGACCTTATCTTTTAAAAAAGAAAAGAAAAA","GCTGGGCGCAGCAGCTCACACCTGTAATCCCAGTGCTTTGGAGGTCCAAGGTAGGAGGATTGCTTAAGACTAGGTGTTCAAGACCAGTCTTGGCAACATAGTGAGAACTCATCTCTACAATAAATAAATAAATAAATAAATAAATGAAAATAAAAA"
"chr1","6542904","6543193","chr8","25360790","25361095","62","18817886","GGCTGGGCACCGTGGCTTCTGCCTGTAATCCCAGCACTTTGGGAAGCTGAGGTAGGAGGATTGCGTGAGCCCAGGAGTTTCGGACCAGCCTGGGCAACGTAATGAGACCCTGTCTCTACAAAAAATTTAGAAATTAGTCAGGCATGGTGGCATGTGCCTGTGGTCCCAGCTACTTGGGAGGCTAAGGAGGGAGTATTGCTTGAGCCCAGGAGGTCGAGGCTGCAGTGAGTTCTGATCACTGCACTCCAGCCTGGGTGACTCGGTGACACCCTGTCTCAAGAAAAAATAAA","GGCTGGGAGCAGTGGCTCATACCTGTAAGCCCAGCACTTTGGGAGGCTGAGGTGGGAGGATTGCTGAAGCCCAGGAGTTTGAGACCAACCTGGGCAATGTAGGGAGACCCCGTCTCTACTAAATAAATAAATAAATAAATAAATAAAGTCGGGCATGGTGGCATGTGCCCTGTAGTCCCAGCTTCTTGGGAGGCTGAGGTGGGAGGATTGCTTGGGCCCAGGAATCAAGGCTGCAGTGAGCTGTGATTGTGCCACTGTACTACAGCCTGGGTGACAGTGCAAGACTGTCTCAAAAGAAAAACAAAA"
"chr1","6594748","6595069","chr7","12886919","12887228","77","6292171","GCTGGGCGTGGTGGTTCACGCCTATAATCCTAGCACTTTGGGAGGCTGAGACAGGAGGGTCACTTGAGGCCAGGAGTGTGAGACCAGCCTGGGTAACACAGCAAGACCCTGTCTCTATAAAAATTTTAAGAATATCCTTTTGTATCTACATATGAGAAAAAAAATTACTGGGTGTGGTGGCACACGCCTGTAGTCTCAGCTATTCAGGAAGGTGCGGTGGGAGGACTGCGAGTCAAGGAGGTGGAGGCTGCAGTGAGCCATGATTGTACCACTGCACTCCAGCCTGGGTGACAGAGCAAGACCCTGTCTCAAAAATAAAAAA","GACTGGGCTTGGTGGCTCATGCCTATAATCCCAGTGCTTTGGAAGGCCCAGGCTGGAGAATTACTTGAGGACAGGAGTTTCAGCCCAGCCTGGGCAACACAGCAAGAATCCATCTCTACAAAATAAATAAATACATAAACAAATAAATAAATAATTAGCTGGGCATGGTGGCACATGCCTGTAGTCCCAGCTACTCGGGAGGCTGAGGCAGGAGGATTGCTTGAGTCCAGGGGGTCAAGGCTGCATAAGCTATGATCATACCACTGCATTCTAGCCTGGGTGACAGAGGGAGACCCTGTCTCAAAAAAAA"
"chr1","6604961","6605166","chr22","26696703","26696888","81","20091742","TTTGAGACCAGCCTGGGCAACATAGTGGGACCCAATATTTTGTCTCAACAAAAAGTTTTCAAATTGGCCAGGCGTGGTGGCATGCACCTTTAGTCTCAGCTACTTGGGAGGCTGAAGTGGGAAGATCACATAAGCCCAGATGACAGTGAGCTGTCATTGTTCCACTGCTCCCACTCTGCCTGCCCCACCCCTGAAAAAAAGAAAGA","CCAGCCTTGGCAACATAGCAAGACCCTGTCTCTATCAATCAATCAATCAATCAATCAATAATCCAGGCGTGATGGCACACACCTGTGGTCCCAACGACCCGGGAGCCTGAGGTGGAAAGATCGTTTGAGCCCAGGAAGTTGAGGCTGCAATGAACTGTGAACATGCTACGGCACTCCAGTCTGGGC"
"chr1","6631009","6631316","chr1","207218281","207218584","70","200587272","GGCCAGGTGCGGTGGCTCCCGCCTATAATTCCAGCACTTTGTGGGGCCAAGGCAGGAGAATCCCCTGAATCCAAGAGTTTGAGACCAGACTGGGCAAGATAGCAAGACCCCCATTTCTAAAAAAAAAAAAAAAAAAAATTTTTAATTAGCTGGGCATGGTAGCACATGCTTGTGGTCCCAGCCACTTGGGAGGCTCAGGTGGGAGGATGGCTTGATCCTGGGAGGTTGAGGCTGCTGCGAGCCATGACTGCACCACTGTACAGAGCCTGAGCAACAGAGTGAGACCCTGTCTCAAAAACAAAGAAAAA","GCCAGGCACAGAGGCTCATGCCTGTAATCCCAACACTTTGGGAGGCCGAGACAGGAGGATCACTTCAGGCTAGGAGTTGAGACCAGTCTGGGCAATATAGTAAGACCCTATCTCTATTAAAAAAAAAAAAAAAAAAAAAAAAAAGCTGGGTATGGTGGCACATGCCTGTGTTCCCAGCTACCTGGGAGACTAAGGTGGGAGGACTGCTTGATCCCAAGAATTTGAGGCTGCAGTAAGCTATGACTGCACCACTGCACTCCAGCATGGGCGACAGAGCGAGACCTTGTCTCAAGAAAACAAAAAA"
"chr1","6642558","6642686","chr9","47045786","47045941","57","40403228","GGCTGGGCGCTGTGGCTCACACCTGTAATCCTAACACTTTAGGAGGCCGAAGCGGGAGAACTACTTGAAGCCAGGAGTTCAAAACCAACCTGGGCAACCAAGTGAGACCCTGTCTCTATAAAAATAAAA","GCTGGGCGCAGCAGCTCACACCTGTAATCCCAGTGCTTTGGAGGTCCAAGGTAGGAGGATTGCTTAAGACTAGGTGTTCAAGACCAGTCTTGGCAACATAGTGAGAACTCATCTCTACAATAAATAAATAAATAAATAAATAAATGAAAATAAAAA"
"chr1","6668610","6668731","chr15","37343640","37343763","65","30675030","CCAGACATGGTGGCTCGTGCCTGCAATCCCAGCACTTTGGGAGGCTGATGTGGGAGGATCCTTTGAGGCCAAGAGTTTGAGGCCAACCTGGGCAATATAGCAAGACCCCGTTTCTACAACAA","AAGATCCCTGGCCAGGATTTCAAGACCAGCCTGGGCAACACAGTGAGACCATACATACATACATACATACATACATACATCATACATACATACATACATACATACATACACAGTCTTACAAAGA"
"chr1","6676398","6676666","chr10","28570518","28570799","69","21894120","GGCTGGGTGCGGTGGCTCACACCTGTAATCCCGGCGCTTTGGGAGGCTGAGGGGGGAGGGTAGCTTCAGGCTAGGAGTTTGAGACCAGCCTGGGCAACATAGAAAGACCCCATCTCTACAAAAAATTTAAAAATTAGCTAGGCATGGTGGTGTGTGCCTGTAGTCGCAGCTACTTGGGAGGCTGAGGTAGGAGACTCACTTGAGCCTGGGAGGTCGAGGGTGCAGTGAGCCATGATGGCACCAACACACTGCAGCCTGGGCGACAGAGC","GACTGGGCGCAGTGGCTCACACCTGAATTCCCAGTGCTGAGGGAGGCTGAGGCAGGAGGAGTGCTGGAGGCCAGGAGTTCAAGACCAGTCTGGGCAACATAGTGAGACTCCATCTTTACAAAAAATAAAATAAAATAAAATAAAATTAGCCAGGCAAGGTGGTGTGTGCCTGTAGTCCCAGCTACTTGGGAAGCTGAGATGGGAGGATTGCTTGAGTCTGTGAATTAGAGATTACAGTGAGCTATGGTTATACCACTGCACATTCTGGGCTGGGCAATAGAG"
"chr1","6677293","6677594","chr19","44841372","44841689","77","38164079","CCAGGCAAAGTGGCTCACACCTGTAATCCTAACACTCTGGGGAGCCAGGCTGGGAGGATCACATGAGGCCAGGAGTTCGAGACCAGCCTGAGAAACATAGCAAGACCCTGTCTCTACAAAACATTTTTTTAAAAATTAGTCGGGCTTGGTGGCGCACACCTGTATTCCCAGCTATTCAGGAGGCTGAGATGGGAGAATCACTTGAGCACAGGAGGTTGAGGCTGCAGTGAGCTATGATCACGCCACTACACTCTAACGTGGGCAACAGAGCAAGACCCTGTCTCACAAAAAAAAGAAAGAAA","GGACAGGTGCAGTGGCTCATGCCTGTAATCCCAACACTTTGGGAGGCCAAGGTGGGAAGATTGCTTGAACCCAGGAATTCGTGACCAGCCTAAGCAACACAGCAAGACCCCATGTCTAAAAATAATAATAATAATAATAATAATAATAAATTAGTCAGGCATGGCGGCATACGCCTGTAATTCCAGCTACTTGGGAGGCTGAAGTGGGAGAATCACTTGAATCGAGGAGGTGGAGGCTGCAGCGAGCCATGATCATGCCACAGCACCCCAACCTGGGCAATGGAGCAAGACCCTGTCTCAAAAAAAATTAAGAGAAAA"
"chr1","6678673","6678947","chrX","3592780","3593062","79","3085893","GCTGGGTGCAGTGGCTCACACCTGTAATCCCAACACTTTGCAAGGCCAAGGCAAGAGAATCATTTAAGGCCAGGAATTCGAGATCAGCCTAGGCAACATAGTGAGACCCCATCTCTACAAAAAATAAATTAGCTGGGCATGGTGGCACACACCTGTAATCCCAGCTGCTTGGGAAGCTAGAGCAGGAGGATTAGTTAAGCCCAGGAATTCAAGGCTGCAGTGAGCTATGATCTTACCATTGCACTCCAGCCAGGACAACAGAGAAGGACCCTGTC","GTGGTGGCTCATGTCTGTAATCCCAGCACTTCAGGGGGCCAAAGCGAGAGGACTGCTTGAGGCCAGGAGTTTGAGACCAGCCTGCGCAACATAGAAAGACCCCATCTCTATAAATAAATAAATAAATAAATAAATAAGTCAGGCATGGTGGCACATGCCTGTAGTCCCAGCTACTCAGAAGGCTGAGGTCGGAGGATCTCTTGAGCCCAGGGGTTCAAGGCTGCAGTGAACCATGATCACACCAGTGCACTGCAGCCTGGGCAACACAGCAAAACCCTGTCCC"
"chr1","6684986","6685165","chr9","47045786","47045941","59","40360800","GGCTGGGTGCAATGGCTCACACCAGTACAGTAATCCCAGCACTTTGGTATCCCAAGGTGGGAGGATCGCTTGAGGCCAGGAGTTCAAGACCAGTTTGAGCAACATAGCGAGATCCTGACTCTACAAAAAAATTTAAAAAAATTATCCAGGTGTACTTCCAGCACCTCAGGAGGCTAAGGC","GCTGGGCGCAGCAGCTCACACCTGTAATCCCAGTGCTTTGGAGGTCCAAGGTAGGAGGATTGCTTAAGACTAGGTGTTCAAGACCAGTCTTGGCAACATAGTGAGAACTCATCTCTACAATAAATAAATAAATAAATAAATAAATGAAAATAAAAA"
"chr1","6704662","6704972","chr12","94594421","94594744","84","87889759","GGCCAGGCACGGTGGCTCACACCTGTCATCTCAGCACTTTGAGAGGCTGAGGCGGGCAGATCACTTGAGACGGGAGTTCCAGACCAGCCCTGCAATGTAGCAAGACCCTGTCTCTACAAAAAATACAAAGCTTAACCAGGTATGGTGGCGGGCACCTGTAGTCCTAGCTACTATGGAGGCTGAGGTGGGAGAATTACCTAAGCTTGAAGAGGTGGAGGCTGCAGCAAGCCATGATTGCACCACTGTACTGCAGCCTGGGTGACAGAGGGAGACCCCGTCTCAAAAAAAAAAAAAAGAAAGAGAAAAGAAAA","GGCCAGGTGCAGTGGCTCATGCCTGTAATCCCAGCACTTAGGGAGGATGAGGTGGGAGGATTGCTTGTGTCTAGGAGTTCAAGACCAGCCTGGGCAACATAGCAAGATGCCATCTCTACAAAAAATAAAAAGTTAGCCAGGTGTGGTGGTGGGCACCTGTAGTCCCATTTACTTGGGAGGTGGAGGAGGGACGATCACTCGAGCCTGAGAGGTCGAGGCTACAGTGAGCTGTGATCATGCCACTGCAGTACTTCCTGGGTGACAGAGCAAGACCCTGTCTCAATAATAATAATAATAATAATAATAAAATAAAAAGAAAGGAAA"
"chr1","6717242","6717406","chr19","6391716","6391877","62","325526","CTGGGCATGGTAGTGCACGCCTGTAGTCCCAGCTACTTGAGAGGCTGAGGTGGGAGGATTGCTTGAGCCCAGGATTTGGAGGCTGCAGTTAGCTATGATCATGCCACTGCACTCCAGCCTGGGTGACAGAGCAAGACCCAGTCACTAAAAATAAAAATTAAAAAA","CCAGGCGCAATGGCTCACGCCTGTAATCCCAACACTTTGAGAGGCCGAGGCAAGAGGATTGCTTGAGGCCAGGAGTCCGAGACCAGCCTGGGCAACACAGCGAGGCCTCATTCTCTACAAAAAATAAATATATAAATAAATAAATAAATAAGAAGAAGAAAA"
"chr1","6733916","6734083","chr19","13525969","13526165","72","6792053","TACAAAGAAATTTTACAGGTATGGTGGCGCGCCTGTAGTAACAGCTACTTGGGATGCCAAGGTGGGAGGATTGTTTGAGGTTGGGAGTTCAAGGCTGCAGTGAGCTATGATCGCACCCCAGCACTCCAGTCTGGGTGACAGAGCGAGACCCTGTTTCAAAAAAAGAAA","AAGAAATAAATTAGTTGAGCATGGTGGTGCATGCCTATAGTCCCAGCTACTGGGGAGGCCAAAGTGGGAGGATTGTGTGAGCCCAGGAGTTTGAGGCTGCAATGAGCCAAGATTATGCACACCAGTGTGGGAGACAGTCAAGTCTCAAAAAATAAACAACAACAACAACAACAACAACAAACACATAAAAAGAAAAA"
"chr1","6734318","6734418","chr8","58489091","58489211","64","51754773","TGGCCCATGCGTGTAATCCCAACACTTTGGGAGGCCGAAGTGGGAAGACTGCTTGAGATCAGCAGTCTCAAAAAAAAATCTTGTTTTTTTTGAGACAGGGT","TTGAGACCAGGAGTTTGAGACCAGCTTGGACAACATAGTGAGACCCTGTCTAAAAGAAAGAAAGAAAGAAAAGAAAGAAAGAAAGATGTAGCCAAGTGTGGTGGTGCACATCTGTGTCTCA"
"chr1","6749842","6750136","chrX","46692258","46692555","74","39942416","GCCAGGTGAGGTAACTCATGCCTGTAATCTCAGCACTCTGGGAGGCCAAGGCAGGAGGACCACTTGAGCCCAAGAGTTTAGACAAGCCTGGGCAACATAGCGAAACCTCATCTCTACAAATATTTTTTAAAAAAATAATCGGGCATGGTGGTGTGCATCTGTGGTCCCAGCTACTCAGGAGGAAGGTTGAGGTGGGAGGATGGCTTGGGCCCAAGATGTTGAAGGCAGTGAGCTATGATCATGCCATTGCACTTCAGCCTGGGCAACAGAATGAGACCCTCTCTCAAAAGAAGAA","GGCCAGGCATGGTGGCTCATGCCTGTAATCCCAGCACTTTGGGAGGCTGAGGAAAGATGATCACTTGAGCCAGGAGTTTGAGCCCAGTCTGGGTAACATAGTGAGACCTCCATCTCTACAAAAAAAAAAAAAAAAAAAAAAAAAAGCTGGGCATGGTAGCACACATCTGTAGTGTCAGCTACTCAGGAGGCTGAGGTAGGAGGATTGCTTGGGCCCAGGAGATCAAGACTGCAGTGAGCTATGACTGCACCACTGCACTCCAGCCTGGGCAATGGAGTGAGACCCTGTCTCAAAAAAA"
"chr1","6750816","6751129","chr14","31798968","31799292","72","25048152","GGGCATGGTGGCTCATGCCTGTAATCCCAACACTTTGGGAGGCTGACATAGAAAGATCGCTTGAGGCCAGGAGTTCAAGACCAGCCTGGGCAACATAGCAAGACTCTATCTCTACGCAAAAAAAAAAAAATTAATTAGTGGGGTGTGGTGGCACATGCCTGCAGTCCCAGCTACTCAGAAGGCTGAGGCAGGAGGGTTGCTTGATCACAGGAATTGGAGACTGCAGTGAGCTATGATTGTGCCACTGCACTCCAGCCTGGAGGAGACAGCAAGCCCCTCTATGAAAAAAAAAAAAAAAGAAATCAAGAAAGAAA","GGCTGGGCACAGTAGCTTACACCTGTAATCCCAGTACTTTGGAAGGCTGAAGTGGGAGGATCCCTTGAGGCCAGGAGTTTGAGACCAGCCTGGGCAACATAGTGAGACCCTGTCTCTACAACAAACAAACAAACAAACAAACAAAACTTAGCCAGTTGTGGTGGCACATCCTATAGTCCCAGCTACTCAGGAGGCTGAGGAGGGAGGATCTCTTGAGCCCAGGAGTTTGAGGCTGCAGTGAGCTATGATCATGACACTGCACTCCAGCCTGGATAACACAGCAAAATCCTGTCTCAAAAAAAAAAAAAAAAAAAAAAAAAAAGAA"
"chr1","6756876","6757216","chrX","16472440","16472771","85","9715564","GGCTGGGCACGGTGGCTCACACCTACAATCCCAGCACTTTGGGCAGCTGAGGCAGGAAGGTTGCTTGAGCCCAGGAGTTCAGGACCATCTTGGGCAATATAGATAGACCTCATCTCTACCAAGATTTTTTTTTTTAATTAGCTGAGCATGTGGCACACACCTGTAATCACAGCTTCTCAGAAGGCTGAGGTGGGAGGATTGTTTGAGCCCGGGAGGTTGAGACTGCAGTGAACCAGATCATGCTACTGTACTCCAGCCTGGGCAACAGAGGAAGAGCCTATCTCAACAAACAAAAAAAATAAATAAATAAAAAAGAAAGAAAGAAACAAAAGAAAAAGAAA","CTGGGCATGGTGGCTCGCACCTGTAATCTCAGCACTTTGGGAGGCCAAGGTAGGAGGATTGCTTGAGGTCAGGAGTTCAAGACCAGCCTGGACAACATAGGGAGACCCCCCCCACCAACCATCTCTTAAAAAAAAATAGCCAGGTGCAGTGCCATGCACCTGTGGTCCCAACTACTCGGGAGGCTGATGTGGGAAGATCGTTTGAGCCCAGGAGGTTGAGATTGCAGTCAGCCATGATTGTGCCACTGCACTCCAGCCTGGGCAACAGAGGGAGACTCTGTCTCAAATAAATAAATAAATAAATAAATAAATAAAAGAAAAGAAAGAAAGAA"
"chr1","6759142","6759270","chr9","47045786","47045941","60","40286644","GGTGGTGCAGTCCTGTAGTCCTAGCTACTTGAGAGGCTGAGGTGGGAGGATCGCCTGAGCCCAGGAGTTTGAGACCAGCCTGGACAATACAAGGAGACCTGGAGTCTCTACAAATAATTTAAAAATTAA","GCTGGGCGCAGCAGCTCACACCTGTAATCCCAGTGCTTTGGAGGTCCAAGGTAGGAGGATTGCTTAAGACTAGGTGTTCAAGACCAGTCTTGGCAACATAGTGAGAACTCATCTCTACAATAAATAAATAAATAAATAAATAAATGAAAATAAAAA"
"chr1","6759572","6759736","chr5","32595015","32595178","64","25835443","TTAGCTGGGCATGGTGGCGCGTGCCTGTGATCTCAGCTACTTGGGAGGCTGAGGTGGGAGGATCACCTGAGCCCAGGAGGTCGAGGCTACAGTGAGCCATGATTGTTTCATTGCATTCCAACCTGGACTACAGAGTGAGACCTTGTATCTAAAACATAAATAAAA","GGCCGGGTGTGGTCCCTCATGCCTGTAATCCCAACACTTTGGGAGGCTGAGATAGGAGGACTGCTTGAGGCCAGGAGTTCAAGACCAGCCTGGTCAACATAGTGAGACCCCATCTCTATAAAATAATAATAATAATAATAATAATAATAATAAATAAATAAATA"
"chr1","6773169","6773474","chr1","136656911","136657239","80","129883742","GGCTAGGCCCAGTAGTTCATGCCGTAATCCCAGCACTTTGGGGCCGAGGCAGAATAATCACTTGAGGCCATGAGTTCTAGATCAGTCTGGGCAACACAGCAAGATGTCACTACAAAAGAATATAAAAGATTAGCAAGGTGTGGTGGTGCGCACCTGTAGTCCCAGCTACTCAGGAAGCAAAGGCAGAAGGATCACTTGAAGCCAGGAGTTCGAGGGTGCAGTAAGCTATGATTGCGCCACTGCACTTCAGCCTGGGTGACAAAGCAAGACCCTGTCTCAAAAAAAAAAAAGAAGAAGAAGAAGAAA","GCCAGGCACAGTGGCTCACACCTATAATCCCAACACTTTGGGAGACCAAGGCAGGAGAATCACTTGAGGCCAGGAGTTTGAGACCAGCCTGAGCAACATAGCAAGACCTTGGCTCTACTAAAAAAATAATAAAATAAAATAAAATAAAATAATTAGCCAGGCATGGTGGCATGCACCTGTAGTCCCAGCTACTCAGGAGGCTGAGGCAGGAGGATGGCTTAAGTCCAGGTGTTCAAGGTTGCAGCAAGCTATGATTGCCACTGCACCCCAGCCTGGGTGACAGAGCAAGTCCCTGTCTCAAAAAAATAGATAAATAAATAAAAATAAAA"
"chr1","6773494","6773655","chr5","32595015","32595178","64","25821521","GCCAGGCATGGTGGTTCATGCCTGTAACCCCAATGCTTTGTGAGGCTGATGGGGGAAGACCATTTGAGCCCAGGAGTTCAAGGGTATAGTGAGCTATGATTATGCCACTGCACTCTAGCCTGGCAACAGAGTGGGACCCTGTCTCAAAAAAAAAAAAAAAAA","GGCCGGGTGTGGTCCCTCATGCCTGTAATCCCAACACTTTGGGAGGCTGAGATAGGAGGACTGCTTGAGGCCAGGAGTTCAAGACCAGCCTGGTCAACATAGTGAGACCCCATCTCTATAAAATAATAATAATAATAATAATAATAATAATAAATAAATAAATA"
"chr1","6773719","6774017","chr8","25360790","25361095","71","18587071","GGCTGGGTGAGGTGGCTCACGCCTGTAATCCCAGCACTTTGGGAGCCCAAGGTGGGTGGATGGCTTGAGGCCAGGAGTTCGAGATCAGCCTGAGCAACATGGCAAAATCCTGTCTTTACAAAAAATACAAAAGTATGCCAAGTGTGGTGGTGCACGCCTGTAGTCCCAGCCACTTGGGAGTCTGAGGTGGGAGGATCATCTGAGTCCAGGGATGCAGAGGTTGCAGTGAGCTGTGGTTGTGCCACTGCACTCCAGCCTGGGTGACAGAGCAACACACTGTCTCAAAAAATAAAATAAAA","GGCTGGGAGCAGTGGCTCATACCTGTAAGCCCAGCACTTTGGGAGGCTGAGGTGGGAGGATTGCTGAAGCCCAGGAGTTTGAGACCAACCTGGGCAATGTAGGGAGACCCCGTCTCTACTAAATAAATAAATAAATAAATAAATAAAGTCGGGCATGGTGGCATGTGCCCTGTAGTCCCAGCTTCTTGGGAGGCTGAGGTGGGAGGATTGCTTGGGCCCAGGAATCAAGGCTGCAGTGAGCTGTGATTGTGCCACTGTACTACAGCCTGGGTGACAGTGCAAGACTGTCTCAAAAGAAAAACAAAA"
"chr1","6799086","6799367","chr8","15910614","15910909","78","9111528","GCCAGGCACAGCGGCTCATGCCTGTAAGCCTGGCACTTTGGGAGGCTGAGACAGGATGACTGCTTGAGGCCAGGAGTACAAGACAAGCCTGCGCAACATAGCAAGACCCTTTCTCCATAAAATTAAAAAAGAATTAGCCGGGTGTGGTGGCACACGCCCGTAGTCCTCACTACTCAGGAGGCTGAGGCAGGAGGATCACTTGAACCCAAGAGTTCAAGGTTGCAGTGAGCTGTGATGGCACTCTAGCCTGGGTGACAGATCAAGACTCTTGTCTCTAAAAAA","GGCCAGGCGAAGTGGCTCACACCTGTAATCCCAGCACTTTGGGAGGCCAAGGCAGGAGGATCATTTGAAGCCAGGAGTTCAAGGCCAGCCAGAGAAACATAGTGAGAACCTGTCTTTACAAAAATTAAAATTAAAATTAAAATTAGCCAGGAGTGGTGGTGCATGCCTGCAGTCCCAGCAGCTCAGGAGGCTGAGGTGGGATGATTGCTTGCACCAGGAGTTCGAGGCTGCAGTGAGCTGTGATCGTGCCACTGCACTCCAGCCCCTGGGTGACAAAGCAAGATCCTCTAAAAAAA"
"chr1","6802741","6803048","chr8","25360790","25361095","82","18558049","GGCCGGGCACGGTGGCTCACGCCTGTAATCCCAGCCCTTTGAGAGACTGAGGCAGGTGGATTGCTTGAGCTGGCCAAGAGTTCAAGACCAGCCTAGGCAACATAATGAAACCCCTGTCTCTACTAAAAACATAAAAATCAGCCGGGCGTTGTGGCATATGCCTGTGTTTTCCAGCTAAGTCCTCAGCTTGGGGGGCTGAGGTGGGAGGATCACTTGAGCCCAGGCTGTCGAGGCTTCAGTGAGCTGAAATTGTGCTACTGCACTCCAGCCTGGGCGACAGAATAAGACCTTGTCTCAAAAAAAAAAAA","GGCTGGGAGCAGTGGCTCATACCTGTAAGCCCAGCACTTTGGGAGGCTGAGGTGGGAGGATTGCTGAAGCCCAGGAGTTTGAGACCAACCTGGGCAATGTAGGGAGACCCCGTCTCTACTAAATAAATAAATAAATAAATAAATAAAGTCGGGCATGGTGGCATGTGCCCTGTAGTCCCAGCTTCTTGGGAGGCTGAGGTGGGAGGATTGCTTGGGCCCAGGAATCAAGGCTGCAGTGAGCTGTGATTGTGCCACTGTACTACAGCCTGGGTGACAGTGCAAGACTGTCTCAAAAGAAAAACAAAA"
"chr1","6834638","6834930","chr1","213591659","213591963","81","206757021","GCGGGAGCTCCCACCCATAATCCCAGCACTTTGGGAGGCTGAGGCAGGAAGACTGCTTGAGCCCAGGAGTTCAAGACCAGCCTGGGCAACATGGCGAGCGAGATTCCATCTCCAAAAACAATGTATAAATTAGCTGGGCGTGGCACACGCCTATAGACCCAGCTACTCAGAAGGCTGAGGTGGGAGGATAGCTTGAGCCCGGAAGGTCGAGGCTGCGGTAAGTTATGATTGCGCCACTACACTCCAGCCAGGACAACAGAGCACGACTCTGTCTCAAAAAAAAAAATTAAAAA","GTGCAATGGCTGATGTCTGTAATCCCAGCACAGTGGGAGGCCAAGGCAGGAGGATTGCTTGAGGCCAGGGATTCAAGACCAGCCTGGGCAACCTAGTGAAACCTCATCTCTATTAAAAATAAAAATAAAAATAAAAATTAGTTGGGCATGGTGGCACACACCTGTGGTCCCAGGAGTCCTCAGGAGGCTGAGGTAGGGGGATCACTTGAGCCCAAGAGTTGAGGTTGCAGTGAGCTATGATTGCACCACTGCACTCCAGCATGGGCAACAGAGTGAGACTTTGTCTCAAAACAAAACAAACAAAA"
"chr1","6838774","6839056","chr8","15910614","15910909","74","9071840","GGCTGAGCACGATGGCTCACACCTGTAATCCCAGCACTTTGGGAGGCTGAGGCAAGAGGATCATTTGAGGCCAGGAATTCAAGACCAGCCTGGGCAAGACAGCAAGATCCTGTCTCCACAAAAAATAAAAAACGTTGCCAGGCATGGTGTCCCATGCCTGTAGTCCTAACCATTCAGGAGGCTGAGGCAGGAGGATCTCTTGGGTCCAGGAATTTGAAGCTGCAGTGAGCTATAATCGCACCATTGCACTCCAGCCTGGGTGACAGAGAGAGAATCTGTCTCA","GGCCAGGCGAAGTGGCTCACACCTGTAATCCCAGCACTTTGGGAGGCCAAGGCAGGAGGATCATTTGAAGCCAGGAGTTCAAGGCCAGCCAGAGAAACATAGTGAGAACCTGTCTTTACAAAAATTAAAATTAAAATTAAAATTAGCCAGGAGTGGTGGTGCATGCCTGCAGTCCCAGCAGCTCAGGAGGCTGAGGTGGGATGATTGCTTGCACCAGGAGTTCGAGGCTGCAGTGAGCTGTGATCGTGCCACTGCACTCCAGCCCCTGGGTGACAAAGCAAGATCCTCTAAAAAAA"
"chr1","6848163","6848448","chr8","15910614","15910909","90","9062451","GGCCAGATGCAGTAGCTTATGCCTGTAATCCCAATACTTTGGGAGGACGAAACGGGAGGACCACTTGAGACTAGGAGTTCAAGGCCGGGGAAATGTAGGGAGACTCTGTCTTTACAAAATAAAAATAAAACTATTAGCCAGATATGGTGGTGCACCCCTGTGGTCTCAGCCACGCTGGAGGCTGAGGTATGAGAGGATTGTTTGAGGCCAAGGAGTTGAAGTCTATGGTGAGCTATGATCAAGCTGGGAGACAGAGTGAGACCTTCAAAGAAAACAACAACAAAAA","GGCCAGGCGAAGTGGCTCACACCTGTAATCCCAGCACTTTGGGAGGCCAAGGCAGGAGGATCATTTGAAGCCAGGAGTTCAAGGCCAGCCAGAGAAACATAGTGAGAACCTGTCTTTACAAAAATTAAAATTAAAATTAAAATTAGCCAGGAGTGGTGGTGCATGCCTGCAGTCCCAGCAGCTCAGGAGGCTGAGGTGGGATGATTGCTTGCACCAGGAGTTCGAGGCTGCAGTGAGCTGTGATCGTGCCACTGCACTCCAGCCCCTGGGTGACAAAGCAAGATCCTCTAAAAAAA"
"chr1","6880076","6880373","chr12","22057795","22058093","94","15177719","GGCTGGGCCTGGTGGCTCATGCCTGTAACCCCACACGTTGGGAGGTTGAGACAGGAGGATCATTTGAGGCCAACAGCTCGAGACCAACCTGGACACATAGTGAAACCCTGTCTATACAAGAAAAACAAAAAAGTTAGCTGGGCGTGGTGGTATGCACCTCTGGTCCCAGCTACTCCAGAGGCAAGCCTAGGCATTTGAGGTCACAGTGATGATCATCGTGCCACTGAACTCCAGGCTGGACAACAGAATAAAACCCTGTCTCTATTAAATTAAAGATAAATATAAAAAATAAATAAAA","GTGCGGTGGCTCACACCTGTAATCCCAGCACTTTGGGAGGCCAAAACAGGAGGATTCCATGAGGCCGAGAGTTTGAAACCAGCCTGGGAAACATAGTGAGACCTGTCTCCACAAAATAAAAATAAAAATAAAAATAAATTAGCCAGGCATGGTGGTGCATGCCTGTAGTCCCAGGAGCTACTCAGAAGGCAGGAAGAGGAGTTGGAGGCTACCATGCCATGACTGTGGGGGCACTGCACTCCAACCTGGACAACAGAGGAAAACCCTGTCTCCAGAAAAAAAAGAAAAAAGAAAAAAAA"
"chr1","6942388","6942688","chr19","13342110","13342403","67","6399722","GTGGCTCATGCTATAATCCCAGCACTTTGGGAGGCTGAAGCAGGAGGATCACTTGAGTCCAGGAGTTCGAGAGCAGCCTGGGCAACATAGTGAGACCCCTATTTCTACACAAAAATAATGATAAAAAATTAGCTGGATGTGGTGGCCTATAATCCCAGCTACTTGGGAGGCTAAGGTGAGAGGATCACCTGAGCCCAGGAGATCAAGGTTGCAGTGAGCTATGATTGTGCCATTGCACTCCAGCCTGGGTGACAGAGTGAGACCCTGTCTCTAAAAAAATAAAAAATAAAACCAAAACAAA","TCATGCCTGTAATCCCAGCACTTTGGGAAGCCAGGGCAGGAGGATCACTTGAGACCAGGAGTTTGAGACCAGCCTGGGCAACATAGCCAGACCCCCATCTCAACAACAACATCAACAACAACAACAACAAATTAGCTGGGTGTGGTGGTGCCTGTAGTCCCAGCTACTTGGGAGGCTAAGCTGGGAGGATCGCTTGAGCCCAGGAGCTCCAGGCTGCAGAGAGCTATGATCATATCACTGCACTCCAGCCTGAGTGACAGAGCAAGAACCTGCCTCTAAAAACAATAAACAAAA"
"chr1","6981429","6981735","chr9","57029965","57030284","75","50048536","GGCCAGGCATGGTGGCTCATGCCTGTAATTCCAGCACTTTGGGAAGCTGAGGTAGGAGGATCACTTGAATCCAGGAGTTTAAGACCACCCTAGGCAACATAATAGGGAGAACTTGTCTCCACAAAAAAATTAAAAATTAGCCATGTGTAGTGGTGCATGCCTATGGTCCCAGCTACTCAGAAGGCTGAGATGGGAGGATCACTTGAGCCCAGGAGGTTAAGGCTGCGGTGAGCCATGATCACACTACTGCACTCCGGCCTGGGTTTCAGAGTGAGACCCTGCCTCAAAAAAATAAATAAAATAATAA","GGCTGGGCATGGTGGTTCATGCGTGTAGTCCCAGCACTTTTTCAGGCCAACGTAGGAGGATCACTTGAGGCCTGGAGTTTGAGACCAGCCTGGGCAACAAAGGGAGACCTTGTCTTTACAAATAAATAAATAAATAAATAAATAAAAATTTAGCTGGGCATGGTGGTGCACACCTGTGGTCTCAGCTACTCAGGAGGCTGATGTGGGAGGATCACTTGAGCCCCAGAAGTTTGAGGCTTGCGGTGAGCTATGATCATACCACAGCACTCCAGCCTGGGTGACAGAGCAAAACCCTGTCTCTAAAATTAAAAAAAAAAAAA"
"chr1","7118291","7118514","chr14","51003183","51003398","59","43884892","CAGCCTGGGGAACACATGAAGACCCCAACTCTCCAAAAAAAAATTTTTTTTTTAATTAGCCAGGCATGGTGATGTACTCCTGTGGTCCCAGCTACTCAGGAGGCTGAAGTGAGAGACTCACTTGAGCCCAGGAGATCGAGGTTGCAGTGAGCCAAGACTGCACCACTGCACTCCAGCCTGGGTGGCAGAGCAAGACCCTGTCTCAAAAAAAAAAAAAAAAAAAA","AGCCTGGGCAAGATAGTGAGACCTCATCTCTTAAAATAAATAAATAAATAAATAAATAGCAGGATGTGGTGGCGTGCATCTGTAGTCCCAGCTACTCAGGAGGCTGAGATGGGAGGATTACTTGAGCTCAGGAGGTCGAGGCTGCAGTGAGCTATGATCACGCCACTGTACTCCAGCCTGGGTGAGAGTGATACCCTGTCTCTAACAAAAAAAAAA"
"chr1","7137977","7138291","chr19","48171503","48171823","72","41033526","GGCCAAGCACTGTGGCTCACACCTAGAATCCCAGCACTTTGGGAGGCCAAGGCGGGAGGATTGCTTGAGCTCAGGAGTTAGAGATGAGACCAGCCTGGACAACATAGTGAGACTCCATTTCTACAAAAAATTTTAAAAATTAGCTGGGCGTGGTGGTGCGCACCAGTGGTCCCAGCTACTTGGGTGGCTGATGTGGGAGGATCACTTGTGCCCAGGAGGTCAAGGCTGCAGTGAGCCATGATTGTGCCACTGCACTCCAGCCTGGGCAACAGAGCAAGACTCTGTCTCTCAAAAAAATAAATAAATAAAATAAAA","GCTGGGAGTGGTGGCTCACACCTGTAATCCCAACACTTTGGGAGGCTGAGGCAGGAGGATTGCTTGAGCTCAGGAGTTCAAGACCAGCCTGGAGCCTGGGCAACATAGCAAAACTCCATCTCTAAAAAAAAAAAAAAAAAAAAAAAAATTAGCCAGGTGTCGTGGTGCATGCCTGTAATCACAGCTACTCAGGGGGCTGAGGTGGGAAGATCGCTTGAGCCCAGGAGTCGGAGGTTGCAGTGAGCCAAGACTGTGCCACCGCACTCCAGCCTGGGCAACAGGGCAAGACCCTGTCTCCAAAAAATAAAAAGTTAAAAAAAA"
"chr1","7159534","7159848","chr16","34390584","34390900","73","27231050","GGCCAGGGGTGGTAGCTCATGCCTGTAATTCCCAGCACTTTGGGAGGCCAAGGCAGGAGGATCACTTGAGGTCAGGAGTTTGGGAACAGCCTGTGCAACACAGCAAGACCCCATCTCTACAAAAAAAATTTTTTTTAATTAGCCAGGTATGATCCTGTGCAACTGTAGGCCTAGCTACTTGCGAGACTGAGGTGGGAGGATTGCTCGAGCCCAGGAGTTCAAGGCTGCAGTGAGCTATGATTGTGTCATTGCACTTCAGCCTGGGTGACAGAGCAAGACCCTGTCTCAAAAACAAAAACAAGAACGAAAACAAAA","GGCTGAGCACGGTGGCTCATGCATGTAATCCCAGCACTTGGGGAGGCCAGGGCGACAGGATCACTTGAGCTCAGGAGTTCGAGACCAGCCTGGCCAACATAGCAAGACCTTGTCTCTACTAAAAAAAAAAAAAAAAAAAAAAAAAAGCCAGGTGTGACGGCATGTGACTGTAGTTGTAGCTACTTGGGAGGCTGAGGTGAGAGGATTGTTTGAGCCCAGGAATTCAAGGCTGCAGTGAGCTATGATTGCACCACTGAACTTCAGCCTGGGTGACAGAGCAAGGCTCTATCTCAAAAATAAATAACTAAATAAATAAA"
"chr1","7167762","7168034","chr3","83975049","83975347","71","76807287","GCTGGGTACAGTGGCTCACACCTGTAATCCCAGGACTTTGGGAGGATTGTTTGAAGCCAGAAATTTGAGACCAGTCTGGGCAACATAGTGAGACCCTGTCTCTACCAAAAAGGTAAAAATTAGCTGGGTATGGTGGCACATGCCTGTAGTCCTAGCTACTCGGGAGGCTGAGGTGGGAGGATCACTTGAGGCTAGGAATTCGAGGCTGCAGTGAGCTATGATTACCCCACTGCATTCCAGACTGGGTGACAGAGCAAGACTCTGTCTCTAAAA","GGCTGGGTGCAGTGGCTCATGGCTGTAATCCCAGGACTTTGGGAGGCTGAGGCAGGAGAATCACTTGAGGCCAGGAGTTTGAGACCAACCTGGGCAACAAAGTGAGGCATGTCTCTACAAAAACAAAACAAAACAAAACAAAACAATTAGCTGTGTGTGGTGATGCCTGCCTGTCGTCCCAGCTACTCGGGAGGCTGTGGTGGGAGGATCTCTTGAGCCTGGGAGGTTGAGGCTGCAGTGAGCTGTGATTGCCCACTGTACTCTAGCATGGGTTACAGAGCAAGACTCTGTCTCAAAAA"
"chr1","7392142","7392256","chr20","87144","87254","65","7304998","GGCTGGGCACTGTGGCTCATGCCTGTAATTCCAACACTTTGGGAGGCCAAGGTGAGAGGATTGCTTGAGGCCAGGAGTTTGAGACCCTCCAAACCTCAACATGGTGAGACCCCCA","CCTGGGCAACATAGTGAGACTACATCTCTACACTCACGCACACACACACACACACACACACACCCCCCAAATTAGCCAGGCATGCTGATGTGCACCCATAGTCTCAGCAAC"
"chr1","7392555","7392596","chr20","87144","87254","81","7305411","AAGACCCCCATCTTTACAATTTTTTTTTAATTAGCTGGAGGT","CCTGGGCAACATAGTGAGACTACATCTCTACACTCACGCACACACACACACACACACACACACCCCCCAAATTAGCCAGGCATGCTGATGTGCACCCATAGTCTCAGCAAC"
"chr1","7392898","7393069","chr18","55799233","55799394","68","48406335","TATAAGCTGAGTGTGGTGGTTAGTGCACACCTGTAGTCCCAGCTACTTGGGAAGCTGAGGCGAGAGGATCATTTGAGGTCAGGAGTTCGAGGCTGCAGTGAGCTATGATCGCGCCACTGCGTTCCAGCCTGGATGACAGAGTGATACTATATCTCTTAAAAAAAAAAAAAAA","GGCTGAGAGAGGTGGCTCATGCTTGTAATCCCAGCACATTGGGAGGCAAAGGTGGGAAGATTGCTTGAGGCCAGGAGTTCAAGACCAGCCTGGGCAACATGAAAACACTTTGTCTCTACAATAAATAAATAAATAAATAAATAAATAAAAGAAACAAGAAAA"
"chr1","7532292","7532563","chr3","9052682","9052970","79","1520390","TCGGGGGGCCGAAATGGGAGGATTGATTGAGCCCAGGAGTTCAAGACCAACCTGGGCAACATGGTAAGAGCCCCGTCCCTAAAACAAACATAAAATAAAAATTAGCTGGGCACAGGGGTGTGTGCCTGTAGTCCCAGATACTTGGGAGGCTGAGGTGGGAGGATCACTTGAGCCCAGGAGGCTGCGGTGTGCTGTGACTATACCACTGCACTCCAGTCTGGGCAACAGAGTGAAATCTGTCTCTAAAAAAAAAATAGAAAGAAATGAAAGAA","ACTTTGGGAGGCTGAGTCGGGAGGATTACTTGACACCAGGAGTTCAAGACCACCTGGGTAACATAGTGAAAACTTCTCTTAACAAAAAAAAAAAAAAAAAAAAAAAAAAAATTAGCCAGCCATAGTGGTGCATGCCTGTGGTCTCAGCTACTCAGGAGGCTGAGACAGGAGGATCACTTGAGCCCAGAACTTCAAGGCTGCAGTAAGCCCTGATTATGCCACTGCACTCCAGCATGGGCAACAGAGCAAGACCTTGTCTCAAAAAAAAAAAAGAAAAAACAGGAGAAAA"
"chr1","7710328","7710625","chr1","80364799","80365106","74","72654471","TGGCTCACACCTGTAATCCCAGCATGTTGGGGGGTCGAGGCAGGAGGATCTCTTGAAGCCAGGAGTCTGAGACTAGCCTAGGCAACATAGCAAGACCTCATCTTTAAAAAAAATTTAAAACAAATAGCTGGACACAGTGGCACACACCTATAGTCCCAGCTACTCAGGAGGCTGAAGCAGGAGGATTGCTTGAGCCCAGGAGTTTGAGGCTGCGGGTGAGCCACGATTACACCACTGCACTCCAGCCTGGGTGACAGAACGAGACCCTGTCTCAAAAAAAAAAAAAAAAAAAAAAGAA","GGTGGCTCACACTTGCAATCCCAGCACTTTGGGAGGACAAGTGGGGGAAGATTACTTGAAGCCAGGAGTTTGAGACTATCCTGGGTAAGAAAGCCAGACCCTGTCTGTATAAAAAATAAAAAATAAAAAATAAAAAAATTAACTAGTCATGGTGGTGCACACCTGTAGTCCTAGCTACCCAGGAGGCTGAAGCAGGAGGATTGCTTGAGCCTAGGTATTAAGGCTCCAGTGAGCTATGACTGTACCACTGAACTTTAGCCTGGGCAACAGAGCAAGATCCTGTCTCAAAAAAAAAAAAAAAAAAAAAA"
"chr1","7822777","7823077","chr1","88859712","88859991","94","81036935","GGCCAAGCATAGTGGTTCACAACTGTAACCCCAGGGACTCAGGAGGCCAAGGAGGTAAGATTGCTTGAGGCCAGGAGTTTGAGACCAGCCTGGGCAATACAGTGAAACCCCATCTCTACAAAAAATGTTTAAATTAGCCAAGTGTGGTGACCCACACCTGTAGTCCCAGCTACTTGGGAGGCTGAGACAGGAGGATCAATTGAGCCTAGCTTGAGCTCATCTTGGGTTCGTTGCTACAGTGAGTTCTGATCACATTACTGTACTCCAGCTGAGGGACAGAGCAAGACCCTGTCTCTAAAAA","CCAGGCACAGTGGCTCACACCTGTAATCCCAGCACTTTGGGAGGCCAAGGCAGGAGGATTGCTTGAATCCAGGAGTTTGAGACCAGCCTGGGCAGCATAGTGAGACTTGGCCTCTACAAAAAAAAAAAAAAAAAAAAAAAAAAGTTACCTGGGAAGTCTCAGCTACTTGGAAGGCTGAGGTCGGAAGGTTGCTTGAGTACAGGAGGTCAAGGCTGCAGTGAGCTATGATTGTACCACTGCACTCCAGCGTGGGCAACAGAGTGAGACCTTATCTCAAAAA"
"chr1","7834450","7834757","chr6","157423301","157423612","75","149588851","GGTTGGGCGTGGTGGCTCACACCTGTAATCCTGGCACTTTGGGAGGCCAAGATGAGAGGACTGCTTGAGGCCAGGAGTTTGAAACCAGCCTGGGCAACACAGTGAGGTAGGTTCCATCTCCATAAAAATAAAAAATTAGCTGAGTGTGGTGGTACATGCCTGTAGTCCTAGCTACTCAGGAGGCTAAGGTTGGAGGATTGCTTGAGCCCAGGAGTTTGAGGCTACAGTGAGCTATGATTGCATCAGTGCACTCTAGCCTGGGTAACAGAGTGACACCTTGTGTCAAAACAACAACAACAACAACAAAA","GGCTGGGCGTGGTGGCTCACACCTGTAATCCTAGCACTTTAGGAGGCCTAGGTGGGAGGACTGCTTGAGCCCAGGAGTTTGAGACCAGCCTGGGCAACACAGTGAGACCTCATCTCTACTAAAAAAAAAAAAAAAAAAAAAAAAAATCAGCCAGGTATGGTGCCATATCCCTGTAGTCTCAGCTACTTGGGAGGCTGAGGTGGGAGGATCACTTAAGCCTGGGAGATGGAGACTACAGTGACCCATGATAGCACCACTGCACTCCAGCCTGGGCAAGAGAGCGAGACTTGGTCTCAAAATGAAACAAAGAAA"
"chr1","7855718","7855998","chr1","88859712","88859991","87","81003994","GCCATGCATGGTGGTTTGCGCCTGTAATCCCAGAGGGTTGGAAGGCTGAGGCTGAGGCAGGAGGATTGCTTGAGGTTAAGATTTTGAGACCAGCCTGGGCAACACATTGAGACCCCATCTGAAAAAAAAAAAACTAGCTGAGCGTGGTGGCATGTGCCTGTGGTTCCAGCTATTTGGAAGGCCAAGGTAGAATTGCTTGAGCCTGGGAGGTCAAGGCTACAGTGAGTCATGATCACGCCACTGAACTCCAGCCTGGGTGACAGAGTGAGATCCTGTCTCAA","CCAGGCACAGTGGCTCACACCTGTAATCCCAGCACTTTGGGAGGCCAAGGCAGGAGGATTGCTTGAATCCAGGAGTTTGAGACCAGCCTGGGCAGCATAGTGAGACTTGGCCTCTACAAAAAAAAAAAAAAAAAAAAAAAAAAGTTACCTGGGAAGTCTCAGCTACTTGGAAGGCTGAGGTCGGAAGGTTGCTTGAGTACAGGAGGTCAAGGCTGCAGTGAGCTATGATTGTACCACTGCACTCCAGCGTGGGCAACAGAGTGAGACCTTATCTCAAAAA"
"chr1","7865656","7865953","chr1","213591659","213591963","75","205726003","GGCTGAGCATGGTGGTTCTGTAATCCCAGAACTTTGGGAGGCTGAGGTGAGAAGATCACTTGAGGCCAGGAGTTCCAGACCAGCCCGAGCAACACAGGGAGACCCCATCTCTACAAATACAATTTTAAAAATTAGCCAGGCTTGGTGGCACACACCTGTGGTCCCAGCTACTCGGGAGGCTGAGGTGGGAGGATCATTTGAGCCCAGGAGGTCAGGGCTGCCATGAGCCAAGATTGTACCACTGCACTCAGCCTAGGTGACAGAGTGAGACCCCGTCTCAAATAAACAAATAAACAAA","GTGCAATGGCTGATGTCTGTAATCCCAGCACAGTGGGAGGCCAAGGCAGGAGGATTGCTTGAGGCCAGGGATTCAAGACCAGCCTGGGCAACCTAGTGAAACCTCATCTCTATTAAAAATAAAAATAAAAATAAAAATTAGTTGGGCATGGTGGCACACACCTGTGGTCCCAGGAGTCCTCAGGAGGCTGAGGTAGGGGGATCACTTGAGCCCAAGAGTTGAGGTTGCAGTGAGCTATGATTGCACCACTGCACTCCAGCATGGGCAACAGAGTGAGACTTTGTCTCAAAACAAAACAAACAAAA"
"chr1","7882055","7882350","chr5","63802202","63802507","78","55920147","CCAGGCGTGGTGGCATATGTGTGTAACCCCAACACTTTGGGAGGCCAAGGTGGGAGTATTGCTTGGGCCCTGGAGATCAAGACAAGCCTGGGCAACAAAGGGAGACGCCATCTCTACAAACACTTTAAAAATTAGCTGAGTGTGGTGGATAGTGCCTGTAGTTCCAGCTACTTGGGAGGCTTAGGTGGAAGTATTGCTTGAGCCCAGGAAGTCAAGGCTGCAGTGAACTATGATAGTGCCACTGCACTCCAGCCTGGGCAACAGAGTGAGTTCCTGACTCTAAATAAATAAATAAA","GACTAGGGGTGGTGGCTCATGCCTGTAATCCCAGCACTTTGGGAGGCTGAGCTGGGAGGATTGCTTGAGCCCAGAAGTTCAAGACCAGCCTGGGCAACATAGCAAGACTCCATCTCTAAAAAAAAAAAAAAAAAAAAAAAAAAAAAATTAGCCCCGAGTGGTGGTGTGCACTTGTAGTCCCAGCTACTCAGGAGGCTGAGGTGGGAGGATCTCTTGAGCCTGGGAGGTCCAGGCTGCAGTGAACCATGATTGTGCCACTGGACTCCAGCCTAGGCAATAGAGTGAGACCTTGTCTCAAAAATAAAA"
"chr1","7890648","7890812","chr16","46964977","46965105","67","39074329","TTAAGAGGCCAAGGCAGGAGGATCACTTGAGATCTGGAGTTGGAGATCAGCCTGGACAACAGAGTGAGACCCCATCTCCACAAAAAAAAAAAAAAAAAATGAACCAGGCATGGTGGCATGCACCTGTGGTCCCAGCTACTCGAGAGGCTGAGGTGGAAGGATCAC","AGACTGGCCTGGGCAATGCAGTGAGACCCCATCTCTACAAAACAAAAACAAAAACAAAAACAAACCAATTAGCTGGGCATGGTGGTGCATGCCTGTAGTCCCAGCTATTTGAGAGGCTAAGGTGGGAGG"
"chr1","7902600","7902720","chr18","55799233","55799394","64","47896633","GGCCGGGGAAGCTGGCTCACTTCTTCAGCACTTTGGGAGGCCGAGGTGGGAAGATCACGTGAGGTCAGGAGTTCAAGACCAGCCTGGCCAACATAGCGAGACCCCCGTCCCTATAAAAAAT","GGCTGAGAGAGGTGGCTCATGCTTGTAATCCCAGCACATTGGGAGGCAAAGGTGGGAAGATTGCTTGAGGCCAGGAGTTCAAGACCAGCCTGGGCAACATGAAAACACTTTGTCTCTACAATAAATAAATAAATAAATAAATAAATAAAAGAAACAAGAAAA"
"chr1","7919576","7919736","chr2B","7187318","7187503","78","732258","GCACCTGTAATCCCAGCTACTTGGGAGACTGAGGCGGGTGGATCACTTGAGCCCAGGAGTTTAAGGCTAAAGTGTGCTATGATTGTGCCTGTGAATAGCCACTCCATTCCAGCCTGGGCAACAGAGCAAGACTGTCTCAAGCAAACCAACAGACAAACAAA","GGTGGCTGATGCCTGTAATCCCAGCACTTTGAGAGACTGAGGCAGAAGAATCGCTTGAGGCCAGAAGTTTGAGACCAGCCTGCACAAATGTGAAACTTCATCTCTACACACACACACACACACACACACAATTAGTCAGGCGTGGTGGCATCTGCCTGTATTCCCAGCTACTCAGGAGGCTGAGAC"
"chr1","7923559","7923849","chr16","32352979","32353289","73","24429420","CTGGGTGTGGGGGCTCACGCCTGTAATCCCAATACTATGGGGGCCAAGGCAGGAGGATCGCTTGAGTCCAGGAGTTCTAGACCAGCTTGGGTAACAGAGCAAGACCCTGTCTCTACAAAACATTTAAAAATTAGCCAGGGGTGGTGGCACATGACTGTAGTCTCAGCTACTCTGGAGGCTGAGGTGGGAGGATCACTTGAGCCCAGGAAGTTGAGGCTGCATTGAGGCGTGATCATGCCACTGCACTCCCGCCTGGGTAATAGAGCAAGCAAGACCCTGACTTCTAAAAAA","GGCTGGACACGGTGGCTGCTGCCTGTAATCCCAGCACTTTGGGAGGCCAAGGCAGGAGAATGGCTTGAGCCCAGGAGTTCAAGACCAGCCCGGGCAACAGAGTGAGACCTTGTCTCTACAAAAATAAAAATAGAAATAAAAATAAAAATTAGCCAAGTGTGGTGGCATGCACCTGTGGTCTCAGCTACTCAGGAGACTGAGGTGGGAGGATCCCTTGAGCCCAGGAGGTCGAGGCTGCAGTGAGCTGTGATCATGCCACTACACTCCAGCCTGGGTGACAGAGCTGTCTCAAAAAAATAATAATTAAAAAA"
"chr1","7935550","7935768","chr11","89572983","89573210","64","81637433","GCATGGTGGCTCACGCCTATAATCTCAACACTTTGGTAGGCTGAGGCCAGAGGATCACTTGAGACCAGGCGTTGGAGACCAGCCTGAGCAACATAGCAAGACCCCATCTCTACAAAAATTAAAAGACAAACAAAAATTAACTGATGGTGCATGCCTGTGGCCCCAGCTACTCGGGAGACTGAGGTGGGAGGATCACTTGAACCCAGGAGTTTGAGGCTG","GGCACGATGGCTCATGCCTGTAATCCCGACTACTCAGGAAGCTAAGCCAGGAGGATTGCTTGAGGCCAGGAGTTTGAGATCAGCCTGGGCAACAAAGCAAGATCCTCATCTCTAAATATATATATATATATATATATATATATCTCCATCCAGGGTGACAGGTACCTGCAGTCTCAGCTACTCAGGAAGCTGAGGTGGGAAGATCCCTTGAGCCTAGCAGTTTGAGAC"
"chr1","7957471","7957738","chr1","94172177","94172465","93","86214706","ATCCCAACACTCTGGGAGGCCGAGGCGGGAGGATTGTTTGAGCCCAGGAGTTGGGGACCAGCCTGGACAACATGGCAAGACCCTGTCTCTACAAAAAATTTTAAAAATTACACGCCTATGGGTCCCAGCTACTTGAGAGGCTGACAGCGCAGCGGGGGAATCACTTGAGCCCAGGAGGTCAAGGCTGCAGTGGGTCATGATCTCATGCCACTGCACTCCAGGCTGGATGACAGAGTGAGACTGTGTCTCTAAAAAAAAAAAAAAAAAA","GTCTGTAATCCCAACACTTTGGGAAGCCAAGGCAGGAGAATCATTTGAGCTCAGGAGTTTGAGACCATCCTGGGCAACATATCAAAACCCCATCTCAATAATAATAATAATAATAATAATAATAATAATAAGCCAGATGTGGTGGCACATGCCTGTGGTCCCAGCTACTTGGGAGGCTGAGGTGGGAGGATCGATTGAGCCCAGGAGGTAGAGGCTGCAGTGAGCTATGATCATTTAGGCACTTCAGCCTAGATGACAGAGCAAGATTCTGTCTCAAAAAAAAAAACAA"
"chr1","7969909","7970209","chr3","83975049","83975347","81","76005140","GGTCAGGTGCAGTGGCTCAACGTCTATAATCCCAGTGGTTTGGGAGGCTGAGACAGGAGGATTGCTTGAGGCCAGGAGTTTGAGACCAGCCTAAGTAACACATCGAGACGCCATCTCTACAAAAAATTTTCTTTTAATTAGCTGGGCACGGTGGTGCACACTTGTAGTCCCAGCTACTCGGGAGGCTATGGTGGGAGGATGACTTGAGGCCAGGGATTTGAGGCTGCAGTGAGCTGTGAATGCACCACTGCATTCTAGCCTGGGCAACAAAGCAAGAACCTGTCTTATCAGAAAAAAAAAA","GGCTGGGTGCAGTGGCTCATGGCTGTAATCCCAGGACTTTGGGAGGCTGAGGCAGGAGAATCACTTGAGGCCAGGAGTTTGAGACCAACCTGGGCAACAAAGTGAGGCATGTCTCTACAAAAACAAAACAAAACAAAACAAAACAATTAGCTGTGTGTGGTGATGCCTGCCTGTCGTCCCAGCTACTCGGGAGGCTGTGGTGGGAGGATCTCTTGAGCCTGGGAGGTTGAGGCTGCAGTGAGCTGTGATTGCCCACTGTACTCTAGCATGGGTTACAGAGCAAGACTCTGTCTCAAAAA"
"chr1","7972180","7972469","chrX","46692258","46692555","73","38720078","GGCCAGGTGTGGTGGCTCATGCCTGTAATCTCAGCATTTTGGGAGGCCAAGGCAGAAGGATCTCTTGAAAGCCAGGAGTTTGAGACTAACCTTGGCAACATAGCCAGACCCCCATCTCAACAAACAAACAAACAAAAAATTAGCCAAGCACAGTACTGCATGCATGTAGTCCCAGCTACTCAGGAGGCTGAGATGGGAGGATCGCTTGAAGGCAAGAGTTAGAGGCTGCAGTGAGCTATGATTGCACTCCAGCCTGGGCAGCAGAGTGACACCATGTCTTTCAAACAAAA","GGCCAGGCATGGTGGCTCATGCCTGTAATCCCAGCACTTTGGGAGGCTGAGGAAAGATGATCACTTGAGCCAGGAGTTTGAGCCCAGTCTGGGTAACATAGTGAGACCTCCATCTCTACAAAAAAAAAAAAAAAAAAAAAAAAAAGCTGGGCATGGTAGCACACATCTGTAGTGTCAGCTACTCAGGAGGCTGAGGTAGGAGGATTGCTTGGGCCCAGGAGATCAAGACTGCAGTGAGCTATGACTGCACCACTGCACTCCAGCCTGGGCAATGGAGTGAGACCCTGTCTCAAAAAAA"
"chr1","7974028","7974345","chr2B","83001661","83001979","79","75027633","GGCTGGCTGTGGTGGCTCATAGCTGTAATCCTAGCACTTTGGGAGACTGAGGTGGGAGGATCACTTGAACCCAGGAGTTCAAGACCAGCCTGGGCAACATAGTGAGACCCCCCCACCGACCTCTACAAAAAAATATTTTAAAAAATCAGCCTGGTGTGGTGGTGCACACTTGTAGTCCCAGCTACTCAGGAGGCTGAGGTGGGAGGATCACTTTGAGCCCAGGAATTTGAGGTTACATTGAGATGTGGTGATCACACCACTGCACTTGAGCCTAAAGGACAGAGCAAGACTTGGTCTCTTAAAAAAAAAAAGTAAAAA","GGCTGGAGATGGTGGCTCACACCTGTAATCCTAGTACTTTGGGAGTCCGAGGTAGGAGGATCACTTGAGGCCAGAAGTTTAATACCAGCCTGGGCAACATAGTGAGAGCCTATCTCTACAAAAAAAAAAAAAAAAAAAAAAAAAGCCAGGTGTGGTGGTGCATGTTTGTAGCCTCAGTTACTTGGGAGGCTGAGGTGGGAGGATCATTTGAGCCCAGGAGGTTAAGGCTGCAGTGAGCCAGTTATGGCACCACTGTACTCCAGCCTGGGCGACAGGGCAAGACCCTGTCTCACAAACAAAAACAAAACAAGACAAAAAA"
"chr1","7985505","7985811","chr16","32352979","32353289","70","24367474","GGCTGGGTGTGGTGGCTCATGCCTGTAATCCCAGCACTTTAGGAAACCGAGCCAGGAGGATTGCTTGAGGCCAGGAGTTCAAGACCAGCCTGGGCAACATAGCAAGTCTCCATCTCTACAAAAAAATACAAAAACTAGCCAGGCATGGTGGCATGCACCTGTAGTCCCAGCTACTTAGGAGCCTGAGGTGAGAGGATCACTTGAGCCCCAGGGGGTCAAGGCTACAATGAGCTGTGATCACACCACCGCACCCCAGCCTGGGTGTCACAGCGAGACCCTGTCTCCAAAAAAAAAAAAAAGAAAAAAA","GGCTGGACACGGTGGCTGCTGCCTGTAATCCCAGCACTTTGGGAGGCCAAGGCAGGAGAATGGCTTGAGCCCAGGAGTTCAAGACCAGCCCGGGCAACAGAGTGAGACCTTGTCTCTACAAAAATAAAAATAGAAATAAAAATAAAAATTAGCCAAGTGTGGTGGCATGCACCTGTGGTCTCAGCTACTCAGGAGACTGAGGTGGGAGGATCCCTTGAGCCCAGGAGGTCGAGGCTGCAGTGAGCTGTGATCATGCCACTACACTCCAGCCTGGGTGACAGAGCTGTCTCAAAAAAATAATAATTAAAAAA"
"chr1","8059760","8059882","chr15","37343640","37343763","63","29283880","GACCAGAGGCAGGGTCTCACACTTGTAATCCCAACACTCTGGGAGGTTGAGGTAGGATTGTCTGAAGCCAGGAGTTTGAGACCAGCCTGAGCAACAAAGCAAGACCCCTGTCTCTACAAAGAA","AAGATCCCTGGCCAGGATTTCAAGACCAGCCTGGGCAACACAGTGAGACCATACATACATACATACATACATACATACATCATACATACATACATACATACATACATACACAGTCTTACAAAGA"
"chr1","8093163","8093480","chr7","7056350","7056674","75","1036813","GCCAGGAGAGGTGGCTCATGCCTGTAATCCTAGCACTTTGAGAGGCCATGGAGAATTGCTTGAGGCCAGGAATTTGAGACCAGCCTGAGCAACATGGCAAGACCCCATCTCTACAAAATATATTTTTTTTTCCAAGAAGAAAACAAAGTTAACTGGGCATGGTGGCATGCACCTCTAGTCCTAGCTACTCAGGAGGCTGAGGCAGGAGGAGTGCTTGACCCTGGAAGGTGGAGGCTGCAGTGAACTATGATCGCGCCCCTGCACTCCAGCCTGAGTGACAGAGCAGACTCTGTCTCCAAAAAAAAAAAAAAACAAAAA","GGCTGGGCACGGTGGCTCATGCCTGTAATCCCAGCAATTTGGGAGGCCAAGGCAGGAGGATTGCTTAAGGCCAGGAGTTCAAGACCAGTCTGGGCAACATAGCGAGACCCCATCTCTAAAAAAAAAAAAAAAAAAAAAAAAAAAAAAAATTCAAAACATTAGCTGGGCATGGTGGCACTGCCTGGAGTCCTAGTTACTCGGGAGGCTGAGGCAGGAGGATCATCTGAGCCTAGGAGGTAGAGGCTGCAGTGAGCTATGATTGCACCACTGTACTCCAGCATGGGTGACAGACCAAGACCCTGTCTCAGAGAAAAAAATAAAAAAA"
"chr1","8115066","8115344","chr4","187957937","187958223","88","179842871","GGCTGGGTGCAGTGGCTCACACCTGTAGTCCCAGCACCTTGGGAGACCAAGGCAGGTAGATTGTGTGAGCCCAGGGCAGCACAGCAAGACCCCATCTCTATAAAAAATTTAAACATTAGCTGGGCATGGTGGTGAGCCCTTGTAATTTCAGCTACTCAAGAGGCGAAGGCGCAAAGATAGCTTGAGCCTAGGAGTTTGAGGCTGCAATGAGCTATGCACACGCCGCTGCACTCCAGCCTGGGCAACAGAGTGAGACCCTGCCTCAAAAAAAAAAAAAAA","GGGCACAGTGGCTCATGCCTGATTCCCAGCACTTTGGGAAGTTGAGACAGGCGGATCACTTGAGCCCAAGAGTTCGAGACCAGCCTGGTGTTCTCTAAAACAAACAAACAAACAAACAAACACACGATTAGCTGGGCATGGTGGCTCACACCTGTAGTTCTAGCTACTCAGGAGGCTGAGGTGGGAGGGTAGCTTGAGCCCAGGAGTTCAAGGCTGCAGTGGGCTATGATCATGCCATTGCACTCTAGCCTGGGCAACAGAGTGAGACCCTGTTTCAAAAAAAAAAA"
"chr1","8127694","8128012","chr13","29223313","29223640","78","21095619","GACTGGGCACAGTGGCTCACACCTGTAATCCCAGCACATTGGGAAGCCAAGGAAGGAGGATTGCTTGAGGATAGGAGTTTGGGATTAGCCTGGGCAAAATAGCAAGACCCCTTCTCTATAAAAAAATTCAAAATAAAAATTAACCAGGTGTGGTGGCACACACCTGTAGTCTCAGCTACTTGGAAGGCTGGGGCAGGAACCTTGGGGATTGCTTGAGCCCAGGGGTTCAAGGCTTCAGTGAGCTATGACTGTAGCACTTCACTCCAGCCTGGCGACAGAGGGAGATCCTGCCTCAAAAAAAAAAAAAAAAAAAAAAAAA","GACTGGGCGCAGTGACTCACACCTGTCACCCAGCACTTTGAGAGGCCAAGGCAGGAGGACTGCTTGGGCCCAGGAGTTCCAGACTAGCCTGGGCAACATAGCAAGGCTCCATCTCTACAATCAATCAATCAATCAATCAATCAATCAAACTAGCTGGGTGTGGTGGCACACACCTGTGGTCCCAGCTACTCGGGAGGCGGAGGTGGGAGGATGGCTTGAGCCAGGGAGTTTGAGGCTGCAGTGAGCCATGATCACACCACTACACTCCAGCCTGGGTGACGGAGCAAGACCCCGTCTCAACAAAAATTAAATGAAAAAAAAAAAAAAA"
"chr1","8132901","8132989","chr8","58489091","58489211","64","50356190","GTGTGGTGGCACGCGCCTGCAGTCCCAGCTCCTTGGAAGGCTAAGGTGGGAGGATAGCTTGAGCTTAAAAGGTGGAGGTTGCAATGAGC","TTGAGACCAGGAGTTTGAGACCAGCTTGGACAACATAGTGAGACCCTGTCTAAAAGAAAGAAAGAAAGAAAAGAAAGAAAGAAAGATGTAGCCAAGTGTGGTGGTGCACATCTGTGTCTCA"
"chr1","8141375","8141658","chr4","112106023","112106320","73","103964648","GGCCGGGCTTGGTGGCTCATTCCTGTAATGCCAGCACTTTGAGAGGCCAAGGCAGGAGGACTGCTTGAGGCCAGGAGTTCAATATCAGCCTGGGCAACATAGCAAGATCCCATCTCTACAAAAAAATAAAATTAGCTGGGCGTGCCTGTAGTCCTAGCTACTGGTGAGGTTGAGGCGGGAGGATCACCTGAGCCCAGGGGATTGAGGCTGCAGTGAGTGGTAATCTCACCACTGCACTGCAGCCTGGGTGACAGAGCAAGACCTTGTCTCAAAACAAAGCAAAA","GACCAGTTGCAGTGGCTCAAGCCTGTAATCCCAGCACTTTGGGAGGCCAAGGCAGGAGTAATGATTGAAGCCAAGCATTCAAGACCAGCGTGGGAGACATGGCAAGATCTCTTCTCTAAATAAATAAATAAATAAATAAATAAGCATGGTGATGCATGCCTGTAGTTCCAGCTACTTGGAAGGCTGAAGCAGGAGGATATCCTGTGCCTAGGAGGTTGAGGCTGCAGTGAGCCATGATCTTGCCCACTGTACTCCAGCTTGGGTGACAGGGCAAGGTCGTGTCTCAGAAAAACAAAAA"
"chr1","8164937","8165107","chr18","55799233","55799394","72","47634296","TTGAGCTGCATGGGGTGGCACATGGCTGTAGTCTTACCTTTCTATTCAGTAGGCTGAAGTACGAGAATCACTTGAGCCCAGGGGTTTGAGGCTGCCCTGAGCCACGATTGTACCATTGTACTTGAGCCTGGGTGGCAGAGCAAGACACTGCCAAAAAAAAGAAAAAAAAAA","GGCTGAGAGAGGTGGCTCATGCTTGTAATCCCAGCACATTGGGAGGCAAAGGTGGGAAGATTGCTTGAGGCCAGGAGTTCAAGACCAGCCTGGGCAACATGAAAACACTTTGTCTCTACAATAAATAAATAAATAAATAAATAAATAAAAGAAACAAGAAAA"
"chr1","8165367","8165504","chr9","47045786","47045941","49","38880419","GCTGGGCACAGTGGCTCATGCCTGTAATCCCCAGCAGGCTTTGAGAGGCCGAGGCAGGAGGATCACTCGAGGGGAGGAGTTCAAGACCAGCCTGGGCAACAAAGCGAGACCTCGTCTCTACAAAATAAAAAAATTAGC","GCTGGGCGCAGCAGCTCACACCTGTAATCCCAGTGCTTTGGAGGTCCAAGGTAGGAGGATTGCTTAAGACTAGGTGTTCAAGACCAGTCTTGGCAACATAGTGAGAACTCATCTCTACAATAAATAAATAAATAAATAAATAAATGAAAATAAAAA"
"chr1","8172623","8172784","chr5","32595015","32595178","62","24422392","GTGGTGGTGCTCGCCTGTAATCCCAGCATTTAGGAAGGCTGAGGTGGGAGGATCACTTGAGCCCAGGAGTTCAAGGCTGCAGTGAGCTGTGATTGGGCCATTGTGCTCCAGCCTGAGCAACAGAGCTCAACCCTGTCTCAAAATAAATAAATAAATAATAAA","GGCCGGGTGTGGTCCCTCATGCCTGTAATCCCAACACTTTGGGAGGCTGAGATAGGAGGACTGCTTGAGGCCAGGAGTTCAAGACCAGCCTGGTCAACATAGTGAGACCCCATCTCTATAAAATAATAATAATAATAATAATAATAATAATAAATAAATAAATA"
"chr1","8186036","8186257","chr14","51003183","51003398","64","42817147","GATACCAGCCTGGGCAACATCGTGAGACTCCATCTCTACTAAAACAATTTTTTATAGCTGGACATGGTGGTGCGTGCCCGTAGTCCCAGCCACTTGAGAGGCTGAGCTGGGAGGATCGCCTGGGCCCAGGGGGTTCAGGCTGCAGTGAGCCATGATCGTGCCACTGCACTCTGACCTGGGTGACAAAGTGAGACCTTGTCTCTCAAAAAATAAAACATAAAA","AGCCTGGGCAAGATAGTGAGACCTCATCTCTTAAAATAAATAAATAAATAAATAAATAGCAGGATGTGGTGGCGTGCATCTGTAGTCCCAGCTACTCAGGAGGCTGAGATGGGAGGATTACTTGAGCTCAGGAGGTCGAGGCTGCAGTGAGCTATGATCACGCCACTGTACTCCAGCCTGGGTGAGAGTGATACCCTGTCTCTAACAAAAAAAAAA"
"chr1","8197457","8197737","chr3","180847740","180848052","85","172650283","GCTGGGTGTTGTGGCTCATGCTTGTAATTCCCAATACTGAGGCAGGAGAATTGCTTGAGGCCAGGAGTTCAAGACCAGGCTGGGCAACATGGCGAGACCCCATCTCTACAAAAATACAGAAAAATGAGCTGGGTGTGGTGGCACGTGCCTGTGGTCCCATGACTCGGGAGGCTGAAGTGGGAGGATCACTTTAGCTGGGGAGGTGGAGGTTGCAGTGAGTTGAGCACTCCAGCCTGGGCTACAGAGTGAAACGCTGTCAAAAAAAGAAAAAAGAAAAAAAA","GCCGTGGGCCGTGGCTTACACCTGTAATCCCAATGGTTGGCTAACGCAGGAGGATCGTTTGAAGCCAGGAACTCGAGACCAGCCTGGGCAACACAGTGAGACCTCCTCTCTACATAAAATAAAATAAAATAAAATAAAATAGCTGGGTGTGGTGGCACGCGCCTTTGGTCCCAGCTACTCAGGAGGCTGAGGTGGGAGACTCACTTGAGGCCAGGAGGTCGAAGTTGCAGTGAGCCGAGATCACGCCACTGCACTCCAGCCTGGGTGACAGAGCGAGACCCTGACTCCAAAAAAAAAAAAAAAAAAAAAAAAA"
"chr1","8208183","8208476","chr3","65159963","65160267","74","56951780","GGCCGGGGTGGTGACTCACACCTAGAATCCCAACACTTTGAGAGGCCGAAGTGGGAGGATCGCTTGAGGCCAGGAGTTCAAGACCAGCCTGGGCAACACAGCGGGACTCCCTCTCTACAAAAAATAAAAATAAGCCAGGCATGATGGTGTGTGCTTGTAGTCCCAGCTACGCAGGAGGCTGAGGTGGGAGCATTGCTTGAGCCCGGGAGGTTGAGGCCACGGTGAGTAGTGATTGTGCCACTACACTGCAGCCTGGGCGACAGAGTAAGACCCTATCTCAAAAAAAAGAGAAAA","GGCATGGTGGCTCACACCTGTAATCTCAGCACTTTGGGAGGGCAAGGTAGGAGGATTGCTTGAGGCCAGGAGTTCAAGACCAGCCTGGGAAACACAACGAGACCCTGTATCTGCCAAAAAAAAAAAAAAAAAAAAAAAAAATTGACCAGGCATAATGGCAATGGCGTGGGGTTCCAGCTACTCAGGAGGCTGAGGTGGGAGGATTGCTTGAACCCCAGAGTTTGAGGCTGCAGTGAGCTATGATCGTGCCACTGCACTCCAGTGTGGAAAAAAGAGTGAGACCCTGTCTCAAAAAAAAAAAAAAA"
"chr1","8219307","8219423","chr20","87144","87254","61","8132163","GGCTGGACACAGTGGCTCATGCCTGTAATCCCAGCACTTTGGGAGGCCAAGGCAAGTGGATCACTCGAGGCCAGGAGTTCCAGACCAGCCTGGACAACATAGTGAGACCCTGTCTCT","CCTGGGCAACATAGTGAGACTACATCTCTACACTCACGCACACACACACACACACACACACACCCCCCAAATTAGCCAGGCATGCTGATGTGCACCCATAGTCTCAGCAAC"
"chr1","8236709","8237005","chr12","108570006","108570305","70","100333297","GGGTATAGTGGCTCTCACACCTGTAATCCCAGCACTTTGGGAGGCTGAGGCAGGAGGATTGCTTGAGGCCAGGAGTTTGAAACTAGCCAGGGCAACCTAGTGAGAGACCATCTCTAGAAAACTTAAAAAAACTTTAGCCAGGTGTGGTGGTGCACGCCTGAAGTCCCAACTACTCAGGAGGCTGAGGCAGAGGATTGCTTGAGCCCAGGAGTTCAAGAATACAATGAACTGTGATGGCACCACTGCACTCCAGCCTGGGAGACAGAGAAAGACGCTGTCACTAAAAGAAAAAAAAAA","GGCAGGGCGTGGTGGCTCACACCTGTAATCCCTGTATTTTGGGAGGCTGAGGCAGGACGATTGCTTGAGGCTAGGAGTTTGAGACCAGTCTGGGCAACATTTAAATAAATAAATAAATAAATAAATAAATAAATAAATCAGCCAGGCATGGTAGCATGAACCTGTAGTCCCAGCTCCTCAGGAGGCTGAGGGAGGATTGCTTGAGCCCAGGAGTTCAAGGTTGCATTGAGCCATGATTGCACCACTGTACTCCAGCCTGGGAAACAGAGTAAGACCCTGTCTCAGAAACAAACAAAAAAA"
"chr1","8304828","8305009","chr1","9000895","9001091","55","696067","GGCCAGGTGTGGTGGCTCATGCCTATAATTCCAGCACTTTAGGAGGCCAAGGCAGGAGAATTGCTTGAGGCCAGGAGCCTGGGCAACAAAGCAAAACCCCATCTCAAAAAAAAATAATAATAAGAAAGAAATGCTGGGCACTGTGGTGTGTGCCTGCAATCCCAGTTACTTGGGAGGCTGAG","GGCCAGACGTGGTGGCTCACTCCTGTAATCCTAGCACTTTATGAGCCTGAGGCAGGAGAATCACTTGAGGCTAGGAGTTTGAAACCAGCTGAGGCAACATAGTCAGACTCTGTCTCTACTAAAAAAAAAAAAAAAAAAAAAAAAAGCCAGGCACAGTGGTGCACACCTATAGTCCCAGCTACTTGGAAGGCTGAGGC"
"chr1","8334465","8334726","chr13","85095450","85095684","80","76760985","CCAAGGTGGGAGGACCACTTGAGGCCAGGAGTTTGAGATCAGTCTGGGCAACATAGTGAGACCCCATCTCTGTAACAATTTTTTAAAAATTAGCCAGGTGTGGTGGTGCTCGCCTGTAGTCCCAGCTACTCGGGAGGCTGAGGTGGGAGGATCACTTGAGCCCAGGAGGTCGAGGCTGCAGTGAGCCATGACCGCACCACTGCACTCCAGCCCAGGCGACAGAGCGAAACTGTCTCTAAAACAACAAAAACAACAACAACAA","GCCTGGGCAACATAGCAAGACTACATCTCTACAAAAAAATAAAAATAAAAATAAAAAATAAAAAATTTGTAAGTAGCCAGGTGTGGTGGTGCATGCCTGTAGTTCCAGCTACTGAGGAGGTTGAGGTGGGAGGATCACTTGAGCCTAGGAGTTCAAGGCTGCAGTGAGCCATGATCAGCCACTGCACTCCAGCCTGTGTGACAGAGAGAAATCGTGTCTCAAAAGAAAAAAAAAA"
"chr1","8342699","8342928","chr7","119744984","119745215","51","111402285","CAGTCTGGGCAACATAGTCAGACCCCATCTCTAAAAAAATAAAATTAAAAATTAGCCAGGTGTGGTGGCATGCACCGGTAGTTCCAGCTACTCGGGAGGCTGAGGTGGGAGGATCACTTGAGCCCAGGAGGCTGAGGCTGCAGTGGGCTGAGATTGTGCCACTGCACTCCAGCCTGGGCAACAGAGCAAGACCCTGTCTCAAAAAAAAAAAAAAGAAAAGAGAAAAGAAA","CAGCCTGGGCAATATAGGGAGACCTCATCTCACAAAAAAAAAAAAAAAAAAAAAAAAAATTAGCCTATTGTGGTGGTGCACGCTTGTGGTGCCAGCTACTTGGGAGGCTGAGGTGGGAGGATCACTTCAGCCCAGGAGTTAGAGGCTGCAGTGAGCTATGATCCTGCCACTGCACTCCATCCTTGGCAACAGGGCAAGACACTTGACTCAAAAAGAAAAAAGAAAAAAAAAA"
"chr1","8368920","8369235","chr19","48171503","48171823","93","39802583","CTGGGCATGGTGGTGTGCACCGGCAGTCCCAGCTACTTGGGAGATCAAGGCAGGAGGATTGCTTGAGGCCAGGAGCTTAAGACAAGCCTGGGCCCTACAGGCCCAATCTCTACAAAAAAGTTTAAAAAATTAGCCCAGTGTGCTGGTGTGTGCCTGTAATAATACCAGCTATTCAGGAAGCTGAGACAAGAGGATCACTTGAGCCCAGGAGGCTGAGGCTGCAGTGAGCTACAAATGTGCCACCGCACTCCAGCCTGGGGGACAGGGCGAGAGGCCATCTCTTTAAAAAAAATAAAAGAACACTTAAAAACAAGAA","GCTGGGAGTGGTGGCTCACACCTGTAATCCCAACACTTTGGGAGGCTGAGGCAGGAGGATTGCTTGAGCTCAGGAGTTCAAGACCAGCCTGGAGCCTGGGCAACATAGCAAAACTCCATCTCTAAAAAAAAAAAAAAAAAAAAAAAAATTAGCCAGGTGTCGTGGTGCATGCCTGTAATCACAGCTACTCAGGGGGCTGAGGTGGGAAGATCGCTTGAGCCCAGGAGTCGGAGGTTGCAGTGAGCCAAGACTGTGCCACCGCACTCCAGCCTGGGCAACAGGGCAAGACCCTGTCTCCAAAAAATAAAAAGTTAAAAAAAA"
"chr1","8400274","8400551","chrX","3592780","3593062","76","4807494","GGCCAGGTGAGGTGACTCACTCCTATAATCTCAGTGCTTTGGGAGGCCAAAGAGGGAGGATCACTTGAGGCCAAAATTTCAAGACCAACCTGGGTAACATAGAAAGACCTCATTTCTACAAAAAATAAAAATATTAGCCGGCCATGGTGGCATGCGCCTGTAGTCCCACTACTTGGGAGGCTGAGGTGGGAGGATTGCTTGAGCCCAGGGGTTCAAGTTATAGTGAGCTATGATCATACCTCTGCACTCCAGTCTGGGTAACAGAGCATGACTTTGTC","GTGGTGGCTCATGTCTGTAATCCCAGCACTTCAGGGGGCCAAAGCGAGAGGACTGCTTGAGGCCAGGAGTTTGAGACCAGCCTGCGCAACATAGAAAGACCCCATCTCTATAAATAAATAAATAAATAAATAAATAAGTCAGGCATGGTGGCACATGCCTGTAGTCCCAGCTACTCAGAAGGCTGAGGTCGGAGGATCTCTTGAGCCCAGGGGTTCAAGGCTGCAGTGAACCATGATCACACCAGTGCACTGCAGCCTGGGCAACACAGCAAAACCCTGTCCC"
"chr1","8404445","8404546","chr20","87144","87254","61","8317301","GGCTCACGAACCTGTAGTCTCAGCACTTTGGGAGGCTGAGGCAAGAGGATCATTTGAGGCCAGGAGTTTGAGACCAGTCTGAACATAGTGAGACTCCATCTC","CCTGGGCAACATAGTGAGACTACATCTCTACACTCACGCACACACACACACACACACACACACCCCCCAAATTAGCCAGGCATGCTGATGTGCACCCATAGTCTCAGCAAC"
"chr1","8461840","8462067","chr7","119744984","119745215","53","111283144","AGCCTGGTCAACACAGCAAGACCTTGTCTCCACAAAAAAATTAAAAACATAATAAAATAGCTGAACATGGTGCCATGTGCCTGTAGTCCCAGTTACTTGGGAGGCTGAGGTTGGAGAATCGCTTGAGTCCAGGGGTTAGAGGCTGCAGTGAGCCGTGATCATGGCACTGCACTCCAGCCTGGGCAACAGAGCAAGACTCTGTCTCCAAAAAAAATAATAATAATAAAA","CAGCCTGGGCAATATAGGGAGACCTCATCTCACAAAAAAAAAAAAAAAAAAAAAAAAAATTAGCCTATTGTGGTGGTGCACGCTTGTGGTGCCAGCTACTTGGGAGGCTGAGGTGGGAGGATCACTTCAGCCCAGGAGTTAGAGGCTGCAGTGAGCTATGATCCTGCCACTGCACTCCATCCTTGGCAACAGGGCAAGACACTTGACTCAAAAAGAAAAAAGAAAAAAAAAA"
"chr1","8465406","8465535","chr19","6391716","6391877","67","2073690","GCCAAGCATGGTAGAGCATGCCTACAGTCCCAGCTACTTAAGAAGCTGGGGCAAGAGGACTGATGGAGCCCAGGAGTTCAAAACCAGCCTGAGCAACACGGCAAAACCCCCTTCTCTAAAATAATTATGA","CCAGGCGCAATGGCTCACGCCTGTAATCCCAACACTTTGAGAGGCCGAGGCAAGAGGATTGCTTGAGGCCAGGAGTCCGAGACCAGCCTGGGCAACACAGCGAGGCCTCATTCTCTACAAAAAATAAATATATAAATAAATAAATAAATAAGAAGAAGAAAA"
"chr1","8479104","8479227","chr19","6391716","6391877","59","2087388","GCTGGGCAAGGTGGCTCACACCTGTAATCCCAGCACTTTCAGAAGCCAAGGCAAGAGGACTTCTTGAGGCCAAGAGTTTGAGACCAGCCTGGACAACACAGTGAGCCCCTGTCTCTACAAAAAA","CCAGGCGCAATGGCTCACGCCTGTAATCCCAACACTTTGAGAGGCCGAGGCAAGAGGATTGCTTGAGGCCAGGAGTCCGAGACCAGCCTGGGCAACACAGCGAGGCCTCATTCTCTACAAAAAATAAATATATAAATAAATAAATAAATAAGAAGAAGAAAA"
"chr1","8495893","8496169","chr3","173091221","173091509","85","164595328","GGCTGGGTGTGATGGCTCATGCCCGTAATCCCAGCACTCTGGGAGCCTGACGCCAGAGGACTGCTTGAGGCCAGAGAGTTCAAAATCAGCCCTGACAACATAGAGAGAGAAAAAAAATATATTAGCCAGGTATGGTGGTGCATGCCTGTAGTCCTAGCTACTGGGGAGGACGAGGTGGGAGGATGACTTGAGCCCAGGAGGTTAAGGCTGTAATGAGTCATGATTATGCCACTGCACTCCAGTGTGAGACCCTGTCTTAAAAAAAAAAAAAAAAAAA","GCTGGAAGTGGTGGCTCATGCCTGTAATCCTAAAGCTCTGGGAGGATCCTTTGAGGCCAAGAGTTTGAGACCAGCCTGAGCAACATAGCAAGATCTTGTCTCTACAAAAAAAAAAAAAAAAAAAAAAAAAATTAGCCAGACGTGGTGGTGCACGCTTCTAGTCCTAGTTACTCAGAGACTGAGGCAGGAGGATCATTTGAGCCAAAGAGTTCAAGGCTGCAGTTAGCTAAAATGGTGCCACTGCACTGCAGTGACAGAGTGAAACTGTCTTAAAAACAAAACAAAAAAA"
"chr1","8496282","8496518","chr5","132198669","132198902","72","123702387","GGGCAACACAGAAAGGACCCCATCTCAACCAAAAACAAAATTAAAAATAGCCGGGCATGGTGCCACGGGTCTATAACCCTAGCTACTCAGGAGGCTGAGGCAGGAGGATCGCTTGAGCTCAGGAAGTTAAGGCTGTAGTGAGCTATAATTGTGCCACTGTACTCCAGCCTGGGTGACACAGCAAGACCCTGTTTCAAAAAAACAAAACAAGTAACAACCAAAAAAAAAAGAAAAAAA","AGCCCAGGCAACATAATGAGACCCTGTCTCTGTGGGGAAAAACAAACAAACAAACAAACAAACAGGCATGGTGCCATGTGTCTATAGTCCCAGCTGCTCAGAAGGCTGAGGTAAGAGGATTGCTTGAGCTCAGGAGGTCAAGGCTGTAGTGAGCCATGATTGCACCACTGCACTCCCACCTGGGTGACAGAGTGAGACGTTGTCTCTTAAAAAAAAAAAAAGACAACAAATAAA"
"chr1","8542541","8542657","chr20","87144","87254","62","8455397","GCCAGGCACAGTGACTTCACACCTGTAATCCCAGCACTTTGGGAGGCTACGACAGGAGGATTATTTGAGGCCAGGAATTCAAGAAAAACTTGGGCAACATTAGTTGAGACCCCATCT","CCTGGGCAACATAGTGAGACTACATCTCTACACTCACGCACACACACACACACACACACACACCCCCCAAATTAGCCAGGCATGCTGATGTGCACCCATAGTCTCAGCAAC"
"chr1","8569610","8569905","chrUn_NW_019938566v1","98142","98430","83","8471468","GGTTGGGCACAGTGGCTCACATCTGTAATTCCAGCACTTTGGAAGGCAGAGGCATGAAGACCGCTTGAGCCCAGTAGTTTGAGACTAACTTGGACAACAAAGTCAGACTCTGCCTTTACAAAAAATTTAAACATTAGACAGGCATGGTGTCATGCTCTTGTAGTCCCAGTTATTCTGGAGACTGAGGCGGTAGGATCTCCTGAGCCCAACAGCTAAAGGCTGCAATAAGCTATGATGGCACTGCCACACTCCAGCCTGGGTGACAGAGCTAGACCCTGTCTTAAAAAAAAAGAAAA","GCTGGGCGTGGTGGCTCACGTCTCAAATCCCAGCACTTTGGGAGGTCAAGCACTGAGGATTGCTTAAGGCCAGGAGTTTGAGACCAGTCTGGGAAACATAGTGAGAGTCTGTCTCTACAAAACACACACACACACACACACACACACACCTGTAGTCCCAGGTACTCAGTAGGCTGAGGCAGGAGGATTGCTTGATCCCAGGAGTTCAAGGCTGCAGTGAGCTGAGATTGCACCACTGCACTCCAGCCTGGGCAACAGAGCAAGACTGCATCTCTAAAAAAAAAAAAAA"
"chr1","8582214","8582533","chr8","16648876","16649161","105","8066662","GCCAAGTGTGGTGGAGCATGCCTGTAATCCCAGTATTTTGGGAGGTAGAGGCCAGGAGTTTGAGACCAGCCTGGGTGACACAGTGAGACCCTGTCTCTACCCCCCAAAAAAAAAAAAAGAAAAAAAGTTTTTAAAGAAAGAGAGAGAAAAAAAAAAAAGCAGGCACAGTGATACACACCTATAGTCCCAGTCATTAATACTTGGGAGGCTGAGGCGGTAGGATTGCTTGAACCCAGGAGTTTAAGGCTATTGTGTGCTGTGATCAGCCCTGTGGATAGCCACTGCGCTGCAGCCTGGGTAACACAGCAAGACCCTCTCTC","CTGGGTGTGGTGGTTTATGCCTGAAATCCCAGTACTTTGGGAAGCCAAAGTGGGCCAGGAGTTCAGGACCAGCCTAGGCAACATAGCAAGACCCTATCTCTAAAAAAAAAAAAAAAAAAAAAAAAAAAAACAGCTAGGCATGAGGGCATGATGTTGTGCCCCTGTAGTCCCAGCTATTCAGGAGGCTGAGGCAGGAAGATCACTTGAGCCCAGAAGTTCAAGGCTGCAGTGAGTTATGATCATGCCACTGTACTCCAACCTGGGCAGCAGAGCAAAACCCTGTCCC"
"chr1","8594876","8595175","chr20","46003702","46004015","71","37408826","GGCCAGGCACAGTGGCTCACACCTGTTAATCCCAGTGCCTTGGGAGGCCAAGGCAGGAGGATCATTTGAGGCCAGGAGCCTGATACCAGCCTGGGCAACATAGTGAGACTTCATCTCTACAAAACATTACAAAATTAGCCAGGTGTGGTGGCATGTGCTTGTGTGGTCCCAGCTACTCAAAAGGCTGAGGCAGGAGGATCGCTTGAGCCCAGGAGCTTAAGGCTGCAGTGCTCTATGATCACACCACTCATTCCAGCCTAGGTGACAGAGCAAGACCGTGTCCAAAAAAAAAAAAAAAAA","GGCTGCGCACAGTGGCTCACACCTGTAATCCAGCACTTTGGGAGGCCAAGGCAGGAGAATCATTTTCGTTCAGGAGTTTGAGGCCAGCCTGGGCAATATAGAGAGATCTTCTCTCTACAAAATATAATAATAATAATAATAATAATAAGCCAGTTGTGGTGGCTCACACCTGTAGTCTCAACTACTCAGGAAGCTGAGGTGGGAGGATCACTTGAGCCCAGGAGGTTGAGGCTGCAGTGAACCAGACTACACCACTGCACTCCAGCCTGAGTGACAGAGCAAGACCTTGTCTCAAAAGAAAAAAAACAACAAAA"
"chr1","8630606","8630717","chr20","87144","87254","61","8543462","GCTGCTCAGGAAGCTCAGGTGACAGCATCACTGGAGCCCTGGAGTTCAAAGCTGCAGTGAGCTATGATCCAGCCACTGTACTCCAATCTAGGTGACAGAGTGAGACCCTGTC","CCTGGGCAACATAGTGAGACTACATCTCTACACTCACGCACACACACACACACACACACACACCCCCCAAATTAGCCAGGCATGCTGATGTGCACCCATAGTCTCAGCAAC"
"chr1","8633138","8633422","chr1","20214247","20214541","75","11581109","GGCCAAGCTTAGTGGCTCACACTTATAATCCCAACACATTGGGAGGTGGAGGCAGGAGGATCACTTCAGGTCAGAAGTTCGAGACCAGCCTGAGCAACATAGCAAGACTCCATCTCTACAAAAAAAATTTTTTTAAATAGCTGGGCACGGTGGCAGGCACCTGCAGTCCCAGCTGCTTAGGAGGTTGAGGTGGGAGGATCACTTAAGCCCAGGAGGTTGAGGCTGCAGTGAGCTATAATAGCACCACTGCGTGCCAGCCTGGGGAACAAAGCAAGATCCTGTCTC","GACTGGGCGTGGTGGCTCACACGTGTAATGTCAACACTTTGGGAGGCCGAGGTGGAGGATTGCTTATGACCAGGAGTTTGAGACCAGCTGGGCAACATAGTGAGACCCCATCTCTACCACACACACACACACACACACACACAAATTAGCTGGGTGTGGTGGCAAGCCCCTGTAGTCCCAGCTACTCAGGAGGCTGAGGTGGGAGGATCACTTGAGCCTGGGATGTTGAGGCTGCAGTGAATCATGATTGCACCATCGCATTCTAGCCTGGGAGACAGAGCAAGACCTTGTCTCA"
"chr1","8651820","8651979","chr18","55799233","55799394","56","47147413","GCTGGGCAAGGTGGCTCACACCTGTAATCCCAGCACTTTGAGAGTCTCAGGTGGGAGGATCACTTGAGGCCAGGAGTTTAAGGCTGCAGTGAACTACATGCCATTATATTACAGCCTGGGTGACAGAGCAAGACTGTCTCTTAAAAAACAAAAAACAAAA","GGCTGAGAGAGGTGGCTCATGCTTGTAATCCCAGCACATTGGGAGGCAAAGGTGGGAAGATTGCTTGAGGCCAGGAGTTCAAGACCAGCCTGGGCAACATGAAAACACTTTGTCTCTACAATAAATAAATAAATAAATAAATAAATAAAAGAAACAAGAAAA"
"chr1","8656831","8656959","chr9","47045786","47045941","61","38388955","GGCCAGGCACTGCGGCTCATGCCTTGTAATCCCAGCATTTTGAGAGGCCAAGCCAGAAGGACCACTTGAAGCCAGGAGTTCAAGACCAACCCTGGCAACAAAGCGAGATCCCATCTCCAACATAAAATA","GCTGGGCGCAGCAGCTCACACCTGTAATCCCAGTGCTTTGGAGGTCCAAGGTAGGAGGATTGCTTAAGACTAGGTGTTCAAGACCAGTCTTGGCAACATAGTGAGAACTCATCTCTACAATAAATAAATAAATAAATAAATAAATGAAAATAAAAA"
"chr1","8671989","8672123","chr1","217544386","217544536","62","208872397","GCCGGGCGTGGTGGCTCATCCCTAAAATTCTATCTAGCACTTTGGGAGGCTGAGGCAGGAGGATCATCACTACAGGCCAGGAGTTTGAGACCAGCGTGGGCAACATAGCAAGCTCCCATATCTCCACAAAAAATA","GGCTGGGCGTGGTGGCTCATGCCTCTAATCCCAGCACTTTAGGAGGCCAAGGCAGGAGGATAACTTAAGACCAGGCTGGGTGACACAGTGAGACTTTGTCTCTAAAAAAAAAAAAAAAAAAAAAAAAAAAAAAAACCTACAAAAACATATA"
"chr1","8688160","8688283","chr20","87144","87254","63","8601016","GGGCACAGCGACTAACGCCTATAATCTCAACACTTTGGAAGGCCAAGTCAGGAGGATCGCTTGAACCAACGAGTTTGAGAGGAGCCTGGAGAACATGAGACCCCTATCTCTACAAAAAATTTAA","CCTGGGCAACATAGTGAGACTACATCTCTACACTCACGCACACACACACACACACACACACACCCCCCAAATTAGCCAGGCATGCTGATGTGCACCCATAGTCTCAGCAAC"
"chr1","8688574","8688674","chr20","87144","87254","58","8601430","TTAAAATTAAAATTAAAAAATTAGCCAGGCATAGTGGCACACACCTGTAGCCTCCCAGCTACTCCAGAAGCTAAGGTGGGAGGATAACTTGAGCATGGGAG","CCTGGGCAACATAGTGAGACTACATCTCTACACTCACGCACACACACACACACACACACACACCCCCCAAATTAGCCAGGCATGCTGATGTGCACCCATAGTCTCAGCAAC"
"chr1","8769490","8769777","chrX","46692258","46692555","72","37922768","GGCCTGGGTGTGGTGACTCATGTCTGTAATCCCAGCATTTCGGGAGGCTGAGGCAGGAGTATCGCTTGAGTCCAGGAGTTCGAGACCAGCCTGGGCAGAGACCCCATCTCTACAAAAATAAAATAATAAAGTTAGCTGGGCATGATAGCATGAGCCTGTAGTCCCAGGTACTTGGGAGGCTGACATGGGAGGATCGCTTGAGCCTTGGAGGTTGAAGCTGGAGTGAGCCATGACTGTGCCACTGCACCTCACCCTGGGTGAGCGATTGAGACCCTGTCTCCAAACAAA","GGCCAGGCATGGTGGCTCATGCCTGTAATCCCAGCACTTTGGGAGGCTGAGGAAAGATGATCACTTGAGCCAGGAGTTTGAGCCCAGTCTGGGTAACATAGTGAGACCTCCATCTCTACAAAAAAAAAAAAAAAAAAAAAAAAAAGCTGGGCATGGTAGCACACATCTGTAGTGTCAGCTACTCAGGAGGCTGAGGTAGGAGGATTGCTTGGGCCCAGGAGATCAAGACTGCAGTGAGCTATGACTGCACCACTGCACTCCAGCCTGGGCAATGGAGTGAGACCCTGTCTCAAAAAAA"
"chr1","8775290","8775602","chr1","196006286","196006594","75","187230996","GGCCGGGAACAGTGGCTCACACCTATAATCCCAACACTTTGGGAGGCCGAAGCAGGAAGACTTCTTGAAGCTAGGCATTCAAGACCAGCCTGGGCAAGAAAGTAAGACCCTGACCCTGTCTCAGCAAAAAATAAAAAAATAAAAATTAGCCAGATGTGGTGGCACGCACCTGTAGTCCCAGCTACTCAGGAGGCTGAAATGAGAGGATCTCTTGGGCCCAGAAGGTAGAGGCTGCAGTGAGCTACAATCACACCACTGCACTGCAGCCTGGGCAACACAGTAAGATCTTGCCTTTAAAAACTAAACAAATAAA","GGCCAGGCGCAGTGGCTCACACCTGTAATCCCAGCACTTTGGCAGGCTAAGGCGGGGGAGTCGCTTTAGCACAGGAGTTTGAGACCAGCCTGGGTAACAAAGCAAGACCCTATCTCTACAAAAAAAAAAAAAAAAAAAAAAAAAAAATTAGACAGGTGTGGTGGCACACGCCTGTGGTCCCAGCTACTTGGGGGCCGAGGTGAGAGGATAGCTTGAGCCGAGGAGGTCAAGGCTGCAGTGAGCTATGATCACACCACTGCACTCCAGCCTGGAGCAAGCAAGAATTTCATTCTAAAAAAAAAAAAAAAA"
"chr1","8791940","8792117","chr2A","60286019","60286209","62","51494079","AAATTAGGCCGGGCATGATAGTTCACACCTGTAATCCTAATACTTTGGAAGGCCAAGGTGGGAGGATCGCTTGAGCCCAGGAGGTCAAGGCTGCAGTGAACTATAATTGCACCACTCCAGCCTGGGCAACAAAGCAAGACCCTGTCTCAAAAGAAGGAAAAAAAAAAAGAAAACAAAA","AAAATTAGCCAGGTGTGATGGCACCTGTAGTCCTAGCTACTTGGGAGGCTAAGGTGGGAAGAGGGCTTGAGCCCAAGATTGTGAGGCTGTGGTGAGTCATGACTGTGCCATTGCCCTCTGGCCTGGGTGACAGAGTGAGAAGCTGTCTCAAATAAATAAATAAATAAATAAATAAATAAAAATAAACAAAA"
"chr1","8794748","8794824","chrX","45395975","45396094","68","36601227","CAAATAAAAAAAAAACTGGCCAGGTGTGGTGACATGCACTTGTAGTCCTAGCTACTGCCAGAAGGTGGGGAGGGAGG","CAGCCTGGCCAACATAGAGAAACCCTGTTTCAACAAAACAAAACAAAACAAAACAAAACACAACACAACCTGGGCAGGGTGGTGCATGCCTGTAGTCCCGAGAACGAGACGGGAGGATTG"
"chr1","8797977","8798101","chr1","217544386","217544536","61","208746409","GGCCAGGCGCAGTGGCTCATTCCTGTAATCCCAACACTTTGGAAGGCCAAGGTGGGAGGATCGATTGAGGCCAGGAGTTTGAAACCAACCTGGGAAACATAGCAAGACCCCATTTCTATAAAAAA","GGCTGGGCGTGGTGGCTCATGCCTCTAATCCCAGCACTTTAGGAGGCCAAGGCAGGAGGATAACTTAAGACCAGGCTGGGTGACACAGTGAGACTTTGTCTCTAAAAAAAAAAAAAAAAAAAAAAAAAAAAAAAACCTACAAAAACATATA"
"chr1","8807057","8807352","chr5","83677678","83677973","70","74870621","GCTGGATGTGGTGGCTCACAACTGTAATCCTAGTGCTTTGGGAGGTCGAGGCAGGAGGCTCCCTTGAGACCAGGAGTTTGAGACCAGCCTGGGCAACGTAACAAGACCCCCGTCTCTGCAAAAAAAATTAAAAATTAGCCAGGCGTGGTAGCACGTGCCTGTAGCCCAAGCTACTCAGAAGGCTGAGGCGGGAGGATTGTTTGAGCCTAGGAGGTCAAGGCTGCAGTGAGCCAATATTGTGCCATTGCTTTCCAGCCTGGGAGACAGAGTGAGACCCTGTCTCAACAACAACAAAA","CTGGGTGTGGTGGCTCACACTTGTAATCCGAACACTTTGGGAAGCCAAGGCAGGAGGATTGCTTGAGCCCAAGAATTTGAGATCAGCCTGGGCAACATGACAAGACTCCATCTCTAAAAAAAAAAAAAAAAAAAAAAAAAATCTAGCCAGGTGTGGTAGCATGCACCTGTGGTCTCAGCTACTCAGGAGTCTGAGGTGGGAGAATTGCTTGAGCCCAGCAGGTCAAGGCTGCAGTGAGCCATGTTTGTGTACTGCACTCCACCCAGGGTGACAGAGTGAGACCCTGTCTCAAAAAA"
"chr1","8824088","8824210","chr1","217544386","217544536","61","208720298","GCTGGGTGTGGTGGCTCACTCCTATAATCCCAGCACTTTGAGAGCCAAAGGCAGGAGGATCTCTTGAGGCCAGGAGTTAGAGACCAGCCTGAGCAAAATGGTGAGACTCCGGCTCCACAAAAA","GGCTGGGCGTGGTGGCTCATGCCTCTAATCCCAGCACTTTAGGAGGCCAAGGCAGGAGGATAACTTAAGACCAGGCTGGGTGACACAGTGAGACTTTGTCTCTAAAAAAAAAAAAAAAAAAAAAAAAAAAAAAAACCTACAAAAACATATA"
"chr1","8841498","8841629","chr1","217544386","217544536","70","208702888","GAGGCCTGAGGTGGGAGGACTGCTTGAGCCCAGGAGTTTGAGACTACAGTGAGCTAGGATTGTGCCACTGCACTTCAGCCTGGGTGACAGAGCAAGAAAGTTCTTGTCTCAAAAAAAAAAAAAAAAAAAAAA","GGCTGGGCGTGGTGGCTCATGCCTCTAATCCCAGCACTTTAGGAGGCCAAGGCAGGAGGATAACTTAAGACCAGGCTGGGTGACACAGTGAGACTTTGTCTCTAAAAAAAAAAAAAAAAAAAAAAAAAAAAAAAACCTACAAAAACATATA"
"chr1","8841799","8841809","chr20","87144","87254","100","8754655","TTTAAAAGAAA","CCTGGGCAACATAGTGAGACTACATCTCTACACTCACGCACACACACACACACACACACACACCCCCCAAATTAGCCAGGCATGCTGATGTGCACCCATAGTCTCAGCAAC"
"chr1","8852608","8852764","chr19","6391716","6391877","55","2460892","GCCAGGCATGATGGCTCACGCCTGTAATCCCAACACTTTAGGAGGCTGAGGCTGGAGGATGCCTTGAGCCCAGGAGTTCGAGGCTGCAGAGAGCTATGCTTACCACTGAAATCCAGCCTGGGTGACAGAGACTCTGCCTCAAAAATAAAAAAGAAAA","CCAGGCGCAATGGCTCACGCCTGTAATCCCAACACTTTGAGAGGCCGAGGCAAGAGGATTGCTTGAGGCCAGGAGTCCGAGACCAGCCTGGGCAACACAGCGAGGCCTCATTCTCTACAAAAAATAAATATATAAATAAATAAATAAATAAGAAGAAGAAAA"
"chr1","8854874","8855016","chr19","6391716","6391877","53","2463158","GGCCAGGCACGGTGGCTTATGCCTGTAATCTCTGTACTTTGGGAGGCAGGAGGATTGCGTAAACCCAGGAGTTGGAGACCAGCCTGGGTAATACAGCAAGACCTTGTCTCTAAAAAAAAAAGTTTTAAAATTAGCCAGGCATC","CCAGGCGCAATGGCTCACGCCTGTAATCCCAACACTTTGAGAGGCCGAGGCAAGAGGATTGCTTGAGGCCAGGAGTCCGAGACCAGCCTGGGCAACACAGCGAGGCCTCATTCTCTACAAAAAATAAATATATAAATAAATAAATAAATAAGAAGAAGAAAA"
"chr1","8855329","8855475","chr1","217544386","217544536","65","208689057","GCCAGGCATGGTGGCATGTGCCTGTAGTCACAGCTACTCAAAAGACTGAGGTGGGAGGATCGCTTGAGCCCAGGAGGCGGAAGATGCAGTGAGTCCTGATCACACCAATGCACTCAGTCTGGCTGACACAGTAAAAAAAAAAAAAAA","GGCTGGGCGTGGTGGCTCATGCCTCTAATCCCAGCACTTTAGGAGGCCAAGGCAGGAGGATAACTTAAGACCAGGCTGGGTGACACAGTGAGACTTTGTCTCTAAAAAAAAAAAAAAAAAAAAAAAAAAAAAAAACCTACAAAAACATATA"
"chr1","8857560","8857715","chr1","217544386","217544536","81","208686826","AAAAAATAGTAAAAAATTAGCTGGGCATGGTGACATGGTCCCTGTAGTCCCAGCTACTCAGGAGGCTGCGGTGGAGAGATCACTTGAGCCCAGGAGTTGTGAGCTGTGATCACTGCAGCCTGAGCAGCAAACCGAGACTCTGTCTTCAAAAAAAAA","GGCTGGGCGTGGTGGCTCATGCCTCTAATCCCAGCACTTTAGGAGGCCAAGGCAGGAGGATAACTTAAGACCAGGCTGGGTGACACAGTGAGACTTTGTCTCTAAAAAAAAAAAAAAAAAAAAAAAAAAAAAAAACCTACAAAAACATATA"
"chr1","8887712","8888002","chr8","15910614","15910909","70","7022902","GGCTGGGCAGTGGCTCATGCCCATAATCCTGGCACTTTGGGAGGCCAAGCTGGTGAATCGCTTGAACCCAAGAGTTCTAGATCAGCTTGGACAACAAAGTGAGACTTCTCTCTACCAAAAAAAATAAATAATTAGCCAGGCGTGGTGGTACATGCCTGTAGTCCCAGCTACTCAGGAGGCTAAGATGGGAGGATCACTTGAACCCTGGAGGCTGAAGCTGCAATGAGCTGTGATCATGCCACTGCACTCCAGCCTCAGTGACAGAGCAAGACCCTGTCTTAAAAAAAGAAA","GGCCAGGCGAAGTGGCTCACACCTGTAATCCCAGCACTTTGGGAGGCCAAGGCAGGAGGATCATTTGAAGCCAGGAGTTCAAGGCCAGCCAGAGAAACATAGTGAGAACCTGTCTTTACAAAAATTAAAATTAAAATTAAAATTAGCCAGGAGTGGTGGTGCATGCCTGCAGTCCCAGCAGCTCAGGAGGCTGAGGTGGGATGATTGCTTGCACCAGGAGTTCGAGGCTGCAGTGAGCTGTGATCGTGCCACTGCACTCCAGCCCCTGGGTGACAAAGCAAGATCCTCTAAAAAAA"
"chr1","8913418","8913553","chr15","37343640","37343763","67","28430222","GGGAGGCTGATGGGAGGATTGCTTGAGGCCAAGAGTTTGAGGCTGCCATGAGCCATGATTATGCCACTGCACTACAGCCCGGGCAACAGAGCAAGACCCTGACTCAAATTTTAAAAACTTTTTAAAGAAAAGAAAA","AAGATCCCTGGCCAGGATTTCAAGACCAGCCTGGGCAACACAGTGAGACCATACATACATACATACATACATACATACATCATACATACATACATACATACATACATACACAGTCTTACAAAGA"
"chr1","8918545","8918866","chr1","88859712","88859991","102","79941167","GGCTGGGAGCAGTGGCTCACTACTGTAATCTCAACACTTTGGTAGGCTGAGGCAGGAGGATTGCTTGAGGTCAGGAGTTCAAGACTAGCCTGGGCAATATAGCAAGACTCTGTCTCTACCAAAGCCAGAAAAAAAAAATCTAAAATAAAGTATTCTTAGGGACACCTCTCAAGAATTGTAACTAAGAGGTGGGCAAGGTGGTTCCTGCCTGTTGTTTCAGCTACTGAGTTTCAGGCTGCAGCGTGCTGGGATAGCACTTGTGAATAGCCACTGCTCTCCAGTCTCGGCAACATAGCAAGACCCTGTCTTTAAAAAAAAAAAA","CCAGGCACAGTGGCTCACACCTGTAATCCCAGCACTTTGGGAGGCCAAGGCAGGAGGATTGCTTGAATCCAGGAGTTTGAGACCAGCCTGGGCAGCATAGTGAGACTTGGCCTCTACAAAAAAAAAAAAAAAAAAAAAAAAAAGTTACCTGGGAAGTCTCAGCTACTTGGAAGGCTGAGGTCGGAAGGTTGCTTGAGTACAGGAGGTCAAGGCTGCAGTGAGCTATGATTGTACCACTGCACTCCAGCGTGGGCAACAGAGTGAGACCTTATCTCAAAAA"
"chr1","8929246","8929414","chr12","4864673","4864880","65","4064573","TTAACCAGATGTGGTGGCATACACCTGTGGTCCCAGCTACTGGGGAGGCTGAGATAGGAGGATCACTTGAGCCCAGGAGGTAGAGGCTACAGTAAACTATGATCGCGCCACTGCAGTCTAGCCTGGGCAACAGAACCAGACCCTGTCTCGAAAAAAGAAAAACAAAAAA","AATTAGCCAGGTATGGTGGTGTGCACATGCAGTCCCAGCTGTTTGGGAGGCTGAGGCAGGAGGATCACTTGAGCCCAGGAGTTTGAGGCTGCAGTCAGCTATGATCATGCCACTGCACTCCAGCCTGGACAACAGAACAAGACCCTGTCTCAAAAACAAAACAAAACAAAACAAAACAAAACAAGAACAGAAAACAATCAAACAAAAA"
"chr1","8929698","8929841","chr9","47045786","47045941","48","38116088","CTGGGCACGGTGGTTTATACTTGTAATCCCAGCACTTTGGGAGGCTGAGGCAGGAGGAACACTTGAGGCTAGGAGTTTGAGACCAGCCTGGGCAACAAAGTGAGACTCCATCTCTATAAAAAATGTAAAAAATTAGCCAGGCAT","GCTGGGCGCAGCAGCTCACACCTGTAATCCCAGTGCTTTGGAGGTCCAAGGTAGGAGGATTGCTTAAGACTAGGTGTTCAAGACCAGTCTTGGCAACATAGTGAGAACTCATCTCTACAATAAATAAATAAATAAATAAATAAATGAAAATAAAAA"
"chr1","8942846","8943023","chr2A","60286019","60286209","75","51343173","GGCACGCACCTGTTGTCCCAGCTACTTGGAGGGGATGAGGCGGAAGGGGGTGCTGAGGCGGGAGGATCACCTGAGCACTGGGAGGCTGCAGTGAGCCATGATTGCACCACTGCACTCCAGCCTGGGCAACAGAGTGAGACCCTGTCTCAAAAAAGAAACCAAAAACCAAAAACAACAA","AAAATTAGCCAGGTGTGATGGCACCTGTAGTCCTAGCTACTTGGGAGGCTAAGGTGGGAAGAGGGCTTGAGCCCAAGATTGTGAGGCTGTGGTGAGTCATGACTGTGCCATTGCCCTCTGGCCTGGGTGACAGAGTGAGAAGCTGTCTCAAATAAATAAATAAATAAATAAATAAATAAAAATAAACAAAA"
"chr1","8966999","8967122","chr19","6391716","6391877","57","2575283","GGCCAGGCGCAGTGGCTCACGCTTGTAATCTCAACACTCTGGGAGGCCAAGGCGGGAGGATTGCTTGGGGCCAAGAGTTCAAGACCAGCCTGGGCAACACAGGGAGGCCCCGTCTCTACAATAA","CCAGGCGCAATGGCTCACGCCTGTAATCCCAACACTTTGAGAGGCCGAGGCAAGAGGATTGCTTGAGGCCAGGAGTCCGAGACCAGCCTGGGCAACACAGCGAGGCCTCATTCTCTACAAAAAATAAATATATAAATAAATAAATAAATAAGAAGAAGAAAA"
"chr1","8972050","8972350","chr5","63802202","63802507","68","54830152","GGCCGAACGAGGTGGCTCGTGCTTATAATCCCAGCACTTTGGGAGGCTGAGGGGGGAGGATTGCTTGTGGCCAGGAGTTTGAGACCAGTCTGAGCAACATAGTAAGAGTCCATCTCTACAAAAACTACAAAAAAAATTAGCTGGGTGTGGTGGTGTGTGCCTGCAGTCTCCGCTACTGGGGAGGCTGAGGTGGGAGGATCACTTGAGCCTGGATGTTTGAGGCTGCAGTGAGCCGTGATTGTGCCACTGAGCTCCAGCCTGGGCAACAGACTGAGACCTTGTCTCAAAAAAGAAAAAAAAA","GACTAGGGGTGGTGGCTCATGCCTGTAATCCCAGCACTTTGGGAGGCTGAGCTGGGAGGATTGCTTGAGCCCAGAAGTTCAAGACCAGCCTGGGCAACATAGCAAGACTCCATCTCTAAAAAAAAAAAAAAAAAAAAAAAAAAAAAATTAGCCCCGAGTGGTGGTGTGCACTTGTAGTCCCAGCTACTCAGGAGGCTGAGGTGGGAGGATCTCTTGAGCCTGGGAGGTCCAGGCTGCAGTGAACCATGATTGTGCCACTGGACTCCAGCCTAGGCAATAGAGTGAGACCTTGTCTCAAAAATAAAA"
"chr1","8990885","8991154","chrUn_NW_019938566v1","98142","98430","74","8892743","GCTGGGTGTGGTGGCTCATGCCTGTAATCCCAGCACTTTAGGAGGCTGAGGCAGGAGGATCTGTTGAGGCCAGTAGTTTAAGACCAGCCTGGGCAACATAGTGAGACCCTGTCTCTACAAAAAATGGTAGTGTGTGCCTGTAATCCCAGCTACTCAGGAGGCTGAGGCAGGAGGATGGCTTGAGCATAGGAGTTGGAGGCTGCAGTGAGTCATGACTGCACCACTCCACTCCAGCCTGGGTGGCAGAGTGAGACCCAGTCTCCAAAACAA","GCTGGGCGTGGTGGCTCACGTCTCAAATCCCAGCACTTTGGGAGGTCAAGCACTGAGGATTGCTTAAGGCCAGGAGTTTGAGACCAGTCTGGGAAACATAGTGAGAGTCTGTCTCTACAAAACACACACACACACACACACACACACACCTGTAGTCCCAGGTACTCAGTAGGCTGAGGCAGGAGGATTGCTTGATCCCAGGAGTTCAAGGCTGCAGTGAGCTGAGATTGCACCACTGCACTCCAGCCTGGGCAACAGAGCAAGACTGCATCTCTAAAAAAAAAAAAAA"
"chr1","8992201","8992487","chr8","25360790","25361095","74","16368589","GGCCAGGTGCTGTGACTCATGCCTATAATCCCTGCACTTTCAGAGGCCAAGGCAGGAGGATTGCTTGAGCCCAGGAGTTTGAGACTAGCCTGGGCAACATAGCAAGACCCCCATCTCTACAAAAAAATATATTAAAATTAGTTGGGTGTGGTGGCATGTGCCTGTAGTCCCAGCTACCCAGGAGGCTAAAGTGGGAGGATTGTCTGAGCCCAGGAGGTTGAGTGCAGTTCATGCCACTGCACATTAGCCTGGGCAACAGGGCAAGACCTGCCTCAAAAAAAAAAAAA","GGCTGGGAGCAGTGGCTCATACCTGTAAGCCCAGCACTTTGGGAGGCTGAGGTGGGAGGATTGCTGAAGCCCAGGAGTTTGAGACCAACCTGGGCAATGTAGGGAGACCCCGTCTCTACTAAATAAATAAATAAATAAATAAATAAAGTCGGGCATGGTGGCATGTGCCCTGTAGTCCCAGCTTCTTGGGAGGCTGAGGTGGGAGGATTGCTTGGGCCCAGGAATCAAGGCTGCAGTGAGCTGTGATTGTGCCACTGTACTACAGCCTGGGTGACAGTGCAAGACTGTCTCAAAAGAAAAACAAAA"
"chr1","9023628","9023749","chr9","47045786","47045941","61","38022158","GGCTGGGAATGGCTCACACCTGTAATCCTGGCACTTTGGGAGGCCGAGGCGGGAGGATTGCTTGAGGCCAAGGGTTCAAGAGCAACCTGGCCAACATAGGGAGACCCTGTCTCTATTAAAAA","GCTGGGCGCAGCAGCTCACACCTGTAATCCCAGTGCTTTGGAGGTCCAAGGTAGGAGGATTGCTTAAGACTAGGTGTTCAAGACCAGTCTTGGCAACATAGTGAGAACTCATCTCTACAATAAATAAATAAATAAATAAATAAATGAAAATAAAAA"
"chr1","9049856","9049989","chr5","32595015","32595178","53","23545159","GGCTGGGTGCCGTGCTCATGCCCGTAATCTCAGCACTTTTGGACACTGAGGTAGGAGGATCACTTGTGTACAGAAGTTCCAGACCAGCCTGGGCAACATAGTGAGACGCCATCTCTAGAAAAAAATAATAGATT","GGCCGGGTGTGGTCCCTCATGCCTGTAATCCCAACACTTTGGGAGGCTGAGATAGGAGGACTGCTTGAGGCCAGGAGTTCAAGACCAGCCTGGTCAACATAGTGAGACCCCATCTCTATAAAATAATAATAATAATAATAATAATAATAATAAATAAATAAATA"
"chr1","9050305","9050486","chr2A","60286019","60286209","64","51235714","TTTGCTGGGCACTATTGGTGGTGCACTCCTGTAGTCCCAGCTACTGGAGAGGCTGAGGCGGGAGTATTGCTTGAGCTAGGAAGTTTGAGGCTGCAGCAAGATGTGATTGTGTCACTGCACTCAGCCTGGGTGACAGAGTGACACCCTGTCTCAAAAACAAAAAACAAAAAAAAGGAAAGAAA","AAAATTAGCCAGGTGTGATGGCACCTGTAGTCCTAGCTACTTGGGAGGCTAAGGTGGGAAGAGGGCTTGAGCCCAAGATTGTGAGGCTGTGGTGAGTCATGACTGTGCCATTGCCCTCTGGCCTGGGTGACAGAGTGAGAAGCTGTCTCAAATAAATAAATAAATAAATAAATAAATAAAAATAAACAAAA"
"chr1","9052736","9052974","chr15","26873577","26873832","75","17820841","GGCAGGACATGGTGGCTCTTGCCAGTAATCTCAGCACTTTCAGAGGCCAAGGTGGGAGGATGGCTTGAGGCCAGGAGTTCAAGACCAGACTGAGCAACATAGCAAGACCCCATCCCTGTAGTCTCAGCTACTAGAGAGGAGGATCACTTGAGCACAGGAGGTGGAGTCTGCAGTGAGCCACAATCGTGCCACTGCACTCCAGCCTGGGCGACAGAGTAAGACCATATTTCAAAAAAAAA","GGTCAGGCACAGTGGCTCACTCCTGTAATCCCAGCACTTTGGGAGGCCAAAGCAGGAGGATTATTTGAGCCCAGGAGTTCAAGGCCAGCCTGGCCAACATAGTGAGATCTTGTCTCTAAATAAATAAATAAATAAATAAATAAATAAATGAGGTGGGAGGATTGCTTGAGTCCCAGGAGGTTGAGGCTGCAGTGAGCCAGGATCATACCACTGCACTTCCACCTGGGTGTCAGAGCAAGACCTTGTCTTAAAAAAA"
"chr1","9061320","9061619","chr1","213591659","213591963","76","204530339","CTGAGTGTGATGGCAAACACTTGAATCCCAGCACTTCGAGAAGCTAAGTAAGGTAGGAGGATCACTTGAGCCCTGGAGTTTGAGACCAGATTGGGCAACATAGGGAAATCCTGTCTCTACCAAAAAAATTTTAAAAATTAGCTGGGTGTGGTGGCACACGCCTGTGGTCCCAGCTACTCACGAGGCTGAGGTGGGAGGATCACTTGAGCCCAGGAATTCAAGGTTGCAGTGAGCTATGGTTGCACCACTGCACTCCAGCCTGGGCCACAAAATGAGACCCTGTCTCAAAAAAAAAAAAAA","GTGCAATGGCTGATGTCTGTAATCCCAGCACAGTGGGAGGCCAAGGCAGGAGGATTGCTTGAGGCCAGGGATTCAAGACCAGCCTGGGCAACCTAGTGAAACCTCATCTCTATTAAAAATAAAAATAAAAATAAAAATTAGTTGGGCATGGTGGCACACACCTGTGGTCCCAGGAGTCCTCAGGAGGCTGAGGTAGGGGGATCACTTGAGCCCAAGAGTTGAGGTTGCAGTGAGCTATGATTGCACCACTGCACTCCAGCATGGGCAACAGAGTGAGACTTTGTCTCAAAACAAAACAAACAAAA"
"chr1","9066699","9067009","chr1","135236320","135236644","83","126169621","GGCTGAGTGCAGTGGCTCAGGCCTACAATCCAAGCACTTTGGGAGGCTGAGGCAGAAGGCACACTTGAGCCCAGTAGCCCAAGACCAGCCTGGGTATAGTGAGACCCCGTCTCTTCAAAATATTTAAAAATTAGCCAAGGGTGGTGCTACATGCCTGTAGTCCCAGCTACTCGGGAGGCTGAGGTGGGAGGATTGCTGGAGCCCCGGACTTCAAGGCCGCGGTGAGCTATGATCCCACCATTGCACTCTGGCCTGGCCAACAGAGTAAGACCCTGTCTCAAAATTAAAAAAAAAAAAAAAGGAAAAAGAAA","GGCTGGGTGTGGTGGCTCGTGCCTATAATCCCAGCACTTTGGGAGGCCAAGGTAGGAAGATCACTTGAGCCCAGGAGTTTGAGACCAGCCTGGGCAAAATGGCAAGACCCTGTCTCTATAAAAATTTAAAAAAATTAGCCAGCTGTGTTTGTATGCGTCTGTCATCTCAGCTACTAGGGAGGCTGAGGTGGGAGGATTGCTTGAGTCCGAGAGTTTGAGGCTGCAGTGAGCTATGATCATGCCACTGTACTCCAGCCTGAGTGACAGAGTGAGACCCTGTCACACACACACACACACACACACACACAAAAGAAAAGGAAAGAAA"
"chr1","9102913","9103072","chr5","32595015","32595178","71","23492102","GATGTGGTGGTGCGTGCCTGTAGTCCCTACTACTCAGGAGGCTGAGACGGGAGGATCCCTTGAGCCCAGGGATTTGAGGCTTCATTGAACTGGGATGGCACCACTGCCACTCCAGCCTGGGCAACAGCAGGACCCTGTCTCAAAAAAAGAAAAAAACAAA","GGCCGGGTGTGGTCCCTCATGCCTGTAATCCCAACACTTTGGGAGGCTGAGATAGGAGGACTGCTTGAGGCCAGGAGTTCAAGACCAGCCTGGTCAACATAGTGAGACCCCATCTCTATAAAATAATAATAATAATAATAATAATAATAATAAATAAATAAATA"
"chr1","9116749","9117040","chr18","16899958","16900260","73","7783209","GACTGGGCATGGCGGCTCTTGTCTGTAATCCCAGCACTTTGAGAGGCCAGGGCGAGAAGATAACTTGAAGCCAGGAGTTCAAGACCAGCCTGGGCAATAAAGCAAGCCTTTGTCTCTACAAAAAGCAAAAAATAAGCCGGGCATGGTAGCATGTGTCTGTAGTACCCCCTACTCAGGAGGTTGAGGTGAGAGGATTACTTGAGTCCGAGATTTGGAGGCTGCAGTGAGCCATGACTATGCCACTGCACTCCAGTCTGGGCAACAGAGCAAGACCCTGTCTCTAAAATAATAA","GTCAGGCGCGGTGGCTCACACCTGTAATCCCAGCACTTTGGGAAGCCGAGGCAGACGGATCACCTGAGGCCAGGAGTTCAAGACCAACCCCGGGCAACAAAGCAAGACCCTGTCTCTATAAAAAAAAAAAAAAAAAAAAAAAAATTAGCCGAGCATGATGGCAAGTGCCTGTAGTCCCAGCTACCTAGGATGTTGAGGTAGGAGGATTGCTTGAGCCCAAGAGGTTGAGGCTGCAGTGAGCCATGATCTCACCACTGCACTCCAGCCTGGGTGACAGAGCGAGACCCTGTCTCAAAAAATAAA"
"chr1","9126907","9127178","chr3","83975049","83975347","86","74848142","GGCCCAGTGTGGTGGCTTGTACCCGTAATCCCAGCACTTTGGGAGGCCGAGGCAGGAGCATCGCTTGAGCCCAGGAGTTCAACTGGCCAACACAGTGAGGCTTTGTCTCTACTAAAAATTTAAAAATTAGCTGGGCATGGTGGCGCATGCCTGTAGTTCCAGCTACTTGTGAGGCTGAGGTGGGAGGATCGCTTGAGCCTGGGAGGTCGAGGCTGTAGTGAGCTATGATTGCAGACAGAGCAACACCCTCTCTCAAAAAAAAAAGAAAAAAA","GGCTGGGTGCAGTGGCTCATGGCTGTAATCCCAGGACTTTGGGAGGCTGAGGCAGGAGAATCACTTGAGGCCAGGAGTTTGAGACCAACCTGGGCAACAAAGTGAGGCATGTCTCTACAAAAACAAAACAAAACAAAACAAAACAATTAGCTGTGTGTGGTGATGCCTGCCTGTCGTCCCAGCTACTCGGGAGGCTGTGGTGGGAGGATCTCTTGAGCCTGGGAGGTTGAGGCTGCAGTGAGCTGTGATTGCCCACTGTACTCTAGCATGGGTTACAGAGCAAGACTCTGTCTCAAAAA"
"chr1","9131082","9131230","chr1","217544386","217544536","68","208413304","TTAGTGGGGCATGGTGACATGCACCTGAAGTCCTAACTACTGGGGAGGCCAAGGTGGGAGAATTCTTAAGCCTAGGAATTTGAGACTGCAGTGAGCTGTGGTTGTACCTGCACTCCAGCCTCGGCGACAAGACCTTGTCTCAAAAAAAA","GGCTGGGCGTGGTGGCTCATGCCTCTAATCCCAGCACTTTAGGAGGCCAAGGCAGGAGGATAACTTAAGACCAGGCTGGGTGACACAGTGAGACTTTGTCTCTAAAAAAAAAAAAAAAAAAAAAAAAAAAAAAAACCTACAAAAACATATA"
"chr1","9131533","9131651","chr1","217544386","217544536","56","208412853","GGCTGGGTGAGGTGGCCTCACGCCTGTAATCCCAGCACTTTGGGAGGCCAAGGCAGGAGTTTGAGACCAGCCTGGGCAATACAGTGAGACCCCATCTCCAAAAAAAAAATTAGTGGGGC","GGCTGGGCGTGGTGGCTCATGCCTCTAATCCCAGCACTTTAGGAGGCCAAGGCAGGAGGATAACTTAAGACCAGGCTGGGTGACACAGTGAGACTTTGTCTCTAAAAAAAAAAAAAAAAAAAAAAAAAAAAAAAACCTACAAAAACATATA"
"chr1","9133186","9133311","chr5","32595015","32595178","61","23461829","GGCCGGGCGCAGTGGCCTGTAATCCCAGCTCTTTGGGAGGCTAAGATGGGAGAAACACTTGAGAGGCCAGGAGTTTAAGACCAGCCTAGACGACTTAGTGAGACTCCATCTCATACAAAAATAAAA","GGCCGGGTGTGGTCCCTCATGCCTGTAATCCCAACACTTTGGGAGGCTGAGATAGGAGGACTGCTTGAGGCCAGGAGTTCAAGACCAGCCTGGTCAACATAGTGAGACCCCATCTCTATAAAATAATAATAATAATAATAATAATAATAATAAATAAATAAATA"
"chr1","9145696","9146002","chr3","99347730","99348048","73","90202034","GCCAGGTGTGGTGGCTCATACCTGTAATCTCAGCACTTTGGGAGGCTGAGGTGGGAGAACTGCTTGAGTCGAGGAGTTAGAGACCAGCCTGGGCAACATAATGAGACCCCTTGTCTTTAGAAAAAATGTAAACATTTGCCAAGTGTGATGGCGTACACCTGTAGTCCCAGCTACTTAGGAGGCTGAGGTGGGAGGCTCGCCTGAGCCCAAGAGGTCAAGGTTGCAGTGAGCCATGATCGCACACTGCACTTCAGCCTGGGCAACAGAGCAAGACCCTGTCTCAGGAAAAAAAAAAAGGAAAAGAAAA","GGCTGAGCATGGTGGCTCATACTTCATCCCAGCACTTTGGGAGGCTGAGGTGGGAGGACTGCTTGAGTCCAAGAATTTGAGACCAGCCTGGGCAACACAATGACACCCCATCTCTCAAAAAAAAAAAAAAAAAAAAAAAAAAAAAGCCAGGCATGGTGGCACACACCTGTGGTCCCAGCTACTTGGGAGTCTGAAGTGGGAGGATCACTTGAGCTCAGGAGATCAAGGCTGCGTGAGCTGTGACTGCATCACCACACTCCAGCCTGGGTAACAAAGTGAGACCCTGTCTCAAAAAAAAAAAAAAGAAAAGAAAAGAAAA"
"chr1","9152127","9152267","chr9","47045786","47045941","49","37893659","GTGATGGCTCACACCTGTAATCCCAGCAATTTTGGAGGCCAAGACAGGAGGATCACTTGAGGCGAGAAGTTCAAAACCAGCCTGGTTAACATAGCCAGACCACCACCTTCAGCAACTGTCTCTACAAAATGAAAATAAAAA","GCTGGGCGCAGCAGCTCACACCTGTAATCCCAGTGCTTTGGAGGTCCAAGGTAGGAGGATTGCTTAAGACTAGGTGTTCAAGACCAGTCTTGGCAACATAGTGAGAACTCATCTCTACAATAAATAAATAAATAAATAAATAAATGAAAATAAAAA"
"chr1","9154735","9154880","chr1","217544386","217544536","65","208389651","GTGGTAGTGCATGCCTGTAGTCCCAGCTACTCAAGAGGCCAGGGTGGGAGGATCACTTGAGCCCAGGAATTGAGGCTGCAGTGAGCCACTGCGCTCTAGCCTGGGTGACAGAGCAAGACCCTGTCTCTAAAAATAAAAATAAAAAA","GGCTGGGCGTGGTGGCTCATGCCTCTAATCCCAGCACTTTAGGAGGCCAAGGCAGGAGGATAACTTAAGACCAGGCTGGGTGACACAGTGAGACTTTGTCTCTAAAAAAAAAAAAAAAAAAAAAAAAAAAAAAAACCTACAAAAACATATA"
"chr1","9168118","9168412","chr17","50238409","50238704","72","41070291","GACCAGGCACGGTGGCTCACACCTGTAATCCTAATGCTTTGGGAAGCTGAGGTGGGAGGATCTCTTGAGCCCAGGAGTTTGAGACCAGCTTGGGCAACACAGGGAGAGGCCATCTCTAAAAAAATATTTTAAAATCATCCAGGTGTGCACCTGTAGTCCCAGTTACTCAAGAGGCTGAGGAGGGAGGATCGCTTGAACCCAGGATTTTGAGGCTGCAGTAGGCTATGATCACACCACTGTACTCCAGCCTGAGCAACAGAGCAAGACCCTGTCTCTAAAAATAAAATAAAATAAA","GACTGGGCGAGGTGGCTCACACCTAGAATTCCAGTGCTTTGGGAAGCCATGGTGGGAGGATTGCTTGAAGCCAGGATTTCGGGACCAGTGTGGGCAACAAAGTGAGACCCCATTTCTACAAAAAAAAAAAAAAAAAAAAAAAAAGCCATGTACCTGTAGTCCTAGTACTCAGGAGGCTGAGGTGGGAAGATGGCTTGAGCCCAGGAGTTCTATACTACAGTGAGCTATGATGGCACCACTGCACTCCAGCCTGGCCAAGAGTATGAGACCCTCTCTCTAAAAAAAAAAAAAAAGAA"
"chr1","9194533","9194660","chr18","55799233","55799394","54","46604700","GGCTGGACATGGTGGCTTACGTCTGTAATCCCAGCACTTTGGGAGGCTGGAGTGGGAAGATTGCTTGAGGCCAGAAGTTGGAGACCAGCCTGGACAACATAGCAAGACCCCATTTAAATAAAATAATA","GGCTGAGAGAGGTGGCTCATGCTTGTAATCCCAGCACATTGGGAGGCAAAGGTGGGAAGATTGCTTGAGGCCAGGAGTTCAAGACCAGCCTGGGCAACATGAAAACACTTTGTCTCTACAATAAATAAATAAATAAATAAATAAATAAAAGAAACAAGAAAA"
"chr1","9220905","9221212","chr10","125157322","125157641","71","115936417","GGCTGGGTGCAGTGGTGCATGCCTGTAATCCCAGCACTTTGGGAAGCCAAGGTGGGAGGATCACTTGAGGCCATAAGTTCAAGTCCAGCCTGGGCAACATGGTAAGACCCTGTCTAAACCAAAAAAATTTGTTTAATTAGCTGGGTATGGTGGCGCATGCCTTTACTCCCAGCTACTAAAGAGGCTGAGGTGGGAGGATCACTTGAGCCCAGGAGGTCAAGGCTGCAGTGAGTTGTGATCATGCCACTGCACTCCAGCCTGGGTAACAGAGCAAGGCCCTGTATCAAAAAAAAAAAAAAAAAAAAAAA","GGCTGGGTGCAGTGGCTCATGCCAGCAATCCCAGCCCTTTGGGAGGCTGAGGTGAGCAGATCGCTTGAGCCCAGGAGTTTGAGACCAGGTGAGGCAACATGGCAAGATCCCCTCTCTACCAAACAAACAAACAAACAAACAAAAAACAACTAGCTAGGGATGGTGGTGCGTGCCTGTAGTCCCAGCTACTTGGGAGGCTGAAGTGGGAGGATCGCTTGAGCCCAGGAGTTCAAAGCTGCAGTGAGTCATGATAGCACCACTGCACTCCAGCCTGGGTGACAGAGTGAGACCCTGTCGCAAAAAAAAAAAAAAAAAAAGAA"
"chr1","9267972","9268266","chr3","99347730","99348048","78","90079758","GTGGCTCATGCCTGTAATCCCAGCACTATGGGAGGCTGAGGTGAGAGGATCACTTGAGCCCAGAAGGTTGAAACCAGCCTGGGCAACATAGTGAGACCCCATCTCTACAAAAAGTTTTAAAACCAGGTATGGTGGTGCCCTCCTGTGGTCCCAGCTACTCGGGAGTCTGAGGTGGGAGGATCACCTGAGCCCAGGAGACTGAGGCTGCAGTAAGGTGTGATTGCACTATTGCTCTCTAGCCTGGAAAACAGAGTGAGACCCTATCTCAAAAAAAAAAAAAAAAAAAAAGGAAAGA","GGCTGAGCATGGTGGCTCATACTTCATCCCAGCACTTTGGGAGGCTGAGGTGGGAGGACTGCTTGAGTCCAAGAATTTGAGACCAGCCTGGGCAACACAATGACACCCCATCTCTCAAAAAAAAAAAAAAAAAAAAAAAAAAAAAGCCAGGCATGGTGGCACACACCTGTGGTCCCAGCTACTTGGGAGTCTGAAGTGGGAGGATCACTTGAGCTCAGGAGATCAAGGCTGCGTGAGCTGTGACTGCATCACCACACTCCAGCCTGGGTAACAAAGTGAGACCCTGTCTCAAAAAAAAAAAAAAGAAAAGAAAAGAAAA"
"chr1","9283011","9283290","chrX","6298217","6298515","86","2984794","GGCCAGGCACAGTGGCTCATGCCTGGAATCCCAACAGTTTGGTAGGCCAAGGCTGAAGGATCACTTGAAGCCAGGAGTTTGAAACCAGCCTGAGCAACATAGAAAGACCCTGTCTCTACAAAAAAAAAAAAGCTAGCTGGGCATTGTGGCATGTGCCTGTAGTCTACAGGCACTAACTGGGAGGCTGAGGTGGGAGGATCACTTGAGGCTGCAGTGAGCTAGGATCATGCCACTGCACTGCAGCCTGACTCTAAAAAAAAAAAAAAGAAAAGAAAAGGAA","GGCCAGGCACAGTAACTCACGCCTGTAATCCCAGCATTTTGGTAGGCCAAGGCAGGAGGATCACTCGAGGCCAGGAGTTCAAGACCAGCCTTGGCAACATGGCCAGTCCCCATCTCTACCAAAAAAAAAAAAAAAAAAAAAAAAAAAGCTAGGCATGGTGTCATGTGCCTGTAGTTGCGGCTACTGGGGAGGCTGGGGCAGGAGGATGCCTTGAACCCAGGAGCTGCAGTGAGCTGTGATGGTGCCACTGCACTCCCGCCTGGGCAACAGAGCGAGACTCTGTCTCTGAAAAGAAGAAA"
"chr1","9299357","9299468","chr20","87144","87254","61","9212213","GGCTGGGCACGGTGGCTCACTCCTGTAATCCTAGCACTTCAGGAGGCCGAGGCAGGAGGATCGCTTGAACTTAGGAGTTTGAGACCAGCCTGGGCAACACAGTGAGACGTCA","CCTGGGCAACATAGTGAGACTACATCTCTACACTCACGCACACACACACACACACACACACACCCCCCAAATTAGCCAGGCATGCTGATGTGCACCCATAGTCTCAGCAAC"
"chr1","9299777","9299982","chr14","51003183","51003398","72","41703406","GCCGACATCATCTCTATAAATTTTTTTTTTTTTTAAATTAGCCAGGCATGATGGTGTGTGCCTGTGGTCCCAGCTACTTGGGTGGCTGAGGTGGGAGGATCGCTTGAGCCTAGGAGGTCAAGACTTGCAGTGAGCAGTGATTGTGTTACTTTACTCCAACCTGGGCAACAGAGTAAGACCCTGTCTCAAAAAAAAAAAAAAAAAAA","AGCCTGGGCAAGATAGTGAGACCTCATCTCTTAAAATAAATAAATAAATAAATAAATAGCAGGATGTGGTGGCGTGCATCTGTAGTCCCAGCTACTCAGGAGGCTGAGATGGGAGGATTACTTGAGCTCAGGAGGTCGAGGCTGCAGTGAGCTATGATCACGCCACTGTACTCCAGCCTGGGTGAGAGTGATACCCTGTCTCTAACAAAAAAAAAA"
"chr1","9304769","9304955","chr8","53067733","53067939","71","43762964","GAGCGCTGTGGCTCATGCCCATAATCCTAGCACTTTGGGAGGATTGCTTGAACCCAGGAGTTCGAGACCAGCCTGGGCAACATAGGGAGACACCGTCTTTGTGAGAAATTTAAAAATTAGCTGGGGGTGGTGGTGTGCACCGATAGTCCCAGCTACTGGGGGGCTGAGGTGGGAGGATTGCTTGAGC","GGTTGGGCACAGTGGCTTATGGCTCTAATTCCAGCATTTTGAGAGGCTGCTTGAGGCCAGGAGTTTGAGACAAGCCTGAGCAACACAGCGAGACCGTGTCTCTACAAACAAAACCAAAAACCAAAAACCAAAAAACAAACTACCCTGGTGTGGTGGCGCCTGTAGTCCCTGCTACTTGGGAGGCTGAGGTGAGAGGGATGCTTAAGC"
"chr1","9309338","9309532","chr14","51003183","51003398","63","41693845","AGCCTAGGCAACATGGCGAGACCCCATCTCTACAAAAACTTTTAAAAATTAGCCAGGTATGGTGACACATACCTATAATTCCCGCTACTCAGGATGCTGAGGTGGGAAGATCGCTTGAGCCCAGGAGTTCGAGGCTGCAGTGAGCTGTGACCGCACCACTGCACTCCAGCCTGGGTGACAGAGAGAGAATCTGTC","AGCCTGGGCAAGATAGTGAGACCTCATCTCTTAAAATAAATAAATAAATAAATAAATAGCAGGATGTGGTGGCGTGCATCTGTAGTCCCAGCTACTCAGGAGGCTGAGATGGGAGGATTACTTGAGCTCAGGAGGTCGAGGCTGCAGTGAGCTATGATCACGCCACTGTACTCCAGCCTGGGTGAGAGTGATACCCTGTCTCTAACAAAAAAAAAA"
"chr1","9312016","9312326","chr17","49042955","49043238","92","39730939","GACCGGACACAATGGCTCGTGCCTGTAATCCCAGAGCTTTGGGAGGCCAAGTTGGGAAGACTGCTTGAGCCCAGGACGGGTTCGAGACCAACCTGAGCAACATAGCACTGCAGCCTGGGTGACAGAGCGAGATTCTGCCTCGAAAAAAATTAAAAAATTAAAAAATTAAAATAAAATAAAAATTAGCCAAGCGTGGTGGCATGTGTCTGTGGTCCCAGCTACTCAGGAGGCTGAGGAGGGAGGATCACTTGAGGAGTTTGAGGTGCAGTGAGCTATGATCACGCCACTGCACTCCAGCCTGGGTGACAGAG","GGCGGGACACAGTAGCTCATGTTTGTAATCCTAGCACTTTGGGAGGCTGAGACAGGAGGATCACTTGAGGCCAGCAGTTCAAGACTAGCTTGAGCAACATAGTGAGACCTGTCTTTACAAAAAAAAAAAAAAAAAAAAAAAAAAAAAAATTAGACAGGCATGGTTGTGGGCACCTGTGGTCCCAGCTACTCAGGAGACTGAGGTGGGAGGATTGCTTGGGCCCAGGAGTTGGAGGCTTCTGTCAGCTATGATCGCATCATTGCATTCCATCCTTGGTGACAGAG"
"chr1","9492041","9492157","chr9","47045786","47045941","62","37553745","GCTGGGCGCAGTGGTTCACGCTGGTAATCCCAGCACTTTGGAAGGCCAAGGCAAGAGGATCTCTTGAGGGTAGGAGTTCAAAACCAGCCTGGGCAACACAGTGAGGCCCTACAAAAA","GCTGGGCGCAGCAGCTCACACCTGTAATCCCAGTGCTTTGGAGGTCCAAGGTAGGAGGATTGCTTAAGACTAGGTGTTCAAGACCAGTCTTGGCAACATAGTGAGAACTCATCTCTACAATAAATAAATAAATAAATAAATAAATGAAAATAAAAA"
"chr1","9498631","9498930","chr5","152110395","152110709","73","142611764","GGCTGGGAGTGGTGGTTCATTCCTGTAATCTCAGCACTTTGGGAGAGGCCAAGACAGGAGGATCGCTAGAGCCCAGGAGTTCAAGACCAGCCTGGGCAACATAGGGAGACCCTGTCTACAAACAGTGTTAAAATTAGCTGGGTGTGGTGGCACACACCTTTAGTCCCAGCTACTTGGGAAGCTGAGGTGGGAAGATTGCTTGAGTCAGGGAGGTTGAGGCTGCAGTAAGCTGTGATTTCACCACTGCACTCCAGCCTGGGCAACAGAATGAGACCCTGTCTCAAAAAACAAAAAACAAAA","GGCTGGGAGTGGTGGCTCATGCCTATAATACCAGCACTTTGGGAGGCCAAGGTGGGAAGATCACTTGAGGCCAGGAGTTCAAGATCAGCCTAGGCAACATAGCAAGACCCTGTCTCTACAAAACAAACAAACAAACAAACAAACAAAATTAGCTGGGCATGGCGGTATGCACCTGTAGTCCCAGCTACTTGGGAGGCTGAGGCAGGAGGATTGTTTGAGCCCAGAAGGTTGAGGCTGCATTGAGCCATGATTATGCCACTTTACTCCAGCCTGGGCAACAGAGGGAGACCCCATTCTCAAAAACAAAACAAAAAA"
"chr1","9586161","9586412","chr1","164929853","164930117","81","155343692","GCGGTAGCTCACACCTGTAATCCCAGCACTTTGGGAGGCTGAGGAAGGAGAATTGCTTGAGGCCAGGAGTTCAAGGCCAGCCTGGGCAACATAGGGAGACCTTCTCTTTACAAAAAAATTAGCTGAGCATGCACCTGTAGTCCCAGCTACTTGGGAGGCTGAGGTGGGAGGATCCCTTGAGGCCAGGAGGTTGAGGCTGCAGTGAGCCATGGGATTGTGCCACTCTACTCCAATCTGGACGACAGAGCAAGA","GGCCAGGTGTAGTGGCTCACACCTGTAATCCCAGCACTTTGGGAGGCTGTGGCGTCAGGATCACTTAGAGTCAGGAGTTTGAGACCAGTCTGCACAACATAGCCAGACCCATCTCTACAAAAAAAAAAAAAAAAAAAAAAAAAATCCTAGCTACTTGGGAGGCCGAGATGAGAGGATCACTTGAGTCCAGGAGTTCAAGGCTGCAGTGAGCTATGATCCTGCCACTGCACTCCGGCCTAGGTGACAGAGTGAGACCAAAAAAAAA"
"chr1","9607966","9608255","chr2A","88638728","88639031","72","79030762","GGTGGCTCATGCCTTTAATCCCAGCACTTTAGGAGGCCAAGGTGGGAGGATGGCTTGAGGCTAGGAGTTCAAGACCAGCCTGGGCAACATAGGGAGACGCTGTCTCTACAAAAAAAGTTGTTTTAATTAACTGGGCATGGTGGCGTACACCTATAGTCCCAGCTATTTAGGCTGAGGTGGGAGGATCGGTTGAACCCAGGAGTTGGAAGCTGCAGTGAGCTATGATCACGCCACTGCATTCCACCATGGGCAACAGAGCAAGACCCTGTCTCAACAAAAATAAAAATAAA","GGTGCAGTGGCTCATGCCTGTAATTCCAGCGCTTTGGGAGGCAAAGGTGGGAGGACTGCTTGAGCCCAGGAGTTTGAAACCAGCCTGGGCAACATAGGGAGACTTCATCTGTATAAATAAATAAATAAATAAATAAATAAATAAGCTGGGCATGGTGGCATGCACCTGTGGTCCCAGCTACTTGAGAGGCTAAGGTGGGAGGATCACTTGAGCCCAGGAGGTTGAGGCTGCAATGAGTCATGATCACGCCACCACACTCCAGCCTGAGCTACAGAGTGAGGTCTTGTCTCAAAAAAAAAAAAAA"
"chr1","9631990","9632001","chr20","87144","87254","99","9544846","TAGAAGAAGGAA","CCTGGGCAACATAGTGAGACTACATCTCTACACTCACGCACACACACACACACACACACACACCCCCCAAATTAGCCAGGCATGCTGATGTGCACCCATAGTCTCAGCAAC"
"chr1","9632311","9632489","chr18","55799233","55799394","71","46166922","AGCTGGGCATGACGGCACATGGCCGCAGTCCCAGTTACTTGGGAGGCTGAGGTGGGAGGATCGCTTGAGCCCAGGAGTTTGAGGCTGTAGTGCATTATCCTTGCACCTGTGAATAGCCACTGCACTCCAACCTGGCAACATAGTTGAGACCCTCTGTCTTTAAAAAAAAGAAAGAAGAA","GGCTGAGAGAGGTGGCTCATGCTTGTAATCCCAGCACATTGGGAGGCAAAGGTGGGAAGATTGCTTGAGGCCAGGAGTTCAAGACCAGCCTGGGCAACATGAAAACACTTTGTCTCTACAATAAATAAATAAATAAATAAATAAATAAAAGAAACAAGAAAA"
"chr1","9649231","9649532","chr14","35729192","35729503","76","26079961","GGCCAGGCATGATGGCTCAGGCCTGTAGTCCCAGCACTTTGGGAGGACGAGGCTGGAGGATCCCTTGAGGCCAGGAGTTTGAGACCAGCCTGGGTGATATGGCAAAACCCAGTCTCTACAAAAAAATAGAAAAAATTAGCCGGGTTTAGTGGTGTGCACCTGTAGTTCCAGATTCTCGGGAGGCTGAGGTGGGAGGATCACCTGAGCCCTGGAGGTTGAGACTGCAGTGAGCCATAACTGTGCCACTGCACTCCAGCCTGGGTGATGGAGTGAGATTCTGCTTTGAAAAAAAAAGAAAAAGA","GGCTGGGCATGATGGCTCAGGCCTATAATCCCAGTACTTTGGGAGGCCAAGGTAGGAGGACTGCTTGAGTCCAGTAGTTTAAGACCAGCTTTGGCAATAAAGTGAGACCCTGTCTCTCCAAAAAAAAAAAAAAAAAAAAAAAAAAAAGCCTGGCACAGTGGCGCACACCTGAAGTCCTAGCTACTCGGGAGCCTGAGGTGGGAGGATCGCTCGAGCCTGGGAGTTCAAGGCTACAGTGAGCTATGACAGTGCCACTGCACTCCAGCCTGGGTGACAGAGAGAGACAACTGCCTTATTAAAAAAAAAAAAAAA"
"chr1","9667177","9667312","chr20","87144","87254","71","9580033","AAAAATTAGCTGGGCACAGTGGCATGCACCTGTAATCCCAGCTACTTGGGAGGCTGAGGCGAGAGGATTGCTTGAGCCCAGGAATTCAAGGTTGCCAAGGGTGATGATCACACCATTGAACTCCAGCCTGGGTGAC","CCTGGGCAACATAGTGAGACTACATCTCTACACTCACGCACACACACACACACACACACACACCCCCCAAATTAGCCAGGCATGCTGATGTGCACCCATAGTCTCAGCAAC"
"chr1","9669162","9669321","chr19","6391716","6391877","70","3277446","CCGGGTGTGGTGGCATATGCCTGTTGTCCCAACTACTAGGTGGGCGGATCACTTGAACCCAGGAGACTGAGGCTGCAATGAGCTATGATAGCTCCACTGCACTGCACCCTGGGTGACAGAGCAAGACCTTGTCTCAAAAAAAGTTAATTAGAAATAAAAA","CCAGGCGCAATGGCTCACGCCTGTAATCCCAACACTTTGAGAGGCCGAGGCAAGAGGATTGCTTGAGGCCAGGAGTCCGAGACCAGCCTGGGCAACACAGCGAGGCCTCATTCTCTACAAAAAATAAATATATAAATAAATAAATAAATAAGAAGAAGAAAA"
"chr1","9681255","9681402","chr1","217544386","217544536","68","207863131","AGCCAGGCATGGTGATGCATACCTGTAGTCCCAGCTGCTTGAGAGGGTGAGGCTGGAGGGTTGCTTGAGCCCAGGAGCTGGAGGCTGCAGTGAGCTCTGATTGTGCCACTGCACCTCAGCCTGGGCAGCAGAGACCCTATCTCTAAAA","GGCTGGGCGTGGTGGCTCATGCCTCTAATCCCAGCACTTTAGGAGGCCAAGGCAGGAGGATAACTTAAGACCAGGCTGGGTGACACAGTGAGACTTTGTCTCTAAAAAAAAAAAAAAAAAAAAAAAAAAAAAAAACCTACAAAAACATATA"
"chr1","9686258","9686498","chr7","49845301","49845560","68","40159043","CGGGCACGGTGGCTCACGCCTGTAATCTCAGCACTTTGCGAGGCCGAGGTGGGAGGATCATTTAAGGCCAGGAGTTTAAGAACAACCTGGGCAAAACAGTGAGACCTCGTCTCTACTAAAAAAAAAAAAAAAAGAAAATTAGCCTGGCATGGTGGCATTTGCCTGTAGTCCTAGCTACTTAGGAGGCCAAGGGAGAAGGATTGCTTGGCCCAGAAGTCTGCGGTGAGCTATGATGGAGCCA","GGTCAGGCATGGTGGCTCATGCCTGTAATCCCAACACTTTGGGAGACCTATGTGAGAGGATCGCCTGAGCCCAGGAGTTTGAGACCAGCCTTGGCGACATAGTGAGACCTTGTCACTACAAAAAAAAAAAAAAAAAAAAAAAAAAAAAATTAGCCGGGCATGGTGGTGCATGCCTGTGTTCCCAGCTATGTGGGAGGCTGAGGGTGGGAGGATTGCCTGGGCCCAGGAGATTGAGACTGCAGTGAGCTGAGATTGCACCA"
"chr1","9688572","9688838","chr10","96412023","96412287","78","86723451","CCGAGCACTTTGGGAGGCTGACGCGGTAGGATGGCTTGAGCCCAGGAGTTCGAGACCAGCGTAGGCAACATAGTTAGACCCCCGCCTCTACAAAAAATTTTAAAAAATTAGCTGAGTGAGGTGGTGCGCACTTGAGGTCTCAGCTACACGGGAGGCTGGGGTGAGAGGATCGATTGAGCCAGAGAGGTAGAGGCTACAGTGAGCTATGATCGCACCACTGCACCCCAGCCAGGGCAACAGAGCAAGACCCTGTCTCAAAAACAAAAA","CTTTGAGAGGAAGACGTAGGAGGATTGCTTGAGCCCAGCAGTTTGAGACTAGCCTGGGCAACATAGGAAGACTCCCATCTCTACACACACACACACACACACACACACACAATTATCCAGGGTGGTGGTGCATGCCTGTGGTCCCAGCTACTTGGGAGGTTGAGGTGGGAGGATTGCTTGAGCCCAGGAGGTCCAGGCTGTAGTGAGCCATGATCATACCGCTGCACTCCAGCCTGGGCAACAGAGTGAGACCCTGTCTCAAAAA"
"chr1","9696813","9697084","chr15","79057692","79057974","77","69360879","GGTCAGGCATGGTGGCTCATGCCTTGTAATCACAGCACTTTGGGAAGCCAAGGCAGGAGGATCGCCTGAGCCCAGGAGTTTGCATCCAGCCTGGGCAATGTACTAAGACCTTGTCTCTACAAAAAATTTGAAAATTAGCCAAGTGTGGTGGTGCATGCCTGTAGTCCCAGTTACTGAGGAGGCGGAGATTGCAGTGAGCTGTACTTGTGACACTGCACTCCAGCCTAGGGGACAGAGTAAGATCCTGTCTCAAAAAAAAAAAAAAAAAAAAA","GGCTGGGCATGGTGGCTCATGTCTGTTATGTCAGCACTTTGGGATGCCAAGGTGGGTGGATCGCTTGAGCCCAGGAGTTTCAGACCCACCGGGGCAACATAGTGAGACCTTGTCTCTATTAAAAACAAACAAACAAACAAACAAACAGCTGGGTGTGATGGCACACTCCTGTAGTTCCAGCTACTCAGGAGGCTGAGGTGGGAGCCAAGATTGCACCACTGCACTCCAGCACTCCAGCCTGGGTGACAGAGCGAGATCGTCTCAAAAAAAAAGGAAAAGAAAA"
"chr1","9706805","9707114","chr14","31798968","31799292","69","22092163","GGCTGGGCTCATGGTGGCTCATGCCTGTAATCCCAGTGCTTTAGGAGGCCAAGGTAGGAGGATCACTTGAGGCCAGGAGTTAGAGACCAGCCTGGGCAACATAGTGAGAGCCCATCTCTACAAAAAAAAAAAAAAATTAAAAATTAGCCAAGCATGGTGGAGCGTGCCTGTAGTCGCAGCTACTTGGAAGCTGAGGTGGAAGGATCACTTGAGCCTGGGAGTTTGAGATGCTATGATGGATCACTACACACCAGCTTGGCAATACAGCAAAATCATGTCTCAAAAAAAAAAGAAAAAAGTAAAAAAAAAA","GGCTGGGCACAGTAGCTTACACCTGTAATCCCAGTACTTTGGAAGGCTGAAGTGGGAGGATCCCTTGAGGCCAGGAGTTTGAGACCAGCCTGGGCAACATAGTGAGACCCTGTCTCTACAACAAACAAACAAACAAACAAACAAAACTTAGCCAGTTGTGGTGGCACATCCTATAGTCCCAGCTACTCAGGAGGCTGAGGAGGGAGGATCTCTTGAGCCCAGGAGTTTGAGGCTGCAGTGAGCTATGATCATGACACTGCACTCCAGCCTGGATAACACAGCAAAATCCTGTCTCAAAAAAAAAAAAAAAAAAAAAAAAAAAGAA"
"chr1","9713597","9713770","chr19","13525969","13526165","70","3812372","ATAAAAAATAAAATTAGCCAGGCATGGTGGTGCATGCCTGTAGTCCCAGCTACTCAGTAGGCTAAGATGGGAAGATCGCTTGGGCCCAGGATGTCAAGGCTGCAGAGAGCTAGGATTATGCCACTGCATTCCAGCCTGTGCAACAAAGTGAGACCATTCTCAAGCAAAATAAAA","AAGAAATAAATTAGTTGAGCATGGTGGTGCATGCCTATAGTCCCAGCTACTGGGGAGGCCAAAGTGGGAGGATTGTGTGAGCCCAGGAGTTTGAGGCTGCAATGAGCCAAGATTATGCACACCAGTGTGGGAGACAGTCAAGTCTCAAAAAATAAACAACAACAACAACAACAACAACAAACACATAAAAAGAAAAA"
"chr1","9753809","9754106","chr8","25360790","25361095","75","15606981","GGCCAGGTGCAGTGGCTCACACCTATAATCCCAGCACTTTGGGAGGCTGAGGTGGGAAGATTGCTTGAGCCTAGGAGTTTGAGAGCAGCCTAGACAATGTAGGAGATGCCATCTCTACAAAACATAAACAGCCAGGTATGGTGGCACATGCCTGTGGTCTCAGCTACTTGGGAGGCTAAGGCGGGAGGATTGCTTGAGCCCGAGAGGTTGAGGCTGCAGTGAGCCATGATTGTGCCACTGTACTCCAGTCTGAGTGTCAGAATGAGACCCTGTCCCTAAAAAACAATAACAACAAAAA","GGCTGGGAGCAGTGGCTCATACCTGTAAGCCCAGCACTTTGGGAGGCTGAGGTGGGAGGATTGCTGAAGCCCAGGAGTTTGAGACCAACCTGGGCAATGTAGGGAGACCCCGTCTCTACTAAATAAATAAATAAATAAATAAATAAAGTCGGGCATGGTGGCATGTGCCCTGTAGTCCCAGCTTCTTGGGAGGCTGAGGTGGGAGGATTGCTTGGGCCCAGGAATCAAGGCTGCAGTGAGCTGTGATTGTGCCACTGTACTACAGCCTGGGTGACAGTGCAAGACTGTCTCAAAAGAAAAACAAAA"
"chr1","9797353","9797657","chr19","36137286","36137590","80","26339933","GGCTGGCCATGGTGGCTCATGCCTGTAATTCTATCCCTTTGGAGGCTAAGGTGGGGACAATCACTTAAGCCAGTAGTTCAAGACCAACCTGGTCAACATTAATGAGACCTCAATCTCTACAAAATAAATTTTTTTAAAATTAGCCTGGCGTGGTGGTGCATGTCTGTAGTCTCATCTACTTGGGAGGCTCAGGCGGGAGGATCATGTGAGCCCAGGAGTTGGAGGTTGCAGTGAGCTATGATTATGCTACTGCACCCCAGTCTGGGTGACAAAGCAAGACCCTGTCTCAAAAGAAGAGAAGAGAA","GGCTGGACATGGTGGCTCATGCCTGTAATCCCAGCACTGTGGGAGGCCGAGGTGGGAGGATCACTTCAGACCAGAGTTTGAGACCAGCCTGGCCAACATAGTGAGACCTCATCTCTACAAAAAAAAAAAAAAAAAAAAAAAAAAATTAGCTGGGCATAGTGCCACATGCCTTTGGTCCCAACTACTTGGGAAGCTGAGGCAGAAGGACTGCTTGAGCCCAGAAGTTCAAGGCTGCAGTGAGCTATGATCATGCCACCGCACTCCAGTCTGGGCAATGGAGCAAGACCCCGCCTCAAAAAAATAAA"
"chr1","9802814","9803121","chr2B","83001661","83001979","71","73198847","GCTGGGCGTGGTGGCTTATGCCTGTAATCCCAGCACTTTGGGAGGCTGAGGCAGGAGGATCACTTGAGCCAGGAGTTTGAGACCAGCCTGGACAACATAGCGAAACCTTGTCTCTACAAAAAATAAAAAATTACCTAAGTGTGGTGGCAGGTGCCTGTGGCCCCAGTTACTTGAGATGCTTAGGTGGGAGGATCATTTGAGCCCTGGAGCTTGAGGCTGCAGTGAGCCCTGATTGTGTCACTGCACTCCAGCCTGGGCGACAAAGTGAGACTCTGTCTCAAAAAAAAAAAAAAAAAAATCTAAGAAAA","GGCTGGAGATGGTGGCTCACACCTGTAATCCTAGTACTTTGGGAGTCCGAGGTAGGAGGATCACTTGAGGCCAGAAGTTTAATACCAGCCTGGGCAACATAGTGAGAGCCTATCTCTACAAAAAAAAAAAAAAAAAAAAAAAAAGCCAGGTGTGGTGGTGCATGTTTGTAGCCTCAGTTACTTGGGAGGCTGAGGTGGGAGGATCATTTGAGCCCAGGAGGTTAAGGCTGCAGTGAGCCAGTTATGGCACCACTGTACTCCAGCCTGGGCGACAGGGCAAGACCCTGTCTCACAAACAAAAACAAAACAAGACAAAAAA"
"chr1","9814629","9814918","chrUn_NW_019938566v1","98142","98430","77","9716487","GCTGGACATGGTGGCTCACGCCTATAATCGCAGCACTTTGGAGGGCCAAAAAGGGCAGAATGCTTGAGCCCAAAAGTTCGAGACCAGCCTGGGCAACATAGGAAGATCCCGTCTCTACAAAAATTTTAAAATTAGCCAGGCATGGCGGTGTGCACACCTACTCAGGAGGCTGAGGTGGAAGGATAGTTTAAGCCAAGGGAGGTTGAGGCTGCAGTGAGCTGTGATTGTGCCACTGCACTCCAGCCTGGGCAACAGAGCAAGATCCTGTCTCAAAAAAAAAAAAAGAAAAA","GCTGGGCGTGGTGGCTCACGTCTCAAATCCCAGCACTTTGGGAGGTCAAGCACTGAGGATTGCTTAAGGCCAGGAGTTTGAGACCAGTCTGGGAAACATAGTGAGAGTCTGTCTCTACAAAACACACACACACACACACACACACACACCTGTAGTCCCAGGTACTCAGTAGGCTGAGGCAGGAGGATTGCTTGATCCCAGGAGTTCAAGGCTGCAGTGAGCTGAGATTGCACCACTGCACTCCAGCCTGGGCAACAGAGCAAGACTGCATCTCTAAAAAAAAAAAAAA"
"chr1","9833319","9833609","chr1","84037299","84037592","69","74203980","CAGTGGCTCACACCAGTAATCTTAATTCTTTGATGAGGCTGAGACGGAAGGATATCTTGAGGCCAGGAGTTCAAGACCAGCCTGGGCAATATAGTGAAACCTCATTTCTACCAAAAAAAAAAAAAAAAAAAGTTAGTTGGGCATGGTAGCAGGTGCCTGTAGTCCCAGCTGCTCGGGAGGCTGAGGCAGGAGGATCACTTGAGCCCAGGAGTTCAAGGCTGCAGTGAGCTATGATGGCACCACTGCACTCCAGCCTAGGTGACAAAGCAAGACCCTGTCTCTGAAAAAAGA","GACCAGGTGCAATGGCTCACGCCCGTAATCCCAATACTTTGGGAGGCTGAGGCAAGAAGATTGTTTGAGGCCAGGAGTCTGAAATCAGCCTAGGCAATATAAGCAGACCTAGCTCTACAAAAAAAAAAAAAAAAAAAAAAAAATTAATAGCCAGGTGGTGCGTGCCTGTAGTCCCAGCTACTTGGGAGGCTGAGGCAGGAGGATCACCAGAGCTCAGGAGTTCAAGGCTGCACTGAGCCATGATCACGCCACTGCACTCCAGCCTGGGTGACAGCAAGGCCCTGTTTCAAAAAA"
"chr1","9855726","9855907","chr12","23162528","23162744","74","13306802","AAAAAAAAATTAATTAGCCGAGTGTAGCAGTGTGGGCCTGTGGTCCCAGCTCCTCAGGAGGCTGAGGTGAGAGAATCAATTGAGTCCAGAAGGTCAAGGCTGCTTTGAGTGCTGATTGTACCACTGCACTCTAGCCTGCGTGACAGAGCAAGACCCTGTCCAGGAAAAAAAAAAAAAAAAAA","TCTCTACAGAAAATAATAAAAACTTGGCTGGGCATGGTGGCATGTTCTTGTAGTCTCAGCTACTCAGGAGGCTGAGGTGAGAGGATTGCTTGAGCCCAGAAGGTTGCGTTAGGGTTAGGGTTAGGTTTAGGGTTAAGGTTAGCCATGATTGCACTCTTGCCTGGGCAACAGAGCAAGACCCTGTCTCAAAAAAAAAAAAAAAAAAAAAAAAAAAAAA"
"chr1","9856178","9856309","chr9","47045786","47045941","58","37189608","GCCAGGCGTGGAGGCTCATTCCTGTAATCCCAGTACTTTACATGGCAGAGGCAAGAGGATGGCTTGAGCCCAGGAGTTCAAGACCAGCCTGGGCAACATAGGAAGATACCCCATCTGTCAAAACAATTTTTC","GCTGGGCGCAGCAGCTCACACCTGTAATCCCAGTGCTTTGGAGGTCCAAGGTAGGAGGATTGCTTAAGACTAGGTGTTCAAGACCAGTCTTGGCAACATAGTGAGAACTCATCTCTACAATAAATAAATAAATAAATAAATAAATGAAAATAAAAA"
"chr1","9873744","9874001","chr10","96412023","96412287","66","86538279","TTGGGGAGGATGAGGTGGGAGGATCACTTGAGCCCAGGAGTTTGAGACCAGCCTGGGCAACATAGCAAGACCCTGTCTCTACAAAAAAATGTTTTTAAATTAGCCAAGCGTGGTGATGTGCACCTGTGGCCCTAGCTTACTCAGGAGGCTGAGTTGGGAGGATTGCTAAAGCCCAGCAGGTTGAGGCAGCAGTGAGCTATGATCGCGCCACTACACTCCAGCCTGGGCGACAGAGGGAGACCCTGTGTCAAAAAATAA","CTTTGAGAGGAAGACGTAGGAGGATTGCTTGAGCCCAGCAGTTTGAGACTAGCCTGGGCAACATAGGAAGACTCCCATCTCTACACACACACACACACACACACACACACAATTATCCAGGGTGGTGGTGCATGCCTGTGGTCCCAGCTACTTGGGAGGTTGAGGTGGGAGGATTGCTTGAGCCCAGGAGGTCCAGGCTGTAGTGAGCCATGATCATACCGCTGCACTCCAGCCTGGGCAACAGAGTGAGACCCTGTCTCAAAAA"
"chr1","9874288","9874551","chr3","98206950","98207200","84","88332662","CGGGCATGGTGGCTCATGCCTGTTAATTCCAATATTTTGGGAGACCAAGGCAGGAGGATTGCTTGAGACCAGGAATTTGAGACCAACCTGGCTGTGCAACATAACAAGACCTCTACAAAAAAATTTAAAAGTGGCAGGGTGTTGTGGCATGCTTCTGTGGTCCCAGCTAGTTAGGAGGCTGAGGCAGGAGGATCGCTTAAGCCCAGGAGTTCAGGGCTGCAGTGAGTTCTGATCATACCACTGTACTCCTGGGCACCAGAGCAA","GCCAGATGGAGTGGCTCATGCCTGTAATCCCAGCATTTTGGGAGGCTGAGGCAGAAGGACTGCTTGAGACCAGGAATTCAAAACCAACCTGGGCAACCTAGTAGGACTGGCTCTACAAAAAAAAAAAAAAAAAAAAAAAAATTAAGTACCTGGGCTGGGTTCCACCTACTTGGGAGGCTGAGGTAGGAGGACTGTGAGCCCAGGAGTTTGAGGATGCAGTAAGCCACTGCTCTCCAGCCTGGGTGACAGAG"
"chr1","9881035","9881323","chr12","108570006","108570305","80","98688971","GGCTGGGTGTGGTGGCTCATGCCTGTAATAAGAGGCGGAGGTGGGAGGATTGCTTGAGCCCAGGAGTTCAAGACCACCCTGGGCAACATCATGAGAACCTGTCGCTACAAAAAATATAAAAATTAGCCGGATATGGTGGTGCATGCCTGTGGTTCAGCCATGCAGGAGGCTGAGGTGGGTGGATTGCTTGAGCTAGGGAGTTCAAGGCTGCAGTGAGCCATGATTGCACCACTGTACTCCAGCTGGAGCAACAGAGCAAGACCCTCTCTCTCAAAAGAAAAAAAAAGAA","GGCAGGGCGTGGTGGCTCACACCTGTAATCCCTGTATTTTGGGAGGCTGAGGCAGGACGATTGCTTGAGGCTAGGAGTTTGAGACCAGTCTGGGCAACATTTAAATAAATAAATAAATAAATAAATAAATAAATAAATCAGCCAGGCATGGTAGCATGAACCTGTAGTCCCAGCTCCTCAGGAGGCTGAGGGAGGATTGCTTGAGCCCAGGAGTTCAAGGTTGCATTGAGCCATGATTGCACCACTGTACTCCAGCCTGGGAAACAGAGTAAGACCCTGTCTCAGAAACAAACAAAAAAA"
"chr1","9891664","9891781","chr5","32595015","32595178","64","22703351","GGGCACAGTGGCAAATGCCTGTAATCCCAGCACTTTGGGAGACTGAGGTAGGAGAATTGCTTGAGGCCTGGACTTCAAAACCAGCCTGGGCAATAAAGTAAGACCCCATCTCTTTAAA","GGCCGGGTGTGGTCCCTCATGCCTGTAATCCCAACACTTTGGGAGGCTGAGATAGGAGGACTGCTTGAGGCCAGGAGTTCAAGACCAGCCTGGTCAACATAGTGAGACCCCATCTCTATAAAATAATAATAATAATAATAATAATAATAATAAATAAATAAATA"
"chr1","9892105","9892142","chr20","87144","87254","76","9804961","TTCTACAAAAAATCTTTAAAAGATTAGCTGGGTGCAGC","CCTGGGCAACATAGTGAGACTACATCTCTACACTCACGCACACACACACACACACACACACACCCCCCAAATTAGCCAGGCATGCTGATGTGCACCCATAGTCTCAGCAAC"
"chr1","9892440","9892611","chr12","4864673","4864880","67","5027767","GATTAGCTGGGTGTGCAGTGGCTTGCACCTGTAGGCCCAGTTACTTGGGAGGCTGAGGTGGGAGGATCCCAAGAGCCCAGGAGTCTGAGGTTGCAGTGAGCTATGATCACACCACTGCACCCCAGCCTGGGCAACAGAGCGAGACTGTCTCAAAAAAAAAAAAAGAAAAGAA","AATTAGCCAGGTATGGTGGTGTGCACATGCAGTCCCAGCTGTTTGGGAGGCTGAGGCAGGAGGATCACTTGAGCCCAGGAGTTTGAGGCTGCAGTCAGCTATGATCATGCCACTGCACTCCAGCCTGGACAACAGAACAAGACCCTGTCTCAAAAACAAAACAAAACAAAACAAAACAAAACAAGAACAGAAAACAATCAAACAAAAA"
"chr1","9931086","9931249","chr16","46964977","46965105","85","37033891","TTAAAAAGAAAAAAAATTAGCTAGGTGTGGTGGCATGCACTTACAGTTCTAGCTACTTGAGAAGCTGAGGCAGGAGGATCACTTGAACCCAGATATTTGAGGCTGCAGTGAGCCAAGATCATGCCATTGTACTCCAGCCTGGGTGACAGAGCAAGACCTGTCTC","AGACTGGCCTGGGCAATGCAGTGAGACCCCATCTCTACAAAACAAAAACAAAAACAAAAACAAACCAATTAGCTGGGCATGGTGGTGCATGCCTGTAGTCCCAGCTATTTGAGAGGCTAAGGTGGGAGG"
"chr1","9931562","9931640","chr8","58489091","58489211","58","48557529","CTTGAGGCCAGGAGTTCTAGACCAGCCTGGGCAACATGGTGAGACCCTTTGTCTTCAAAATTAAAAAGCGGGAGGCCAA","TTGAGACCAGGAGTTTGAGACCAGCTTGGACAACATAGTGAGACCCTGTCTAAAAGAAAGAAAGAAAGAAAAGAAAGAAAGAAAGATGTAGCCAAGTGTGGTGGTGCACATCTGTGTCTCA"
"chr1","9936686","9936820","chr9","47045786","47045941","54","37109100","GACTGGGTGTGGTGGCTTATGCCTATAATCCCACCTCTTTGGTAGTCCAAGATGGGAGGGTCACTTTAGGCCAGATGTTCCGAGACCAGCCTGGGCAACATAGTGAGACTCTGTCTCTACAAAAAATAAAACTTA","GCTGGGCGCAGCAGCTCACACCTGTAATCCCAGTGCTTTGGAGGTCCAAGGTAGGAGGATTGCTTAAGACTAGGTGTTCAAGACCAGTCTTGGCAACATAGTGAGAACTCATCTCTACAATAAATAAATAAATAAATAAATAAATGAAAATAAAAA"
"chr1","9947186","9947318","chr20","87144","87254","69","9860042","CTACTTGGGAGGCGGAGGTGGGAGGATCACCTAAGTCTAGGAGTTCAAGGCTGCAGTGAACCATGATCACGCCATTGCACTCCAGCCTGGGCGACACAGCAAGACCCTGTCTCCAAAAAAAAGAGAAGAGAAA","CCTGGGCAACATAGTGAGACTACATCTCTACACTCACGCACACACACACACACACACACACACCCCCCAAATTAGCCAGGCATGCTGATGTGCACCCATAGTCTCAGCAAC"
"chr1","9954224","9954508","chr3","90264983","90265291","76","80310759","GGCTGGGTCCAGTGGCTCATGCCTGTAACCCCAACACTTTGAGGCTGAGGTGGGAGGATCGTGTGAAGTCAGGAGTTCAAGACCAGCCTGGGCAACATGGTGAGACATCATCTCTACAAAAAATAGAAGAAGTTAGCTGGGCATGGTGTCATGCACCTGTAGTCCCTGCTACTTGGGAGGTTGAAGTAAGAGGGTCACTAAAGCCCAGGAGGTGGAGGGTGCAGTGAGTCATGTCATTGCACTCCAGCCTGGGTGACAGAGGGAGGCCCTATCTCCAAAAAAAAA","GGCTGGGCCTAGTGGCTTATGCCTGTAATCCAAGCACTTTGGGACACTGAAATGGGAGGATCAGTTGAGATCAGGAGTTTGAGACCAGCCTAGGCAACATAGTGAAGACCTCATTACTACTACAAAAAAAAAAAAAAAAAAAAAAAAAAAGCCAGGCATGGTGTCAAGCACCTGTAGTACCAGTTGCTTAGGAGGCTGAGGTGGGAGGATCACTTGAGCCAGGAGGTTGAGGCTGTAGTGAGTCAACTTTGTGCCACTGCACTCCAGCCTGGGTGACAGAGTGAGACTTTGTCTCAGAAAATAAATAAA"
"chr1","9960136","9960313","chr2A","60286019","60286209","58","50325883","TTAGCCAGGAGTGATGGCGTGTGCTTGTAGTACTAGCTACTTGGCAGGCTGAGGTGGGAGGATCTCTTGAGCCTGGGATTTGAAGGCTGCAGTGAGCAATGATTGTGCCACTGTACTGCAGCCTAGGCAACAGAGCGATACCCTATCTCTAAAAAAAACAAAAACAAAAACAAAAAAA","AAAATTAGCCAGGTGTGATGGCACCTGTAGTCCTAGCTACTTGGGAGGCTAAGGTGGGAAGAGGGCTTGAGCCCAAGATTGTGAGGCTGTGGTGAGTCATGACTGTGCCATTGCCCTCTGGCCTGGGTGACAGAGTGAGAAGCTGTCTCAAATAAATAAATAAATAAATAAATAAATAAAAATAAACAAAA"
"chr1","9960380","9960506","chr1","217544386","217544536","56","207584006","GGCCAGGTGTGGTGGCTCATGCCTCTAATCCCAGCACCGTGGGAGGCCAAGGTGGGAGGATCACTTGAGGCCAGGAGTTTGACACCAGCCTGGGCAACACAGCGAGACCCCATCTCTACCAAAAATA","GGCTGGGCGTGGTGGCTCATGCCTCTAATCCCAGCACTTTAGGAGGCCAAGGCAGGAGGATAACTTAAGACCAGGCTGGGTGACACAGTGAGACTTTGTCTCTAAAAAAAAAAAAAAAAAAAAAAAAAAAAAAAACCTACAAAAACATATA"
"chr1","9971681","9971982","chr8","25360790","25361095","78","15389109","GGCTGGGCGTGGTGACTCATGCTTGTAATCCCAGCACTTTGAGAGACTGAGGTGGAAGGGTTGCTTGAGACCAGTAGTCTGAGAGCAGCCTGGGCAACATAGCAAGACCCCCATCTCTACAAAAATTAGTCTTTAAAATAATTAGCCAGCCTATTGGTATGTGCCTGTGTTCCCAGCTACTTGAGAGGCTGAGGTGGGAGCATCACTTGAGCCCAGAAGTTTGAGGGTGCAGTCAGCTGTGGTTGCATCACTACACTCTAGCCAGGGTGGCAGAGCAAGACCTTATCTTAGGGAAAAAAAAA","GGCTGGGAGCAGTGGCTCATACCTGTAAGCCCAGCACTTTGGGAGGCTGAGGTGGGAGGATTGCTGAAGCCCAGGAGTTTGAGACCAACCTGGGCAATGTAGGGAGACCCCGTCTCTACTAAATAAATAAATAAATAAATAAATAAAGTCGGGCATGGTGGCATGTGCCCTGTAGTCCCAGCTTCTTGGGAGGCTGAGGTGGGAGGATTGCTTGGGCCCAGGAATCAAGGCTGCAGTGAGCTGTGATTGTGCCACTGTACTACAGCCTGGGTGACAGTGCAAGACTGTCTCAAAAGAAAAACAAAA"
"chr1","9979186","9979484","chr1","213591659","213591963","75","203612473","GGCTGATCATGGTGGCTCACATCTATAGTCCCAGCACTTTGGGAGTCTGAGGCAGGAGGATTGCTTGAGGCCAGGAGTTCAAGACCAGTGTGGGCAACATAGTGAGACCTCATCTCTCCAAAAAACTAAAGTTAGCTGAACATGGTGGCACGTGCCTGTAGTCGCAGCTATCTGGGAGGCTGAGGCGGTAGGATCACTTGAGCCCAGGAGTTTTGGTTGCAGCGAGCTATGATTGTGCCACTGTGCTCCATCCTGGGCAATAGAGTGAGCCTGTGTCTCTGAAAAACAAACCAAAAAAA","GTGCAATGGCTGATGTCTGTAATCCCAGCACAGTGGGAGGCCAAGGCAGGAGGATTGCTTGAGGCCAGGGATTCAAGACCAGCCTGGGCAACCTAGTGAAACCTCATCTCTATTAAAAATAAAAATAAAAATAAAAATTAGTTGGGCATGGTGGCACACACCTGTGGTCCCAGGAGTCCTCAGGAGGCTGAGGTAGGGGGATCACTTGAGCCCAAGAGTTGAGGTTGCAGTGAGCTATGATTGCACCACTGCACTCCAGCATGGGCAACAGAGTGAGACTTTGTCTCAAAACAAAACAAACAAAA"
"chr1","10001318","10001563","chr10","96412023","96412287","64","86410705","AGGCAGAGGCAGGAGGATTGCATGTGGCCAGGAGTTTGAGACCAGCCTGGACAACACAGCAAGACACCGTCTCTACAAAAAAATTGAAAAATTGGCCAAGTGTGGTGGTATGCACCTGTTGTCCCAGCTACTTGGAAGGCTGAGGTGGGAGGATCGCCTGAGCCCAGGAAGTGAAGGCTGCAGTGAGCCATGATCGCACCACTGCACTACAGCCTGAGCGACAGAGCAAGACCCTATCTCAAAAAA","CTTTGAGAGGAAGACGTAGGAGGATTGCTTGAGCCCAGCAGTTTGAGACTAGCCTGGGCAACATAGGAAGACTCCCATCTCTACACACACACACACACACACACACACACAATTATCCAGGGTGGTGGTGCATGCCTGTGGTCCCAGCTACTTGGGAGGTTGAGGTGGGAGGATTGCTTGAGCCCAGGAGGTCCAGGCTGTAGTGAGCCATGATCATACCGCTGCACTCCAGCCTGGGCAACAGAGTGAGACCCTGTCTCAAAAA"
"chr1","10023403","10023486","chr20","87144","87254","60","9936259","TCACACTTGTAATCCTAGCACTTTGGGAGGCTGATGTAGGAGGATCACTTGAAGCCAGGGGTTTGAGACCAGCCTGGGCAACAT","CCTGGGCAACATAGTGAGACTACATCTCTACACTCACGCACACACACACACACACACACACACCCCCCAAATTAGCCAGGCATGCTGATGTGCACCCATAGTCTCAGCAAC"
"chr1","10024242","10024522","chr19","13342110","13342403","74","3317868","TCACACTTGTAATCCCAGCACTTTGGGAGGCTGATGTAGGAGGATCGCTTGAGGCCAGGTGTTTGAGACCAGCCTGGGCAACATAGGGAGACCCTGTCTCTACAAAAAATACAAAAATTAGTTGGGTGTGATGGTTCATGCCTGTAGTCTCAGCTACTCAGGAAGCTGAGGTGGGAGGATTACTTGGGCCCAGGAGGTCGGGGCTGCAGTGAGCCAGTGACCATGCCAGTATACTCCAGCCCTGATTACAGAACAAACCCCTATCTCAAACAAACAAACAA","TCATGCCTGTAATCCCAGCACTTTGGGAAGCCAGGGCAGGAGGATCACTTGAGACCAGGAGTTTGAGACCAGCCTGGGCAACATAGCCAGACCCCCATCTCAACAACAACATCAACAACAACAACAACAAATTAGCTGGGTGTGGTGGTGCCTGTAGTCCCAGCTACTTGGGAGGCTAAGCTGGGAGGATCGCTTGAGCCCAGGAGCTCCAGGCTGCAGAGAGCTATGATCATATCACTGCACTCCAGCCTGAGTGACAGAGCAAGAACCTGCCTCTAAAAACAATAAACAAAA"
"chr1","10027456","10027625","chr5","32595015","32595178","70","22567559","TAGCCAGGCTCAGTGGTGCCTGCCTATAGTCCCAGCTACCCAGGAGGCTGAGACAGGATGATCACTTGAGTCCGGGAGATCATGGCTGCAGTGAGCTATTATCATGCCATAACACTCCAGTCTGGGTGAGAAAGTGAGACCTTGTCTCTAAAAACTAAACTGAAAAAAAA","GGCCGGGTGTGGTCCCTCATGCCTGTAATCCCAACACTTTGGGAGGCTGAGATAGGAGGACTGCTTGAGGCCAGGAGTTCAAGACCAGCCTGGTCAACATAGTGAGACCCCATCTCTATAAAATAATAATAATAATAATAATAATAATAATAAATAAATAAATA"
"chr1","10027920","10028075","chr18","55799233","55799394","51","45771313","GGCCTGATATAGTGGTTCACACCTGTAATTCCAGCACTTTGGGAGGCCGAGGTGAGGGGATCGCCTGAGGCCAGCACCAGCCTGGGCAACATAGCGACACTATCTCTACAGAAAACAAAACAAATCAAAACAAAACAAAAAAATAGTCAGGCTCAT","GGCTGAGAGAGGTGGCTCATGCTTGTAATCCCAGCACATTGGGAGGCAAAGGTGGGAAGATTGCTTGAGGCCAGGAGTTCAAGACCAGCCTGGGCAACATGAAAACACTTTGTCTCTACAATAAATAAATAAATAAATAAATAAATAAAAGAAACAAGAAAA"
"chr1","10036504","10036600","chr15","37343640","37343763","65","27307136","CACTTTGGGAGGCTGAAGTGGGAGGATCGCTTGAGGTCAGGAGTTTGAGACCATCCTGGGAAACATGGCAAGACCCCCGTCTCTACAAAAAAAAAAA","AAGATCCCTGGCCAGGATTTCAAGACCAGCCTGGGCAACACAGTGAGACCATACATACATACATACATACATACATACATCATACATACATACATACATACATACATACACAGTCTTACAAAGA"
"chr1","10047869","10048148","chr1","213591659","213591963","95","203543790","GGACGGATGCAGTGGCTCATGCTTATAATCCCAGGGCCTTGGGAAGCCAAGGAAGGAGGATTGTTTGAAGTCAGGAGTTCAAGACCAGCCTAGGCAACACAGGGAGACCCTCGTCTCTAATAAAAATTTAAAAATTAGCTGGGCACAGTGGCACACACCTCCCAGTTACTCAGGAGACTAAGGCAGAAGGATCACTTGAACCCAGGAGTTAGAGGCTGCACTGTACTCTAGCCTGGGTGACAAAAAATACCTTGTCTCTAAAAAAGTAAAATAAATAAAA","GTGCAATGGCTGATGTCTGTAATCCCAGCACAGTGGGAGGCCAAGGCAGGAGGATTGCTTGAGGCCAGGGATTCAAGACCAGCCTGGGCAACCTAGTGAAACCTCATCTCTATTAAAAATAAAAATAAAAATAAAAATTAGTTGGGCATGGTGGCACACACCTGTGGTCCCAGGAGTCCTCAGGAGGCTGAGGTAGGGGGATCACTTGAGCCCAAGAGTTGAGGTTGCAGTGAGCTATGATTGCACCACTGCACTCCAGCATGGGCAACAGAGTGAGACTTTGTCTCAAAACAAAACAAACAAAA"
"chr1","10053060","10053138","chr20","87144","87254","65","9965916","AGCCATGCACGGTTGTAAACACCTGTGGTCCCAGTTACTCGGGAGGCTGAGGTGGGAGGGTCGCTGATGAAATTAGGAG","CCTGGGCAACATAGTGAGACTACATCTCTACACTCACGCACACACACACACACACACACACACCCCCCAAATTAGCCAGGCATGCTGATGTGCACCCATAGTCTCAGCAAC"
"chr1","10053449","10053504","chr20","87144","87254","68","9966305","CCAGCCTGGGCGACGAGCAAAATTCCATCTCAAAAAAATTAAATAAAAAATAAATA","CCTGGGCAACATAGTGAGACTACATCTCTACACTCACGCACACACACACACACACACACACACCCCCCAAATTAGCCAGGCATGCTGATGTGCACCCATAGTCTCAGCAAC"
"chr1","10071300","10071588","chrX","46692258","46692555","69","36620958","GGCTGGGCATGGTGCTTCATGCCCATAATCCTAGTACTCTGGGAGGCCAAGGTGGGAGGATCACTTGGGGCCAGGAGGTTGAGACCAGCCTGGGCAACATAGTGAGACCTCGTCTCTGTCAAAAATTAAAAAAAATTAATTAGCTGGACATGGTGGTTTGCACCTGTAGTGTTAGATACTTAGGAGGCCGAGGTGGGAAGATTACTTGAGCCCAGGAGTTCAAGGCTGCAGTGAGCTATGATTGAAATACTGCACTCCAGCTTGGGTGACAGAGAGACTCTCTCTAAAA","GGCCAGGCATGGTGGCTCATGCCTGTAATCCCAGCACTTTGGGAGGCTGAGGAAAGATGATCACTTGAGCCAGGAGTTTGAGCCCAGTCTGGGTAACATAGTGAGACCTCCATCTCTACAAAAAAAAAAAAAAAAAAAAAAAAAAGCTGGGCATGGTAGCACACATCTGTAGTGTCAGCTACTCAGGAGGCTGAGGTAGGAGGATTGCTTGGGCCCAGGAGATCAAGACTGCAGTGAGCTATGACTGCACCACTGCACTCCAGCCTGGGCAATGGAGTGAGACCCTGTCTCAAAAAAA"
"chr1","10078836","10079101","chr12","82298322","82298589","85","72219486","CATGCCTGTAATCCCAATACTTTGAGAGATTGAGGCAGGAAGATCGCTTGAGGCCAGGAGTTCAAAACCAGCCTAGGCAACACAGTAAAACTTCATCTCTACAAAAAAAATTAAAAAATTAGCCAGGCATGGTGGCGCGCACCTGTAGTCTCAGCTACTTCTGAGGCTGAAGCAGGAGGACCACTTAAGCTCAGGAGTTTGTGGCCGCAATGAGCTATGGTCGCACCACTGTACTCCAGCCTGACTTTGTCTTAGAAAAACAAAAA","TCATGCCTTTAATCTTAGCACTTTGAGAGGGTGGGCCAGAAGAATTGCTTGAGGCCAGGAGTTCAAGACCAGCCTGGGCAACAGAGTGAGACCCCATCTCTAATAATAATAATAATAATAATAATAAAAAGCCAGGCGCAGTGGCATGTACCTTTAGGCCCAGCTAATTGGGAAACTGAGGCAGAAGGATCACATGGAGTTCTAGGCTAAAGTGAGCTATGGTCACACCCCTTAACTCCAGCCTAGGGGACAGAATGTGACCTTGTCT"
"chr1","10091443","10091607","chr19","6391716","6391877","69","3699727","TTAGGCATGGTGGCATGCACCTGTAATCTTAGCTACTTGAGAGGGTGAGGTGGAAGGATTGCTTGAGCCCAGGAATTAGAAGCTGCAGTGGGCTATAATCATACCACTGCACTCCAGCATGGGCAACAGATGGGTCTTTTTTAAGACCCTGTGTCAAAAAAAAAA","CCAGGCGCAATGGCTCACGCCTGTAATCCCAACACTTTGAGAGGCCGAGGCAAGAGGATTGCTTGAGGCCAGGAGTCCGAGACCAGCCTGGGCAACACAGCGAGGCCTCATTCTCTACAAAAAATAAATATATAAATAAATAAATAAATAAGAAGAAGAAAA"
"chr1","10091904","10092038","chr19","6391716","6391877","52","3700188","GTGCCTCACATCTGTAATCCCAGCACTTTTGGGGAGTCAAGGAGAGAGGATCACTTGAGGCCAGGAGTTTGAGACCAGCCTGGGCAACACAGAGACCCTGTCTCTACAAAATACTTAAAAAATTAGTCAGGTAGT","CCAGGCGCAATGGCTCACGCCTGTAATCCCAACACTTTGAGAGGCCGAGGCAAGAGGATTGCTTGAGGCCAGGAGTCCGAGACCAGCCTGGGCAACACAGCGAGGCCTCATTCTCTACAAAAAATAAATATATAAATAAATAAATAAATAAGAAGAAGAAAA"
"chr1","10133766","10134077","chr14","31798968","31799292","74","21665202","CTGGGCATGGTGGCTGGTGCATGCCTATAGTTTCAGCTACTTGGGAGGCTGAGGCAAGAGGATCACTTGAGCCAGGGAGGTCGAGACCAGCCTGGGCAACATAGGGAGACCCTGTCTCTACAAAAAAAATAAAAAATTAGCCAGTATAGTGGCATAGACCTGTAGACCCAGTTATTCAGGAGGCTGAAGTGGGAGGATCACTTAAGCCCGGGAGGTTGAGGCTGCAGTGAGCTATGTTTGCACCACTGCACTACAGCCTGGGCAACAGAGTAAAACCCTGTCTCAAAAAAAAAAAAGAAAGAAAGAAAGAAA","GGCTGGGCACAGTAGCTTACACCTGTAATCCCAGTACTTTGGAAGGCTGAAGTGGGAGGATCCCTTGAGGCCAGGAGTTTGAGACCAGCCTGGGCAACATAGTGAGACCCTGTCTCTACAACAAACAAACAAACAAACAAACAAAACTTAGCCAGTTGTGGTGGCACATCCTATAGTCCCAGCTACTCAGGAGGCTGAGGAGGGAGGATCTCTTGAGCCCAGGAGTTTGAGGCTGCAGTGAGCTATGATCATGACACTGCACTCCAGCCTGGATAACACAGCAAAATCCTGTCTCAAAAAAAAAAAAAAAAAAAAAAAAAAAGAA"
"chr1","10153224","10153518","chr14","31798968","31799292","82","21645744","GGCTGGGCACGGTGACTCCAGCTAATAATCCTAGCACTTTAGGAGGCCAAGGTGGGAGGATTGTTTGAGCCTAAGAGTTGGAGACCAGCCTGGGCAACATGGCGAGACCCCATCTCTACGAAAAATTTAAAAATTAGATGCCTGTTGTCCCAGCTACTAAGGAGGCAGAGGTGGGAGGAAGGCTTGAGCCCAGGAGTTCAAGGCTGCAGTGAGCTATGATCTTGCTGCTGCGTTCCAGCCTGTGAAACAAAGCAAGACCCTGTTTCTAAAAAAAAAAAAAAAAAAAAAAAAAAAA","GGCTGGGCACAGTAGCTTACACCTGTAATCCCAGTACTTTGGAAGGCTGAAGTGGGAGGATCCCTTGAGGCCAGGAGTTTGAGACCAGCCTGGGCAACATAGTGAGACCCTGTCTCTACAACAAACAAACAAACAAACAAACAAAACTTAGCCAGTTGTGGTGGCACATCCTATAGTCCCAGCTACTCAGGAGGCTGAGGAGGGAGGATCTCTTGAGCCCAGGAGTTTGAGGCTGCAGTGAGCTATGATCATGACACTGCACTCCAGCCTGGATAACACAGCAAAATCCTGTCTCAAAAAAAAAAAAAAAAAAAAAAAAAAAGAA"
"chr1","10156898","10157028","chr9","47045786","47045941","47","36888888","GTGGCTCACACCTGTAATCTCAGTACTTTGGAAGGACGATGTAGGAGGATCGCTTGAGGCAGGAATTTGAAACCAGCCTAGGCAACATAGTGAGACCCCATCTGTAAAAAAATTAAAAGTGAAAAAAAAAA","GCTGGGCGCAGCAGCTCACACCTGTAATCCCAGTGCTTTGGAGGTCCAAGGTAGGAGGATTGCTTAAGACTAGGTGTTCAAGACCAGTCTTGGCAACATAGTGAGAACTCATCTCTACAATAAATAAATAAATAAATAAATAAATGAAAATAAAAA"
"chr1","10157321","10157496","chr2A","60286019","60286209","67","50128698","ATAAAAAATAAGCCACGCGTGGTGGATACACCTCCAGTCCCAGCTACTTGGGATGCTGAGGTGGGAGGATCACTTGAGCCCGAGAGGTTGAGGCTGCAGTGAGCCATTATTCACACCACTGCACTTTACCCTGGGTGACAGGGCAAGACCCTGTCTCCAAAAAAATAATAATAAAA","AAAATTAGCCAGGTGTGATGGCACCTGTAGTCCTAGCTACTTGGGAGGCTAAGGTGGGAAGAGGGCTTGAGCCCAAGATTGTGAGGCTGTGGTGAGTCATGACTGTGCCATTGCCCTCTGGCCTGGGTGACAGAGTGAGAAGCTGTCTCAAATAAATAAATAAATAAATAAATAAATAAAAATAAACAAAA"
"chr1","10164374","10164515","chr5","32595015","32595178","67","22430641","TGGCCAGCCATGGTGGCTCACAACTATAATCCCAGCATTTTGGGAGGCTGAGGTGGGAGGACTGCTTGAGGCCAGGAGGTTGTAGGCTGTAGTGAGCTAAGATCTGTCATTGCACTCCAGCCTGGGTGACAGAGCAAGACTC","GGCCGGGTGTGGTCCCTCATGCCTGTAATCCCAACACTTTGGGAGGCTGAGATAGGAGGACTGCTTGAGGCCAGGAGTTCAAGACCAGCCTGGTCAACATAGTGAGACCCCATCTCTATAAAATAATAATAATAATAATAATAATAATAATAAATAAATAAATA"
"chr1","10177503","10177659","chr9","47045786","47045941","69","36868283","AAAATTAACTGGGCATAGTGGCATGCACCTGTAGTCCCAGCTACTTGGGTGGCTAAGGTGAGAGGATTGCTTGAGCCCAGGAGTTTGAGGCTGCAGTGAGCCATGATTGCACCACTGCACTCCAGCCTGAGTGACAGAATGAGACTCTGTCTCAAAA","GCTGGGCGCAGCAGCTCACACCTGTAATCCCAGTGCTTTGGAGGTCCAAGGTAGGAGGATTGCTTAAGACTAGGTGTTCAAGACCAGTCTTGGCAACATAGTGAGAACTCATCTCTACAATAAATAAATAAATAAATAAATAAATGAAAATAAAAA"
"chr1","10212605","10212811","chr17","17826312","17826529","60","7613707","GGGTGTGGTGGCTCATGCCTTGTAATCCCAACACTTTGGGAGGCTGAGACAGGAGGATCCCTTGAGCTCAGGAGTTCGAGACCACCCTGGGCAACAGAGTGGGACTCTGTCTCTACAAAAATAAATGAATAAATAAATACCTGGGCATGGTGGCTCATGCCTGTATTCCCAGCTATTTGGGAGACTGAGGTGGGAGGATTGCTTGAG","GGCCAGGCGCGGTGGCTCACACCTGTAATCCCAGCACTTTGGGAGGCCGAGGCAGGAGGATTGCCTGAGGCCAGGAGTTTGAGATCAGCCTGGCCAACATGGTGAAACCCCGTCTCTACTTAAAAAAAAAAAAAAAAAAAAAAAAATAGCCAGGCTGGTGATGTACACCTGTAGTCCCAGCTACTCAGGAGGCTGAGGCAGGAGAATCACTTGAGCTC"
"chr1","10224431","10224723","chr7","49832421","49832722","80","39607990","GGCCAGGCATGGTTCCTCACGCCTATAATCCCAACACTTTGGGAGGCTAAAGTGAAAGAATTGCTTGAGGCCAGAAGTTCAAGACCAGCCTGGGCAACATATTCAGACACTCTCTACCAAAAAACATTTTTGTTTAAATTAGCTGGGTGTGGTGGCATGCATCGGTAATCCCAGCTACTTGAGAGGCTGAGGTGGGTAGATCACTTGAGCCCAGGAGTTGGAGGCTGCAATTAGCCATGATTCCATCACTGCACTCCAGTTTGGACAACAGAGCCAACAACATCTCAAAAAAA","GGCCAGGCATGGGGGCTCATGCCCGTAATCCCAGCACTTTGGGAGGCCAAGGCAGGAGGATTGGTTGAGGCCAGGAGTTCAAAACCAGTCTTGGGCAACATAGTGAGACCCTGTTTCTACAAAAAAAAAAAAAAAAAAAAAAAAAAAAAATCTAGGTATGGTGTGTGTGCCTGTAGTCCCAGATATTTGGGAGGCTGAGGTGGGAGGATTATGTGAGCCCAGAAGTTTGAGGCTACAGTGAGCTATGATCATGCCACTGCACTCCAGCCTGGACAACAGAGTAAAACCTTATCTCAAAAAAA"
"chr1","10229911","10230154","chr9","79131976","79132248","80","68902065","GGCCAGACGTGGTGGCTCACACCTATAATCCCAGCACTTTGGGAGGCTGAGTCAGGAGTTTGAGAACAGACTGGGCAACATAACAAGACTTTGTCTCTACAAATAAAATAAAATATTAGTTGGGTGTGTTGGTGTGTGCCTGTAGTCGCAGCTGTTTTGGAGGCTGAGGTGGGAGGATCACTTGAGCCCAGGAGTTCAAGGTTACAGTGAGCTATGATTGTGCCACTGTACAGTAGCCTGGACG","GGCTGGGCATGGTGGCTCACACCTGTAATCTCAGCACTTTGGGAGTCTGAGTTGGGAAGATTGCTTGAATCCAGGAGTTGGGAGACCAACCTGGGCAACAAAGCGAGACCCTGCCTCTCCAAAAAAAAAAAAAAAAAAAAAAAAAAAAAGCTGGGTGTGAAGGTGCATGCCTGTAGTCTCAGCTATTCTAGAGGCTGAGGTGGGAGGATCGCTTGAGCTATGGAGTTTGAGGCTGCAGTGAGCTATGATGGGATCACTGCACTCCAGCCTGGG"
"chr1","10250573","10250824","chr10","22344248","22344507","82","12093675","CCCATGACTTTGGGAGGGCAAGGAAAGAGGATTGCTTGAGCCAAGAGTCTCAGTCCAGCCTAGGCAACATGGCAAAGCCCCATCTCTGCAAAAAAAATTAAAATTTGGCTTGGCATGGTAGTGCACACCTATAGGCCCAATTACTTGGGAGGCAGAGGTGAGAGGTTCACTTGAGCCCAGGAGTTGCAGGCTGCAGTAAGCCATGATTGAGCCACTGTACTCCAGCCTGGGTGACAGACCGTGACGCTGTCT","ATTTTGGGAGGCTAAGGCAGGAGAATTACTCGAGCCCAGAAGTTTGAGATCAGTCTAGGTAACAGAGCGAGACCTTGTCTCTACAAAAAAAAAAAAAAAAAAAAAAAAAAAAGCTGGATGTGGGTGCATATGCCTCTGATCTCAACTACTTGTGAGGCTGAGGTGGGAGGATCGCTTGAGCCCAGGAGGTTGAGGCTGTAGTGAGCCATGTTCATGCCACAGCACTCTTCAGCCTGGGTGACAGAGTGAGATCCTGTCTC"
"chr1","10327925","10328215","chr16","18746194","18746482","83","8418269","CCAGGTGCAGTGGCTCACACCTGTAATCTCAGCAACTCTGGAGGCTGAGGCCAGAAGTTTGAGACCAGAGTGGGCAACATAGTGAGACCCTGTCTCTTTGAAAATTTAAAAAACAATTAGCTGGGTGTTGTGGTGCATGCCTGTAGTCCCAGCTCCTTGGAAGGCTAAGGCAGGAGGATAATTTGAGCCCAAGAGTTTGAGGCTGCAGTGAGCCATGATTGCACCACTGCACTCCAGCCTGGGGACAGAGCAAGACCCCAAGTCTACCAAAAAATATAAAATAAAATAAAA","GGGCGTGGTGGCTCACACCTGGAATCCCAGCACTTTGGGAGGCTGAGGTGGGAGGATTGCTTGAGACCAGCCTGAGCAACATAGTGAGACCCCATCTGCTAAAAAAAAAAAAAAAAAAAAAAAAAAATTAGCTGGGTTTGCTGGTGCATGGCTATAGTCCCAGTTACTCAAGAGGCTGAGGGGGGAGGATTGCTTGAGCCCAGGAGTTTGAGGTTACATGATCATGCCACCGCACTCCAGCCTGGGAGACAGAGCAAGACACTGTCTGTAAATAACAATAATAATAAAA"
"chr1","10334943","10335245","chrX","46692258","46692555","82","36357315","GGCCGGGTGCAATGGCCCACACCCGTAATCCTAACATTTTGGGAGGCCAGGGCAGGAAGATCACTTGAACTCAGGAGTTCGATCGAGACTATGCTGGGCAGCATAATGAGACCCCAACTCTATAAAATTTATAAACTTAAAAATTAGCTGGGATGGTGGTGTGCATCTGTAGTTCCAGCTATTCAGGTGGCTGAGGTGGGAGGATGGCTGAGCCTGGAGGTGAAGGATGCAGTGAGATATGATTGCACCATTGCACTCCAGCCTGGACGACAAAGTGAGACCCTGTCTCAAAAAAAAAAAAAA","GGCCAGGCATGGTGGCTCATGCCTGTAATCCCAGCACTTTGGGAGGCTGAGGAAAGATGATCACTTGAGCCAGGAGTTTGAGCCCAGTCTGGGTAACATAGTGAGACCTCCATCTCTACAAAAAAAAAAAAAAAAAAAAAAAAAAGCTGGGCATGGTAGCACACATCTGTAGTGTCAGCTACTCAGGAGGCTGAGGTAGGAGGATTGCTTGGGCCCAGGAGATCAAGACTGCAGTGAGCTATGACTGCACCACTGCACTCCAGCCTGGGCAATGGAGTGAGACCCTGTCTCAAAAAAA"
"chr1","10356931","10357179","chr7","49845301","49845560","76","39488370","GGTCAGTTGTGGTAGCTCACACCTGTAATCCCAGCACTATGGGAGATAAAAGTGGGAAGATCACTTGAGGCCAGGAATTTGAGGCCAGCGTGGGCAATATAGCGAGACCCTGTCTCTACAAAAAAATTTTAAATTAGCGAGGCATGGTGGCACGTGTCTGGAGTCCCACCTATTCGGGAGGCTGAGGAGGGAGGACTGCTTGAGCCCAGGAATTCAAGGTTGCAGTGAGCTATGATCATGCTACCGCAC","GGTCAGGCATGGTGGCTCATGCCTGTAATCCCAACACTTTGGGAGACCTATGTGAGAGGATCGCCTGAGCCCAGGAGTTTGAGACCAGCCTTGGCGACATAGTGAGACCTTGTCACTACAAAAAAAAAAAAAAAAAAAAAAAAAAAAAATTAGCCGGGCATGGTGGTGCATGCCTGTGTTCCCAGCTATGTGGGAGGCTGAGGGTGGGAGGATTGCCTGGGCCCAGGAGATTGAGACTGCAGTGAGCTGAGATTGCACCA"
"chr1","10362793","10363079","chr8","15910614","15910909","75","5547821","GGGCATGGTGGCTTATGCCTATAATCTCAGCACTTTTTGATGCCAAGGTGGAAGGATCACTTGAGGCCAGGAGTTCAAGACCAGCCTGGGCAACATAAGGAGACCCTATCTCTACAAAAAAACTTAAAAATTAGCTGGGTATAGTGGTGTATGCCTGAAGTCCCAACTACTCAGGAGGCTGAGGCAGAAGGATCACATTAGTCCAGGAGTTCGAGGCTGCAGTAAGTTGTGATTACATCACTGCACTCCAGCCTGGGTGACACAGGGAAACCCTATCTATAAAAAAA","GGCCAGGCGAAGTGGCTCACACCTGTAATCCCAGCACTTTGGGAGGCCAAGGCAGGAGGATCATTTGAAGCCAGGAGTTCAAGGCCAGCCAGAGAAACATAGTGAGAACCTGTCTTTACAAAAATTAAAATTAAAATTAAAATTAGCCAGGAGTGGTGGTGCATGCCTGCAGTCCCAGCAGCTCAGGAGGCTGAGGTGGGATGATTGCTTGCACCAGGAGTTCGAGGCTGCAGTGAGCTGTGATCGTGCCACTGCACTCCAGCCCCTGGGTGACAAAGCAAGATCCTCTAAAAAAA"
"chr1","10369347","10369616","chr2A","75514615","75514896","83","65145268","GGCTGGGTGTGGTGGTGCATACCTGTAATCCCAGCACTTTGGGAGGCCAAGATGAGGGGATCGCTTGAGGCCAATAGGTTGAGACCAGCCTGGGCAATATAGCACAAATACCCTATCTCTACAAAAAAATTTTTGAAAAATTAGCCAAATGTGGTGGTACACACCTATAGTCCTAGCTACTCAGGAGGCCAAGGCAGGATTGCCTGAGCCCAGGAGTTTGAGGCTGCAGTGAGGTATGATTGTGCCATTGCACCCCAGCCTGTGTGACAG","CAGGCGTGGTGGCTCACACCTGTAATCTCAGCACTTTGGGAGGTGGAGGTGGGAGGATTGCTTGAGGCCAAGAGTTTGACACCAGCCTGGGTAACATAGCTAGATCCTGTCTCTACAAAAAATAAATAAATAAATAAATAAATAAATAAATAAGCCAGGTGTGGCAGTGTGTGCCTGTAGTCCCAGCTATTTGGGAAGCTGAGGTGGAATGATCACTTGAGCCCAGGAGTTTGAAGCGGCAGTGAGCCAGGATCATACCACTGCACTCCACCCTGGGGGACA"
"chr1","10371663","10371959","chr10","125157322","125157641","82","114785659","GGCCAGGTGAGGTGGCTCCCAGCACTTTCGGATGCCAAGGCAGGAGGATTGCTTGAGGCTGGGAGTTCGAGACCAGGCTGGGCAACATAGCGATATGCTGTCTCTACAAAAAATAAATAAGATACCCAGGCGTGGTGGTCTGTGCCTGTGGTCCCAGCTACTCGGGAGGCTGAAGTGGGAGGATCGCTTGAATCCAGGAGTTCAAGGTTGCAGTGAGGTTTTATTATTGCACCACTGCATTCCACCCTGGGCGACAGAGCAAGACCCTGTCCCTAAAAAAAATAAAAAAAAGACAAA","GGCTGGGTGCAGTGGCTCATGCCAGCAATCCCAGCCCTTTGGGAGGCTGAGGTGAGCAGATCGCTTGAGCCCAGGAGTTTGAGACCAGGTGAGGCAACATGGCAAGATCCCCTCTCTACCAAACAAACAAACAAACAAACAAAAAACAACTAGCTAGGGATGGTGGTGCGTGCCTGTAGTCCCAGCTACTTGGGAGGCTGAAGTGGGAGGATCGCTTGAGCCCAGGAGTTCAAAGCTGCAGTGAGTCATGATAGCACCACTGCACTCCAGCCTGGGTGACAGAGTGAGACCCTGTCGCAAAAAAAAAAAAAAAAAAAGAA"
"chr1","10387162","10387458","chr2B","83001661","83001979","73","72614499","CAGGCATGGTGGCTTACACCTGTAATCCCAGCACTTTGAGAGGCCGTGGCAGGAGGATCACTTGAAGCCAGAGCTCAAAACCAGCCTGGGCAACTTAGTGAGCCCCCATTTCTACAAAAAATAAAAACAATTAACTGGGCATGGTGGTACACACCTGTAGCCTCAGCTACTCAGGAAGCTGAGATGGGAGGATCCCTTGAGCCCAGGAGTTTGAGACTGCAGTGAGCTATGATGGTGCCACTGGCGCCTGGGTAACAAAGCAAGACCCTGTCTCAAAAAAAAAAAAAAAAAAAAAAA","GGCTGGAGATGGTGGCTCACACCTGTAATCCTAGTACTTTGGGAGTCCGAGGTAGGAGGATCACTTGAGGCCAGAAGTTTAATACCAGCCTGGGCAACATAGTGAGAGCCTATCTCTACAAAAAAAAAAAAAAAAAAAAAAAAAGCCAGGTGTGGTGGTGCATGTTTGTAGCCTCAGTTACTTGGGAGGCTGAGGTGGGAGGATCATTTGAGCCCAGGAGGTTAAGGCTGCAGTGAGCCAGTTATGGCACCACTGTACTCCAGCCTGGGCGACAGGGCAAGACCCTGTCTCACAAACAAAAACAAAACAAGACAAAAAA"
"chr1","10389720","10389848","chr18","55799233","55799394","63","45409513","GGCTGGGCACGGTAGCTTGCACCTGTAATCTCCCAACACTTTGGGAAGCAAAGGTGGGAAGTTGGCTGGAGGCCAGGAGTTCAAGGCCAGCCTATGCAACCAAGCAAGACCCTGTCTCTACAAAAAATA","GGCTGAGAGAGGTGGCTCATGCTTGTAATCCCAGCACATTGGGAGGCAAAGGTGGGAAGATTGCTTGAGGCCAGGAGTTCAAGACCAGCCTGGGCAACATGAAAACACTTTGTCTCTACAATAAATAAATAAATAAATAAATAAATAAAAGAAACAAGAAAA"
"chr1","10391887","10392196","chr8","40540954","40541273","76","30149067","CTGGGTGCAGTAGCTCAACCTGTAATCCTAGCACTTTGGGACGCCAAGGTGGGAGGATTATTTAAGTCCAGGAGTTTGAGACCAGCCTGGGCAACAGAGAGAGATCTCGTCTTGTCTCTTAAAAAAAAAAAAAAAAAAAAAAAAGGCCAGACACGGTGGTGTGCACCTGTAGTCCCAACAACTTGGGAGGCTGAGATGGGAGGATTGCTTGAGCCCAGGAGTTCAAGACTGCAGTGAGCCACTGCACTTCAGGCTGGACAACAGAGCGAGTCCCTGTGTCAAAAAAAAAAAGGAAAAAGAAAAGAAACAA","GACCGGGTGCGGTGGCTCAAGCCTGTAATCCCAGCACTCTGGGAGGCTGAGGCAGGAGGATTGCTTGGGGCTAGGAGTTCAAAACCAGCCTGGATAACAGCAAAATCCCATTGCTCCAAAAAAAAAAAAAAAAAAAAAAAAAAGCTAGGTGTGGTGGCCTGCATCTGTAGTCCCAACTACTTGGGAGGCTGAGGTGGGAGGGTTGCCTGAGTCCAGGAGGTCAAGGCTGCAGTGAGCCAAGGTCCTGCCACTGCGCTCCAGCCTGGGGAACAGAGTGAGACTCCGTATCAAAAAAAAAAAAAAAAAAAAAAAAAAAAAAA"
"chr1","10397475","10397636","chr5","32595015","32595178","67","22197540","GCCGGGCATGGTGTTGCATGCCTGTAGTCCTAGCTACTCAGGAAGTTGAGGCTAGAAGATTGCTCGACCTCAGGAGTTCAAGGCTGCAGTAAGCTATGGTCATGCCACTGCACTCCAGCCTGGGCAACAGAGCAAAGACCTGGTCTTTATAAAAATTAAAAA","GGCCGGGTGTGGTCCCTCATGCCTGTAATCCCAACACTTTGGGAGGCTGAGATAGGAGGACTGCTTGAGGCCAGGAGTTCAAGACCAGCCTGGTCAACATAGTGAGACCCCATCTCTATAAAATAATAATAATAATAATAATAATAATAATAAATAAATAAATA"
"chr1","10407167","10407455","chrX","46692258","46692555","75","36285091","GCCAGGCATGGTGGCTCACGCCTATGGTCCCAGCACTTTGGGAAGCTGAGGTGTGAGGATTGCTTGAGGCCAGGAGCTCAACACCAGCCTGGGCAACATAGCAAGATCCTGTCCCTACAAAAAAAAGTTTTTAATTAGCTGGGTGTGATGGCACACACCTGTAGCCCCACCTACTTGGGAGGCTGAGGCAGGAGGATCACCTAAGTCCAGGAGTTTGAGGCTGCAGGGAGCCGTGATTGTGCCACTGCACTCCAGCCTGGGCAACAGAGTGAGACCCTGTCTCTAAGAA","GGCCAGGCATGGTGGCTCATGCCTGTAATCCCAGCACTTTGGGAGGCTGAGGAAAGATGATCACTTGAGCCAGGAGTTTGAGCCCAGTCTGGGTAACATAGTGAGACCTCCATCTCTACAAAAAAAAAAAAAAAAAAAAAAAAAAGCTGGGCATGGTAGCACACATCTGTAGTGTCAGCTACTCAGGAGGCTGAGGTAGGAGGATTGCTTGGGCCCAGGAGATCAAGACTGCAGTGAGCTATGACTGCACCACTGCACTCCAGCCTGGGCAATGGAGTGAGACCCTGTCTCAAAAAAA"
"chr1","10409466","10409618","chr1","217544386","217544536","70","207134920","GCCGGGTGTAGTGGCTCGTGCTTATAATCCAGTATTTTGGGAGGATCCCTTGAGCCCACGAGTTCAAGGCTGCAGTGAGCAGTGATCATACTACTGCACTCTGGCCTGGGTAACAGAGAGAGACCCTGTCTCTTAAACAGAAAAAAACAAAAA","GGCTGGGCGTGGTGGCTCATGCCTCTAATCCCAGCACTTTAGGAGGCCAAGGCAGGAGGATAACTTAAGACCAGGCTGGGTGACACAGTGAGACTTTGTCTCTAAAAAAAAAAAAAAAAAAAAAAAAAAAAAAAACCTACAAAAACATATA"
"chr1","10416087","10416257","chr10","32749231","32749409","59","22333144","GCTGGGCAAGGTGGCTAACACCTGTAATCCCAGCACTTTGGCAGGCTGAGGTGGGAGGATCACTTGAGCCCAGGAGTTCAAGGCTACAGTGAGCCATGATCACACCACTGCTCTCCAGCCTGGGCAACACAGTGAGACCCTGTCTCTAAAACCAGTAAAATAAAATAAAAA","GCTGGGCACAGTGCCTCATGCCTGTTATTCCAGCACTTTGGGAGGCCGAGGAGAGAGGATTGCTTGAGGCCAGGAATTCAAGACCAGCCCAGGGAACATAGTGAGACCCTGTCTCTACTAACTAACTAAATAAACTACTAACTAACTAACTAACTAACTAACTAAATAAATAAATAAAA"
"chr1","10422744","10423042","chr5","63802202","63802507","67","53379458","GGCCAGGCGTGGTGGCTCATGCCTGTGGTCTCAGCACTTGGGAGGCTGAGGCGGGAGGATCGCTTGAGCCCAGGAGTTGAAGATCAGCCTGGGCAACATAGGGAGAGCTCATCTCTACAAAAAGTTTAGAAATTAGCCAGGCGTGGCGGTGTGCACCTGGAGTCCCAGCTAGCCAGGAGGCTGAGTTGGGAGGATCACCTGAGCCCAGGAGGTTGAGGCTGCAGTGAGCCATGATAGTGCCACACTGCACTCCAGCCTGGGCCACAGAATGAGACCTTGTCTCAAAAAAAAGATAGAAA","GACTAGGGGTGGTGGCTCATGCCTGTAATCCCAGCACTTTGGGAGGCTGAGCTGGGAGGATTGCTTGAGCCCAGAAGTTCAAGACCAGCCTGGGCAACATAGCAAGACTCCATCTCTAAAAAAAAAAAAAAAAAAAAAAAAAAAAAATTAGCCCCGAGTGGTGGTGTGCACTTGTAGTCCCAGCTACTCAGGAGGCTGAGGTGGGAGGATCTCTTGAGCCTGGGAGGTCCAGGCTGCAGTGAACCATGATTGTGCCACTGGACTCCAGCCTAGGCAATAGAGTGAGACCTTGTCTCAAAAATAAAA"
"chr1","10429571","10429880","chr2B","83001661","83001979","71","72572090","GGCAGGGCATGGTGGCTCACACCTGTAATTCCAGCACTTTGGGAGGCTGAGGTGGGATGATTGTTTGAAGCCAGGAGTTTGATACCAGCCTGGGCAACATAGTGAGACCTGGTCTCTACAAAAAATAAAAATTAGCCAGGTGCGCTGATGCAGGCTTGTGGTCCCAGCTACTTGGGAGGCTGAAGTGGGAGGATCACCTGAGCCCAGGAGGTGGAGGTTACAGTGAGTCTTGGTGGTGCCACTGCACTCCAGCCTGGGCGGCAGAGTGAGACCCTGCCTCTCAAAAAACTACAATAAAAACAAACCAAAA","GGCTGGAGATGGTGGCTCACACCTGTAATCCTAGTACTTTGGGAGTCCGAGGTAGGAGGATCACTTGAGGCCAGAAGTTTAATACCAGCCTGGGCAACATAGTGAGAGCCTATCTCTACAAAAAAAAAAAAAAAAAAAAAAAAAGCCAGGTGTGGTGGTGCATGTTTGTAGCCTCAGTTACTTGGGAGGCTGAGGTGGGAGGATCATTTGAGCCCAGGAGGTTAAGGCTGCAGTGAGCCAGTTATGGCACCACTGTACTCCAGCCTGGGCGACAGGGCAAGACCCTGTCTCACAAACAAAAACAAAACAAGACAAAAAA"
"chr1","10457916","10458020","chr20","87144","87254","63","10370772","GGCTGGGTGTGGTGGCTCATGCCTGTAATCCCAAAATTCTGGGAAGCTGATGTGGGAGGATTGCTTGAGGCCTGGAGTTTGAGACCAGCCTGGGTAACATGGTGA","CCTGGGCAACATAGTGAGACTACATCTCTACACTCACGCACACACACACACACACACACACACCCCCCAAATTAGCCAGGCATGCTGATGTGCACCCATAGTCTCAGCAAC"
"chr1","10459750","10459931","chr22","26696703","26696888","67","16236953","CAGCTTAGGCAACATAGCAAGACCCTGTCTCTACAAAAAAAAAATTTAAGTTAGCCAGGCATGGTGGCACTGACCTATAATCCTAGCTACTCTGGAGGCTAAGGCGAGAGTATCACTTGAGCCCAGGAGCTCAAGGCTGATCATGCCACCATACTCCAGCCTGGATGATAGAGTAAGACCCT","CCAGCCTTGGCAACATAGCAAGACCCTGTCTCTATCAATCAATCAATCAATCAATCAATAATCCAGGCGTGATGGCACACACCTGTGGTCCCAACGACCCGGGAGCCTGAGGTGGAAAGATCGTTTGAGCCCAGGAAGTTGAGGCTGCAATGAACTGTGAACATGCTACGGCACTCCAGTCTGGGC"
"chr1","10473215","10473344","chr15","37343640","37343763","68","26870425","TGAGGTGGGAGGATTGCTTGAGCCCAGGAGATCAAAACTGCAGTGAGCCATCATCGCGCCACTGCACTCCAGCCTGGGAGACAGAGCGAAACGCTGTCTCAAAAAAAGAAAAAAGAAACAAGGAAGGAAA","AAGATCCCTGGCCAGGATTTCAAGACCAGCCTGGGCAACACAGTGAGACCATACATACATACATACATACATACATACATCATACATACATACATACATACATACATACACAGTCTTACAAAGA"
"chr1","10479095","10479375","chr1","20214247","20214541","75","9735152","GGCTGGGCGTGATGGCTCATACCTGTAATCTTAGCACTTTGGGAGGCTGAGTTGGGAGGATCGCTTGAGGCCAGGAGTTTGAGACCAGCCTTTGCAATATAGGGAGACCTCGTTCCTACTGAAAATTAAAAAATTAGCCAGGCATGGTAGTGCTTGCCTGTGGTTCCAGCTACTTTGGAGGCTGAGGTGAGAGCATCACTTGGGCCTGGGAGGTTGAGGCTGCAGTGAGCGGTGATTGTGCCATTGCCCTCCAGCCTGGGTGAGAGAGCAATACCCTGTTT","GACTGGGCGTGGTGGCTCACACGTGTAATGTCAACACTTTGGGAGGCCGAGGTGGAGGATTGCTTATGACCAGGAGTTTGAGACCAGCTGGGCAACATAGTGAGACCCCATCTCTACCACACACACACACACACACACACACAAATTAGCTGGGTGTGGTGGCAAGCCCCTGTAGTCCCAGCTACTCAGGAGGCTGAGGTGGGAGGATCACTTGAGCCTGGGATGTTGAGGCTGCAGTGAATCATGATTGCACCATCGCATTCTAGCCTGGGAGACAGAGCAAGACCTTGTCTCA"
"chr1","10481434","10481697","chr3","9052682","9052970","84","1428752","TGGGAGACTGAGGTGGGAGGCTCACTTGAGGTCAGGAGTTCAAGACCAGCCTGGGCGACACAGCGAGACCCGACCTCTACAAAAAATAATTAGCTGGGCATCATAGTGCATGACTATAGTCCCAGCTACTCGGGAGGCTGAGGCTGGAGGATCACTTGAACCCAGGAGGTCAAGGCTACAGTGAGCTGTGATAACACCTCTCCACTCCAGACTGGGTGACAGAGTAAGACCCTGTCTCAAAAAACAAACAAACAAACAAACAAA","ACTTTGGGAGGCTGAGTCGGGAGGATTACTTGACACCAGGAGTTCAAGACCACCTGGGTAACATAGTGAAAACTTCTCTTAACAAAAAAAAAAAAAAAAAAAAAAAAAAAATTAGCCAGCCATAGTGGTGCATGCCTGTGGTCTCAGCTACTCAGGAGGCTGAGACAGGAGGATCACTTGAGCCCAGAACTTCAAGGCTGCAGTAAGCCCTGATTATGCCACTGCACTCCAGCATGGGCAACAGAGCAAGACCTTGTCTCAAAAAAAAAAAAGAAAAAACAGGAGAAAA"
"chr1","10491386","10491659","chr15","50439849","50440151","90","39948463","GTGGCTTACACCTTAAACCCAGCACAGCACTCTGGGAGGGTACAATGGGAGGATCCCTTAAGGCCAGGAGTTTGAGACCAGCCTGGGCAACACAGCGAGACCCCATCTCTACAAAAAATTTAAAAATTAGCCGGGTGTGGTGGTGCATCCTATAGTCCCAGCTACTCAGGAGGCTCGCTTGATCCCAGGAGGCAGAGATTGCAGTGAGCTATGATGGTGCCATTGTATTCCAGCTTGGTCAACAGAGCAAGACTCTGTCTCAAAAAGAAAAAAA","GCTGGGTGCAATAGCTCTGTAATCCCAATACTCTGGGAGGCCAAGGCTGGAGGATTGCTTGAAGCCAGGAGTTTGAGACCAGCCTGGGCCACAGAATGAGACCCCATCTCAATCAATCAATCAATCAATCAATCAATCAGTCAATCAGGTGTGGTGGCGCACGCCTGTAGTCCCAGCTGCTTGGGAAGCTGAGGCAAAAGGATCACTTGAGCCCAGGAGGTTTGAAGTTGCAGTGAGCTGTGATTGTGTCACTGCACTCCAGCCTGGGAGCAGAGTAAGACCCTGTCTCAACATAAAAAGAAA"
"chr1","10497998","10498280","chrX","3592780","3593062","69","6905218","GGCCAGGTGCAGTGGCTCATGCCTATCATCCCAGCACTTTGGGAGGCCAAGGTCGGGGGATCACTTGAGGCCAGGAGTTTGAGACCAGCCTGCACAAAATAGAGAGACCCCATCTCTATTATAAATTTTAACATTAGCCGGGCTTGGTGCCTCATGCCTATACTCTCAGCTGCTCAGGAGGCAGAAGCCAGAGGATTGCTTGAGCTCAGGAGTTTGAGGCTGCAGTGAGCTATGATCAGGCCACTGCACTCCAGCCTGAGCAACAGAGCAAGGCCCTGTCTCT","GTGGTGGCTCATGTCTGTAATCCCAGCACTTCAGGGGGCCAAAGCGAGAGGACTGCTTGAGGCCAGGAGTTTGAGACCAGCCTGCGCAACATAGAAAGACCCCATCTCTATAAATAAATAAATAAATAAATAAATAAGTCAGGCATGGTGGCACATGCCTGTAGTCCCAGCTACTCAGAAGGCTGAGGTCGGAGGATCTCTTGAGCCCAGGGGTTCAAGGCTGCAGTGAACCATGATCACACCAGTGCACTGCAGCCTGGGCAACACAGCAAAACCCTGTCCC"
"chr1","10498320","10498338","chr20","87144","87254","92","10411176","GAATGAAAATAAAAGTAAA","CCTGGGCAACATAGTGAGACTACATCTCTACACTCACGCACACACACACACACACACACACACCCCCCAAATTAGCCAGGCATGCTGATGTGCACCCATAGTCTCAGCAAC"
"chr1","10502786","10503100","chr16","9702460","9702783","76","800326","GGCAGGGCGTGGTGGCTCACACCTGTAATCCCAGCACTTTGGGAGACTGAGGCGGGGGGATCGCTTGAGCCCAGGAGTTCGAGATCAGCCTGGGCAACATAGTGAGACCTCATCTCTACACAATTTTTTTAAAAAATTAGCTGGGCATGGTGGTGTGCACCGGTAGTCCCAGCTACTGGGGAGGCTGAGGTGGGAGAATCACCTGAGCCCAAGAGGTGGGGGGCTGCAACGAGCCATGATTGTGCCACTGCACTCCAGCCTGAGTGACAGAGAAAGACTCTGTCATTAAAAAAAAAAAAAAAAAGAAAAAGAAAA","CCGGGCATGATGGCTCATGCCAGTAATCCTAGCACTTTGGGAAGCTGAGGTGGAAGGATCGCTTGAGGCCAGGAGTTCGAAACCAGCCCAGTCAACATAGTGAAACCCCATCTCTACAAAAGAAAAATTAAAAAATTAGCTGGAATGGTGGCACATGCCTGTAGTCCTAGCTACTTGGGAGGCTGAGGCAGGAGAACTGTTTGAGCTCAGAAGTTCAAGGCTGCAGTGAGCCATGACTGTGCCACTGCACTCTAGCCTGGGTGACAGAGTGAGACCCTGTCTCAATAAATAAATAAATAAATAAATAAATAAGAAAACTAAAAA"
"chr1","10543642","10543899","chr3","15191824","15192108","86","4648182","GGCCAGGTGCCGTGGTTCATGTCTGTAATTCCAATGCTTTGGGAAGGCAAGGCAGAAGGATGACTTGAGGCCGAGAGTTTGAGACCAGCCTGGGAAACACAGTGAGACCCTGTCTCTACAAAAAAACTCACCAGGTGTGGTGGCACGTGCCTGTAGTCCCAGCTACTCGGGAGGCTAAGGCAGAAGGATCGCTTGAGCCCAGAAGTTCAAGGCTTCAGTGAGCTATGATCATGCCATTACATTCCAGCCTAGGCAATA","GGCTGGGCACAGTGGCTCACACCTTTAATCCCTGCACTTTGGGAGGCCAAGGCAGGAGGATCACTTGAGGCCAGAAGTTCAAGACCAGCTTGAGCAACATAGGGAGACACTGTTTCTACAAACAACAACAACAACAACAACAACAACAAAACGTAGCTGGGTGTGGTGCCATATACTTATAGTCCCAGCTACTTGGGAGGCTGAGGTGGGAGAATTGCTTAAGCCCAGGAGGTCGAGGCTGCAGTGAACTGTGATCACGCCTCTAGCGCTCCAGCCTGGGCGACA"
"chr1","10565734","10565937","chr13","83255168","83255404","71","72689434","CTGAGTGCAATGGCTTGAGCCTGTAATCCCAGCTACTTGGGAGGCTGAGGCAGGAGGATTGCTTGAGGCTAGGAGTTTGAGACCAGCCTGGGCGACCTCATTGCTACAAAAAAACACAAAAATTAGATGGGTGTGGTAGCACATGCCTGTAGTCCCAGCTACTTGGGAGGCTGAGGTGGGAAGATCTCTTAAGCCCAGGAGTTC","GCCAGGCCTGGTGGTTCACACCTGTAATCCCAGTAATTTCAGAGGCCAAAGCAGGTGAATGGCTTGAGCTCAGGAGTTTGAGACCAGTCTGGGCAACATGGCAAAACTCTGTTTCTACAAAAACAAAAACAAAAACAAAAAAAATTAGCTGGGCATGGTGGCACATGCCTGTAGTCCCAGCTATTTGGGGGACTGATGTGGAAGGATCACTTAAGCCCAGGAGGTCAAGGCTGCAGT"
"chr1","10574829","10575100","chr10","28570518","28570799","93","17995689","GGCCGGGTGTGGTGGCTCACACTAGTGATCCCAGAGCTTAGGGGGCTGAGGCAGGAGGATGGCTTGAGGCCAGGAGTTCGAGACCAGCCTGGGCAACATGGTGAGACCCCCATCTGAAAAAAATTCGTAAAAGATAAACCAGGTATGGTGGTGTGCACTTGTAGTCCCAGCTGTTCAGGAGGCTGATGCGGGAGGGTAGCTTGAGCTGCACTCCTAGACAACAGAGCAAGAACCCGTCTCTTAAATAAAAAAAAAAAAGGAAGAAAAGAAAA","GACTGGGCGCAGTGGCTCACACCTGAATTCCCAGTGCTGAGGGAGGCTGAGGCAGGAGGAGTGCTGGAGGCCAGGAGTTCAAGACCAGTCTGGGCAACATAGTGAGACTCCATCTTTACAAAAAATAAAATAAAATAAAATAAAATTAGCCAGGCAAGGTGGTGTGTGCCTGTAGTCCCAGCTACTTGGGAAGCTGAGATGGGAGGATTGCTTGAGTCTGTGAATTAGAGATTACAGTGAGCTATGGTTATACCACTGCACATTCTGGGCTGGGCAATAGAG"
"chr1","10604354","10604632","chr11","34622326","34622621","76","24017972","CGCCTGTAATCCCAACTCTTTGAGAGGCTGAGACAGGAGGAGCACTTTGAAGCTAGGAGTTCAAGACCAGCCTGGGCAACATAGTGAGATGCCATCTCTGTAAAAAAATTTAAAAAACAAAACTAGCCAGGCATGGTGGTGCGTGTACTTGGGAGGCTGAGGTGGGAGGATTGCTTGAGCCCAGGAGATCGAGTCTGCAGTGAACCATGGTTGTACCCCTGCACTCCAGCCTGGGCTCCAGAGCAAGGCCCTGCCTCTAAAAAACCAAAAAGAAAGAAA","ATGCCTGTAGTCCCAGTTACTTGAGAGGCTGAGGCAGGAGGATCACTTGAGGCAAGGAGTTTGAGATCAGCCTGGGTAACATAGTGAGACCCTATCTTTACAAATAAAATAAAATAAAATAAAATAGCCAGACATGGTGGTGTGCACCTGTAACCCTAGCTAATGGGGAGGCTGAAGCAGGAGGATCGCTTGAGCCCAGGAGTTGGAAGCTGTAGTGAGCTGATTACACCACTGCACTCCTGCCTGGGCAACACAGCAAGACTCTGTCTCAACAACAACAGAATAAAAAGAGAGAA"
"chr1","10740671","10740986","chr9","68878569","68878883","71","58137898","GGGCACAATCGCTCATGCCTGTAATCCCCGCACTTTGGGATGCCAAGGCGGGTGGATTGCTTGAGGCCAGGAGTTCAAGACCAGCCTGGGCAATACAGTGAGACCCTGTGTCTCCACAAAAAAAATTTTTTTTTAAAATTAGCTGGTTGCGGTGGCGCACACCTGTAGTTCTGGCTCCTTGGGAGGCTAAAGTGGGAGGATTACTTGAGCCCAGGAGGTGGAGGCTGCAGTGAGCTATGATCGCTTCACTGCACACCAGCCTGGGCGACAGGGTGAGACCCTGTCTGGACAAAAAAAAAAAAAAAAAGAAAAAAAA","GGCTGGGCACGGCAGCTCATGTCTGTAATCCCAGCACTTTGGGAGGCCAAGGTGGGAGGATTGCTTGAGTCCAGGAGTTCAAGACCAGCCTGGGCAACATAGTGAAACCCCAGTCTCTACAAATAAATAAATAAATAAATAAATAATTAGCTGGGCATGTTGATGCATGCCTGTAGTCCTAGCTACTCGGGGGGTGAGGTGAGAGGATTGCTTGAGTCCAGAAGGTGGAGGCTGCAGTGAGCTATGATCACACCACTGCACTCCAGCCTGGAAGACAGGGTGAGACGCTGTCTTTAAAAAAAAAAAAAGAAAAGA"
"chr1","10750263","10750567","chr11","113329688","113329999","91","102579425","GGCTGGGCACAGTGGCTCACGCCTGTAATCCCAGCGTTTTGGAAGGCTGAGGCGAGAATCGCTTGACGCCAGGGGTTCAAGACTCCCATCTCTTAAAAAAAAAATTAAAAAATAAAAATTAGCCAGGTGTGGTGGCGCACGCACCTGTAGTCCTACCTATTTGGGAGGGGAGGCTGAGGTGGGAGAATCACTGGAGCCCAGGAGGTTGAGGCTATAGTGAGCTGTGATCGCACCACTGCACCCCAGCCTTGGCAGCAGGGCAAGACCCCGTCTCTTAAAAAGTAGAAGAAGAAAAGAAAAGAAAA","GGCTGGGCATAGTGACTCATGCCTATAATCACAGCACTTTGGGAGGTGGGAGGACTGCTTGAGGCCAGGAGTTTGAGACAGGCCTGAGCAACATAGTGAGACCCTTGCTTTTAAAAAAAAAAAAAAAAAAAAAAAAAAAGCCAGGTGTGGTGGTGTACACCTGTAGTCCCAGCTGTTCGGGAAGCTGAGGTGGAAGGAATGCCTGAGCCCAGGAGTTTGAGGTTGCAGGAAACTATGATTGTGCCACTGCACTCCAGCCTGCACAACTGAGTGAGACCCTGTCTCAAAAAAGAAAAAAAAAAAAAAAGAAAA"
"chr1","10833383","10833686","chr9","68878569","68878883","73","58045186","GGCCGGGTGCGGTGGCTCACACCTGTAATCCCAGCACTTTGGGAGGCTGAGGCAGGAGAATCGCGTGAGTCCAGGAGTTCGAGACCAGCTCTGGCAACACAGTGAGACCCCCTTTCTATGAAAAATTTACATATTAGCTGGATGTGGTGGTGCATGTTTGTAGTCCCAGCTACTTGGGAGGCTGAGGCGAGGGGATTGCTTGAGCCTGGGAGGTCGAGGCTGCAGTGAGCCATGATCATGCCACTGCACTCCTGCCTGGGTGACTGAGCAAGACCCTGTCTCAAAAAATAAACAAATAAAATAA","GGCTGGGCACGGCAGCTCATGTCTGTAATCCCAGCACTTTGGGAGGCCAAGGTGGGAGGATTGCTTGAGTCCAGGAGTTCAAGACCAGCCTGGGCAACATAGTGAAACCCCAGTCTCTACAAATAAATAAATAAATAAATAAATAATTAGCTGGGCATGTTGATGCATGCCTGTAGTCCTAGCTACTCGGGGGGTGAGGTGAGAGGATTGCTTGAGTCCAGAAGGTGGAGGCTGCAGTGAGCTATGATCACACCACTGCACTCCAGCCTGGAAGACAGGGTGAGACGCTGTCTTTAAAAAAAAAAAAAGAAAAGA"
"chr1","10843258","10843541","chrX","3592780","3593062","69","7250478","CTGGGCATAGTACCTCACATCTGTAATCCCAGCACGTTGGGAGGCCAAAGTGGGAGGATCACTCAGGTCCAGGAGTTTGAGACCAGCCCAGGTAACAGAGTGAGACCTCGTCTCTATAAAAAAAAATTTTAATAACTAGCTGGGCATGGTGGTGCATGCCTGTAGTTCCAGCTACTCAGGAGGCTGAGGCGGGAGGATCCCTTGAGCCCAAGAGGCTAAGACTGCAGTGAGCTATGATTTCACCATTACACTCCTGCCTGGGTGACAGAGTGCAACCCTGTCTC","GTGGTGGCTCATGTCTGTAATCCCAGCACTTCAGGGGGCCAAAGCGAGAGGACTGCTTGAGGCCAGGAGTTTGAGACCAGCCTGCGCAACATAGAAAGACCCCATCTCTATAAATAAATAAATAAATAAATAAATAAGTCAGGCATGGTGGCACATGCCTGTAGTCCCAGCTACTCAGAAGGCTGAGGTCGGAGGATCTCTTGAGCCCAGGGGTTCAAGGCTGCAGTGAACCATGATCACACCAGTGCACTGCAGCCTGGGCAACACAGCAAAACCCTGTCCC"
"chr1","10845006","10845208","chr12","105257502","105257717","66","94412496","TCGTGACCAGCCTGGGCAACATAGAGAGACCTGGTCTCTACAAAATAACAAACAAGAAATTAGCTGGGCATGGTGGCATGCACCTGTAGTCCCCATTAATAGGGAGGCTGAGGTGGGAGGTTGAGGCTGCAGTGAGCTGTGATCATGCCACTGCACTCCAGCCTGAATGACAGAGTGAGATTCAGTTTCAAAAAAAAAAAAGA","GGCCAGCCTGGGCAACATAGTGAGACTTCATTTCCACACATACACACACACACACACACACACACAAAATTAGCCAGACATCTTGGCTCACACCTGTAGTCCCAGCTACTTGAGAGGCTGAGGTGGGAGGATTGCTTGAGCCCAGGAGCCATGATTGCACCACTGCATTCTAGCCTTGGTAATAGAGTGAGACCCTGTCTCAAAAAAAGAAAAAAA"
"chr1","10887049","10887340","chr4","187957937","187958223","74","177070888","GCTGGGTGCAGTGACTCATGCCTGTAATCCCAGCACTTTGGGAGGCTGAGGCAGGAGGATCATTTGAGGTCAGGAGTTCAAGACCAGCCTGGACAACATAGCAAGACTCAGTCTCTACGGAAAATGCAGAAGTTAGCTGGGTGTCATGGTGTGCGCCTGTAATCCCAGCTACTTGGGAAGCTGAGATGGGAGGATCGCTTGAGGCCAAGAGTTGGAGGCTGCAGTGAGCTATGATCACACCACTGCACCCTAGCCTAGGCAAGAGAATGAAACCCTGTCTCAAAAATAATAA","GGGCACAGTGGCTCATGCCTGATTCCCAGCACTTTGGGAAGTTGAGACAGGCGGATCACTTGAGCCCAAGAGTTCGAGACCAGCCTGGTGTTCTCTAAAACAAACAAACAAACAAACAAACACACGATTAGCTGGGCATGGTGGCTCACACCTGTAGTTCTAGCTACTCAGGAGGCTGAGGTGGGAGGGTAGCTTGAGCCCAGGAGTTCAAGGCTGCAGTGGGCTATGATCATGCCATTGCACTCTAGCCTGGGCAACAGAGTGAGACCCTGTTTCAAAAAAAAAAA"
"chr1","10923940","10924232","chr19","13342110","13342403","63","2418170","GTGGCCCATCCCTGTAATCCCAGTGCTTTGAGAGACCAAGGCAGAAGGATCGCTTGAGGGCAGGAGTTTGAGACCAGCCTGGGCAACGTAGCAAGACCCTGTCTCTACAAAAAATAAAAATAAAATAAAATTAGGCATGGTGGTGTGTGCCTGTAGTCCTAGCTACTCATGAGGCTGAGGTGGGAGGATCGCTTGGGCCCAGGAATTCAAGGCTGCAGTGAGCCATGATTGTGCCACTGCACTCCAGCCTGAGTTACAGAACAAGAGCCTGACTTTAAAAAAAAAATAAAGAA","TCATGCCTGTAATCCCAGCACTTTGGGAAGCCAGGGCAGGAGGATCACTTGAGACCAGGAGTTTGAGACCAGCCTGGGCAACATAGCCAGACCCCCATCTCAACAACAACATCAACAACAACAACAACAAATTAGCTGGGTGTGGTGGTGCCTGTAGTCCCAGCTACTTGGGAGGCTAAGCTGGGAGGATCGCTTGAGCCCAGGAGCTCCAGGCTGCAGAGAGCTATGATCATATCACTGCACTCCAGCCTGAGTGACAGAGCAAGAACCTGCCTCTAAAAACAATAAACAAAA"
"chr1","10962838","10963067","chr13","83255168","83255404","61","72292330","GGCCAGGCGTAGTGGCCCACGCCTATAATCCCAGGGCTTTGAGAGGCCAAGGTGAGAGGATCGCCTGAAGCCAGGAGTTTGAGACCAGCCTGGGCAACACAGTGAGACGCCGTCTCTACAAAAAATTTGAACATTAGCTGGGCATGGTGTCATACGCCTATAGTCCCAGCTACTTGGGAGGCTGAAGTGGGAGGATCCCTTAAGCTCAGGAGGTCAAGGCTGCAGTGAGC","GCCAGGCCTGGTGGTTCACACCTGTAATCCCAGTAATTTCAGAGGCCAAAGCAGGTGAATGGCTTGAGCTCAGGAGTTTGAGACCAGTCTGGGCAACATGGCAAAACTCTGTTTCTACAAAAACAAAAACAAAAACAAAAAAAATTAGCTGGGCATGGTGGCACATGCCTGTAGTCCCAGCTATTTGGGGGACTGATGTGGAAGGATCACTTAAGCCCAGGAGGTCAAGGCTGCAGT"
"chr1","10970864","10971165","chr8","25360790","25361095","84","14389926","GCCAGGCATGGGGGCTCATACCTGTAATCCCAGGACTTTGGGAGGCTGAGGAGAGCAGATTGCTTAAGCTCAGAAGTTCGAGACCAGCCTGGGCCAAAGCAAGACCCCCCATCTCTAAGAAAAAAATTTTTTGTTTAAATTAGCGGAGCATCGTGGTGCATGCCTGTGGTCCCAGCTACTCAGGAGGTGAGGCGGAAAGACTGTGAGCTCAAGAGGCAGAGGCTGCAGTGAGCCGAGATGGCGCCACTACACTCCAGCCTAAGCGACAGAGCAAGACTCCACCTCAAAAAAAAAAAAGAAAA","GGCTGGGAGCAGTGGCTCATACCTGTAAGCCCAGCACTTTGGGAGGCTGAGGTGGGAGGATTGCTGAAGCCCAGGAGTTTGAGACCAACCTGGGCAATGTAGGGAGACCCCGTCTCTACTAAATAAATAAATAAATAAATAAATAAAGTCGGGCATGGTGGCATGTGCCCTGTAGTCCCAGCTTCTTGGGAGGCTGAGGTGGGAGGATTGCTTGGGCCCAGGAATCAAGGCTGCAGTGAGCTGTGATTGTGCCACTGTACTACAGCCTGGGTGACAGTGCAAGACTGTCTCAAAAGAAAAACAAAA"
"chr1","10978428","10978724","chr5","63802202","63802507","67","52823774","GCTGGGCATGGTGGCTTATGCCTATAATCCCAACACTTTGGGAGACTGAGGCAGGAGGATCACTTGAGCCCAGGAGTTTGAGACCAGCCTGGGCAAAATAGCAAGACTCGATGTCTACAAAAAGATTTTAAAATTAACCTGGTGTGGTGGCATGCGCTTGTGGTCCCAGCTACTCAGGAGGCTGAGGTGGGAGGATTGCTTGAGCCTGGGAGGTCTAGGTTGCAATGAGCAATGATTGTCCCACTGCACTCCAGCCTGGGTAACAAAGCGAGACCCTGTCTCAAAAAAAAAGAAAGA","GACTAGGGGTGGTGGCTCATGCCTGTAATCCCAGCACTTTGGGAGGCTGAGCTGGGAGGATTGCTTGAGCCCAGAAGTTCAAGACCAGCCTGGGCAACATAGCAAGACTCCATCTCTAAAAAAAAAAAAAAAAAAAAAAAAAAAAAATTAGCCCCGAGTGGTGGTGTGCACTTGTAGTCCCAGCTACTCAGGAGGCTGAGGTGGGAGGATCTCTTGAGCCTGGGAGGTCCAGGCTGCAGTGAACCATGATTGTGCCACTGGACTCCAGCCTAGGCAATAGAGTGAGACCTTGTCTCAAAAATAAAA"
"chr1","10982466","10982762","chr5","152110395","152110709","71","141127929","GGCCAGGCATGGTGGCTCATGCCTGTAACCCCAGCATTTTGGGATGCAGAGATGGGCAGATTGTTTGAGGTCAGGAGTTCGAAACAAGCCAGGGGAACATGGCAAGACCCTGTCTCTACAAAAAATTTAAAAACTAGCTGGGCATGGTGGCACACACCTGTGGTCCTAGCTACTCAGGAGGCTGAGGTGAGAGGATTGCTTGAGCCCAGGAGGTTGAGGCTGCAGTGAGCCCTGATTGTGCTACTGCACTCCAGCCTGGGCAACAGAACAAGACCCTGTCTAAAAAAAAAAAAAAAA","GGCTGGGAGTGGTGGCTCATGCCTATAATACCAGCACTTTGGGAGGCCAAGGTGGGAAGATCACTTGAGGCCAGGAGTTCAAGATCAGCCTAGGCAACATAGCAAGACCCTGTCTCTACAAAACAAACAAACAAACAAACAAACAAAATTAGCTGGGCATGGCGGTATGCACCTGTAGTCCCAGCTACTTGGGAGGCTGAGGCAGGAGGATTGTTTGAGCCCAGAAGGTTGAGGCTGCATTGAGCCATGATTATGCCACTTTACTCCAGCCTGGGCAACAGAGGGAGACCCCATTCTCAAAAACAAAACAAAAAA"
"chr1","11003607","11003904","chr7_NW_019937272v1_random","2134063","2134360","79","8869544","TGACTCATGCCAGTAATCCCAGCACATTGGGAGGCCGAGACGGGAGGATCGCTTAGGGCCAAGAACATGAGACCAATCTGGGCAACGTAGGAAGACCCCATCTCTACAAAAAATTTTAAAAATAAAAAAAATTAGCCAGACATGGTGGTGCACTTGTAGCCCCAGCTACTCTGGAAGATGAGGCAGGAGGATCGCTTCAGCCCAGGAGGCCAAGGCTGTGGTAAGCCATGATTGCACCACTGCACTCCAAGGTGAGCGACAGAGTGAGACCCTATCCCTAAAAAAATAAAAATAAAAA","GCTGGGCTGGTCTTGCACCTATAATCTCAGCACTTTGGGAGGCCGAGGCAGGAGGATCACTTGAGCCTGGAAGTTCAAGACCGGCCTGGGCAACATAGCAAGACCTTATTTCTAAAAAAAAAAAAAAAAAAAAAAAAATTAGCCAGGCATGGTGGCATGCACCTGTAGTCCCAGCTACTCAGCAGGCTGAGGTGGGAGGATCACTTGAGCCAGGGAGGTCAAGGCTGCAGTGAGCCATGATCATGCCGCTGCACTCCAAACTGGGGGACAGAATGAGACCCTATATCAAAAAAAAAAA"
"chr1","11010235","11010531","chr6","32649583","32649885","77","21639348","GCTGGGTATGGTGGCTCACGCCTGTAATCCCAGCACTTTGGGAGGCTGAGGCAGATGGATCGCTTGAGCTCAGGAGTTGGAGGCCAGCTTGGGTAACATGTCAAGACCCTGTCTCTACAAAAAATATAAAAAATTGGCTGAGTGTGGTGGTGTGCACCTGTGGTCCAAGCTACTCCGGAGGCTAAGGTGAGAGGATCGTTTGACCCCTGGAGTTAGAGGTTGCAGTGAGCCGAGGTCACTGCACTGCACTCTAGCCTGGGTGACAGAGTGAGACCCCATCTTAAATAAATAAATAAA","CTGGGTGTGGTGGTTCATGCCTGAAATCCCAGCACTTTGGGAGGCCAAGGCAAGAGGACTTCTTGAGCCTAGGAGTTCGAGACTGGCCTGGGCAACATAGTGAGACCCTGTCTCTAAAAAAAAAAAAAAAAAAAAAAAAATCAGCTGGATGTGGTGGTGCACACCTGCAGTCCCAGCTACTCAGGAGGCTGAGGTGGGAGGATTGCTTGAGCGCAGGAGTTTGATGCTGCAGTGAGCCACAATCATGCCACTGCTCCACTCTGGGTAACAGAGTGAGATTTTGTCTCAAAAAAAGGGAAAAAA"
"chr1","11016266","11016454","chr2A","60286019","60286209","67","49269753","AAAACAGAAAACCAGGTACAGTGGTGTGTATGCCTGTAAGTTCCAGCAACTCAGGAGGCTGAGGAGGAAGGACGACTTGAGTCCAGGAGTTTGAGGCTGCAGTGTGCCTATGAATAGCCACTGCAATATGCCTGGGCAACAGAGCGAGAGCCTCCATCTCTAATTTCAAAAAAGAAAAAGAAACCAAAA","AAAATTAGCCAGGTGTGATGGCACCTGTAGTCCTAGCTACTTGGGAGGCTAAGGTGGGAAGAGGGCTTGAGCCCAAGATTGTGAGGCTGTGGTGAGTCATGACTGTGCCATTGCCCTCTGGCCTGGGTGACAGAGTGAGAAGCTGTCTCAAATAAATAAATAAATAAATAAATAAATAAAAATAAACAAAA"
"chr1","11017774","11017875","chr20","87144","87254","63","10930630","GTGGTGGCTCATGCCTGTAATCCCAGCATTTTGGGAGGCTGAGGTGGGAGGGTTGCTTGAGGCCAGGAGTTCAAGGCCACCTTGGCGAACATATCCAGACTC","CCTGGGCAACATAGTGAGACTACATCTCTACACTCACGCACACACACACACACACACACACACCCCCCAAATTAGCCAGGCATGCTGATGTGCACCCATAGTCTCAGCAAC"
"chr1","11021586","11021916","chr5","152110395","152110709","88","141088809","GGCTGGGCATGGTGGCTCATGCCTGTAATCCTAGCGCTTTGGGAGGCCAAGGTGGGAGGACTGTGTGAGGCCAATAGTTCAAGACTAGCCTGGCAGCCTAGACAACACAGGGAGACCCCACCTCTATCAAAAAAAACCACAAAAAAGCCACATTAGCTGGGCGTAGTGGCATGCATCTGTCCTAGCTACTTGGGAGGCTGAAGCTGGAGGATCCTCCCCCTGGAGGCTGAGCCCAGGAGTTCTAGGGTGTAGTGAGCTATGATTACACCACTGTGTTCCACCAGCCTGGGCAACAGAGTGAGACCCTGTCTCAAAATAATAATTTAAAAAA","GGCTGGGAGTGGTGGCTCATGCCTATAATACCAGCACTTTGGGAGGCCAAGGTGGGAAGATCACTTGAGGCCAGGAGTTCAAGATCAGCCTAGGCAACATAGCAAGACCCTGTCTCTACAAAACAAACAAACAAACAAACAAACAAAATTAGCTGGGCATGGCGGTATGCACCTGTAGTCCCAGCTACTTGGGAGGCTGAGGCAGGAGGATTGTTTGAGCCCAGAAGGTTGAGGCTGCATTGAGCCATGATTATGCCACTTTACTCCAGCCTGGGCAACAGAGGGAGACCCCATTCTCAAAAACAAAACAAAAAA"
"chr1","11030952","11031110","chr16","46964977","46965105","66","35934025","AGCACCTTTGGGAGGCTGAGGCGGGCAAATCCCTTGAGCTCAGGAGTTTGAGACCAGCCTGGGCAACATGGCAAGACCCCCTCTCTACGAAAGGTTAAAAAGCCGAGCATGGTGGCACGTGCCTGTTGTCCCAATTACTTGAGAGGCTGAGGTGGGAGG","AGACTGGCCTGGGCAATGCAGTGAGACCCCATCTCTACAAAACAAAAACAAAAACAAAAACAAACCAATTAGCTGGGCATGGTGGTGCATGCCTGTAGTCCCAGCTATTTGAGAGGCTAAGGTGGGAGG"
"chr1","11048635","11048932","chr7_NW_019937272v1_random","2134063","2134360","66","8914572","GGCTGGGTGTAGTGACTCCTGCCCATAATCCCAGGAGGCTGGGAGGCTGAGGCAGGTGGGTCGCCTGAGACCGGGAGTTCAAGACCAGCTTGGGCAACATAGCAAGACCTTGTCTCTAAAAAAAAAAAAAATTTTTTTAAATTAGCCAGGCATGGTGGCATGCACCTTTAGTCCCAGCTACTTGGCAGGCTGAGATGGGACAATCGCTTGAGCCCAGGAGGTCTCAAGGTTGCAGTGAGCCATGTTCATGCCATTGAACTCCAGCCTGGGTGACAGAGTAAGATTTTGTCTCAAAAAA","GCTGGGCTGGTCTTGCACCTATAATCTCAGCACTTTGGGAGGCCGAGGCAGGAGGATCACTTGAGCCTGGAAGTTCAAGACCGGCCTGGGCAACATAGCAAGACCTTATTTCTAAAAAAAAAAAAAAAAAAAAAAAAATTAGCCAGGCATGGTGGCATGCACCTGTAGTCCCAGCTACTCAGCAGGCTGAGGTGGGAGGATCACTTGAGCCAGGGAGGTCAAGGCTGCAGTGAGCCATGATCATGCCGCTGCACTCCAAACTGGGGGACAGAATGAGACCCTATATCAAAAAAAAAAA"
"chr1","11056875","11057156","chr16","18746194","18746482","87","7689319","GGCCAGGTGTGGTGGCTCACAGCTGTAATCCTAGCACTTTTGGAGGCCGAGGTGGGAGGATCGAGGAGTTCGAGGCAACATAGGGAGACTCTATCTCTACCAAAAATTTAAAAAGTAGCCAAGTATGATTGAACACACTTGTCCCAGCTACTCAGGAGGCTGATGGGGGAGGATCACCTGAGCCCCGGAGGCCGAGGGTGTAGTGAGCCATGATCGATGCCACTGCACTCCAGCCTGGGCCACAAAGTGAGACCCTGTCTCAAAAAAAAATAATAAAAAAAA","GGGCGTGGTGGCTCACACCTGGAATCCCAGCACTTTGGGAGGCTGAGGTGGGAGGATTGCTTGAGACCAGCCTGAGCAACATAGTGAGACCCCATCTGCTAAAAAAAAAAAAAAAAAAAAAAAAAAATTAGCTGGGTTTGCTGGTGCATGGCTATAGTCCCAGTTACTCAAGAGGCTGAGGGGGGAGGATTGCTTGAGCCCAGGAGTTTGAGGTTACATGATCATGCCACCGCACTCCAGCCTGGGAGACAGAGCAAGACACTGTCTGTAAATAACAATAATAATAAAA"
"chr1","11065890","11066136","chr12","95325313","95325577","70","84259423","GCTGGGTGTGGTGGCTCATGCCTGAAATCCCAACACTGGCAGGACAAGACAGGAGGATTGCTTGAGGCCAGGAGTTCAAGACCAGCCTGGGCAACACAGCAAGACCCCATCTCTATAAAACATAAGAAAAATTACCCAGGTGTGGTGGCATGTGCCTGGGAGGTCAAGGCTGCAGTGAGCTAGGATCACACTACTGCACTCCAGAATGGGCAACAGAGTGAGACCCTGTCTCAAAAAAAGGAAAAAA","GCTGGGTGTGGCGGCTCATGCCTGTAATCCCAGCACTTTGGGAGACTGAGGCAGGAGGATCACTTGAGGCCAGGAGTTAAAGACCTGCCTGGACAACATACTGAGACCCTGTCTCTCATATTTAAAAAAAAAAAAAAAAAAAAAAAAAATTAGCCAAGCTCCTGCTTGAGCCCAGGAGTTGGGGCTGCAGTGAGCCATGATCATTCCCCTGCACTCCAGCATGGGCAATAGAGTAAGACTCTGTCTCTAAGAAAGAAAAAAAAAA"
"chr1","11069954","11070285","chr7","40732565","40732896","90","29662611","GGCCAGGTGCAGTGGCTCATGCCTATAATTCCAGTGCTTTGGGCGGCCTAGGTGGGAGGACTGCTTTAGGCAGTCTGAGACCAGCCTGGGCAACATAGCAAGACCCCTATCTCTACAAAAAAAAAGAAACAAATGTAGCTGGGCATGGTGGTGCGTGCTTGTAGTCCTAGCTACTTGGGAGGCTGAGGTGGGAGGATCACTTGAACCCAGGAGTACAAGGCTGCAATGAGCTATAATTGCACCACTGTACTCCAGCCTGGGCATCAGGGTAAGAGTAAGACCATGTCACTATTTTTTTTTTAAAAGGAAATTAAAAAAAAAAAAAAAAAAAA","GGCCAGGTGTGGTGGCTCATGCCTGCAATCCCAGCATTTTGGGAGAATAAGGCAGGAGGACTGCTTGAGGCCAGGAGTTCAAGACTAGCCTGGGTGACATAGTGAGACTCCATCTCTACAAAAAATAAAAAATTAGCCAGGCACGGTGGCACATGGCTTTGGTCCCAGCTACTCAGGAGGCTGAGCCAGGAGGATCACTTGAACCCAGAAGTTCAAGGTTTTAGTGAGCTTTGATTGTACCACTGCACTCCAGCCTGGGCAACACAGCAAGACTCTGACTCTAATAATAATAATAATAATAATAACAATAATAATAATAAAACAAAAATAAA"
"chr1","11070308","11070543","chr7","119744984","119745215","66","108674676","AAGAATTCGAGTGATAGCCTGGGCAATATAGTGAGACCCCGTCTCCACCAAAAACAATAACAAAAAATAGCTGGGAATGGTGGTGTGTGCCTGTGGTCTAGCTACTTGGGTGGTTGAGGAGGGAGGATCGTTTGAGCCCAAGAGTTTGAGGCTGTAGTGAGCTGCAACTGTGCCACTGCACTCCAGCCTGTGCAACAGAGGTAGACACTACTTCAAAAAAAAAAAAAAAAAAAAAA","CAGCCTGGGCAATATAGGGAGACCTCATCTCACAAAAAAAAAAAAAAAAAAAAAAAAAATTAGCCTATTGTGGTGGTGCACGCTTGTGGTGCCAGCTACTTGGGAGGCTGAGGTGGGAGGATCACTTCAGCCCAGGAGTTAGAGGCTGCAGTGAGCTATGATCCTGCCACTGCACTCCATCCTTGGCAACAGGGCAAGACACTTGACTCAAAAAGAAAAAAGAAAAAAAAAA"
"chr1","11093785","11094099","chr10","65849492","65849800","83","54755707","GTCAGGCACAGTGGCTCATGCCTATAATCCTAGTGACTAAGGAGGCTGAGGTGGGGGGGGATTGTTTGAGGCCAGGATTGTTTGAGGAGTTCAAGACCAGCCTGGGCAACACAGCAAGACATTGTCTCTATAAAATAAAAAAAAATTCAGCCAGACGTGGTGGTGCACACCTGCAGTCCCAGCTACTTGGGAGGCTGTGGTGGGAGGATCGCTTGAGCCCAGGAGTTCAAGGTTGCAGTGAGTTATGGTTGCACCACTGCACTCCAGCCTGGGTGACAGAGCAAGACTTCAGTATCCAAAAAAATAAAAACAGAA","GGCCAGGTGTACTGGCTCATGCTTATAATCCCTGCACTTTGGGAGGCTGAGGTGGGAGGATTGTCTGAGGCCAGGAGTTTGAGACCAGCCTGGGCAACAGAGTGAGACCTTGTATCTTAAAAAAAAAAAAAAAAAAAAAAAAAAGCAGGGTATGGTGGTGCACACCTGTGGTCCAAGCTACTCGGGAGGCTGAGTGTTGGAGGATTGCTTGGGCCCAGGAGGTCGAGGCTGCAGTGAGCTGTATTCATGCCAGTGCACTCCAGGTTGGGTGACAGGGTGAGATTCTGTCTCAAAAAACAAACAACAAAA"
"chr1","11096464","11096778","chr13","11426887","11427206","76","330423","GGCCAGACATGGCGGCTCATGCCTGTAATCCTAGTGCTTTGGGAGGCAAAGGCAGAAGGATCGCTTGAGCCCAGGAGTTCAAGACCAGCCTGGGCAACGTAGGGAGACTCCATCCCTACAAAAAATTTTTAAAGTAGCTGGGAGTGGTGGTGCACCACTCCCAAGTCACAGCTACTTGGGAGGCTGAGGTGGGAGTATCACTTGAGCCCAGGAGTTCAAGGCTACAGGGAGCTGTGATTGTACTGCTGCATTCCAGCCTGGGTAACAGAGCAAGACCCTGTCTCTTTAAAAAAAAAAAAAAAAAAAAGAAAGAAA","GCCAGGTGCAGCGGCTCGTGCCTGTAATCCCAGCACTTTGGGAAGCTGAGGCAGGAGGATCGCTTGACCCCAGGAGTTCAAGACCAGCCTGGGCAACAAAGTGAGACACTGTCTCTACAAAATAATAATAATAATAATAATAATAATAATAAATTAGCTGGGCATGAAGTCTGCTGGTTACACTGGAGGCTGAAGTGGGAGGATCACTTGAGCTCAGGAGTTCAAGGCTACAGTGAGCTGTGATTATTCCACTGCACTCCAGCCTGGGTAACAGCGCAAGACCCTGTCTAAAGAAAAACAAAAAACAAAAAACAAAAAAA"
"chr1","11154646","11154863","chr14","51003183","51003398","55","39848537","CCAAACTTGGCAACATAATGAGACCCTATCCCTACAAAAAATAATTTAAAAAAATTAGCCAGGCATGGTGGTGCATTTCTGTAGTTCCTTCTACTCAGGAGGCTGAGGTGGGAGGATTGCTTGAGTCCAGGAGTTCAAGACCACAGTGAGCTGTGATCACACCACTGTACTCCACTGAGAGACAGATTAAAGTCCTGCCTCTTAAAAAAAAAAAAGAA","AGCCTGGGCAAGATAGTGAGACCTCATCTCTTAAAATAAATAAATAAATAAATAAATAGCAGGATGTGGTGGCGTGCATCTGTAGTCCCAGCTACTCAGGAGGCTGAGATGGGAGGATTACTTGAGCTCAGGAGGTCGAGGCTGCAGTGAGCTATGATCACGCCACTGTACTCCAGCCTGGGTGAGAGTGATACCCTGTCTCTAACAAAAAAAAAA"
"chr1","11177276","11177573","chr1","49763974","49764279","79","38586698","GGCTAGGCGCGGTGGCTCATGCCTGTAATCCCACCACCTTGGGAGGCCGAGACAGGATGACTGCTTGAGGACAGGAATTCAAGACCAGCCTGAGCAACATAGCAAGACTTCGAATCTACAAAAAATTTAAAAATTAGCTGGGTGAGGTGATCTGTGTCTGCAGTCCCAGCTATTTGGGAGACTAAGGCGGGAGGAACACTTGAGCCCACGAGTGTGAGGCTGCAGTGGGCTACAATCGCACCACTGCACTCCAGACTGGGTGACAGAGTGAGACTCTGTCTCCAAAAACAAAACAAAA","GGCTAGGCCTGGTAGCTCAAGTCTGTAATCCCAGCACTTTGGGAAGTCAGGGCAGGAGGATCCCTTGAGTCCAGGAGTTCAAGACCAGCCTGGGCAACAAAGTGAGACCCTATCTGTATAATAAAATAAAATAAAATAAAATAAATTAGCCAGGTGTGGTGGTGTGTGTCTGTGGTCCAAGGTACTTGGGAGGCTGAGGTGGGAGAATGGCTTGAGCCCAAGAGTTTGAGGCTGCAGTAAGCCGGGTTTGCTACTGTACTCTAGTCTGGGCAACAGAGCCAGACTCTGTCTCAAAAAACAAAAAAA"
"chr1","11179915","11180204","chrUn_NW_019938566v1","98142","98430","68","11081773","GGCTGGGTGCAGTGGCTCACTCCTATAATCCCAGCACTTTGGGAGGCCAAGACAGGAGGATTGCTTGAAGCCAGGAGTTCAAGACCAGCCTGGGTAACATAGCAAGACCTTGTCTCTGTAAAAAGTTTAGTGGGGCATGATGGCATGCGCTTGTGGTCTCAGCTACTCAGGAGGCCAAGGCAGGAGGATCACTTGAGTCCAGGAGTTTGAGGCTGCAGTGAGCTATGATTGCACCACTGCACTCCAGCGTGGGCAACAGAACAAGACACTATCTCAAAACAAACAAAAAA","GCTGGGCGTGGTGGCTCACGTCTCAAATCCCAGCACTTTGGGAGGTCAAGCACTGAGGATTGCTTAAGGCCAGGAGTTTGAGACCAGTCTGGGAAACATAGTGAGAGTCTGTCTCTACAAAACACACACACACACACACACACACACACCTGTAGTCCCAGGTACTCAGTAGGCTGAGGCAGGAGGATTGCTTGATCCCAGGAGTTCAAGGCTGCAGTGAGCTGAGATTGCACCACTGCACTCCAGCCTGGGCAACAGAGCAAGACTGCATCTCTAAAAAAAAAAAAAA"
"chr1","11201818","11202105","chr7_NW_019937272v1_random","2134063","2134360","76","9067755","GGCTGGGCATTGTGGCTCCTGCCTATAATCTCAGCACTCTAGGAGGCTGAGACAGGAGGATCACTTGAGGCCAAGAGTTCAAGACCAGCCTGGGCAACCTAGCGAGACTCTATCTCTACAAAAATGAAAAATTAGCCAAGCGTGGTGGCATGAAGCTGTAATCCTAGCTACTCAGGAGGCTAAGGCGGGGGGATTACTTGAGTCCAGGAGTTTAGAGGCTGCAGAGAGCCACAATCGTGCCCCTGCATTCCAGCCTAGATGGCAGAGCAAGACTGCATCTCAAAAAAA","GCTGGGCTGGTCTTGCACCTATAATCTCAGCACTTTGGGAGGCCGAGGCAGGAGGATCACTTGAGCCTGGAAGTTCAAGACCGGCCTGGGCAACATAGCAAGACCTTATTTCTAAAAAAAAAAAAAAAAAAAAAAAAATTAGCCAGGCATGGTGGCATGCACCTGTAGTCCCAGCTACTCAGCAGGCTGAGGTGGGAGGATCACTTGAGCCAGGGAGGTCAAGGCTGCAGTGAGCCATGATCATGCCGCTGCACTCCAAACTGGGGGACAGAATGAGACCCTATATCAAAAAAAAAAA"
"chr1","11207408","11207794","chr1","89503424","89503784","113","78296016","GCTGGGCATGGTGGCTCATGCCTGTAATCTCAGTAATTTGGCAGGCCAAAATGGAAGAATCACTTGAAGCAGGAGTTTGAGACCAGCCTGGGCAACATAGTAAAACACCATCTGTATAATAAAAATGAAAAATGAAAAAAATTAATTTCAGCCTGGGCAACAGAGTAAGACCCTGTCTCAAAAAAAAAAAAAAAAAAGGAATTGAAAAAATTTTAAAAATTAGCTGAGCAGAGTGGCACCTGCCTGTAGTCCCAGCTACTCAGGAGACTGAGGCAGGAGGTTCACTTGAGCCCATGAGTTCCAGGGTGCAGTGAGCTATGATTGCGCCACTGCACTCCAGCCCAGGTGACAGAGCAAGATTCTCTTCAAAAAAAAAAAAAAAAAAGA","GGGCATGGTGGTTCACGCCTATAATCCCAGCACTTTGGAAGGCTGAGGTGGGAGGATCACTTGAGCTCAGGAGTTCAAGACTAGCCTGGGCTACATAGCAAGACATCGTGTATACAGAACAAAACAACAAAAACAAAGAAAAGAGAGAGAGAGAGGAAGGAAGGAAGAAAGGAAGGAAGGAAGGAAAAGAAAGAAAAAATTAGCAGGATGTGGCAACGCCTGTGGTCCCATCTACTCAGGAGATTGAGGTGGGAGGATTGCTTGAGCACAGGAGGTGGAGGTTGCAGTGAGCCATGATTGCACCACTGCACTCTAGCCTGGGCAACAGAGCAAGACCCTGTTTCAAAAATAAATAAATAAA"
"chr1","11211383","11211665","chr1","88859712","88859991","79","77648329","GCTAGGCACAGTGACTCACACCCGTAATTCCAGCAACTTGGGAGGCTGAGGCAAGAGGATTGCTTGAGATCAGGAGTTGGAGACCAACTCCAGACATAGCAAGACCCTGTCTCCACAAAAAAATTTAAAACTTAGCCAGGCGTAGGAACACGTGCCTGTGGTCCCAGCTACTCAGGAGGCTAAGGCAGAGGGATCGCTTGAGCCCAGGAGTTCCAGACTGCAGTGACCCCCATAATTGTGCCATTGCACTCCAGCCTGGGCAACAGAGCAAGACCTCATCTCA","CCAGGCACAGTGGCTCACACCTGTAATCCCAGCACTTTGGGAGGCCAAGGCAGGAGGATTGCTTGAATCCAGGAGTTTGAGACCAGCCTGGGCAGCATAGTGAGACTTGGCCTCTACAAAAAAAAAAAAAAAAAAAAAAAAAAGTTACCTGGGAAGTCTCAGCTACTTGGAAGGCTGAGGTCGGAAGGTTGCTTGAGTACAGGAGGTCAAGGCTGCAGTGAGCTATGATTGTACCACTGCACTCCAGCGTGGGCAACAGAGTGAGACCTTATCTCAAAAA"
"chr1","11216401","11216671","chr10","101970539","101970842","87","90754138","CTCAGTGCTTTGGGAGGCCAAGGCGGGAGGACTGCTTGAGGCCAAGATTTCAAGAACAGCCTGGGCAACATGGCGAGATCCTGTCTCTACAAAAAAAATACAAAAAATTAGCTGGGCACTTGCCTGTAGTTCTAGCTACTGGATGCTAAGGTGGGAGAAATGCTTGAGCCCAGAAGTTCAAGGCTGTAGTGAGCTATGCACGTGCCACTGCACTCTACAGAGTGCAGGGTGACAGGGTGAGACCCTGTCTCTTAAAAAAAAAAAAAAAAAA","CCTGTAATCATAGTGCTCTGGGAAGCCCAGGTGGGAGGATTGCTTGAGGCCAGGAGTTTGAGATCAGCCTGGGCAAATAGTGAGACCCCATTTCTACCACACACACACACACACACACACACACACAAAATTAGGTGGACATGGTATTATGCACCTGTGGTCCCAGCTACTTGGGAGGCTGAGGCAGGAAAATAGCGTGAGCCCAGGAGTTCGAGGCTGCAGTGAGCTATGAACAGACCACTGCACTCCAGCCCAAGTGACAGAGTGAGACTCTGTCTCTGAAAAAAAAAAAAAGAAAGAAAAA"
"chr1","11243410","11243711","chr16","32352979","32353289","77","21109569","GGCCAGGCACAGTGGCTCACACCTGTAATCCCAACACTTTGGGAGGCCAAGGAGAGAGGAGTGTTTGAGGCCAGGAGTTCGAAACAGCCTGGGCAACACAGTGAGACCCTGTCTCTACAAAAATAAAAATTAGCCAGGTGTGGTGGTGCATGCCTGTAATCCCAGCTACTCGGGAGGCTGAGGCAGGAGGATCACTTGAGCCCAGATGGTTGAGGCTGCAGAAAGGTGTGATCGTGTGCAGCACTGCACTCAAGCCTGAGTGACAAAGAGCCTGTCTCAAAAAAAAAAAAAAACCCAAAAAA","GGCTGGACACGGTGGCTGCTGCCTGTAATCCCAGCACTTTGGGAGGCCAAGGCAGGAGAATGGCTTGAGCCCAGGAGTTCAAGACCAGCCCGGGCAACAGAGTGAGACCTTGTCTCTACAAAAATAAAAATAGAAATAAAAATAAAAATTAGCCAAGTGTGGTGGCATGCACCTGTGGTCTCAGCTACTCAGGAGACTGAGGTGGGAGGATCCCTTGAGCCCAGGAGGTCGAGGCTGCAGTGAGCTGTGATCATGCCACTACACTCCAGCCTGGGTGACAGAGCTGTCTCAAAAAAATAATAATTAAAAAA"
"chr1","11275459","11275747","chr3","83975049","83975347","68","72699590","GGCTGAGTGCAGTGGCTCATGTCTGTAATCCCAGCCCTTTGGGAGGCTGAAGCGAGAGGATCGCTTGAGGCCAGGAGTTAAACACCAGCCTGGGCAACATAGACCCCTGTCTGTATAAAATATAAAATAAAAAATATTAGCTGGGCATGGTGGTGCTTGCCTGTGGTCCCAGCTACTTTGGAGGCTGAGGCGGGAGAATTGCTTGAGCCCAGGGGTCAAGGCTGCAGTGAGTCCTGATCACACCACTGCACTCCAGCCTGGGCGACAGAGTGAGACCATGCCTCAGAAA","GGCTGGGTGCAGTGGCTCATGGCTGTAATCCCAGGACTTTGGGAGGCTGAGGCAGGAGAATCACTTGAGGCCAGGAGTTTGAGACCAACCTGGGCAACAAAGTGAGGCATGTCTCTACAAAAACAAAACAAAACAAAACAAAACAATTAGCTGTGTGTGGTGATGCCTGCCTGTCGTCCCAGCTACTCGGGAGGCTGTGGTGGGAGGATCTCTTGAGCCTGGGAGGTTGAGGCTGCAGTGAGCTGTGATTGCCCACTGTACTCTAGCATGGGTTACAGAGCAAGACTCTGTCTCAAAAA"
"chr1","11288626","11288934","chr9","68878569","68878883","64","57589943","GACTGGGCATGGTGGCTCACGCTTGTAATCACAGTAATTTGTGAGGCCAAGGTGAGAGGATTGCTTGAGCCCAGGAGTTTGAGACCAGCCTAAGTAACGTAGTAAGACCCCATCTCTACAAAAAAAATTTTAAAAAGTTAGCTGGGCGTGGTGGTGCATGCCTGTAGTCTCAGCTACTCAGGAGGCTGAGGTGGAAGGATCGCTTGAACCTAGCAGGTCGAGGCTGCAGTGAGGTATGATCACGCCACTGCACATCCGCCTGGGCGACAGAGCGAGACACTGTCTCAAAAAAAAAAACAAAACAAAAAA","GGCTGGGCACGGCAGCTCATGTCTGTAATCCCAGCACTTTGGGAGGCCAAGGTGGGAGGATTGCTTGAGTCCAGGAGTTCAAGACCAGCCTGGGCAACATAGTGAAACCCCAGTCTCTACAAATAAATAAATAAATAAATAAATAATTAGCTGGGCATGTTGATGCATGCCTGTAGTCCTAGCTACTCGGGGGGTGAGGTGAGAGGATTGCTTGAGTCCAGAAGGTGGAGGCTGCAGTGAGCTATGATCACACCACTGCACTCCAGCCTGGAAGACAGGGTGAGACGCTGTCTTTAAAAAAAAAAAAAGAAAAGA"
"chr1","11294333","11294445","chr20","87144","87254","64","11207189","GGCTGGGTGTGGTGGCTCACACCTGTAGTCCCAACGCTTTGGGAGGCCAAGGTAAGACTGCTTGAGGCCAGGAGTTTGAGACCAGCCTGGCCAACATAATGAGACCCTGTCTC","CCTGGGCAACATAGTGAGACTACATCTCTACACTCACGCACACACACACACACACACACACACCCCCCAAATTAGCCAGGCATGCTGATGTGCACCCATAGTCTCAGCAAC"
"chr1","11311193","11311492","chr10","65849492","65849800","72","54538299","GGCAGGATGGTTCATGCCTGTAATCCTAGCACTTAGGGAGGCTGAGGTGGGAGGATCAATTGAGGCCGGGAGTTCAAGACCAGCCTGAGCAACATAACAAGACCCTGTCTCTACTAAAAACATTAAAAATTAGCAGGATGTGGTGGCACATGCCTGTGGTCCCAGCTACTCAGGAGGCTGAGGTGGGAGGATTGCTTGTGCCCAGGAGGTCAAGGCTGCAGTGAGCCGTGACTAAGCCACTGCACTCCAGCCTGGGCAACAGAGCAAGACTCTGCCTCAAAACAAGACAACATAAAAAAA","GGCCAGGTGTACTGGCTCATGCTTATAATCCCTGCACTTTGGGAGGCTGAGGTGGGAGGATTGTCTGAGGCCAGGAGTTTGAGACCAGCCTGGGCAACAGAGTGAGACCTTGTATCTTAAAAAAAAAAAAAAAAAAAAAAAAAAGCAGGGTATGGTGGTGCACACCTGTGGTCCAAGCTACTCGGGAGGCTGAGTGTTGGAGGATTGCTTGGGCCCAGGAGGTCGAGGCTGCAGTGAGCTGTATTCATGCCAGTGCACTCCAGGTTGGGTGACAGGGTGAGATTCTGTCTCAAAAAACAAACAACAAAA"
"chr1","11313053","11313357","chr10","125157322","125157641","64","113844269","GGCTGGGCACAGTGGCCTCATGCCTGTAATCCCAGCACTTTGGGAGGTTGAGGTAGGAGGATCACTTGAGGTCAGTTCGAGACCAGCCTGGGTAACATAGTGAGACCCCCATCTCTACCAAAGAAAAAACTAAAAATGAGCTAGGTGTGGTGGTGCCCGCCTATAGTCCCAGCTACTTGGGAGGCTGAGGTGGAAGGAGTGCTTGAGCCCAAGAGTTCGAGGCTGCAGTGGGCTATGATCCCACCACTGCACTCCAGCCTGGGTGACAGAGTGAGACCCTATCTCAAAAAAAAAAAAAAAAACAA","GGCTGGGTGCAGTGGCTCATGCCAGCAATCCCAGCCCTTTGGGAGGCTGAGGTGAGCAGATCGCTTGAGCCCAGGAGTTTGAGACCAGGTGAGGCAACATGGCAAGATCCCCTCTCTACCAAACAAACAAACAAACAAACAAAAAACAACTAGCTAGGGATGGTGGTGCGTGCCTGTAGTCCCAGCTACTTGGGAGGCTGAAGTGGGAGGATCGCTTGAGCCCAGGAGTTCAAAGCTGCAGTGAGTCATGATAGCACCACTGCACTCCAGCCTGGGTGACAGAGTGAGACCCTGTCGCAAAAAAAAAAAAAAAAAAAGAA"
"chr1","11317091","11317403","chr14","31798968","31799292","80","20481877","GGGTGCAGTGGCTCACATCTGTAGTTCCAGCACTTTGGGAATCCAAGGCAGAAGGATGACTTGAGGCCAGGAGTTTGAGACTTGGCTTGGGCAACATAGTGAGACTCCATCTCTACAAAAAGCTTGAAAATTCGCCAGGCATGGGGACTTGTGCCTGTAGTCCCAGCTACTCAGGAGAGAGGCTGAGGCGGGAGGATTGCTTGAGTCCAGGAGTTTGAGGCTGCAGTGAGCCATGATCATGCCACTGCACTCCAGCCTGGATGACACAGGGAGGCCCAATATCAAAAAAAAAAAAAAAAAAAAAGTAAAGGAA","GGCTGGGCACAGTAGCTTACACCTGTAATCCCAGTACTTTGGAAGGCTGAAGTGGGAGGATCCCTTGAGGCCAGGAGTTTGAGACCAGCCTGGGCAACATAGTGAGACCCTGTCTCTACAACAAACAAACAAACAAACAAACAAAACTTAGCCAGTTGTGGTGGCACATCCTATAGTCCCAGCTACTCAGGAGGCTGAGGAGGGAGGATCTCTTGAGCCCAGGAGTTTGAGGCTGCAGTGAGCTATGATCATGACACTGCACTCCAGCCTGGATAACACAGCAAAATCCTGTCTCAAAAAAAAAAAAAAAAAAAAAAAAAAAGAA"
"chr1","11332132","11332441","chr9","2736689","2737010","75","8595443","GGCTGGACGTGGTGGCTCACGCCTGTGATCCCAACACTTTAGGAGGCTGAGTCAGGAGGACTGCTTGAGGCCAGGAGTTTCAAGACAAGCCTGGGCAAAACAGCAAGACCCTGTTTCTAAAAAAAAAGAAAAAAAATTATCTGGGCTTGGTAGTGCACTTGTGTAGTCCCAGCTACTTGGTAGGCTGAGGTGGGAGGATGATTTGAGACGAAGAGGTGGAGGCTGCAGCGAGCTGTGATCACGCTACTGCACTCCAGCCTGGGCAATAGAGCGAGACCCTGTCTCAAAACAATAAAAATAAAAGAACAAA","GCCTGGTGCAGTGGCTCACACCTAGTATTCCCAGCACTGTGGGAGGCCAAGGCAAGAGGACTGCTTGAGCCCAGGAGTTCAAGACCAGCCTGGGTAACATAGCAGGACCTTGTCTCTACAAACAAACAAACAAACAAACAAACAAATTAGCTGGGCATGGTGGCATGCACCTGTAGTCCCAGCTGCTTGGGAGGCTGAGGTGGAAGGATCATTTGAGCTTGGGAGGTTGAGGCTGCAGTGAGTCATAATCACATCACTGTACTCCAGCCTGAGTGACAGAGTGAGACCCTGTCTCTAAATACAGAAATAAATAAAAGAAAAA"
"chr1","11336326","11336609","chrX_NW_019937303v1_random","2630481","2630786","89","8705845","GGCCAGGCGCAATGGCTCACGCCTGTAATCCTAGCGCTTCAGGAGGCCAAGGAGGATCACTTAAGGCCAGGAGTTTGAGACCAGCCTGGGAAACTTGGTGAAACACCCCGTTTCTACAAAAAGTAGCCAGGTGCCTATAGCCCCAGCTACTCGGGAGGCTGAGGTGGGAGGATCACTTGAGCCCAGGAGTTCAAGGCCATAGTGAGCTATGATCATGCCACTGTACTTCAGCCGAGGCAGCAGAGTGATACCATATCTCAAAACAAAACAAAACAAAGCAAAAA","GCTGGGCGTGGTGGCTCACGTCTCAAATCCCAGCACTTTGGGAGGTCAAGCAGTGAGGATTACTTAAGGCCAGGAGTTTGAGACCAGTCTGGGAAACATAGTGAGAGTCTGTCTCTACAAAACACACACACACACACACACACACACACACCTGTAGTCCCAGGTACTCAGTAGGCTGAGGCAGGAGGATTGCTTGATCCCAGGAGTTCAAGGCTGCAGTGAGCTGAGATTGCACCACTGCACTCCAGCCTGGGCAACAGAGCGAGACTCCATCTCAAAAAAAAAAAAAAAAAGAAAAGAAAAGAA"
"chr1","11341339","11341621","chr1","88859712","88859991","82","77518373","GGTGCAGTGGCTCACGCCAGTGCTTTGGGAGTCCAAGGCAGGAGGATCGCTTGAGGCCATGAGTTTAAGACCAGCCTGGGTAACATAGTGAGATCCTGTCTCTACAAAAAATTAAAAACTTAGCTGGGCATGGTGGTGTGTGGCTGTAGTCCCAGCTACTTGGGAGGCTGAGACAGGGGGATTGCGTGAGTCCAGCAAGTCAAGGTTGCAGTGAGCCGTGATTGCACCATTGCACCCCAGCCTGGGCAACTTAGAGTGAGACTCCATCTCTTTTTAAAAAAAA","CCAGGCACAGTGGCTCACACCTGTAATCCCAGCACTTTGGGAGGCCAAGGCAGGAGGATTGCTTGAATCCAGGAGTTTGAGACCAGCCTGGGCAGCATAGTGAGACTTGGCCTCTACAAAAAAAAAAAAAAAAAAAAAAAAAAGTTACCTGGGAAGTCTCAGCTACTTGGAAGGCTGAGGTCGGAAGGTTGCTTGAGTACAGGAGGTCAAGGCTGCAGTGAGCTATGATTGTACCACTGCACTCCAGCGTGGGCAACAGAGTGAGACCTTATCTCAAAAA"
"chr1","11377538","11377835","chr12","108570006","108570305","80","97192468","GGCTGGGTGCGGTGGCTCACACCTGTCATCCCGGCACTCTGGAGGCTGAAGCAGCAGGATCCTTGAGGCCAGGATTGAGACCAGCCTGGGCAACATAGGGAGATGCTCACTCTACAGGGTATTTTTTAAATTAGCTAGATGTGGTGGCATGCACCTATAGTCCCAGCTACTCAAGAGGCTGAAGCCGGAGGATCACTTGAGCCCAGGAGTCGGAGGCTACAACGAACTGTAATTGTACCACTGCACTCCAGCCTGGGCAACAGTGCAGGACCCTGTCTTGAAATAATAATAATAATAA","GGCAGGGCGTGGTGGCTCACACCTGTAATCCCTGTATTTTGGGAGGCTGAGGCAGGACGATTGCTTGAGGCTAGGAGTTTGAGACCAGTCTGGGCAACATTTAAATAAATAAATAAATAAATAAATAAATAAATAAATCAGCCAGGCATGGTAGCATGAACCTGTAGTCCCAGCTCCTCAGGAGGCTGAGGGAGGATTGCTTGAGCCCAGGAGTTCAAGGTTGCATTGAGCCATGATTGCACCACTGTACTCCAGCCTGGGAAACAGAGTAAGACCCTGTCTCAGAAACAAACAAAAAAA"
"chr1","11378440","11378566","chr9","47045786","47045941","67","35667346","GGCCAGGCACAGTGGCTCACCCCTCTGTAATTCCAGCACTTTGTGAGGCCACGATGGGAGGATCATTTGAGGGCAGAAGTTCAAGACCAGCCTGGGCAACCTAGCAAGATCCTGCCTCTACAAAAAA","GCTGGGCGCAGCAGCTCACACCTGTAATCCCAGTGCTTTGGAGGTCCAAGGTAGGAGGATTGCTTAAGACTAGGTGTTCAAGACCAGTCTTGGCAACATAGTGAGAACTCATCTCTACAATAAATAAATAAATAAATAAATAAATGAAAATAAAAA"
"chr1","11394366","11394666","chr7","93103409","93103731","71","81709043","GGCCGGGCACAGTGGCAGACTCCTATAATCCTAGCACTTTGGGAGGCTGAGGCAGGAGGATTGCTTGAGCCCGGGAGTTCAAGACCAGCCAGGGCAACATAGGGAGACCCCCTATCGCTACAAAAAATAATAATAATTAGCCAGACGTTGTGGTGCACACCTGTAGTCCCAGGTACTTGGGAGGCTGAGGTGAGAGGATCATTTGAGCCCGGGATGTTGAGGCTATAGTGAGCTGAGATTGCGCCAGTGCACTCCAGCCTGGGTGACAGAGCCAGACTCTGTTTCAAAAAAAAAAAAAAAA","GGCCAGGCCCAGTGACTCATGCCTATAATCCTAGCATTTTGGGAGGCTCAGAAGGAGGACTACTTGAGCCCAGGAGTTTAAGACCAGCCTGGGCAACATAGTGAGACCTCATCCCTAAATAAATAAATAAATAAATAAATAAATAAATAAATAAAGCCAGACAAGGCAGGGTACATCTGTAGTCCCAGCTACTTGAGAGGCTAAGGTGGGAGGATCACTTGAGCCTGGGAGTTTGAGGCTGCAGTGAGCTGTGATCACACCACTGCACTCCAGCCTGGGTGACAGAGTGAGACCCTGTCTCAAAAAAGAAAGACAAAAAAGAA"
"chr1","11470155","11470318","chr5","32595015","32595178","60","21124860","GCCAGGTGTGGTCTCATACCTGTAATCCCAATGTTTTGGAAAGCTGAGGTGGGAGGATTACTTGAGCCCAGGAATTTGAGGTTGCAGTGAGCTATGAAGGCACCACTGTACTCCAGCCTGGACCAAAGAACAAGACTCTGTCTCTAAAAATATAATAATAATAA","GGCCGGGTGTGGTCCCTCATGCCTGTAATCCCAACACTTTGGGAGGCTGAGATAGGAGGACTGCTTGAGGCCAGGAGTTCAAGACCAGCCTGGTCAACATAGTGAGACCCCATCTCTATAAAATAATAATAATAATAATAATAATAATAATAAATAAATAAATA"
"chr1","11506795","11507073","chr3","9052682","9052970","74","2454113","CACTTTGAGAGGCCAAGGTGGGAGGACCACTTGAGGCCAGGAGTTTGAGACCAGTGTGGGCAACATAGTGAAACGCTGTCTCAAAACAAAAACAAAAACAAAAAACTAGCTGGGCATGGTGGCACATGCCTGTAGACCTAGCTACTCAGGAGGCTGAGATGGGAGGATTACCTGAGCCCAGGAGTTTCAGGCTGCAGTGAGCTATAACCATGCCACTGCACTTCAGCCTTAATGAGAGTGACACCTTGTCTCAAAAAGATAAAAATAAAAACATAAAAA","ACTTTGGGAGGCTGAGTCGGGAGGATTACTTGACACCAGGAGTTCAAGACCACCTGGGTAACATAGTGAAAACTTCTCTTAACAAAAAAAAAAAAAAAAAAAAAAAAAAAATTAGCCAGCCATAGTGGTGCATGCCTGTGGTCTCAGCTACTCAGGAGGCTGAGACAGGAGGATCACTTGAGCCCAGAACTTCAAGGCTGCAGTAAGCCCTGATTATGCCACTGCACTCCAGCATGGGCAACAGAGCAAGACCTTGTCTCAAAAAAAAAAAAGAAAAAACAGGAGAAAA"
"chr1","11508141","11508434","chr3","1995447","1995752","73","9512694","GCAGGGTACCGTAGTTCATGCCTATAATCCCAGCTACTTGGAAGGCTGAGGCAGGAGGATCCTTGAGGCCAGGAGGTTAAGACCAGCCGGGGAAACAGCAAGACCCTCTCTGTAAAAACACACAAAAATTAGCCAGGCATGGTGACACATGCCTGTAGTCCTTGCTACTTTGGAGGCTGAGGTTGGAGGATCCCTTGAGCTGAGGAGTTCAAGGCTGCAGTGAACTATGATTGGGCTACTGCACTGTAGCCTGGGTGGCAGAGCAAGACCCTGTCTCTTAAAAAAAAAAAAGAA","GGCAGGGTGTGGTGACTCATACCTGTAATCACAGTACTTTGGGAGGTTAAGGCAAGAGGATCACTTGAGGCCAGGAGTTCAAGACCAGGCTGGGCAACATAGTGAGACCCCGTCTACACACACACACACACACACACACATACGGGCATGGTGACACATGCCTGTAGTCCTAACTAGCTACTCAAGAGGCTAAGGTGGGAGGATTGCTTGAGCTTGGAAGGTGAAGAATGCAGCGAACTATGATTGTGCTGCTGTACTCCAGCTTGGGTGACAGAGTGAGACCCTGTCTCAAAAAAAAATAAAGAA"
"chr1","11510690","11510800","chr20","87144","87254","63","11423546","GGCCGAGCACAGTGGCTAACACCTGTAATCCCACTTTAGGAGGCCAAAGTGGGAGGATTGCTTGAGGCCAGGAGTTCAAGACCAGCCTGGGCAACATAATGAGACCCCATC","CCTGGGCAACATAGTGAGACTACATCTCTACACTCACGCACACACACACACACACACACACACCCCCCAAATTAGCCAGGCATGCTGATGTGCACCCATAGTCTCAGCAAC"
"chr1","11513110","11513306","chr12","23162528","23162744","63","11649418","CCATCTCTACTAAAAAATAAAAAAAATCGGCCAGGCATGGTGGCATGCATCTGTAGTCTAGCTACTCAGGAGGCTGAGGTGGAAGGATTGTTTGAGCCCAGGAGTTAGAGGCCATAGTGAGCTATGATCATGCCATTGCAGTCAAGCCTGGGTGACAAAGTGAGACCCTGGCTCAAAAAATAAATAAATAAATAAAA","TCTCTACAGAAAATAATAAAAACTTGGCTGGGCATGGTGGCATGTTCTTGTAGTCTCAGCTACTCAGGAGGCTGAGGTGAGAGGATTGCTTGAGCCCAGAAGGTTGCGTTAGGGTTAGGGTTAGGTTTAGGGTTAAGGTTAGCCATGATTGCACTCTTGCCTGGGCAACAGAGCAAGACCCTGTCTCAAAAAAAAAAAAAAAAAAAAAAAAAAAAAA"
"chr1","11525793","11526026","chr7","137245286","137245521","60","125719493","AGCCTGGGCTACACAGAGAGACCCTGTCTCTACAAAAAATAAAAGATAAAATTAGCTGGCATGGTGGTGTGTGCCTGTGGTCACAGCTACTCAGGAGGCTGATGAGAGAGGATCGCTTGAGCCCAGGAGGTCGAGGCTGCAGTGAGCTATGATCATGCCACTGCACTCCAGCCTGGGTGACAGAGCAAGCCCCTGTCCTCCCCCCACCCCCAAGAAAAAGAAAAGAAACACAAA","AGCCTGGGCAATATAGTGAGACTCTGTCTCTACAAAATAAATAAATAAATAAATAAATAAAATTAGCCAGATGTGGTGGTGCATGCCTGTAGTCCCAGCTACTAGTGAGGCTGAGGTGGGAGGATCACTTGAGTTCGGGAAGTCGAGGTTGCAGTGAGATATGATCATGCCACTGCACTCCAGCCTGGATGACAGAGTGAGACCCTGCCTCAAAAAAATTAAAAAAGAAAAGAAAA"
"chr1","11548404","11548696","chr9","68878569","68878883","70","57330165","GGCTGAGCGCAATGACTCACGCCTGTAATCCCAGCACTTTGGGAGGCTGGAGGATTGCTTGAGCCCAGGAGTTCAAGACCAGCCTGGGCAACATAGGGAGACCCCACGTCTACAATAAATTTTAAAAATTAGTTGGATATGGTGGCACATGCCTGTTGTCCCAGCTACTCAGGAGGCTGAGGTGGGAGGATCACTTGAACTGAGGAGGTCAAGACTGCAGTGAGCCAAGATCATGCCACTGCACTCCAGTCTGGGCAACAGAGTGAGACCCTGTCTCAAAAAAAAAAAAAAAA","GGCTGGGCACGGCAGCTCATGTCTGTAATCCCAGCACTTTGGGAGGCCAAGGTGGGAGGATTGCTTGAGTCCAGGAGTTCAAGACCAGCCTGGGCAACATAGTGAAACCCCAGTCTCTACAAATAAATAAATAAATAAATAAATAATTAGCTGGGCATGTTGATGCATGCCTGTAGTCCTAGCTACTCGGGGGGTGAGGTGAGAGGATTGCTTGAGTCCAGAAGGTGGAGGCTGCAGTGAGCTATGATCACACCACTGCACTCCAGCCTGGAAGACAGGGTGAGACGCTGTCTTTAAAAAAAAAAAAAGAAAAGA"
"chr1","11551745","11552043","chr8","25360790","25361095","70","13809045","GGCCAGGCATGGTGGCTCAAACCTGTAATCCCAGCACTTTGGGAGGTCGAGGTGGGAGAAGTGTTTGAGCCCAGGAGATTGAGATCACCCTGGGCAATATAGGGAGACTCCGTCTCCTCACACAAAAAAATAAAATTAGCTGGGTGTGGTGGTGCTCACCTGCAGTTCCAGCTACTCAGAAGGCTAACGTGGGAGAGTTGCTTGAGCCTGGGAGGTTGAGGCTGCAGTGAGCTGTGATTGTGCCACTGTACTCCAGCCTGGGCAAGACAGCAAGACCCTGTCTCAAAAAAAAAAAAAGA","GGCTGGGAGCAGTGGCTCATACCTGTAAGCCCAGCACTTTGGGAGGCTGAGGTGGGAGGATTGCTGAAGCCCAGGAGTTTGAGACCAACCTGGGCAATGTAGGGAGACCCCGTCTCTACTAAATAAATAAATAAATAAATAAATAAAGTCGGGCATGGTGGCATGTGCCCTGTAGTCCCAGCTTCTTGGGAGGCTGAGGTGGGAGGATTGCTTGGGCCCAGGAATCAAGGCTGCAGTGAGCTGTGATTGTGCCACTGTACTACAGCCTGGGTGACAGTGCAAGACTGTCTCAAAAGAAAAACAAAA"
"chr1","11589096","11589370","chrX","3592780","3593062","74","7996316","CAGTGGCTCATGCTTGTAATCCCAGTGACTCAGGAAGCTGAGGTGAGAGAATCACTTGAGGCCAGGAGTTCTAGACCAGCCTGGGCAACATAGCAAAACCCTGTTTAAAAAAAAATTTAAAACTTAACTGGCATGGTGGTGTGCACCTGTAGTCCCAGCTACTCAAGAGGCTGAGGCAGGAGGATTGCTTGAGCCAGGGAGTTCAAGGCTGCAGTGAGCTGTGATCATGCCACTGCACTCCAGCCTGAACGACAGAACAAGACTCTAACTCTAAA","GTGGTGGCTCATGTCTGTAATCCCAGCACTTCAGGGGGCCAAAGCGAGAGGACTGCTTGAGGCCAGGAGTTTGAGACCAGCCTGCGCAACATAGAAAGACCCCATCTCTATAAATAAATAAATAAATAAATAAATAAGTCAGGCATGGTGGCACATGCCTGTAGTCCCAGCTACTCAGAAGGCTGAGGTCGGAGGATCTCTTGAGCCCAGGGGTTCAAGGCTGCAGTGAACCATGATCACACCAGTGCACTGCAGCCTGGGCAACACAGCAAAACCCTGTCCC"
"chr1","11595756","11595992","chr16","14564705","14564970","82","2968949","TAATCTCGGCACTTTGGGAGGTTGAGGCAGGAGCATAGCTTGAGCCCAGGAGTTTGAGACTAGCCTGGGCAACATAGCAAGACCCCATCTCTACGAAAAATTTTAAAATTAGCCAGATGCAGTGGCACACATCTGTAGTCGCTACTTGGGAGGCTGAGGTGGGAGGATCACTTGAGCCTGGGAGGTTGGGGCTGCAGTGAGCTGTGATTGAGCCACTGTACTCCAGCCTGGGTGGCA","CTGTAATCCCTGCACTTTGGGAGGCTGAGACAGGAGGATCACTTGAGACCAGGAGTTAGAGACCAGCCTGAGCAACATAGCAAGGCCCTATCTCTACAATAAATAAATAAATAAATAAATAAATAAATAACTTTTATTTGCTGGGCCTGGTGGCACGTGCCTACAGTTCCAGCTCCTCAGAAGGCTGAGGTGGGAGGATCGCATGAGTCCAGGATTTTGAGTATAGTGAGCCATGGTCGCATCACTGCACTCCAGCCTAGGTGACA"
"chr1","11645463","11645747","chr18","16899958","16900260","67","5254495","GGCCAGGCACGGTGGCTCACGTCTATAATCCCAGCACTTTGGGAGGCCGAGGCAGGAGGATTGCTTGAGGTCAGGAGTTTGTGACCTGCCTGACCAACATGGCAAGACCCTATCTCTATAAAAAATAAAAATTAGCCTGGTGTGGTGGCACGTGCCTGCAATCCCAGCTACTCAGGAGGCTGAGGTGGAAGGATCGCTTGAGCCCAGAAAATTGAGGCTGCAGTGAGCCATGATCACACCACTGCACTCCAGCCTGGGTGACAGAGTGAGACCGTGTCTCTAAAA","GTCAGGCGCGGTGGCTCACACCTGTAATCCCAGCACTTTGGGAAGCCGAGGCAGACGGATCACCTGAGGCCAGGAGTTCAAGACCAACCCCGGGCAACAAAGCAAGACCCTGTCTCTATAAAAAAAAAAAAAAAAAAAAAAAAATTAGCCGAGCATGATGGCAAGTGCCTGTAGTCCCAGCTACCTAGGATGTTGAGGTAGGAGGATTGCTTGAGCCCAAGAGGTTGAGGCTGCAGTGAGCCATGATCTCACCACTGCACTCCAGCCTGGGTGACAGAGCGAGACCCTGTCTCAAAAAATAAA"
"chr1","11659522","11659795","chrX","46692258","46692555","77","35032736","GGCTGGGCACAGTGGCTCATGCCTGTAGTTCCAGCACTTTGGGAGGCTGAGGCAGAAGGATGACTTGAGGCCAGGAGTGCGAGACCAGCCTGGGCAACAAAGCAAAACTCCATCTCTACAAAAAAAAATTTTTTTTTTAATTAGTGGTGGTGCACACCTGTACTCCCAGCTACTCAGGATGCTGAGGCAGGAGGATGACTTGAGCCTAAGAGTTTGAGTCTGCAGTGAGCTATGAATGCGCCAGCCTGGGTGACAGAGACCCTGTCCCTAAAAA","GGCCAGGCATGGTGGCTCATGCCTGTAATCCCAGCACTTTGGGAGGCTGAGGAAAGATGATCACTTGAGCCAGGAGTTTGAGCCCAGTCTGGGTAACATAGTGAGACCTCCATCTCTACAAAAAAAAAAAAAAAAAAAAAAAAAAGCTGGGCATGGTAGCACACATCTGTAGTGTCAGCTACTCAGGAGGCTGAGGTAGGAGGATTGCTTGGGCCCAGGAGATCAAGACTGCAGTGAGCTATGACTGCACCACTGCACTCCAGCCTGGGCAATGGAGTGAGACCCTGTCTCAAAAAAA"
"chr1","11666194","11666365","chr22","26696703","26696888","69","15030509","CAACCTTGGCAACACAGGGAGGCCCCGTCTCTATAAATAGTGAAAAAATTCGCCGGGCATAGTGGCGAGTGCCTATGGTCCTAGCTACTTGGGAGGTTATGGCGTCAGGATCTTCTGAGCCCAGGAGGTCAAGGCTGCAGTAGCTCACAGGTGTGAGCCACCGAACCCAGCC","CCAGCCTTGGCAACATAGCAAGACCCTGTCTCTATCAATCAATCAATCAATCAATCAATAATCCAGGCGTGATGGCACACACCTGTGGTCCCAACGACCCGGGAGCCTGAGGTGGAAAGATCGTTTGAGCCCAGGAAGTTGAGGCTGCAATGAACTGTGAACATGCTACGGCACTCCAGTCTGGGC"
"chr1","11687056","11687232","chr2A","60286019","60286209","54","48598963","TTAGCTGGGTGTGATGGTGCACACCTGTAGCCCCAGCTATTGGGGAGGCTGAGGTGGGAGGATCGCTTGAGCCCAGGAGGTTGAGGCTTCAGTGAGCTGTGATTGCGTCACTGCACTCCAGCCTAGATGACAGAGTGAGACCCTGTCTCCAAAAAATAAAATAAAAAAATAAAAAAA","AAAATTAGCCAGGTGTGATGGCACCTGTAGTCCTAGCTACTTGGGAGGCTAAGGTGGGAAGAGGGCTTGAGCCCAAGATTGTGAGGCTGTGGTGAGTCATGACTGTGCCATTGCCCTCTGGCCTGGGTGACAGAGTGAGAAGCTGTCTCAAATAAATAAATAAATAAATAAATAAATAAAAATAAACAAAA"
"chr1","11687538","11687675","chr5","32595015","32595178","48","20907477","GGTCAGGCGCAGTGGCTCATGCCTGTAATCCTAGCACTTTGAGAGGGTGAGGCAGGAGGACCTCTTGAAGCCAGGAGTTGGAGACCAGCCTGGCAACATAGTGAGACCCCTTCTCTACAGAAAATTTTAAAAATTAGT","GGCCGGGTGTGGTCCCTCATGCCTGTAATCCCAACACTTTGGGAGGCTGAGATAGGAGGACTGCTTGAGGCCAGGAGTTCAAGACCAGCCTGGTCAACATAGTGAGACCCCATCTCTATAAAATAATAATAATAATAATAATAATAATAATAAATAAATAAATA"
"chr1","11716672","11716791","chr20","87144","87254","68","11629528","GCCGAGGCGGGAGGATCCCTTGAGCCCGGGAGTTAAAGCTACAGAGAGCTGGGATTGCGCCACTGCACTCCAGCCTGGGTGACAGAGTGAAACCCTGTCTCAAAAAATAATTAAATTAAA","CCTGGGCAACATAGTGAGACTACATCTCTACACTCACGCACACACACACACACACACACACACCCCCCAAATTAGCCAGGCATGCTGATGTGCACCCATAGTCTCAGCAAC"
"chr1","11718462","11718763","chr12","108570006","108570305","81","96851544","GGGTACGGTGGCTCACACCCGTAATCCCAGCACTTTGAGAGGCTGAGGTGGGAGGATCGCTTGAGCCCAGTAGTTCCAGACCAGCCTAAGCAACATAGGGAGACCCTATCTCTACAAAAAATGTAAAAATTAGCCAGGCATTGTGGCATACACCTGTAGTCCCAACTATAGGAAGGAGGGGCTAACATGAGAGGATCCTTTGAGCCCAGGAGTTCCAGGCTGCAGTGCGCCTTGGTTGCACCACTGTAGTTCAGCCTGGGTAACAGAGTGAGACTCTGTCTCAAAAAAATTAAAAAATAAAA","GGCAGGGCGTGGTGGCTCACACCTGTAATCCCTGTATTTTGGGAGGCTGAGGCAGGACGATTGCTTGAGGCTAGGAGTTTGAGACCAGTCTGGGCAACATTTAAATAAATAAATAAATAAATAAATAAATAAATAAATCAGCCAGGCATGGTAGCATGAACCTGTAGTCCCAGCTCCTCAGGAGGCTGAGGGAGGATTGCTTGAGCCCAGGAGTTCAAGGTTGCATTGAGCCATGATTGCACCACTGTACTCCAGCCTGGGAAACAGAGTAAGACCCTGTCTCAGAAACAAACAAAAAAA"
"chr1","11725120","11725343","chr7","119744984","119745215","57","108019864","AGCCTAGGCAACATAGGGAGACCTCATCTCTGCAAAAAATAACAAAATTAGCCGGGCATGGTGGTGCACACCTGTAGTCCCAGCTATTCTCCAGGCTGAGGTGGGAGGATCGCTTGAGCCCAAGAGGTTGAGGCTGCAGTGAGCCATGATCGCACCACTGCACTCCAGCTTAGGCAATACAGCGAGACCTTGTCTCAAAAAAAGACAAAAAAAACAAAAAGAAA","CAGCCTGGGCAATATAGGGAGACCTCATCTCACAAAAAAAAAAAAAAAAAAAAAAAAAATTAGCCTATTGTGGTGGTGCACGCTTGTGGTGCCAGCTACTTGGGAGGCTGAGGTGGGAGGATCACTTCAGCCCAGGAGTTAGAGGCTGCAGTGAGCTATGATCCTGCCACTGCACTCCATCCTTGGCAACAGGGCAAGACACTTGACTCAAAAAGAAAAAAGAAAAAAAAAA"
"chr1","11731262","11731433","chr5","32595015","32595178","69","20863753","TTAGCTGGGCATGGTGGTGTGAGCCTGTAATACCAGCTACTTGGGAGGCTGAGATGGGAGGATCACTTGAGCCCAGGAGTTGGAGGCTGCAGTGAGCCAAGGTTGCACCACTGTACTCCAGTCTGGGTGACAGAGCACCTAGAGGGCCCTGTCTCAAAAAAAGAAAATAAAA","GGCCGGGTGTGGTCCCTCATGCCTGTAATCCCAACACTTTGGGAGGCTGAGATAGGAGGACTGCTTGAGGCCAGGAGTTCAAGACCAGCCTGGTCAACATAGTGAGACCCCATCTCTATAAAATAATAATAATAATAATAATAATAATAATAAATAAATAAATA"
"chr1","11769304","11769577","chr5","6598042","6598342","75","5171262","GCCAGGCACGGTGGCTCACACCTATAATCCCAACACTTTGGGAGGCCTCGGCCAGGAGTTAGACACCAACCTGGGCAACATAGCGAGACCCCGTCTCTAGCAAAAAAATGTAAACATTTAGCCAGGCATGGGGGCATGCTTGTAGTCCCAGCTACTCTAGAGACTGAGGCAGGAGGATCACTTGAGGCCAGGAAATCAAGGCTGCAGTGAGCTATGATCATGCCACTGCACTCCAGCCTGGGCAACAGGTCAAGACCCTGTCTCAAAAAAACAA","GGCTGGATACAGTGACTCACACCTATAATCCCAACATTTTGGGAGGACAAGGCAAGAAGATCACTTGAGGCCGAAGTTTGAGACCAGCCTGAGCAACAGAGTGATACCTGGTCTTTACAAAATAATAATAATAATAATAATAATAACAAGTGTGGTGGCACATGCTTGTAGTCCCAGCTACTCGAGAGGCTGGGACAGGAAGATCGCTTAAGCCCTGGAACTCAAGGCTGCAGTGAGCCATGATCATGCCACTGCACTGCAGCCTGGGCAACACAGCAAGAACCTGTCTCGAAAAATAAAA"
"chr1","11773922","11774203","chr1","20214247","20214541","72","8440325","GCCAGGCATGGTAGCTCACACCTGTAATCTCAGCACTTTGGGAGGTCAAGGTGGGCGAATTGCTTGAGTCCAGGAGTTCGAGGCCAGCCTGAGCAACGTGGCAAAAAATTAAATCTCTACAAAAAATTTAAAAATTAGCCAGGTGTGGTGGTATGCACCTATAGTCCCAGCTACTTGGAGGCAGAGGTGAGAGGATCCCTTGAGCCTAGGAATTTGAGGCTACAGTGAGACATGATTGCACCACTGCACTCCAGCCTGGGTGACACAGTAAGACCCTGTCTC","GACTGGGCGTGGTGGCTCACACGTGTAATGTCAACACTTTGGGAGGCCGAGGTGGAGGATTGCTTATGACCAGGAGTTTGAGACCAGCTGGGCAACATAGTGAGACCCCATCTCTACCACACACACACACACACACACACACAAATTAGCTGGGTGTGGTGGCAAGCCCCTGTAGTCCCAGCTACTCAGGAGGCTGAGGTGGGAGGATCACTTGAGCCTGGGATGTTGAGGCTGCAGTGAATCATGATTGCACCATCGCATTCTAGCCTGGGAGACAGAGCAAGACCTTGTCTCA"
"chr1","11797293","11797612","chr1","199907800","199908113","69","188110507","GGCTGGGTACAGTGGCTCATGCCTGTAATCTCAGCACTTTGGGAGGCCAAGGTGGGAGGATTGCTTGAGCCCAGAAGTTCCAGACAAACCTGGACAAGATAGCAAGACCCCATCTCTAAAAAATAAATAATTAATTAAAAAAATTTTTTTTAATTAGCCAGATGTGGTGGCTTGCATCTGTAGTCCAAGCTACTCAGGAGACTGAAGTGGGAGATCACTTGTGCCCGGGAGTTCAAGGCTACAGTGAGCCATGATTGTATCACTGCACTCTAGCCTGGGTGACAGAGCAAGACCCTGTCTCTGAAACAAAACAAAACAAA","GGCTGGGTGCAGTGGCTCATGCCTGTAATCCCAGCACTTTGGGAAGCCAAGGCGGGAGATGGCTTGAGGCCAGAAGTTCAAGACCAGCCTGGGAAACATAGCAAGATCCTGTTTCCACAAAAAAAAAAAAAAAAAAAAAAAAATGTTTTTTAAATTAGCCAGTCATGGTGGCATGCGCCTGTAGTCCTGGCTACTAGGGCGGCTAAAGCAGGAGGATAGCTTGAGACCAGGAGTTCAAGGCTGCAGTGAGTCATGATCATGCCACTGCTCTTCAGCCTGGGTGACAGAGCAAGACTGTGTCTCTTAAGAAAAAA"
"chr1","11831687","11831966","chr13","82343527","82343808","86","70511840","GGTTGGGTGCTATGGCTTGTGTCTATAATCCTAGCACTCCTAAAACAGGAGATCATTTTAGGCCAGAAGTTCGAGACCAGCCTGGGCAACATAGTGAGATCCTGTCTCTATAAAAATAAGCTGGATGTGGTGGCATGCACCTGTAGTCCCAGCTACTTGGGAGGCTGAGATGGGAGGATCGCTTGAGCCCAGGAGTTTGAGGTTACAATAAGCTATGATCACACCACCGTACTCCAGCCTGGGTGACAGAGTGAGATCCTGTCTCTAAAAAGATAAAGAA","GGGCATGTTGGCTCATGCCTGTAATCCAAGCACTTTGAGAGGCCAAGCAGGGAAGATCACTTGAGGCCAGAAGTTCAAGACCCTGTCTCGCCACAAAAAAAAAAAAAAAAAAAAAAAAAAAGCTGGGTATGGTGGCATGCACCTATAGTCCTAGCTTCTCAGGATGCTGAGGTGGGAGGATGGCTTAAGACCAGGAGCTGAGACTGCAGTGAGCTATGATTGTGCCACTGCACTCCAGCCTCAGTAGCAGAGCAAGACCCTGTTTCTACAAATAATAATAAA"
"chr1","11852518","11852834","chr14","31798968","31799292","73","19946450","GGCCAGGTGCAGTGGCTCACACCTGTAATCCCAGCACTTTGGGAGGCTAAGGTAGGAGGATTGCTTGAGGCCGTGAGTTCAAAATCAGCCTTGCAAACATAGTGAGACTCTCCATCTCTACAGAAAAAAAAAATTATTTTAATTAGCCAGACATGGCAGCATACTCCTGTAATCCCAGCTACTTGGGAGGCTGACGTGGGAGGATCGCTTGAGCCCAAGAGTTTGAGGTTATAGTGAGCTATGATCATGCCACTGCACTCCAGCCTTGGTGACAGAGCAAGACTCTGTCTCTATTTAAAAAAAAAAAAAAAAAAAAA","GGCTGGGCACAGTAGCTTACACCTGTAATCCCAGTACTTTGGAAGGCTGAAGTGGGAGGATCCCTTGAGGCCAGGAGTTTGAGACCAGCCTGGGCAACATAGTGAGACCCTGTCTCTACAACAAACAAACAAACAAACAAACAAAACTTAGCCAGTTGTGGTGGCACATCCTATAGTCCCAGCTACTCAGGAGGCTGAGGAGGGAGGATCTCTTGAGCCCAGGAGTTTGAGGCTGCAGTGAGCTATGATCATGACACTGCACTCCAGCCTGGATAACACAGCAAAATCCTGTCTCAAAAAAAAAAAAAAAAAAAAAAAAAAAGAA"
"chr1","11864231","11864553","chr1","216791060","216791385","27","204926829","GGTGTGGTGGTGCACACCTGTAATCCCAGCACTTTGGAAGGCCCAGGTGGGAGGATTGCTTGAACCCAGAAGTTGAAAGCCAGCCTGGGCAACATCGTGAGACCCTGCCTCTACAAAAAAAAAAAAAAGAAAGAAAGAAATTAATTAAATAAAATAAAAAATAGCCGGGTATGGTGGTGTCACCTATAGTCCTAGCTACTTGGAAGGCTGAAACGGGAGGATCACCTGAGCCCAGGAGCCCAGGATCACCCCACTACACTCCAGCCTGGGCGACAGAGTGAGACCTTGTCTTCAACAATAACAACAATAACAACAATAACAAA","GGTGTGGTGGCTCACACCTGTAATCCCAGCACTTTGGAAGGCCCAGGTGGGAGGACTGCTTGAGCCCAGAAGTTGAAAGCCAGCCTGGGCAACATCGTGAGACCCTATCTCTAAAGAAAAAAAAAAGAAAGAAAGAAAGAAACAAAGAAATTAAATAAAATAAAAAATAGCTGGGTGTGGTGGTGTCACCTATAGTCCTAGCTACTTGGAAGGCTGAAATGGGAGGATCACCTGAGCCCAGGAGCCCAGGATCACCCCACTACACTTCAGCCTGGGTGACAGAGTGAGACCTTGTCTTTAAAACAACAATAACAACAACAACAAAA"
"chr1","11866364","11866651","chr5","63802202","63802507","71","51935838","GGCTGGGTGTGGTGTCTCACGCCTGTAATTCTAGCACTTTGTGAGGCAGAGGCAAGAAGAACGATTGAGCCCAGGAGTTCGAGACCAGCCTGGGCAACATAGGGAGACCCTGTCTCTACAAAAAATCTAAAAATTGGCTGGACGTGGTGGTGTGTGCCTGTAGTCCAGCGGCTCAGGAGGCTGAGGTGGAAGGATTGCTTGAGCCTGGGAGGTCAAGGCTGCAGTGGACCATGATTGCACCACTGTCCTCCGGCCTGGGCAACAGAGTGAGATCCTATCTCAAAAAAA","GACTAGGGGTGGTGGCTCATGCCTGTAATCCCAGCACTTTGGGAGGCTGAGCTGGGAGGATTGCTTGAGCCCAGAAGTTCAAGACCAGCCTGGGCAACATAGCAAGACTCCATCTCTAAAAAAAAAAAAAAAAAAAAAAAAAAAAAATTAGCCCCGAGTGGTGGTGTGCACTTGTAGTCCCAGCTACTCAGGAGGCTGAGGTGGGAGGATCTCTTGAGCCTGGGAGGTCCAGGCTGCAGTGAACCATGATTGTGCCACTGGACTCCAGCCTAGGCAATAGAGTGAGACCTTGTCTCAAAAATAAAA"
"chr1","11872192","11872490","chr3","75083989","75084283","78","63211797","GGCACAATGGCTCACACCTGTAATCCCAGCACTTTGGGAGGCTGGGGTGGGAGGATCATTTGAGGCCAGGAGTTTGAGACTAGCCTGAGCAATATAGTGAGACCCCATCTCTACCTGCCCCCAACCCCCCCACCAAAAAAAAAAAACAAAACGGAAATTAGCTAGACGTGGTGGCACCTACCTGTAGTCCCAGCTGCTAGGGAGGCTGAGGTGGGAGAATGGCATAAGCCCAGGGGTTTGAGGCTGCGGTGAGCCATGATCACGCCACTGCACTCCAGCCTGGGTGACAGAGGGAGACC","GGTGGCTCGTGCCTGTAATCCCAGTGCTATGGGAGGCTAAGCAGGGAGGATTGTTTGAGGCTAGAAGTTTGAGACCAGCCCAGGCAACATGGCAAGACCCTGTCTCTACAACAACAACAACAACAACAACAACAACAACAAAAAAGAATAAAAAATTAGCTGGGTATGGTGGCACACACCTGTAGTTCCAGCTACTTTGGAGGCTGAGGTGGGGAGATCACTTGAGCCCAGGAGGTCGAGGCTGCAGTGAGCCCTGATTGTGCCACTGCACTTCAGCCTGGGTGACAGAGCAAGA"
"chr1","11891628","11891934","chr11","113329688","113329999","76","101438060","GCCAGACAGGGGGGCTCATGCCTGTAATCCCAGCAAGGCCAAGGTGGGAGGATTGCTTGAGGCCAGGAATTCAAAACCAGCTTGGGCAACATAGCAAGATCCCATCTGTAAAAAAATAAGAAAAAATTTGCCAAGCTATGGTGGTGTGTAACTGTAGTCCCAGCTGTTGGAGAGGCTGAGGTGGGAGGATCGCTTGAGCCCAGGAGATGGAGGCTGCAGCAAGCTATAATTGAGCCACTGCACTTCCAGCCTGGGCAACGGAACAAGACCCTGTCTCAAAAAAAAAAAAAGAAAAATAAATAAATAA","GGCTGGGCATAGTGACTCATGCCTATAATCACAGCACTTTGGGAGGTGGGAGGACTGCTTGAGGCCAGGAGTTTGAGACAGGCCTGAGCAACATAGTGAGACCCTTGCTTTTAAAAAAAAAAAAAAAAAAAAAAAAAAAGCCAGGTGTGGTGGTGTACACCTGTAGTCCCAGCTGTTCGGGAAGCTGAGGTGGAAGGAATGCCTGAGCCCAGGAGTTTGAGGTTGCAGGAAACTATGATTGTGCCACTGCACTCCAGCCTGCACAACTGAGTGAGACCCTGTCTCAAAAAAGAAAAAAAAAAAAAAAGAAAA"
"chr1","11911916","11912193","chr5","83677678","83677973","66","71765762","GGGTGCAGTGGCTCACACCTGTAATCCAACACTTTGGGAGGCCGAGGCGGAAGGATCGCTTGAGCCCAGGAGTTTGAGGCCAGCCCGGGCAACATGGCGAGGCCCCATCTCTACAGAACATTTTTAAAAAATTAGCCGGGTGTGGTAGCATGCACTTGTGGTCCCAGCTACTCAGGAGGCTGAGGTGGGAGGATCACTTGAGCCCAAGAGCTCGAGGCTGCAGTGAGCCATGATTGTACCACTGCACTGCAGCCTGGGAGACCCTGTTTCAAAATAAA","CTGGGTGTGGTGGCTCACACTTGTAATCCGAACACTTTGGGAAGCCAAGGCAGGAGGATTGCTTGAGCCCAAGAATTTGAGATCAGCCTGGGCAACATGACAAGACTCCATCTCTAAAAAAAAAAAAAAAAAAAAAAAAAATCTAGCCAGGTGTGGTAGCATGCACCTGTGGTCTCAGCTACTCAGGAGTCTGAGGTGGGAGAATTGCTTGAGCCCAGCAGGTCAAGGCTGCAGTGAGCCATGTTTGTGTACTGCACTCCACCCAGGGTGACAGAGTGAGACCCTGTCTCAAAAAA"
"chr1","11914345","11914657","chr20","46003702","46004015","75","34089357","GACTGAGCACAGTGGCTCACACCTGTAATCCCAGCACTTTGGGAGGCTGAGACAGGAGGATCTCTTGAGCCCAAGACTTCGAGACCAGCCTGAGTGATATAGTGAGACCTTGTCTCTACAGAAAATTTTAAAAGTTAGCTGAGCATGGTGGTGGCGTGCACCTGTGATTCCAGTTACTTGGGAGGCTAAGGTGGGAGGATCGCTTGAGCCCAGGAGGTGGAGGTTGCAGTGAGCCAAGATCATACCACTGTACTCCAGCCTATGTGACAGAGTAAGATCCTATATCAAAACAAAACAAAAACAAACAAAAAAA","GGCTGCGCACAGTGGCTCACACCTGTAATCCAGCACTTTGGGAGGCCAAGGCAGGAGAATCATTTTCGTTCAGGAGTTTGAGGCCAGCCTGGGCAATATAGAGAGATCTTCTCTCTACAAAATATAATAATAATAATAATAATAATAAGCCAGTTGTGGTGGCTCACACCTGTAGTCTCAACTACTCAGGAAGCTGAGGTGGGAGGATCACTTGAGCCCAGGAGGTTGAGGCTGCAGTGAACCAGACTACACCACTGCACTCCAGCCTGAGTGACAGAGCAAGACCTTGTCTCAAAAGAAAAAAAACAACAAAA"
"chr1","11921853","11922147","chr12","62126102","62126415","74","50204249","GGCAGGGCCTGGTGGCTCATGCCTATAATCTCAACACTTTGGGAGGCCGAGGTGGGAGGATCCTTCGAGCCCAGTAGTTTGAGACCAGCCTGGGCAGGATAACGAGGACTTGTCTCTACAAAAAATTTAAAAATCAGCCAGGCGTGATGGTGCACGCTTGTAGTCCCAGCTACTTAGGAGGCTGAGGTGGGAGGATCACTTGAGCCCAGGAGTTTGAGACTGCAGTGAGCTGTGATTACACCATTGCACTCCATCCCAGGTGACAGAGTGAGACCCTGTCTAAAAATAATAATAA","GCTGGGCATGGTGGCCCAGGGGTGTAAATCCCAGCACTTTGGGAGGCCAAGGTGGGAGGATCGCTTAAACCCAGGAGTTCCAGACCAGCCTGGGCAATATAACGAGACTCCATCTCTATAAATAAATAAATAAATAAATAAATAAATAAAATTAGCCAGCCATGGTAGTGTGCACCTGTAGTCCCAACTACTCAGGAGGCTGAGGTGGAAGGATTGCTTGAGCCCAGGAGGTCGAGGCTGCAGTGAGCTGTGATCAAGCCACTTCACTCCAGCCTTGGTGACAGAGTAAGACCCTGTCTCGAAACTAAATAAAA"
"chr1","11922188","11922353","chr18","55799233","55799394","61","43877045","GCTGGGTGTGGTGGCTTGTGCCTGTAGTCCCAGCTACTTGGGAGGCTGAGATGGGAGAATCCCTTGAGCCCAGGAGTTTGAGGCTGCAGTGAACTATGATTGTGTCATTGCACTCTAGCTGGGGCAACAGAGCAAGACCCTGTCTCAAAAAAGCAAAAAACAAAAA","GGCTGAGAGAGGTGGCTCATGCTTGTAATCCCAGCACATTGGGAGGCAAAGGTGGGAAGATTGCTTGAGGCCAGGAGTTCAAGACCAGCCTGGGCAACATGAAAACACTTTGTCTCTACAATAAATAAATAAATAAATAAATAAATAAAAGAAACAAGAAAA"
"chr1","11930250","11930566","chr10","125157322","125157641","78","113227072","GGCCAGGTGCCATGACTCACGCCTGTAATCCCAACACTTTGGGAGGCTGAGGTGGGAGGATCCTTTGAGACCAGGAGTTCAAGACCAGCCTGGGCAACATAGACCCGTCCCTCCGCCCCCACCCACCTCCCGTCTCCACAAAAAAAATTAGGAGGGCATGGTGGTGTGCGCCTGTAATCTCAGCTTCTCAGGAGGCTGAAGTGGGAGGATCACTTGAGCCCAAGAGGTTGAGGCTGCAGTGAGCCGTAATTGTACCACTGTACTTCTGCCTGAGTTACAGAGTAAGACTCTGTCTCAAAAAAAAGGAAAAGAAAAAA","GGCTGGGTGCAGTGGCTCATGCCAGCAATCCCAGCCCTTTGGGAGGCTGAGGTGAGCAGATCGCTTGAGCCCAGGAGTTTGAGACCAGGTGAGGCAACATGGCAAGATCCCCTCTCTACCAAACAAACAAACAAACAAACAAAAAACAACTAGCTAGGGATGGTGGTGCGTGCCTGTAGTCCCAGCTACTTGGGAGGCTGAAGTGGGAGGATCGCTTGAGCCCAGGAGTTCAAAGCTGCAGTGAGTCATGATAGCACCACTGCACTCCAGCCTGGGTGACAGAGTGAGACCCTGTCGCAAAAAAAAAAAAAAAAAAAGAA"
"chr1","11940077","11940318","chr2A","34453871","34454129","80","22513794","GGGTGGGGTGGCTCACACCTGTAATGTCAACACTTAGGGAGACCAAGGCAGGAGGCTTATTTGAGGCCCTGAGTTCAAGACCAACCTGTGCAACAAAGTGAGACCCTGTCTCTACAAAAAATTAAAAAATTAGCCAGACATGGTGGCACGCACCTCTAGGCCCAGCTACTCAGGAAGCTGAGGCAGGAGGATTGCTTGAGCCCAGGAGGTGAAGGCTGCAGTGAGCTATAGTCATGCTACTG","GGCCAGACACAGTGTCTCACACCTATAATCCCAACACTTTAGGAGGCTAAGGCCGGAGGATCATTTGAGGCCAGAAGTTAGAGATCAGCCTGGGCAACACAGCAAGACTCAGGCTCTAAAATAAAAAATAAAAATAAAAAATAAAAATTAGCTGGGCGTGGTACATGCATCAAGTCCTAGATACTTGATAGGCTGAGGTGGGAGGATCGCTTGAGTCCAGGAGTTCAAGGCTGCAGTGAACTGTGATCACGCCACTGCA"
"chr1","11961102","11961411","chr1","213591659","213591963","78","201630557","GGCCGAGAGCAGTGGCTCATGCCTGTAATCCCTGCACTTTGAGAGGCCAAAGTTGAAGGATTGCTTGAGGCCAGGAGTTCAAGAGCAGCCTGGGCAACATAGCGAGACCCTATCTCTTCAAAAATTAAAAAAAAATAGCCAAGTGTGGTGGCTTGAACCTGGGGTCCCAGCTACTGAAGAAGCTGAGGCAGGAGGACCTCTTGAGCCCGGGAAGTCGAGGTTGCATGAGCTATGATTGCACCACTGTGTTCCAGCCTGGGAAACAGAGCGAGACCTTGTCTCATAAAGCAAAACAAAAACAAAGAAAGAA","GTGCAATGGCTGATGTCTGTAATCCCAGCACAGTGGGAGGCCAAGGCAGGAGGATTGCTTGAGGCCAGGGATTCAAGACCAGCCTGGGCAACCTAGTGAAACCTCATCTCTATTAAAAATAAAAATAAAAATAAAAATTAGTTGGGCATGGTGGCACACACCTGTGGTCCCAGGAGTCCTCAGGAGGCTGAGGTAGGGGGATCACTTGAGCCCAAGAGTTGAGGTTGCAGTGAGCTATGATTGCACCACTGCACTCCAGCATGGGCAACAGAGTGAGACTTTGTCTCAAAACAAAACAAACAAAA"
"chr1","11961608","11961786","chr12","4864673","4864880","67","7096935","TATTTAAAAATTAACTGGATGTGATGGCACATGCCTGTAGTCCCAGCTTCTTGGGGGGCTGAGGCAGGAGGATCACTTGAACCCAGGGGTTTGAGGCTACAGTAAGCTATGATCCTGCCACTGCACTCCAGCCTGGATGACAAGAGTGACACCAAGTCTCAAAAAGAAAAAAAAATAAA","AATTAGCCAGGTATGGTGGTGTGCACATGCAGTCCCAGCTGTTTGGGAGGCTGAGGCAGGAGGATCACTTGAGCCCAGGAGTTTGAGGCTGCAGTCAGCTATGATCATGCCACTGCACTCCAGCCTGGACAACAGAACAAGACCCTGTCTCAAAAACAAAACAAAACAAAACAAAACAAAACAAGAACAGAAAACAATCAAACAAAAA"
"chr1","11962087","11962227","chr19","6391716","6391877","43","5570371","CCAGGTGCAGTGGCTCATGCCTGTAATCCCAGCACTCTGGGAGGCTGAGACGGGAGGATAACTTCAAGCCAGGAGTTTGAGACCAGCCTGGGCAACATAGCAAGATCCTGTCTCTACAAAAAATAAAAATAAATAAATTAA","CCAGGCGCAATGGCTCACGCCTGTAATCCCAACACTTTGAGAGGCCGAGGCAAGAGGATTGCTTGAGGCCAGGAGTCCGAGACCAGCCTGGGCAACACAGCGAGGCCTCATTCTCTACAAAAAATAAATATATAAATAAATAAATAAATAAGAAGAAGAAAA"
"chr1","11978983","11979257","chr10","96412023","96412287","94","84433040","CCTGTAACCCGGCATTTTGGGAAGCCGAGGCAGGAGAAGATTGCTTGACTCCAGGAGTCCAGGAGTTCAGGACACCAGCCTGGGTAACAAAGTGAAATGCTTCCCCATGTCTACAAAAGATAAATACTAGGCATGGCTGCAGCATCTGTGGTCAGCTACTTGGGAGGCTGAGTGAGGTGGGAGGATTACTTGAGCCCAGGAGTTCGAGGCTGCAGTGAGCCGTGATTGCACCACTGCACTCCAGCTTGAGTGAGAGTGAGACTCTGGCTCAAAGA","CTTTGAGAGGAAGACGTAGGAGGATTGCTTGAGCCCAGCAGTTTGAGACTAGCCTGGGCAACATAGGAAGACTCCCATCTCTACACACACACACACACACACACACACACAATTATCCAGGGTGGTGGTGCATGCCTGTGGTCCCAGCTACTTGGGAGGTTGAGGTGGGAGGATTGCTTGAGCCCAGGAGGTCCAGGCTGTAGTGAGCCATGATCATACCGCTGCACTCCAGCCTGGGCAACAGAGTGAGACCCTGTCTCAAAAA"
"chr1","11992813","11992979","chr2A","60286019","60286209","69","48293206","AAAAAAAAAAAAGTCAGGCTTGATGGCATGCACCTGCAGTCCCAGCTGCTCAGGAGGCTCAGGTGGGAGGATCACCTGAGCCCAGGGAGGTCGAGGCTGTAATGAGCTTCCAGCCTGGGTGACAGAGAACCCTGTCTCAAAAATCAAATAAATAAATAAAATATAAA","AAAATTAGCCAGGTGTGATGGCACCTGTAGTCCTAGCTACTTGGGAGGCTAAGGTGGGAAGAGGGCTTGAGCCCAAGATTGTGAGGCTGTGGTGAGTCATGACTGTGCCATTGCCCTCTGGCCTGGGTGACAGAGTGAGAAGCTGTCTCAAATAAATAAATAAATAAATAAATAAATAAAAATAAACAAAA"
"chr1","11994966","11995297","chr14","31798968","31799292","95","19804002","GGGTGCAGTGGTTCACACCTGTAATCTCAGCACTGGGAGGCTGAGGCAGGAGAATTGCTTGAGCCCAGGAGTTTGAGACCAGCCTGAGCAACATGGCAAGACCCCATCTCTACCAAAAATTTAAAAATTAGCTGGGCGTGGTCGCAGCTATAGTCTATATATAGGTGGTACCTATAGTCTAAGCTACTTGGGAGGCTGAGGTGGGAGGATCATTGAGCCCTGATGGTCGAGGCTGCAGTGAGCTATATTCATGCCACACGCTACTGCACTCCAGCTTGGGCGAGAAAGCAAAATCCCATATCAAAAAAAACAAACAACAACAACAACAACAA","GGCTGGGCACAGTAGCTTACACCTGTAATCCCAGTACTTTGGAAGGCTGAAGTGGGAGGATCCCTTGAGGCCAGGAGTTTGAGACCAGCCTGGGCAACATAGTGAGACCCTGTCTCTACAACAAACAAACAAACAAACAAACAAAACTTAGCCAGTTGTGGTGGCACATCCTATAGTCCCAGCTACTCAGGAGGCTGAGGAGGGAGGATCTCTTGAGCCCAGGAGTTTGAGGCTGCAGTGAGCTATGATCATGACACTGCACTCCAGCCTGGATAACACAGCAAAATCCTGTCTCAAAAAAAAAAAAAAAAAAAAAAAAAAAGAA"
"chr1","12018278","12018483","chr14","51003183","51003398","80","38984905","CCAGCCTGGGCAACATGGCAAAACCCCGTCTCTACAAAAAATGAGCCAGGCACGTACCTGTAGTCCAGCTACTCGGGAGGCTGAGATGGGAGGATCACCTGAGTCCAAGAGGCTGAGGCTGTGGTGAGCTTTGATTGCACCACTGCACTCCACCCTGACTGAGAGACCCTGTCTCAATAAATAAATTAATTTAAAAAAGAAAGAAA","AGCCTGGGCAAGATAGTGAGACCTCATCTCTTAAAATAAATAAATAAATAAATAAATAGCAGGATGTGGTGGCGTGCATCTGTAGTCCCAGCTACTCAGGAGGCTGAGATGGGAGGATTACTTGAGCTCAGGAGGTCGAGGCTGCAGTGAGCTATGATCACGCCACTGTACTCCAGCCTGGGTGAGAGTGATACCCTGTCTCTAACAAAAAAAAAA"
"chr1","12051709","12051860","chr9","47045786","47045941","73","34994077","GTGCTCACCTGCGGTCCCAGCTGCCTGGGAGGCTGAGGCGGGAGAATTGCTTAAACCCAGGAAATCGAGGCTGCAGTGAGCTAGGATTGCACCACTGCACTCCAGGCTGGGTGACAGAGTGAGACTCTGTTTAAAAACAAAAAAAAAAAAAA","GCTGGGCGCAGCAGCTCACACCTGTAATCCCAGTGCTTTGGAGGTCCAAGGTAGGAGGATTGCTTAAGACTAGGTGTTCAAGACCAGTCTTGGCAACATAGTGAGAACTCATCTCTACAATAAATAAATAAATAAATAAATAAATGAAAATAAAAA"
"chr1","12053254","12053421","chr9","47045786","47045941","64","34992532","GCCGGGCGTCATGGCGCACACCTGCGGTCCAAGCTACTCAGGAGGCTGAGGTGGGAAGATTGCTTGAGCCCAGGAGTTCAAGGCTGTAGTGAGCCATGATTATGCCACTGCACTCCAGCCTGAATAACAGTCAGCCTGGCCCTGACTCTAAAAAAAAAGAAAAAGAAA","GCTGGGCGCAGCAGCTCACACCTGTAATCCCAGTGCTTTGGAGGTCCAAGGTAGGAGGATTGCTTAAGACTAGGTGTTCAAGACCAGTCTTGGCAACATAGTGAGAACTCATCTCTACAATAAATAAATAAATAAATAAATAAATGAAAATAAAAA"
"chr1","12092189","12092469","chr4","187957937","187958223","75","175865748","CAGGCACGGTAACTCATGCCTGTAATCCCAACACTTTAGGAGGCTGAAATGGAAGGATCACTTGAGGCCAGGAGTTTGAGACTAGCCTGGGCAACAAGGCAAGACCCCATCTACAACAATAGAAAATTAGCCAGGTGTGATGTCACATTGTACTCCTAGCTACTCAGAAAGGCTGAGGTGGGAGGATCACTTCAGCCCAGGAGTTAGAGGTTGCAGTGGGCTATGATCATGCCACTGCACTCCAGCCTGGGTGACAGAGCAAAACCCTGTCTCTGAAACAA","GGGCACAGTGGCTCATGCCTGATTCCCAGCACTTTGGGAAGTTGAGACAGGCGGATCACTTGAGCCCAAGAGTTCGAGACCAGCCTGGTGTTCTCTAAAACAAACAAACAAACAAACAAACACACGATTAGCTGGGCATGGTGGCTCACACCTGTAGTTCTAGCTACTCAGGAGGCTGAGGTGGGAGGGTAGCTTGAGCCCAGGAGTTCAAGGCTGCAGTGGGCTATGATCATGCCATTGCACTCTAGCCTGGGCAACAGAGTGAGACCCTGTTTCAAAAAAAAAAA"
"chr1","12101144","12101447","chr16","32352979","32353289","67","20251835","GGCCGGCTTGGTGGCTGATGCCTGCAGTCTCAGCACTTAGGGAGGCCAGGCTGGGAGAATCACTTGAGGCCAGGAGTTTGAGACCAGCCTGGGCAACACAGTGAGATCCCCATCTCTACACAAGATAAAATACATTAGCTGGGTGTGGTGGCATGCGCCTGTAGTCCCAGCTACTCAGGAGGCTGAGGTGGGAGGATGGCTTGAGCCCAGGAAGTTGAGGTTACAGTGAGCTGTGATCATGCCACTGCACTCCAGCCTGGGCAACAGAGCAAGACCCTGTTTCAAAAAAAAAAAATGATAAAAA","GGCTGGACACGGTGGCTGCTGCCTGTAATCCCAGCACTTTGGGAGGCCAAGGCAGGAGAATGGCTTGAGCCCAGGAGTTCAAGACCAGCCCGGGCAACAGAGTGAGACCTTGTCTCTACAAAAATAAAAATAGAAATAAAAATAAAAATTAGCCAAGTGTGGTGGCATGCACCTGTGGTCTCAGCTACTCAGGAGACTGAGGTGGGAGGATCCCTTGAGCCCAGGAGGTCGAGGCTGCAGTGAGCTGTGATCATGCCACTACACTCCAGCCTGGGTGACAGAGCTGTCTCAAAAAAATAATAATTAAAAAA"
"chr1","12166293","12166585","chrX","61799705","61800010","94","49633412","GGCCGAGTGCAGTGGCTCACACCTATAATCCCAGCACCTTGGGAGGCCAGAGGCGGGAAGATCACTTGAGGGTGGGAAGAACACGTGAGCTCAGGAGTTCGAGACCAGCCTGGACAACATGGCGAAACCCCATCTCTATAAAGAAATCAGCCTAGCATGGTGGCCCGAGCCTGTAGTCCCAGCTACTCGGGAGGCTGAGGTGGGAGGATCGCTTGAGCGCAGGAGTTGGAGGCTGCAGTGAGCTATGGGTGAAAGAGTGAGACCTTGTCTCAAAAAAAATTAAAAAATAAGAA","GGCCGGGAGCACAGGTTCACACCTATAATCCCAGCATTTTGGGAGGCCGAGGCATGTGGGATTGCTTGAGCTCAAGAGTTTCAGACCAGCCTGGGCAACATAGTGGGAACCCGTCTCTACAAAAAAAAAAAAAAAAAAAAAAAAAAAATTAGCCGAGCCTAGTGGTACATGCCAGTAGTCCCAGCTACTTGGGAGGCTGAGGTGGGAGGATTGCTTGACGCTGCAGTGAGCTGAGATTGTGCCAGTATACTCCAGCTGGGGCAACAGAATGAGACCGTGTTTCAAAAAAAAAAAAAAAAAAAAGAA"
"chr1","12193291","12193596","chr2A","88638728","88639031","79","76445437","GGCTGGATGCAGTGGCTCAAGCCTGTAATCCCAGTGCTTTGGGAGGCCAAGGAGGCTGGAGGATTGCTTGAGGCTAAGAGTTTGAGGTCAGTCTGGGTAACACAGCGAGACTCCATCTCTATAAAAAAATTAAAAAATTATTTGGGTGGGATGGTGCCTATTGTCCCAGCTACTCAGGAGGCTGAGGTGGGAGGATCACATGAGCCCAGGAATTTGAGGCTGCATTGAGCTCTGATCGTGCCACTGCACTCCAGCCTGGGCAATGAGTGAGGTCCTATCTCAAAAACAAAACAAAACCAAACAAAA","GGTGCAGTGGCTCATGCCTGTAATTCCAGCGCTTTGGGAGGCAAAGGTGGGAGGACTGCTTGAGCCCAGGAGTTTGAAACCAGCCTGGGCAACATAGGGAGACTTCATCTGTATAAATAAATAAATAAATAAATAAATAAATAAGCTGGGCATGGTGGCATGCACCTGTGGTCCCAGCTACTTGAGAGGCTAAGGTGGGAGGATCACTTGAGCCCAGGAGGTTGAGGCTGCAATGAGTCATGATCACGCCACCACACTCCAGCCTGAGCTACAGAGTGAGGTCTTGTCTCAAAAAAAAAAAAAA"
"chr1","12212126","12212276","chr18","55799233","55799394","62","43587107","GGTGTGGTGGCTCATCCCTATAATCCCAGCACTTTGGGAAGCCAAGGTGGGAGGATCACTTGAGCCCAGGAGTTTCAGGCTGCATTGAGCTGTGATTGCGCTACTGCCCTCCAGCCTGGGTCACAGAGTGGTACTCAGTCTCAAACAAAAA","GGCTGAGAGAGGTGGCTCATGCTTGTAATCCCAGCACATTGGGAGGCAAAGGTGGGAAGATTGCTTGAGGCCAGGAGTTCAAGACCAGCCTGGGCAACATGAAAACACTTTGTCTCTACAATAAATAAATAAATAAATAAATAAATAAAAGAAACAAGAAAA"
"chr1","12213568","12213858","chr3","56709786","56710088","83","44496218","GGCCAGGCATGATGGCTCACGCCTGTAATCCCAGAACTTTGGGAAGCCGAGGTGGGTGGATCGCTTGAGTTCAGAAGTTCGAGACCATCCTGGACAACATAGCAAGACTCCGTCTCTATGAAAATGAGCTGGGCATGGTGGCATGCGCCTGTGGTCCCAGCTACTCAGGAGGCTAAGGCGGGAAGATTGTGCGAGCCCAGGAAGTCGAGGCTGCAGGGAGCCATGACCTGTGCCACTGTACTCCAGCCTGGGTGACAGGGCGAGACCCTAAAAAAAAAAAAAAAAAAAAAA","GGCCAGGCATGATGGCTCATGCATGTAATCTCAGCAATTCGGGAGGCCCAGGCAGGAAAATTGCTTGAGGCCAGGAGTTCGAGACCAGCCTGGACAAAACAGGGAGACACCTGTCCCTGCAAAAATAAAAATAAAAATAAAAATAAACAGCCAGGGGTGGTAGTCCCAGCTACTGTGGAGGCTGAGGTGAGGGGATTGCTTGAGCCCACCAGGAAGTGAAGGCTACAGTGAGCCATAAACGCACCACTGCACTCCAGCCTGGGTGACAGAGCAAGACCCCATCTCAAAAAAAAAAAGAAAAAA"
"chr1","12218393","12218518","chr9","47045786","47045941","59","34827393","GACTGGGTATGGTGGCTCACACCTGTAATCCCAGCACTTTGGGAGGCCCAAGGTGGGAGGATGGCTTGAGGCCAGGAGCTTAATACCATCCTGGGCAACATAGGGAGACCTCGTCTCTACCAAAAA","GCTGGGCGCAGCAGCTCACACCTGTAATCCCAGTGCTTTGGAGGTCCAAGGTAGGAGGATTGCTTAAGACTAGGTGTTCAAGACCAGTCTTGGCAACATAGTGAGAACTCATCTCTACAATAAATAAATAAATAAATAAATAAATGAAAATAAAAA"
"chr1","12227616","12227899","chr1","88859712","88859991","82","76632096","GGCCTGGCACCGTGGCTCACACCAGTAATCCTAGCACTTTGGGAGGCCAAGGCAGTGGGGGGGATTTTTTGAGGCCAGGAATTCAAGACCAGCCTGTGCAACATAAGGAGACCCCAATCTCTACAAAAAATTATAAATGAAAAAATTAGCTGGGCACGGTGGCACATGCCTGTACTCCCAACTACTGGGAGGAGGATTGCTTGAGCCCATGAGTTCAAGGTTACAGTGAGCAATGATCATGCCTGTGCACTCCAACCTGCGCAACAGAGACCCTGTCTCAAAAA","CCAGGCACAGTGGCTCACACCTGTAATCCCAGCACTTTGGGAGGCCAAGGCAGGAGGATTGCTTGAATCCAGGAGTTTGAGACCAGCCTGGGCAGCATAGTGAGACTTGGCCTCTACAAAAAAAAAAAAAAAAAAAAAAAAAAGTTACCTGGGAAGTCTCAGCTACTTGGAAGGCTGAGGTCGGAAGGTTGCTTGAGTACAGGAGGTCAAGGCTGCAGTGAGCTATGATTGTACCACTGCACTCCAGCGTGGGCAACAGAGTGAGACCTTATCTCAAAAA"
"chr1","12237537","12237839","chr1","49763974","49764279","65","37526437","GGTCGGGTGTGGTGCCTCACGCCTGTAATCCTAGCACTTCGGGAGGCCAAGGCCAGAGGATCACCTGAGGCCAGAAGTTCAAGACTAGCCTGGGCAACATGGTGAGATCCCTTCTCTAAAAAAAAAAATAAATAAATAAAATTAGCTGGGTGTTGTGGTGCACGCCTGTGGTTCCAGCTACTTGGGAGGCCCAGGTGGGAGGATCGCTTGAGCCCAGGAGGTCGAGGCTGCATTGAGCTATGTTCTTGTCACTGCACTGTAGCCTGGGCAACAGAGCAAGACCCTGTTTCAAAAACAAAAAAA","GGCTAGGCCTGGTAGCTCAAGTCTGTAATCCCAGCACTTTGGGAAGTCAGGGCAGGAGGATCCCTTGAGTCCAGGAGTTCAAGACCAGCCTGGGCAACAAAGTGAGACCCTATCTGTATAATAAAATAAAATAAAATAAAATAAATTAGCCAGGTGTGGTGGTGTGTGTCTGTGGTCCAAGGTACTTGGGAGGCTGAGGTGGGAGAATGGCTTGAGCCCAAGAGTTTGAGGCTGCAGTAAGCCGGGTTTGCTACTGTACTCTAGTCTGGGCAACAGAGCCAGACTCTGTCTCAAAAAACAAAAAAA"
"chr1","12243510","12243608","chr20","87144","87254","57","12156366","GACTGGACTTGGTGGCTTTCACCTGGAATCCCAGCACTTTGGGAGGCTGAGGCAGGAGGATCACTTGAGGCCAGGAGTTCAAGACCAGCCTGGGCAACA","CCTGGGCAACATAGTGAGACTACATCTCTACACTCACGCACACACACACACACACACACACACCCCCCAAATTAGCCAGGCATGCTGATGTGCACCCATAGTCTCAGCAAC"
"chr1","12289672","12289953","chr8","25360790","25361095","78","13071118","GGCTGGGCACGGTGGCTCACGCCTGTAATCCTAGCACTTTGGGAGGCTGAGGTCAGGAGTTTGAGACAAGCCTGGGCAACATAGTGAGACCTCATCTCTACAAAAATAGTAAAAATTAACCAGTTGTGATGGCCAGTGCCTGTAGTCCCAGCGACTCAGGAGGCTGAGGTGGTTGGATTGCTTGAGCCTGGAAGGTCAAGGCTGCAGTGAGCCATGATTGTGCCACTGCACTGTAGCCTGGGCGACAGAGTGAGACCCTGTCTCAAAAAATAAAAAAAAAAA","GGCTGGGAGCAGTGGCTCATACCTGTAAGCCCAGCACTTTGGGAGGCTGAGGTGGGAGGATTGCTGAAGCCCAGGAGTTTGAGACCAACCTGGGCAATGTAGGGAGACCCCGTCTCTACTAAATAAATAAATAAATAAATAAATAAAGTCGGGCATGGTGGCATGTGCCCTGTAGTCCCAGCTTCTTGGGAGGCTGAGGTGGGAGGATTGCTTGGGCCCAGGAATCAAGGCTGCAGTGAGCTGTGATTGTGCCACTGTACTACAGCCTGGGTGACAGTGCAAGACTGTCTCAAAAGAAAAACAAAA"
"chr1","12291352","12291624","chr12","99989922","99990215","84","87698570","GGTGCGGTGGGTCATGCCTGTAATCTAAGCTCTTTGGGAGGCCAAGGCAGATGGATTGCTTAAAGCCAGGAGTTCGAGACCACCCTTGGCAACATAGACACTGTCTCTATAGAAGAAAAAAGCCGTCTGTGTGTGGTGGTATGCAACTGTAGTTCTAGCTACTTGAGAGGCTGAGGTGGGAGGATCCCTTAATCCCAGGAGTTGGAGGCTGCAGTGAGCCATGACTGTGCTACTGCACTCCAGCCTGGGTGATGGAGGGGGGCCTTGTCTCAA","GGCTAGGCATGGTGGCTCATGCCTGTAATCCCAACGCTTTTGGAGGCCAAGGTGGGAGGATCGCTCGAGGCCAGAAGTTCAAGACCAATAGGGGCAATGTATAGAGACCTAGTCTCTACAAAAATAAAATAAAATAAAATAAAATTTAGCCAGATATGGTGGTGTAAAACTGTAGTTCCAGCTACTTGAGAAGCTGAGGTGAAAGGATTGCTTGAGCCCAGGAATTCGAGGCTGCAGTGAGCTGTGATCTCGGCACTGCACTCCAGCCTGGATAACAGAGCGAGACCCTGTCTC"
"chr1","12312476","12312742","chr17","56439745","56440021","69","44127269","GGCTAGGCGCAGTGGCTCAGGCCTGTAGTCCCAGCACTTTAGGAAGCCAAGGAAGGAGGATTGCTTGAGGCCAGGAATTCCAGACTGGCCTGGGCAACATAGTGAGAGACCCTGTCTCTACAAAAAATTAAAAAACTAGCTGCGCATGGTGGTGCATGCCTGTAGTCCCAGCTACTCAAGGCGTTAAGGTGAGAGAATCACTTGAACCAGGAGATTGAGGCTGCAGTGAGCCATGATCACACCACTGCACTCCAGCCTAGGTGACAG","GCCAGGCGCAGTGGCTCACACTTGTAATCCCAGCACTTTGGGAGGCTAAGGCAAGCAGATTGCTTGAGTCCAGGAGTTCAAAACAAGCCTGGGCAACATCATGAGACCTTGTCTCTACTGGTAAAAAAAAAAAAAAAAAAAAAAAAAAATTAGCTGTGCATAGTGGTGCATACCTGTAGTCCCAACTACTTGGGAGACTGAGGTGGAAGGATTACTTGAACCTGGGAGATTGAGGCTGCAGTGAGCTATGATCACGCCACTGCCCTCTAGCCTGGGC"
"chr1","12323080","12323364","chr18","16899958","16900260","75","4576878","GTGGCTCACACCAGTAATCCCAATACTTTGGGAGGCTAAGGCAGGGGGACTACTCGAGACCAGGAACTCAAGACCAGCCTGGGCAAAATAGCAAGACCCCGTCTCTAAAAAAAAAAGGTAAAAATTAGTGAGGCATGATGGCACACACCTATAGTCCCTCCCAGCTACTCAGGAGGCTGAGGAGTGAAGATAGCTTGGGCCCAGGAGTTTGAGGCTGCAATAAGCTATGATCACACCACTGCTCTCCAACCTGGGTGACAGAGCAAGACCCTGTCTAAAAATAAA","GTCAGGCGCGGTGGCTCACACCTGTAATCCCAGCACTTTGGGAAGCCGAGGCAGACGGATCACCTGAGGCCAGGAGTTCAAGACCAACCCCGGGCAACAAAGCAAGACCCTGTCTCTATAAAAAAAAAAAAAAAAAAAAAAAAATTAGCCGAGCATGATGGCAAGTGCCTGTAGTCCCAGCTACCTAGGATGTTGAGGTAGGAGGATTGCTTGAGCCCAAGAGGTTGAGGCTGCAGTGAGCCATGATCTCACCACTGCACTCCAGCCTGGGTGACAGAGCGAGACCCTGTCTCAAAAAATAAA"
"chr1","12326322","12326634","chr14","31798968","31799292","74","19472646","GGCCGAGCACAGTGGCTAATGCTTATAAGCCCAATGCTTTGGGAGGTTTAGGCAAGGGATCACTTTAGGTCAGGAATTTGAGACCAGCCTGGGCAACATAGCAAGACCTGTCTCTACAAAAAATTTAAAAATTAGCCACGTATGGTGGTGCATCCTGTAGTCCCAGCTACTCAGGAGGCTTAGGTGGGAGGATCATTTGAGCCTAGGAGTTTGAGGCTAGAGTGAGCCATGATCATTGTGCCACCACTACACTCCAGCCTGGGTAACAGAGCAAAACCCAGTATCTAAAATTAAAAAAAAAAAAAAAAAAAAA","GGCTGGGCACAGTAGCTTACACCTGTAATCCCAGTACTTTGGAAGGCTGAAGTGGGAGGATCCCTTGAGGCCAGGAGTTTGAGACCAGCCTGGGCAACATAGTGAGACCCTGTCTCTACAACAAACAAACAAACAAACAAACAAAACTTAGCCAGTTGTGGTGGCACATCCTATAGTCCCAGCTACTCAGGAGGCTGAGGAGGGAGGATCTCTTGAGCCCAGGAGTTTGAGGCTGCAGTGAGCTATGATCATGACACTGCACTCCAGCCTGGATAACACAGCAAAATCCTGTCTCAAAAAAAAAAAAAAAAAAAAAAAAAAAGAA"
"chr1","12334485","12334787","chr8","25360790","25361095","85","13026305","GGCCGTGCACATTGGCTCATGCCTGTTAACCCAGTTCTTCGAGAAGCCAAGATGGGAAGCTCATTTGAGGCCAGAAGTTCCAGACCAGCCTAGGCAAAATTGTGAGACCTTGTCTCTACAAAAATAAACAATTAGCTGGGCATAGTGGCGTGTGCCTGTAGTCCCAGCTACTCAGGAGGCTGAGGTGGAAGGATTACTTGAGTGCAGGAGTTCAAAGTTACAGTGAGCTATGATTGTGCCCGTGTACTCCAGCCTTGGAGACAGAGCAAGACCCTGTCTCTAAGAAACCAACCAAACAAAAAA","GGCTGGGAGCAGTGGCTCATACCTGTAAGCCCAGCACTTTGGGAGGCTGAGGTGGGAGGATTGCTGAAGCCCAGGAGTTTGAGACCAACCTGGGCAATGTAGGGAGACCCCGTCTCTACTAAATAAATAAATAAATAAATAAATAAAGTCGGGCATGGTGGCATGTGCCCTGTAGTCCCAGCTTCTTGGGAGGCTGAGGTGGGAGGATTGCTTGGGCCCAGGAATCAAGGCTGCAGTGAGCTGTGATTGTGCCACTGTACTACAGCCTGGGTGACAGTGCAAGACTGTCTCAAAAGAAAAACAAAA"
"chr1","12354382","12354547","chr9","47045786","47045941","67","34691404","TTAGCTAGAGGTGGCGGCAGTACATGCCTGTAGTCCCAGCTTCTCAGGAGGCTGAGGCGGGAAGATTACTTGAGTCTAGAAGTTCGAGGCTTCAGTGAGCTATGTTCACGCTACTGCCCACCAGCCTGAGCAACAAAGTAAGACCCTGTCTCTTAAAAAAAAAGAA","GCTGGGCGCAGCAGCTCACACCTGTAATCCCAGTGCTTTGGAGGTCCAAGGTAGGAGGATTGCTTAAGACTAGGTGTTCAAGACCAGTCTTGGCAACATAGTGAGAACTCATCTCTACAATAAATAAATAAATAAATAAATAAATGAAAATAAAAA"
"chr1","12515296","12515617","chr16","9702460","9702783","75","2812836","GACCGGGCACAGTGGTTCATGCCTATAATCCCAGCACTTTGGGAAGCTGAGGCAGGTGGATCAGTTGAGTCCAGGAGTTTGAGACCAGCCTGGGCAACACAGTAAGACCCGATCTCTACTCAAAATAAAAAAAATTAGCCAGGCAAGGTGGCACACGCCTATAGCCCCAGCTCCATGGGAAGAAGAGGTGGGAGGATCGCTTGAGCCCAGGAGTTCAAGGTTGCGGTGAGCCAAGACTGAGCCACTGCCCTCCAGCCTGGGCAACAGAGTGAGACCCTGTCTCAAAAGAAAAAAAAAAAAGGTTACTCTGAAAAAAAGAAAA","CCGGGCATGATGGCTCATGCCAGTAATCCTAGCACTTTGGGAAGCTGAGGTGGAAGGATCGCTTGAGGCCAGGAGTTCGAAACCAGCCCAGTCAACATAGTGAAACCCCATCTCTACAAAAGAAAAATTAAAAAATTAGCTGGAATGGTGGCACATGCCTGTAGTCCTAGCTACTTGGGAGGCTGAGGCAGGAGAACTGTTTGAGCTCAGAAGTTCAAGGCTGCAGTGAGCCATGACTGTGCCACTGCACTCTAGCCTGGGTGACAGAGTGAGACCCTGTCTCAATAAATAAATAAATAAATAAATAAATAAGAAAACTAAAAA"
"chr1","12516373","12516652","chr19","13342110","13342403","74","825737","GGCTCATGTCTATAATCCCAGCTCTTTGGGAGGCCGAGGCAGGAGAATTACTTGAAGCTAGGAATTCGAGACCAGCCTTGGCAAAAAGCGAGAGACCTGCCTCTACAAAAAAGAAAATAAATTAGCTGGGCATGGTGGCATGTGCCGGTGGTCCCAGATACTTGGGAGGCTGAGGCAGGAGGATGGCTTGAGGCCAGGAGTTCAAGACTACAGGGAGCTATGATCATACCGCTGCACTCCAGCCTGGGTGACAAAGCAAGACCTTGTCTCTTAAACAAAA","TCATGCCTGTAATCCCAGCACTTTGGGAAGCCAGGGCAGGAGGATCACTTGAGACCAGGAGTTTGAGACCAGCCTGGGCAACATAGCCAGACCCCCATCTCAACAACAACATCAACAACAACAACAACAAATTAGCTGGGTGTGGTGGTGCCTGTAGTCCCAGCTACTTGGGAGGCTAAGCTGGGAGGATCGCTTGAGCCCAGGAGCTCCAGGCTGCAGAGAGCTATGATCATATCACTGCACTCCAGCCTGAGTGACAGAGCAAGAACCTGCCTCTAAAAACAATAAACAAAA"
"chr1","12535826","12535936","chr20","87144","87254","63","12448682","GCCAAGCACGGAGGCTTACACCTGTTATCCTAGCACTTTGGGAGGATTGCTTGAGACCAGGAGCTCAAGACCAGCCTGGGTAACATAGGGAGACCTTCTCTCTACAAATAA","CCTGGGCAACATAGTGAGACTACATCTCTACACTCACGCACACACACACACACACACACACACCCCCCAAATTAGCCAGGCATGCTGATGTGCACCCATAGTCTCAGCAAC"
"chr1","12539620","12539921","chr16","9702460","9702783","82","2837160","CCAGGCATGGTGACTCATGTCTGTAAAACTAGCACTTTGAGAGACCAAAGTGGGAGGATTGCTTGAGGTCAGGAGTTCGAGACCAGCCTGGCCAACATAGTGAGATCCCACCTCTATCAAAAAATATAAAAATTAGCTGGATTAATGGGGCACACCTGTAGTCCCAGCCACTCAGGAGGCTGAGGCAGGAAGATCACTTGAGTCCAGGAGTTCAAGGCTGCACTGAGTCACTTGCACTCTAGCCTGGGCCACAGAGCAAGACCCTCTCTCAAAAAACCAAACCAAACCAACCAAACAAAAAA","CCGGGCATGATGGCTCATGCCAGTAATCCTAGCACTTTGGGAAGCTGAGGTGGAAGGATCGCTTGAGGCCAGGAGTTCGAAACCAGCCCAGTCAACATAGTGAAACCCCATCTCTACAAAAGAAAAATTAAAAAATTAGCTGGAATGGTGGCACATGCCTGTAGTCCTAGCTACTTGGGAGGCTGAGGCAGGAGAACTGTTTGAGCTCAGAAGTTCAAGGCTGCAGTGAGCCATGACTGTGCCACTGCACTCTAGCCTGGGTGACAGAGTGAGACCCTGTCTCAATAAATAAATAAATAAATAAATAAATAAGAAAACTAAAAA"
"chr1","12544221","12544496","chr15","26873577","26873832","86","14329356","CCTGGTGCAGTGGCTCATGCCTGTAATACCTGCACTTTGGGAGGCTGAGGCAGGAGGATCACTTGAGCCCAGGAGTTTAAGACAAGTCTGGTCAACATAGGGAGATAGGGAGGCCCTTTTTCTACCAAAAAAAAATTAAAATTAGCCGGGCATGGTGGCACATGCGGGCAGTTCCACCCGTGGTCCCACTGAGATGGGCAGATTGCACTAAGCCATGATCACACCACTGGACTCCAATCTGGGTGCCAGAGCGAGACCTTGTCTCAAAGAAAAAAA","GGTCAGGCACAGTGGCTCACTCCTGTAATCCCAGCACTTTGGGAGGCCAAAGCAGGAGGATTATTTGAGCCCAGGAGTTCAAGGCCAGCCTGGCCAACATAGTGAGATCTTGTCTCTAAATAAATAAATAAATAAATAAATAAATAAATGAGGTGGGAGGATTGCTTGAGTCCCAGGAGGTTGAGGCTGCAGTGAGCCAGGATCATACCACTGCACTTCCACCTGGGTGTCAGAGCAAGACCTTGTCTTAAAAAAA"
"chr1","12550198","12550430","chr14","51003183","51003398","58","38452985","AGGAGTTTAAGACCAGCCTGGGCAACATAGTGGGACGTCTCTACAAAAAAAAAAAAAAAATTAAAAATTAGCAGGGCGTAGGGATGAGCATCTGTAGTCCCTGCTACTCAGGAGGCTGAGGTGGGAAGATCGTTTGAGCCCGGGAGGTCAAGGCTGCAGTGAGCTATGATCGCACCACTGCACTCCAGCCTGGATGACAAGGCAAGACCCTGTCTCAAAAAAACAAAAAAAAA","AGCCTGGGCAAGATAGTGAGACCTCATCTCTTAAAATAAATAAATAAATAAATAAATAGCAGGATGTGGTGGCGTGCATCTGTAGTCCCAGCTACTCAGGAGGCTGAGATGGGAGGATTACTTGAGCTCAGGAGGTCGAGGCTGCAGTGAGCTATGATCACGCCACTGTACTCCAGCCTGGGTGAGAGTGATACCCTGTCTCTAACAAAAAAAAAA"
"chr1","12565678","12565917","chr10","96412023","96412287","71","83846345","CTTTGGGAAGTCAAGGCAGAAGGGTTGCTTAAGCCAGGAATTCCAGACTAGCCTGGGCAACATAGCGAGACCCTATCTTTACAAAAAAATGATGAAGTGAGCCAGGCGTGGTGGCACATGCCTGTAATCTCAGCTACTCGAGAGGCTGAGGTGGGAGGATTGCTTGAGCCTGGGAGGTGGAGGCTGCAGTGGCCATGATCGGGCCACTGCACTCCAGCCTGGGCAACAGAGTGAGGACCT","CTTTGAGAGGAAGACGTAGGAGGATTGCTTGAGCCCAGCAGTTTGAGACTAGCCTGGGCAACATAGGAAGACTCCCATCTCTACACACACACACACACACACACACACACAATTATCCAGGGTGGTGGTGCATGCCTGTGGTCCCAGCTACTTGGGAGGTTGAGGTGGGAGGATTGCTTGAGCCCAGGAGGTCCAGGCTGTAGTGAGCCATGATCATACCGCTGCACTCCAGCCTGGGCAACAGAGTGAGACCCTGTCTCAAAAA"
"chr1","12589702","12589818","chr18","55799233","55799394","66","43209531","GGCTGGATATGTTGGCTCACGCCTATATTCCCAGCACTTTGGGAGGCCGAGGTGGGGGAATTACTTGAGGCCAGGAGTTCAAGATCAGCCTGGGCAACATAGCAAGACTCTGTCTCT","GGCTGAGAGAGGTGGCTCATGCTTGTAATCCCAGCACATTGGGAGGCAAAGGTGGGAAGATTGCTTGAGGCCAGGAGTTCAAGACCAGCCTGGGCAACATGAAAACACTTTGTCTCTACAATAAATAAATAAATAAATAAATAAATAAAAGAAACAAGAAAA"
"chr1","12593376","12593503","chr5","32595015","32595178","56","20001639","GGCCAGGTGTGGTACCTCACTCCTGTAATCCCAGCACTTTGGGAGACTGAGGCAGGAGGATCACTTGAAGCCAGGAGTTCAAGACCAGCCTGGGCAACAATGTGATACCCCCGTCTCTACAAATAATA","GGCCGGGTGTGGTCCCTCATGCCTGTAATCCCAACACTTTGGGAGGCTGAGATAGGAGGACTGCTTGAGGCCAGGAGTTCAAGACCAGCCTGGTCAACATAGTGAGACCCCATCTCTATAAAATAATAATAATAATAATAATAATAATAATAAATAAATAAATA"
"chr1","12647091","12647398","chr9","68878569","68878883","68","56231478","GGCCGTGCACAGTGGTTCATGCCTGTAATCCTAGCACTTTGGGAGGCCAAGGCAGGAGGATTGCTTGAATCCAGGAGTTTAAGATCAGCCTTGGCAACGTAGCAAGACCCCATCTGTACAAAATATCAAAAAATTAGCCAGGCGTGATGTGAAGGTGCACGCCTGTGGTCCGAGCTACATGGGAGGCTGAGGTGGGAGGATCACTTGAACCCAGGAGGTGGAGGCTGCAGTGAGCCGTGTTCACGCCACTGCACTCCTGCCTGGGTGACAGAGTGAGACCCTGTCTCAGAAAAAAAAAAAAAAAAAAA","GGCTGGGCACGGCAGCTCATGTCTGTAATCCCAGCACTTTGGGAGGCCAAGGTGGGAGGATTGCTTGAGTCCAGGAGTTCAAGACCAGCCTGGGCAACATAGTGAAACCCCAGTCTCTACAAATAAATAAATAAATAAATAAATAATTAGCTGGGCATGTTGATGCATGCCTGTAGTCCTAGCTACTCGGGGGGTGAGGTGAGAGGATTGCTTGAGTCCAGAAGGTGGAGGCTGCAGTGAGCTATGATCACACCACTGCACTCCAGCCTGGAAGACAGGGTGAGACGCTGTCTTTAAAAAAAAAAAAAGAAAAGA"
"chr1","12753783","12753899","chr8","58489091","58489211","63","45735308","GGCTGGGTGTGGTGACTCATGCCAGTAATCCCAGCACTTTGAGAGTCTGAGGCAGGAGGACTGCTTGAGGAAAGGAGTTCAAGACCAGCCTAGGCGACACAGCAAGAACTTATCTCT","TTGAGACCAGGAGTTTGAGACCAGCTTGGACAACATAGTGAGACCCTGTCTAAAAGAAAGAAAGAAAGAAAAGAAAGAAAGAAAGATGTAGCCAAGTGTGGTGGTGCACATCTGTGTCTCA"
"chr1","12829424","12829708","chr1","47533839","47534134","81","34704415","GGCTGGGGCGGAGGCTCACACCTATAATCCCACTATGTTGGGAGGCCAAGAGGGGTAGATTGCTTGAGACTAGGAGTTCAAGACCAGCTTGGACAACATAGCGAAATCCACTGTCTTTACAAAAAGTCAAAAAATAAAAGATGAGCTGGGTGTGGTGATGCATAACTGTGGTCCCAGCTACTTGAGAGGCTGAGGAGGAAGAATCCTTTGAGCTGGGAGGTCAAGGCTGCACTGAGCTGAGATCCCACCACTACACTCCAGGCTGGGTGACAGCAAGACCCTGTC","GGCTGGGCACGGTAGCTCACACCTGCAATCCCACCACTTTGGGAGGCTGAGGTGGGTGGATTGCTTGAGCCCAGGAGTTCTAGACCAGCCTGGGTGATACAGGCAGACCCTATCTCTACCAAAAAAAAAAAAAAAAAAAAAAAAAAAGGCTGGGCATGGTGGCATGTGCCTGTGGGCTCAGCTACTTAGGAGGCTGAGGTGGGAGGATCAGTTGAGCCCAGGAGGAGTTGAGGCTGCAGTGAGCCTAGATCCTGCCACTGCACTCCAATCTGGGCAACAGAGCGAGACCCTGTCTC"
"chr1","12841683","12841825","chr18","55799233","55799394","47","42957550","GCAGAGGCTCATGCCTGCAATCCCAGCACTTTGGGAGGCCAAAGTGGGTGGATTGTTTGAGTCTAGGAGTTCAAGACCAGCCTGGACAACATAGTGAAACCCACTGTCTTTACAAAAAGTCAAAAAATAAAAGATTAGCTGGG","GGCTGAGAGAGGTGGCTCATGCTTGTAATCCCAGCACATTGGGAGGCAAAGGTGGGAAGATTGCTTGAGGCCAGGAGTTCAAGACCAGCCTGGGCAACATGAAAACACTTTGTCTCTACAATAAATAAATAAATAAATAAATAAATAAAAGAAACAAGAAAA"
"chr1","12884029","12884315","chr3","83975049","83975347","82","71091020","GGCTGGGGTGGAGGCTCACACCTATAATCCCAGTATGTTGGGAGGCCAAGAGGGGTAGATTGCTTGAGACTAGGAGTTCAAGACCAGCTTGGACAACATAGCGAAATCCACTGTCTTTACAAAAAGTCAAAAAATAAAAGATGAGCTGGGTGTGGTGATGCATAACTGTGGTCCGAGCTACTTGGGAGGCTGAGGAGGAAGAATCCTTTGAGCTGGGAGGTCAAGGCTGCACTGAGCTGAGATCCCACCACTACACTCCAGGCTGGGTGACACAGCAAGACTCTGTC","GGCTGGGTGCAGTGGCTCATGGCTGTAATCCCAGGACTTTGGGAGGCTGAGGCAGGAGAATCACTTGAGGCCAGGAGTTTGAGACCAACCTGGGCAACAAAGTGAGGCATGTCTCTACAAAAACAAAACAAAACAAAACAAAACAATTAGCTGTGTGTGGTGATGCCTGCCTGTCGTCCCAGCTACTCGGGAGGCTGTGGTGGGAGGATCTCTTGAGCCTGGGAGGTTGAGGCTGCAGTGAGCTGTGATTGCCCACTGTACTCTAGCATGGGTTACAGAGCAAGACTCTGTCTCAAAAA"
"chr1","12896169","12896310","chr9","47045786","47045941","51","34149617","GGATTACGCCTGTAATCCCAGTACTTTGGGAGGCCAAGGCGGGTGGAATGTTTGAGTCTAGGAGTTCAAGACCAGCCTGGACAACATAGTGAAACCCACTGTCTTTACAAAAAGTCAAAAAATAAAAGATTAGCTGGGCATG","GCTGGGCGCAGCAGCTCACACCTGTAATCCCAGTGCTTTGGAGGTCCAAGGTAGGAGGATTGCTTAAGACTAGGTGTTCAAGACCAGTCTTGGCAACATAGTGAGAACTCATCTCTACAATAAATAAATAAATAAATAAATAAATGAAAATAAAAA"
"chr1","12943187","12943473","chr8","15910614","15910909","82","2967427","GGCAGGGGTGGAGGCTCACACCTATAATCCCAGTATGTTGGGAGGCCAACAGGGGTAGATTGCTTGAGACTAGGAGTTCAAGACCAGCTTGGACAACATAGCGAAATCCACTGTCTTTACAAAAAGTCAAAAAATAAAAGATGAGCTGGGTGTGGTGATGCATAACTGTGGTCCCAGCTACTTGGGAGGCTGAGGAGGAAGAATCCTTTGAGCTGGGAGGTCAAGGCTGCACTGAGCTGAGATCCCACCACTACACTCCAGGCTGAGTGACAGAGCAAGACCCTGTC","GGCCAGGCGAAGTGGCTCACACCTGTAATCCCAGCACTTTGGGAGGCCAAGGCAGGAGGATCATTTGAAGCCAGGAGTTCAAGGCCAGCCAGAGAAACATAGTGAGAACCTGTCTTTACAAAAATTAAAATTAAAATTAAAATTAGCCAGGAGTGGTGGTGCATGCCTGCAGTCCCAGCAGCTCAGGAGGCTGAGGTGGGATGATTGCTTGCACCAGGAGTTCGAGGCTGCAGTGAGCTGTGATCGTGCCACTGCACTCCAGCCCCTGGGTGACAAAGCAAGATCCTCTAAAAAAA"
"chr1","13054294","13054580","chr3","83975049","83975347","79","70920755","GGCTGGGGCAGAGGCTCACACCTATAATCCCAGTATGTTGGGAGGCCAAGAGGGGTAGATTGCTTGAGACTAGGAGTTCAAGACCAGCTTGGACAACATAGCGAAATCCACTGTCTTTACAAAAAGTCAAAACATAAAAGATGAGCTGGGTGTGGTGATGCATAACTGTGGTCCCAGCTACTTGGGAGGCTGAGGGGGAAGAATCCTTTGAGCTGGGAGGTCAAGGCTGCACTGAGCTGAGATCCCACCACTACACTCCAGGCTGGGTGACAGAGCAAGACCCTGTC","GGCTGGGTGCAGTGGCTCATGGCTGTAATCCCAGGACTTTGGGAGGCTGAGGCAGGAGAATCACTTGAGGCCAGGAGTTTGAGACCAACCTGGGCAACAAAGTGAGGCATGTCTCTACAAAAACAAAACAAAACAAAACAAAACAATTAGCTGTGTGTGGTGATGCCTGCCTGTCGTCCCAGCTACTCGGGAGGCTGTGGTGGGAGGATCTCTTGAGCCTGGGAGGTTGAGGCTGCAGTGAGCTGTGATTGCCCACTGTACTCTAGCATGGGTTACAGAGCAAGACTCTGTCTCAAAAA"
"chr1","13105989","13106131","chr18","55799233","55799394","47","42693244","GCAGAGGCTCATGCCTGCAATCCCAGCACTTTGGGAGGCCAAAGTGGGTGGATTGTTTGAGTCTAGGAGTTCAAGACCAGCCTGGACAACATAGTGAAACCCACTGTCTTTACAAAAAGTCAAAAAATAAAAGATTAGCTGGG","GGCTGAGAGAGGTGGCTCATGCTTGTAATCCCAGCACATTGGGAGGCAAAGGTGGGAAGATTGCTTGAGGCCAGGAGTTCAAGACCAGCCTGGGCAACATGAAAACACTTTGTCTCTACAATAAATAAATAAATAAATAAATAAATAAAAGAAACAAGAAAA"
"chr1","13174360","13174646","chr3","83975049","83975347","79","70800689","GGCTGGGGCAGAGGCTCACACCTATAATCCCAGTATGTTGGGAGGCCAAGAGGGGTAGATTGCTTGAGACTAGGAGTTCAAGACCAGCTTGGACAACATAGCGAAATCCACTGTCTTTACAAAAAGTCAAAACATAAAAGATGAGCTGGGTGTGGTGATGCATAACTGTGGTCCCAGCTACTTGGGAGGCTGAGGGGGAAGAATCCTTTGAGCTGGGAGGTCAAGGCTGCACTGAGCTGAGATCCCACCACTACACTCCAGGCTGGGTGACAGAGCAAGACCCTGTC","GGCTGGGTGCAGTGGCTCATGGCTGTAATCCCAGGACTTTGGGAGGCTGAGGCAGGAGAATCACTTGAGGCCAGGAGTTTGAGACCAACCTGGGCAACAAAGTGAGGCATGTCTCTACAAAAACAAAACAAAACAAAACAAAACAATTAGCTGTGTGTGGTGATGCCTGCCTGTCGTCCCAGCTACTCGGGAGGCTGTGGTGGGAGGATCTCTTGAGCCTGGGAGGTTGAGGCTGCAGTGAGCTGTGATTGCCCACTGTACTCTAGCATGGGTTACAGAGCAAGACTCTGTCTCAAAAA"
"chr1","13227309","13227443","chr9","47045786","47045941","55","33818477","GACCAGTCATGTTGGCTCATGCCTGTAATCCCAAGACTTTAGGAGGCAAAGTGGGAGGTTTGCTTGAATCTAGGTGTCCCAGACCAGCCTAGGTAACAAACCAAGACCTCATCACTATAAAAAATAATAATAATA","GCTGGGCGCAGCAGCTCACACCTGTAATCCCAGTGCTTTGGAGGTCCAAGGTAGGAGGATTGCTTAAGACTAGGTGTTCAAGACCAGTCTTGGCAACATAGTGAGAACTCATCTCTACAATAAATAAATAAATAAATAAATAAATGAAAATAAAAA"
"chr1","13227755","13227939","chr19","13525969","13526165","80","298214","TCAAAAAAATTAGCCAGTTATACTAGTGCATGCCTGAATTCCAGCTATTCAGAAGGCTAGAACTTCTGAGTAGGGAGGATGGCTTGAGCCCAGAAGGCAGAGGTTGCAGTGAGTCGAGATCACAATACTGCATTCCACCAAGAATGACGCAGGAAGACAATGTCTCAAAGAAAAAAAAAAAAAGA","AAGAAATAAATTAGTTGAGCATGGTGGTGCATGCCTATAGTCCCAGCTACTGGGGAGGCCAAAGTGGGAGGATTGTGTGAGCCCAGGAGTTTGAGGCTGCAATGAGCCAAGATTATGCACACCAGTGTGGGAGACAGTCAAGTCTCAAAAAATAAACAACAACAACAACAACAACAACAAACACATAAAAAGAAAAA"
"chr1","13258314","13258600","chr8","15910614","15910909","81","2652300","GGCAGGGGTGGAGGCTCACACCTATAATCCCAGTATGTTGGGAGGCCAACAGGGGTAGATTGCTTGAGACTAGGAGTTCAAGACCAGCTTGGACAACATAGCGAAATCCACTGTCTTTACAAAAAGTCAAAAAATAAAAGATGAGCTGGGTGTGGTGATGCATAACTGTGGTCCCAGCTACTTGGGAGGCTGAGGAGGAAGAATCCTTTGAGCTGGGAGGTCAAGGCTGCACTGAGCTGAGATCCCACCACTACACTCCAGGCTGGGTGACAGAGCAAGACCCTGTC","GGCCAGGCGAAGTGGCTCACACCTGTAATCCCAGCACTTTGGGAGGCCAAGGCAGGAGGATCATTTGAAGCCAGGAGTTCAAGGCCAGCCAGAGAAACATAGTGAGAACCTGTCTTTACAAAAATTAAAATTAAAATTAAAATTAGCCAGGAGTGGTGGTGCATGCCTGCAGTCCCAGCAGCTCAGGAGGCTGAGGTGGGATGATTGCTTGCACCAGGAGTTCGAGGCTGCAGTGAGCTGTGATCGTGCCACTGCACTCCAGCCCCTGGGTGACAAAGCAAGATCCTCTAAAAAAA"
"chr1","13305492","13305633","chr9","47045786","47045941","51","33740294","GGATTACGCCTGTAATCCCAGTACTTTGGGAGGCCAAGGCGGGTGGAATGTTTGAGTCTAGGAGTTCAAGACCAGCCTGGACAACATAGTGAAACCCACTGTCTTTACAAAAAGTCAAAAAATAAAAGATTAGCTGGGCATG","GCTGGGCGCAGCAGCTCACACCTGTAATCCCAGTGCTTTGGAGGTCCAAGGTAGGAGGATTGCTTAAGACTAGGTGTTCAAGACCAGTCTTGGCAACATAGTGAGAACTCATCTCTACAATAAATAAATAAATAAATAAATAAATGAAAATAAAAA"
"chr1","13317487","13317773","chr3","83975049","83975347","82","70657562","GGCTGGGGTGGAGGCTCACACCTATAATCCCAGTATGTTGGGAGGCCAAGAGGGGTAGATTGCTTGAGACTAGGAGTTCAAGACCAGCTTGGACAACATAGCGAAATCCACTGTCTTTACAAAAAGTCAAAAAATAGAAGATGAGCTGGGTGTGGTGATGCATAACTGTGGTCCCAGCAACTTGGGAGGCTGAGGAGGAAGAATCCTTTGAGCTGGGAGGTCAAGGCTGCACTGAGCTGAGATCCCACCACTACACTCCAGGCTGGGTGACAGAGCAAGACTCTGTC","GGCTGGGTGCAGTGGCTCATGGCTGTAATCCCAGGACTTTGGGAGGCTGAGGCAGGAGAATCACTTGAGGCCAGGAGTTTGAGACCAACCTGGGCAACAAAGTGAGGCATGTCTCTACAAAAACAAAACAAAACAAAACAAAACAATTAGCTGTGTGTGGTGATGCCTGCCTGTCGTCCCAGCTACTCGGGAGGCTGTGGTGGGAGGATCTCTTGAGCCTGGGAGGTTGAGGCTGCAGTGAGCTGTGATTGCCCACTGTACTCTAGCATGGGTTACAGAGCAAGACTCTGTCTCAAAAA"
"chr1","13323075","13323365","chr3","54066100","54066414","85","40743025","GCCAAGCGTGGTGGTCCATGCCTATACTCCCTGCATTTTGGGAGGCCAAGGCAGGAGAATCACAAGGTCAGGAGTTACAGATCAGCCTGGGGAAGACAGCGAGGCCTTGTCTCTACTAAAAAGAAGTATCCAGGTGTGTTGGCTCACACAGCTGTAGTCCTAGCTACTCAGGAGGCTGAGGTGGGAGGATCGCTTGAACCCAGGAAATTGAGGCTGCAGTGAGGTATGATTGTGCCACTGCACTGTAGCCTGAGTGACAGGAGACCTTTAAAAAACAAAAAGAAAAAAAAA","GGATGTAGTAGTTCACGCCTATAATCCTAGCATTTTTGGGAGGCCAAGGCAGGAGGATCACCTGAGGCCAGGAGTTCCAGACCAGCCTGGGCAAGATAGTGAGACCCTATCTCTAAAAAAAAAAAAAAAAAAAAAAAAAATTTAGCTGGGTTTGGCAGCTCATGTCTGTAGTCCTAGCTACTTGGGAGGCTGAGGTGAGAGGATCACTTGAGGCCAAGAGTTAGAGGCTGCAGAGAGCTATAATTGTGCCATTGTACTCCAGCCTGGGTGACAGAACAAGACTCTGTCTCTAAAAACAAAAATAAAGTAGAAAAA"
"chr1","13373406","13373540","chr9","47045786","47045941","58","33672380","GACCAGTCATGTTGGCTCATGCCTGTAATCCCAAGACTTTGGAAGGCGAAGTGGGAGGTTTGCTTGAATCTAGGTGTCCCAGACCAGCCTAGGTAACAAACCAAGACCCCATCACTATAAAAAAACATAGTAATA","GCTGGGCGCAGCAGCTCACACCTGTAATCCCAGTGCTTTGGAGGTCCAAGGTAGGAGGATTGCTTAAGACTAGGTGTTCAAGACCAGTCTTGGCAACATAGTGAGAACTCATCTCTACAATAAATAAATAAATAAATAAATAAATGAAAATAAAAA"
"chr1","13374154","13374330","chr18","55799233","55799394","73","42425079","TTAGCCAGTTATACTGGTGCGCGCCTGAATTCCAGCTATTCAGAAGGCTAGAACTTCTGAGTAGGGAGGATTGCTTGAACCCAGAAGGCAGATGTTGCAGCGAGTCGAGATCAAAACACTGCATTCCACCATGAATGACGCAGCAAGACACTGTCTCAAAAAAAAAAAAAAAAAAAA","GGCTGAGAGAGGTGGCTCATGCTTGTAATCCCAGCACATTGGGAGGCAAAGGTGGGAAGATTGCTTGAGGCCAGGAGTTCAAGACCAGCCTGGGCAACATGAAAACACTTTGTCTCTACAATAAATAAATAAATAAATAAATAAATAAAAGAAACAAGAAAA"
"chr1","13397837","13398143","chr16","32352979","32353289","76","18955142","GGCTGAGTGTGGCGACTCAAGACTAATCCCAGCACTTTTGGATGTCAAGGCAGGAGTATCGCTGAAGACCAGGAGTTCGAGACCAGCCTAGCCAACAGAGTGAGGCCCCATCCCTATAAAAATAAAAAAAAATTAGCCAGTTGTGATGGTGTCCATCTGTGGTCTCAGCTACTCAGGAGGCTGAGGTGGGAGGATTGCTTGAGCCCAGGAAGTTGAGGTTGCAGTGGATTATGATCACACCACTGCACTCCAGCCTGGGTGACAGAGGGAGATCCTGTCTCAGAAAAAATTAATAAATAAATAAGAA","GGCTGGACACGGTGGCTGCTGCCTGTAATCCCAGCACTTTGGGAGGCCAAGGCAGGAGAATGGCTTGAGCCCAGGAGTTCAAGACCAGCCCGGGCAACAGAGTGAGACCTTGTCTCTACAAAAATAAAAATAGAAATAAAAATAAAAATTAGCCAAGTGTGGTGGCATGCACCTGTGGTCTCAGCTACTCAGGAGACTGAGGTGGGAGGATCCCTTGAGCCCAGGAGGTCGAGGCTGCAGTGAGCTGTGATCATGCCACTACACTCCAGCCTGGGTGACAGAGCTGTCTCAAAAAAATAATAATTAAAAAA"
"chr1","13480480","13480515","chr20","87144","87254","77","13393336","CTGGGCAACAGAGCGAGACCCTGTCTTTACAAAAAA","CCTGGGCAACATAGTGAGACTACATCTCTACACTCACGCACACACACACACACACACACACACCCCCCAAATTAGCCAGGCATGCTGATGTGCACCCATAGTCTCAGCAAC"
"chr1","13480864","13480957","chr20","87144","87254","62","13393720","GGCTGGGCCTGGTGGCTCACGCCTTTAATCTCAGAGCTTTGTGAAGCTGAGGTGGGAGGATTGCTTGAGGACAGCAGTTCCAGACCAGCCTGGG","CCTGGGCAACATAGTGAGACTACATCTCTACACTCACGCACACACACACACACACACACACACCCCCCAAATTAGCCAGGCATGCTGATGTGCACCCATAGTCTCAGCAAC"
"chr1","13540393","13540503","chr20","87144","87254","68","13453249","GGCATAGCGGCTTACACTTATAATTCCCAGGCCCTTGAGAGGCTTGGGTGGGAGGATTACTTGAGGCCAGGAGTTCAAGACCAGCCTGGGTAATATAGCAAGACCTCATCT","CCTGGGCAACATAGTGAGACTACATCTCTACACTCACGCACACACACACACACACACACACACCCCCCAAATTAGCCAGGCATGCTGATGTGCACCCATAGTCTCAGCAAC"
"chr1","13542662","13542797","chr9","47045786","47045941","48","33503124","GGCCAGGCACAGCGACTCACACCTGTAATCCTAGCACTTTGGGAGGCCAAGGCAGGAGGATTGCTTGAGGCCAAGAGTTCAAGACCAACCTGGCCAACATACCAAGGCTCCCTCTCTTTTGTAAAAAATAAATAAA","GCTGGGCGCAGCAGCTCACACCTGTAATCCCAGTGCTTTGGAGGTCCAAGGTAGGAGGATTGCTTAAGACTAGGTGTTCAAGACCAGTCTTGGCAACATAGTGAGAACTCATCTCTACAATAAATAAATAAATAAATAAATAAATGAAAATAAAAA"
"chr1","13574425","13574545","chr15","37343640","37343763","65","23769215","TGACTCACACCTGTAATCCTAGCTACTTGGAAGGCTGAGATGAAAGGGTTGGTGGACGCCAAGAGTTTGAGACCAGCCTGGGCAACATACTGAGACGTCGTATCTAAAACACATATAAAAA","AAGATCCCTGGCCAGGATTTCAAGACCAGCCTGGGCAACACAGTGAGACCATACATACATACATACATACATACATACATCATACATACATACATACATACATACATACACAGTCTTACAAAGA"
"chr1","13579433","13579559","chr19","6391716","6391877","54","7187717","GCCAGGGCAGTGGTTCATGCCTGTAATCCCAGCATTTTGGGAGGCCAAGGCAAGAGTATTGCTTGAGGCCAGGAGTTCAAGACCAACTTGGGCAACATAGCAAGACCCTGTCTCTACAAAATAAAAA","CCAGGCGCAATGGCTCACGCCTGTAATCCCAACACTTTGAGAGGCCGAGGCAAGAGGATTGCTTGAGGCCAGGAGTCCGAGACCAGCCTGGGCAACACAGCGAGGCCTCATTCTCTACAAAAAATAAATATATAAATAAATAAATAAATAAGAAGAAGAAAA"
"chr1","13580670","13580942","chrX","3592780","3593062","72","9987890","CGCAGTGGTTCATACCTGTAATCCTAATGCTTTGAGAGGCAGAGGCGAGAGGATCACTTGAGGTGAGGAGTTTGAGACCAGCCTGGGCAACATAGCAAGACCCTGCTTCTATAAAAAATAAAAATAACATTAGCCAGGTGTGGTGACACGTACCTGTGATCCCAGCTACTCAGGATGCTGAGTTGGGAGAATCACTTGAGCCCAGGAGGTCAAGGCAGCAGTAAGCCATGATCATGCCACTGCATTCCTGCTGGGGTAACAGAGCTAGACCCT","GTGGTGGCTCATGTCTGTAATCCCAGCACTTCAGGGGGCCAAAGCGAGAGGACTGCTTGAGGCCAGGAGTTTGAGACCAGCCTGCGCAACATAGAAAGACCCCATCTCTATAAATAAATAAATAAATAAATAAATAAGTCAGGCATGGTGGCACATGCCTGTAGTCCCAGCTACTCAGAAGGCTGAGGTCGGAGGATCTCTTGAGCCCAGGGGTTCAAGGCTGCAGTGAACCATGATCACACCAGTGCACTGCAGCCTGGGCAACACAGCAAAACCCTGTCCC"
"chr1","13597724","13597981","chr10","96412023","96412287","67","82814299","CACTTTGGGAGGCCAAGGTGGAAGAGTCGCTTGAGCCCAGGAGTTTGAGACCAGCCTGGACAACATAGTGAGACCCTGTGGTCTACAAAAAAATAAACCCAATTAGCCAGGCATGGTGGTACGCACTTATAGTCCCAGCTACTCGAGAGGCTAAGGTGGGAGGATCACTTGAGCCTGGAAAATCGAGGCTGCAGTGAGCCAAGATTGTGCCACTGCACTCCAGCCTGGGTGACAGAGGGAGACCCTGTCTCAAAAAAA","CTTTGAGAGGAAGACGTAGGAGGATTGCTTGAGCCCAGCAGTTTGAGACTAGCCTGGGCAACATAGGAAGACTCCCATCTCTACACACACACACACACACACACACACACAATTATCCAGGGTGGTGGTGCATGCCTGTGGTCCCAGCTACTTGGGAGGTTGAGGTGGGAGGATTGCTTGAGCCCAGGAGGTCCAGGCTGTAGTGAGCCATGATCATACCGCTGCACTCCAGCCTGGGCAACAGAGTGAGACCCTGTCTCAAAAA"
"chr1","13606521","13606710","chr2A","60286019","60286209","59","46679498","AGTTGGGTGTGGTGGTGAGCACTTGTAGTCCCCGCTACTTTGGAGACTGAGACGGGAGGATCGCTTGAGCCCAGGAGTTTGAGGTTATAGTGAGCTATGATTGTGCCTCTGTACTCTAGCCTCAGCAACAGAGGGAGAGCCTGTCTCTTAAGAAAAATTAATTTGAAAAGGTAGAGAAAAAAATAAAAAA","AAAATTAGCCAGGTGTGATGGCACCTGTAGTCCTAGCTACTTGGGAGGCTAAGGTGGGAAGAGGGCTTGAGCCCAAGATTGTGAGGCTGTGGTGAGTCATGACTGTGCCATTGCCCTCTGGCCTGGGTGACAGAGTGAGAAGCTGTCTCAAATAAATAAATAAATAAATAAATAAATAAAAATAAACAAAA"
"chr1","13631539","13631693","chr18","55799233","55799394","61","42167694","GCCAAGCATGGTGGCTCGAGCCTGTAATCCCAGCTACTCGGGAGGCAGAGCTGGGAAGATCGCTTGAGCCCAGGAGTTCAAGGCTACAGTGAGCTATGATGGTGCCACCGCACCCCAGCCTGGGCAACAGAGCAAGACCCTATCTCTAAAAAAAA","GGCTGAGAGAGGTGGCTCATGCTTGTAATCCCAGCACATTGGGAGGCAAAGGTGGGAAGATTGCTTGAGGCCAGGAGTTCAAGACCAGCCTGGGCAACATGAAAACACTTTGTCTCTACAATAAATAAATAAATAAATAAATAAATAAAAGAAACAAGAAAA"
"chr1","13633346","13633653","chr9","68878569","68878883","68","55245223","GGCTGGGCATGGTGGCTCACACCTGTAATCTCAACAGTTTGGGAGGCCAAGGCGGGAAGATCACTTGAGGCCAGGAGTTTGAGACCAACCTAGGCAATATAGTGAAACCCCATCTCTACAAAAAATTAAAAACTATTAGCCAGGCATGTTGGCACACACCTTTAGTTCCAGCTACTAGAGAGACTGAGGTGGGAGGATTGCTTGAGCCAGGGAGGCCGAGGCTGCAGTGAGCTATGATTGTGACACTGCACTCCAGCCTGGGTGACAGAGTAAGACCCTGTCTCAAAAAAAAAACAACAAAAAAAGAA","GGCTGGGCACGGCAGCTCATGTCTGTAATCCCAGCACTTTGGGAGGCCAAGGTGGGAGGATTGCTTGAGTCCAGGAGTTCAAGACCAGCCTGGGCAACATAGTGAAACCCCAGTCTCTACAAATAAATAAATAAATAAATAAATAATTAGCTGGGCATGTTGATGCATGCCTGTAGTCCTAGCTACTCGGGGGGTGAGGTGAGAGGATTGCTTGAGTCCAGAAGGTGGAGGCTGCAGTGAGCTATGATCACACCACTGCACTCCAGCCTGGAAGACAGGGTGAGACGCTGTCTTTAAAAAAAAAAAAAGAAAAGA"
"chr1","13712019","13712239","chr14","51003183","51003398","50","37291164","AGCCTGGGTAACAAGGTGAGACTCCATCTCTACCCAAAAAAAAAAAAAAAAAAAAATTAGCCAGGCATGGTGGCGCGAGCCTGTAGTCTTAGTTATTTAGGAGGCTGAGGTGGGAGGATCACTTGAGCCCAGGAGTTCGAGGCTGCAGTGAGCTATGATTGTGCCATTGCAGTCCAGCCTGGGTGAGAGAGTACTACACCATCTCCAGAAAAAAAGAAGAA","AGCCTGGGCAAGATAGTGAGACCTCATCTCTTAAAATAAATAAATAAATAAATAAATAGCAGGATGTGGTGGCGTGCATCTGTAGTCCCAGCTACTCAGGAGGCTGAGATGGGAGGATTACTTGAGCTCAGGAGGTCGAGGCTGCAGTGAGCTATGATCACGCCACTGTACTCCAGCCTGGGTGAGAGTGATACCCTGTCTCTAACAAAAAAAAAA"
"chr1","13773430","13773725","chr8","25360790","25361095","67","11587360","GACCAGGTGTGGTGGCTCACACCTGTAATCCCAGCACTTTGGGAGGCTGAGCCAGAAGGATCTCTGGAGGCCAGGAGTTTGAGGCCAGCCCGGGCAACATAGTGAGACCCTGTTTCTACAAAAGAAAATAAGAAAATTCACTAAGATGATGGCATGTGCCTGTAGTTCTAGCTACTTGACAGGCTGAGGTGGGAGGATCACTGGTGCCCAGGAGTTAGAGGCTACATTGAGCTGTGATCCCCCCACTGTACTCCAGCCTGGGTGACAGGGCGAGACTGTCTCTAAAAAAATAAAAA","GGCTGGGAGCAGTGGCTCATACCTGTAAGCCCAGCACTTTGGGAGGCTGAGGTGGGAGGATTGCTGAAGCCCAGGAGTTTGAGACCAACCTGGGCAATGTAGGGAGACCCCGTCTCTACTAAATAAATAAATAAATAAATAAATAAAGTCGGGCATGGTGGCATGTGCCCTGTAGTCCCAGCTTCTTGGGAGGCTGAGGTGGGAGGATTGCTTGGGCCCAGGAATCAAGGCTGCAGTGAGCTGTGATTGTGCCACTGTACTACAGCCTGGGTGACAGTGCAAGACTGTCTCAAAAGAAAAACAAAA"
"chr1","13895992","13896117","chr15","37343640","37343763","68","23447648","CAGGAGGCAGAGGTGGCAGGACCACTTGAGCCTAGGAGGTTGAGGTTGCAGTGAGCTATGATCATGCCACTGCACTGTAGCCTGGGTGACAAAGCAAGACCCTGTCTCAAAAAATAAAAAAAAAAA","AAGATCCCTGGCCAGGATTTCAAGACCAGCCTGGGCAACACAGTGAGACCATACATACATACATACATACATACATACATCATACATACATACATACATACATACATACACAGTCTTACAAAGA"
"chr1","13896331","13896590","chr9","79131976","79132248","68","65235645","GCCTGGCATGGTTGCTCACTCCTATAATCCCAGTATCTGGGGAGGCTGAGACAGAAGGATCGCTTGAGCCCAGGAGTTCAAGACCAGCCTGGGCAACATAACGAGACTTCATCTCTACAAAAAAAATTAAAAAATTAACCTGGAATGGTGGTACATGCCTGTGGTCCCAGCTACTTGAGAGACTGAGATGGGAGGATCGCTTGAGCCTAGGAGGTCAAGGCTGCAGTGAGCTATGATCATGCCACTGCACTACAGCCTGG","GGCTGGGCATGGTGGCTCACACCTGTAATCTCAGCACTTTGGGAGTCTGAGTTGGGAAGATTGCTTGAATCCAGGAGTTGGGAGACCAACCTGGGCAACAAAGCGAGACCCTGCCTCTCCAAAAAAAAAAAAAAAAAAAAAAAAAAAAAGCTGGGTGTGAAGGTGCATGCCTGTAGTCTCAGCTATTCTAGAGGCTGAGGTGGGAGGATCGCTTGAGCTATGGAGTTTGAGGCTGCAGTGAGCTATGATGGGATCACTGCACTCCAGCCTGGG"
"chr1","13929048","13929206","chr2A","60286019","60286209","62","46356971","GGCTCGTGCTTGTAATCCCAGCTCCTTGGGAGGCTGAGGTGGAAAGATTGCCTGAGCCCAGGATTTCGAGGCTGCAGTGAGCTATGATCCTGCCACTGCAATCCAGCTTGGGTGACAGAGTAAGACCCTGTCTCTTAAAAAAAAAAAAAAAAAAAAAAA","AAAATTAGCCAGGTGTGATGGCACCTGTAGTCCTAGCTACTTGGGAGGCTAAGGTGGGAAGAGGGCTTGAGCCCAAGATTGTGAGGCTGTGGTGAGTCATGACTGTGCCATTGCCCTCTGGCCTGGGTGACAGAGTGAGAAGCTGTCTCAAATAAATAAATAAATAAATAAATAAATAAAAATAAACAAAA"
"chr1","14145161","14145452","chr8","25360790","25361095","64","11215629","GGCTGGGTGCTGTGGCTCACATCTGTAATCCCAACACTTTGGGAGGCCAAGGTGGGAGAGTCACTTGAGCCCAGGAGCTTGAGACCAGCCTGGGCAACATAGTGAGACCCCATCTTTACAAAATAAATTTAAAAATTAGCCGGGCATGGTGGCATGTTCCTGTAGTCCCAGCTCTCAGGAGGCTGAGGTGGGAGGATCGCTTGAGTCAAGGAGGTCGAGGCTGCAGTGAGCTATGATTGCACTACTGCACTCCAGCCTGGGTGATAGAAAAAGACCATGTCTCTGAAAAAAA","GGCTGGGAGCAGTGGCTCATACCTGTAAGCCCAGCACTTTGGGAGGCTGAGGTGGGAGGATTGCTGAAGCCCAGGAGTTTGAGACCAACCTGGGCAATGTAGGGAGACCCCGTCTCTACTAAATAAATAAATAAATAAATAAATAAAGTCGGGCATGGTGGCATGTGCCCTGTAGTCCCAGCTTCTTGGGAGGCTGAGGTGGGAGGATTGCTTGGGCCCAGGAATCAAGGCTGCAGTGAGCTGTGATTGTGCCACTGTACTACAGCCTGGGTGACAGTGCAAGACTGTCTCAAAAGAAAAACAAAA"
"chr1","14445915","14446212","chr5","152110395","152110709","68","137664480","GGCTGGGCACAGTGGCTCAAGCCTGTAACCCTGCACTTTGGGAGGTCAAGGTGGGAGGATCACTTGAGGCCAGGAGTTCAAGACTGAGCAACATGGCAAGACCCCATCTCTACAAAAAAAAAAAAAATTAAGTTAGCCAAGTGTGCTGGTGCACACCTGTAGGCCCAGCTACTCAGGAGACTGAGGCTGGAGGATTACTTCAGCCCAGGAGGTCCAGGCTGCAGTGAGCTATCATCATGCCACTACACTCCAGCCTGGGCCACAGAGCAAGACCCTGTCTCAGAAAACAAAAAAAGAA","GGCTGGGAGTGGTGGCTCATGCCTATAATACCAGCACTTTGGGAGGCCAAGGTGGGAAGATCACTTGAGGCCAGGAGTTCAAGATCAGCCTAGGCAACATAGCAAGACCCTGTCTCTACAAAACAAACAAACAAACAAACAAACAAAATTAGCTGGGCATGGCGGTATGCACCTGTAGTCCCAGCTACTTGGGAGGCTGAGGCAGGAGGATTGTTTGAGCCCAGAAGGTTGAGGCTGCATTGAGCCATGATTATGCCACTTTACTCCAGCCTGGGCAACAGAGGGAGACCCCATTCTCAAAAACAAAACAAAAAA"
"chr1","14619203","14619498","chr8","25360790","25361095","77","10741587","GCCTGGCACAGTGGCACACAACTGCAATCCCAGTGCTTTGGGGGCTGAGGTGGGAGGATTGCTTGAGGCCAGGAGTTCAGAGACCAACCTGGACACCATGGCGAGACCCTGTCTTTACAAAAAAATTTAAAAAATTAGCCAGGTGTGTTGGCACCCACCTGTAGATCTAGCTACTTAGGAGGCTGAGGTGGGAGGATTGTTTGAGCCCAGGAGTTTGAGGCTGCAGTGAGCTATGATTGCATCACTGCACTTGAGCCCAGGCAAGAGAGTAAAATTTTGTCTTAAAAAAAAAAAAA","GGCTGGGAGCAGTGGCTCATACCTGTAAGCCCAGCACTTTGGGAGGCTGAGGTGGGAGGATTGCTGAAGCCCAGGAGTTTGAGACCAACCTGGGCAATGTAGGGAGACCCCGTCTCTACTAAATAAATAAATAAATAAATAAATAAAGTCGGGCATGGTGGCATGTGCCCTGTAGTCCCAGCTTCTTGGGAGGCTGAGGTGGGAGGATTGCTTGGGCCCAGGAATCAAGGCTGCAGTGAGCTGTGATTGTGCCACTGTACTACAGCCTGGGTGACAGTGCAAGACTGTCTCAAAAGAAAAACAAAA"
"chr1","14669463","14669775","chr14","31798968","31799292","72","17129505","GCTGGGCGCGGTGGCTCACACCTCTAATCCCAGCACTTTGTGAAGCTGAGCGGGGAGGATTGTTTGAGGCCAGGAGTTTGAGAACAGCCTGGGCAACATATCAAGACCCCATCTCTACACAAAAATGTTTAAAAATTAGCCAGGTACAGTGGTGTGCACCTATAGTCCCAGCTACTCAGGAGGCTGGGATGGGAGGATCGCTTGAGCCCAAGAGTTTGAGGCTGCAGTGAGCCAAGATCGTGTCATTGCATTCCAGCCTTGGTGACAAAATGAGAGCCTGTCTCTAAGAAACAAACAAACAAAAAACAAATAA","GGCTGGGCACAGTAGCTTACACCTGTAATCCCAGTACTTTGGAAGGCTGAAGTGGGAGGATCCCTTGAGGCCAGGAGTTTGAGACCAGCCTGGGCAACATAGTGAGACCCTGTCTCTACAACAAACAAACAAACAAACAAACAAAACTTAGCCAGTTGTGGTGGCACATCCTATAGTCCCAGCTACTCAGGAGGCTGAGGAGGGAGGATCTCTTGAGCCCAGGAGTTTGAGGCTGCAGTGAGCTATGATCATGACACTGCACTCCAGCCTGGATAACACAGCAAAATCCTGTCTCAAAAAAAAAAAAAAAAAAAAAAAAAAAGAA"
"chr1","14674778","14675005","chr13","1430460","1430706","68","13244318","GACCAACCTGGGCAACACAGTAAGATTTTGTTCCTACAAAAATAAAATAAAAATAGCTGGGTGTGGTGGTGCGTGTCTGTAGTCCCAGGTGCTCAGGAGGCTGAGGTGGGAAGATGGCTTTAACCCAGGAGTTCGCAGCTGCAGTGAGCTATGATTGCACCACTACACTCCAGCCTGGGCAACAGAATGACCCAGTCTTAAAAAAAAAGAAAAGAAAAGAAAAGAAAA","CGAGTGCAGCCTGGGCAACACAAGGAGATCTCGTCTCTTAAAAAAAAAAAAAAAAAAAAAAAAAAAAATAGGCCGGACGCGGTGGCCCTCGCCTGCAATCTCAGCTACTTAGGAGGCTGAGTGGGAGGGTCGCTTGAGCCTGGGAGTTCCAGGCTGCAGTGAGCCGTGATGGCGCCACTGCACTCCAGCCTGGACAACAGAGCAAGACCCTGTCTTAAAAAAAAAAAAAAAAAAAAAAAAAAAAAAA"
"chr1","14701125","14701430","chr8","15910614","15910909","68","1209489","GGCTGGGCACAGTGGCTCATGCCTGTAATCCCAACACTTTGGGAGGTCAAGGCAGGACGACAGCTTGAGTCCAGGAGTTCACGACCAGCCTGGGAAACATAGTGAGAACTAATCTCTACTAAGAATAATAACAATTTTAAAAATTAGCCAGGCATGGTGGCACATGCCTGCAGTCCTAGCTACTCAGGAGGCTGAGGTGGGAGGATCACTTAAGCCCAGGAGGTTGGGCTTAAGTGCAGTGAGCTGTGAGCATGCCATTGCACTGCAGCCTGGGTGACAGAGCGACTTCCTGTCTCAGAAAAAAAA","GGCCAGGCGAAGTGGCTCACACCTGTAATCCCAGCACTTTGGGAGGCCAAGGCAGGAGGATCATTTGAAGCCAGGAGTTCAAGGCCAGCCAGAGAAACATAGTGAGAACCTGTCTTTACAAAAATTAAAATTAAAATTAAAATTAGCCAGGAGTGGTGGTGCATGCCTGCAGTCCCAGCAGCTCAGGAGGCTGAGGTGGGATGATTGCTTGCACCAGGAGTTCGAGGCTGCAGTGAGCTGTGATCGTGCCACTGCACTCCAGCCCCTGGGTGACAAAGCAAGATCCTCTAAAAAAA"
"chr1","14703626","14703909","chr11","34622326","34622621","89","19918700","CCAGTGCTTTGGGAGGCGTAGGCAGGAAGATCACTTGGGGCCAGGAGTTGGAGACCAGCCTGGACCACATAGTGAGACTCTGTCTCTACAAAAGCACAATAAAAATTAGCCAGGCATGGTGGCACACACCTGTAGTCCCAGCTACTCAGGAGGCCAAACCAGAGGAGTTGTTGAGCCCAGGAGGTCAAGGCTGCAGTGAGTTGTGATGGCGTCGCTGCGCTTCAGCCTGGGGCAACTCCAGCCTGTGAGACTTTGTCTCTAAAAAAATGAAAAATAAAAAAGAA","ATGCCTGTAGTCCCAGTTACTTGAGAGGCTGAGGCAGGAGGATCACTTGAGGCAAGGAGTTTGAGATCAGCCTGGGTAACATAGTGAGACCCTATCTTTACAAATAAAATAAAATAAAATAAAATAGCCAGACATGGTGGTGTGCACCTGTAACCCTAGCTAATGGGGAGGCTGAAGCAGGAGGATCGCTTGAGCCCAGGAGTTGGAAGCTGTAGTGAGCTGATTACACCACTGCACTCCTGCCTGGGCAACACAGCAAGACTCTGTCTCAACAACAACAGAATAAAAAGAGAGAA"
"chr1","14710902","14711192","chr1","47533839","47534134","63","32822937","GGCTGGGTACAGTAGCTCACATCTGTAATCCCAGCACTTAGGGAGGCCAAGGTGGGAGGATCACTTGAGGCCAGGAGTTCAAGACCAGCCTGGGCAACATGGCAAGATACCACTATCTCCACAAAAAAATTAAAAAACAAAAATAGCTGGGCATGGTGGTGTGTGCTTGTAGACCCAGCTACTTGGGAGACTGATGCAGGAGGCTCACTTGAGCCCAGGAGTTGGAGGCTGCAGTGAGCCATGATGGCACCACTGCCCTCCAGCCTGGGGGACAAAGCCAGACCTTGTCTC","GGCTGGGCACGGTAGCTCACACCTGCAATCCCACCACTTTGGGAGGCTGAGGTGGGTGGATTGCTTGAGCCCAGGAGTTCTAGACCAGCCTGGGTGATACAGGCAGACCCTATCTCTACCAAAAAAAAAAAAAAAAAAAAAAAAAAAGGCTGGGCATGGTGGCATGTGCCTGTGGGCTCAGCTACTTAGGAGGCTGAGGTGGGAGGATCAGTTGAGCCCAGGAGGAGTTGAGGCTGCAGTGAGCCTAGATCCTGCCACTGCACTCCAATCTGGGCAACAGAGCGAGACCCTGTCTC"
"chr1","14738891","14739195","chr1","213591659","213591963","20","198852768","GGTCAAGTGCAATGGCTCATGTCTGTAATCCCAGCACGGTGGGAGGCCAAGGCAGGAGGATTGCTTGGGGCCATGGATTCAAGACCAACCTGGGCAACCTAGTGAAACCTCATCTCTATTAAAAATAAAAATAAAAATTAGTTGGGCATGGTGGTATACACCTGTGGTCCCAGGAGTCCTCAGGAGGCTGAGGTAGGGGGATCACTTGAGCCCAAGAGTTGAGGTTGCAGTGAGCTATGATTGCACCACGGCACTCCAGCATGGGCAACAGAGTGAGACTTTGTCTCAAAACAAAACAAACAAAA","GTGCAATGGCTGATGTCTGTAATCCCAGCACAGTGGGAGGCCAAGGCAGGAGGATTGCTTGAGGCCAGGGATTCAAGACCAGCCTGGGCAACCTAGTGAAACCTCATCTCTATTAAAAATAAAAATAAAAATAAAAATTAGTTGGGCATGGTGGCACACACCTGTGGTCCCAGGAGTCCTCAGGAGGCTGAGGTAGGGGGATCACTTGAGCCCAAGAGTTGAGGTTGCAGTGAGCTATGATTGCACCACTGCACTCCAGCATGGGCAACAGAGTGAGACTTTGTCTCAAAACAAAACAAACAAAA"
"chr1","14744447","14744742","chrX","16155635","16155942","69","1411188","GGCCAGGTGTGATGGCTCACGCCTGTAATCCCAGCAATTTGGGAGGCTGAGGTAGGACAGTCACTTGAGGCTAGGAGTTCAAAACCAGCCTGGGCAACATAGCAAGATCCTGGTACTCTACACAAAATAAAAATAAAAAATTAGCCAGGTATGGTGGCATGTGCCTGTAGTCCCAGCTACTCGGGAGGCTGAGGCAGGAAGATCACTTGAGCCCAGGAGTTCGAGGCTGCAGTGAGCTGTGATTATGACACTGTATTCCAGCCTGGGTAACCCAGTCTCTTTAAAAATAAAAACAA","GGCCAGGCACAGTGGCTCACACCTGTAATCCCGGTACTTTGGGAGGCTGAGGCGGGAGGATCACTTGAGCCCAGGAGTTCAAGACCAGCCTGGGCAACATAACAAGACCCTGTCTCTACCAAAAAAAAAAAAAAAAAAAAAAAAAATAGCCAGGCCTGGTGGCCTGTGTCCATAGTCCCAGCTACTTTGGGAGACTGAGGTGGAAGGATCACTTGAGTCTGGAAATCAAGACTGCTGTGAGCTGTGATCATGCCACTGTACTCCAGCCTGAGCAACAGAGTGAGACCCTGTCTAAAAAAAAAAAAAAA"
"chr1","14758186","14758455","chr1","213572383","213572661","24","198814197","CATGCCTGTAATCCCAGCTACTACAGAGGCTGAGGTAGAAGCATCACTTGAGCTCAGAAGGTTGAGACCAGCCTGGGCAACACGGCAAGACCCCAACTCTAAAAATAAATAAATAAATAAATATTAGTTGGGTGTGGTGCTGTGTGCCTGTAGTCTCAGCTGTTCAGGAGGCTGAGGTGGGAGGATCGCTTGAGCCCAGGAGGTTGAGGCTGCAGTGAGGTATAATGGCACCATTACACTCTAGCCTGGGTGACAAAGCAAGAGCCTGTC","GCCTGTAATCCCAGCTACTACAGAGGCTGAGGTAGAAGGATTGCTTGAGCTCAGAAGGTTGAGACCAGCCTGGGCAACATGGCAAGATCCCAACTCTAAAAATAAATAAATAAATAAATAAATAAATAAATATTAGTTGGCTGTGGTGCTGTGTGCCTGTAGTCTCAGCTATTCAGGAGGCTGAGGTGGGAGGATTGCTTGAGCCCAGGAGGTTGAGGCTGCAGTGAGGTATAATGGCACCATTACACTCCAGCCTGGGTGACAAAGCAAGAGCCTGTC"
"chr1","14772200","14772479","chr1","20214247","20214541","68","5442047","GGCCTGGGTGCGGTGGCTCACGCCTGTAATCCTGGCACTTTGGGAGGCCGAGGCAGGAGGATCGCTTGAGCCCAGGAGTTTGAGACCAGCCTGGGCAACATAGTAAGACCCCTGTCTCTATAAAAAATTTAACAATTAGCCAGGAGTGGTGGCATGCACCTGTGGTCCCAGCTCCTCAGGAGGCTGAGGTGGGAGAATCCCTTGAGCCCAAGAGTTTGAGGCTGCAGTGAGCTATGACTGCACCATGACATTCTAGCCTGGGTGACAGAGTGAGATCCTG","GACTGGGCGTGGTGGCTCACACGTGTAATGTCAACACTTTGGGAGGCCGAGGTGGAGGATTGCTTATGACCAGGAGTTTGAGACCAGCTGGGCAACATAGTGAGACCCCATCTCTACCACACACACACACACACACACACACAAATTAGCTGGGTGTGGTGGCAAGCCCCTGTAGTCCCAGCTACTCAGGAGGCTGAGGTGGGAGGATCACTTGAGCCTGGGATGTTGAGGCTGCAGTGAATCATGATTGCACCATCGCATTCTAGCCTGGGAGACAGAGCAAGACCTTGTCTCA"
"chr1","14812516","14812811","chr12","108570006","108570305","74","93757490","CTGGGCATGGTGGCTCACACTTCCAATCCCAATGCGTTGGGAAGCTGAGGCAGGAGGATCCCTTGAGGCCAGGATTTGAGACCAGTCTGGGCAACATAGTGAGACCTCATCTCTACAAAAAATTTAAAAAATTAGCTGGGCATGGTGGCATGCACCTGTAGTCCTAACTATGCAGGAGGCTGAAGTGGGAATATTGCTTGGGCCTAAGAGTTTGAGGCTGCAGTGAGCTATGATCACACCACTGCATTCCAGCCTGGATGATAGAGCAAGACTCTATTTCAAAACACAACAAAAAA","GGCAGGGCGTGGTGGCTCACACCTGTAATCCCTGTATTTTGGGAGGCTGAGGCAGGACGATTGCTTGAGGCTAGGAGTTTGAGACCAGTCTGGGCAACATTTAAATAAATAAATAAATAAATAAATAAATAAATAAATCAGCCAGGCATGGTAGCATGAACCTGTAGTCCCAGCTCCTCAGGAGGCTGAGGGAGGATTGCTTGAGCCCAGGAGTTCAAGGTTGCATTGAGCCATGATTGCACCACTGTACTCCAGCCTGGGAAACAGAGTAAGACCCTGTCTCAGAAACAAACAAAAAAA"
"chr1","14837551","14837853","chr20","46003702","46004015","67","31166151","GCCAGGTGCCATGGCTCACGCCTGTAATCCCAGCACTTTGAGAGGCTGAGGTAGAGGGATTGCTCGAATCCAGGAGTTCAAGACCAGCCAGGGCAACAGGCTTGTCTCTAAAAATAATAATAATAATAATAATAATTATCCAGGGGTGGTGGCACATGCCTATCTGCCAGCTACTCAGGAGGCTGAGGTGGGAGGATCTCTTGAGCCTAGGAGGTTGAGGCTGCAGTGAGCTATGATTGCGCTATTGCACTCCAGCCTGGGTGACAGAGCAAGACCCTGTCTCAAAAAAAAAAAAAAAAAAAA","GGCTGCGCACAGTGGCTCACACCTGTAATCCAGCACTTTGGGAGGCCAAGGCAGGAGAATCATTTTCGTTCAGGAGTTTGAGGCCAGCCTGGGCAATATAGAGAGATCTTCTCTCTACAAAATATAATAATAATAATAATAATAATAAGCCAGTTGTGGTGGCTCACACCTGTAGTCTCAACTACTCAGGAAGCTGAGGTGGGAGGATCACTTGAGCCCAGGAGGTTGAGGCTGCAGTGAACCAGACTACACCACTGCACTCCAGCCTGAGTGACAGAGCAAGACCTTGTCTCAAAAGAAAAAAAACAACAAAA"
"chr1","14847703","14848002","chr9","68878569","68878883","77","54030866","GGGCACAGTGGCTCACGCCTGTTATCCCACCACTTTGGGAAGCCGAGGTGGGAGGATCAGTTGAGGCCAGGAGTTGGAGATCAGCCTGGGCAAAATTTTGAGACCTCGTCTCTACAAAATATTTTAAAAAATTAGCCAGGCGTGATGGCCACCTACAGTCCTAGTTTCTTGGGAGGCTGAGGTGAGAGGATCACTCGAGCCCAGGAGTTCGAGGCTGCAGTGAACTATGATCAGGCCACTGCACTCCATCCTGGGCGACAGAGTGAGATTCTGTCTCAAAAACAAAAACAAAAACAAAAA","GGCTGGGCACGGCAGCTCATGTCTGTAATCCCAGCACTTTGGGAGGCCAAGGTGGGAGGATTGCTTGAGTCCAGGAGTTCAAGACCAGCCTGGGCAACATAGTGAAACCCCAGTCTCTACAAATAAATAAATAAATAAATAAATAATTAGCTGGGCATGTTGATGCATGCCTGTAGTCCTAGCTACTCGGGGGGTGAGGTGAGAGGATTGCTTGAGTCCAGAAGGTGGAGGCTGCAGTGAGCTATGATCACACCACTGCACTCCAGCCTGGAAGACAGGGTGAGACGCTGTCTTTAAAAAAAAAAAAAGAAAAGA"
"chr1","14908121","14908258","chr5","32595015","32595178","43","17686894","GGCACGGTGGCTCACACCTGTAATGCCAGCACTTTGGGAGGCTGAGGCAGGAGGATCGCTTGAGGCCAGGAGTTCAAGACCAGCCTGGGCAACATAGCAAGACCCCTATCTGTACAAAAAATAAAAATAAGAAAAATT","GGCCGGGTGTGGTCCCTCATGCCTGTAATCCCAACACTTTGGGAGGCTGAGATAGGAGGACTGCTTGAGGCCAGGAGTTCAAGACCAGCCTGGTCAACATAGTGAGACCCCATCTCTATAAAATAATAATAATAATAATAATAATAATAATAAATAAATAAATA"
"chr1","14908572","14908725","chr5","32595015","32595178","73","17686443","ATTACCTGGGTGTGGAGGCATGTGACTCCCAGCTACTCAGGAGGCTGAGGTGGGAGGATTGCTTGAGGCTGGGAGGTTGAGGCTGCAGTGAACCCTATTCATGCCACTCCTCTCCAGTCTGGGTGACAGAGACCAGACCCTGGCTCAAAAAGAA","GGCCGGGTGTGGTCCCTCATGCCTGTAATCCCAACACTTTGGGAGGCTGAGATAGGAGGACTGCTTGAGGCCAGGAGTTCAAGACCAGCCTGGTCAACATAGTGAGACCCCATCTCTATAAAATAATAATAATAATAATAATAATAATAATAAATAAATAAATA"
"chr1","14916639","14916926","chr2A","88638728","88639031","71","73722089","GTGGTGGCTCATACCTGTAATTCTAGTGCTTTGGGAGGCTAAGGTAGGAGGACCACTTAACGCCAGGAGTTTGCGGCAGCTTGGGCAACACAGTGAGACCCTATATCTACAAAAAAAATTAAAAATTAGCTGGGCATGGTGGTGGCACACCTGTGGTCCTAGGTACTTGGGAGACTGAGGCAGAAGGATTGCTTGAGCCCAGGAGTTTGAGGCTGCATTGAGCCATCATCATACCACTGCATTCTAGGCTGGGTGACAAGCAAGACCTTGTCTCAAAAAAAAAAAAAA","GGTGCAGTGGCTCATGCCTGTAATTCCAGCGCTTTGGGAGGCAAAGGTGGGAGGACTGCTTGAGCCCAGGAGTTTGAAACCAGCCTGGGCAACATAGGGAGACTTCATCTGTATAAATAAATAAATAAATAAATAAATAAATAAGCTGGGCATGGTGGCATGCACCTGTGGTCCCAGCTACTTGAGAGGCTAAGGTGGGAGGATCACTTGAGCCCAGGAGGTTGAGGCTGCAATGAGTCATGATCACGCCACCACACTCCAGCCTGAGCTACAGAGTGAGGTCTTGTCTCAAAAAAAAAAAAAA"
"chr1","14939274","14939572","chr8","15910614","15910909","66","971340","GGCCAGGCGAGAGGCTCACACCTGTAATCCCAGCACTTTGGTAGGCTGAGGTGGGAGGATCACTTGAGACCAGGAGTTCGAGACCAGCCTGGGCAACAAGTGAGACCCTGTCTCTACAAACAAAATGTTTTAAAAATTAGCCAGGCATGGTGGTGTGTGCCTGTAGTCCTAGCTACTCGGGAGGCTGAGGTGGGAGGATGACTTGAGCCCAGGAGTTTGAGGCTGAAGCGAGCAATGATCCTGCCATGGCACTCCAGCCTGGGAGGCAAGAGCAAGACCCTGTGTCTAAAATGAATAAA","GGCCAGGCGAAGTGGCTCACACCTGTAATCCCAGCACTTTGGGAGGCCAAGGCAGGAGGATCATTTGAAGCCAGGAGTTCAAGGCCAGCCAGAGAAACATAGTGAGAACCTGTCTTTACAAAAATTAAAATTAAAATTAAAATTAGCCAGGAGTGGTGGTGCATGCCTGCAGTCCCAGCAGCTCAGGAGGCTGAGGTGGGATGATTGCTTGCACCAGGAGTTCGAGGCTGCAGTGAGCTGTGATCGTGCCACTGCACTCCAGCCCCTGGGTGACAAAGCAAGATCCTCTAAAAAAA"
"chr1","15031602","15031907","chr10","65849492","65849800","74","50817890","GGCTGGGCGCCTTGGCTCATGCTTGTAATCCTAGCACCTTGGGATCTTCCAGGAGGATTGCTTGAGTCCAGGAGCTCGAGACTAGCCTGGACGACATGGTGAGACCTCATCTTTACAAAAAATAATAATTAAAACAATACGCTGATTGTGGTGGTGCATGCCTGTGGTCCCAGCTACTTGGTAGGCTGAGGTGGGATGATTGCTTGAGCACAGGAGGTTGAGGCTGCAGTGAGTCATGTTCATGCCACTGCACCCCAGCCTGGGTGACAGAGCAAGATCCAGTCTCTAAAACCAAACCAAAGCAAA","GGCCAGGTGTACTGGCTCATGCTTATAATCCCTGCACTTTGGGAGGCTGAGGTGGGAGGATTGTCTGAGGCCAGGAGTTTGAGACCAGCCTGGGCAACAGAGTGAGACCTTGTATCTTAAAAAAAAAAAAAAAAAAAAAAAAAAGCAGGGTATGGTGGTGCACACCTGTGGTCCAAGCTACTCGGGAGGCTGAGTGTTGGAGGATTGCTTGGGCCCAGGAGGTCGAGGCTGCAGTGAGCTGTATTCATGCCAGTGCACTCCAGGTTGGGTGACAGGGTGAGATTCTGTCTCAAAAAACAAACAACAAAA"
"chr1","15130471","15130556","chr20","87144","87254","58","15043327","GGCCAGACATGGCAGTTCATCCTTGTAATCCCAGCACTTTGGGAGGCCAAGGCAGGAGGATCACTTGAGGCTAGGAATTCAAGATC","CCTGGGCAACATAGTGAGACTACATCTCTACACTCACGCACACACACACACACACACACACACCCCCCAAATTAGCCAGGCATGCTGATGTGCACCCATAGTCTCAGCAAC"
"chr1","15132585","15132702","chr20","87144","87254","62","15045441","GGCCTGGTGTGGCTGGTCACACCTGTAACCTCACACTTTGGGAGGCCGAGAGGGGAGGATAGCTTGAGGCCAGGAGTTTGAGACCAGCCTGGGCATAGAAAGACCCCATCTCTACAAA","CCTGGGCAACATAGTGAGACTACATCTCTACACTCACGCACACACACACACACACACACACACCCCCCAAATTAGCCAGGCATGCTGATGTGCACCCATAGTCTCAGCAAC"
"chr1","15147497","15147717","chr17","17826312","17826529","62","2678815","GGCGCGGTGGCTCACACCAGTGATCCTAGCACTTTGGGAGGCCAAGGCAGGTAGATCACTTAGGCCCAGGATTTTGAGACCAGCCTAGGTAACGTAGCAAGAACCCCATCTCTACAAAAAAAAAAATTAAAAATTAGCCAGGTGTGGTGGTGCATGCCTGTAGTCCCAGCTACTCAGGAGGCTGAGATGGAAGAATCACTTGAGCCCAGCAAGTGGAGGCT","GGCCAGGCGCGGTGGCTCACACCTGTAATCCCAGCACTTTGGGAGGCCGAGGCAGGAGGATTGCCTGAGGCCAGGAGTTTGAGATCAGCCTGGCCAACATGGTGAAACCCCGTCTCTACTTAAAAAAAAAAAAAAAAAAAAAAAAATAGCCAGGCTGGTGATGTACACCTGTAGTCCCAGCTACTCAGGAGGCTGAGGCAGGAGAATCACTTGAGCTC"
"chr1","15148810","15149109","chr8","15910614","15910909","66","761804","GGCTGGGCGCGGTGGCTGACACCTGTGATCCTAGCACTTTGGGAGGCCAAGGCAGGTGGATCACTTAAGCCCAGGATTTTGAGACCAGCCTGGGTAACGTAGCAAGACCCCCATCTCTACAAAAAAATTTAAAATTTAAAACTTAGCCAGGTGTGGTGGTGCATGCCTGTAGTCCCAGCTACTCAGGAGGCTGAGATGGAAGAATCACTCGAGTCCAGGAAGTGGAGGCTGCAGTAAGCAGAGATTATGCCATTGCACCACAGCCTGGGTGACAGAGAAAGATCCTGTCTGAAAAAAAAA","GGCCAGGCGAAGTGGCTCACACCTGTAATCCCAGCACTTTGGGAGGCCAAGGCAGGAGGATCATTTGAAGCCAGGAGTTCAAGGCCAGCCAGAGAAACATAGTGAGAACCTGTCTTTACAAAAATTAAAATTAAAATTAAAATTAGCCAGGAGTGGTGGTGCATGCCTGCAGTCCCAGCAGCTCAGGAGGCTGAGGTGGGATGATTGCTTGCACCAGGAGTTCGAGGCTGCAGTGAGCTGTGATCGTGCCACTGCACTCCAGCCCCTGGGTGACAAAGCAAGATCCTCTAAAAAAA"
"chr1","15208341","15208582","chr12","71868675","71868924","59","56660334","GCCAGGCATGGTGGCTCATGCCTGCAATCCCAGCACTTTGGTAAGGCCGAAGCAGGAGGATCGCTTGAGGCCAGGAGTTCAAGACCAGCCTGGGCAACACAGCAAGATTCCATCTCTACAAAAAGATTAAAAATTAAAACATTAGCTGGGTGTGATGGTGTGCACCTGTAATCCCAGGTACTTGGGAGGCTGAGGCGGGAGGATCACTTGAGCCCAGGAGTTCGAGGCTGCAGTGAGCTATG","GCCAGGCATGGTGATTCGCGCTTGTGATTCCAATGCTTTGGGATGCCGAGGTGGGTGGATCACCTGAGGCCAGGAGTTCAAGACCCGCCTAGGCAGAAAAGCAAGATGTCATCTCTAACAACAACAACAACAACAACAACAAAAAGTTAGCCAGGCATGGTGGTATGCACCTATAGTCCCAGCTACTTGGGAGGCAAAGGCGAGAAGATCACTTGAGCCCAGGAGTTCAAGGCAGCAGTGAGATATGATC"
"chr1","15295327","15295606","chr1","164929853","164930117","75","149634526","GGCCAGGCATAGTGGCTCCCATCTGTAATCCCAGCACTTTGGGAGGCTGAGACAGGAGGATCACTTAAGCTTAGAGGTTTGAGACCAACTTGGATAACATAGCAAGATCCTGTCTCTACAAAAAATTAAAAATTAGCCAAGCACGGTAGCATGCACCTGTAGTCACAACTACTTGGGAGCCTGAAGTGGGAAGATCAATTGAGCCCAGGAGGTCAAGGCTGCAGTGATCCATGATCATGCTACTGCACTCTAGCCTGGGTGACAGAGCGAGACCCTGTCT","GGCCAGGTGTAGTGGCTCACACCTGTAATCCCAGCACTTTGGGAGGCTGTGGCGTCAGGATCACTTAGAGTCAGGAGTTTGAGACCAGTCTGCACAACATAGCCAGACCCATCTCTACAAAAAAAAAAAAAAAAAAAAAAAAAATCCTAGCTACTTGGGAGGCCGAGATGAGAGGATCACTTGAGTCCAGGAGTTCAAGGCTGCAGTGAGCTATGATCCTGCCACTGCACTCCGGCCTAGGTGACAGAGTGAGACCAAAAAAAAA"
"chr1","15319481","15319606","chr19","6391716","6391877","50","8927765","CCAGGTGCAGTAGCTCACGCCTGTAATCCCAGCACTTTGGAGGCCGAGACAGGAGGATTGCTTTAGACCAGGAGTTCAGGACCAGCCTGGCCAACACAGTGAGGCCCTGTCTACAAAAAATTAAAA","CCAGGCGCAATGGCTCACGCCTGTAATCCCAACACTTTGAGAGGCCGAGGCAAGAGGATTGCTTGAGGCCAGGAGTCCGAGACCAGCCTGGGCAACACAGCGAGGCCTCATTCTCTACAAAAAATAAATATATAAATAAATAAATAAATAAGAAGAAGAAAA"
"chr1","15332427","15332728","chr5","177155309","177155607","75","161822882","GCCAGGTGTAGTGGCTCATGCCTGTGATCCCATCAACATAAGAGGCTGAGGCAGGAGGATCATTTAAGGCTTGAAGTTCAAGACCAACCTGGGCAACATCGTGAAACCCCTCATCTCCAAAAAATTTAAAAAATAATAATAAATTAGCCAGGCATGGTGGCACAGGCCTGTAGTCCCAGCTACTCATGAGGCTGAGCCAGGAGAATCCCTTGAGGCTAAGATTTCAAGGCTGCAGTGAGCTATGATTACTCCACTGCACTGCAGCCTGTGTGATAGTGAGACCTTGTCTAAAAATAAATAAA","GGCCAGACATGGTGGCTCATGCCTGTAATCCCACACTCTGGGAGGCTGAGGTGGGAGGATCACTTGAGGCCAGGAGTTCAAGACCAGCCTAGGCAACACAATCTCCACCAAAAAAAAAAAAAAAAAAAAAAAAAAAATAGCAATTAGCCAGGCATGGTGGCACATACCTGTTGGTCCCAGCTCCTCGGGAGACTGAGGCAGGAGGATCGTTTGAGCCCAGGAGTTCAAGGCTACAATGAGCCGTGACACGCCACTGCACTCCAGCCTGGGTGTGAGACCCTGTCTCCAAAAATAAAGAA"
"chr1","15342667","15342959","chr19","36137286","36137590","74","20794619","GCTGGGTGTGGTGGTGTGTGCCTGTGGTCCCAGCTACTTGAGAGACTGAGGTGGGAGGGTCACTTGAGCCCAGGAGTTCAAGACCAGCCTGGGCAACATTGCAAGATCCCATCTCTACAAAAAAAAATAATAATTAGCTGGGTGTAGTGCCATATGCCTGTGGTCCCAGCTACTTGGGAGGCTGAGGTGGGAGGACCACTGCAGCCTGGGAGTTCGAGGCTGTGGTGAGCTATGGTCACACTATTGCACTCCAGCCTGGGCAACAGAGCAAGACCCCATCTTAAGAAAAAAAA","GGCTGGACATGGTGGCTCATGCCTGTAATCCCAGCACTGTGGGAGGCCGAGGTGGGAGGATCACTTCAGACCAGAGTTTGAGACCAGCCTGGCCAACATAGTGAGACCTCATCTCTACAAAAAAAAAAAAAAAAAAAAAAAAAAATTAGCTGGGCATAGTGCCACATGCCTTTGGTCCCAACTACTTGGGAAGCTGAGGCAGAAGGACTGCTTGAGCCCAGAAGTTCAAGGCTGCAGTGAGCTATGATCATGCCACCGCACTCCAGTCTGGGCAATGGAGCAAGACCCCGCCTCAAAAAAATAAA"
"chr1","15342960","15343094","chr5","32595015","32595178","52","17252055","CAGGTATGGTGGCTCATACCTGTAATCCCAGAACTTTTGGAGGCTGAGGTGGGAGGATCACTTGATGCCAGGAGTCTGAGACCAGCCTGGGCAACATAGAGAGAGACCTCATTTCTACAAAAAATAAAAATATTA","GGCCGGGTGTGGTCCCTCATGCCTGTAATCCCAACACTTTGGGAGGCTGAGATAGGAGGACTGCTTGAGGCCAGGAGTTCAAGACCAGCCTGGTCAACATAGTGAGACCCCATCTCTATAAAATAATAATAATAATAATAATAATAATAATAAATAAATAAATA"
"chr1","15373571","15373839","chrX","3592780","3593062","79","11780791","GGCTGGTTACAGTAGCTCATGCCTGTAATCCCAGCACCTTGGGAGGCGGAAGCAGGAGGATTGCTTGAGCTCAGGAGTTTGAGACCAGCGTGGGCAACAAAGCGACATCCTGTCTCTACAAAAAAATAGAGAAAAATTAGTCGGGCGTGGTGGCACACACTTGTAGTTCCAGCTGCAGAGCTGGAAGGATCGCTTGAGCGCAGAGGTAGAGGCTACAGTGAGCCGTGATCATGCCATTGCATTCCAACCTGGGCAACAGAGCAAGACCC","GTGGTGGCTCATGTCTGTAATCCCAGCACTTCAGGGGGCCAAAGCGAGAGGACTGCTTGAGGCCAGGAGTTTGAGACCAGCCTGCGCAACATAGAAAGACCCCATCTCTATAAATAAATAAATAAATAAATAAATAAGTCAGGCATGGTGGCACATGCCTGTAGTCCCAGCTACTCAGAAGGCTGAGGTCGGAGGATCTCTTGAGCCCAGGGGTTCAAGGCTGCAGTGAACCATGATCACACCAGTGCACTGCAGCCTGGGCAACACAGCAAAACCCTGTCCC"
"chr1","15387467","15387603","chr5","32595015","32595178","49","17207548","GGCTGGGTGCGGTGGCTCACGCCTGTAATCCTAACACTTTGGGAGGCCGAGGCAGAAGGATGACTTGAGGCCAGGAGTTTGAGACCAGCCTGGGCAACATAGCACGACCCCCATCTCTACAAAAAACAAAAAAATTA","GGCCGGGTGTGGTCCCTCATGCCTGTAATCCCAACACTTTGGGAGGCTGAGATAGGAGGACTGCTTGAGGCCAGGAGTTCAAGACCAGCCTGGTCAACATAGTGAGACCCCATCTCTATAAAATAATAATAATAATAATAATAATAATAATAAATAAATAAATA"
"chr1","15399285","15399579","chr10","100799003","100799317","70","85399718","GGCCAGGCATGGTGGCTCACATCTGTAATCCTAACACTTTGAGAGGCTGAGGCAGGAGGATTGCTTGAGCCTAGGAGTTCCAGATCAGCCTGGACAACACAGTGAGACCCTGTCTCTACAAGAAACTTAAAAATTAGCTGGCATGGTGGTGTGTGCCAGTAGTCACCACTATTTGGGAGGCTGTGCTGGGAGGATCGCTTGAGCCCAGGAGGTTGAGGCTGCAGTGAGCTATGACTGTACCACTGCATTCCAGCCTGGGCAACAGAGCAACACCTTGTCTCAAAAAAAAAATAAA","GGCTGACCATGGCAGCTCACATCTGTGATCCTCGCACTTTGGGAGGCTGAGGAAGGAGGATGGCATGAGCTCAGTAGTTCGAGACCAGCCTGGACAACATAGCAAGACCTCTCTCTACTAAAAAAAAAAAAAAAAAAAAAAAAAAAAATTAGCTGGGTGTGGAGGTGTCTGCCTGTAGTCCCAGCTACTTGGGAGACTGAGGTGGGAGGATCGCTTGAGCCCAAGAGATTGAGGCTGCAGCGAGCTATGATTGTGTCACTGCACTCCAGTCTGGGCAACAGAGCAAGCGAGACCCTGTCTAAATAAATAAATAAA"
"chr1","15416816","15417110","chr8","25360790","25361095","63","9943974","GGCTGGGCGTGGTGGCTCATGCCTGTAATCCCTGCACTTTGGGAGGATGAGGTGGGAGGGTGGCTTGGGGCCAGGAGTTTGAGACCAGTCTGAGCAACATAATGAGACCCCATCTCTACAAAAATAAAAAAAAATTAGCTGGATGTGGTGGCATGTGCCTGTAGTCCCAGCTACTCAGGAGGCTGAGGTGGGAGGATCACTTAAGCCCAGGAAGTTGAGGCTGCAGTGAGCTATGATCGTACCACTGCACTTGGTCTGAGTGACAGAGCAAGACTCTGTCTCTTAAAAAAAAAAA","GGCTGGGAGCAGTGGCTCATACCTGTAAGCCCAGCACTTTGGGAGGCTGAGGTGGGAGGATTGCTGAAGCCCAGGAGTTTGAGACCAACCTGGGCAATGTAGGGAGACCCCGTCTCTACTAAATAAATAAATAAATAAATAAATAAAGTCGGGCATGGTGGCATGTGCCCTGTAGTCCCAGCTTCTTGGGAGGCTGAGGTGGGAGGATTGCTTGGGCCCAGGAATCAAGGCTGCAGTGAGCTGTGATTGTGCCACTGTACTACAGCCTGGGTGACAGTGCAAGACTGTCTCAAAAGAAAAACAAAA"
"chr1","15431540","15431662","chr9","47045786","47045941","56","31614246","GGGCATGGTGGCTCACACCTGTAATCCCAGCACGTTGGGAGGCCGAGGTAGAAGGATCACTTGAAGCCAGGAATTCAAGACCAGTCTGGGCAACATAGTGAGACCCGATCTCTACAAAATATA","GCTGGGCGCAGCAGCTCACACCTGTAATCCCAGTGCTTTGGAGGTCCAAGGTAGGAGGATTGCTTAAGACTAGGTGTTCAAGACCAGTCTTGGCAACATAGTGAGAACTCATCTCTACAATAAATAAATAAATAAATAAATAAATGAAAATAAAAA"
"chr1","15434056","15434367","chr14","31798968","31799292","73","16364912","GGCTGGGCATGGTGGCTCGTGCCTGTAATCCCAGCTACTCAGGAGGCTGAGGTGAGAGGATCCCTTGAGGCCAAGAGTTCAAGACCAGCCTGGGCAACATGGCGAGACCCCTGACTCTAAAAGAATTTAAAAAATTACCTGGGTGTGGTGGCACATGCCTGTAGTCCCAGATACTCTAGAGGCTGAGGTGGGAGGACTACTTGAGGCCAGGAATTTGAGGCTGCAGTAAGCTATGATCATGCTACTGCATTCTAGCCTGGGTGACATAGAGAGACCCCAACTCCAAAAAATAAAACATAAAAAAATGAAAAA","GGCTGGGCACAGTAGCTTACACCTGTAATCCCAGTACTTTGGAAGGCTGAAGTGGGAGGATCCCTTGAGGCCAGGAGTTTGAGACCAGCCTGGGCAACATAGTGAGACCCTGTCTCTACAACAAACAAACAAACAAACAAACAAAACTTAGCCAGTTGTGGTGGCACATCCTATAGTCCCAGCTACTCAGGAGGCTGAGGAGGGAGGATCTCTTGAGCCCAGGAGTTTGAGGCTGCAGTGAGCTATGATCATGACACTGCACTCCAGCCTGGATAACACAGCAAAATCCTGTCTCAAAAAAAAAAAAAAAAAAAAAAAAAAAGAA"
"chr1","15441695","15442041","chr20","48305651","48305992","112","32863956","GGCCAGGTGCGTTGGCTCATGCCTGTAATCCCAGCACGTTGGGAAGCCGAGACGGGGGGATTGCTTGAGGCCAGGAGTTTGAGACCAGCCTGAGCCACATGGCAAATCCCCATCTCTACAAAAAATAGAAAACTTATGGTGAGGTTTGGGCTTCTAAGTTAAAAAACAAACAAACAAACAAAAAACAAGAAGAAAAATTAGCTGGGAATGCGTGGTGGCGTGTGCTTATAGACCCAGCTACTCGGGAGGCTAAGGTGGGAGGATTGCTTGAGCTCAGGAGGTCAAGGCTACAGTGAACCATGATGGTACCACTAAATGAGACTCTGTCTCTACCAAAAAAAAAAAAA","GGCTGGGTGTGGTGGCTCACGCCTATAATCCCAGCCCTTTGGGAGGCTGAGGTGGAAGGATTGCTTGAGTCCAGGAGTTTGAGACCAGCCTGGGCCATATAGTGAGACCTTGTATCTACAAAAATAAATAAATAAATAAATAAATAAATATAAATTTTAAAAAAAAGGAAGAAACGAAAGAAAAAAATTAGCCGGGTATGATAGCATGCACCCATAGTCCCAGCTGCTCAGGAGGCTGAGGCGGGAGGATTGCGTGAGCCCAGGAGGCTGCAGTGAACTGTGATCTCCAGCCTGGGTGACAGAGTGAGAACCTGTCTTAAAAAGAAAAGAAAAGAAAAAGAA"
"chr1","15443979","15444288","chr14","43050155","43050466","77","27606176","GTGGCGGCTCACACCTGTAATCCCGACATTTTAGGAAGCTGAGGAGGAAAGATCACTTGAGGCCAGGAGTTCAAGACCAGCCTGGGCAACATAGTGAGACCCTGCCTCTACAAAAAAAAAATTTTTAAATAGCAGTGTATGGTGGTGTGTACCTGTAGTCCCAAACTACTCAGGAGGCTGAGGTGAGAGGATCATTTGAGCCCAGGGGTTTGAGGCTGCAGTGAGCTATGATCTTGCCACTGCTGTCCAGCCTGAGCAACAGAGTGAGACCTTGTATGTATCAAAAAAAAAAAGAAAGAGAAATAGAAAA","CGTGGCAGCTCACACCTATAATCCCAGCATTTTGGGAGGGTAAGGCAGGAGGATCACTTGAGCCTAGGAGTTCAAAACCAGCTTGGGCAACATAATGAGACCTTGTCTCTAAAAAAAAAAAAAAAAAAAAAAAAATTAGCTAGGTATGGTGGCACGTGCCTGTAGTCCCGGTTACTCACAAGGCTGAGGTGGGAGAATCACTTGAGCCCAGGATACTGAGTCTGCAATGAGCCATGATTGTGCCACTGCTGCACTCCATCCTGGGTGACAGATCAAGGTCTTGTCTCAAAAAAAAAAAAAAAAAAAAAAGAA"
"chr1","15468525","15468801","chr5","63802202","63802507","85","48333677","GGCCAGGTGCCATGGCTCATGCCTGTAATCGCAGCACTTTGGGAGGCCAAGGAGGGAGGATTGCTTGAGCCCAGGAGTTCAAGAGCATCCTGGGCAACATAGCAAGACTCTGTCTTTACAAAAAAATTTTTTTTAATTACTCAGGCACGGTGGTACATGCCTGTAGTCTCAGCTACTTGGGAGGCTTGGGTGGAAGGATCACTTGGGCCCGGGAGGCCAACGCTGCAGTGAGCACTTAAGCCTGGGCGACATAGCAAGACCCTGTCTCCAAAAATAA","GACTAGGGGTGGTGGCTCATGCCTGTAATCCCAGCACTTTGGGAGGCTGAGCTGGGAGGATTGCTTGAGCCCAGAAGTTCAAGACCAGCCTGGGCAACATAGCAAGACTCCATCTCTAAAAAAAAAAAAAAAAAAAAAAAAAAAAAATTAGCCCCGAGTGGTGGTGTGCACTTGTAGTCCCAGCTACTCAGGAGGCTGAGGTGGGAGGATCTCTTGAGCCTGGGAGGTCCAGGCTGCAGTGAACCATGATTGTGCCACTGGACTCCAGCCTAGGCAATAGAGTGAGACCTTGTCTCAAAAATAAAA"
"chr1","15488105","15488395","chr8","15910614","15910909","72","422509","GGCCAGGTGCCATGGCTCATGCCTGTAATCGCAGCACTTTGGGAGGCCAAGGAAGGAGGATTGCTTGAGCCCAGGAGTTCAAGAGCAGCCTGGGCAACATAGCGAGACTCTGTCTTTACAAAGATTTTTTTTTTTAATTAGCCATGGTGGTGCATGCCTGTAGTCTCAGCTGCTTGGGAGGCTGAGGTGGAAGGATCGCTTTGGCCCAAGAGGTGGAGCCTACAGTAAGCCAAGGTCGCACCACTGCACTGCAGCCTGAGCGACATAGCAAGACCCTGTCTCTGAAAATAA","GGCCAGGCGAAGTGGCTCACACCTGTAATCCCAGCACTTTGGGAGGCCAAGGCAGGAGGATCATTTGAAGCCAGGAGTTCAAGGCCAGCCAGAGAAACATAGTGAGAACCTGTCTTTACAAAAATTAAAATTAAAATTAAAATTAGCCAGGAGTGGTGGTGCATGCCTGCAGTCCCAGCAGCTCAGGAGGCTGAGGTGGGATGATTGCTTGCACCAGGAGTTCGAGGCTGCAGTGAGCTGTGATCGTGCCACTGCACTCCAGCCCCTGGGTGACAAAGCAAGATCCTCTAAAAAAA"
"chr1","15522436","15522716","chrX","46692258","46692555","81","31169822","GGCCGGGTACAGTGGCTCACACCTGTAATCCCAACACTGAGGCAGGAGAATCACTTGAGGCCAAGAGTTTGAGACTCATCTAGGCAACATAGCAAGACTCCTATCTGTACAAAAAAAAAATTTTTTTTAATTAGCCAGGCATGGTGGCATGTGCCTAAAGTCCCAGCTGCTCTAAAGGCTGAGGCAGGAAGACCACTTAAGCCCAGGAGGTCAAGGTCGCAGTGAGCCATGATCTCATCCCTGCACTCCAGGCTGGGCAAGAGTGAGACCCTGCCTCAAAA","GGCCAGGCATGGTGGCTCATGCCTGTAATCCCAGCACTTTGGGAGGCTGAGGAAAGATGATCACTTGAGCCAGGAGTTTGAGCCCAGTCTGGGTAACATAGTGAGACCTCCATCTCTACAAAAAAAAAAAAAAAAAAAAAAAAAAGCTGGGCATGGTAGCACACATCTGTAGTGTCAGCTACTCAGGAGGCTGAGGTAGGAGGATTGCTTGGGCCCAGGAGATCAAGACTGCAGTGAGCTATGACTGCACCACTGCACTCCAGCCTGGGCAATGGAGTGAGACCCTGTCTCAAAAAAA"
"chr1","15535764","15536026","chr7","7616254","7616509","85","7919510","TGTGAGGCCAAGGTTTGGAGGATCCCTTGAAGCCAGGAGTTCAAGACCAGCCTGGACCACATAGCATGACTTTGCTACAAAAAGAAAAAAAAAAATCGGCCAGGCATGGTGGTGCGTGCCTATAGTCCTAGCTACTTGGGAGGGTGAGGTGAGTGGGAGATTGCTTGAGCCCAGTAGTTGAAGGCTGCAGTGAGCTGTGATCGCATCACTGTACTCCAGCCTGGGTGACAGAGACAGACTGTCTCTTAAGAAAAAAGAAAAAA","GGCCATGCACGGTGGCTCACACTTGTAATCCCAAAACTTTGGGAGGCTGAAGCAGATTTCATCTCTACAAAAAAAAAAAAAAAAAAAAAAAAATTGGCCAGGTGTGGTGGCATGAGCCTGTAGTCCCAGCTACTAGGGAGGCTGAGGTGGGAGGATCGCTTTGGCCCAGGAGTTTGAGGCTGCAGTGAGTTACGACTGTGCCTCTGCACTCCAGCCTGGGTGACAGAGCGAGATCCTGTCTCTAAAAATATATAAA"
"chr1","15561749","15561846","chr20","87144","87254","61","15474605","CAGGCACGATGGCTCATGCCAGTAATCCCAACACTTTGGGAGCCTGAGGTAGGAGGATTGTCTGAGGCCAGGAGTTCAAGACCAGCCTGGGCAATATA","CCTGGGCAACATAGTGAGACTACATCTCTACACTCACGCACACACACACACACACACACACACCCCCCAAATTAGCCAGGCATGCTGATGTGCACCCATAGTCTCAGCAAC"
"chr1","15589107","15589408","chr6","157423301","157423612","73","141834194","GGCCAGGTGTGGTGGCTCACACCTGTAATCCTAACACTTTGGGAGGCCAAGGTGGGAGGATCCCTTGAGGAGTTCAAGACCAGCCTGGACAACATAGTGAGACCCTCATAATTACAAAAAAAATTTAAAAAATATTAGCCAGTTGAGGTGGCATGAGCCTGTGGTCCCAGCTACTCAGGAGGCTGAGGTGGGAGGATCAGTTGAGTCCTAGGATTCAAGGCTGCAGTGAGCCACGACAGTACCACTGCACTGCAGCCTGGGAGACAGAGCCAGACCCTGTCTCTCAAAAAAGTTAAAAAAAA","GGCTGGGCGTGGTGGCTCACACCTGTAATCCTAGCACTTTAGGAGGCCTAGGTGGGAGGACTGCTTGAGCCCAGGAGTTTGAGACCAGCCTGGGCAACACAGTGAGACCTCATCTCTACTAAAAAAAAAAAAAAAAAAAAAAAAAATCAGCCAGGTATGGTGCCATATCCCTGTAGTCTCAGCTACTTGGGAGGCTGAGGTGGGAGGATCACTTAAGCCTGGGAGATGGAGACTACAGTGACCCATGATAGCACCACTGCACTCCAGCCTGGGCAAGAGAGCGAGACTTGGTCTCAAAATGAAACAAAGAAA"
"chr1","15589905","15590212","chr9","68878569","68878883","62","53288664","GCTGGGTGTGGTGGCTCATGCCTATAATCCTAGCACTTTGGGAGGCCAAGATGGCAGGATTGCTTGAGACCAGGAGTTTGAGACCAACCTGGGCAACATAGTGAGAACTTATCTCTACGAAAAAATCTAAAAAAAAGTTAGCTGGGCATGGTGATGCATGCCTCTTGTCCTAGCTACTCAGGAGACTGAGGTGGGAGGATTGCTTGAGCCCAGGAGGTAGAGAGATGCTGCAGTGAGCCATGATCGCACCACTGCACTCCAACCTGGGTAACAGAGTGAAAATCTGTCTCTAAATAAATAAATAAAAA","GGCTGGGCACGGCAGCTCATGTCTGTAATCCCAGCACTTTGGGAGGCCAAGGTGGGAGGATTGCTTGAGTCCAGGAGTTCAAGACCAGCCTGGGCAACATAGTGAAACCCCAGTCTCTACAAATAAATAAATAAATAAATAAATAATTAGCTGGGCATGTTGATGCATGCCTGTAGTCCTAGCTACTCGGGGGGTGAGGTGAGAGGATTGCTTGAGTCCAGAAGGTGGAGGCTGCAGTGAGCTATGATCACACCACTGCACTCCAGCCTGGAAGACAGGGTGAGACGCTGTCTTTAAAAAAAAAAAAAGAAAAGA"
"chr1","15602106","15602429","chr7","7056350","7056674","84","8545756","GGTAGCTCAGGCCTGTAATCCCAGCACTTTGGGGGGCTGAGGCAGGTGGATTGCTTGAGACCAGGAGTTCGAGACCAGCCTGAGAAACATAGCAAGACCCTTTCTCTATAAAAAGAAAATTAAAATATACAAAAATATATAATTTAATTTTAAAAAATTAGTCTGGCATGGTGATGCAGGCCTGCAGTCCCAGCTACTCAGGAGGCTGAGGCAGAAGTATCACAGCAGATCGAGGTTGCAGCGAGCTGTCATGGCACCACTGCACTGCAGCCTGAGCGACACAGCAAGACCCTGTCTCAAAAACAAAACAAACAAACAAAAAAA","GGCTGGGCACGGTGGCTCATGCCTGTAATCCCAGCAATTTGGGAGGCCAAGGCAGGAGGATTGCTTAAGGCCAGGAGTTCAAGACCAGTCTGGGCAACATAGCGAGACCCCATCTCTAAAAAAAAAAAAAAAAAAAAAAAAAAAAAAAATTCAAAACATTAGCTGGGCATGGTGGCACTGCCTGGAGTCCTAGTTACTCGGGAGGCTGAGGCAGGAGGATCATCTGAGCCTAGGAGGTAGAGGCTGCAGTGAGCTATGATTGCACCACTGTACTCCAGCATGGGTGACAGACCAAGACCCTGTCTCAGAGAAAAAAATAAAAAAA"
"chr1","15614973","15615349","chr1","112998725","112999079","105","97383752","GGCTGGGTGCGATGGCTCACATCTGTAATCCCAGTACTTCGTGAGGCCAAGGTGGGAGGATCACTTGAGGCCAGGATTTGGAGATTAGCCTGGTCAACATAGCAAGGACTCATCCCTATTTTTTTTAACTAAAAATAATGTAAAATCATAATAAAAAGGAAATCAAGCCTGGGCAACATAGCAAGATCTCATCTCTACTAAAAAGAAATTAGCTGCGTGTGGTGGTGCACACCTGTAGTTCCAGCTGCTGGGGAGGTTGAGCTGGAGGGATCACTTGAGCCCTGGAGGTTGAGGCTGCAGTGAGCCATGATCGTGCCACTGCACTCCAGCCTGGGTGACAGAGCCAGACCCTGTCTTGATAAAAAAAAAAAAAAAAA","GGCTGGACATGGTGGCTCACGCCTATAATCCCAGCACTTTGAGAGGTTGAGGTGGGTGGATAGCTTGAGACCAGGAGTCGGAGACCAGCCTGGGCAACAAAATGAGACCCCATCTTTAAAAAAAAAAAAAAAAATAAAAAAAAAATATATATATATATATATATAATATATAGATATATATATATATATATATATATATCTGGGTGTGATGGTATGCACCTGTAGTGCCAGCTACTCAGGAGGCTGAGGCAGGAGGATCATTTGAGCCCGAGTTTGAGGTTGCAGTGGGCTATGATCATGCCACTGCACTCCAGCCTGGGTGACAGAGCGCGACCCTGTATCAAAAAATAAAAAA"
"chr1","15622074","15622323","chr15","26873577","26873832","84","11251503","GGCCAGGTGCAGTGGCTCACACATGTAATCCCAACACTCTGGGAGGCAGAGGCAGGAGAACTGCTTGAGGTTAGGAGTTCAAGCCTAGCACTGGCAAGACCTCGTCTCAAAAAAAAAAAAAAAAAGTCGCAGCTACTTGGGAGGATCCCTTGACCCCAACATGTTGAGGATACAGTGAGCTGTGATTGCAACACTGCATTCCAGCCTGGGCGAGAGCGAGATCCCATCTCTAAAATATAAAGAATAAAGA","GGTCAGGCACAGTGGCTCACTCCTGTAATCCCAGCACTTTGGGAGGCCAAAGCAGGAGGATTATTTGAGCCCAGGAGTTCAAGGCCAGCCTGGCCAACATAGTGAGATCTTGTCTCTAAATAAATAAATAAATAAATAAATAAATAAATGAGGTGGGAGGATTGCTTGAGTCCCAGGAGGTTGAGGCTGCAGTGAGCCAGGATCATACCACTGCACTTCCACCTGGGTGTCAGAGCAAGACCTTGTCTTAAAAAAA"
"chr1","15623382","15623557","chr12","4864673","4864880","60","10758709","GCCAGGCATGGTAGCATATGCCTGTAGTCTCAACTATTTGGGAGACTGAAGCTGGAGGATCACCTGAGCCCAGGAGTTCGAGGTTGCAGTGAGTTATGATTGTACCACTGCACTCCAGCCTGGGCAACAGAATAAGATCTTGTCTCTTAAAAAAAAAAAAAAAAAAAAAAGAAGAA","AATTAGCCAGGTATGGTGGTGTGCACATGCAGTCCCAGCTGTTTGGGAGGCTGAGGCAGGAGGATCACTTGAGCCCAGGAGTTTGAGGCTGCAGTCAGCTATGATCATGCCACTGCACTCCAGCCTGGACAACAGAACAAGACCCTGTCTCAAAAACAAAACAAAACAAAACAAAACAAAACAAGAACAGAAAACAATCAAACAAAAA"
"chr1","15623584","15623701","chr20","87144","87254","65","15536440","GGCTGGGTGCCATGGCTCACGCCTTAATTCCAAAACTTTGGGAGGATGAGGTAGGAAGATCATTTGAGGCCAGGAATGCAAAGCCAGCCTGGGCAATACAGCAAGACCCCATCTCTAA","CCTGGGCAACATAGTGAGACTACATCTCTACACTCACGCACACACACACACACACACACACACCCCCCAAATTAGCCAGGCATGCTGATGTGCACCCATAGTCTCAGCAAC"
"chr1","15632913","15633228","chr9","68878569","68878883","77","53245656","GGCTGGGTGTGGTAGCTCATGCCTATAATCTCGACACTTTGGGAGGCTGAGGTGGGAGGACCGTTTGAGCCTAGGAGTTCGAGACCAGCCTGGGCAACATAGCAAGACCTTGTCTCTACAAAAAATATAAAAATTAGTTGGGCGTGGTGGTGCATGCCTGTAGTCCCAGCTACTGTTGGATGGGGGTTCAAGGGTGGGGGGATGGCCTGAGCCCAGGAGGTCGAGGATGCAGTGAGCTGTGATCGCACCACACACTCCAGCCTGGGTGACATGGTGAGACCCTGTTTTTTTTTTTTTAAAAAAAAAAAAAAAAAAA","GGCTGGGCACGGCAGCTCATGTCTGTAATCCCAGCACTTTGGGAGGCCAAGGTGGGAGGATTGCTTGAGTCCAGGAGTTCAAGACCAGCCTGGGCAACATAGTGAAACCCCAGTCTCTACAAATAAATAAATAAATAAATAAATAATTAGCTGGGCATGTTGATGCATGCCTGTAGTCCTAGCTACTCGGGGGGTGAGGTGAGAGGATTGCTTGAGTCCAGAAGGTGGAGGCTGCAGTGAGCTATGATCACACCACTGCACTCCAGCCTGGAAGACAGGGTGAGACGCTGTCTTTAAAAAAAAAAAAAGAAAAGA"
"chr1","15634978","15635249","chr11","117289294","117289598","80","101654316","GGTGGCTCATGCCTGTAATCCCAACACTTTGCTTGAAGCCAGGAGTTTGAGGCCAGCCTGGGCAGCAAAGTGAGACTCTGTCTTTACAAAAAATAAAATAAATTAGCCAGGTGTGGTGGCATGCACCTGCAGTCCCAGCTACTCAGGAGGCTGAGGCAGGAAGATCACTTGAGCCCAGTAGTTGGAGGCTGCAGTAAGCTATGATTGTACCACTGCATTCCAACCTGGGCAAGAGAGTGAGACCCCCATCTTAGGAAAAAAAAAAAAAGAAA","GGGGGCTTATGCCTGTAATTTCAACAACTTAGGAGGCTAAGGCAGGATGATCATTTGAGGCTAGGAGTTTGAGACCAGCCTGGGAAAAATAGAGAGACTTTGTCTCTTAAAAGTAAATAAATAAATAAATAAATAAATAGCCAGGGGTTGTGGCATACATCTATAGAGTCAACTACTTGGAAGGCTAAGGCAGGAGGATCTCTTGAGCCCAGGAGTTGAAGGCTGCAGTGAGCTATGATTACACCACTGCATTCCAACCAGGATGACAGAGCGAGACCCTGTCTCTAGGAAAAAAAAAAAAAAAA"
"chr1","15639481","15639699","chr10","102878352","102878592","74","87238871","TTGAGGCCAGGAGTTCCCAATCAGCCTACACAATACAGGGGAACCCTGTCTCTACAAAAAGTTAAAAAATCAGCCAGGTATGGTTGCACATGCCTGTGGTTCCAGCTACTTGAGAGGCTGAGGCTGGAGGATCACTTGAGCCCAGGAGTTGGAGGCTGAAGTGAGCTGACTGCACCACTGCACTCTAGCCTGGGTGACAGAGACCCTCTCTTTAAAAAA","AGGCCAGGAGTTCAAGACTAGCCTGGGCAATACAGTTACACCCCCATCTCTACAAACAATAATAATAATAATAATAATAATAATAATTAACTGGGCATGGTGGCATGCTCCTGTAGTCCCATCTACTTGGGAGGCTGAGGCAGAAGGATCACTTGAGCCCAGGAGGTTGAGGCTGCAGTGAGCTATGATCATCCCACTGCCTCCAGCATGGGTGGCAGAGTAAAACTGTGTCTCTAAAAAA"
"chr1","15645587","15645884","chr8","25360790","25361095","75","9715203","GGCTGGCCGGGATGGCTCACACCTATAATCCCAGTGCTTTAGGAGGCTCATGTGGGATGATGGCTTGAGGCCAGGAGTTTGAGACCAGCCTGGGCAACATAGGGAGAATTCGTCTCTACAAAAAATTTTTTTAAATAGCCGGGTGTGGTGGCAAGTGCCGATGGTGCCAGCTACTCGAGAGGCTAAGGCAGGAGGATTGCTTGAGCCAGGGAGATAGAGGCTGCAGTGAGCTGTGTTCATACTACTGTACTCCAGCTTGGATGACAATGAGAACTCGTCTCAAAAAAAAAAAAAAAAA","GGCTGGGAGCAGTGGCTCATACCTGTAAGCCCAGCACTTTGGGAGGCTGAGGTGGGAGGATTGCTGAAGCCCAGGAGTTTGAGACCAACCTGGGCAATGTAGGGAGACCCCGTCTCTACTAAATAAATAAATAAATAAATAAATAAAGTCGGGCATGGTGGCATGTGCCCTGTAGTCCCAGCTTCTTGGGAGGCTGAGGTGGGAGGATTGCTTGGGCCCAGGAATCAAGGCTGCAGTGAGCTGTGATTGTGCCACTGTACTACAGCCTGGGTGACAGTGCAAGACTGTCTCAAAAGAAAAACAAAA"
"chr1","15648952","15649075","chr1","217544386","217544536","59","201895434","GCTGGGTGTGGTGGCTCACTCTTGTAATCCCAGCACTTTGGGACGCCAAGGCAGGGATGACTGCCTGAGGCCAGAAGTTCAAGACCAGCCTGGTCAATATAGCGAGACTCAATCTCTACAAAAA","GGCTGGGCGTGGTGGCTCATGCCTCTAATCCCAGCACTTTAGGAGGCCAAGGCAGGAGGATAACTTAAGACCAGGCTGGGTGACACAGTGAGACTTTGTCTCTAAAAAAAAAAAAAAAAAAAAAAAAAAAAAAAACCTACAAAAACATATA"
"chr1","15653295","15653436","chr19","6391716","6391877","72","9261579","GGCATGGTGGCTCATGCCTGTAATACTTTGGGAGGCGGAGGCGAGAGGATCTGCTTGAGCCTGTGAGACTGAGACTGAGGCTGCAGTGAGCCATGGCTGCGCCACTGCACTCCAGCATGGGCAGCAGAGCAAGACTCTGTCT","CCAGGCGCAATGGCTCACGCCTGTAATCCCAACACTTTGAGAGGCCGAGGCAAGAGGATTGCTTGAGGCCAGGAGTCCGAGACCAGCCTGGGCAACACAGCGAGGCCTCATTCTCTACAAAAAATAAATATATAAATAAATAAATAAATAAGAAGAAGAAAA"
"chr1","15656023","15656139","chr8","58489091","58489211","63","42833068","GCTGAACACAGTGACTCTGGCCTGCAGTCCCAACACTTTGGGAGGTCCAGGAGGGAGAATCCCTTGAGGTCAGGAGTTCAAAATCAGCTGGGGCAACATAGTGAGACACCATCCCTA","TTGAGACCAGGAGTTTGAGACCAGCTTGGACAACATAGTGAGACCCTGTCTAAAAGAAAGAAAGAAAGAAAAGAAAGAAAGAAAGATGTAGCCAAGTGTGGTGGTGCACATCTGTGTCTCA"
"chr1","15673556","15673709","chr1","217544386","217544536","75","201870830","TTATGCGGCTGTGGTGGTGCATACCTGTAGTTGTAGCTACTGGGGAGGCTGAAGTGGGAGGATTACTTGAGCTTAGGAGGTCGAGGCTTCAGTGAGCCGTGATTGCACCGCTGCACTCCAGCCTGGGTGACAGAGCGAGGCTGTCTCAAAACAA","GGCTGGGCGTGGTGGCTCATGCCTCTAATCCCAGCACTTTAGGAGGCCAAGGCAGGAGGATAACTTAAGACCAGGCTGGGTGACACAGTGAGACTTTGTCTCTAAAAAAAAAAAAAAAAAAAAAAAAAAAAAAAACCTACAAAAACATATA"
"chr1","15674001","15674128","chr1","217544386","217544536","57","201870385","GGCCAGGCATGGTGGCTCACACCTCTAACTCCAGCACTTTGGGAGGCTGAGGTAGGAGGACTGTTTGAGCAGCTTGGGCAACATAGTGAGACCCTGTCCCAAGGAAAAATTAAAAATAAATTAGCCGG","GGCTGGGCGTGGTGGCTCATGCCTCTAATCCCAGCACTTTAGGAGGCCAAGGCAGGAGGATAACTTAAGACCAGGCTGGGTGACACAGTGAGACTTTGTCTCTAAAAAAAAAAAAAAAAAAAAAAAAAAAAAAAACCTACAAAAACATATA"
"chr1","15676438","15676568","chr8","58489091","58489211","71","42812653","GGAGGTGTGGATCTGTAGTTCCAGTTCCTCAGGAGGCTGAGGTGGGAGGATCTCTTGAGTCCAGGAGTTTGAGGCTGCAGGGAGCTGTGATCGCACAGTACTTCAGCCTGGGTGACAGAGCGAGACCTTGT","TTGAGACCAGGAGTTTGAGACCAGCTTGGACAACATAGTGAGACCCTGTCTAAAAGAAAGAAAGAAAGAAAAGAAAGAAAGAAAGATGTAGCCAAGTGTGGTGGTGCACATCTGTGTCTCA"
"chr1","15691064","15691371","chr16","18367809","18368125","75","2676745","GGCCAAGTGCAGTGGCTCATGCCTGTAATCTTAGCACTTATGCAGGCCGAGGTGGGAGGATCACCTGAGCTCAGGAGTTCGAGACCAACCTGGGCAACATAGTGAGACCTTGTCTCCACACTAAAAAATTAAAAATTAGCTGGACGTGGTGGCATATGTCTGTAGTTCCAGCTACTCAGGTGGCTGAGGCGGGAGAATCGCTTGATCCCAGGAGTTGAAGGCTACAGTGAGCCATGATGGTGCCACTGTACTCCAGCCTGGGCCACAGAGTGAAACCCTGTCTCAAACAAACACACACACAAAAAGAA","GGCCAGGCGCAGCAGCTCATGCCTGTAATCCCAGCACTTTGGGAGGTTGAGGCAGGAGGATCACTTGAGCCAGGAGTTTGAGACCAGCCTGGGCAATAAAGCAAGACCTTGTCTCTCAAAAATAAATAAATAAATAAATAAATAATTAGCTGGACATGGTGGCACGTACCTGTAACCCCAGCTACTTGGGAGGCTGAGGTGGGAGGATCACTAGAGCCCAGGAGTTCAAAGCCGCAGTGATCCATGATTGCACCACTGTATTCTAGCCTGGGAGACAGAGCAAGACTCCATCTCTTTAAACAAACAAACAAACAAAA"
"chr1","15702718","15703029","chr9","68878569","68878883","76","53175851","GGCTGGGCGCTGTGGCTCACGCCTGTAATTCCAGCACTTTGGGAGGCTGAGTCAGCGGGAGTATTGCTTGAAGCCAGAAGTTTGAGACCAGCTGGGCAATATAGCAAGACCCTGTTTCTAGCAACTTTTTTTTTTTTTAAAGTTAGCTGGGCGTGGTGGTGCATACCTATAGTCCCAGTTACTCGGAAGGCTAAGGCAGGAGGATTGCTTGAGCCCAGGAGCTGGAGGCTGCAATGTGCCATGATCACACCTCTGTACTCCAGCCTGGGCAACAGAGTGAGACCCTGCCTCGAAAAAAAAAAAAAAAAAAAA","GGCTGGGCACGGCAGCTCATGTCTGTAATCCCAGCACTTTGGGAGGCCAAGGTGGGAGGATTGCTTGAGTCCAGGAGTTCAAGACCAGCCTGGGCAACATAGTGAAACCCCAGTCTCTACAAATAAATAAATAAATAAATAAATAATTAGCTGGGCATGTTGATGCATGCCTGTAGTCCTAGCTACTCGGGGGGTGAGGTGAGAGGATTGCTTGAGTCCAGAAGGTGGAGGCTGCAGTGAGCTATGATCACACCACTGCACTCCAGCCTGGAAGACAGGGTGAGACGCTGTCTTTAAAAAAAAAAAAAGAAAAGA"
"chr1","15708595","15708721","chr9","47045786","47045941","63","31337191","GCCAGGCATGGTGGCTCACAAGTATAATTCCAGCTCTTTGGGAGGCCAGTGAAGGAGGATCATTAGAGGCCAGGAGTTTGAGACCAGCCTGGGCAATATAGCAAGACCCCATCTCTATTTTAAAAAA","GCTGGGCGCAGCAGCTCACACCTGTAATCCCAGTGCTTTGGAGGTCCAAGGTAGGAGGATTGCTTAAGACTAGGTGTTCAAGACCAGTCTTGGCAACATAGTGAGAACTCATCTCTACAATAAATAAATAAATAAATAAATAAATGAAAATAAAAA"
"chr1","15710786","15710851","chr20","87144","87254","67","15623642","AGATCAGCCAGGCATAGTGGCATGCATTTGTAGTTCCAGCTACCCAGCAGGCTGAGGTGAGAGGAT","CCTGGGCAACATAGTGAGACTACATCTCTACACTCACGCACACACACACACACACACACACACCCCCCAAATTAGCCAGGCATGCTGATGTGCACCCATAGTCTCAGCAAC"
"chr1","15712640","15712837","chr12","23162528","23162744","76","7449888","AAAATAAAAATAAAAATAAGCTAGCTAGGCATGGTGGCATGCACCTATAGTCTCACCTACTTGGGAGGCTGAGGCAGGGTCAGGGGGAGGTATCCCTTGAGCCCAGGAGTTCAAGGTTGCAGTGAGCTGTAATGGCACCACTGCACTCCAGCCTGGAGCAAGAACTTGTCTCAAAAAAAAAAAAAAAAAGGAAAATAA","TCTCTACAGAAAATAATAAAAACTTGGCTGGGCATGGTGGCATGTTCTTGTAGTCTCAGCTACTCAGGAGGCTGAGGTGAGAGGATTGCTTGAGCCCAGAAGGTTGCGTTAGGGTTAGGGTTAGGTTTAGGGTTAAGGTTAGCCATGATTGCACTCTTGCCTGGGCAACAGAGCAAGACCCTGTCTCAAAAAAAAAAAAAAAAAAAAAAAAAAAAAA"
"chr1","15713100","15713245","chr19","6391716","6391877","46","9321384","GTGGTGGCTCATGCCTGTAATCTCAACACTTTGGGAGGCCCGAGGCAGGAGGATCGTTTGAGGCCAGGAGTTTGAGACCAGCCTCAGCCACATAGCAAAACGCTGTGTCTACAAAAACAAACAAACAAACAAAAAATTAAAAATTA","CCAGGCGCAATGGCTCACGCCTGTAATCCCAACACTTTGAGAGGCCGAGGCAAGAGGATTGCTTGAGGCCAGGAGTCCGAGACCAGCCTGGGCAACACAGCGAGGCCTCATTCTCTACAAAAAATAAATATATAAATAAATAAATAAATAAGAAGAAGAAAA"
"chr1","15716971","15717253","chrX","46692258","46692555","66","30975287","GGCCAGGCATGGTGGCTCACACCTGTAATCCCAGCATTTTGGGAGGCTGAGGAGGGAGGATGGCTTGAGGCCAGGAGTTTAGACCAGCCTGGGCAACACAGTGAGACCCCATCTCTACAAAAATTTAAATATTACATGGATGTCTTGGTACACACCTATAGTCCCAGCTACTCAGGGGCTGAGGTGGGAGGATGGCTTGAGCCCCGGAGTTTGAGGCTGCAGTGAGGCATGACCACAGCATTGCACTCCAGCCTGGAAGAAAGAGTGAGACCCCATCTCTAAA","GGCCAGGCATGGTGGCTCATGCCTGTAATCCCAGCACTTTGGGAGGCTGAGGAAAGATGATCACTTGAGCCAGGAGTTTGAGCCCAGTCTGGGTAACATAGTGAGACCTCCATCTCTACAAAAAAAAAAAAAAAAAAAAAAAAAAGCTGGGCATGGTAGCACACATCTGTAGTGTCAGCTACTCAGGAGGCTGAGGTAGGAGGATTGCTTGGGCCCAGGAGATCAAGACTGCAGTGAGCTATGACTGCACCACTGCACTCCAGCCTGGGCAATGGAGTGAGACCCTGTCTCAAAAAAA"
"chr1","15772673","15772789","chr8","58489091","58489211","66","42716418","GCCAGGCGCGGTGGCTCACACCTGCAATCTCAGCACTTTGGGAGGCTGAGGTGGGAGGATTACTTGAGGTCAGAAGTTCAAGACGAGCCTGGGCAACATAGCAAGACTCCATCTCTA","TTGAGACCAGGAGTTTGAGACCAGCTTGGACAACATAGTGAGACCCTGTCTAAAAGAAAGAAAGAAAGAAAAGAAAGAAAGAAAGATGTAGCCAAGTGTGGTGGTGCACATCTGTGTCTCA"
"chr1","15794667","15794962","chr1","49763974","49764279","75","33969307","GCTGGGCACGGTGGCTCACTCCTGTAATCCCAGCACTTGGGAGGCCGAGGCAGGAGGATTGCTTGAGGCCAAGAGTTCCAAATCAGCCTAAGCAGCATGGTAAAACCCCATCTTTACAAAAAATTTAAAAAATTAGTCAGGTGTGGTGGTGCATGCTTGGGGTCCCAGCTACTTGGGAGGCTGAGGTAGGAGGACTGCTTGAGCCCAGGACATCATCAAAGCTGCAGTGAGCTGTATTTGCACCACTGTACTCCAGCCTGGGCAACAGAGTGAGACTGTGTCTCAAAAAAAAAAAA","GGCTAGGCCTGGTAGCTCAAGTCTGTAATCCCAGCACTTTGGGAAGTCAGGGCAGGAGGATCCCTTGAGTCCAGGAGTTCAAGACCAGCCTGGGCAACAAAGTGAGACCCTATCTGTATAATAAAATAAAATAAAATAAAATAAATTAGCCAGGTGTGGTGGTGTGTGTCTGTGGTCCAAGGTACTTGGGAGGCTGAGGTGGGAGAATGGCTTGAGCCCAAGAGTTTGAGGCTGCAGTAAGCCGGGTTTGCTACTGTACTCTAGTCTGGGCAACAGAGCCAGACTCTGTCTCAAAAAACAAAAAAA"
"chr1","15804823","15804921","chr8","58489091","58489211","63","42684268","GGCCAGGTGTGGTGGTTCACACCATTAGTTCTTTGGGAGAACTGTTTGAGGCCAGGAGTTCGAGACCAGCAGCCTGGGGAACATAGTGAGGTCCTGACT","TTGAGACCAGGAGTTTGAGACCAGCTTGGACAACATAGTGAGACCCTGTCTAAAAGAAAGAAAGAAAGAAAAGAAAGAAAGAAAGATGTAGCCAAGTGTGGTGGTGCACATCTGTGTCTCA"
"chr1","15809666","15809951","chr1","13807217","13807528","94","2002449","GCCAGGTGCAGTGGCTCATGACTATGATCCCAGCACTTTGAGAGGCTGAAATAGGAGGTTCACTTGATCCCAGGAGTTTGAGACCAGCCTGGACAACATAGTGAGATCCCCGTTGCTAAAAATATTTTCTTTTAATTAGCGAGGTGTGGTGGTATGTACCTCTAGTCCCAGCTACTCGGGAGACCGAGGTGGGAGGATCACTTGAGCCATGATTGTGCCACTGCACTCCAGCCTGTGTGACACAGCAAGACCTTGTCTCAAAAAAAAAAAAATTAAATTAAAAAAA","GCTGGGTGCAGTGGCTGACATCTGTAATCCCGGCACTTTGGGAGGCCAAGATGGGAGGATTGCTTGAGCTCAGGAGTTTGAGACCAGTCTGGGAAACATAGTGAGACCACATCTCTACCAAATTTTTTTTTTTTTAATTAGCTGGACATGGTGGTATGTGCCTACTCAGGATGCTGAGGTGGGAGGATCACTTGAGCCCAGAAGATAGAAGCTGCTTTGAGTTATGATCTCACCACTGCACTCCAGCCAGGGCAACAGAGCAAGACTTTATTTCAATAATAATAATAATAATAATAATACTTTAAAAAAAAA"
"chr1","15812699","15812918","chr7","119744984","119745215","56","103932285","CCAGCCTGAGCGACAGAGCAAGACCCTATCTCAAAAAAAAAAAAAAAAAAAAAAATTAGCTAGCTGTGGTGGTATAGTCCCGGCTACTTGAATGGCTGAGTTGGGAGCATCACTTGAGCCCAGGAGGCAAAGTTTGCAGTGAGCTGAGATTGTGCCACTGCACTCCAGCCTGGGTGACAGAGCAAGATGCTGCCTCAAAAAAAAAAAAAAGAAAAGAAAA","CAGCCTGGGCAATATAGGGAGACCTCATCTCACAAAAAAAAAAAAAAAAAAAAAAAAAATTAGCCTATTGTGGTGGTGCACGCTTGTGGTGCCAGCTACTTGGGAGGCTGAGGTGGGAGGATCACTTCAGCCCAGGAGTTAGAGGCTGCAGTGAGCTATGATCCTGCCACTGCACTCCATCCTTGGCAACAGGGCAAGACACTTGACTCAAAAAGAAAAAAGAAAAAAAAAA"
"chr1","15820773","15820987","chr14","51003183","51003398","72","35182410","CCAGACTGGGCAACACAGTGAGACCCTGTCTCTACAAAAAATTTTAAAATTAGCCGGGGGTGGTGGCATGCTCTTGTATTCACAGACACCTGGGAGGCTGAGGCAGAGAGGGGAGGATCCCTTGTACCCAGGAGTTAAAAGCTGCAGTGAGCCATGATCACATCACTGCTGGGTGACAGAGCAAGACCCTGTCTCAAAAAAAAAAAAAAAAAAAA","AGCCTGGGCAAGATAGTGAGACCTCATCTCTTAAAATAAATAAATAAATAAATAAATAGCAGGATGTGGTGGCGTGCATCTGTAGTCCCAGCTACTCAGGAGGCTGAGATGGGAGGATTACTTGAGCTCAGGAGGTCGAGGCTGCAGTGAGCTATGATCACGCCACTGTACTCCAGCCTGGGTGAGAGTGATACCCTGTCTCTAACAAAAAAAAAA"
"chr1","15836796","15836907","chr20","87144","87254","64","15749652","GGCCGGGCGTGGCGGCTCACACCTGTAATCTCAGCACTTTGGAAGGCCCTGGCGGAAGGATCTCTTGACGTCAGGACTTCCAAAACAGTTGGGCAACACAGCAAGACCCCGT","CCTGGGCAACATAGTGAGACTACATCTCTACACTCACGCACACACACACACACACACACACACCCCCCAAATTAGCCAGGCATGCTGATGTGCACCCATAGTCTCAGCAAC"
"chr1","15837969","15838246","chr1","164929853","164930117","88","149091884","GGCCTGGACCAGTGGGTCACACCTGTAACCCCAACACTTTGGGAGGCTGAGGTGGGAGGATCACTTGAGCCCAGGAGTTCCAGACCAGCTTGGACAACAAGGCAAGACCCTTGTCTCTACAAAAAATTTAAAAATTAGCCGGGTGTGGCGGTGCGCCTGCAGGTGGGCGAATCCATTGAGCCCAGGAGGTCGAGGCTACAGTGAGTTCTGTTCGTGCCACTGTACTCCAGCCTAGACGACACAGAGAGACTCTGTCTCTAAATAAATAAATAAATAAA","GGCCAGGTGTAGTGGCTCACACCTGTAATCCCAGCACTTTGGGAGGCTGTGGCGTCAGGATCACTTAGAGTCAGGAGTTTGAGACCAGTCTGCACAACATAGCCAGACCCATCTCTACAAAAAAAAAAAAAAAAAAAAAAAAAATCCTAGCTACTTGGGAGGCCGAGATGAGAGGATCACTTGAGTCCAGGAGTTCAAGGCTGCAGTGAGCTATGATCCTGCCACTGCACTCCGGCCTAGGTGACAGAGTGAGACCAAAAAAAAA"
"chr1","15857701","15857856","chr22","26696703","26696888","76","10839002","GACCTTGTCTCTAAAACAAATTTTTTTAATTAGCTGGACATTATGGCTCATGCCTATAGTCCCAGATACTGAGAAGGCTAAGGTGGGAGGATACCTCAAGCCCAGGAGGTCGAGGCTGCAGTGAACCATAATTATGCCATTACACTCCAACCTGGG","CCAGCCTTGGCAACATAGCAAGACCCTGTCTCTATCAATCAATCAATCAATCAATCAATAATCCAGGCGTGATGGCACACACCTGTGGTCCCAACGACCCGGGAGCCTGAGGTGGAAAGATCGTTTGAGCCCAGGAAGTTGAGGCTGCAATGAACTGTGAACATGCTACGGCACTCCAGTCTGGGC"
"chr1","15858142","15858252","chr20","87144","87254","57","15770998","GCTGGGCCCAGTGACTCATGCCTGTAATCCCAGCACTTTGGTAGGACAAGGCAGGAGGATCACTTGAGCCCAGGAGTTCAAGACCAGCCTAGGCAACATAGTGAGACCTTG","CCTGGGCAACATAGTGAGACTACATCTCTACACTCACGCACACACACACACACACACACACACCCCCCAAATTAGCCAGGCATGCTGATGTGCACCCATAGTCTCAGCAAC"
"chr1","15861660","15861755","chr8","58489091","58489211","63","42627431","CCTGTTATTTCAGCATTCTGGGAGGCCAAGGTGAGAGGATGTTTAAAGCAAGGAGTTTTGAGACCAGCCTGGAAACACAGCAAGACCCTGTCACTA","TTGAGACCAGGAGTTTGAGACCAGCTTGGACAACATAGTGAGACCCTGTCTAAAAGAAAGAAAGAAAGAAAAGAAAGAAAGAAAGATGTAGCCAAGTGTGGTGGTGCACATCTGTGTCTCA"
"chr1","15864609","15865000","chr10","117410724","117411074","136","101546115","GGGCAGGAATGATGGCTAACATCTATAATCCCACCACTTTGGGAAGCCAAGGCGCGAGGACGATTTGAGGTCAGGACATCAAGACCAACCTGGGGAACAAAGCAAGACCCCTCCCCACCTCCCCACCCTACCCCCTTCTCTACTAAAAATAAAAACATTAGCCAGGTGTGTTGGCACTTAGTAGTAGTCCTAGCTACTCAAGAGGTTAAGATGGGAGTTTGAGTCCTAGCTACTCGGTAGGCTGAGACGGGAGCTTGAGCCCTAGCTACTCGGTAGGCTGAGACGGGAGCTCGAGCCCAGTAGTTCCAGGCTGCAGTGGGCATGATCACACCACTGAACTCCAGACTGGGTGACAGAGCGAGACCTTGTCTCAAAAAAAAAAAAAAAAAAAA","GGCCGAGTACAGTGTCTCCCACCTGTAATCCCAGCACTTTGGGAGGCCAAGGTGGGAGAATCACTTGAGGCCAGGAATTCAAGACAAACCTGAGCAACATAGCAAGACTCCATGTCTAAAATACATATATATTTATAATATATAATATATATATACATATATATATGTAAAATATATTAGCCTAGCAAGGTGGCATGTGCCTATAGGCCTAGCTACTCTGGAGGCTGAGGAAGGAGGATTGCTGGAGCCCAGGAGTTCAAGGCTGCAATGAGCTACGCTGGTGCCACTGTACTCCAGCCTGGGCAACAGAGTGAGACCTTGTCTCCAAAAAAAAAAAAGAAAAAAAAAAAA"
"chr1","15868186","15868306","chr15","37343640","37343763","61","21475454","GACTGGACACAGTGGCTCAAGTCTGTAATCCCAAAGCTTTGGGAGGCCAGGTGGGAGGATCACTTGAAACCATGAGTTCCAGACCCACCTACACAACACAGCAAGACCTCATCTCTATAAA","AAGATCCCTGGCCAGGATTTCAAGACCAGCCTGGGCAACACAGTGAGACCATACATACATACATACATACATACATACATCATACATACATACATACATACATACATACACAGTCTTACAAAGA"
"chr1","15891199","15891352","chr1","217544386","217544536","69","201653187","TTTAGCTAAGTGTGGTGGCATGTCTATAGTCTCGGCTACTTAGGAGGCTGAGGTGAGGGGATCCCTTGAGCCCAGGAGTTCAAGGTTGCAGTGAGCCATGATTGCACCACCACTCCAGCCAGGGTGACAGAGCAAGACTGCCTCTAAAAAAAAA","GGCTGGGCGTGGTGGCTCATGCCTCTAATCCCAGCACTTTAGGAGGCCAAGGCAGGAGGATAACTTAAGACCAGGCTGGGTGACACAGTGAGACTTTGTCTCTAAAAAAAAAAAAAAAAAAAAAAAAAAAAAAAACCTACAAAAACATATA"
"chr1","15891650","15891787","chr9","47045786","47045941","49","31154136","CCAGGTACAGCGGCTCATGCATGTAATCCCAGTGCTTTGGGAGTCCAAGGCAGGAGGATCACTTGAGGTCATGAGACCTAGACCAGCCTGGGCAACATAGCGAGACCCTATCGCTTAAAAACAAAAAACAAAAAACAA","GCTGGGCGCAGCAGCTCACACCTGTAATCCCAGTGCTTTGGAGGTCCAAGGTAGGAGGATTGCTTAAGACTAGGTGTTCAAGACCAGTCTTGGCAACATAGTGAGAACTCATCTCTACAATAAATAAATAAATAAATAAATAAATGAAAATAAAAA"
"chr1","15896768","15896980","chr14","51003183","51003398","55","35106415","ACTAGCTTGGGCAACATAGTGAGATCCTGTCTCTACAAGTAATTTTAAGTGTTAGCCTGGTGTGGTGGCGCATGCCTGTTGTCCTAGCTACTTAGGAGGCTGAGGTGGGAGGATTGCTTGAGCCCAGGAGGTTGAGGCTGCAGTGAGCCATGAGTGCACCTCTGCACTCCAGCCTGGATGACAGAGCGAGACCTTGTCGTGAAAGAAAAGAAA","AGCCTGGGCAAGATAGTGAGACCTCATCTCTTAAAATAAATAAATAAATAAATAAATAGCAGGATGTGGTGGCGTGCATCTGTAGTCCCAGCTACTCAGGAGGCTGAGATGGGAGGATTACTTGAGCTCAGGAGGTCGAGGCTGCAGTGAGCTATGATCACGCCACTGTACTCCAGCCTGGGTGAGAGTGATACCCTGTCTCTAACAAAAAAAAAA"
"chr1","15966800","15966912","chr20","87144","87254","59","15879656","CGGGAGGCTGAGGTGGGAGGATCGCTTGAGCCCTGGAGGTCGAGGCTGCAGTGAGCTATAATCCCAGCACTGCACTCCAACCTGGGCGAAAGAGCGAGACCCTGTCTCAAAAA","CCTGGGCAACATAGTGAGACTACATCTCTACACTCACGCACACACACACACACACACACACACCCCCCAAATTAGCCAGGCATGCTGATGTGCACCCATAGTCTCAGCAAC"
"chr1","15973908","15974220","chr16","9702460","9702783","73","6271448","GGCCAGGCATGGTTGCACATGCCTATAATCCCAGTACTTTGGGAGGCTGAGGCGGGAGGATCATTTGAGGCCAAGAGTTCGAGACCAGTCTGGGCAACATAGTGAGACCCCATCTCTACTAAAAATTTAAAAAATTAGCCAGGTGTTATGGTGCACGCCTGTAGTCCCAGCTAGTTGGGAGGCTGAGGCAGAAGGATCACTTGAGTTCAGATCAAGGCTGCAGTGAACTATGATTATGCTGCCACTGCACTCCAGCCTGGGTGACAGAGCAAGACGTAGTCTCAAAAAAAAAAAACAAAAACAAAAACAAAAA","CCGGGCATGATGGCTCATGCCAGTAATCCTAGCACTTTGGGAAGCTGAGGTGGAAGGATCGCTTGAGGCCAGGAGTTCGAAACCAGCCCAGTCAACATAGTGAAACCCCATCTCTACAAAAGAAAAATTAAAAAATTAGCTGGAATGGTGGCACATGCCTGTAGTCCTAGCTACTTGGGAGGCTGAGGCAGGAGAACTGTTTGAGCTCAGAAGTTCAAGGCTGCAGTGAGCCATGACTGTGCCACTGCACTCTAGCCTGGGTGACAGAGTGAGACCCTGTCTCAATAAATAAATAAATAAATAAATAAATAAGAAAACTAAAAA"
"chr1","15998910","15999007","chr20","87144","87254","54","15911766","GGCCAGGCACAGTGGCTCATACCTATAATCTCAGCACTTTGAGAGGTCGAGACGGGAGGATCACTTGAAGCCAAGAGTTCAAGGCAAGGTCTGAGCAA","CCTGGGCAACATAGTGAGACTACATCTCTACACTCACGCACACACACACACACACACACACACCCCCCAAATTAGCCAGGCATGCTGATGTGCACCCATAGTCTCAGCAAC"
"chr1","15999924","16000000","chr20","87144","87254","60","15912780","CGAGGCAGGAGGAGCACTTGAAGTCAGAAGTTCCTTGCCAGCCTGGGCAACATGGCAAGACCCAGTCTTCACAAAGA","CCTGGGCAACATAGTGAGACTACATCTCTACACTCACGCACACACACACACACACACACACACCCCCCAAATTAGCCAGGCATGCTGATGTGCACCCATAGTCTCAGCAAC"
"chr1","16001522","16001803","chr1","47533839","47534134","75","31532317","GGCCAGGCATGGTGGCTCACACCTATAATCTCAGCACTTTGAGAGGCCGAGATGGGAGGATTGCTTGAAGCCAAGAGTTCGAGACCAGCCTGGGCAGCACAGTGAGACCCTCCATCTCTACAAAAGGTTTTTTAAAAAATTAACCAGGTGAGGTGGCATGAGCCTGTAGTCCCAGCTAATCAGGAGGCTGAGGTGGGAGGATTGCATGAGGCCGGGAGGTCGAGGCTGCAATGAGCCATGACTGTGCCACTGTACTCCAGCCTGGGCAACAGTGAGACCCTG","GGCTGGGCACGGTAGCTCACACCTGCAATCCCACCACTTTGGGAGGCTGAGGTGGGTGGATTGCTTGAGCCCAGGAGTTCTAGACCAGCCTGGGTGATACAGGCAGACCCTATCTCTACCAAAAAAAAAAAAAAAAAAAAAAAAAAAGGCTGGGCATGGTGGCATGTGCCTGTGGGCTCAGCTACTTAGGAGGCTGAGGTGGGAGGATCAGTTGAGCCCAGGAGGAGTTGAGGCTGCAGTGAGCCTAGATCCTGCCACTGCACTCCAATCTGGGCAACAGAGCGAGACCCTGTCTC"
"chr1","16007441","16007735","chr3","79276465","79276785","74","63269024","GACCAGATACGGTGGCTCACACCTATAATCCAAGCACTTAGGGAAGCTGAAGCGGGAGGATAGCTTGAGGCCAGGAGTTCAAGACCAGCCTGGGCAGCACAGTGAGACCTCTTCTCTACTAAAAGAAGTCAAGCTGGGCGTAGTGGTGCACCTATAGTCTCAGCTACTCGGGAGGCTGAGGCAGGAGGATCACTTGAGCCCAGGAGTTTGAGGCTGCAGTGAGCTGTGATTGTTCCACTGCACTCCAGCCTGGGTGATAGAGTGAGACTCTGTCTCTAAAATAAATACAGAAAAA","GGCTGGGTGCAGTGGTTTATGCTTATAATCCTAGCACTCAGGGAGGCTGAGGGGGGAGGATTGCTTGAAACCAGGAGTTCAAGACCAGCCTGGGCAACATAGGGAGACCTCAGTTTCTACAAAAACAAACAAACAAACAAACAAACAAAAAATTAGCCAGGCGTGGTAGTGTGCACCTATATTCCCAGCTACTCAGGAGGCTGAGGCAGGAGGATCACTTGAACCCAGGAGTTCGATGCTGCGGTGAGCTGTGATCATGCCACTGCACTCCAGCCTGGGAGACAGAGTGAGACCCTATCTCTAAATAATAATAATAAAAAA"
"chr1","16047495","16047781","chr4","139746214","139746515","85","123698719","GCTGGGCACACTGGCTCATACCTATAATCCCAGCACTTTGGGAGGCGGAAGTGGACAGATCGTTTGAGGTCAGGAGTTCTAGAGCAGCCCGGGCAACATAGCTAGACTCCATCTCTTTAGAAAAATAAGGTGGGCGAAGTGGTCTCCACCTATAGTCCCAGCTATTCAGGAGGCTGACGCAGGAGGATAACTTGAGCCCTGGCAACTGAGGCTGCTGTAAGCTATGATCCTACCACTGTACTCCAGCCTGGCCAACAGAGCAAGATCTTGTCCCCAAAGGAAAATAA","GGCCAGGCACAGTAGTTTATGCCTGTAATCCCAGCACTTTGGAAGGCTGAGGCAGAAAGATCCCTTGAGCTCAGGAGTTTGAGATCAGCTTGGGCAACATAGCGAGACCCCATCTCCTAAAAAAAAAAAAAAAAAAAAAAAAACTAGCTGAGCATGGTACACACACCTGTAGTCCCAGCTATTTGGAGGTGCTGAGGTGGGAGGATCACTTGAGTCCAGGAAGTTGAGGCTGCAGTGAGCCAAGATCATGCCACTGCACTCCAGCCTGCACAACACAGCAAGACTCTGTCTCAAAAAACAAA"
"chr1","16070510","16070647","chr9","47045786","47045941","46","30975276","GGCCGGGTGCAGTGGCTCACACCTGTAATCCCAGCACTTTGGGAGGCCGAGGTGGGAGGGTGGCTTGAGGCCAGGAGTTCGAGATAAGCCTGGGCAACATAGTGAGAGCCTGTCTCTATTATAATATATACAATATTA","GCTGGGCGCAGCAGCTCACACCTGTAATCCCAGTGCTTTGGAGGTCCAAGGTAGGAGGATTGCTTAAGACTAGGTGTTCAAGACCAGTCTTGGCAACATAGTGAGAACTCATCTCTACAATAAATAAATAAATAAATAAATAAATGAAAATAAAAA"
"chr1","16093285","16093505","chr14","51003183","51003398","52","34909898","CCAGCCTGGACAATAAAGCAAGACCCTGTCTCTACAAAAATAAAAATAAAAAAAATTAGCCAGGCGTGGTGGCGCATGCCTGTGGTCCCAGCTACTCAGGAGGCTAAGGTGGGAGGATTGCCTAAGCCTAGGAGGTCAAGGCTGTAGGGAGCTGTGATCGCGCCACTGCCCTCCAGCCCGGGCCACAGAGTGAGACCTTATCTCAAACAAAACAAAACAAA","AGCCTGGGCAAGATAGTGAGACCTCATCTCTTAAAATAAATAAATAAATAAATAAATAGCAGGATGTGGTGGCGTGCATCTGTAGTCCCAGCTACTCAGGAGGCTGAGATGGGAGGATTACTTGAGCTCAGGAGGTCGAGGCTGCAGTGAGCTATGATCACGCCACTGTACTCCAGCCTGGGTGAGAGTGATACCCTGTCTCTAACAAAAAAAAAA"
"chr1","16097032","16097156","chr9","47045786","47045941","61","30948754","GGCTGGGCTCACTGGCTCACACCTGTAATGCCAACATTTTAGGAAGCTGAGGCGGGAGGATCGTTTGAGGCCAGGAGTTCAAGACCAGCCTCGGCAACACAGTGAGAACCCCATCTCTACAAAAA","GCTGGGCGCAGCAGCTCACACCTGTAATCCCAGTGCTTTGGAGGTCCAAGGTAGGAGGATTGCTTAAGACTAGGTGTTCAAGACCAGTCTTGGCAACATAGTGAGAACTCATCTCTACAATAAATAAATAAATAAATAAATAAATGAAAATAAAAA"
"chr1","16111340","16111594","chr1","88859712","88859991","79","72748372","GCCAGACACAGTGGCTCATGCCTGTAATCCCAGCACTTTGGGAGGCTAAGGCGGGAGGATCACTGGAGCACAGGAGTTCGAGACCAGCCTGGGTAACAGAGTAAGACCCTGTCTCTACCAAAAATAGTTTTAAAGAGTACGTGCCTGTAGTCTCAGCTACTCTGGAGGCTGAGGTGGGAAGATTGCTTGAGCCTGGGAGTTCCAGGCTGCAGTGAGCTGTGATTCAGAATGAGACCCTGTCTCAAAAAATAAAAA","CCAGGCACAGTGGCTCACACCTGTAATCCCAGCACTTTGGGAGGCCAAGGCAGGAGGATTGCTTGAATCCAGGAGTTTGAGACCAGCCTGGGCAGCATAGTGAGACTTGGCCTCTACAAAAAAAAAAAAAAAAAAAAAAAAAAGTTACCTGGGAAGTCTCAGCTACTTGGAAGGCTGAGGTCGGAAGGTTGCTTGAGTACAGGAGGTCAAGGCTGCAGTGAGCTATGATTGTACCACTGCACTCCAGCGTGGGCAACAGAGTGAGACCTTATCTCAAAAA"
"chr1","16170820","16171123","chr10","65849492","65849800","81","49678672","GGCTGGGGGTGGCGGCTCCTGCCTGTCATCCCACCACTTAGAGATGCCGAGGCAGAAGGATTGTTTGAGCCCAGGATTTCGAGACCAGCCTGGGCAATACAGGGAGACCCTGTCTCCACAGAAACATTTTTAAGATGAGCTGGGTGTGGTGGTGCACATCTATGGTCCAAACTACTCGGGAGACTGAGGTGGGAGGTTCGCTTGAACCCGGGAGTTCAAGGCTGCAGTGAGCTGTGATGGAGCCACTGCACTCTAACCTGGGCAACAGAGTGAGACTATGTCTCCAAAGGAAAAAAAAAAAAAA","GGCCAGGTGTACTGGCTCATGCTTATAATCCCTGCACTTTGGGAGGCTGAGGTGGGAGGATTGTCTGAGGCCAGGAGTTTGAGACCAGCCTGGGCAACAGAGTGAGACCTTGTATCTTAAAAAAAAAAAAAAAAAAAAAAAAAAGCAGGGTATGGTGGTGCACACCTGTGGTCCAAGCTACTCGGGAGGCTGAGTGTTGGAGGATTGCTTGGGCCCAGGAGGTCGAGGCTGCAGTGAGCTGTATTCATGCCAGTGCACTCCAGGTTGGGTGACAGGGTGAGATTCTGTCTCAAAAAACAAACAACAAAA"
"chr1","16194253","16194343","chr20","87144","87254","59","16107109","GGGAGGCTGAGGAGGGTGAATTGTTTGAGACCAGGAGTTCAAGACCAGCCTGAGCAACATAACAAGACCTCTTCTCTACAAAAAATTAAAA","CCTGGGCAACATAGTGAGACTACATCTCTACACTCACGCACACACACACACACACACACACACCCCCCAAATTAGCCAGGCATGCTGATGTGCACCCATAGTCTCAGCAAC"
"chr1","16229313","16229512","chr14","51003183","51003398","70","34773870","GAGCCCAGGAATTTGAGACCAGCTTGGTCTCTCAAAAAGTTTTAAAATTAGCTGGGTATGGTGGGAGCTACTTCCGGGGCTGGGGAGAAACGGGGAGGATCACTTGAGCCCAGGAGTTCGAGGCTACAGTGAATGATGATTGTGCCACTGCACTCCAGCCTGGGCGACAGAGCAAGACCCTGTCTCTAAAAAAATAAGAA","AGCCTGGGCAAGATAGTGAGACCTCATCTCTTAAAATAAATAAATAAATAAATAAATAGCAGGATGTGGTGGCGTGCATCTGTAGTCCCAGCTACTCAGGAGGCTGAGATGGGAGGATTACTTGAGCTCAGGAGGTCGAGGCTGCAGTGAGCTATGATCACGCCACTGTACTCCAGCCTGGGTGAGAGTGATACCCTGTCTCTAACAAAAAAAAAA"
"chr1","16258347","16258656","chr8","25360790","25361095","83","9102443","GGACAGGCACAGTGGCTTACACCTGTAATCCTAACACTTCGAAAGGCCAAGGCGGCAGGATTGCTTGAACCCATGAGTTCGAGACCAGTCTGGGCAATGCAGGGAGTCCCCATCACTACAAAAAATTTAAAAATTAGTCGGGCATGGTGGTGCTTGCCTGTATTCCTAGCTATTTGGGAGGTTAAAGTGGGAGGATCCCTTGAGCCCAGGAGGTTGAGGCTGCAGTGAGCCGTAATTGTGCCACTGCACTCCAGCCTGGGCAACAGCAAGACCCTGTCTCAAAAAAAAAAAAAGGAAGAAGAAATGAAAA","GGCTGGGAGCAGTGGCTCATACCTGTAAGCCCAGCACTTTGGGAGGCTGAGGTGGGAGGATTGCTGAAGCCCAGGAGTTTGAGACCAACCTGGGCAATGTAGGGAGACCCCGTCTCTACTAAATAAATAAATAAATAAATAAATAAAGTCGGGCATGGTGGCATGTGCCCTGTAGTCCCAGCTTCTTGGGAGGCTGAGGTGGGAGGATTGCTTGGGCCCAGGAATCAAGGCTGCAGTGAGCTGTGATTGTGCCACTGTACTACAGCCTGGGTGACAGTGCAAGACTGTCTCAAAAGAAAAACAAAA"
"chr1","16258735","16259039","chr9","68878569","68878883","81","52619834","GACTGGGTGAGGTGGGTAATGCCTATAATCCCAGCACTTTGGGAGGCTGAGGCGGGAGGATCGCTTGAGGCCAGGAGTTCGTGGCCAGCCTGAGCAACATAGCAAGACCTGATCACAACAAAAAAATTTTAAAAATTAGCTGGATATGGTATTACATGCCTGTAGCCTCTGCTACTCGAGAGGCTGAAGCAAGAGGATTGCTTCAGCCTGAGGAAGTCGAGGCTGCAGTGAGCCATGATCGCATCACTGCACTCTAGCCTGGGTGACAAAGCTAGACCCTGTCTCAAGATTAATAAATAAATAAA","GGCTGGGCACGGCAGCTCATGTCTGTAATCCCAGCACTTTGGGAGGCCAAGGTGGGAGGATTGCTTGAGTCCAGGAGTTCAAGACCAGCCTGGGCAACATAGTGAAACCCCAGTCTCTACAAATAAATAAATAAATAAATAAATAATTAGCTGGGCATGTTGATGCATGCCTGTAGTCCTAGCTACTCGGGGGGTGAGGTGAGAGGATTGCTTGAGTCCAGAAGGTGGAGGCTGCAGTGAGCTATGATCACACCACTGCACTCCAGCCTGGAAGACAGGGTGAGACGCTGTCTTTAAAAAAAAAAAAAGAAAAGA"
"chr1","16260689","16261001","chr10","125157322","125157641","81","108896633","GGTGAGGTGGCTCATGCCTGTAATTCCAGCACTTTGGGAGGTGGCAGAGGTGGGAGAATCACTTGAGGCCAGGAGTTTAAGACCAGTCTGGGCAACACAGAGAGACCCCCATCTCTACCCAAAAAAAGAAAAAAATTAGCTGGATGTAGTGGCCTGTGACTGTAGTCCTAGCTGCTTAGGAGGCTGAGGTAGAAAGATCCCTTGCACCCAGGAGGTCAGAAGTGCAGTGAGCCATGATCAGTCACACCACTGCACTCCAGCCTGGGTGCCAGAGTGAGACCTCATCTCAAAAAAATAAAATTAAAAATTAAAA","GGCTGGGTGCAGTGGCTCATGCCAGCAATCCCAGCCCTTTGGGAGGCTGAGGTGAGCAGATCGCTTGAGCCCAGGAGTTTGAGACCAGGTGAGGCAACATGGCAAGATCCCCTCTCTACCAAACAAACAAACAAACAAACAAAAAACAACTAGCTAGGGATGGTGGTGCGTGCCTGTAGTCCCAGCTACTTGGGAGGCTGAAGTGGGAGGATCGCTTGAGCCCAGGAGTTCAAAGCTGCAGTGAGTCATGATAGCACCACTGCACTCCAGCCTGGGTGACAGAGTGAGACCCTGTCGCAAAAAAAAAAAAAAAAAAAGAA"
"chr1","16275339","16275654","chr12","41584147","41584465","88","25308808","CAGGTGCGATGGCTCATGTCTGTAATCTCGGTACTTCGAGAGGCCAAGGCAGGGGGATCACTTGAGGCTAGGAGTGCAAGACCAGTCTGGGCATTACAGTGAGACGCTGTCTCTACAAATAATAAAATAAAATAGCTGGGCATAGTGGTTCATGCCTGTAGTCCTTGCTACTTGGGAGGCTGAAGCAGGAGGATCGCTTGAGCCCAGGAATTTGAGGCTGCAGTGAGCTATGATGATGCCACTGTATTCCACTCAGGGACAAAAAGCTAGACCCTGTCTCTTACCCAAAAACAGAAAAGGAAGAATAAAAATAAAA","GGCTGGATGTGGTAGCTCGTGCCTGTAATCTCAACTACCAGGGAGGCTGAGGCAGTAGGATCACTTGAGGCCAGGAGTTCAAGACCAGCCTGTGTAACATAGCAAGACCCTGTCTCTAAAATAAATAAATAAATAAATAAATAATTAACTGGGCATGGTGACACACACTTGTAGTCCAAGCTACTTGGAAGGCTTAGGCAGAAGAATTGCTTGAGCCCAGGAATTCGAGGCTGCAGTGAGCTGTGATTTGTGCCACTGCACTCCAGCCTGGGCAACAGAGCAAACCTATGTCTCTTAAAAAAAAAAAGAAAAGAAAGAA"
"chr1","16282563","16282680","chr20","87144","87254","64","16195419","GACCAGGTGCAGTGGCTCATGCCTAAAATCCTAGCAGTTTGGGAGGCCAAGGTAGGAGGACAGCTTGAGGCCAGGAGTTCAAGACCAACCTGGGCAACACAGTAAGACCCCATTTCCA","CCTGGGCAACATAGTGAGACTACATCTCTACACTCACGCACACACACACACACACACACACACCCCCCAAATTAGCCAGGCATGCTGATGTGCACCCATAGTCTCAGCAAC"
"chr1","16287594","16287749","chr1","217544386","217544536","60","201256792","GGCCAGGCACAGTGGCTCACACCTGTAATCCTAGCACTTCAGGAGGCTGAGTGGGAGGATGGCTTGAGGCCAGGCCACTCTGAGGCCAGGATGGCTTGAGTTCAAGACCAGCCTGAGCAACATAGCAAGAGCCCATCTCTACAAAAATAATAAAAA","GGCTGGGCGTGGTGGCTCATGCCTCTAATCCCAGCACTTTAGGAGGCCAAGGCAGGAGGATAACTTAAGACCAGGCTGGGTGACACAGTGAGACTTTGTCTCTAAAAAAAAAAAAAAAAAAAAAAAAAAAAAAAACCTACAAAAACATATA"
"chr1","16289122","16289424","chr3","65159963","65160267","78","48870841","GCAGTGGCTCATGCCTGTAATCCAGCACTTTGGGAGGCCAAGGCAGGAGGATCATTTGAGGCTAGGAGTTGAAGACCAGCCCAGGCAACATAGTGACACCCTAGTTCTACAAAAAAAAAAGAAAGAAAAGAAAATGTCCCGATGTGGGGGTGCAAACCTGTGGCTCCAGCTATGCAGGAGGCCGAGGTGGGAGGATCACTTGAACCCAGGGGTTTGAGGCTATAGTCAATTAATTATGATTGTGCCACTGCACTCCAGCTTTGGCAAGGGAGCAAGATTGTCTCTTTAAAAAAAAAAAAAAAA","GGCATGGTGGCTCACACCTGTAATCTCAGCACTTTGGGAGGGCAAGGTAGGAGGATTGCTTGAGGCCAGGAGTTCAAGACCAGCCTGGGAAACACAACGAGACCCTGTATCTGCCAAAAAAAAAAAAAAAAAAAAAAAAAATTGACCAGGCATAATGGCAATGGCGTGGGGTTCCAGCTACTCAGGAGGCTGAGGTGGGAGGATTGCTTGAACCCCAGAGTTTGAGGCTGCAGTGAGCTATGATCGTGCCACTGCACTCCAGTGTGGAAAAAAGAGTGAGACCCTGTCTCAAAAAAAAAAAAAAA"
"chr1","16291684","16291971","chrX","46692258","46692555","66","30400574","GGCTGGGCACAGTGGCTCACTCCTCTAATCCCAGCACTTTAGGAGGCTGAGACAGGAGGATCTCTTGAGGCCAGGAATTTGAGACCAGCCTGGGTAACATAGTGAGACCCTGTCTCTACAAAACAATTAAAAATGAGCCGGGCATGATGGCATGTGCCTGTAGTCCTAGCTACTTGAGAGGTTGAGGTGGGAGGATTGCTTGAGCCCAGGAGTTCAAGGCTACAGTGAGTGATGATTGCTCCACTGCACTCTAGCCTGAGTGAAAGAGGGAGACCCTGTCTCAAAAAA","GGCCAGGCATGGTGGCTCATGCCTGTAATCCCAGCACTTTGGGAGGCTGAGGAAAGATGATCACTTGAGCCAGGAGTTTGAGCCCAGTCTGGGTAACATAGTGAGACCTCCATCTCTACAAAAAAAAAAAAAAAAAAAAAAAAAAGCTGGGCATGGTAGCACACATCTGTAGTGTCAGCTACTCAGGAGGCTGAGGTAGGAGGATTGCTTGGGCCCAGGAGATCAAGACTGCAGTGAGCTATGACTGCACCACTGCACTCCAGCCTGGGCAATGGAGTGAGACCCTGTCTCAAAAAAA"
"chr1","16292314","16292596","chrX","61799705","61800010","87","45507391","GGCTAGGCGAAGTGGCTCACGCCTATAACCCCAGCACTTTAGGAGGCCAAGGCAGAAGGATCCCTTGAGGCCAGGAGTTTGAGACTCACCTGGGCAACATGGTGAGACCCCCATCTCTACAAAAAATAAAAACAAAAAATTAGCCAGGCATGGTGGCATGCCTCCATAGTCCCAGATACTTGGGAGGGTGAGACAGGAGGATTGCTTGAGCCCACAGATATAAGCCCAGACGCCTAGGCGAGAGTGAGACTGTGTCTCAAAAAAAGAAACAAAGAAAGAGAAA","GGCCGGGAGCACAGGTTCACACCTATAATCCCAGCATTTTGGGAGGCCGAGGCATGTGGGATTGCTTGAGCTCAAGAGTTTCAGACCAGCCTGGGCAACATAGTGGGAACCCGTCTCTACAAAAAAAAAAAAAAAAAAAAAAAAAAAATTAGCCGAGCCTAGTGGTACATGCCAGTAGTCCCAGCTACTTGGGAGGCTGAGGTGGGAGGATTGCTTGACGCTGCAGTGAGCTGAGATTGTGCCAGTATACTCCAGCTGGGGCAACAGAATGAGACCGTGTTTCAAAAAAAAAAAAAAAAAAAAGAA"
"chr1","16307217","16307535","chr16","18367809","18368125","81","2060592","GGCCAGGCGCAGTGGCTCACACCTGTAATCCCAGTGCTTTAGGAAGCCAAAGCAGAAGGATAGCTTGAAGCCAGGAGTTTGAGACCAGCCCGGGCAACATAGCAAGACCCCATTTCTCTGCAAAAAAATTAAAAATTAGCCAGGCATGGTGGTCTGCACTTGTAGTCCTAGCTACTTGGGAGGCAGAGGAGGGAGGATCACCTGTGCCCAGGAGTTCAAGGCAGCAGTGATCATGCCTATGATCATGCCATGCCACTGCACTCCAGCCTGGGCAAGACAGTGAGACCCTGTCTCTTAAAAAACAAGCAAAAAAAAAAAA","GGCCAGGCGCAGCAGCTCATGCCTGTAATCCCAGCACTTTGGGAGGTTGAGGCAGGAGGATCACTTGAGCCAGGAGTTTGAGACCAGCCTGGGCAATAAAGCAAGACCTTGTCTCTCAAAAATAAATAAATAAATAAATAAATAATTAGCTGGACATGGTGGCACGTACCTGTAACCCCAGCTACTTGGGAGGCTGAGGTGGGAGGATCACTAGAGCCCAGGAGTTCAAAGCCGCAGTGATCCATGATTGCACCACTGTATTCTAGCCTGGGAGACAGAGCAAGACTCCATCTCTTTAAACAAACAAACAAACAAAA"
"chr1","16317642","16317947","chr20","46003702","46004015","82","29686060","GGGCAGGCACAGTGGCTCATGCCTATAATCCCAACACTTTAGTAAGCCAAAACAGGAGGATCATTTGAGGTCAGGAATTTGAGACCAGCCTGGGCAACAAAGTGAGACACCATCTCTACAAAAAAATAATTAACCGGGTGTGCTGGCACACATCTGTGGTCCCAGCTACCCAGGAGGCTGAGCAGGAGGATCACTTGAGCCCAAGAGTTTGAGGCTACAGGAAGCCATGACCACACCACTGGACTCCAGCCTGGGCAACCGAGTTAGACCATGTCTCGAAGAAAAAAAAAAAAAGAAGAAGAAGAA","GGCTGCGCACAGTGGCTCACACCTGTAATCCAGCACTTTGGGAGGCCAAGGCAGGAGAATCATTTTCGTTCAGGAGTTTGAGGCCAGCCTGGGCAATATAGAGAGATCTTCTCTCTACAAAATATAATAATAATAATAATAATAATAAGCCAGTTGTGGTGGCTCACACCTGTAGTCTCAACTACTCAGGAAGCTGAGGTGGGAGGATCACTTGAGCCCAGGAGGTTGAGGCTGCAGTGAACCAGACTACACCACTGCACTCCAGCCTGAGTGACAGAGCAAGACCTTGTCTCAAAAGAAAAAAAACAACAAAA"
"chr1","16320500","16320708","chr7","137245286","137245521","65","120924786","CCAGTCTGGGGCACAGAGCGAGACTCCCATCTCAAAAAAAAAAAAAATTAGCTGGGCATAGTGATGTGCGCCAGCTACTTGGGAGGCTGAGGTGGGAGAATCACTTGAACCTGGGAGGCAGAGGTTGCAGTGAGCTCAGATCGTGCCACTTCACTCCAGCCTGGGTGACAGAGTGAGACCCTATCTCAAAAAAATAATAAAACAAAAAA","AGCCTGGGCAATATAGTGAGACTCTGTCTCTACAAAATAAATAAATAAATAAATAAATAAAATTAGCCAGATGTGGTGGTGCATGCCTGTAGTCCCAGCTACTAGTGAGGCTGAGGTGGGAGGATCACTTGAGTTCGGGAAGTCGAGGTTGCAGTGAGATATGATCATGCCACTGCACTCCAGCCTGGATGACAGAGTGAGACCCTGCCTCAAAAAAATTAAAAAAGAAAAGAAAA"
"chr1","16330239","16330506","chr1","88859712","88859991","79","72529473","GGCAGGGTGCAGGGGCTCATGCCTGTAATCCCAGCACTTTGAGACGCCAAGATGAGAGGATCACTTGAGCCCAGGAGTTCAAGACCAGCTGGGGCAACACAGACTAGGCCCTGTTTCCACAAAAAAAATTTAAAAATTAGCTGGGTGTGGTGGCAGCTACTTGGGGGCTGGGGTGGAAGGATGGCTTGAGCCCAAGAGGTGGAGGCTGCAGGGAGCTATGGTCTTACCACTGCACTCCAGCCTGTGTGACAGAGTGAGATCCTGTCCC","CCAGGCACAGTGGCTCACACCTGTAATCCCAGCACTTTGGGAGGCCAAGGCAGGAGGATTGCTTGAATCCAGGAGTTTGAGACCAGCCTGGGCAGCATAGTGAGACTTGGCCTCTACAAAAAAAAAAAAAAAAAAAAAAAAAAGTTACCTGGGAAGTCTCAGCTACTTGGAAGGCTGAGGTCGGAAGGTTGCTTGAGTACAGGAGGTCAAGGCTGCAGTGAGCTATGATTGTACCACTGCACTCCAGCGTGGGCAACAGAGTGAGACCTTATCTCAAAAA"
"chr1","16333332","16333592","chr2B","20323238","20323496","86","3989906","GCCAGGAGTGGTGGCTTATGCCTATAATCACAGCAACTCAGGAGACTGCCACCAGAGGATCGCTTGAGGCCAGGAGTTCGAGACCAGCCTGGGCAAATAGTGAGACCCCCCCCCCCCATTTCCAAGAAGAAAAAAAAAATGCTAGGTATGGTGGTGTGCACCTGTAGTCCCAGCTATGTGGGAGGCTGAGGTGGGAAGATCACCTGATGATTGCACCACTGCACTCCAGCCTGTGACAGTGCAAGACGATCTCTTAAAAAA","GGCCAGGCACAGTGGCTTATGCCTATAATCTCAGCAATTTGGGAGGGTGAAGTGGGAGAATCGCTTTAGTCCAAGAGTCTGAGATCAGCCTGGGCAACAGAGTGATACACCGTCTCTACAAAAAAAAAAAAAAAAAAAAAAAAATTAGCCAGGCAGGTGTGGCTGTGGTCCCAGTTACTGGGGAGGCTAAGGTGAGAGGATCACTTCAGTGAATCTTCTTACTGCACTTCAGACTGGGCAACAGAGTGAGACCCTGTCT"
"chr1","16356702","16356824","chr15","37343640","37343763","66","20986938","GGCCAGTTGCAGTGTTGCACGCTGGTAATCCCAACCCTTTCAGTGGCTGACATGGGAGGCTGACTTGAGGCCAGGAGTTGAGATCAACCTGAGCGAGATAGCAAGACCCCATCTCTACAAAAA","AAGATCCCTGGCCAGGATTTCAAGACCAGCCTGGGCAACACAGTGAGACCATACATACATACATACATACATACATACATCATACATACATACATACATACATACATACACAGTCTTACAAAGA"
"chr1","16371192","16371354","chr19","6391716","6391877","63","9979476","GCTGGGCATGATGGCTCATGCCTGTAATCCCAGCACCTTGGGAGGCTGAGGCGGGTGGAGATTGCCTGAGACAGAAATTGCCTGAGACTGCAGTGAGTGTTCCCCACTGCACCCCAGCCTGGGCAACAGAGCAAGACCCTGTCTCAAAGAAAAAAGACAAAAA","CCAGGCGCAATGGCTCACGCCTGTAATCCCAACACTTTGAGAGGCCGAGGCAAGAGGATTGCTTGAGGCCAGGAGTCCGAGACCAGCCTGGGCAACACAGCGAGGCCTCATTCTCTACAAAAAATAAATATATAAATAAATAAATAAATAAGAAGAAGAAAA"
"chr1","16371436","16371449","chr20","87144","87254","97","16284292","GGAAAAAAAAGGAA","CCTGGGCAACATAGTGAGACTACATCTCTACACTCACGCACACACACACACACACACACACACCCCCCAAATTAGCCAGGCATGCTGATGTGCACCCATAGTCTCAGCAAC"
"chr1","16371761","16371945","chr22","26696703","26696888","73","10324942","CCAGTCTGGGCAATATGGCAAGACCCTGTCTCTACAAAAAAATTTTCTTTTTAAATTAGCCAGGCACATAGTGGTACACGCCTGTGGGCCCAGCTACTCAGGAGGCTGAGGCTGCAGTGAGCTGTATTCCGACCACTGCACTCCAACCTTGGCAACAGAGCAAGACCCTTCTGTCTTAAGAAAGG","CCAGCCTTGGCAACATAGCAAGACCCTGTCTCTATCAATCAATCAATCAATCAATCAATAATCCAGGCGTGATGGCACACACCTGTGGTCCCAACGACCCGGGAGCCTGAGGTGGAAAGATCGTTTGAGCCCAGGAAGTTGAGGCTGCAATGAACTGTGAACATGCTACGGCACTCCAGTCTGGGC"
"chr1","16380196","16380309","chr8","58489091","58489211","66","42108895","CAGGCAAGGTGGTGCGCGGCTGTATTCCCATCTACTTGGGAGGCTGAGGCAGGAGGATCGCTTGAGGGCAGGAGTTTGAGACCAGCCTGAGCAACATAGAGAGACGCTCGTCTC","TTGAGACCAGGAGTTTGAGACCAGCTTGGACAACATAGTGAGACCCTGTCTAAAAGAAAGAAAGAAAGAAAAGAAAGAAAGAAAGATGTAGCCAAGTGTGGTGGTGCACATCTGTGTCTCA"
"chr1","16380907","16381104","chr12","23162528","23162744","73","6781621","CCTCATCTTTTTTTTTTTTTTAAAGAAAAAAATAGCTGGGCATAGTGGCATGTGCTTGTAATCCCAGCTGCTCAGGAGGCTGAGGCAGATCGCTTGAGTCCAGGAAATCAAGGCTACAGTGAGCTATGATTGCATCACTGCACTCCAGCCTGGGCAACAGAGCAAGACCCTGGCTCGTTAAAAAAAAAAAAAAAAAAA","TCTCTACAGAAAATAATAAAAACTTGGCTGGGCATGGTGGCATGTTCTTGTAGTCTCAGCTACTCAGGAGGCTGAGGTGAGAGGATTGCTTGAGCCCAGAAGGTTGCGTTAGGGTTAGGGTTAGGTTTAGGGTTAAGGTTAGCCATGATTGCACTCTTGCCTGGGCAACAGAGCAAGACCCTGTCTCAAAAAAAAAAAAAAAAAAAAAAAAAAAAAA"
"chr1","16381108","16381273","chr18","55799233","55799394","63","39418125","GCCAGGTGTGGTGGCACATGCCTATAATCCCAGCTGCTCAGGAGGCCGAGGCCGAAGGATCACTTGAGTCCAGGAGTGTGAGGCTGCAGTGAGCTGTGATTGTACCATTGCACTGTAGTTTGAACAACAGAGCAAGAACTTGTTTCTTAAAAAAATAAATAAAAAA","GGCTGAGAGAGGTGGCTCATGCTTGTAATCCCAGCACATTGGGAGGCAAAGGTGGGAAGATTGCTTGAGGCCAGGAGTTCAAGACCAGCCTGGGCAACATGAAAACACTTTGTCTCTACAATAAATAAATAAATAAATAAATAAATAAAAGAAACAAGAAAA"
"chr1","16383209","16383518","chr16_NW_019937288v1_random","81574","81898","81","16301635","GGCTGAGGCAGTGGCTCATGCCTGTAATCCCAACACTTTGGGAGGCTGAAAGAGGAGAATTGCTTGAAACCAGGAGTTCAAGACCAGCCTGGACAAGAAAGTAAGACCTCAACTCTACAAAAAATAAAAAATTAGCTGGGCATGGTGGCACACACCTGTAGTCCCAGCTACTTGGGAGGCTGCTGAAGTGGGAGGATTGCTTAAGTCCAAGAGTTTGAGGCAGCAGTGAGCTATGATTGTGCCATTGCACTCCAGGTGCATGACAGAGTGGGGCCCCACCTCGAAAGAAAAGAAAAAAAAAAGGAAAGAA","GGCTAGGCCCATTGGCTCATGCCTGTAATCACAACACTTTGGGAGGCTGACATGGGAGTATTGCTTGAGGCTAGGAGTTCAAGACCAGCCTGGGCAATATGGTGAGATCCTGTCGGTAGACCAAAAAAAAAAAAAAAAAAAAAAAAAAAATTAGCTGAGCATGGTAGCACATGTCTGTAGTCCCAGCTACTTGGAAGGCTGGGGTAAAAAGATTGCTTCAACCCAGGGTTTAAGGCTGCAGTGAGCTATGATCATGCCTCTGGACTCCAGTCTGGGTGACAGAGCAAGACCCCATCTCTAAGAAAAAAAAAAAGAAAAGAAAAAA"
"chr1","16401313","16401587","chrX","3592780","3593062","70","12808533","GCAGTGGCTCACGCCTGTAATCCCAACACTTTGGGAGGCCAAGGTGTAAGGATTGCTTGAGGCAAGGAGTTTGTGACCAGCCTGGGCAACACAGCGAGACCACGTCTCTACACAAAATAAAAAAATCAGCTGGGTGTGGTGGTTGGTGCCTATGGTCCCAACTACTCAAGAGGCTAGGGCAGGACGATCAGTTGAGCCCAGGAGTTTAAGGCTGTAGTGAGGCCATGTTCACGCCACTGCACTCCTGCCTGGGTAACAGAGTGAGACTCTGTCTC","GTGGTGGCTCATGTCTGTAATCCCAGCACTTCAGGGGGCCAAAGCGAGAGGACTGCTTGAGGCCAGGAGTTTGAGACCAGCCTGCGCAACATAGAAAGACCCCATCTCTATAAATAAATAAATAAATAAATAAATAAGTCAGGCATGGTGGCACATGCCTGTAGTCCCAGCTACTCAGAAGGCTGAGGTCGGAGGATCTCTTGAGCCCAGGGGTTCAAGGCTGCAGTGAACCATGATCACACCAGTGCACTGCAGCCTGGGCAACACAGCAAAACCCTGTCCC"
"chr1","16406461","16406763","chr20","46003702","46004015","82","29597241","GGCTAGGTGCGATGGCTTACACCATCTACCCAGCACTTTGGGAAGCTGAGGCAGTAGAATCACTTGAGTCTGGGAGTCCGAGAACAGCCTGGGCAACATAAGAGACTCCATCTCTACAAAAAATTTTAGAAATTAGCCAGCCACAGTGGCACATGCCTGTAGTCCCAGCTACTCAGGAGGCTGAGGTGGAAGGATTACTTGATCCCCGAAGGTGGAGGCTGCAGTGAGGTAGGATCATATGACTGCATTCCAGCCTGGGTGACAGAACAAGGCCCTGTCTCAAATAAATAAATAAATAATAAA","GGCTGCGCACAGTGGCTCACACCTGTAATCCAGCACTTTGGGAGGCCAAGGCAGGAGAATCATTTTCGTTCAGGAGTTTGAGGCCAGCCTGGGCAATATAGAGAGATCTTCTCTCTACAAAATATAATAATAATAATAATAATAATAAGCCAGTTGTGGTGGCTCACACCTGTAGTCTCAACTACTCAGGAAGCTGAGGTGGGAGGATCACTTGAGCCCAGGAGGTTGAGGCTGCAGTGAACCAGACTACACCACTGCACTCCAGCCTGAGTGACAGAGCAAGACCTTGTCTCAAAAGAAAAAAAACAACAAAA"
"chr1","16411190","16411473","chr4","187957937","187958223","82","171546747","GGTGGCACACATCTGCAATCCCAGCACTTTGGGAGGCTGAGGTAGGAGGATCATTTGGGCCAAGGGTTTTGAGACCAGCCTGGGCAAGACAAGACCCTGTCTCTACAAAAAATTAAAATATTAGCCAGGCCTGGTGGTGAGCACCTGTAGTCCCAGCTACTTGGGAGGCTGAGGTGGGATTATCTCTTGAGCCCAGGAATTCAAGGTGGCAGTGAGCTGAGATCGTGTCACTGCCTTCCAGCCTGGGCAACAAAACGAGACCCTATTTCTTTCAAAATAAAAGA","GGGCACAGTGGCTCATGCCTGATTCCCAGCACTTTGGGAAGTTGAGACAGGCGGATCACTTGAGCCCAAGAGTTCGAGACCAGCCTGGTGTTCTCTAAAACAAACAAACAAACAAACAAACACACGATTAGCTGGGCATGGTGGCTCACACCTGTAGTTCTAGCTACTCAGGAGGCTGAGGTGGGAGGGTAGCTTGAGCCCAGGAGTTCAAGGCTGCAGTGGGCTATGATCATGCCATTGCACTCTAGCCTGGGCAACAGAGTGAGACCCTGTTTCAAAAAAAAAAA"
"chr1","16434849","16435151","chr14","31798968","31799292","78","15364119","GGTACAGTGGCTCACACCTGTAATCCCAAAACACTGGGAGGCTGAGGCGGGAGGATCCCTTGAGCTGAGGAGTTCAAGACCAGCCTGGACAACATAGTGAGATTCCCATCTACAAAATATTTGAAAATTAGCCAGGTGTGGTGGTGTGCACTTGTAGTCTCAGCTACTCAGGAGGCTAAGGTGGGAGGATCCCTTGAACCCCAGAGTTGGAGGTTGCAGTGAGCTATGGTCATACCACTGCACTCCATCCTGGGTGATAAAGGAAGACCCTGTCTCAAAAAATAAATAAATAAATAAATAAGA","GGCTGGGCACAGTAGCTTACACCTGTAATCCCAGTACTTTGGAAGGCTGAAGTGGGAGGATCCCTTGAGGCCAGGAGTTTGAGACCAGCCTGGGCAACATAGTGAGACCCTGTCTCTACAACAAACAAACAAACAAACAAACAAAACTTAGCCAGTTGTGGTGGCACATCCTATAGTCCCAGCTACTCAGGAGGCTGAGGAGGGAGGATCTCTTGAGCCCAGGAGTTTGAGGCTGCAGTGAGCTATGATCATGACACTGCACTCCAGCCTGGATAACACAGCAAAATCCTGTCTCAAAAAAAAAAAAAAAAAAAAAAAAAAAGAA"
"chr1","16438074","16438401","chr2B","11119941","11120261","78","5318133","GGCCAGGTATGGTGGCTCATGCCTATAATCCTAGCACTTTGGAAGGCTGAGGCAGGAGGATCTCTTGAAGACAGGAATTCAAGACCAGCCTGGGCAACATAGCAAGACCCCCGTCTCTACAAAAAGTAAGAAAAATAGCAGGGTAGGGTGGTGTGTGCCTGTAGGCCCAGCTACTCAAAAGGTTGAGGCAGGAGGATCCCTTGAGCCCGGGAATTTGAGGCTGCAGTGAGTGATGATCGCACCATTGCACTCCAGTGTGGGGTGACAGAGAGAGAAAGAAAGAGAGAGACCCTGTCTAAAAAAAAAAAAAAAAAGAAAAGAAAAAGAA","GGCTGGGTGTGGGGGCTCATGCCTGTAATCCCAGTGCTTAGGGAGGTCGAGGTGGCAGGGTCGCTTGAAGCCAGAATTTGAGACCAGCCTGGGCAACATAATGAAACCCCATCTCTACAAAAAATAAAAAATTAGCCAGGCGTGGTGGTATGTGCCTGAGGTCACGCTACTCAGGAGGCTGAGATGGGAGGATCTCTTGAGACCAGGAGGTCGAGGCTGCAGTGAGCAATGATCATTTCACTGCATTTCAGCCTGAGTGACAGAGAGAGAGAGAGAGAGAGAGAGAGACCCTGTCTTTAAAAAAATAAAAAGAAAACAAAA"
"chr1","16446286","16446561","chrX","3592780","3593062","80","12853506","GCCAGGTGTGGTGACTCACGCTTATAATCCCAGGGCTTTGGGAGGCCAAGGTGGGAGGATCACTTAAGACCAGGAGTTAGAGACCAGCCTGGGCAACATATCAAGACCCTATCTCTAACAAAAATTGAGTGGGCATGGTGGCATGTGCCTGTATTCCCAGCTACGTGAGAGGCTGAAGCGGGAAGATTACTTGAGCCCAGGAGTTCGAGGCTGCAGTGAGCTATGGTGCACTGCACACTGCACTTCAATCTGGGCAACAGAGCATGACCCTGTTTC","GTGGTGGCTCATGTCTGTAATCCCAGCACTTCAGGGGGCCAAAGCGAGAGGACTGCTTGAGGCCAGGAGTTTGAGACCAGCCTGCGCAACATAGAAAGACCCCATCTCTATAAATAAATAAATAAATAAATAAATAAGTCAGGCATGGTGGCACATGCCTGTAGTCCCAGCTACTCAGAAGGCTGAGGTCGGAGGATCTCTTGAGCCCAGGGGTTCAAGGCTGCAGTGAACCATGATCACACCAGTGCACTGCAGCCTGGGCAACACAGCAAAACCCTGTCCC"
"chr1","16460496","16460606","chr20","87144","87254","61","16373352","GGCCGGGTGCAGTGGCTCACGCCTGTAATCCCAGCACTTTGAGAGGCCAAGACGGGAGGATCATTTGAGGCTGGGAGTTTGGGACCAGCCTGGGCAACATAGTAAGATGCA","CCTGGGCAACATAGTGAGACTACATCTCTACACTCACGCACACACACACACACACACACACACCCCCCAAATTAGCCAGGCATGCTGATGTGCACCCATAGTCTCAGCAAC"
"chr1","16460903","16461118","chr7","119744984","119745215","63","103284081","TGTTAGACCCCATTTCTTAAAAAAAAAAAAAAAAAAAAAAATTAGTGTGGTGGTGGTGCATGCTTGGAATCCTAACTACTTGCGAGGCTGAGGTGGGAGAATTGCTTGAGCCCAGGAGTTTGAGGCTGCAGTGAGCTATGATCACGGCCTCGCACTCCAGTCTAGGCAGCAGTGAGACCCTAGAGAATTCTCTAAAAGAATTAAAAATGAAAAAAA","CAGCCTGGGCAATATAGGGAGACCTCATCTCACAAAAAAAAAAAAAAAAAAAAAAAAAATTAGCCTATTGTGGTGGTGCACGCTTGTGGTGCCAGCTACTTGGGAGGCTGAGGTGGGAGGATCACTTCAGCCCAGGAGTTAGAGGCTGCAGTGAGCTATGATCCTGCCACTGCACTCCATCCTTGGCAACAGGGCAAGACACTTGACTCAAAAAGAAAAAAGAAAAAAAAAA"
"chr1","16463509","16463617","chr20","87144","87254","64","16376365","GTGGTGGCTCATGCCTTTAAGCCCAGCACTTTGGGCGGCCAAAGCAGGAGGATCACTTGAGGCCAGGAGTTTGAGATCAGCCTGGTCAATATAGCAAGACTCCATCTCT","CCTGGGCAACATAGTGAGACTACATCTCTACACTCACGCACACACACACACACACACACACACCCCCCAAATTAGCCAGGCATGCTGATGTGCACCCATAGTCTCAGCAAC"
"chr1","16480100","16480217","chr8","58489091","58489211","63","42008991","GCCAGACACAGTGGCTTATGCCTGTAATCCCAGCAATTTGGGAGGCTGAGGTGGGAGGAGTGTTTGAAGCTAGGAGTTCAAGACCAGCGTGGGCAACATAGTGAGACCCCCATCTCCA","TTGAGACCAGGAGTTTGAGACCAGCTTGGACAACATAGTGAGACCCTGTCTAAAAGAAAGAAAGAAAGAAAAGAAAGAAAGAAAGATGTAGCCAAGTGTGGTGGTGCACATCTGTGTCTCA"
"chr1","16504148","16504264","chr8","58489091","58489211","62","41984943","GGCTGGACCAGGTGGTGCATGCCTGTAGTCCCAGCACTTTGGGAGGAGGAGACAGGAGGATCGCTTGAGGACCAGAGTTGGAGACCAGTATGGGCAAGATTGCAAGACCCTGTCTCT","TTGAGACCAGGAGTTTGAGACCAGCTTGGACAACATAGTGAGACCCTGTCTAAAAGAAAGAAAGAAAGAAAAGAAAGAAAGAAAGATGTAGCCAAGTGTGGTGGTGCACATCTGTGTCTCA"
"chr1","16595717","16596013","chrX","16155635","16155942","78","440082","GGCCAGGTTCAGTGGCTAACTTCTGTAATCCCAGCACTTTTGGAGGCCTAGGTGGGAGGATCGCTTGAGGCCAGAAGTTCAAAACCAGCCTGAGCAACATAGCAAGACCTTGTCTCTATGAAAAATATAAAATTAGCCAGAAATGGTGATGTGTGCCTATAGTTCCAACTACTTGGAAAGCTGAGGCAGGAGGATCGCTTGAGCCCAGAAGTTCAAGATTGCCGTGATCTATAATCACCAGTGCACTCCACCCTGGGTGACAGAATAAGACCCTGTCTCAAAAAAAAAAAAAAAAAA","GGCCAGGCACAGTGGCTCACACCTGTAATCCCGGTACTTTGGGAGGCTGAGGCGGGAGGATCACTTGAGCCCAGGAGTTCAAGACCAGCCTGGGCAACATAACAAGACCCTGTCTCTACCAAAAAAAAAAAAAAAAAAAAAAAAAATAGCCAGGCCTGGTGGCCTGTGTCCATAGTCCCAGCTACTTTGGGAGACTGAGGTGGAAGGATCACTTGAGTCTGGAAATCAAGACTGCTGTGAGCTGTGATCATGCCACTGTACTCCAGCCTGAGCAACAGAGTGAGACCCTGTCTAAAAAAAAAAAAAAA"
"chr1","16635418","16635610","chr14","51003183","51003398","64","34367765","ACATAGCAAGACCCTGTCTCAAAAAAAAAAAAAAAAATTAGCTGGGTATAGTGGTGAACACTTATAGTCCCAGCTATTTGGGAGGCTGAGGTGGGAGGATCACTTGAGCCTGGGAGGTCAAGCCTAACATGAGTTGTGATTGTGCCACTGCACTCCAGCCTGGGCGACAGAGAGAGACTGGCTCAAAAAAAAA","AGCCTGGGCAAGATAGTGAGACCTCATCTCTTAAAATAAATAAATAAATAAATAAATAGCAGGATGTGGTGGCGTGCATCTGTAGTCCCAGCTACTCAGGAGGCTGAGATGGGAGGATTACTTGAGCTCAGGAGGTCGAGGCTGCAGTGAGCTATGATCACGCCACTGTACTCCAGCCTGGGTGAGAGTGATACCCTGTCTCTAACAAAAAAAAAA"
"chr1","16898856","16899115","chrX","146667163","146667441","100","129768307","GCCAGGAATGGTGGCTCATATCTACAATCCCAGCACTTAAAGAGTTGGAGACCAGCCTGGGCAACATAGTGAAACTCCTGTCTCTACAAATTTTTAAGTATTAGCTAATTTTTTAAAGTTGGCAGGGCATGATAATGCATGACTGTAATCTCAGCTACTAGGGAGACTGAGGCAGGCTCCAGTGAACTATGATTGTGCCACTGCCCTCCAGCCTGGGTGACAGAGTGAGACTCCCAACTCAAAAAAAAAAAAAGAAAAGA","TCATGCCTGTAATCCCAGCACTTTAGGATGCCAAGGCAGGAGGACCTCAGGAGTTCGCGATTAGCCTGGGCAACATAGGGAGACCCTGTCTCTATAAAATAATAATAATAATAATAATAATAATAATAAATTAGCTGAGTATAATGGTGCATGCCTGTGTTCCCAGTTACTCAGGAGGCTGAGGTGGGAGGATCCCTTAAGCATAGAAGGTCTGTGATTACACCACTGCACTCCAGCCAGGGCAACAGAGTGAGACCCTGTCTCAAAAAAGTAAAAAAA"
"chr1","16909343","16909459","chr20","87144","87254","63","16822199","GGCTGGACGAGGTGGTGCATGCCTATAGTCCCAGCACTTTGGGATGGGGAGATAGGAGGATCGCTTGAGGCCCAGAGTTGGAGACCAATATGGGCAAGATTGCAAGACTCTGTCTCT","CCTGGGCAACATAGTGAGACTACATCTCTACACTCACGCACACACACACACACACACACACACCCCCCAAATTAGCCAGGCATGCTGATGTGCACCCATAGTCTCAGCAAC"
"chr1","16941877","16942001","chr1","217544386","217544536","57","200602509","GGCTAGGCATGGTGGCTTATGCCTCTAATCCCAGCATTTTTGGAGGCCGAGGCAGGGGAATCACTTGAGGCCAGGAGTTTGAGACCATCCTGGGCAACACAGCAAGACCCCATCTCTAAAAAAAA","GGCTGGGCGTGGTGGCTCATGCCTCTAATCCCAGCACTTTAGGAGGCCAAGGCAGGAGGATAACTTAAGACCAGGCTGGGTGACACAGTGAGACTTTGTCTCTAAAAAAAAAAAAAAAAAAAAAAAAAAAAAAAACCTACAAAAACATATA"
"chr1","16957127","16957414","chr8","15910614","15910909","73","1046513","GCCAGCTGTGATGGCTCATGCCTTTAATCTCATGCTTTGGGAGGCCAAGTTGGGAGGACTGCTTGAGCCTAGGAGTTCAAGACCAGCCCAGGCAACATAGTGAGAACCAGTCTCTACAAAAAATTTAAAAAATAGCTAGGTGTGGTGACACGCTCCTGGAGTCCCAGCTACTTGGGAGGCTGAGGTGGGAGTATCCCTTGAGCCCAGGAAGTCAAGGCTGCAGTGAGCTGTGATCGCATCACCGCACTCCAGCCTGGGCGACAAAGCAAGACCCTGACTCTAAAAAAA","GGCCAGGCGAAGTGGCTCACACCTGTAATCCCAGCACTTTGGGAGGCCAAGGCAGGAGGATCATTTGAAGCCAGGAGTTCAAGGCCAGCCAGAGAAACATAGTGAGAACCTGTCTTTACAAAAATTAAAATTAAAATTAAAATTAGCCAGGAGTGGTGGTGCATGCCTGCAGTCCCAGCAGCTCAGGAGGCTGAGGTGGGATGATTGCTTGCACCAGGAGTTCGAGGCTGCAGTGAGCTGTGATCGTGCCACTGCACTCCAGCCCCTGGGTGACAAAGCAAGATCCTCTAAAAAAA"
"chr1","16961363","16961569","chr17","17826312","17826529","53","864949","GACCGGGTGCCGTGGCTCATGCCTCTAATCCCAACCCTGAGAGGCTGAGACAGGAGGATCGCTTGAGGCCAGGAGTTTAAGACCAGCCTGGGCAACATAGTGAGACCCCGTCTCCACAAAAACTACAAAAATTAGCTGGGCGTGGTGGCACACCTGTAGTCCCAGCTACTCAGGAGGCTGAGGAGGGAGGACCACTTGAGCCCGGGA","GGCCAGGCGCGGTGGCTCACACCTGTAATCCCAGCACTTTGGGAGGCCGAGGCAGGAGGATTGCCTGAGGCCAGGAGTTTGAGATCAGCCTGGCCAACATGGTGAAACCCCGTCTCTACTTAAAAAAAAAAAAAAAAAAAAAAAAATAGCCAGGCTGGTGATGTACACCTGTAGTCCCAGCTACTCAGGAGGCTGAGGCAGGAGAATCACTTGAGCTC"
"chr1","16981146","16981282","chr5","32595015","32595178","67","15613869","GGCCGGGGGCAGGGACTCATGCCTGTAATCCCAACAGCCCAGGAGGATGAGACAGGAGGAATGCTTGAGGCCAAAATTTCGAGGCCGGAAGTTCCAGACGAGCCTGGGCAACACAGCAAGACCCTGTCTCTAGAAAA","GGCCGGGTGTGGTCCCTCATGCCTGTAATCCCAACACTTTGGGAGGCTGAGATAGGAGGACTGCTTGAGGCCAGGAGTTCAAGACCAGCCTGGTCAACATAGTGAGACCCCATCTCTATAAAATAATAATAATAATAATAATAATAATAATAAATAAATAAATA"
"chr1","17009388","17009694","chr16","9702460","9702783","79","7306928","GGCCGGGTGTGGTGGCTCACACCTGTAATCCCAGCACTTTGGGAGGCTGAGGTAGGAGGATCAGCATGAGGCCGGGAGTTCAAGATCAGCCTGGGCAACAAAATGAGACCCTGTCCCTACTAAAAAAAAATTAGCCTGGTGCAGTGGCACCTGCCTGTAGTGCCAGCTACTTGGGAGGCAGAGGCAAGAGTACCTCCTTTAGCCTAGGAGGTCAAGGCTCCAGTGAGCTAGGATCATGCCACTGTGCTCCAGCCTGGGTGACAGAGTGAGACCCTGTCTCTTTTAAAAAAAAAAAAAAAAAAAAAAA","CCGGGCATGATGGCTCATGCCAGTAATCCTAGCACTTTGGGAAGCTGAGGTGGAAGGATCGCTTGAGGCCAGGAGTTCGAAACCAGCCCAGTCAACATAGTGAAACCCCATCTCTACAAAAGAAAAATTAAAAAATTAGCTGGAATGGTGGCACATGCCTGTAGTCCTAGCTACTTGGGAGGCTGAGGCAGGAGAACTGTTTGAGCTCAGAAGTTCAAGGCTGCAGTGAGCCATGACTGTGCCACTGCACTCTAGCCTGGGTGACAGAGTGAGACCCTGTCTCAATAAATAAATAAATAAATAAATAAATAAGAAAACTAAAAA"
"chr1","17017438","17017527","chr8","58489091","58489211","61","41471653","TTCTAGCACTTTTGGGAAGCCAAGGTGGGAGGATTGCTTGAGGCCAGGACTTCAAGATCAACCTGGCCAACATAGTGAGACCCTGTCTCT","TTGAGACCAGGAGTTTGAGACCAGCTTGGACAACATAGTGAGACCCTGTCTAAAAGAAAGAAAGAAAGAAAAGAAAGAAAGAAAGATGTAGCCAAGTGTGGTGGTGCACATCTGTGTCTCA"
"chr1","17019755","17019954","chr14","51003183","51003398","65","33983428","GACCAGCCTGGACAACATAGTGAGATCCCATCTCTACAAACAAAATTTTTTTTAATTAGCCAGGTGTGGTGGCACGCACCTGTAGTTTCAGTTACTTGAGAGGCTGAGGCCGGAGGATCACTTGAGCCAGGTGTTCCAGGCCACAGTGAACTATGATCACACTTCAGCCTGGATGACAGAGCAAGACCCTGTCAAAAAAA","AGCCTGGGCAAGATAGTGAGACCTCATCTCTTAAAATAAATAAATAAATAAATAAATAGCAGGATGTGGTGGCGTGCATCTGTAGTCCCAGCTACTCAGGAGGCTGAGATGGGAGGATTACTTGAGCTCAGGAGGTCGAGGCTGCAGTGAGCTATGATCACGCCACTGTACTCCAGCCTGGGTGAGAGTGATACCCTGTCTCTAACAAAAAAAAAA"
"chr1","17025408","17025624","chr14","51003183","51003398","57","33977775","CAGCCTGGGGAACATAGGGCGACCCTGTCTCTACAAAAACTTTAAAACTTAGCCAGGCATGGTGGTATGCACCTATAGTCCCAGCTACTCAGGAGGCTGAGATGGGAGGATTGCTTGAGCACAAGAGTTCCAGGCTGCAGTGAACTGTGATTGTGCCACTGCACTCCAGCCAGGGGCACACAGCAAGACCCTGTCTCAAAAAAAAAAAAAAAAAGAA","AGCCTGGGCAAGATAGTGAGACCTCATCTCTTAAAATAAATAAATAAATAAATAAATAGCAGGATGTGGTGGCGTGCATCTGTAGTCCCAGCTACTCAGGAGGCTGAGATGGGAGGATTACTTGAGCTCAGGAGGTCGAGGCTGCAGTGAGCTATGATCACGCCACTGTACTCCAGCCTGGGTGAGAGTGATACCCTGTCTCTAACAAAAAAAAAA"
"chr1","17029726","17029919","chr12","23162528","23162744","74","6132802","TACAAAGAATTTTTTTGAATTCGCCGCACATGGCGGCATGTGCCTGTAGTCCCAACTACTCAGGAGGCTGTGGTGGGAGGATCGCTTGAGCCCAGAAGTTTGAGGCTAAAGTGAGCTACAGTGAGCTATGACTCCACCACTGTACTTCAGCCTGGGTGACACAGCAAGACTCAGCCAAGAAAAAAAAAGAAGAA","TCTCTACAGAAAATAATAAAAACTTGGCTGGGCATGGTGGCATGTTCTTGTAGTCTCAGCTACTCAGGAGGCTGAGGTGAGAGGATTGCTTGAGCCCAGAAGGTTGCGTTAGGGTTAGGGTTAGGTTTAGGGTTAAGGTTAGCCATGATTGCACTCTTGCCTGGGCAACAGAGCAAGACCCTGTCTCAAAAAAAAAAAAAAAAAAAAAAAAAAAAAA"
"chr1","17030208","17030334","chr18","55799233","55799394","61","38769025","GTCAAGTGTAGTGGCTCAGGCCTGTAATCCCAACACAGTGGGAGGCAAAGGCAGAAGGATTACTTGAGGCCGTGAGTTAGAGACCAGCCTGGGCAATATAGTGAGACACCTGCTCTACAAAAAACAA","GGCTGAGAGAGGTGGCTCATGCTTGTAATCCCAGCACATTGGGAGGCAAAGGTGGGAAGATTGCTTGAGGCCAGGAGTTCAAGACCAGCCTGGGCAACATGAAAACACTTTGTCTCTACAATAAATAAATAAATAAATAAATAAATAAAAGAAACAAGAAAA"
"chr1","17036827","17036957","chr1","217544386","217544536","63","200507559","GGCTAGGCATGGTGGCTCACACTTGTAATACTAGCACTTTCTTTGTGAGGCCAAGGCAGGAGGATTGCTTGAGGCCAGGAGTTTTGAGACCAGCCTGGGCAACAATAGCAAGACTTAGTCTCTACAGAAAA","GGCTGGGCGTGGTGGCTCATGCCTCTAATCCCAGCACTTTAGGAGGCCAAGGCAGGAGGATAACTTAAGACCAGGCTGGGTGACACAGTGAGACTTTGTCTCTAAAAAAAAAAAAAAAAAAAAAAAAAAAAAAAACCTACAAAAACATATA"
"chr1","17047698","17047976","chrX","3592780","3593062","72","13454918","CCTGGCATGGTGGCTCATGCCTATATCCCAACTCTTCGGGAGGGCCAGGCAGAGGATCACTTGGGGCCAGGAGTTCAAGACCAGCCTAGGCAACACAGTGAGACCCCTATCTCTACAAAAATAAATGTAAAAAAACTAACTGGGCATGGTGGCGCATGCCTGTAGTCCTAGCTACTGGGGAAGCTGAGATGGGAGGATCGCTTGAGTCCAGAAGGTTGAGGCTGCAGTGAGCTGTGATCATGCCACTGCACAATCAGTGACAGAGCAAAACTCTCTCTC","GTGGTGGCTCATGTCTGTAATCCCAGCACTTCAGGGGGCCAAAGCGAGAGGACTGCTTGAGGCCAGGAGTTTGAGACCAGCCTGCGCAACATAGAAAGACCCCATCTCTATAAATAAATAAATAAATAAATAAATAAGTCAGGCATGGTGGCACATGCCTGTAGTCCCAGCTACTCAGAAGGCTGAGGTCGGAGGATCTCTTGAGCCCAGGGGTTCAAGGCTGCAGTGAACCATGATCACACCAGTGCACTGCAGCCTGGGCAACACAGCAAAACCCTGTCCC"
"chr1","17070972","17071103","chr18","55799233","55799394","55","38728261","GGCCAGACACAGTGTCTCATGCCTGTAATCTCAGAACTTTGGGAAGCCAAGGCGGGAGGATTGCTTCAGGCCAGGGGCTTGAGACCAGCCTGGGCAACATAGTGAGACACTTGTCTCTACAAAAAAAATAAA","GGCTGAGAGAGGTGGCTCATGCTTGTAATCCCAGCACATTGGGAGGCAAAGGTGGGAAGATTGCTTGAGGCCAGGAGTTCAAGACCAGCCTGGGCAACATGAAAACACTTTGTCTCTACAATAAATAAATAAATAAATAAATAAATAAAAGAAACAAGAAAA"
"chr1","17092667","17092978","chr14","31798968","31799292","71","14706301","GGCTGGGTGCTGTGGCTCACACCTGTAATCCCAGTGCTTTGGGAGGTTGAGGTGGGTGGATCACTTAAGGCCAGGAGACAAACACCAGCCTGAGCAACATAGCAAGACCCCATCTTTACAAAAATAAAAAAAATTAGCCACGCATGGTGGCATGTGCCTGTAATCCTGGCTACTCAGGAGGCTGAGGCAGGAGGATGGCTTGAACCCAGGGGGTTGAGGCTGTAGTGAGCTATGATCATGCCACTGCACTCCAGCTTGGGCAATAGAACAAGGCCTTGTCTCAAAAAAAAAAAAAAAGAAAAAAAAAGAAAA","GGCTGGGCACAGTAGCTTACACCTGTAATCCCAGTACTTTGGAAGGCTGAAGTGGGAGGATCCCTTGAGGCCAGGAGTTTGAGACCAGCCTGGGCAACATAGTGAGACCCTGTCTCTACAACAAACAAACAAACAAACAAACAAAACTTAGCCAGTTGTGGTGGCACATCCTATAGTCCCAGCTACTCAGGAGGCTGAGGAGGGAGGATCTCTTGAGCCCAGGAGTTTGAGGCTGCAGTGAGCTATGATCATGACACTGCACTCCAGCCTGGATAACACAGCAAAATCCTGTCTCAAAAAAAAAAAAAAAAAAAAAAAAAAAGAA"
"chr1","17124968","17125272","chr10","65849492","65849800","79","48724524","GCTGGATGTGGTGGCTCAAGCCTGTAATCCCAACACTTTGGGAGGCTGAGGAGGGAGGATCACTAACATTCAGGAGTTTGAGATGAGCCTGGGCAACATAGCAAGACCCTGTCTCTACAAAAAAATTTAAAAATTAGCCAGGCATGGTGATGCACCCCCTGTACTCCCAGCTACTTGGGAGGCCAAGGTTGGGGGAATCTCTTGAGCCCACGAGGTTGAGGCTGCAAGTGAGCAGTGACCGTGCCACTGCATGCCAGCTGGGGCGACAGAGCAAGACTCTGTCTCAAACAAACAAACATCAAAAA","GGCCAGGTGTACTGGCTCATGCTTATAATCCCTGCACTTTGGGAGGCTGAGGTGGGAGGATTGTCTGAGGCCAGGAGTTTGAGACCAGCCTGGGCAACAGAGTGAGACCTTGTATCTTAAAAAAAAAAAAAAAAAAAAAAAAAAGCAGGGTATGGTGGTGCACACCTGTGGTCCAAGCTACTCGGGAGGCTGAGTGTTGGAGGATTGCTTGGGCCCAGGAGGTCGAGGCTGCAGTGAGCTGTATTCATGCCAGTGCACTCCAGGTTGGGTGACAGGGTGAGATTCTGTCTCAAAAAACAAACAACAAAA"
"chr1","17128882","17129178","chr20","46003702","46004015","74","28874820","GGCCAGGCACAGTGGCTCACGCCAATAATTCCAGCACTTTGGGAAGCTGTGTGGATCCCTTGAGTCCAGGACTTCGAGACCAGCCTGGGCAACGTAGTGGGACACCGTCTCTACAAAAAATTTTAAAAATCAGCCATGTGTGGTGGCCCACACCTGTAGTCCCAGCTACTGAGGCTGAGGTGGGAGGATCACTTGAGCCCAGAAGGTTGAGGCTGCAGTGAACTGTGATTGTGCCACTGCACTCCAGCCTGGGCAACAGAGCGAGACCCTGTCTCAAAAAATAATAATAAAAAAAAA","GGCTGCGCACAGTGGCTCACACCTGTAATCCAGCACTTTGGGAGGCCAAGGCAGGAGAATCATTTTCGTTCAGGAGTTTGAGGCCAGCCTGGGCAATATAGAGAGATCTTCTCTCTACAAAATATAATAATAATAATAATAATAATAAGCCAGTTGTGGTGGCTCACACCTGTAGTCTCAACTACTCAGGAAGCTGAGGTGGGAGGATCACTTGAGCCCAGGAGGTTGAGGCTGCAGTGAACCAGACTACACCACTGCACTCCAGCCTGAGTGACAGAGCAAGACCTTGTCTCAAAAGAAAAAAAACAACAAAA"
"chr1","17147614","17147849","chr11","113160190","113160427","70","96012576","AGGATTGGTTGAAGCCAGGAGTTCAAGACCAGCCTGGGCAACATAGTGAGACCTCGTCTCTACAAAAGTAAAAAAATTAGCCTGGCGTACTGGTGCGCATCTGTAGTGATAGCTACTTAGGAAGCTGAGGTGGGAGGATCACTTGAGCCCAGGAGTTTGAGGTTGCAGTGAGCCATGATCAAGCCACTGTACTCCAACCTGGGTGACAGAGTGAGGCACTGTTTCTTAAAACAAAA","AGGAATTGGAGACCAGCCTGGGCAGCATAGCAAGACTTCATCTCTAAACTAAAAAAAAAAAAAAAAAAAAAAAAAAAAATTAGCCAGTCATGGTGTTACATGCCTATAGTCTCAGCTACTTGGGAGGCTGAGATGGGAGGATCATTCGAGCCCAGGAGTTTGAGGCTGCAGTGAGCTATGATCATGCCACTGCACTCTAGCCTAGGTGACATAGTGAGATCCTGTCTCTTAAAAAAAA"
"chr1","17153615","17153899","chr12","36129721","36130020","75","18976106","GCCAGGCATGGTGGCTAACACCTGTAATCTCAGTACTTTGGGAGGCCAAGGCAGAAGGATCACTTGAGGCCAGGAGTTAGGGAACAGCCTGGGCAAAAAGTGAGGCCCTGTTTCTATTTTTTAAAAAAAATTGTTTTAATTAGCTGGGTGTGGTGGTGCACACCTGTGGTCCCAGCTACTTGGGAGGCTGAAGCAGGAGAATTGCTTGAGCTCAGGAGGTCAAGGCTGCAGGGAACTATGATTGAACCACTGCACTCCATCCTGGGCAACAGAGCAAGACCCTGT","GGCCAGGCATGGTGGCTCACATTTGAAGTCCCAGCACTTTCAGAGGCTGAGACAGGAGGATCACTTGAGGCCAGGAGTTTGAGATTAGCCTAGGCAACACAGTGAGAACCTGTTTCTACATGAAACAAACAAACAAACAAACAAACAAAAAGGTTTTAAATTAGCTGGGTGTGGTGGTACACACCTGTAGTCCTAGCTATTTGGGAGGCTGAGGCAGGAAGATGTGTTGAGCCCAGGAGTTCAAGGCTGCAATGAGCTATGATTGTGCCACTGCATTCCAGCCTGGGTGACAGAGCAAGA"
"chr1","17170574","17170680","chr9","47045786","47045941","66","29875212","GCAATGCCAGCACTTTAGGGGGTGAGGCAGGAGGATTTCTTGAGGCCAGGAGTTCAAGACCAGCCTGGGCAACATAGCAAGACCCCATCTCTTTAAAACAAAAATAA","GCTGGGCGCAGCAGCTCACACCTGTAATCCCAGTGCTTTGGAGGTCCAAGGTAGGAGGATTGCTTAAGACTAGGTGTTCAAGACCAGTCTTGGCAACATAGTGAGAACTCATCTCTACAATAAATAAATAAATAAATAAATAAATGAAAATAAAAA"
"chr1","17170982","17171287","chr14","31798968","31799292","78","14627986","GCTGGGCACAGTAGCTGACGCCTGTAAGCCCAGCACTTTGAGAAAGTCACTTTAGGCCAGGAGTTCAAGACCACCCTGGGCAACATAGTGAGACCCCCGTCTCCACAAAATATTTCTCAAAAATTAGCTGGGTGTGGTGGTGTGTGCCTATAGTCCCAGCTACTTGGGAGGCTGAGGTGAGGATTGCTGGAGTCCAGGAGTTTGAAGCTGCAGTGAGCTGTGATCAAGCCACTGCACTCCAGCCTGGGTAACAGAACGAGACCCTGTCTGTAAAACAAACAAGCAAACAAAACAAAAACAAAAAAA","GGCTGGGCACAGTAGCTTACACCTGTAATCCCAGTACTTTGGAAGGCTGAAGTGGGAGGATCCCTTGAGGCCAGGAGTTTGAGACCAGCCTGGGCAACATAGTGAGACCCTGTCTCTACAACAAACAAACAAACAAACAAACAAAACTTAGCCAGTTGTGGTGGCACATCCTATAGTCCCAGCTACTCAGGAGGCTGAGGAGGGAGGATCTCTTGAGCCCAGGAGTTTGAGGCTGCAGTGAGCTATGATCATGACACTGCACTCCAGCCTGGATAACACAGCAAAATCCTGTCTCAAAAAAAAAAAAAAAAAAAAAAAAAAAGAA"
"chr1","17172725","17172996","chr7_NW_019937272v1_random","17648","17925","91","17155077","GGCTGGAGGATTGTTTGAAGTCAAGAGTTTAAGACCAGCCTGAGCAACATAGTGGGACCCCATGCCACAAACCCTCCCTAAAAACTTTTTTTTCTTTATAAACTGGGTGTGGTGGCACACACTTGTGGTCCCAGTTACTTGAGAGGTTGAGGTGGGAAGATCACTTGAGACCACAGCTCTAGGCTACAGTGAGCCAAGATCATGCCTCTGCACTCCAGCCTGGATGACAGAGCAAGACCCTGTTTCTAAAAGAAATAAAAATAATAAATAAA","GAGGCAGAAGGATCCCTTGATGACAAGAGTTCGAGACCAGACGGTAACAAAGTGAGACCCTGTCTCTCCTATCTATCTATCTATCTATCTCTCTATCTATCTATCTTTTAATTATCTGGGCATGGTGGTGCATGCCTGTGGTCTCAGCTACTCCTTAGGCTGAGGTGGGAAGATCCCTTGAGCCCGGGAGTTGAGGCTGCAGTGAGCTATGATGGCACCACTGCACTCCAACCTGGGTGACAAAGCGAGATCCTGTCTCTAAATTAAATTAAAAACAA"
"chr1","17227994","17228274","chr7","116200737","116201028","75","98972743","CAGGTATGGTGGCTCATGTCTATAATCCCAGCACTTTGGGAGGCCAAGGCGGGAGGATCACTTGAGACCAGCCTGGGTAACATAGGGAGACCCCATCTCTACAAAAAATTTTTTAAAATAGCCAGGCGTGGTGGCACATGTCTGTAGTCCCAGCTACTCGGGAGGCTGAGGTGGGAGTATCGCTTGAGCCCGGGAGTTCAAGGCTGCAGTGAGCCGTGATAGCATCACTGCACGCCAGCCTGGACAACAGAGTGAGACCCTGTCTCTAAAACATAAGAAAA","GGCAGGGCATGGTGACTCAGGCCCGTGATCCCAGCACTTTGGGAGGCTGAGGTGAGAGGATCAGGAGTTTGAGATCAGCCTGAGCAACACAGTGAGACCCCATCTGTACAAAAACAAAACAAAACAAAACAAAACACCTGTCATGGTGGCAAACATCTTTAGTCTCAGCTACTTGGGAGGCTAAGTTGGGAGGATCACTTGAGCTCAAGAGTTTGAGACTTCAGTGAGCTATGATCACACCACTGTACTCCAGCCTGGTCGACAGAGTGAGACCCTGTCTCAAAAAAACAAA"
"chr1","17232249","17232402","chr1","217544386","217544536","66","200312137","CTGAGCGTGGTGGGGCAAGCCTGTGCTCCCAGCTCCTCAGGGGGTGAAGTGGGAGGATGGCTTGAGCCCAGGAGGTGGAGACTGCAGTGAGCTAGGATTGCACCACTGCACTCTAGTCTGGGTGACAGAGCAAGACCCTGTTTCATAAAATAAA","GGCTGGGCGTGGTGGCTCATGCCTCTAATCCCAGCACTTTAGGAGGCCAAGGCAGGAGGATAACTTAAGACCAGGCTGGGTGACACAGTGAGACTTTGTCTCTAAAAAAAAAAAAAAAAAAAAAAAAAAAAAAAACCTACAAAAACATATA"
"chr1","17246437","17246749","chr7","1830964","1831289","72","15415473","GGCCAGGCACAGTAGCTCACACCTGTAATCCCAGCACTTTGGGAGGCCAAGATGGGAGGATCGCTTGAGCCCAGGAGTTTGAGACCAGCCTGGGTAACATAGCAAAACCCCAGCTCCGTAAAAAATAAATTAGCAATTAGCTGGGCATGGTGGCCTGTGCCTGTATTCCTAGCTACTCAGGAGGCTGAGGTGGGAGGATCGCTTGAGCACAAGAATTCAAGGCTATAATGAGCTGTGATAGCACCACTGCACTCCAGCTTGGGTGACAGAGCAAGACTCGGTCTCAAACAAAAGAAAAGAAAACAAAACAAAA","GGCCAGCCATGGTGGCTCACACCTGTAATCCTAGCATTATGGGACGCCAAGCTGGGAGGATCACTTGAGGCCAGGAATTCAAGACCAGCCTAGGCAACATAGCAAAACCCAGTGTCTATAAAATAAAATAAAATAAAATAAAATAAAAAAATTAGGTGAGTATGGTGGCACTTGCCTGTAGTACCAATTACTCAGGAGGCTGAGGCAAGAGGATCACTTGAGCCCAGGAGTTCAAGGCTGTAGTGAGCTATGATTGCACCACCGCACTCCAGCCTGGGTGACAGAGCAAGATGCCATCTCTAAAAAAAAAAAAAAGAGAAAGAAAA"
"chr1","17272510","17272795","chr5","104248312","104248604","76","86975802","CCGGGCACGGTGGCTCACACCTATAATCCCAGCACTTTGGGAGGGTGAGGCGGGAGGATTGCTTGAGGCCAGGAGTTTGAGACAACCCTGGGCAACATGGCAAGACCCCATCTCTACAAAAAATTAGCTGAGCCTGGTGGCTGCACCTGTGGTCTCAGCTACTCGGGAGACTGAGGCAGAAGGATCACTTGAACCCAGGAGTTCCAGGCTGCCAGTGAGCTGTGATCATGCCATGGCACTCCAACCAGGGTGACAGAGAGACACTGTCTCCAAAAAGAAAAATAAA","GGCACAGTGCCTCACACCTATAATCCCAGCAATTTGAGAGGCTGAGAGGGTGGATTGCTTGAGGCTAAGAGTTTGAGACCAACCTGGACAACACTGTGAAACCTTGTCTTTACCAAAAAAAAAAAAAAAAAAAAAAAAAGTGGTGTGTGTGCCTTTAGTCTCAGCTACTTGGGAGACTGAAGTGGGAGGATTGCTTAAGCCCAGGAGTTCAAGGCTACAGTGAGCTATGATCACGCCACTGCACTCCATCCTGGGTGACAGAGCAAGATTCTGTCTCTAAGAAGAGAGAGAAA"
"chr1","17292235","17292396","chr5","32595015","32595178","69","15302780","TAGCCAGGCATGGTGGCACACACCTGTAGTCCCAGCTACTTGGGAGACTTAGGTGGGGGAATCACTCGAGCCCAGGAGGTCGAGGCTACAGTACATTGTGACTGAGCCATTACATTCCAGCCTAGGTGACAGAGCAAGACCCTGTCCCACAAGAAAAAAAAA","GGCCGGGTGTGGTCCCTCATGCCTGTAATCCCAACACTTTGGGAGGCTGAGATAGGAGGACTGCTTGAGGCCAGGAGTTCAAGACCAGCCTGGTCAACATAGTGAGACCCCATCTCTATAAAATAATAATAATAATAATAATAATAATAATAAATAAATAAATA"
"chr1","17292423","17292540","chr8","58489091","58489211","64","41196668","GGCCAGGTGTGGTGACTCATACCTGTAATCCCAGCACTCTGGGAGACCAAGGCGGGAGGATTGCTTGAGGCCAGGAGTTTGCAATCAGCTGGGGCAACATGCGATATCCTGTCTCTAC","TTGAGACCAGGAGTTTGAGACCAGCTTGGACAACATAGTGAGACCCTGTCTAAAAGAAAGAAAGAAAGAAAAGAAAGAAAGAAAGATGTAGCCAAGTGTGGTGGTGCACATCTGTGTCTCA"
"chr1","17294516","17294799","chr2A","84713238","84713534","79","67418722","TAATCTCAGCGCTTTGGGAGGCCAACGTGGGAGGATCACTTGAAGCCGGGAGTTTGAGGCCAGAGTGGGCAACATAGTGGGACCCTGTCTCTACAAAGAATAAAATAAAATAAATTAGCGATCATGATAGTGTGTGCCTGTACTCCCAGCTACTCAGGAGGCTGAGTTGGGAGGATGAGTCCAGGAGTGCAAGGCTGGAGTGAGCTGTGATTGCACTACTACTGCCCTCCAGCCTGGGCGACAGAGCAAGACCCTGTCTCTAAAACAACAACAACAACAATAAA","TCTCAGCACTTTGGGAGACCGAAGTGGGGGGATCCCTTGAGGCCAGGAGTTCTAGACCAGCCATGGGCAACACAGTGAGACACCATCTCTATGAAAATAAATAAATAAATAAATAAATAAATAGCTGAGCATGGTGGCATGCACCTATAGTCCCAGCTACTTGGGAGGCTGAGGTGGGAGCATCACTTGAGCCCAGGAGTTTGAGTTCAAGGTTACAGGGAGCTGTGATTCTACTGCTGCACTCCAGCCTGGGCAACAGAGTGAGACCTTGTCTTTACAAAATCAAAAAATAATAAA"
"chr1","17317740","17318033","chr8","15910614","15910909","73","1407126","GCCGGGCACTGTGGCTTGCGCCTGTAATCCCAGCACTTTGGGAGGCCAAGGCAGGAGGATCACTTGAGGCCAGGAGTTCGAGACCAGCCTGGGAAACATACTGAGACTCTCATCTCTATAAAAATGTTTTTTAAATTAGCTGGATGTGGTAGTGTGTGCCTGTAGTCCCAGCTACTCAGGAGGCTGAGGCCGGAGGATTGCTTGAGCCCAGGAGTTCAAGTCTGCCGTGAGCCATGATTGTGCCTCTGCATTCCAGCAAGACCTCCTCTCAGAAAAACCAAAACAAACAAAAAA","GGCCAGGCGAAGTGGCTCACACCTGTAATCCCAGCACTTTGGGAGGCCAAGGCAGGAGGATCATTTGAAGCCAGGAGTTCAAGGCCAGCCAGAGAAACATAGTGAGAACCTGTCTTTACAAAAATTAAAATTAAAATTAAAATTAGCCAGGAGTGGTGGTGCATGCCTGCAGTCCCAGCAGCTCAGGAGGCTGAGGTGGGATGATTGCTTGCACCAGGAGTTCGAGGCTGCAGTGAGCTGTGATCGTGCCACTGCACTCCAGCCCCTGGGTGACAAAGCAAGATCCTCTAAAAAAA"
"chr1","17324502","17324631","chr9","47045786","47045941","51","29721284","GGCCAGGTGCAGTGGCTCACACCTTTAATCCCAGTGCTTTGGGAGGCCAAGGTGGGAAGATCACTTGAGCCAGGAGTTCAAGGCCAGCCAGGGCAACATAGTGAGACCCTGTTTCTATTTTTTAAAAAAT","GCTGGGCGCAGCAGCTCACACCTGTAATCCCAGTGCTTTGGAGGTCCAAGGTAGGAGGATTGCTTAAGACTAGGTGTTCAAGACCAGTCTTGGCAACATAGTGAGAACTCATCTCTACAATAAATAAATAAATAAATAAATAAATGAAAATAAAAA"
"chr1","17328364","17328662","chr2A","88638728","88639031","73","71310364","GGCCAGGCACAGTGGCTCATGCCTGTAATCCCAACACTTTGGAAGACCAAGGCAGAAGGATTGCTTGAGGCCAGGAGTTTGAGACCAGCCTGGGTAACATAGCGAGACTCTGTCTCTACAAAAAATTTTAAAAATTAGCTGGGTGTGGTGGCATGCACCTGTAGTCCCTGCTACTTGGGAGGCTGAGACATGAGGATCACTTGAGCATAGGAGGTCAAGGCTGCAGTGAATTGTGATCACGTCACTGTCCTCTACCCTGGGTGACAAAGGGAGACCCTGTCTCTAAAAAAAAAAAATAA","GGTGCAGTGGCTCATGCCTGTAATTCCAGCGCTTTGGGAGGCAAAGGTGGGAGGACTGCTTGAGCCCAGGAGTTTGAAACCAGCCTGGGCAACATAGGGAGACTTCATCTGTATAAATAAATAAATAAATAAATAAATAAATAAGCTGGGCATGGTGGCATGCACCTGTGGTCCCAGCTACTTGAGAGGCTAAGGTGGGAGGATCACTTGAGCCCAGGAGGTTGAGGCTGCAATGAGTCATGATCACGCCACCACACTCCAGCCTGAGCTACAGAGTGAGGTCTTGTCTCAAAAAAAAAAAAAA"
"chr1","17353182","17353415","chr17","17826312","17826529","70","473130","GGCCAGGCGCAGTAGCTCACACCTATAATCCCAACACTCTAGGAGCCGAGGCAGGAAGATTGAGCCCAGGAGTTTGAGACCAGCCTGGGCAACATAGTGAGACCCCATCTCTACAGGAAAGAACAACTTTAAAAATTAGCCAGGTTGTGATAGCATGCACCTGTGGTCCCAGCTACTCGGGCGGCTGAGACGGGACCGTGATCCTTTGAGCCCAGGAGGTCAAAACTGCAGTGA","GGCCAGGCGCGGTGGCTCACACCTGTAATCCCAGCACTTTGGGAGGCCGAGGCAGGAGGATTGCCTGAGGCCAGGAGTTTGAGATCAGCCTGGCCAACATGGTGAAACCCCGTCTCTACTTAAAAAAAAAAAAAAAAAAAAAAAAATAGCCAGGCTGGTGATGTACACCTGTAGTCCCAGCTACTCAGGAGGCTGAGGCAGGAGAATCACTTGAGCTC"
"chr1","17370865","17371083","chr14","51003183","51003398","56","33632318","CCAGCCTGGGCAACATAACAAGACCCCATCTCTGCGGAAAAATGTAAAACCATTAGCTGGGCATGGTGGTGCACATCTGTAGTCCCAGCTGCTCAGGAGGCTGAGGTGGGAAGACCACTTGAGCCTGGGAGGTCAAGGCTGTGAACCATGATCACGCCACTTCACTCCAGCCTGGGTAACGGAGTGAGACCCTGTCTCAAAAACAACAACAAAAAAAAA","AGCCTGGGCAAGATAGTGAGACCTCATCTCTTAAAATAAATAAATAAATAAATAAATAGCAGGATGTGGTGGCGTGCATCTGTAGTCCCAGCTACTCAGGAGGCTGAGATGGGAGGATTACTTGAGCTCAGGAGGTCGAGGCTGCAGTGAGCTATGATCACGCCACTGTACTCCAGCCTGGGTGAGAGTGATACCCTGTCTCTAACAAAAAAAAAA"
"chr1","17376882","17377036","chr19","6391716","6391877","70","10985166","CCAAGTATGGTGGTATAACACCTATGGTCCAAGCTACTGGAGAGGCTGAGGTGAGAGGATCGTTTGAGGCTGCAATGAGCCATGATCGTGTCTCTTCACTCCAGTTCAGCTTAGGCTACAGAGTGAGACTGTCTCAAAAACAAAAAACAAGACAA","CCAGGCGCAATGGCTCACGCCTGTAATCCCAACACTTTGAGAGGCCGAGGCAAGAGGATTGCTTGAGGCCAGGAGTCCGAGACCAGCCTGGGCAACACAGCGAGGCCTCATTCTCTACAAAAAATAAATATATAAATAAATAAATAAATAAGAAGAAGAAAA"
"chr1","17442918","17443223","chr2A","65797088","65797395","78","48354170","GCCAGGCACAGTGACACATGCCTATAATCCTAGCACTGTGGGAGGCCAAGGCAAAAGGATTGCTTGAGGTCAGGAGTTTGAGACCAGCCTGGGGAACATAGTGAGACCTTGTCTCCACAAAAAAATTTTAAAAATTAGCTGGGCGTGGAGGTGCACGTCTACAGTCTCAGCTACTAGGGTGGCTGAGGCAGGAGAACTGTTTGACCCCAGGAGGTCGAGGCTGTAGTGAGCCAAGATGGCGCCACTACAGTCCAGCCTAGGTGACAGAGTGAGACCCAGTTTCCAAAAAAAAAAAAAGAGAAAGAA","GGCCAGGCTCGGTGGCTCTTGCCTATAATCCTAGCACTTTGGGAGGCCAAGGATTGCTTGAGCCCTGGAGTTTGAGACCAGCCTGGGCAACATAATGAGACCCTGTGTCTACAAAAAAAAAAAAAAAAAAAAAAAAAAATTGGGTGTGGTGACATGTGCCTGTGGTACCAGCTACTAGGGAGGCTGAGGTGGGAGGATCACTTGAACTCAGGAGGTCGAGGCTGCAGTAAGCCACGATTGCACCACTGCACTCCGGCATGGGTGACAGAGCGAAACCCTGTCTAAAAACAAAAACAAAAACAAAAGAA"
"chr1","17470841","17471145","chr8","140149859","140150157","68","122679018","TGACTCACACCTGTAACCTCAGCCCTTTGGCAGGCCAAGGCCGGAGGATTGCTTGAGCCCAGGAGTTCAAGACCAGCCTAGGCAACACAGTGAGACTCTGTCTCTACAAAAAATTTAAAAATTAAAAAAAAACAAAATTAGCCAAGCATAGTGGTGCACACCTGTAGTCCCAGCTGCTCTGGAGGCTGTGGTGGGAGGATCACTTGAGCCCTGAAGGTTGAAGCTGCAGTGAGCCAAGACTGTGCCACTGTACTCCAGCCTAGGTGACAGTGGGAGATTCTGACTGAAAAACAAAAAACAAAAAA","TGGCTCACGCCTATAATCCCAGCACTTTGGGAGGCCAAGGCGGGTGGATTGTTCAACTCCAGGAGTTTGAGACCAGCCTAGGCAACATAGTGAGACCCCATCTCTACAAAAAAAAAAAAAAAAAAAAAAAAAAAAAACCAGCCAGGTGTGGTGGCACGCACCTGTAGACCCAGCTACTCAGGAGGCTATGTTGGGAGGATTGCTTGAGCCTGGCAGGTCAAGGCTGCAGTAAGCTATGATCACACCACTGTACTCCAGCCTGGGTGACAGTGTGAGACCCTGTCTCAAAAAAGAAAAGA"
"chr1","17471342","17471618","chr12","99989922","99990215","75","82518580","GGCTGGGTGTGGTGGCTCATGCCTATAATCCCAGCACTTTGGGATGCCAAGAAGGGAGGATCACTTGAGACCAGGAGTTCCAGACCAGCCTAGGCAACATAGTGAGACCTAGTCTCTGCAAAACATTTAAAAATTAGCCAGGCATGGTGGTGGTCGTCTGTAGTCTCAGCTACTCAAGAGGCTGAGTTCATAGGATTGTTTTAGCCCAGGAACTCAAGGCTGCAGTGACCTATGATTGCACCACTGTAGTCTAGCCTGGGCAACAGAGCAAGACCCT","GGCTAGGCATGGTGGCTCATGCCTGTAATCCCAACGCTTTTGGAGGCCAAGGTGGGAGGATCGCTCGAGGCCAGAAGTTCAAGACCAATAGGGGCAATGTATAGAGACCTAGTCTCTACAAAAATAAAATAAAATAAAATAAAATTTAGCCAGATATGGTGGTGTAAAACTGTAGTTCCAGCTACTTGAGAAGCTGAGGTGAAAGGATTGCTTGAGCCCAGGAATTCGAGGCTGCAGTGAGCTGTGATCTCGGCACTGCACTCCAGCCTGGATAACAGAGCGAGACCCTGTCTC"
"chr1","17473716","17473886","chr5","32595015","32595178","57","15121299","CAGACATGGTGGCTCACATCTGTAATCGCAACACTTCAGGTGGCCATGACAGCAGGAGGATCAGTTGAGGCCAGGAGTTCAAGACTGGCCTGGGCAACATCGCCAGACCCCATCTCTACAAAAAAAAAAAAAAAAATTAACAGGGCGTGTTGGTGTGTCCTACAATCCCAG","GGCCGGGTGTGGTCCCTCATGCCTGTAATCCCAACACTTTGGGAGGCTGAGATAGGAGGACTGCTTGAGGCCAGGAGTTCAAGACCAGCCTGGTCAACATAGTGAGACCCCATCTCTATAAAATAATAATAATAATAATAATAATAATAATAAATAAATAAATA"
"chr1","17512424","17512712","chr8","15910614","15910909","73","1601810","GGCTGAGCACTGTGGCTCACACCTGTAATCGCAGCACTTTGGGAGGCCAAGGTGGAAGGACTCCTTGAAGCCAGGAATTCAAGACCAACCAGGGTGACATAGCCAGGACCCCATCTCTACGAAAATAAAAAAATTAACCAGGCATCATAGTGTGTGCCTGTAGTCCCAGCTACTCGGGAGGCTGAGGCAGGGGGATCACTTGAACCCAGGAGGTCGAGGCTGCGGTAAGCTGAGATCATGCCACTGAACTCCAGCATGAGCAAGACAGCAAGACCCTGTCTCAAAAAAA","GGCCAGGCGAAGTGGCTCACACCTGTAATCCCAGCACTTTGGGAGGCCAAGGCAGGAGGATCATTTGAAGCCAGGAGTTCAAGGCCAGCCAGAGAAACATAGTGAGAACCTGTCTTTACAAAAATTAAAATTAAAATTAAAATTAGCCAGGAGTGGTGGTGCATGCCTGCAGTCCCAGCAGCTCAGGAGGCTGAGGTGGGATGATTGCTTGCACCAGGAGTTCGAGGCTGCAGTGAGCTGTGATCGTGCCACTGCACTCCAGCCCCTGGGTGACAAAGCAAGATCCTCTAAAAAAA"
"chr1","17522958","17523052","chr20","87144","87254","58","17435814","TGGTGGCACATGTCTGTGGTCCCAGCTACTCGGGAAGCTGAGATGGAAGGATCTCCTGAGCCCAGAAGTTTGAGGCTGCAGTGAACTGTGATTGC","CCTGGGCAACATAGTGAGACTACATCTCTACACTCACGCACACACACACACACACACACACACCCCCCAAATTAGCCAGGCATGCTGATGTGCACCCATAGTCTCAGCAAC"
"chr1","17533346","17533464","chr18","55799233","55799394","59","38265887","GGCACAGTGGCTCACGCTTATAATCTCAGCATTTTGGGAGGGCAAGGTGGGAGGATTGCTTGAGGCCAAGAGTTCAAGACCAGCCTGGGCAACATAGCAAGACCCCATCTGTACAAAAA","GGCTGAGAGAGGTGGCTCATGCTTGTAATCCCAGCACATTGGGAGGCAAAGGTGGGAAGATTGCTTGAGGCCAGGAGTTCAAGACCAGCCTGGGCAACATGAAAACACTTTGTCTCTACAATAAATAAATAAATAAATAAATAAATAAAAGAAACAAGAAAA"
"chr1","17536871","17537038","chr18","55799233","55799394","67","38262362","ATCTAGCCAGATGCGGTAGTGCATGCCTATAGTCCCAGCTACTCAGGTGGCTGAGGTGGGAGGATCACTTGAGCCCAGGAGTTTGAGGCTGCAGTGAGCCATGATCCCACCGCTGCACCCCAGCCTAGGCAACAGCATGACTCTGTCTCTGAAAAAAAAAAATTAAAA","GGCTGAGAGAGGTGGCTCATGCTTGTAATCCCAGCACATTGGGAGGCAAAGGTGGGAAGATTGCTTGAGGCCAGGAGTTCAAGACCAGCCTGGGCAACATGAAAACACTTTGTCTCTACAATAAATAAATAAATAAATAAATAAATAAAAGAAACAAGAAAA"
"chr1","17537073","17537192","chr19","6391716","6391877","62","11145357","GCCAGGAGCAGTGGCTCATGCCTGTAATCCCAGCACTTTAGGAGGCCAAGGCAAGAGGATTGCTTGAGGCCAGGCATTTTAGACCAGCCTGGGCAACATAGGGAGACCCCTGTCTCTACA","CCAGGCGCAATGGCTCACGCCTGTAATCCCAACACTTTGAGAGGCCGAGGCAAGAGGATTGCTTGAGGCCAGGAGTCCGAGACCAGCCTGGGCAACACAGCGAGGCCTCATTCTCTACAAAAAATAAATATATAAATAAATAAATAAATAAGAAGAAGAAAA"
"chr1","17542171","17542450","chr3","83975049","83975347","74","66432878","GAGCATGGTGGCTCATGCTTGTAATCCCAGCACTTTAGGAGCCTCAGGTGGGAGGATCACTTGAGCGCAGGTGTTCGGGACCAGCCTGGGCAACACAAGAGAACATGTCTCTACAAAAAATTTTAAAAATTAGTTGGATGTGCTGGTGCACGCCTGTAGTCCCAGCTACTCAGGAGGCTGAGATGGGAGGATCACTTGAGCCTGGAAGTTCGAGGCTGCAGTGAGCTGTGATTGTGCCACCGTACTACAGCTTAAGTGACAGAGGGAGACCCTGTCTTAA","GGCTGGGTGCAGTGGCTCATGGCTGTAATCCCAGGACTTTGGGAGGCTGAGGCAGGAGAATCACTTGAGGCCAGGAGTTTGAGACCAACCTGGGCAACAAAGTGAGGCATGTCTCTACAAAAACAAAACAAAACAAAACAAAACAATTAGCTGTGTGTGGTGATGCCTGCCTGTCGTCCCAGCTACTCGGGAGGCTGTGGTGGGAGGATCTCTTGAGCCTGGGAGGTTGAGGCTGCAGTGAGCTGTGATTGCCCACTGTACTCTAGCATGGGTTACAGAGCAAGACTCTGTCTCAAAAA"
"chr1","17578416","17578674","chrX","3592780","3593062","72","13985636","GGTTCACATCTGTGATCCCAGCACTTGTTGAGGTCAACAAGGGAGGATGGCTTGAGCCCAGGAGTTTGGGACCAGCCTGGGCAACAGAGTAAGACCCTATCTCTAGAAAAAATTTTAAAAAATTAGCCAGGCATGGTGGTGTGTGCCTGTAGTCCCAGCTACTGGGGAGGCTGAGGCGAGAGGATCACTTGACCCAGGAGTTCCAGGCTACAGTGAGCCATGATTGTGCCACTGCACTCCAACCTGGGAAATCGAGACC","GTGGTGGCTCATGTCTGTAATCCCAGCACTTCAGGGGGCCAAAGCGAGAGGACTGCTTGAGGCCAGGAGTTTGAGACCAGCCTGCGCAACATAGAAAGACCCCATCTCTATAAATAAATAAATAAATAAATAAATAAGTCAGGCATGGTGGCACATGCCTGTAGTCCCAGCTACTCAGAAGGCTGAGGTCGGAGGATCTCTTGAGCCCAGGGGTTCAAGGCTGCAGTGAACCATGATCACACCAGTGCACTGCAGCCTGGGCAACACAGCAAAACCCTGTCCC"
"chr1","17716106","17716429","chr9","68878569","68878883","86","51162463","GGTCAGACACAGTGGCTCATGCCTATAATCCCAGCACTTTGGGAGGCAGGAGGCAGAGGCAGAGGCAAGAGGATCACTGGAGCCCAGGAGTTCGAGACCAGCCTGGTGAACATATTGAGACCCTGTCTCTAGAAATAATTTAAAAAATTAGCTGGGCATGGTGGCATGTGCCTTTAGTCCCAGCTCCTCAGGAGGCTGAGGTGGGAGGATTGCTTGAGCCCAGGAAGTTTGAGGCTGCAGCGAGCTATGATTATGCCACTGCACTATGACCTGGGTGACTGAATGAGATCCTGACACTAGAGAAAAAAAAAGAAAAAGAAAAGA","GGCTGGGCACGGCAGCTCATGTCTGTAATCCCAGCACTTTGGGAGGCCAAGGTGGGAGGATTGCTTGAGTCCAGGAGTTCAAGACCAGCCTGGGCAACATAGTGAAACCCCAGTCTCTACAAATAAATAAATAAATAAATAAATAATTAGCTGGGCATGTTGATGCATGCCTGTAGTCCTAGCTACTCGGGGGGTGAGGTGAGAGGATTGCTTGAGTCCAGAAGGTGGAGGCTGCAGTGAGCTATGATCACACCACTGCACTCCAGCCTGGAAGACAGGGTGAGACGCTGTCTTTAAAAAAAAAAAAAGAAAAGA"
"chr1","17727845","17727897","chr20","87144","87254","66","17640701","CTGGGTAACAGAACAAGACACAGTCGAAAGAAAAAGAAGGAAAGAGAAAGAGA","CCTGGGCAACATAGTGAGACTACATCTCTACACTCACGCACACACACACACACACACACACACCCCCCAAATTAGCCAGGCATGCTGATGTGCACCCATAGTCTCAGCAAC"
"chr1","17728254","17728500","chr3","98206950","98207200","84","80478696","GGCCGGGTGTGGTGGCTCATGCCTGTAATCCCAGCATTTTGGGAGGGATGCAGGAAGACTGCTTGAGGCCAGGAGTTCGAGACCAGTCTTGGCAAAGCAGCAAGAGCCCCTACTTCTCAAAAAAAAAAATTAGCCAGACATGGTGGCTCAAGCCTGTAGTCCCACTGCTTGGAGTGGAGAGGGCGACATGAGCCCAGGAGTTCAAGGATGCGGTGAGTTGTGATTGTGCCACTGCACTTCAGCCTGG","GCCAGATGGAGTGGCTCATGCCTGTAATCCCAGCATTTTGGGAGGCTGAGGCAGAAGGACTGCTTGAGACCAGGAATTCAAAACCAACCTGGGCAACCTAGTAGGACTGGCTCTACAAAAAAAAAAAAAAAAAAAAAAAAATTAAGTACCTGGGCTGGGTTCCACCTACTTGGGAGGCTGAGGTAGGAGGACTGTGAGCCCAGGAGTTTGAGGATGCAGTAAGCCACTGCTCTCCAGCCTGGGTGACAGAG"
"chr1","17737761","17737893","chr18","55799233","55799394","52","38061472","GGTCAGATGCGGTGCTCATGCCTGTAATCCCAACACTTTGGGAGGCCGAGGAGGGAAGGATTGATTGAGGCCAGGAGTTCAAGACCAGCCTGGGCAACACAGCAAGGCCATGTCTCTAGCATAAATAAATAAA","GGCTGAGAGAGGTGGCTCATGCTTGTAATCCCAGCACATTGGGAGGCAAAGGTGGGAAGATTGCTTGAGGCCAGGAGTTCAAGACCAGCCTGGGCAACATGAAAACACTTTGTCTCTACAATAAATAAATAAATAAATAAATAAATAAAAGAAACAAGAAAA"
"chr1","17779925","17780233","chr8","25360790","25361095","66","7580865","GGCTGGGTGCAGTGGCTCATACATGTAATCCCAGAGTTTTGGGAGGCTGAGGCGGGAGGATTGCTTGAGTCCAGGAGTTTGAGACCAGCCTGGGCAACATAGGGAGACCCTTTCTCTACAAAAAATAACCAAATTAACTGGTTGTAGTGGTGTGCACCTGCAGTCCCAGCCTCTTGGGAGGCTGAGGTGGGAGGATTGCTTTGAGCCTAGGAGGTCGAAGCTGCAGTGAGCTGTGATTGCGCCACTGCACTCCAGCCTGGGCGACAGAGTTGAGACCCTGTCTTGAAAAAAAACCCCAAAAACAAAAAA","GGCTGGGAGCAGTGGCTCATACCTGTAAGCCCAGCACTTTGGGAGGCTGAGGTGGGAGGATTGCTGAAGCCCAGGAGTTTGAGACCAACCTGGGCAATGTAGGGAGACCCCGTCTCTACTAAATAAATAAATAAATAAATAAATAAAGTCGGGCATGGTGGCATGTGCCCTGTAGTCCCAGCTTCTTGGGAGGCTGAGGTGGGAGGATTGCTTGGGCCCAGGAATCAAGGCTGCAGTGAGCTGTGATTGTGCCACTGTACTACAGCCTGGGTGACAGTGCAAGACTGTCTCAAAAGAAAAACAAAA"
"chr1","17786692","17787001","chr5","152110395","152110709","72","134323703","GGCCAGGCGTGATGGCTCACACCTGTCATCCCAGGGTTTTGGGAGGCCAAGGTGGGAGGATTGCTTGAGGCCAGGAGTTCAAGACCAGCCTGTGCAAGAAAGCACGATCCTGTCTCTACAAAAAAAAAACATTTAAAAAAATAGGCCAGCATGGTGGTGCACACCTGTAGTCCCAGTTACTTGGGAGTCTGAGGCAGGAGGATTGCTTGAGGAGCTCGAGGCTGTGCTGAGCTATGATCATGCCACTGCACTCCAGCCTGGGCAACAGAGTGAGACCGTATCTCTAAAAAAATAATAATTAAAAATAAAA","GGCTGGGAGTGGTGGCTCATGCCTATAATACCAGCACTTTGGGAGGCCAAGGTGGGAAGATCACTTGAGGCCAGGAGTTCAAGATCAGCCTAGGCAACATAGCAAGACCCTGTCTCTACAAAACAAACAAACAAACAAACAAACAAAATTAGCTGGGCATGGCGGTATGCACCTGTAGTCCCAGCTACTTGGGAGGCTGAGGCAGGAGGATTGTTTGAGCCCAGAAGGTTGAGGCTGCATTGAGCCATGATTATGCCACTTTACTCCAGCCTGGGCAACAGAGGGAGACCCCATTCTCAAAAACAAAACAAAAAA"
"chr1","17814215","17814345","chr18","55799233","55799394","59","37985018","GGCTGGATATGGTGGCTCATGCCTGTATTCCTGGCCCTTTGAGAAGCCAAGGCAGGAAGAACGCTTGAGGACAGGCATTCAAAACCAGCCCGGACAACAGAGCAGACTCCATATCTACCAACAAAACAAAA","GGCTGAGAGAGGTGGCTCATGCTTGTAATCCCAGCACATTGGGAGGCAAAGGTGGGAAGATTGCTTGAGGCCAGGAGTTCAAGACCAGCCTGGGCAACATGAAAACACTTTGTCTCTACAATAAATAAATAAATAAATAAATAAATAAAAGAAACAAGAAAA"
"chr1","17893640","17893897","chr12","95325313","95325577","76","77431673","GTTGGGCATGTTGGCTCACACCTGTAATCCCAACACTTTGAGAGGCCGAGGTGAGAGAATCGCCTGACGCCAGGAGTTCAAGACCAGCTTGGGCAACATAGCAAGGCCCCTATCTCTACAAAAAATGTAAAAAATTAAGCCAAGAGTGGATCACTTGAGCTGAGAAGGTCAAGGCTGCAGTGAGCTATGATTGTGCCACTGCACTCACCTTGGGCAACAGGGCAAGACTCTGTCTCTTAAAAAAAAAAAAAAGCAAAA","GCTGGGTGTGGCGGCTCATGCCTGTAATCCCAGCACTTTGGGAGACTGAGGCAGGAGGATCACTTGAGGCCAGGAGTTAAAGACCTGCCTGGACAACATACTGAGACCCTGTCTCTCATATTTAAAAAAAAAAAAAAAAAAAAAAAAAATTAGCCAAGCTCCTGCTTGAGCCCAGGAGTTGGGGCTGCAGTGAGCCATGATCATTCCCCTGCACTCCAGCATGGGCAATAGAGTAAGACTCTGTCTCTAAGAAAGAAAAAAAAAA"
"chr1","17919156","17919471","chr5","138710549","138710854","69","120791393","GGCCAGATGCGATGGCTCACCCCTGTAATCCCAGCAATTTGGGAGGCTGAGGTGGGAGGATCACTTGAGGGCAGGAGTTTGAGACCAGCCTAGGCAACATGACAAGACCCCATCTCTACAAAAATTCAAAGAAAAAAAAACATAAAATTAACCAGGCATGGTGGCATGCGCTTGTAGTCTTAGCTATTCAGGAGTCTGAGGCGGGAGAATTTCTTGAGTCCAGGAGTTCGAGGCTGCAGTGAACTATGAATGGACCACTGCACCCAGCCTGAGTGACACAGCAAGACCCTGTCTCTAAAAAATTAATAAAAGTAAA","GACCAGGCACAGTGGCTCATGCCTGTAGTCCCAGCACTTTGGGAGGCTGAGGTGGGAGGATCACTTGAGGCCAGGAATTTGAGACCAGCCTGAGCAACATAGGGACAGTCCCATCTCTACAAAAAACAAAAAACAAAAAAACAAAAAACTTATCTGAGCACGGTGGCATGTGTTTGTCATCCTAACTACTCAGAAGGCTGAAGTGGGAGGATTGCTTGAGTCCAGGAGTTCAAGACTGTAGTGAGTCCACTGCACTCCAGCCAGGGCGACAGAGCAAGACCCTGACTCAAAAAAATAAAATAAAAA"
"chr1","17934837","17934990","chr5","32595015","32595178","69","14660178","GGCATGGTGGCACGCACCTGTAGTCCCAGCTACCTGGGAGGCTGAGGTGGGACAATCACTTGAGCTTAGGAGGCCAAGGCTGCAGTGAGCTATAAATGCACCACTGTACTTCAGCCTGGGCAACAGAGGGAGATCTTGTCTCTAAATAAATAAA","GGCCGGGTGTGGTCCCTCATGCCTGTAATCCCAACACTTTGGGAGGCTGAGATAGGAGGACTGCTTGAGGCCAGGAGTTCAAGACCAGCCTGGTCAACATAGTGAGACCCCATCTCTATAAAATAATAATAATAATAATAATAATAATAATAAATAAATAAATA"
"chr1","17945105","17945192","chr20","87144","87254","61","17857961","GGCATGGTGGCTCACACCTGTAATCCCAGTGCTTTGGGAGGCCAAGATGGGAGGATTGCTTGAGGCCAAGAGTTTGAGACCAGTCTGG","CCTGGGCAACATAGTGAGACTACATCTCTACACTCACGCACACACACACACACACACACACACCCCCCAAATTAGCCAGGCATGCTGATGTGCACCCATAGTCTCAGCAAC"
"chr1","17946825","17947122","chr14","31798968","31799292","85","13852143","CCGGGCACAGTGACTCATGCCTGTAACCCTAGCACTTTAGGAGGCCGAGGTAGGAAGATTGCTTGAGGTCAGACATTCGAGACTAGCCTGGGCAACATGGCAAAATCCCGTCTCTACTAAAAATACAAACATTAGCCTGGTGCAGTGATGCATGCCTGTAGTCCCAGCTACTCAGAAGGCTGAGATGGGAGGATTGATTGAGCCTAGGAGGTTCAGGCTTCATTGAGCCATGATCTCTAGCCTGGGTAACACAGCAAGACCCTGTCTCAAAAAAAAAAAAAAAAAGAAAAGAAAAGAA","GGCTGGGCACAGTAGCTTACACCTGTAATCCCAGTACTTTGGAAGGCTGAAGTGGGAGGATCCCTTGAGGCCAGGAGTTTGAGACCAGCCTGGGCAACATAGTGAGACCCTGTCTCTACAACAAACAAACAAACAAACAAACAAAACTTAGCCAGTTGTGGTGGCACATCCTATAGTCCCAGCTACTCAGGAGGCTGAGGAGGGAGGATCTCTTGAGCCCAGGAGTTTGAGGCTGCAGTGAGCTATGATCATGACACTGCACTCCAGCCTGGATAACACAGCAAAATCCTGTCTCAAAAAAAAAAAAAAAAAAAAAAAAAAAGAA"
"chr1","17998402","17998609","chr14","51003183","51003398","59","33004781","CCAGCCTGGGCAATATGGCAAAACCTCGTCTCTACAGAAAATTAGCTGGGTGTGGTGGCATGTGCCTGAAGTCCCAGCTATTCAGGAGGCTGAGGTGGGAGGATCGCTTGAGCCTAGGGGATTGAGGCTGCAGTGCGCAATAATCATGCCACTGCACTCCAGCCTGGGCAACAGTGAGACCCTGTCTCAAAAAAAAAAAAAAAGTAAA","AGCCTGGGCAAGATAGTGAGACCTCATCTCTTAAAATAAATAAATAAATAAATAAATAGCAGGATGTGGTGGCGTGCATCTGTAGTCCCAGCTACTCAGGAGGCTGAGATGGGAGGATTACTTGAGCTCAGGAGGTCGAGGCTGCAGTGAGCTATGATCACGCCACTGTACTCCAGCCTGGGTGAGAGTGATACCCTGTCTCTAACAAAAAAAAAA"
"chr1","18090290","18090467","chr2A","60286019","60286209","74","42195729","AATATAAGCTGGGTATGGGGGAGGGTGCTGCATGTAGTTCCAGCTACTCAAGAGCCTGAGGTGGAAGGCTCTCTTGAACCCAGGAGTTTGCAGCTGTAGTGCCCTACACTGCACTCCAGCCTGGGCAACATAGTGGGACCCCATTTCATAAAAGATAAATAAAGAAAAATTTTAAAAA","AAAATTAGCCAGGTGTGATGGCACCTGTAGTCCTAGCTACTTGGGAGGCTAAGGTGGGAAGAGGGCTTGAGCCCAAGATTGTGAGGCTGTGGTGAGTCATGACTGTGCCATTGCCCTCTGGCCTGGGTGACAGAGTGAGAAGCTGTCTCAAATAAATAAATAAATAAATAAATAAATAAAAATAAACAAAA"
"chr1","18141787","18142074","chr1","88859712","88859991","73","70717925","GGCTGGGCACAGTGGCTCATACCTGTAATCCCAGCACTTCGGCAGGCCAAGGCGAGCCGATTGCTTGAGGCCAAGACTTTGAGACCAGCCTGGGCACCATAGCAAGACCCCCATTTCTACAAAAAATACAAAAATCAGCCGGGCATGGTGGTGCATGCCTGTGGTCCCAGCTACTTGGGAAGCTGAGGTGGGAGGATTACTTGAGCCCCGGAGGCCTAAACTGCAGTGAGCCAAGATTGTGCCACTGCATTCCAGCCTGGGCAACAGAGTGATACTGTCGCAAAATAA","CCAGGCACAGTGGCTCACACCTGTAATCCCAGCACTTTGGGAGGCCAAGGCAGGAGGATTGCTTGAATCCAGGAGTTTGAGACCAGCCTGGGCAGCATAGTGAGACTTGGCCTCTACAAAAAAAAAAAAAAAAAAAAAAAAAAGTTACCTGGGAAGTCTCAGCTACTTGGAAGGCTGAGGTCGGAAGGTTGCTTGAGTACAGGAGGTCAAGGCTGCAGTGAGCTATGATTGTACCACTGCACTCCAGCGTGGGCAACAGAGTGAGACCTTATCTCAAAAA"
"chr1","18415291","18415414","chr9","47045786","47045941","62","28630495","GACCAGGTGCAGTGGCTCAAGCCTGTAATTTCAGCACTTTGGGAGACTGAGGTGTGAGGATTGCTTGAGGCCAGGAGCTCAAAACCAGGCTAGGCAACATAGTGAGATCCATGTCTACAAAAAA","GCTGGGCGCAGCAGCTCACACCTGTAATCCCAGTGCTTTGGAGGTCCAAGGTAGGAGGATTGCTTAAGACTAGGTGTTCAAGACCAGTCTTGGCAACATAGTGAGAACTCATCTCTACAATAAATAAATAAATAAATAAATAAATGAAAATAAAAA"
"chr1","18442518","18442825","chr7_NW_019937272v1_random","2134063","2134360","80","16308455","GGCCGGGTGTGGTCATGCATGCCTGAATCCCAATGCTTAATCCCAGCACTTTAAGAGGCTGAGGCAGGAGGATCACTTGAGGCCAGGAGGAGCTCAAGACCAGTCTGGGGAACCTGGCAAGACCTCACCTCTACTAAAAATAAAAATTAAAAAATTAGCCGGGTGTAGTGGTGCATGCCTGAAGTCCCAGCTACTCCAGGGGCCGAGGTGGGAGGATCTCTTGAGCCCAGGAGGTCAAGGTTGCAGTGAGCCATGATCACACCACTGTGTTCCACCCTGGGGAACAGAGCAAGACCCTGTCTCAAAAA","GCTGGGCTGGTCTTGCACCTATAATCTCAGCACTTTGGGAGGCCGAGGCAGGAGGATCACTTGAGCCTGGAAGTTCAAGACCGGCCTGGGCAACATAGCAAGACCTTATTTCTAAAAAAAAAAAAAAAAAAAAAAAAATTAGCCAGGCATGGTGGCATGCACCTGTAGTCCCAGCTACTCAGCAGGCTGAGGTGGGAGGATCACTTGAGCCAGGGAGGTCAAGGCTGCAGTGAGCCATGATCATGCCGCTGCACTCCAAACTGGGGGACAGAATGAGACCCTATATCAAAAAAAAAAA"
"chr1","18465154","18465471","chr1","209597744","209598050","28","191132590","CCAGGCACGGTGGCTCACACCTGTAATCCCAACGCTTTGGGAGGCTAAAGCGGGAGGATCGCTTGAGGCCAGGAGTTCGAGATCAGCGTGGGCAACATAGTGAGACTTCATTTTTCCAAAAAAAAAAAAAGAAAAGAAAAGAAAAGAAAGAAAAAAGGAATAAAAAAAGCCAGACATGGTAGTGCACACCTGTGGTCCCAGCTACTCAGAGGATAAGGCAGGAGGATTGTTTGAGCCCAGGAGTTCGAGTCTGCTGTGAGCCATGATCACACCACCACTGCAGTATGGGCAATAGAGTGAGACCCTGTTTCTAAATAA","CCAGGCACGGTGGCTCACACCTGTAATCCCAACACTTTGGGAGGCTAAAGTGGGAGGATTGCTTGAGGCCAGGAGTTCCAGATCAGCATGGGCAACATAGTGAAACCTCATTTTTACAAAAAAAAAAAAAAAAAAAAGAAAGAAAAAAAGAAAAAAAAAAAGCCAGGCATGGTAGTGCACACCTGTGGTCCCAGCTACTCAGAGGATAAGGCAAGAGGATGGTTTGAGCCCAGGAGTTCGAGCCTGCAGTGAGCCATGATCACACCACCACTGCAGTATGGGCAATAGACTAAGACCCTGTTTCTAA"
"chr1","18498398","18498681","chrUn_NW_019938566v1","98142","98430","69","18400256","GGCTGGGCATGGTGGCTCATGCCTATAATCCCAGCATTTTGGGAGGCTGAGGTAGAATTGCTTGAGGCCAAGAGTTTGAGACCAGCCTGGGCAACGCAGCAAGACCCTGTCTCTACAAAAATTAAAATTAGCCAGACATGGCAGTACACACCTGTAGTCCCAGTTACTTGGGAGGCTGAGGCAGGAGGATCACTTGAGCCCAGGAGTTGGAAGCTGCAGTGAGCCATGATTGCATTGAAGCCTGGGCAACAGAGTGAGACCCCATGTCTACCAAAAAAAAAAAA","GCTGGGCGTGGTGGCTCACGTCTCAAATCCCAGCACTTTGGGAGGTCAAGCACTGAGGATTGCTTAAGGCCAGGAGTTTGAGACCAGTCTGGGAAACATAGTGAGAGTCTGTCTCTACAAAACACACACACACACACACACACACACACCTGTAGTCCCAGGTACTCAGTAGGCTGAGGCAGGAGGATTGCTTGATCCCAGGAGTTCAAGGCTGCAGTGAGCTGAGATTGCACCACTGCACTCCAGCCTGGGCAACAGAGCAAGACTGCATCTCTAAAAAAAAAAAAAA"
"chr1","18544033","18544269","chr13","83255168","83255404","63","64711135","GTCAGATGCAGTGACTCACACCTGTGATCCCAACACTTTGGGAAGCCAAGGTGAGAGGATCGCTTGAAGCCAGGAGTTCGAGACCAGCCTGGGCAACATAGTGAGACCTTGTTTTCAAAAACAAAAAAAAAATAAAAAAATTAGCTGAGTGTGGTGGTGTGCACCTGTAGTCCCAGCTACTCGTGAGGCTAATGTGGGAGAGTCACTTTAGCCCATGAGGACAAGGCTGCAGCGAGC","GCCAGGCCTGGTGGTTCACACCTGTAATCCCAGTAATTTCAGAGGCCAAAGCAGGTGAATGGCTTGAGCTCAGGAGTTTGAGACCAGTCTGGGCAACATGGCAAAACTCTGTTTCTACAAAAACAAAAACAAAAACAAAAAAAATTAGCTGGGCATGGTGGCACATGCCTGTAGTCCCAGCTATTTGGGGGACTGATGTGGAAGGATCACTTAAGCCCAGGAGGTCAAGGCTGCAGT"
"chr1","18574768","18575064","chr8","25360790","25361095","74","6786022","GGCCGTGTGCAGTGGTGCACACCTGTAACCTCAGTGCTTTGGAGGGCAGAGGCAGGAGGATTGCTTGAGGCCAAGAGTTGGAGACCAGACTGGGCAACACAGTGAGACCCTGTCTCTACCAAAAATTTTAAAAATTAGCTGAGCGTGGTGGCATATGCCTATAGTCCCAGCTACTCAGGAGGCTAAGGTGTGAGGATCACTTGAGTCCAGGAGTTGGAGGCTGCAGTGAGCCATGATTGTGCCACTGCACTCCAGCCTGGGCAACAGAGCAAGATCCGTCTCTTAAAAAAGAAAAAA","GGCTGGGAGCAGTGGCTCATACCTGTAAGCCCAGCACTTTGGGAGGCTGAGGTGGGAGGATTGCTGAAGCCCAGGAGTTTGAGACCAACCTGGGCAATGTAGGGAGACCCCGTCTCTACTAAATAAATAAATAAATAAATAAATAAAGTCGGGCATGGTGGCATGTGCCCTGTAGTCCCAGCTTCTTGGGAGGCTGAGGTGGGAGGATTGCTTGGGCCCAGGAATCAAGGCTGCAGTGAGCTGTGATTGTGCCACTGTACTACAGCCTGGGTGACAGTGCAAGACTGTCTCAAAAGAAAAACAAAA"
"chr1","18578514","18578802","chr2A","88638728","88639031","77","70060214","GGCACAGTGGCTCACGCCTGTAATCCCAGCACTGTGGGAGGCCGAGGTGGGCAAATTGCTAGAGCTCAGGAGTTCAAGACCAACCTGGACAACATAGCGAGACCCTGTCTTTACAAAAAAAATACAAAATTAGCCAGGTGTAGTGGTGTGCACCTGTGGTCCCAGCTACTCAGGAGGGTGAGGTGGGAGGATCACCTGAGCTCAGGGAGGTCAATCAGCCATGATCACATCACTTTACTCTAGCCTGGGCCGCAGAGTGAGACCCTATCTCCAAAAAAAAATTTAAAAA","GGTGCAGTGGCTCATGCCTGTAATTCCAGCGCTTTGGGAGGCAAAGGTGGGAGGACTGCTTGAGCCCAGGAGTTTGAAACCAGCCTGGGCAACATAGGGAGACTTCATCTGTATAAATAAATAAATAAATAAATAAATAAATAAGCTGGGCATGGTGGCATGCACCTGTGGTCCCAGCTACTTGAGAGGCTAAGGTGGGAGGATCACTTGAGCCCAGGAGGTTGAGGCTGCAATGAGTCATGATCACGCCACCACACTCCAGCCTGAGCTACAGAGTGAGGTCTTGTCTCAAAAAAAAAAAAAA"
"chr1","18592009","18592301","chrX","46692258","46692555","74","28100249","GGTTGGGCATGGCGGCTCACGTCTATAATCCCAACACTATGGGAGGCCGAAGTGGGAGGATCACTTGAGGCAAGGAGTTTGAGACTAGCTTGGGCAACATAGTGAGACCCCATCTCTACAAAGAAGTTTAAAAATTAGCAGGGTGTGGTGGTGCACACCTATAGTCCCAGCTACTTAAAACGCTGAGGTAGGAGGATAGCTTGAACCTAGAAGTTGGAGGCTGCAGTGAGCTATGATTGCACCATTATACCACAGGCCTGGGCAACAGAGATACACCCTGTCTCTTAAAAAAA","GGCCAGGCATGGTGGCTCATGCCTGTAATCCCAGCACTTTGGGAGGCTGAGGAAAGATGATCACTTGAGCCAGGAGTTTGAGCCCAGTCTGGGTAACATAGTGAGACCTCCATCTCTACAAAAAAAAAAAAAAAAAAAAAAAAAAGCTGGGCATGGTAGCACACATCTGTAGTGTCAGCTACTCAGGAGGCTGAGGTAGGAGGATTGCTTGGGCCCAGGAGATCAAGACTGCAGTGAGCTATGACTGCACCACTGCACTCCAGCCTGGGCAATGGAGTGAGACCCTGTCTCAAAAAAA"
"chr1","18598587","18598882","chr2B","83001661","83001979","78","64403074","GGCGGGGCACGGTGGCTCATGTCTGTAATCCCAGCATTTTGGGAGGCCTAGGCAGGAGGATCTCTTGAGGCCAGGAGTTTGAGACCAGCCTGGGCAACCTATTGCGACCCTCATCTCTAAGAAAATTAAAATTAACCAGGCATGGTGGCAAATGCCTGTAGTCCCAGCTACTAGGGAGGCTGAAGTGGGAGGATCGATTTAGCCCAGGAGGTCAAGGCTACAGTGAGCTATGTTTGTGCTCAGCCTGGGCGACACAGTAAGACTCTGTCTCAAAACAACAACATAAAACCAAAGAA","GGCTGGAGATGGTGGCTCACACCTGTAATCCTAGTACTTTGGGAGTCCGAGGTAGGAGGATCACTTGAGGCCAGAAGTTTAATACCAGCCTGGGCAACATAGTGAGAGCCTATCTCTACAAAAAAAAAAAAAAAAAAAAAAAAAGCCAGGTGTGGTGGTGCATGTTTGTAGCCTCAGTTACTTGGGAGGCTGAGGTGGGAGGATCATTTGAGCCCAGGAGGTTAAGGCTGCAGTGAGCCAGTTATGGCACCACTGTACTCCAGCCTGGGCGACAGGGCAAGACCCTGTCTCACAAACAAAAACAAAACAAGACAAAAAA"
"chr1","18604445","18604739","chr9","68878569","68878883","78","50274124","GGCGGGGAATGGTGGCTCACGCCTGCAATCCCAGTACTTCGGGAGGCCAGGGCGGGAAGGTCATTTGACTAGCCTGGGCAACATAGCAAAACTCCATTTCTACTTAAAAAAATAAAATAAATTAGCTAGGCATGGTGGCATGCACCTGTAGTCCCAGCTACTCAGGAGGCTGAGGTGGGAGGATCCCTTGAGACCAGGAGGTCGAGGCTGCAGTGAGCTGTGATCATGCCATTCACTCCAGCCTGGATGACAGAGTAAGACTCTATCTCAAAGAAAGAAAAAAAAAGAAAAAGAA","GGCTGGGCACGGCAGCTCATGTCTGTAATCCCAGCACTTTGGGAGGCCAAGGTGGGAGGATTGCTTGAGTCCAGGAGTTCAAGACCAGCCTGGGCAACATAGTGAAACCCCAGTCTCTACAAATAAATAAATAAATAAATAAATAATTAGCTGGGCATGTTGATGCATGCCTGTAGTCCTAGCTACTCGGGGGGTGAGGTGAGAGGATTGCTTGAGTCCAGAAGGTGGAGGCTGCAGTGAGCTATGATCACACCACTGCACTCCAGCCTGGAAGACAGGGTGAGACGCTGTCTTTAAAAAAAAAAAAAGAAAAGA"
"chr1","18668419","18668707","chr8","15910614","15910909","71","2757805","GGCCAGGTGTGGTGGCTCACACCTGTAATCCCAGCACTTTGGGAGGCCAAGGCAGGCAAACTGCTTGAGGTTAGGAGTTAGAGACAATCCCTAGCAACATAGTGAGACCCCATCTTTACAAAAAATTTAAAAAAAATTAGCTGGGCATGGTGGCATGTACTTGTGGTCCCAGCTACTCAGGAGGCTAAGGTGGGAGGATGGCATGAGCCTGGGAGGTCGGGGCTGCAGTGAGCCTTGATCTTGCCACTGCACTGCAGCCTGGGCAACAGAGTGAGACTCTGTTTCAAAA","GGCCAGGCGAAGTGGCTCACACCTGTAATCCCAGCACTTTGGGAGGCCAAGGCAGGAGGATCATTTGAAGCCAGGAGTTCAAGGCCAGCCAGAGAAACATAGTGAGAACCTGTCTTTACAAAAATTAAAATTAAAATTAAAATTAGCCAGGAGTGGTGGTGCATGCCTGCAGTCCCAGCAGCTCAGGAGGCTGAGGTGGGATGATTGCTTGCACCAGGAGTTCGAGGCTGCAGTGAGCTGTGATCGTGCCACTGCACTCCAGCCCCTGGGTGACAAAGCAAGATCCTCTAAAAAAA"
"chr1","18708278","18708558","chr3","83975049","83975347","74","65266771","GGGTGCCGTGGCTCACATCTGTAGTCCCAGCACTTTGGGAGGCCGAGGTGGGAGGATCACTTGAGGTCAGAGTTCAAGACCAGCCTGAGCAACATAGCAAAACCCAGTGTCTACAAAAAATTTAAAAATTAGCCAGATACGGTGGGGCGAGCCTGTGGTCCCAGCTACTAGGGTGGCTGAGGTGGGAGGATTGATTGACCCTGGGAGGTTGAGGCTGCAGTGAGCTGTGATTGTGCCACTGTGCGCCAGCCTAGGCGACAGAGAGAGACCCTGTCTCAAAA","GGCTGGGTGCAGTGGCTCATGGCTGTAATCCCAGGACTTTGGGAGGCTGAGGCAGGAGAATCACTTGAGGCCAGGAGTTTGAGACCAACCTGGGCAACAAAGTGAGGCATGTCTCTACAAAAACAAAACAAAACAAAACAAAACAATTAGCTGTGTGTGGTGATGCCTGCCTGTCGTCCCAGCTACTCGGGAGGCTGTGGTGGGAGGATCTCTTGAGCCTGGGAGGTTGAGGCTGCAGTGAGCTGTGATTGCCCACTGTACTCTAGCATGGGTTACAGAGCAAGACTCTGTCTCAAAAA"
"chr1","18749287","18749458","chr18","55799233","55799394","78","37049946","AAAAAGAGAAAAAGAGCCAGGCATACTGGTAGTCCCAATGACTCAGGATGCTGACGGGAAGATCACTTGAGCCCAGGAGTTCAAGGCTTCGGTGTGCTATGATCACACCTGTGAATAGCCTTGCACTCCAGCCTGGGCAACATAGCAAGACCCCATCTCTAAAAAGAACAAA","GGCTGAGAGAGGTGGCTCATGCTTGTAATCCCAGCACATTGGGAGGCAAAGGTGGGAAGATTGCTTGAGGCCAGGAGTTCAAGACCAGCCTGGGCAACATGAAAACACTTTGTCTCTACAATAAATAAATAAATAAATAAATAAATAAAAGAAACAAGAAAA"
"chr1","18806827","18806988","chr5","32595015","32595178","66","13788188","GCCGGGCATGGTGGTGGTTGCCCGTGATCCCAGCACTTTGGGAGGCTGAGGCTGGAGGATCGCTTGAGTCCAGGAGCTCAAGGCTGCAGTGAGCTATGATCATGTCACTGCACTTGAGCTTGGGCAACAGAGTGAGACCCTGTCTCTCAAAAAAATACAGAA","GGCCGGGTGTGGTCCCTCATGCCTGTAATCCCAACACTTTGGGAGGCTGAGATAGGAGGACTGCTTGAGGCCAGGAGTTCAAGACCAGCCTGGTCAACATAGTGAGACCCCATCTCTATAAAATAATAATAATAATAATAATAATAATAATAAATAAATAAATA"
"chr1","18837163","18837436","chrX","3592780","3593062","67","15244383","GCATGGTAGCTCACACCTGTAATCTCAGCACTTTGGGAGGCCAACGTGGGAAGATTGCTTGAGGCCAGGAGTTTGAGATCAACCTGGGCAATGTAGCAAGACCCCATCTCTACAGAAGTAAAAATTAGCTGGGCATGGTGGTGCACGCTTGTAGTCCCAGCTACTCAAGAAGCTGAGGCAGGAGGATCTGTTGAGTGCAGGAGTTCAAGGCTACAGTGAGCAGTGATTGTGCCACTGCATTGCAGCCTGGGCGACAGAGCAAGATCTTGTCTCA","GTGGTGGCTCATGTCTGTAATCCCAGCACTTCAGGGGGCCAAAGCGAGAGGACTGCTTGAGGCCAGGAGTTTGAGACCAGCCTGCGCAACATAGAAAGACCCCATCTCTATAAATAAATAAATAAATAAATAAATAAGTCAGGCATGGTGGCACATGCCTGTAGTCCCAGCTACTCAGAAGGCTGAGGTCGGAGGATCTCTTGAGCCCAGGGGTTCAAGGCTGCAGTGAACCATGATCACACCAGTGCACTGCAGCCTGGGCAACACAGCAAAACCCTGTCCC"
"chr1","18862512","18862809","chr7_NW_019937272v1_random","2134063","2134360","74","16728449","CCAGGCGTGGTGATTTACACCTGTCATCCCAGCACTTTAGCAGGCAGAGGAGGGAGAACCTCTTGAGGCCAGGAGTTCATGACCATTCTGGGCAACATAAAGAGACTCCATCTCTACAAAAAATTAAAAAAACTTAGCTGGGTGTGGTGGCACGTGCCTGTAGCCCTAGCTACTCAGGAGGCTGAGGTGGGAGGATCACTTGAGCCCAGAAGGTCAAGACTGCAGTGAGTTTTCATCATGCCACTGCACTCCAGCCTGGGTGACAGAGTGAGACCCTGTCTCTAAAAAACAGAAACAA","GCTGGGCTGGTCTTGCACCTATAATCTCAGCACTTTGGGAGGCCGAGGCAGGAGGATCACTTGAGCCTGGAAGTTCAAGACCGGCCTGGGCAACATAGCAAGACCTTATTTCTAAAAAAAAAAAAAAAAAAAAAAAAATTAGCCAGGCATGGTGGCATGCACCTGTAGTCCCAGCTACTCAGCAGGCTGAGGTGGGAGGATCACTTGAGCCAGGGAGGTCAAGGCTGCAGTGAGCCATGATCATGCCGCTGCACTCCAAACTGGGGGACAGAATGAGACCCTATATCAAAAAAAAAAA"
"chr1","18916484","18916788","chr1","207218281","207218584","75","188301797","GGCTGTGTGCAGTGGTTCACGCCTGTAATCCCAGCACTTTGGGAGGCCAAGGCAGAAGCATCGCTTGAGCTCAGGAATTTGAGACCAGCCTGGGCAACACAGTGAGACCCTGTCTCTACAAAAAAATTTAAAAATTAGCTGGGCATGGTGGCACATGCCTGTGCTCCCAACTACTTGGGAGGCTGAGATGAAAGGATCCCTAAACCCAAGAGGTTGAGGCTGCAGTGAGCTGTGACCATGCCGCCGCACTCCAGCCTCCAGCCTGGGTGACAAAGTGAGACCCTGTCTCAAAAAAAAAAAGGAAA","GCCAGGCACAGAGGCTCATGCCTGTAATCCCAACACTTTGGGAGGCCGAGACAGGAGGATCACTTCAGGCTAGGAGTTGAGACCAGTCTGGGCAATATAGTAAGACCCTATCTCTATTAAAAAAAAAAAAAAAAAAAAAAAAAAGCTGGGTATGGTGGCACATGCCTGTGTTCCCAGCTACCTGGGAGACTAAGGTGGGAGGACTGCTTGATCCCAAGAATTTGAGGCTGCAGTAAGCTATGACTGCACCACTGCACTCCAGCATGGGCGACAGAGCGAGACCTTGTCTCAAGAAAACAAAAAA"
"chr1","18943086","18943387","chr8","15910614","15910909","72","3032472","GCCAGCCATGGTGGCTCACATCTGTAAGCCCAGTACTTTGGGAGGCCAAGGCAGGAGGATCACTTGAGGCCAGGAGTTCAAGACCAGCCCCGGCAACATAGCGAGACCCCTATCTCAACAAAAATTATTTTTTTTAAAAAAAAATTAGCTGGGTGTAGTGGTGTGTGTCTGAAGTCCTAGCTCCTCGGGAGGCTGAGGCAGGAGGATTGCTTGTGCCTAAGGAGTTGAAGGATGCAGCAAGCAGTGACTATTCAACAGCACTCCAGGCAGGGCAACAGAGCAAGACCCTGTCTTAAAAAAAA","GGCCAGGCGAAGTGGCTCACACCTGTAATCCCAGCACTTTGGGAGGCCAAGGCAGGAGGATCATTTGAAGCCAGGAGTTCAAGGCCAGCCAGAGAAACATAGTGAGAACCTGTCTTTACAAAAATTAAAATTAAAATTAAAATTAGCCAGGAGTGGTGGTGCATGCCTGCAGTCCCAGCAGCTCAGGAGGCTGAGGTGGGATGATTGCTTGCACCAGGAGTTCGAGGCTGCAGTGAGCTGTGATCGTGCCACTGCACTCCAGCCCCTGGGTGACAAAGCAAGATCCTCTAAAAAAA"
"chr1","18961612","18961917","chr9","68878569","68878883","70","49916957","GACCTGGTGCAGTGGCTCACACCTATAATCCCAGGACTTTGGGAGGCCGAAGTGGGAGGATCGCTTGAGCCCAGGAGTTCGAGTCCAGCCTGGGCAACGTAGTGAGACCCCATCTCTACAAAAAAAATTTTTTAAAAATTAGCTGAGCATGGTGGCACATGCCTATGGGGTCCTAGCTACTTGGGAGGCTGAGGTGGGAGGATCATGTAAGCCTGGGAGGTAGAGTCTGCAATGAGCTATAATCTTGCCACTGCACTCCAGCCTGGGTGACAGAGTGAGACTGCCTCCAAAAAAAAAAAAAAAAAA","GGCTGGGCACGGCAGCTCATGTCTGTAATCCCAGCACTTTGGGAGGCCAAGGTGGGAGGATTGCTTGAGTCCAGGAGTTCAAGACCAGCCTGGGCAACATAGTGAAACCCCAGTCTCTACAAATAAATAAATAAATAAATAAATAATTAGCTGGGCATGTTGATGCATGCCTGTAGTCCTAGCTACTCGGGGGGTGAGGTGAGAGGATTGCTTGAGTCCAGAAGGTGGAGGCTGCAGTGAGCTATGATCACACCACTGCACTCCAGCCTGGAAGACAGGGTGAGACGCTGTCTTTAAAAAAAAAAAAAGAAAAGA"
"chr1","18969826","18970120","chr9","68878569","68878883","73","49908743","GGCTGGGTGCAGTGGCTCATACTCGTAATCCCAGTGCTTCAGGAGGCCAAGGTGGGATGATTGCTTGAGTCCAGGAGTTGACCAGCCTGGGCAACATGGCAAGACCCTGTCCCCACAAAAAATTTACAAATCAGCCAGGCATGGTGGTGCACACCCATAGTTCTAGCTACTCAGGAGGCTGAGGCGGGAGGATCTCTTGAATCCAAGAGGTGAAGGCTGCAGTGAGCTATGATCACACCACAGCACTCCAGCCTGGGCGATAGAGCAAGACTCTGTCTCAAAAAAAATAAAAAAA","GGCTGGGCACGGCAGCTCATGTCTGTAATCCCAGCACTTTGGGAGGCCAAGGTGGGAGGATTGCTTGAGTCCAGGAGTTCAAGACCAGCCTGGGCAACATAGTGAAACCCCAGTCTCTACAAATAAATAAATAAATAAATAAATAATTAGCTGGGCATGTTGATGCATGCCTGTAGTCCTAGCTACTCGGGGGGTGAGGTGAGAGGATTGCTTGAGTCCAGAAGGTGGAGGCTGCAGTGAGCTATGATCACACCACTGCACTCCAGCCTGGAAGACAGGGTGAGACGCTGTCTTTAAAAAAAAAAAAAGAAAAGA"
"chr1","18990733","18990936","chr14","51003183","51003398","57","32012450","CAGCCTGGCAACATAGGGAGACACTGTCTCTACAAAAAATAAATTAGCCAGGGGTGGTGGGGTGCACCTGTAGTCCCAGCTACTAGGGAGGTTAAAGTGAAAGGATGGTTTGAGTCCAGGAGGTCAAGGCTGTGGTGAGTTGTGATCATGCCACTGCACTCCAGCCTGGGCAAAAGAGCAAGGCCCTGTCTCAAAATAAAAGAA","AGCCTGGGCAAGATAGTGAGACCTCATCTCTTAAAATAAATAAATAAATAAATAAATAGCAGGATGTGGTGGCGTGCATCTGTAGTCCCAGCTACTCAGGAGGCTGAGATGGGAGGATTACTTGAGCTCAGGAGGTCGAGGCTGCAGTGAGCTATGATCACGCCACTGTACTCCAGCCTGGGTGAGAGTGATACCCTGTCTCTAACAAAAAAAAAA"
"chr1","19040544","19040770","chr15","21573933","21574192","78","2533389","GCACTTTGGGAGGCTGAGGCAGGAGGATTGTTTGAGGCCAGGAGTTCGAGACCAGCCTGAGTAACATAGTGAGACCCTGTCCCTACAAAACTATATTAAAAAAATAGCCAGGTGTAGTAGTGCATGCCTGTGCTCTCAGCTACTCAGGAGGCTGAGGTGGGAGGATCACTTGAGTCCAGAAGGTCAAGGCTGCAGTGAGCTTTGACTGCATCACCGCACTTCAGCCT","TCCCAGCACTTTGGTAGGCCAAGACAGGAGGATCACTTGAGGCCAGAAGCTAGAGACCAGCCTGGCAACATAGTGAGACCCCGTCTCCAAAAAAAAAAAAAAAAAAAAAAAAAAAATTTAATTAGCTGAGTGTGGTGGCGCATGCCTGTAGTCCTAGCTACTCAGAGGCTGAGGTGGGAGGATCATTTGAGCCCAGAAGTTTGAAGCTTCAGTGAACTATGACTGCACCACTACACTCTAGCCTAGGCATCAGAGCGAAA"
"chr1","19130064","19130202","chr15","37343640","37343763","66","18213576","AGAAAATAGCTGGACATGGTGGTGTGCCTATCATCCCAGCAATTCAGGAGACTAAGAAGGGAGGATTGGTTGAGCCCAGGAATTCAAAGATGCAGTGAGCTATGATCATACCACTGCAAACTAGCCTGGGCAACAGAGC","AAGATCCCTGGCCAGGATTTCAAGACCAGCCTGGGCAACACAGTGAGACCATACATACATACATACATACATACATACATCATACATACATACATACATACATACATACACAGTCTTACAAAGA"
"chr1","19194342","19194512","chr5","32595015","32595178","71","13400673","GCCAGGTGTGGTGGTGCATGCCTCTAGTTCCAGTTACTCAGGAGGTTGATGTGGGAGGATCATTTGCACCCAGGGGTTTGAGGCTACAGTGAGTTATAATCGCTCCACTGCACTCCCACCTGGCTGAAACACTAAGATTCTGTCTCTTTTTAAAAAAGTAATAAAAATAAA","GGCCGGGTGTGGTCCCTCATGCCTGTAATCCCAACACTTTGGGAGGCTGAGATAGGAGGACTGCTTGAGGCCAGGAGTTCAAGACCAGCCTGGTCAACATAGTGAGACCCCATCTCTATAAAATAATAATAATAATAATAATAATAATAATAAATAAATAAATA"
"chr1","19226335","19226464","chr5","32595015","32595178","57","13368680","GGCTAGGCGCAGTGGCTCAAGTCTCTAACCTCAACACTTTGGGAGGCTAAGGTAAGAGAACTGCTTGAGGCCAGGAGATAGAGACCAACCTAGGCAACATAGTGAGACCCTGTCAATATAAAAATAAAAA","GGCCGGGTGTGGTCCCTCATGCCTGTAATCCCAACACTTTGGGAGGCTGAGATAGGAGGACTGCTTGAGGCCAGGAGTTCAAGACCAGCCTGGTCAACATAGTGAGACCCCATCTCTATAAAATAATAATAATAATAATAATAATAATAATAAATAAATAAATA"
"chr1","19266306","19266602","chr1","80364799","80365106","79","61098493","GTGGCTGACACCTGTAATCTCAGCACTTTGAGAGGCCAAGGCAGTAGGACTGATTGAAGACAGGAGTTCCAGACCAGTCTGGGAAACAAAGCGAGACCCTGTCTCCACTAAACATAAAAACAAAATTACTGGGGCCCCATGGCACACACCTGTAGTCCCAGCTGCTCGGGAAGCTGAGATGGGCGGATTGCTTGAGCCCAGGTATTCAAGTCTGGAGTGAGCTATGACTGTGCCACTGCACTCCAGCCTGGGCGACAGAGCAAACCCTGTTTCCAAACAAACAAACAAACAAACAAA","GGTGGCTCACACTTGCAATCCCAGCACTTTGGGAGGACAAGTGGGGGAAGATTACTTGAAGCCAGGAGTTTGAGACTATCCTGGGTAAGAAAGCCAGACCCTGTCTGTATAAAAAATAAAAAATAAAAAATAAAAAAATTAACTAGTCATGGTGGTGCACACCTGTAGTCCTAGCTACCCAGGAGGCTGAAGCAGGAGGATTGCTTGAGCCTAGGTATTAAGGCTCCAGTGAGCTATGACTGTACCACTGAACTTTAGCCTGGGCAACAGAGCAAGATCCTGTCTCAAAAAAAAAAAAAAAAAAAAAA"
"chr1","19278951","19279250","chr3","54066100","54066414","79","34787149","GTAGCTCACGCCTGTAATCTCAGTACTTTGGGAGGCCAAGGCAGGAGGATTAATTGAAGACAGGAGTTCCAGACCAGTCTGGACATAGAAGTGAGACCTTGTCTCTAGTAAACATAAAAAGAAAATTAGCTGGGTTCTGTGGCACACACCTGTAGTCCCAGCTACTCAGGAAGCCGAGGTGGGAGGATTGCTTGAGCCCAGGTATTCAAGGCTGGAGTGAGCTATGATTATGCATCACTGCACTGCAGCCTGGGTGACAGAGCAAACCATGTTTCTAAATACATAAATAAGTAAATAAAA","GGATGTAGTAGTTCACGCCTATAATCCTAGCATTTTTGGGAGGCCAAGGCAGGAGGATCACCTGAGGCCAGGAGTTCCAGACCAGCCTGGGCAAGATAGTGAGACCCTATCTCTAAAAAAAAAAAAAAAAAAAAAAAAAATTTAGCTGGGTTTGGCAGCTCATGTCTGTAGTCCTAGCTACTTGGGAGGCTGAGGTGAGAGGATCACTTGAGGCCAAGAGTTAGAGGCTGCAGAGAGCTATAATTGTGCCATTGTACTCCAGCCTGGGTGACAGAACAAGACTCTGTCTCTAAAAACAAAAATAAAGTAGAAAAA"
"chr1","19289859","19290073","chr13","83255168","83255404","81","63965309","TAGCCCACACCTGTAATGTTAGCACTTTGGGAGCCTGAGAAGGGAGGATTGCTTAAGTCCAGGAGTTTGAGACTAGCCTGGGCAACACAGGGAGATCTTATCGCTACAACAAAATTTTAAAAATTATCAAATTGTGGTAGCATGCACCTGTGGTCCCAGTTACTTGGGAGGCAGAGGTGGGAGAATCATCTACGCCTGGGAGGTCGAAGCTGCAG","GCCAGGCCTGGTGGTTCACACCTGTAATCCCAGTAATTTCAGAGGCCAAAGCAGGTGAATGGCTTGAGCTCAGGAGTTTGAGACCAGTCTGGGCAACATGGCAAAACTCTGTTTCTACAAAAACAAAAACAAAAACAAAAAAAATTAGCTGGGCATGGTGGCACATGCCTGTAGTCCCAGCTATTTGGGGGACTGATGTGGAAGGATCACTTAAGCCCAGGAGGTCAAGGCTGCAGT"
"chr1","19321163","19321476","chr14","31798968","31799292","77","12477805","GCTGGGCACAATGGCTCATGCTTGAACCCCAACACTTTGGAGGCTGAGACAGGAGGATTGCTTAAATCTAGGAGTTTGAGACCAGCCTGGACAATACAGTGAGACCTTGTCTCTACCAAAAAAAAAAATTTCAATTAGCAAGGTTTAGTGGTGCACGTCTGTGGTCCCAGTTACTCAAGAGGCTGAGGTGGGAGGACTGCTTGAGCGCAGAAGGTCAAGGTTGCAATGAGCTATGTGATCACACTACTGCACTCCAGCCTGGGGGACAGAGTATGACCGTGTCTCAAAAAAAAAAAAAAAAAAAAAAGAAGAGA","GGCTGGGCACAGTAGCTTACACCTGTAATCCCAGTACTTTGGAAGGCTGAAGTGGGAGGATCCCTTGAGGCCAGGAGTTTGAGACCAGCCTGGGCAACATAGTGAGACCCTGTCTCTACAACAAACAAACAAACAAACAAACAAAACTTAGCCAGTTGTGGTGGCACATCCTATAGTCCCAGCTACTCAGGAGGCTGAGGAGGGAGGATCTCTTGAGCCCAGGAGTTTGAGGCTGCAGTGAGCTATGATCATGACACTGCACTCCAGCCTGGATAACACAGCAAAATCCTGTCTCAAAAAAAAAAAAAAAAAAAAAAAAAAAGAA"
"chr1","19329986","19330130","chr5","32595015","32595178","63","13265029","GCCAGGCATGGTGGTGCTCATCTGTAGTCCCAGCTCCTCGGGAGGCTGAGTGGGAGGATCCCTGGAAGCTAGGAGTTCGAGGCTGCAGTGAGCTATGATCGCACCACTGTACTCCGGCCTGGGCTAAAAAATTTTAAAAATAAAA","GGCCGGGTGTGGTCCCTCATGCCTGTAATCCCAACACTTTGGGAGGCTGAGATAGGAGGACTGCTTGAGGCCAGGAGTTCAAGACCAGCCTGGTCAACATAGTGAGACCCCATCTCTATAAAATAATAATAATAATAATAATAATAATAATAAATAAATAAATA"
"chr1","19336392","19336522","chr9","47045786","47045941","57","27709394","GGCTGGGCGTGGTGGCTTACACCTGTAATCCTAGCACTTTGGGAGACTGAGGTGGGGGATCGCTTGAAGCCAGGAGTTTGAGACCAGCCTGGGCAACAGGGTGAGGGCCCGTCTCTACAAAAACAAAAAAA","GCTGGGCGCAGCAGCTCACACCTGTAATCCCAGTGCTTTGGAGGTCCAAGGTAGGAGGATTGCTTAAGACTAGGTGTTCAAGACCAGTCTTGGCAACATAGTGAGAACTCATCTCTACAATAAATAAATAAATAAATAAATAAATGAAAATAAAAA"
"chr1","19340550","19340670","chr1","217544386","217544536","59","198203836","GGCCGGATGTGGTGGCTCAAGCCTGTAATCCCAGCACTTTGGGAGGCCAAGGCAGGAGGATCATTTAAGGCCAGGAGTTCAAGACCAGCCTGGGCAACATAGTGAGACCCCATCTCTACAA","GGCTGGGCGTGGTGGCTCATGCCTCTAATCCCAGCACTTTAGGAGGCCAAGGCAGGAGGATAACTTAAGACCAGGCTGGGTGACACAGTGAGACTTTGTCTCTAAAAAAAAAAAAAAAAAAAAAAAAAAAAAAAACCTACAAAAACATATA"
"chr1","19364835","19365136","chr1","135236320","135236644","77","115871485","CACGGTGACTTATGCCTATAATCCCAGCACTTTGGGAGGCCGAGGTGGGAAGATTACTTGAGCCCAGGAGTTCAAGACCTGCCTGAGCATAGCGAGACCCTGTCTCTACAAAAAAATTTAAAATTACCCAGGTGTGGTGGCATGCACCTGTAGTCCCAGCTACTCAGGAGGCTGAGGTGGGAGGATCACTTGAGCCCAGAATGTCGAGGCTGCAATGAGCCATGGTCATGCCATTGCACTCCAACCTGGGCAAGAGAACGAGACCCTGTCTCAAAAAAAGAGAGAAAAAAAAAAAGAAAAAA","GGCTGGGTGTGGTGGCTCGTGCCTATAATCCCAGCACTTTGGGAGGCCAAGGTAGGAAGATCACTTGAGCCCAGGAGTTTGAGACCAGCCTGGGCAAAATGGCAAGACCCTGTCTCTATAAAAATTTAAAAAAATTAGCCAGCTGTGTTTGTATGCGTCTGTCATCTCAGCTACTAGGGAGGCTGAGGTGGGAGGATTGCTTGAGTCCGAGAGTTTGAGGCTGCAGTGAGCTATGATCATGCCACTGTACTCCAGCCTGAGTGACAGAGTGAGACCCTGTCACACACACACACACACACACACACACAAAAGAAAAGGAAAGAAA"
"chr1","19416625","19416888","chr12","118411877","118412164","82","98995252","AGGATTGCCTGAGGTCAGCAGTTCGAGACCAGCCTGGGCAACATAGGGAGAACCAGTCTCTATGCAAAATAAAACATTTTAAAAAATTGGCCAGATGTGGTGGTGGGCGCCTGTTGTCTTAGCTACTTGCAAGGCTGAGGCAGAAGATCATTTGAGCCCAGGAGTTTAGGAGGCTGCATTGAGCTTTGATTGCACCACTACACTCTAGCCTGGGTGACAGAGCAAGACCCTGTCTCAAAAAAAAAAAAAAAAAAAAAAAAAAAA","TGGGTGGCTGAGGCGTGAGGATTGCTTGAGGCCGAGAGTTTGAGACCAATCTAGGCAACATAGTGAGACCCCATCTCTACAAAAAAAAAAAAAAAAAAAAAAAAAAAAATTAGCCAAGTATGGTGGTGTGCACTTCTAGTCCCATCTACTCAGGAGGCTGAGGTGGGAGGATCACTTGAGCCCAGGTGTTTGAGGCTGCATTGAGCTCTGGTGGTACCACTGCACTATAGCCTGGGTGACAGAGTAAGAGCCTGTCTCAAAATAAAAATGAAAAATTAAAACGAAAAA"
"chr1","19431803","19432072","chr12","22057795","22058093","90","2625992","GCAATGGCTTACACCTGTAATCCTAGCACTTTGGGAGGCAGAGGTAGGCAGATCACTTGACCCCAGTAGTTCAAGACCAGCCTGGGAAACACAGCGAGACCCCGTCTCTACAAAAAACTTTTTAAATTAGCCAGGTGTGGTGGTGCATGCCTGTAGTCCCAGCTACTCGGGAGGCTGGGGCGGAAAGATCACCTGAGGTTGAGGCTGCCCAGTCTGCATAACAGAATGAGATCCTGTCTCAAAAAAAAAAAAAAAAAAAAAAAGAAAAAA","GTGCGGTGGCTCACACCTGTAATCCCAGCACTTTGGGAGGCCAAAACAGGAGGATTCCATGAGGCCGAGAGTTTGAAACCAGCCTGGGAAACATAGTGAGACCTGTCTCCACAAAATAAAAATAAAAATAAAAATAAATTAGCCAGGCATGGTGGTGCATGCCTGTAGTCCCAGGAGCTACTCAGAAGGCAGGAAGAGGAGTTGGAGGCTACCATGCCATGACTGTGGGGGCACTGCACTCCAACCTGGACAACAGAGGAAAACCCTGTCTCCAGAAAAAAAAGAAAAAAGAAAAAAAA"
"chr1","19466902","19467174","chr16","18746194","18746482","78","720708","GCCAGGCATGGTGGATCTCAGCACTTCGGGAGGCCAAGGTGGGAGGATCACTTGGGACCAGCCTAGGCAACATAGTGAGACCCAATCTCTACAAAATAAATAAATAAATAAATAAAAGCTGGGTGTGATGGTGCATCTGGAGTCCCAGCTACTTGGGAGGCTGAGGCGGGAGGATCCCTGGAGCTTGTGTGTTAGGATTTTTCCTATGAATAACTCCTGCATTCCAGCCTGGGTGACAGAACAACACCCTCTCTCAAAAACAAAAACAAAAAA","GGGCGTGGTGGCTCACACCTGGAATCCCAGCACTTTGGGAGGCTGAGGTGGGAGGATTGCTTGAGACCAGCCTGAGCAACATAGTGAGACCCCATCTGCTAAAAAAAAAAAAAAAAAAAAAAAAAAATTAGCTGGGTTTGCTGGTGCATGGCTATAGTCCCAGTTACTCAAGAGGCTGAGGGGGGAGGATTGCTTGAGCCCAGGAGTTTGAGGTTACATGATCATGCCACCGCACTCCAGCCTGGGAGACAGAGCAAGACACTGTCTGTAAATAACAATAATAATAAAA"
"chr1","19491266","19491549","chr7","7616254","7616509","83","11875012","GGCCAGGCATGGTGGCTCATACCTATAATCCTAACACTTTGGGAGGCTAAGCCCAGGATTTTGAGACCAGCATGGGCAACATGGCAAGACCCCATTTCTATAAAGATTTTTTTTTTTAATTAGCCAGGCATGGTGTCATGTACCTGTGGTCCCAGCTACTTGGAAGGCTGAGGTGGGAGAACCTCTTGAGCCCAGGAGGTTGAGGCTGCAGTAAGCTGTGTTTGTGCCACTGCACTCCAGCCTGGGCAACAGAGTGAGACCCAGTCTCCAAAAAAGAAAAGAAA","GGCCATGCACGGTGGCTCACACTTGTAATCCCAAAACTTTGGGAGGCTGAAGCAGATTTCATCTCTACAAAAAAAAAAAAAAAAAAAAAAAAATTGGCCAGGTGTGGTGGCATGAGCCTGTAGTCCCAGCTACTAGGGAGGCTGAGGTGGGAGGATCGCTTTGGCCCAGGAGTTTGAGGCTGCAGTGAGTTACGACTGTGCCTCTGCACTCCAGCCTGGGTGACAGAGCGAGATCCTGTCTCTAAAAATATATAAA"
"chr1","19497519","19497820","chr2A","65797088","65797395","67","46299569","GGCCAGGCACAGTGGCTCATACCTGTAATCCCAGCACTCTGGGAGGCTGAGGATTGCTTGAGCCCAAGAGTTCAAGACCAGCCTGGGTAACATAGTGAGACCTCATCTTTACTAAAAATAATTGTAAAAATTAGCCACGTGTGGTGCCATGTGCCTGTAGTCCCAGCTGTTTGGGAGGCTGAGGTGAGACGATTGCTTGAGCCTGGGAGGTCAAGGCTGTAGTGAGCAATGATTGCACCACTGCTCTCCAGCCTGGGTGACAGAGTGAGACACTGACTCAAAAAAAAAAAAAAAAAAAAGAA","GGCCAGGCTCGGTGGCTCTTGCCTATAATCCTAGCACTTTGGGAGGCCAAGGATTGCTTGAGCCCTGGAGTTTGAGACCAGCCTGGGCAACATAATGAGACCCTGTGTCTACAAAAAAAAAAAAAAAAAAAAAAAAAAATTGGGTGTGGTGACATGTGCCTGTGGTACCAGCTACTAGGGAGGCTGAGGTGGGAGGATCACTTGAACTCAGGAGGTCGAGGCTGCAGTAAGCCACGATTGCACCACTGCACTCCGGCATGGGTGACAGAGCGAAACCCTGTCTAAAAACAAAAACAAAAACAAAAGAA"
"chr1","19508251","19508324","chr20","87144","87254","60","19421107","GGCCAGGTGCGGTGGCTCACACGTATAATCCCAACACTTTGGGAGGCTGAGGCAGGAGGATCACTTGAGGCCAG","CCTGGGCAACATAGTGAGACTACATCTCTACACTCACGCACACACACACACACACACACACACCCCCCAAATTAGCCAGGCATGCTGATGTGCACCCATAGTCTCAGCAAC"
"chr1","19509282","19509509","chr10","102878352","102878592","72","83369070","CTAGGAGTTCAAGACCAACCTGGGCAACATAGTGAGACACCATCCATACAAAATAAAAATTTTAAAATTAGCTGGGCATGGTGGCATGCCTACAGTCCCAGCCATTGGGGAGGTTGAGGCAGGAGGATTGCTTGAGTCCAGGAGTTTGAGGCTGCACTTAGCAGTGATGGCACTACTGCACTCCAGCCTGGGTGACAGCATGTCTAAAGAAAACAAACAAAACGAAAA","AGGCCAGGAGTTCAAGACTAGCCTGGGCAATACAGTTACACCCCCATCTCTACAAACAATAATAATAATAATAATAATAATAATAATTAACTGGGCATGGTGGCATGCTCCTGTAGTCCCATCTACTTGGGAGGCTGAGGCAGAAGGATCACTTGAGCCCAGGAGGTTGAGGCTGCAGTGAGCTATGATCATCCCACTGCCTCCAGCATGGGTGGCAGAGTAAAACTGTGTCTCTAAAAAA"
"chr1","19517223","19517473","chr2A","34453871","34454129","82","14936648","GGCTGGGTGTGGTGGCTCACATCTGTAATCCCAACATGTTGGGAGGCCAAGGGATTGCTTGAGGCCAATAATTAAACATCAGCCTGGGCAGCATAGCAAGACCTCATCTCTACAAAAAATAAAAATATAGCTAGGTGTGGTAGTGCACAGCTGTAGTCCTATCTACTTGGGAGGCTGAGGTGGGAGGAGTGCTTGAGCCCAGGAGGTCAAGGCTGTAGAGTGAGCTATCATTATACCACTACACTCTACCC","GGCCAGACACAGTGTCTCACACCTATAATCCCAACACTTTAGGAGGCTAAGGCCGGAGGATCATTTGAGGCCAGAAGTTAGAGATCAGCCTGGGCAACACAGCAAGACTCAGGCTCTAAAATAAAAAATAAAAATAAAAAATAAAAATTAGCTGGGCGTGGTACATGCATCAAGTCCTAGATACTTGATAGGCTGAGGTGGGAGGATCGCTTGAGTCCAGGAGTTCAAGGCTGCAGTGAACTGTGATCACGCCACTGCA"
"chr1","19520793","19520971","chr18","55799233","55799394","62","36278440","TAGCTGGGCATGGTGGGTCATGCTTGTAACCTCAGCACCTCAGGAGACTGAGGTGGGCGGATTGCTTGAGTCCAGGAGGCTGAGGCTGCAGTGAGCTAAGATCATGCCACCGTACTTCAGCCTGGGTAACAGAGCAAGATCTTTCTCAAAAAAATAAAAAAAATTAAAAAAATTAAAAA","GGCTGAGAGAGGTGGCTCATGCTTGTAATCCCAGCACATTGGGAGGCAAAGGTGGGAAGATTGCTTGAGGCCAGGAGTTCAAGACCAGCCTGGGCAACATGAAAACACTTTGTCTCTACAATAAATAAATAAATAAATAAATAAATAAAAGAAACAAGAAAA"
"chr1","19524208","19524530","chr14","31798968","31799292","79","12274760","GGCCTGGTGCGGTGACTGACACCTACAATCCCAGAGCTTTGAGAGACCGAGGGAGGAGGATCCTTTGGGGCTAGGTGTTCGAGACCAACCTAGGCCAACAGAGTGATACCCCTATCTCTAAAAATAAAAATAAAAACAAAAAATTAGCTAGGAGTGATGGTGTGTGCCTGTAGTCCTAGTTACTCAGGAGGCTAAGGCAGGAAGGTTGCTTGGAGTCCAGGAGTTTGAGGCTGTAATGAGCTATAATTGTGTCACTGCACTCTAGCCTGGACAACAGAGCAAGACCCTGTCTCTAAAAAAAATTAAAAAATAAAAAGAGAAAA","GGCTGGGCACAGTAGCTTACACCTGTAATCCCAGTACTTTGGAAGGCTGAAGTGGGAGGATCCCTTGAGGCCAGGAGTTTGAGACCAGCCTGGGCAACATAGTGAGACCCTGTCTCTACAACAAACAAACAAACAAACAAACAAAACTTAGCCAGTTGTGGTGGCACATCCTATAGTCCCAGCTACTCAGGAGGCTGAGGAGGGAGGATCTCTTGAGCCCAGGAGTTTGAGGCTGCAGTGAGCTATGATCATGACACTGCACTCCAGCCTGGATAACACAGCAAAATCCTGTCTCAAAAAAAAAAAAAAAAAAAAAAAAAAAGAA"
"chr1","19534752","19535071","chr3","99347730","99348048","70","79812978","GCCAGGCATGGTGGCTCACACCTGTAATCCCAGCTACTCAGGAGACCAAGGTGGGAGGATCGTTTGAGGCTGAGAGTTTGAGAACAGCCTAGGCAACACAGTGACACCTTGTTTCTAAAAAAAAAAATAATAATTAAAATATTAGCCAGGCATGGTGGTGGCATGCACTTGTAGTCCCAACTACTCAAGAGGTTGAAGTGGGAGAATCGCTTGAGTCTAGGAGCTCAAGGCTGCAGTGAGCCATGATTGCACCACTGTACTCCAGCCTGGGTGCCAGAGTAAGACCCTGTCTCAAAAAAAAAAAAAAAAAAGAAAGGAAA","GGCTGAGCATGGTGGCTCATACTTCATCCCAGCACTTTGGGAGGCTGAGGTGGGAGGACTGCTTGAGTCCAAGAATTTGAGACCAGCCTGGGCAACACAATGACACCCCATCTCTCAAAAAAAAAAAAAAAAAAAAAAAAAAAAAGCCAGGCATGGTGGCACACACCTGTGGTCCCAGCTACTTGGGAGTCTGAAGTGGGAGGATCACTTGAGCTCAGGAGATCAAGGCTGCGTGAGCTGTGACTGCATCACCACACTCCAGCCTGGGTAACAAAGTGAGACCCTGTCTCAAAAAAAAAAAAAAGAAAAGAAAAGAAAA"
"chr1","19535543","19535848","chr6","32649583","32649885","68","13114040","GGCCAGATGTGGTGGCTTACGCCTGTAATCCCAGCACTTTGGGAGGCCAAGGCTTGAGAATCACTTGAGTCCAGGAGTTCAAGACCAGCCTGGGCAACATAGTGAGACCCCATCTTTACAAAAAAAAAATGAACAAAATTAGCCAGGCCTGTGGGGTGCACACCTGTAGTCCAAGCTACACAGGAGGCTGAGATGGGAGAATCACTTGAGCCCAGGAGATCAAAGCTGTAGTGAGCCATGATTGTGCCACTGCACTCCAGCCTGGGCAACAAGAATGAAACTCTATCGCAAAAAAAAGAAAAAAAA","CTGGGTGTGGTGGTTCATGCCTGAAATCCCAGCACTTTGGGAGGCCAAGGCAAGAGGACTTCTTGAGCCTAGGAGTTCGAGACTGGCCTGGGCAACATAGTGAGACCCTGTCTCTAAAAAAAAAAAAAAAAAAAAAAAAATCAGCTGGATGTGGTGGTGCACACCTGCAGTCCCAGCTACTCAGGAGGCTGAGGTGGGAGGATTGCTTGAGCGCAGGAGTTTGATGCTGCAGTGAGCCACAATCATGCCACTGCTCCACTCTGGGTAACAGAGTGAGATTTTGTCTCAAAAAAAGGGAAAAAA"
"chr1","19539069","19539397","chrX","16155635","16155942","75","3383434","GGCCAGGTGCAGTGGTTCACGCCTGTAATCCCAGCACTTTGGGAGACTGAGGCAGGAGGATCATTTGAGGCCAGGAGTTCAAGGCCAGCCTGGGCCACATAGCGAAACCCTATCTCTAGACTCCATCTCTACCAAAAAAAAAAAAAAAAAATCAAAAAATAAGCTGGGCATATGGGATTATGTGCCTGTGGTCCCAGCTACTCTGGAGACTGAGGCGGGAGGATAGCTTCAGCCCAGGAGGTCCAGGATATAGTGAGCCAAGACCATGCCACTGCACTCCAGCCTAGGCAATAGAGTAAGACCCTGTCTCTGAAAAATAAAGAAAAAAA","GGCCAGGCACAGTGGCTCACACCTGTAATCCCGGTACTTTGGGAGGCTGAGGCGGGAGGATCACTTGAGCCCAGGAGTTCAAGACCAGCCTGGGCAACATAACAAGACCCTGTCTCTACCAAAAAAAAAAAAAAAAAAAAAAAAAATAGCCAGGCCTGGTGGCCTGTGTCCATAGTCCCAGCTACTTTGGGAGACTGAGGTGGAAGGATCACTTGAGTCTGGAAATCAAGACTGCTGTGAGCTGTGATCATGCCACTGTACTCCAGCCTGAGCAACAGAGTGAGACCCTGTCTAAAAAAAAAAAAAAA"
"chr1","19588250","19588558","chr2B","83001661","83001979","71","63413411","GGCCAGGTGCTGTGGCTCACACCTATAATCCCAGCACTTTGGAAGGCCGAAGTGGGAGGATCACTTGAGTCCAGGAGTTTGAGACCAGCCTGGGCAATATAGTGAGACCTTGTTTGTACAAAAAATGTTAAAAATTAGCCAGGCGTGGTGGTGCATGCCTATAGTCCCAGCTTCTTGGGAAGCTGAGGTGGGAGGATCACTGGAGCCCAGGAGGCAAGGGCTGCAGTGAGCTAAGATCACACCACTACTACTGCACTCCAGCCTGGCGATAGTGAGACCCTGTCTCAAAAAAAAAAAAAAAAAAAAAAA","GGCTGGAGATGGTGGCTCACACCTGTAATCCTAGTACTTTGGGAGTCCGAGGTAGGAGGATCACTTGAGGCCAGAAGTTTAATACCAGCCTGGGCAACATAGTGAGAGCCTATCTCTACAAAAAAAAAAAAAAAAAAAAAAAAAGCCAGGTGTGGTGGTGCATGTTTGTAGCCTCAGTTACTTGGGAGGCTGAGGTGGGAGGATCATTTGAGCCCAGGAGGTTAAGGCTGCAGTGAGCCAGTTATGGCACCACTGTACTCCAGCCTGGGCGACAGGGCAAGACCCTGTCTCACAAACAAAAACAAAACAAGACAAAAAA"
"chr1","19592499","19592664","chr5","32595015","32595178","57","13002516","CAGGCCAGGTGGTATGTGCTTGTTGTCCTAACTACTTGGGAGGCTGAGGTGGGAGGATTGCTTGAGCCCAGGAGTTCGAGGCTGCAGTGATCTATGATAGTGTCACTGCACTCCAGTCTGAGCAACAGAATGATATTTTGTCTCTAAATAACATAAGTAAATAAAA","GGCCGGGTGTGGTCCCTCATGCCTGTAATCCCAACACTTTGGGAGGCTGAGATAGGAGGACTGCTTGAGGCCAGGAGTTCAAGACCAGCCTGGTCAACATAGTGAGACCCCATCTCTATAAAATAATAATAATAATAATAATAATAATAATAAATAAATAAATA"
"chr1","19601297","19601602","chr9","68878569","68878883","73","49277272","GGCCAGGCACAGTGGCTCATGCCTATAATCCCAGCACTTTGGGAGTCTAAGGTGGGAGGATCACTTGAGCCCAAGAGGTCGAGACCAGCCTGGGCAACATAGTTAGACCCATTGCAGCAAAAAATATATATATTAGCTGGGTGTGGTGGCATACGCCTATGGTACCAGCTACTTGGGAGGCTGAGGTGGGAGGATCTCTTGAGCCTAGAGGTTGAGGCTGCAGTGTGCTGTGATCGCACCACTGCACTCCAGCCCAGACGACAGAGCAAGACCCTTTCTCAAAAAAAAAAAAAAAGAAAAGAAAAA","GGCTGGGCACGGCAGCTCATGTCTGTAATCCCAGCACTTTGGGAGGCCAAGGTGGGAGGATTGCTTGAGTCCAGGAGTTCAAGACCAGCCTGGGCAACATAGTGAAACCCCAGTCTCTACAAATAAATAAATAAATAAATAAATAATTAGCTGGGCATGTTGATGCATGCCTGTAGTCCTAGCTACTCGGGGGGTGAGGTGAGAGGATTGCTTGAGTCCAGAAGGTGGAGGCTGCAGTGAGCTATGATCACACCACTGCACTCCAGCCTGGAAGACAGGGTGAGACGCTGTCTTTAAAAAAAAAAAAAGAAAAGA"
"chr1","19608884","19608994","chr20","87144","87254","57","19521740","GCTGGGAAAAGTGGCTCACATCTTAAATTGCAGAATTTTCGGACACTGGGGCAGGAGGATTGCTTGAGGCCAGAAGTAGTAGCCTGAGCAACATGTGAGACCCTGAGTCTA","CCTGGGCAACATAGTGAGACTACATCTCTACACTCACGCACACACACACACACACACACACACCCCCCAAATTAGCCAGGCATGCTGATGTGCACCCATAGTCTCAGCAAC"
"chr1","19618113","19618441","chr2B","51779640","51779976","72","32161527","GGCTGCGTGCAGCAGCTCATGCCTGTAATCCCAGCACGTTAGGAGGCCAAGATGGGAGGATCGCTTGAGCCTAGGAGTTTGAAACCAGCCTGGGCAACACAGTCAGACTGCATCTCTACAAAAACAAAAACAAAACAAAATAATAATAATAATAATAAATAAATAAAAATCAGCCAGGCATGATGGTGCATGCCTGTGCTCCCAGCTACTCAGGAGGCTTGGGTGGGAGGATCACTTTAGCCTGGGAGTTGAGGCTGCAGTGAGCCATGATCATACCACTGTATTGCAGCCTGGACAACAGAGTGAGACCTTGCCAAAAAAAAAAAAAA","GGCTGGGCATGGTAGCTCCTGCCTATAAGCCCAGCACTACGGTAGGCTGAAGAAGGAGGATTGCTTGAGTCTAGGAGTTCGAGAACAGCCTGGGCAACATAGTAAGACCTCATCTCTCCAAAAATAAAATAAAATAAAATAAAATGAAATAAAATAAAATAAAATAAAATAAAATAAAAGCCAGACATGATGAAACATGCCTGTAGTCCCAGCTATTCAGGAGGCTGAGGTGGAAGGATCACTTGAGCCTGAGAGGTTGAGGATGCAGTGAGCGATGATTGCACCACTGTGATCCAGCCTGGGCAACAGAACAAGACCTTGTCTCAAAAGACAAAAA"
"chr1","19638037","19638358","chr16","34390584","34390900","57","14752547","GGTCAGATACAGTGGCTCATGCCTATAATCCCAGCACTTTGGGAGGTCGAGGCAGGAGGATCACTTGAATCCAAGAGTTCGAGACCAGCCTGGACAACATAGCAAGACCCTGTCTCTAAGAAAAAAAAGAAAAAAACTAAAAATTAGCCAGGTGTGGCGGCATGTGCCTGTAGTCCCAGCTACGTGGGAGGCTGAGGTTGGAGGATCTCTTGAGCCCAGGAGTTAGAGGCTGCAGTGAGCTATGATTTTACCACTGCACTCCAGCCTGGGTGACAGAGAAAGAACCTATCTCAATAAATAAATAAATAAACAAACAAAATAA","GGCTGAGCACGGTGGCTCATGCATGTAATCCCAGCACTTGGGGAGGCCAGGGCGACAGGATCACTTGAGCTCAGGAGTTCGAGACCAGCCTGGCCAACATAGCAAGACCTTGTCTCTACTAAAAAAAAAAAAAAAAAAAAAAAAAAGCCAGGTGTGACGGCATGTGACTGTAGTTGTAGCTACTTGGGAGGCTGAGGTGAGAGGATTGTTTGAGCCCAGGAATTCAAGGCTGCAGTGAGCTATGATTGCACCACTGAACTTCAGCCTGGGTGACAGAGCAAGGCTCTATCTCAAAAATAAATAACTAAATAAATAAA"
"chr1","19649713","19649960","chr7","49845301","49845560","73","30195588","GGCTAAGCATGGTGGCTCACACCTGTAATCCCAGCACTTTGGGAGGCCAAGGTGAGAGAATTGCTTGAGCTCAGGAATTCAAGACCAGCCTGGGCAACATAAGACGATCCCATCTCTACAAAAATTTAAAAACTAGCCAGGTGTGGTGGTGCATGCCTGTGGTCCCAGCTACTTGGGAGGCTGAGGTGAGAGGATCACTCGGTCCTGGGAGGTTGAGGCTGCAGTGAGCCAGGATCATGCCACTACAC","GGTCAGGCATGGTGGCTCATGCCTGTAATCCCAACACTTTGGGAGACCTATGTGAGAGGATCGCCTGAGCCCAGGAGTTTGAGACCAGCCTTGGCGACATAGTGAGACCTTGTCACTACAAAAAAAAAAAAAAAAAAAAAAAAAAAAAATTAGCCGGGCATGGTGGTGCATGCCTGTGTTCCCAGCTATGTGGGAGGCTGAGGGTGGGAGGATTGCCTGGGCCCAGGAGATTGAGACTGCAGTGAGCTGAGATTGCACCA"
"chr1","19651697","19651900","chr3","156163392","156163618","76","136511695","TTTTTTTATTATCACACTGTGATAACACATTTTTTATTATCACATTATGCATTGTGATGTGCACCTGTAGTCCAGCTATGTGGGAAGCTGAGGCGGGAGGATGGCTTGAGACCAGGCTTGGGGCTGCAGTGAGCCATGATTGCGTCCCTGCACTCCAGACTGGGTGACAGAGCAAGAACCTGTCAAAAAGGAAAGGGAAAAAAA","CTGGACAACATTGTAAGACCCTGTGTCTAAAAATAATAATAATAATAATAATAATAAAGCCTGGTGTGGTGGCGCCCCATCTGTGGTCCCAGCTACTTGGGAGGCTGAGGCGGGAGGATTGCTTGAGCCCAGGAGGCGGAGGCTGCAGTAAGCCACGTTCACAGCACTGCACTCCGGGCTGGGAGACAGAGCAAGCCCCTGTCTCACTTAAAACCAAACAAACAAAA"
"chr1","19651927","19652042","chr20","87144","87254","60","19564783","GGCCAGGCATGGTGGCTCACACCTGTAATTCTAGCACTTTGGGAGGCCAAAGCGGGAGGACCACTTGAACTCAGGAGTCCAAGACTAGCCTGGGAAGCAAAGTGAGACTTGGTCTC","CCTGGGCAACATAGTGAGACTACATCTCTACACTCACGCACACACACACACACACACACACACCCCCCAAATTAGCCAGGCATGCTGATGTGCACCCATAGTCTCAGCAAC"
"chr1","19662048","19662243","chr19","13525969","13526165","75","6136079","TTTAAAAAAAAGACCTAAAGATTAGCTGAGCGTGGTGGTGCACGACTCTAGTTTCAGCTACTTGTGAGACTGAGGTGAGAGGATTGCTTGAGGCCAAGTGTTCAAGGCTGCAGTGAGCTATGATCACACGTGTGAATAGCCACTGAACTTCAGCCTCGGTGACAGTGTCTCAAACAAACAAACTAACTAAAGAAAA","AAGAAATAAATTAGTTGAGCATGGTGGTGCATGCCTATAGTCCCAGCTACTGGGGAGGCCAAAGTGGGAGGATTGTGTGAGCCCAGGAGTTTGAGGCTGCAATGAGCCAAGATTATGCACACCAGTGTGGGAGACAGTCAAGTCTCAAAAAATAAACAACAACAACAACAACAACAACAAACACATAAAAAGAAAAA"
"chr1","19672756","19672960","chr17","17826312","17826529","62","1846444","GCAGTGACTCACAACTGTAATCCCAACACTTTGGGAGGCCAAGGCAGGAGGATTCTTTGAAGCTAGGAGTTCGAGACCAGCCTGGGCAACATAGCGAGCTCCTGTCTCTAAAAATATATATAAAAAATTAGCCAGGCCTGGTGGCACATACCTTTAGTTACAGCTATTCGAAGAGGCTGAGGTGAGAGGATTGCTTGAGCCCAGG","GGCCAGGCGCGGTGGCTCACACCTGTAATCCCAGCACTTTGGGAGGCCGAGGCAGGAGGATTGCCTGAGGCCAGGAGTTTGAGATCAGCCTGGCCAACATGGTGAAACCCCGTCTCTACTTAAAAAAAAAAAAAAAAAAAAAAAAATAGCCAGGCTGGTGATGTACACCTGTAGTCCCAGCTACTCAGGAGGCTGAGGCAGGAGAATCACTTGAGCTC"
"chr1","19681524","19681773","chr1","88859712","88859991","76","69178188","TGGCTCACGCCTGTAATCTCAGCACTTTGGGAGGCCAAAGTGGGAGGATTGCTTGAGGCCAGGAGTTGGAGATCAGCCTGGGCAACATAGCGAGACCCAGTCTTGACAAAAAATTAAAATAAAAAAATTAGCCACTGCCAACTACTCAGGAGACTGAGGCAGGAGGATTACCTGAGCCCAGGAGCTCGAGGCTGCAGTGAGCTATGATTGTGCTGCAGCACTCCAGCCTGGGTGACAGAGTGAGACTCTG","CCAGGCACAGTGGCTCACACCTGTAATCCCAGCACTTTGGGAGGCCAAGGCAGGAGGATTGCTTGAATCCAGGAGTTTGAGACCAGCCTGGGCAGCATAGTGAGACTTGGCCTCTACAAAAAAAAAAAAAAAAAAAAAAAAAAGTTACCTGGGAAGTCTCAGCTACTTGGAAGGCTGAGGTCGGAAGGTTGCTTGAGTACAGGAGGTCAAGGCTGCAGTGAGCTATGATTGTACCACTGCACTCCAGCGTGGGCAACAGAGTGAGACCTTATCTCAAAAA"
"chr1","19684151","19684424","chr1","88859712","88859991","79","69175561","GCTGGGCACAGTGCCTCAGGCCTGTAATCCCAGCACTTTGGGAGGCTGAGACAGCAGGATTTCTTGAGGCCAAGAGTTCAAGACCTGGGCAACATAGGAGACCCCATCTCTACAACATTTAAAAATTAGCCAGTCATGGTAGCATGCACGTGTAATCCCAGCTACTCAGGAGGCTGAGGTGGGAGAATCACTAGAGCCCAAGAGGTCAAGGCTGCAGTGAGCTATGGTTGTACCACTGCACTCCAGCCTGGACGAGAGAGAGAGAACCCATCTC","CCAGGCACAGTGGCTCACACCTGTAATCCCAGCACTTTGGGAGGCCAAGGCAGGAGGATTGCTTGAATCCAGGAGTTTGAGACCAGCCTGGGCAGCATAGTGAGACTTGGCCTCTACAAAAAAAAAAAAAAAAAAAAAAAAAAGTTACCTGGGAAGTCTCAGCTACTTGGAAGGCTGAGGTCGGAAGGTTGCTTGAGTACAGGAGGTCAAGGCTGCAGTGAGCTATGATTGTACCACTGCACTCCAGCGTGGGCAACAGAGTGAGACCTTATCTCAAAAA"
"chr1","19714961","19715239","chr1","164929853","164930117","79","145214892","GGCCAGGTGCAGTGGCTCATGCATGTAACCCCAGCACTTTTGGAGGCCGAGGTGGCAGGATCACTTGAGCCAGGAGCATGAGACCAGCCTGGGCAATGTAGGAAGTCCCCACCTCTACAAAAAGAATTTGAAAATTAGCCAGGCACACCTACAGTTCCAGCTACTTGGGGGTGCTGAGGTGGGATCACTTCAGCCCGGAGGGGGTCGAGGCTGCGGAGGGTGGTGTTCGTGTCACTGTACTCCATCCTGGGTGACAGAATGAGACTGTCTCAAAACAAA","GGCCAGGTGTAGTGGCTCACACCTGTAATCCCAGCACTTTGGGAGGCTGTGGCGTCAGGATCACTTAGAGTCAGGAGTTTGAGACCAGTCTGCACAACATAGCCAGACCCATCTCTACAAAAAAAAAAAAAAAAAAAAAAAAAATCCTAGCTACTTGGGAGGCCGAGATGAGAGGATCACTTGAGTCCAGGAGTTCAAGGCTGCAGTGAGCTATGATCCTGCCACTGCACTCCGGCCTAGGTGACAGAGTGAGACCAAAAAAAAA"
"chr1","19715240","19715442","chr14","51003183","51003398","69","31287943","GAAAACCAGTCTCTAAAAACAATTGTTTTTAATTAGCCATGACTGGTAACCTGTGCCTGTAATCCCAGCAACTTGGGAGGCTGAGGTGGAAGGATCACTTGAGCCCAGGAGTTCAAGGCTGCAGTGAGCTATGATTGTGCCACTGTACTACAGCCTGGGTTATATACAGTGAGACCCTGTCTCTAACATGAATAAATAAATAA","AGCCTGGGCAAGATAGTGAGACCTCATCTCTTAAAATAAATAAATAAATAAATAAATAGCAGGATGTGGTGGCGTGCATCTGTAGTCCCAGCTACTCAGGAGGCTGAGATGGGAGGATTACTTGAGCTCAGGAGGTCGAGGCTGCAGTGAGCTATGATCACGCCACTGTACTCCAGCCTGGGTGAGAGTGATACCCTGTCTCTAACAAAAAAAAAA"
"chr1","19718398","19718679","chr6","20439531","20439829","79","721133","ATCCCAGCACTTTGGGAGGTCGAGGTGGGAGGATCGCTTGAGGCCAGGAGTTTGAGACTAGCCTGCACAACATAGCAAGGCCCTGTTTCTACAAAAAATTAAAAAATTAGCCAGGTGTGGTGGCATGCGCCTGTATTCCCAGCTATTTGGGAGGCTGCAGTGGGAGGCATTTGAGCCCAGGAGTCTGAGACTGCAGTGAGCTATGATGGTGCCACTGCACTCCAGCCTGGGTAACAGAATGAGACCGTCTCTCAAAAAAAAAAAAAAAAGAGAGAGAGAAAA","CCGTAATTCCAGTACTTTTGGGGGCTGACGGGGGAGGATTGCTTAAGGACAGGAGTTTGAGGCCAGCCTGGGCAACATTACAAGACCCCATCTCCACAAAAAAAAAAAAAAAAAAAAAAAAATTAGCCAGGCTTGGTGGTGCACGCCTACTAGTCCCACCTACTCAGGAGACTGAGACGGGAAGGACCACTGGAGCCCAGGAGTCTGAGGCTGCAGTGAGCCATGATGGTGCCACTGTACTCAAGCCTGGGCAACAGAGTGAGATCCTGTCTCTAAACAAAAACAAAAACAAAACAAAA"
"chr1","19720171","19720301","chr19","6391716","6391877","59","13328455","GCCAGGTGTGGTGGCTCACACATGTAATCCCGGCACTTTGGAAGGCCGAGGCGGGAGGACTCCTTGAGGTCAGAAGTTTGAGACCACCATGGCCAGCATAGCAAGATCCCTATCTCTATTAAATAAATAAA","CCAGGCGCAATGGCTCACGCCTGTAATCCCAACACTTTGAGAGGCCGAGGCAAGAGGATTGCTTGAGGCCAGGAGTCCGAGACCAGCCTGGGCAACACAGCGAGGCCTCATTCTCTACAAAAAATAAATATATAAATAAATAAATAAATAAGAAGAAGAAAA"
"chr1","19760418","19760667","chr7","137245286","137245521","82","117484868","GGCTGGTCACAGTGGCTCATGCCTTTAATCCCACCACGTACTTTGGGAGGCAAAGGTGTGTGGATTGCTGGAGATATATATATATTATCAGAGCATGGAAGCACATGCCTGTAGTCCCAACTGCTCAGGAGGCTGAGGTGAGGGCTCACTTGAGCCCAGGAGGTTGAGGCTGCAGTGAGCCAAGATCATACCACTGCACTCCATCCTGGGTGACAGTGAGACCCTGTCTCAAAAAGAAAAGAAAAGAAAA","AGCCTGGGCAATATAGTGAGACTCTGTCTCTACAAAATAAATAAATAAATAAATAAATAAAATTAGCCAGATGTGGTGGTGCATGCCTGTAGTCCCAGCTACTAGTGAGGCTGAGGTGGGAGGATCACTTGAGTTCGGGAAGTCGAGGTTGCAGTGAGATATGATCATGCCACTGCACTCCAGCCTGGATGACAGAGTGAGACCCTGCCTCAAAAAAATTAAAAAAGAAAAGAAAA"
"chr1","19777772","19778063","chr14","31798968","31799292","93","12021196","GCTGGGCATAGTGGCTTGAACCTGTAATCTCAGCTACTTGGGAGGCTGAGATGGGAGGACTGCTTGAGGCCAGCCCAGGCAGCATTGTGAGACTCTGTCTCTAGAAGAATAAAAAGTTAGCCAGGCATGGTGGCATGCATCTGTAGTCCCAGCTACTCAGAAGGCTGGGGTGGGGGAAGACCACTTGGGCCCAGGAGTTTGAGGTTACAGTGAGCTATGTCTGTATCACTGTACTCCAGCCTGGGTGACTGAGACCCCATCTCTAAAAAACAAAAATTAAACAACCAAAAAA","GGCTGGGCACAGTAGCTTACACCTGTAATCCCAGTACTTTGGAAGGCTGAAGTGGGAGGATCCCTTGAGGCCAGGAGTTTGAGACCAGCCTGGGCAACATAGTGAGACCCTGTCTCTACAACAAACAAACAAACAAACAAACAAAACTTAGCCAGTTGTGGTGGCACATCCTATAGTCCCAGCTACTCAGGAGGCTGAGGAGGGAGGATCTCTTGAGCCCAGGAGTTTGAGGCTGCAGTGAGCTATGATCATGACACTGCACTCCAGCCTGGATAACACAGCAAAATCCTGTCTCAAAAAAAAAAAAAAAAAAAAAAAAAAAGAA"
"chr1","19781179","19781477","chrX","46692258","46692555","65","26911079","GGCCAGGTATGGTGGCTCATGCCTCTAATCCCAGCACTTTTGGAAGCCGAGGTAGGAGGACTGATTGAGCCCAGGAGTTCAAGACCAGCCTGGGCAACATAGTGAGACTCCATCTCTACAGAAAAATAAAATAAAATAATTAGCTGGGCATGGTGGCACACGCCTGTAGTTCCAGCTACTTAGGAAGCTAAGGTGAGAGGATTGCTTAAGCCTAGGAGTTTAAGGCTGCAATGAGCTATGATCATTGCACTCCAGCGTGGGCTAGAGAATGAAACCCTGTCTCTTAAAAAAAAAAAAAA","GGCCAGGCATGGTGGCTCATGCCTGTAATCCCAGCACTTTGGGAGGCTGAGGAAAGATGATCACTTGAGCCAGGAGTTTGAGCCCAGTCTGGGTAACATAGTGAGACCTCCATCTCTACAAAAAAAAAAAAAAAAAAAAAAAAAAGCTGGGCATGGTAGCACACATCTGTAGTGTCAGCTACTCAGGAGGCTGAGGTAGGAGGATTGCTTGGGCCCAGGAGATCAAGACTGCAGTGAGCTATGACTGCACCACTGCACTCCAGCCTGGGCAATGGAGTGAGACCCTGTCTCAAAAAAA"
"chr1","19826500","19826781","chr15","14745634","14745927","77","5080866","GCCTGGCGCAGTGGTTCATGTCTATCATCCTAAAACTTTGGGTGGCAGAGGTGGGAGGTGGAGGCCAGCAGTTCGAGACCAGCCCGAGCAACACAGTGAGACTCTGTCTCTACGAAAAAAATAAAAATAAAAAAAACTGGGCACAGAGGTGTACCTGCAGTCCCAGCTACTCAGGAGACTGAGATGGGAGGATCACTTAAGCCCAGAAAGTGGAGGCTGCAGTGAACTATGTTCCACCACTGCACTCCAGCCTGGACAATAGAACAAGATCTTGTCTCAAAA","GGCCAGGTGTGGTGGCTCATGCCTGTAATCCCAACACTTTGGGAGGCGAAGTTGGGAGGATTGCTTGAGGCCAGGAATTCCAGACCACCCTGGGCAACTGAGACCTCATCTCTATTAAAAAAAAAAAAAAAAAAAAAAAAAAAATTAGCAAGATTTGGTATGTGCCTACAGTCCCAGCTATTCAGGAAGCTGAGGTGGGAGGATCACGTGAACCCAGGAGTGTGAGGCTGCGGTGAGCTATGATCACACCACTGCACTCTAGCCTGGGTGACAGAGCGAGACTGTATCCCAAAA"
"chr1","19828646","19828813","chr5","32595015","32595178","61","12766369","GCTGGGCATGGTGACTCACACCTGTAATCTCAACAACTCGGGAGGCTGAGGAGGGTTGCTTGCTTGAGTCCAGGAGTTTAAGACTGCAGTAAGCTATGATTGTGCAACTGCACTCCAACCTGGGTGACAGAGCAAGACCCTGAATCTAAAAAAAAAAAAAAAAGAAAA","GGCCGGGTGTGGTCCCTCATGCCTGTAATCCCAACACTTTGGGAGGCTGAGATAGGAGGACTGCTTGAGGCCAGGAGTTCAAGACCAGCCTGGTCAACATAGTGAGACCCCATCTCTATAAAATAATAATAATAATAATAATAATAATAATAAATAAATAAATA"
"chr1","19835818","19835926","chr15","37343640","37343763","64","17507822","CACCACTTTGAGAGGGCAAAGTGGGAGGACCACTTGAAGCCAGGAATTTGAGACCAGCCCAGGCAACATAGCGAGACCCTATCTACACAAAAATTTTAAAATAAATTTA","AAGATCCCTGGCCAGGATTTCAAGACCAGCCTGGGCAACACAGTGAGACCATACATACATACATACATACATACATACATCATACATACATACATACATACATACATACACAGTCTTACAAAGA"
"chr1","19836226","19836402","chr2A","60286019","60286209","62","40449793","TTTTAGCCAGGTGTGGTGATGTGTACCTGTAATCCTAGACACTCAGGAGATTGGAACTGCTTAAGCCCAGGAGTTTGAGGCTGTAGTGAGCTATGATCATGCCACTGTATTCTAGCCTGTGTGGCAGGGCAAGATCCTGTCTCTAAATGACAAACAAACAAAAAACAAAGAAAAGAA","AAAATTAGCCAGGTGTGATGGCACCTGTAGTCCTAGCTACTTGGGAGGCTAAGGTGGGAAGAGGGCTTGAGCCCAAGATTGTGAGGCTGTGGTGAGTCATGACTGTGCCATTGCCCTCTGGCCTGGGTGACAGAGTGAGAAGCTGTCTCAAATAAATAAATAAATAAATAAATAAATAAAAATAAACAAAA"
"chr1","19843376","19843504","chr5","32595015","32595178","55","12751639","GGCCAAGCATGGTGGTTCATGCCTGTAATCCTAGCACTTTGGGAGGCCAAGGCAGGAGGACTGATTGAGGCCAGGAGATCAAGACCAGCTTGGGCAACATAGTGAGACCCTGTCTCTGTTAAAAATATA","GGCCGGGTGTGGTCCCTCATGCCTGTAATCCCAACACTTTGGGAGGCTGAGATAGGAGGACTGCTTGAGGCCAGGAGTTCAAGACCAGCCTGGTCAACATAGTGAGACCCCATCTCTATAAAATAATAATAATAATAATAATAATAATAATAAATAAATAAATA"
"chr1","19869613","19869923","chr8","25360790","25361095","74","5491177","GGCTGGGGGCGATGACTCACACCTGTAATCCCAGTGCTTTGGGAGGCTGAGGTGGGAGGATGGCTTGAGGCCAGGTGTTTGAGACCAACTTGGGTAACATAGTGAGACCCTGTATCTACAAAAAAATTAAAAAATTAGCCAGGCATGATGGTGTGTGCCTGTAGTCCCAGCTACTTGGGGGGCTGAAGTGGGAGGATTGCTTGAGCCCAGGAATTCAAGGTTATAGTGAGCTATGATCATGCCACTGAACCCAGCCTGGGTAGCAGAATGAGACCTTGTCTCTCTAAAAAACATAAAGAATAAAAAATAAA","GGCTGGGAGCAGTGGCTCATACCTGTAAGCCCAGCACTTTGGGAGGCTGAGGTGGGAGGATTGCTGAAGCCCAGGAGTTTGAGACCAACCTGGGCAATGTAGGGAGACCCCGTCTCTACTAAATAAATAAATAAATAAATAAATAAAGTCGGGCATGGTGGCATGTGCCCTGTAGTCCCAGCTTCTTGGGAGGCTGAGGTGGGAGGATTGCTTGGGCCCAGGAATCAAGGCTGCAGTGAGCTGTGATTGTGCCACTGTACTACAGCCTGGGTGACAGTGCAAGACTGTCTCAAAAGAAAAACAAAA"
"chr1","19876707","19876824","chr15","37343640","37343763","66","17466933","GAGGCGAGAAGATTGCTTGAGTCGAGGTATTGGAGGCTGTAGTGAGCCATAGTTGCCCCACTGCACTCCAGCCTGAGTAACAGAGTGAGAGCCTGTCACTAAAAAAGGAAAAAAAAAA","AAGATCCCTGGCCAGGATTTCAAGACCAGCCTGGGCAACACAGTGAGACCATACATACATACATACATACATACATACATCATACATACATACATACATACATACATACACAGTCTTACAAAGA"
"chr1","19883657","19883780","chr1","217544386","217544536","60","197660729","GGCCGGGGGTGGTAGCTCATGCCTGTAATCTAGGCACTTTGGGAGGCCGAGGCAGGAGGATCGCTTGAAGCCAGGAGTTCGAGACCAGCCTGGGCAACACAGCAAAATCACCGTCTCTACAAAA","GGCTGGGCGTGGTGGCTCATGCCTCTAATCCCAGCACTTTAGGAGGCCAAGGCAGGAGGATAACTTAAGACCAGGCTGGGTGACACAGTGAGACTTTGTCTCTAAAAAAAAAAAAAAAAAAAAAAAAAAAAAAAACCTACAAAAACATATA"
"chr1","19915717","19915995","chr1","88859712","88859991","71","68943995","GACTGGGCAGGGTGGCTTATCCCTGTAATCCCAACAGTTTGGGAGGCTGAGGCAGGAGGATTGCTTGAGGCCAGGAGTTTGAGACCAGCCTGGCAACATAGCGAGACCCGGTCTCTACCAAAAATAAGTAAGTTAGCCAGAATTGATGGCACACACCTGTTGTCCCAGCTACGTGGGAGGCTAAGGTGGGAGGCTTGCTTGAGTCGAGGAGGTTAAGGCTGCAGTGAACTATGATCGTGCCACTGCAGTCCAACCTGGGCAAGAGGGAGACCCTGTCTC","CCAGGCACAGTGGCTCACACCTGTAATCCCAGCACTTTGGGAGGCCAAGGCAGGAGGATTGCTTGAATCCAGGAGTTTGAGACCAGCCTGGGCAGCATAGTGAGACTTGGCCTCTACAAAAAAAAAAAAAAAAAAAAAAAAAAGTTACCTGGGAAGTCTCAGCTACTTGGAAGGCTGAGGTCGGAAGGTTGCTTGAGTACAGGAGGTCAAGGCTGCAGTGAGCTATGATTGTACCACTGCACTCCAGCGTGGGCAACAGAGTGAGACCTTATCTCAAAAA"
"chr1","19972417","19972715","chrX","46692258","46692555","68","26719841","CCAGACATGGTGGCTCATACCTATAATCCCAGCACTTTGGGAGGCTGAGGCAGGAGGGTGGTTTGAGCCTAGGGGTTCAAGACCAACTTAGACAACATGGTGAGACCGCAACTCTACAAAACATTAAAAAAAACATAAAAAATTTAGCTGGGTGTGATGGCACACACCTGTAGTCCCAGCTACTCGGGAGGCTGAGGCGGGAAGATCACTTGAGCCCAGGAGATGGAGGCTGTAGTGAGTGATTGCGCCACTGCGCTCCAGCCTGGATGACAGTGTGAGACCCTGTCTCAAAAAAAAAA","GGCCAGGCATGGTGGCTCATGCCTGTAATCCCAGCACTTTGGGAGGCTGAGGAAAGATGATCACTTGAGCCAGGAGTTTGAGCCCAGTCTGGGTAACATAGTGAGACCTCCATCTCTACAAAAAAAAAAAAAAAAAAAAAAAAAAGCTGGGCATGGTAGCACACATCTGTAGTGTCAGCTACTCAGGAGGCTGAGGTAGGAGGATTGCTTGGGCCCAGGAGATCAAGACTGCAGTGAGCTATGACTGCACCACTGCACTCCAGCCTGGGCAATGGAGTGAGACCCTGTCTCAAAAAAA"
"chr1","19974493","19974627","chr5","32595015","32595178","49","12620522","GGTTGGGTGCAGTGGCTCATGCCTGTAATCTTAACACTTTGGGAGGCCAAGGCAGGAGCACTGCATGAGGCCAGGAGTTTGAGATCTGCCTGGCCAACATAGCGAGACCCCATCTCTATTAAAAAATAATAAAAA","GGCCGGGTGTGGTCCCTCATGCCTGTAATCCCAACACTTTGGGAGGCTGAGATAGGAGGACTGCTTGAGGCCAGGAGTTCAAGACCAGCCTGGTCAACATAGTGAGACCCCATCTCTATAAAATAATAATAATAATAATAATAATAATAATAAATAAATAAATA"
"chr1","20019878","20020008","chr5","32595015","32595178","58","12575137","GGCTAGGTACAGTAGTTCATGCCTGTAATTTCAGCACTTTGAAAGGCTGAGATAGGAGGATTTCTTATGGCCAGGAGTTCAAGATCAGCCTGGGCAACAAAGAGAGACACCATCTCTGCCAAAAATAAAAA","GGCCGGGTGTGGTCCCTCATGCCTGTAATCCCAACACTTTGGGAGGCTGAGATAGGAGGACTGCTTGAGGCCAGGAGTTCAAGACCAGCCTGGTCAACATAGTGAGACCCCATCTCTATAAAATAATAATAATAATAATAATAATAATAATAAATAAATAAATA"
"chr1","20064612","20064743","chr9","47045786","47045941","52","26981174","GGTCAGGCATGGTAACTCACACCTGTAATCCCAGCACTTTGGGAGGCCAAGGTGGGAGGATTGTTTGAGGCCAGGAGTTCGAGGCCAGCCTGGCCAACATAGTAAGACCCTGTATCTACAATAAAAGAAAAA","GCTGGGCGCAGCAGCTCACACCTGTAATCCCAGTGCTTTGGAGGTCCAAGGTAGGAGGATTGCTTAAGACTAGGTGTTCAAGACCAGTCTTGGCAACATAGTGAGAACTCATCTCTACAATAAATAAATAAATAAATAAATAAATGAAAATAAAAA"
"chr1","20066725","20066998","chr17","58869436","58869729","73","38802711","GGCAAGGCATGGTAGCTCATGCCTATAATTCTAGGACTTTGGGAGGCAGAGGCAGGAGGACTGCTTGAGGCCAGGAGTTCCAAAACAGCCAGAGCAACATAGCAAGACCTCATCTCTAAAAAGAAAAAAAAATTAGTCAGCTGTGGTGACATGTGCCTGTAGTCCGAGCTACTTGGGAGGCTTGGGTGGCAGGATCTTTTGAGCTGAGTAGTTCGAGATGGTAGTGAGCCATTATCACACCACTGCATTCCAGCCTGAGTGACAGAGTGAGACC","GGCCAGGTATGGTGACTTATGCCTGTAATCCGAGCACTTTGGAAGGCTGAGGTGGTAGGATTGCTTGAGGCCAGGAGTTCAAGATCAGCCTGAGCAACATAGCAAGACCCTGTCACTAAAAAATAAATAAATAAATAAATAAATAAAAAGATTAGCCGGGCATGGTGACCTGTGCCTGTAGTCCCAGCTACTTGGGAGGCTGAGGTGAGAAGATGGCTTGAGCCCTGGAGGTTGAAATGCAGTGAGCAGTGATAGCACCACTGCACTCCAGCCTGGGTGACAGAGTGAGACCCT"
"chr1","20067299","20067334","chr20","87144","87254","78","19980155","AAGACCCTATCTCTTGGAAAAAAAGAATAACCAAAA","CCTGGGCAACATAGTGAGACTACATCTCTACACTCACGCACACACACACACACACACACACACCCCCCAAATTAGCCAGGCATGCTGATGTGCACCCATAGTCTCAGCAAC"
"chr1","20093730","20093976","chr11","113160190","113160427","72","93066460","GGCCGAGGTGGGAGGATCGCTTGAGGCCAAGAGTTTAAGACCAGCCGGGGCAACATAGCAAAAGCCTCAGCTCTACAGAAAAATAAAATTATCAAGGTGTAGTGGTGCATGCCTGTAGTCCTAGTAACTCTGGAGGCTGAGGTGGGAGGATCATTTGAGCCCAGGGGTTTGAGGCTGTAGTGAGTTATGATCACGCCACTGCACTGCAGCTAGGTGACAAAGTGAGACCCTGTCCCTGAAAAAAAAA","AGGAATTGGAGACCAGCCTGGGCAGCATAGCAAGACTTCATCTCTAAACTAAAAAAAAAAAAAAAAAAAAAAAAAAAAATTAGCCAGTCATGGTGTTACATGCCTATAGTCTCAGCTACTTGGGAGGCTGAGATGGGAGGATCATTCGAGCCCAGGAGTTTGAGGCTGCAGTGAGCTATGATCATGCCACTGCACTCTAGCCTAGGTGACATAGTGAGATCCTGTCTCTTAAAAAAAA"
"chr1","20101331","20101620","chr6","32649583","32649885","70","12548252","GTGGTGGCTCACATCTGTAATTCCAGCACTGTGGTAGGCCAAAGCGTGAAGATTGCTTGAGCCCAGGAGTTTGAGACCAGCCTGGGCAACACAGTGAGATTCCGTCTCTACAAAATACTTAAAAATTAGCTGGGTGTGGTGGTCCACACCTGTAATCTCAGCTACTCAGGAAGCTGAGGTGGGAGGATTGCTTGAACCCAGGAGGTTGAGGCTGCAGTGAGCTGTAATCATGCCACTGCACTCCAGCCTGGGTGACAGAGTGAGACCCTGTCTCAAAAACAAAAACGAAA","CTGGGTGTGGTGGTTCATGCCTGAAATCCCAGCACTTTGGGAGGCCAAGGCAAGAGGACTTCTTGAGCCTAGGAGTTCGAGACTGGCCTGGGCAACATAGTGAGACCCTGTCTCTAAAAAAAAAAAAAAAAAAAAAAAAATCAGCTGGATGTGGTGGTGCACACCTGCAGTCCCAGCTACTCAGGAGGCTGAGGTGGGAGGATTGCTTGAGCGCAGGAGTTTGATGCTGCAGTGAGCCACAATCATGCCACTGCTCCACTCTGGGTAACAGAGTGAGATTTTGTCTCAAAAAAAGGGAAAAAA"
"chr1","20102340","20102652","chr4","25770742","25771056","68","5668402","GCTGGGCATGGTGGCTCACACCTGCAATCTCAACACTGAGAGACCAAGTGAGGAGAATCACTTAAGGCCAGGAGTTCAAGACCAGCCTGGCCAACATAGTGAGACCTCATCTCTACAGAAAAAAAAAAAAGAAAATTAAAAATGAGCCAGGCACAGTGGTGTGCACCTGTAGTCCCAGCTATTCCGGAGGCTGAGGTGGCAGGATCGCTTGAGCCCAGGAGATCAAGGCTTCAGTGAGACGTGATTGCACCACTGCTCTCTAGCCAAGGCAACAGAGCAAGACCTTGCTGCATATAAAATAAAATGATAAAAA","GGCCAGGCATGGTGGCTCACACCTGTAATTCCAACACTGAGAGCCTGAGGCAGGAGAATCACTTAAGCCCAGGAGTTCAAGAACAGCCTGGACAACATAGGGAGGCCCCGTCTCTACAAAAAAAAAAAAAAAAAAAAAAAAAATTAGCTGGGTGCGATGGCTCACACCTGCAGTCCCAGCTACTTGGGAAGCTGATGTGGGAGGTTCATTTGAGCCCAGGAGGTCTAGTCTACAGTGAGCAGAGTCACACCACTGCACTCCAGCCTGGGCAACAGAGCAAGACCCTGTCTCAAAAAAAAAAAAAAAAAAAAAAAA"
"chr1","20133599","20133835","chr9","65614991","65615226","58","45481392","ACCAGCCTGGGCAACATAGTGAGACCTCATCTCTGCCAAAAAAAAAAAAAGAATGAGCTGGGCATGGGCATGTTTGCACATGCCTGTAGTCCCAGCTATTCAGGAGGCTGAGGTGGGAGGATTGCTTGAACCCAGGAGGTCGAGGCTGCTGTGAGCTGTGATGGTGCCACTGCACTCCAGCCTGGGAAGCAGAGTGAGATTCTATCTCAAAAACAAGACAAAACAAAACAAAACAAA","ACCAGGCTGGGCAACATAGGGAGACCCCATCTCTACCAAAAAAAAAAAAAAAAAAAAAAAAAAATTAGCCTTGCATAGTGGCATGTGGCTATAGTCCTAGCTACTCAGGAGGCTGAGGCAGGAGGATCCCTGGAGCCCATGAGTTCGAAGCTGCAGTGAGCTATGATCCCACTACTGCACTCCAGCCTGGGTAACAGAGTGAGATTCAGTTTCTAAACAAAAAACAAAACAATAAA"
"chr1","20138167","20138292","chr9","47045786","47045941","59","26907619","GCGTGATCACTCACACCTGCAATCCCAGCACTGTGGGAGGCCAAGACGGAAGGATTGCATGAGGCCAGGAATTTGAGACCGGCCTGGGAAACATAGTGAGACCCCATGTCTACAAACAATAGCAAA","GCTGGGCGCAGCAGCTCACACCTGTAATCCCAGTGCTTTGGAGGTCCAAGGTAGGAGGATTGCTTAAGACTAGGTGTTCAAGACCAGTCTTGGCAACATAGTGAGAACTCATCTCTACAATAAATAAATAAATAAATAAATAAATGAAAATAAAAA"
"chr1","20173027","20173345","chr3","99347730","99348048","76","79174703","GGCCAGGTGTGGTGGCTCATGCCTGCAATCCCAGCACTTTGTGAGGATAAGGCAGGAGGATCGCTTCAGTCCAGGAGTTTGAGACCAGCCTGGGCAACATAGGGAGACCGCCTATGTTTTTTAAGTTTAAAAAAAAAAAAAAAGCCAGGCATGGTGGCACCAGCCTGTGGTCCCAGCTACTCAGGAGGCTGAAGTGGGTGGATTGCTTGAGCTCAGGTGACGGAGGCTGCAGTGAGCTCTGATTGAGCCTCTCCACCCCAGCCTGGATAATAGAGCAAGACCCCGTCTCCCAAAAAATAAATAAAATAAAAAATAATAA","GGCTGAGCATGGTGGCTCATACTTCATCCCAGCACTTTGGGAGGCTGAGGTGGGAGGACTGCTTGAGTCCAAGAATTTGAGACCAGCCTGGGCAACACAATGACACCCCATCTCTCAAAAAAAAAAAAAAAAAAAAAAAAAAAAAGCCAGGCATGGTGGCACACACCTGTGGTCCCAGCTACTTGGGAGTCTGAAGTGGGAGGATCACTTGAGCTCAGGAGATCAAGGCTGCGTGAGCTGTGACTGCATCACCACACTCCAGCCTGGGTAACAAAGTGAGACCCTGTCTCAAAAAAAAAAAAAAGAAAAGAAAAGAAAA"
"chr1","20207977","20208194","chr14","51003183","51003398","57","30795206","AAACCAGCCTGGGCAACACAGTGGGACTCTGTCTCTACAAAAAGATTAAAAAAAATTAACCAGGTGTGATAGCGCACACTGTAGTCCCAGCTACTCAAGAGGCTGAGGCGGAAGGATCGCTTGAGCTTGGGAACTCAAGGCTGCAGTGAACCATGATTGCCTCACTGCACTCCAGCCTAGGTGACAGAGTGAGACCCCGCATCCAAAAGAAAAGAAAA","AGCCTGGGCAAGATAGTGAGACCTCATCTCTTAAAATAAATAAATAAATAAATAAATAGCAGGATGTGGTGGCGTGCATCTGTAGTCCCAGCTACTCAGGAGGCTGAGATGGGAGGATTACTTGAGCTCAGGAGGTCGAGGCTGCAGTGAGCTATGATCACGCCACTGTACTCCAGCCTGGGTGAGAGTGATACCCTGTCTCTAACAAAAAAAAAA"
"chr1","20208805","20208919","chr18","55799233","55799394","63","35590428","GGCCAGGGGTGGCTCACGCCTGTTATCCCAGCACTTTGGGAGGCCTAGGCGGGAGGATTGCTCTAGGCCAGGAGTTCAAGACCAGCCTGGGCAACATAGCAAGACCTCATCTCTA","GGCTGAGAGAGGTGGCTCATGCTTGTAATCCCAGCACATTGGGAGGCAAAGGTGGGAAGATTGCTTGAGGCCAGGAGTTCAAGACCAGCCTGGGCAACATGAAAACACTTTGTCTCTACAATAAATAAATAAATAAATAAATAAATAAAAGAAACAAGAAAA"
"chr1","20216943","20217258","chr14","31798968","31799292","66","11582025","GACTGGGAACAGTGGCTCACACCTGTGATCTGAGCACTTTGGGAGGCTGAGGAGAGGATGGCTTGAGCCCAGGAGTTTGAGACCAGCCTGGGCAACATAGCAAGACTCCATCTCCACAAATAAAATAAAATAGTAAGAATATTGGCCAGGCATGGTGGCACACACCTGTAGTCCCACCTACTCAGGAGGCTGAGGTGGGAGGGGATTACTTGAGCCCAGGAGTTTGGGGCTGCAGGGAGCTGTGATCATGCCACTGCACTACAGCTTGCATGGCAGAGCCAGACCTTGCCTCAAAAAAAAAAAAAAAAAAAAAGAA","GGCTGGGCACAGTAGCTTACACCTGTAATCCCAGTACTTTGGAAGGCTGAAGTGGGAGGATCCCTTGAGGCCAGGAGTTTGAGACCAGCCTGGGCAACATAGTGAGACCCTGTCTCTACAACAAACAAACAAACAAACAAACAAAACTTAGCCAGTTGTGGTGGCACATCCTATAGTCCCAGCTACTCAGGAGGCTGAGGAGGGAGGATCTCTTGAGCCCAGGAGTTTGAGGCTGCAGTGAGCTATGATCATGACACTGCACTCCAGCCTGGATAACACAGCAAAATCCTGTCTCAAAAAAAAAAAAAAAAAAAAAAAAAAAGAA"
"chr1","20217354","20217630","chr19","13342110","13342403","74","6875244","TGCAGTCCCAGCACTTTTGGAGGCTAAGGTGGGAGGATCACTTGAGGCCAGGAGTTCAAGACAAGCCTGGATAACATAGTGAGACTCCATCTCTACAAAAAAGTAAAACAAATTAGCTGGGCATGTTTGTGTGTGCCTGCAGTCCCAGCTACTTGGGAGGCTGAGGTGGGAGGATAACTTGAGCCCAGGAGTTTGAGGTTGTGATGAGATGTGAACACACCACTGCACTCCAGCCTGGGCAACAAAGCAAGGTGCCATTTCTAAAACAAAAAACAAA","TCATGCCTGTAATCCCAGCACTTTGGGAAGCCAGGGCAGGAGGATCACTTGAGACCAGGAGTTTGAGACCAGCCTGGGCAACATAGCCAGACCCCCATCTCAACAACAACATCAACAACAACAACAACAAATTAGCTGGGTGTGGTGGTGCCTGTAGTCCCAGCTACTTGGGAGGCTAAGCTGGGAGGATCGCTTGAGCCCAGGAGCTCCAGGCTGCAGAGAGCTATGATCATATCACTGCACTCCAGCCTGAGTGACAGAGCAAGAACCTGCCTCTAAAAACAATAAACAAAA"
"chr1","20335026","20335330","chr6","157423301","157423612","73","137088275","GGCCAGGCCATGGTGGCTCACACCTGTAATCCCAGCACTTTGGGAGGCCAAGGTAGGTGCCTGGCTTGAGGCCAGGAGTTCAAGACCAGCCTGGGCAACCTAGTGAGACCACTTCTCTACAAAATATAAAAATTAAAAAATTAGCCAGACGTGGTGGCATATGCTTGTAGTCCCAACTACTCTGGAAGCTGAGGCGGGAGGATTGCTCAAGCCCAGGAGTTGGAGGCTGCAGTGAACTGATGATGCCACTGCACTCCAGCCTACGTGCAGTGTGGAGACCCTATCTCTAAACAAACAAACAGAAA","GGCTGGGCGTGGTGGCTCACACCTGTAATCCTAGCACTTTAGGAGGCCTAGGTGGGAGGACTGCTTGAGCCCAGGAGTTTGAGACCAGCCTGGGCAACACAGTGAGACCTCATCTCTACTAAAAAAAAAAAAAAAAAAAAAAAAAATCAGCCAGGTATGGTGCCATATCCCTGTAGTCTCAGCTACTTGGGAGGCTGAGGTGGGAGGATCACTTAAGCCTGGGAGATGGAGACTACAGTGACCCATGATAGCACCACTGCACTCCAGCCTGGGCAAGAGAGCGAGACTTGGTCTCAAAATGAAACAAAGAAA"
"chr1","20351239","20351371","chr19","6391716","6391877","48","13959523","CCAGGTATAGTAGCTCACACGTGTAATCCCAGCACTTTGGGAGGCCGAGGCAGGAGGATCACTTGAGGCCAGGAGTTCGAGACCAGCCTGCGCAACACAGTAAGACCCTGTCTCTACAAAAAATTTAAAAATA","CCAGGCGCAATGGCTCACGCCTGTAATCCCAACACTTTGAGAGGCCGAGGCAAGAGGATTGCTTGAGGCCAGGAGTCCGAGACCAGCCTGGGCAACACAGCGAGGCCTCATTCTCTACAAAAAATAAATATATAAATAAATAAATAAATAAGAAGAAGAAAA"
"chr1","20351674","20351823","chr5","32595015","32595178","73","12243341","TTAGCCAGACATGGGTGTGTGCCTGTAGTCCAGGAGACTGAGGTGGGAGGATCGCTTGAGCCCAGGAGGTTGAGGCTGCAGTAAGCTACGATTGTGTCCCTCCAGCCTAGGTGACAGAGTGAGATCCTGTCTCAGAAACAAAACAAAAGA","GGCCGGGTGTGGTCCCTCATGCCTGTAATCCCAACACTTTGGGAGGCTGAGATAGGAGGACTGCTTGAGGCCAGGAGTTCAAGACCAGCCTGGTCAACATAGTGAGACCCCATCTCTATAAAATAATAATAATAATAATAATAATAATAATAAATAAATAAATA"
"chr1","20474006","20474319","chr13","29223313","29223640","78","8749307","GCTGGGCGTGGTGGCTCACACCTGTGCTCAGCACTTGTGAGAGGTCATGCCAAGAGGACTGATTGAGTCCAGGAGTTGGAGACCAGGCTGGGCAACATAGTGAGACCCCCATCTCTACATAAAAATTTTAAAAATTAACTAGGTGTGGTGGTGTGCACCTGTAGTCCCAGCTACCTGGGAGGCTGAAGTGGAAGGATGGCTTGAGCCTAGGAAGTTGAGGCTGCAGTGAACTGTGATCACGCCAGTACACTCCAGCCTGGACAACACAGCGAGACTGTGTCTCTCAAAACAAAAAATAAAAACAAACAAAAAAA","GACTGGGCGCAGTGACTCACACCTGTCACCCAGCACTTTGAGAGGCCAAGGCAGGAGGACTGCTTGGGCCCAGGAGTTCCAGACTAGCCTGGGCAACATAGCAAGGCTCCATCTCTACAATCAATCAATCAATCAATCAATCAATCAAACTAGCTGGGTGTGGTGGCACACACCTGTGGTCCCAGCTACTCGGGAGGCGGAGGTGGGAGGATGGCTTGAGCCAGGGAGTTTGAGGCTGCAGTGAGCCATGATCACACCACTACACTCCAGCCTGGGTGACGGAGCAAGACCCCGTCTCAACAAAAATTAAATGAAAAAAAAAAAAAAA"
"chr1","20489158","20489450","chr14","85602060","85602365","75","65112902","GGTTGGGCGTGGTGGCTCACACCTATAATCCCAGTACTTTGGGAGGCTGAGGCAGTCGGATTGCTTGAGTGTAGGAGTTGTAGACCAGCCTGGGCAATATAGTGAGACCCTCATCTCTACAAAAAATTTAAAAAGGAATCGGGCATGGTGGGGCACACTTGTGATCCCAGCTACTCGGGAGGCTGATCAGGGAGGATTGTTTGAGCCAGGGAAATTGAAGCTGCAGTGAGCCATGATTGCACCACTGCATTCCAGCATGGACAACAGAGCGAGACGCCATCTCAAAAAAAAAA","GGCCGGGTGCAGTGGCTCACACTTGTAATACCAGCACTTTGGGAAGCTGAGGTGGGAGGATCACTTGGGACTAGGAGTTGGAGACCAGCCTGGGCATCATAGTGAGGCCACCCTGTCTCTACAAAAAAAAAAAAAAAAAAAAAAAAAATTCCTGGGCATGGTGGTATGTGTGCTGGTCCCAGCTACTTGTGAGGCTGAGGTGGGAGGATAGTTTGAGCCTAGGAAGTTGAGGGTGCAGTGAACCATAATTGCACCACTGCATTCCGGCTTGGGTAACAGAGTGAGACCCTATTTTAAAAAAAAAAA"
"chr1","20495726","20496030","chr1","213591659","213591963","82","193095933","GCAGTAGCTCCCGCCTGTAATCCCAGCACTTTGGGAGGCCAAGGCAGGAGGATCACTTGAGGCTAGGAAGTAGAATTTGAGATGAGCCTGGACAACATAGCAGGACACTTTCTCTACAAAAAATAAAAACAAAGCTGACCATGGTGGTACACACCTGTAGTCCCAGCCACTCAGGAGACTGAGGTAGGAGGATGGCTTGAGCCCAGGAGATTGAGGTTGCAGTGAGCTGTAATCATGCCACAGCACTCCAGCCTGGGCAACAGAGTGAGACCCTAACTCCAAAAAACAAATAAAAACAAATAGAA","GTGCAATGGCTGATGTCTGTAATCCCAGCACAGTGGGAGGCCAAGGCAGGAGGATTGCTTGAGGCCAGGGATTCAAGACCAGCCTGGGCAACCTAGTGAAACCTCATCTCTATTAAAAATAAAAATAAAAATAAAAATTAGTTGGGCATGGTGGCACACACCTGTGGTCCCAGGAGTCCTCAGGAGGCTGAGGTAGGGGGATCACTTGAGCCCAAGAGTTGAGGTTGCAGTGAGCTATGATTGCACCACTGCACTCCAGCATGGGCAACAGAGTGAGACTTTGTCTCAAAACAAAACAAACAAAA"
"chr1","20502267","20502548","chr8","15910614","15910909","79","4591653","GGTCTGGCACAGTAGGTCACACCTATAATCCCAACACTTTGGGAAGCCAAGTCAGAAGGATCACTTGGGGCCACGAGTTTGAGACCAGCCTGGTTAACACAGTGAGATTCCATCTTTACAAAAAATTAAAAAGTTAGCAGGGTGTGGTGGCATGTGCCTGTAGTCCCAGATACTTGGGAGGCTGAGGCAGGAGAATCACTTGAGCTCAGGAGTTTGAGGCTGCAGTGAGCTATGATCACACCACCATACTACAGCTACCTGGGTGACAGAGCCAAGACTCTA","GGCCAGGCGAAGTGGCTCACACCTGTAATCCCAGCACTTTGGGAGGCCAAGGCAGGAGGATCATTTGAAGCCAGGAGTTCAAGGCCAGCCAGAGAAACATAGTGAGAACCTGTCTTTACAAAAATTAAAATTAAAATTAAAATTAGCCAGGAGTGGTGGTGCATGCCTGCAGTCCCAGCAGCTCAGGAGGCTGAGGTGGGATGATTGCTTGCACCAGGAGTTCGAGGCTGCAGTGAGCTGTGATCGTGCCACTGCACTCCAGCCCCTGGGTGACAAAGCAAGATCCTCTAAAAAAA"
"chr1","20502834","20502844","chr20","87144","87254","100","20415690","TCAAAAAAAAA","CCTGGGCAACATAGTGAGACTACATCTCTACACTCACGCACACACACACACACACACACACACCCCCCAAATTAGCCAGGCATGCTGATGTGCACCCATAGTCTCAGCAAC"
"chr1","20505303","20505609","chr16","9702460","9702783","82","10802843","GGACAGGCATGGTAGCTCACACCTGTAATCCCAGCACTTTGGGAGTCCAAAGTGGGATAGCTGCTTGAGGCCAGCAGTGCAAAACTAGCATGAGCAACATGCAAGACCCCATCTCTATGAAAAATAAAAAATTAGCTGGAGGTGGTGGTGTGCACCTGTAGTCCTAGCTACTTAGGAGGCTGAGGCAGGAGACTGGCATGGGCCTGGGAGCTCGAGGCTGCAATGAGCTATGTTTGTGCCACTGCACTCCAGCCTGGGCAACAGAGTAAGACCATGTCTCAAAAAAAAAAAAAAAAAAAAAAAAGAA","CCGGGCATGATGGCTCATGCCAGTAATCCTAGCACTTTGGGAAGCTGAGGTGGAAGGATCGCTTGAGGCCAGGAGTTCGAAACCAGCCCAGTCAACATAGTGAAACCCCATCTCTACAAAAGAAAAATTAAAAAATTAGCTGGAATGGTGGCACATGCCTGTAGTCCTAGCTACTTGGGAGGCTGAGGCAGGAGAACTGTTTGAGCTCAGAAGTTCAAGGCTGCAGTGAGCCATGACTGTGCCACTGCACTCTAGCCTGGGTGACAGAGTGAGACCCTGTCTCAATAAATAAATAAATAAATAAATAAATAAGAAAACTAAAAA"
"chr1","20509052","20509340","chr1","49763974","49764279","75","29254922","GGCTTGGTGTGGTGACTCACGCCTGTAATCCCAGCACTTTGGGAAGGCAAGTCAGGAGGATCACTTGAGCCCAGGAGTTCCAGACCAGCATGGCCAACATAGTGAGACCTTGACTCTACAAAAAATTTTTTAAAAAATTAGCCGGGGGTGGCATGCATCTTTAGTCCTAACTACTGGGGAGGCTGAGGTGGGAGGATTGCGGGGTGGGAGGCTGCAGGGAGCTATGATTGCACCACTGCACTCCAGCCTGGGCGACAGAGCAAGACCCTGTCTCAAACAAATAAAAAAA","GGCTAGGCCTGGTAGCTCAAGTCTGTAATCCCAGCACTTTGGGAAGTCAGGGCAGGAGGATCCCTTGAGTCCAGGAGTTCAAGACCAGCCTGGGCAACAAAGTGAGACCCTATCTGTATAATAAAATAAAATAAAATAAAATAAATTAGCCAGGTGTGGTGGTGTGTGTCTGTGGTCCAAGGTACTTGGGAGGCTGAGGTGGGAGAATGGCTTGAGCCCAAGAGTTTGAGGCTGCAGTAAGCCGGGTTTGCTACTGTACTCTAGTCTGGGCAACAGAGCCAGACTCTGTCTCAAAAAACAAAAAAA"
"chr1","20565122","20565244","chrX","45395975","45396094","65","24830853","GGGAGGCTGAGGTGGGAGGATCACCTGAGCTCAGGAGGTCAAGGCTGCAGTGAATTATGATCACGCCACAATACTCCAGTCTGGGTGACAGGGCAAGACCCTGTCTCAAAACGAACAAACAAA","CAGCCTGGCCAACATAGAGAAACCCTGTTTCAACAAAACAAAACAAAACAAAACAAAACACAACACAACCTGGGCAGGGTGGTGCATGCCTGTAGTCCCGAGAACGAGACGGGAGGATTG"
"chr1","20585510","20585788","chrX","3592780","3593062","65","16992730","GGCTGGGTGTGGTGGCTCATGTCTGTAATCCCAGTGCTTTGGGAGGCTGAAGCTGGAGGATCGCTTGAGGCCAGGAGTTTGAGACCAGCGGGTGCAACATACTAAGACCCCATCTCTACGAAAATTTAAAAAAAAATTAGCCAGGTATGGTGGCACATGCCTTTAGTCTCAGCTACTCAGGAGGCTGAGGTGGGAGGGTGGCTTGAACCCAGGAGTTCGAGGCTGCAGTGAACTATGATGTTGCCACTGCATTCCTGGGTGACAGAGCAAGATACTGTC","GTGGTGGCTCATGTCTGTAATCCCAGCACTTCAGGGGGCCAAAGCGAGAGGACTGCTTGAGGCCAGGAGTTTGAGACCAGCCTGCGCAACATAGAAAGACCCCATCTCTATAAATAAATAAATAAATAAATAAATAAGTCAGGCATGGTGGCACATGCCTGTAGTCCCAGCTACTCAGAAGGCTGAGGTCGGAGGATCTCTTGAGCCCAGGGGTTCAAGGCTGCAGTGAACCATGATCACACCAGTGCACTGCAGCCTGGGCAACACAGCAAAACCCTGTCCC"
"chr1","20620899","20621228","chr5","93154458","93154787","82","72533559","GGCTGAGCACAGTGGCTCACACCTATAATCCCAACACTGTGGGAGGCTGAGGTAAGAGGACCTCTTGAGGTCAGGAATTCAAGACTAGCCAAGTAAACAGTGAGATTCTGTCTCTAAAATAAACAAATAATTAAATTAATTAAATAATAAAATAAACTAAATAAATTAAATTAGCTTGGCCTTATGATGCTTGCCCGTGGTCCCAGCTACCCAGGAGGCTGAAGCAGACGGATCTCTTGAGGCCAGGAGTTCAGGGCCACAGTGGGCCATGATTGCATCACTGCACTCCAGCCTGGACAACAGAGTGAGATACTGTCTCTAAAACAACAA","GCCAGACATGGTGGCTCACACCTGTAATCCCAACACTTTGGGAGGCTGAGGCAGGAGGATCGCTTGAGTTCAGGAGTTCGAGACCAGCCTGAGCAACATAGTGAGACCTCGTCTCTACAAAATAAATACATAAATAAATAAATAAATAAATAAATAAATAAATAAATAATTAGCTAGTGTGATCGTGCATGCCTGTAGTCCCAGACACTTAGGAGGCTAAAGTAGAAGAATGGCTTGACCTCAAGGAGATCAAGGCTGCAGTGAGCCATGATCATGCCATTGCACTCTAGCCTGGGTGGCAGAGCAAGAGCCTGTCTCAAAAAATAAAAA"
"chr1","20629561","20629831","chr12","99989922","99990215","83","79360361","GGCCAGGGGCAGTGGCTCATTCCTGTAACCCCAGAGATGTGGTGGGAGTATCACTTAATGCCAGGAGTTCGAGACCAGCCTGGGCAAATAGCAAGACCCCATCTCTACAAAATATTTTTTAAATTAGCTGGACATAGTGGTGTGAGCTGTAGTCCCAACTATTTGGGAAGCTGAGGGAGGAAGGTTGCTTGAGCCCAGGAATTCAAGACTGCAATGACCCATGATCATACCACTGCACTCTAGCCTGGGTGACAGAACAAGACCCTGTCTC","GGCTAGGCATGGTGGCTCATGCCTGTAATCCCAACGCTTTTGGAGGCCAAGGTGGGAGGATCGCTCGAGGCCAGAAGTTCAAGACCAATAGGGGCAATGTATAGAGACCTAGTCTCTACAAAAATAAAATAAAATAAAATAAAATTTAGCCAGATATGGTGGTGTAAAACTGTAGTTCCAGCTACTTGAGAAGCTGAGGTGAAAGGATTGCTTGAGCCCAGGAATTCGAGGCTGCAGTGAGCTGTGATCTCGGCACTGCACTCCAGCCTGGATAACAGAGCGAGACCCTGTCTC"
"chr1","20631450","20631726","chr20","19488215","19488490","77","1143235","CCAGCACGTGGGGAGGCTGAGGTGGGAGGATCGCTTGAGGCCAGGAGTTCAAGACCAGCCTGGGCAACATAGGGAGACCCTGTCACTACAGATAATAATAATTTAAAAGACCCCAGCGAGGCATGGTGGCAAGTGCCTGAGGTCCCAGCTACTTGGGAGTCTGAGGCAGGAGGATTGCTTGAGTCCAGGGGGTTGGGGCTGCAGTGGGCTGTGATTGTGCCACTCCACTCTCCACTCCAGCCTGGGTGACAGAGTGAGACTCTGTCTTAAAATAAAA","TGTGATCCCAGCTCTTTGGGAGGCCGAGGTGGGAGGATCAGTAGAGGCTAGGAGTTCAAGACCAGCCCAGGTGACTTAGGAAGACCTCTTTACAAAAAAAAAAAAAAAAAAAAAAAAAAAGGCTGGGCATGGTGGTGTTTCCCTGTAGTCCCAGCTACTTGGGGGGCTGAGGTGGGAGGATCACTTGAGCCCGGGAGTTTGAGGCTGCAGTGAGCTGTGATCGTGCCATCATACTCCAGCCTGGGTTGACAGAACAAGACCCTGACTCTAAATAAA"
"chr1","20645992","20646325","chr14","59216361","59216698","70","38570369","GGCCCGGCACAGTGGCTGACACCTGTAATCCCAACACTTTGGGAGGCTTGCTTGAGGATTGCTTGAGGCCAGCAGTTTGAGACCAGCCTGGGAAACAGAGTGAGATCCCTTCTCTACAAAAAAAAAATATGTTTTAAATTAGCCGGAAAAAAAGTTAGCCAGGCATGGTGGCATGCACCTGTAGCCCCAGCTACTTGGGAGGCTGAGGTCGGAGGATCACTTGAGCCTAGGAGTTAAGAGTCTGCAATGAGCTATGAATGTGCCACTGTACTCCAGCCTGGGCAGCAGAGTGAGATCCTATCTCAAAAAAATAATAAAAAATAATAAAGTAAAA","GGCTGGACACAGTGGCTCACACCTGTAATCCCTACACTTTGGGAGGCCCAGATGGGAGGATCACTTGAGCCCAGGAGTTTGAGACCAGCCTGGGCAACATAGCAAGACCCTGTCTCTACAAAAAAATTAATAATAATAATAATAATAATAATAAATTAGCCAGGCGTGGTGGCATACACCTGTAGTCCCAGCTACTCAGGAGGCTGAGGTGGGAGGATTGCTTGAGCCTGGGAGGTCAAGTCTGCAGTGAACTATGATCGTGCCACTGCTCTCCAGCCTGGGCAACAGAGAAAGACCCTATCCCCCAAAAATATTAATTAAATTTAAAAAAAGAAAAA"
"chr1","20655198","20655310","chr20","87144","87254","64","20568054","GGCCGAGTATAGTGGCTCAACCTGTAATCCCAGCGCTTTGGGAAGGCCTAGGCAGGAGGATCGCTTGAGGCCAGGAGTTTGAGAGCAGCCTGGGCAACACAGAACTCCTCTCT","CCTGGGCAACATAGTGAGACTACATCTCTACACTCACGCACACACACACACACACACACACACCCCCCAAATTAGCCAGGCATGCTGATGTGCACCCATAGTCTCAGCAAC"
"chr1","20658844","20659157","chr2B","83001661","83001979","71","62342817","GGCTAGGTATGATAGCTTATCCCTGTAATCCCATCACTTTGGGAGGCCGAGGCAGAAGGATTGCTTGAGTCCAGGAGTTTGAGACTAGCCTGGGCAACATAGTGAGACCTCATCTCTACAAAAAAATGAACAAAATTAGCCGGGCGTGGTGGTGCATGCCTGTAGTCCCAGCTACTGGGGAAGCTGAGGTGGGAGGATTGCTGACCCTCGGTGGTCAAGGCTGCAGTGAGCTGAGATCATGCCAACTGCACTCCAGCCTAAGCGACAGAGCAAGACCCTGTCTCAAAAAAAAAAAAAAAAAGAAAAGAGAAAAA","GGCTGGAGATGGTGGCTCACACCTGTAATCCTAGTACTTTGGGAGTCCGAGGTAGGAGGATCACTTGAGGCCAGAAGTTTAATACCAGCCTGGGCAACATAGTGAGAGCCTATCTCTACAAAAAAAAAAAAAAAAAAAAAAAAAGCCAGGTGTGGTGGTGCATGTTTGTAGCCTCAGTTACTTGGGAGGCTGAGGTGGGAGGATCATTTGAGCCCAGGAGGTTAAGGCTGCAGTGAGCCAGTTATGGCACCACTGTACTCCAGCCTGGGCGACAGGGCAAGACCCTGTCTCACAAACAAAAACAAAACAAGACAAAAAA"
"chr1","20673923","20674227","chr3","180847740","180848052","79","160173817","GCTGGGTGCAGTGGCTCACACCTGTAATCCCAGGACTTTGAGGGGCCGAGGCAGAAAGACTGCTTGAGGCCAGGAACTCCAGACAAGCCTGGGCAACACAGGGAGATCCTGTCTTTACAGTAAATTAAAAAATTAGCTAGGCGTGGTGGCTCACACCTGTAGTCCCAGCTATTTGGGAGGCTGAGGTGGGAAGATTGCTTGAGCCCAGAACGTCGAGGCCACAGTGAGCTGAGAAGGTGCCGCTGCACTCCAGCCTGGGCAACAGAGTGAGACCCTGTCTCTAAAAAAATAACAACAAACAAAAA","GCCGTGGGCCGTGGCTTACACCTGTAATCCCAATGGTTGGCTAACGCAGGAGGATCGTTTGAAGCCAGGAACTCGAGACCAGCCTGGGCAACACAGTGAGACCTCCTCTCTACATAAAATAAAATAAAATAAAATAAAATAGCTGGGTGTGGTGGCACGCGCCTTTGGTCCCAGCTACTCAGGAGGCTGAGGTGGGAGACTCACTTGAGGCCAGGAGGTCGAAGTTGCAGTGAGCCGAGATCACGCCACTGCACTCCAGCCTGGGTGACAGAGCGAGACCCTGACTCCAAAAAAAAAAAAAAAAAAAAAAAAA"
"chr1","20690519","20690690","chr12","4864673","4864880","65","15825846","TTTTTTTTTGCTGATGGTGGCATGCCCATAGTCCCAGCTATTTGGGAGGCTGAGGCAGGAGGATCACTTGAGCCTGGGAGTTCGAGGCTGGAATGAGCCATGATTATGCCATTGCACTCCAGCCTGGGGGACAGAGTGAGACCCTGTCTCAAAAACAAAACAAAACAAAAAA","AATTAGCCAGGTATGGTGGTGTGCACATGCAGTCCCAGCTGTTTGGGAGGCTGAGGCAGGAGGATCACTTGAGCCCAGGAGTTTGAGGCTGCAGTCAGCTATGATCATGCCACTGCACTCCAGCCTGGACAACAGAACAAGACCCTGTCTCAAAAACAAAACAAAACAAAACAAAACAAAACAAGAACAGAAAACAATCAAACAAAAA"
"chr1","20690987","20691018","chr20","87144","87254","81","20603843","TACAAAATTTTTTTAAAAAATTAGCTGATGGT","CCTGGGCAACATAGTGAGACTACATCTCTACACTCACGCACACACACACACACACACACACACCCCCCAAATTAGCCAGGCATGCTGATGTGCACCCATAGTCTCAGCAAC"
"chr1","20691322","20691446","chr5","32595015","32595178","57","11903693","GGCTGGGTGTGGTGGCTTATGCCTGTAATCCCAACACTCTGGGAGGCTGGGGTGGGAGGATCACTTGAGGCCAGGAGTTTAAGACCAAGCTGGGCAACACAGTGAGACCCCTACTCTATAAATTT","GGCCGGGTGTGGTCCCTCATGCCTGTAATCCCAACACTTTGGGAGGCTGAGATAGGAGGACTGCTTGAGGCCAGGAGTTCAAGACCAGCCTGGTCAACATAGTGAGACCCCATCTCTATAAAATAATAATAATAATAATAATAATAATAATAAATAAATAAATA"
"chr1","20693245","20693565","chr10","125157322","125157641","84","104464077","GGCTGGGTGCGGTGGCTCACTCCTGTAATCCCAGCGCTTTGGGAGGCTGAGGTGGTGGATTGCTTGAGGTCAGGAGTTAGAGACCAGCCTGGGCAACATGGCGAGACCCCCATCTTTACCAAAAATACAAAAAATTAGCCGAGTGTGGTGGTGGGTGCCTGTGGTCCCAGCTTCTCGGGAGGCTGAGGTGGGAGAATTGCTTGAGCCGGGGTTGGGGTTCGGGTTCACTGGAACTTGAGGTGGCAATGAGCTGAGACTGCGTCACTGCACTCCAGCCTGGGTGACAGAGTGACACCTTGTCTAAAAAAAAAAAAAAAAAGA","GGCTGGGTGCAGTGGCTCATGCCAGCAATCCCAGCCCTTTGGGAGGCTGAGGTGAGCAGATCGCTTGAGCCCAGGAGTTTGAGACCAGGTGAGGCAACATGGCAAGATCCCCTCTCTACCAAACAAACAAACAAACAAACAAAAAACAACTAGCTAGGGATGGTGGTGCGTGCCTGTAGTCCCAGCTACTTGGGAGGCTGAAGTGGGAGGATCGCTTGAGCCCAGGAGTTCAAAGCTGCAGTGAGTCATGATAGCACCACTGCACTCCAGCCTGGGTGACAGAGTGAGACCCTGTCGCAAAAAAAAAAAAAAAAAAAGAA"
"chr1","20697326","20697629","chr16","32352979","32353289","73","11655653","GGCCCGGCACAGTGGCTCACGCCTGTAATCCCAACACTTTGGGAGGTTGAGGTGGGAGGATCTCTTGAGCCCAGGAGTTCAAGACCAGCCTAGGCAACATAGAGACCCTATCTCTACAAAAAAATTTAAAAATTAGCCAGGCGTTATGACATGCACCTGTGGTCCCAGCTACTTGGGAAGCTGAGGTGGGAGGAGCACCTGAGCCAGGGAGTTTGAAGGTGCAGTGAGTTGAGATTGCACCACTGCACTCCAGCCTGGGTGACAACAAGACGCTGTCTCAAAAATAAGTAAGTAAATAAATAAA","GGCTGGACACGGTGGCTGCTGCCTGTAATCCCAGCACTTTGGGAGGCCAAGGCAGGAGAATGGCTTGAGCCCAGGAGTTCAAGACCAGCCCGGGCAACAGAGTGAGACCTTGTCTCTACAAAAATAAAAATAGAAATAAAAATAAAAATTAGCCAAGTGTGGTGGCATGCACCTGTGGTCTCAGCTACTCAGGAGACTGAGGTGGGAGGATCCCTTGAGCCCAGGAGGTCGAGGCTGCAGTGAGCTGTGATCATGCCACTACACTCCAGCCTGGGTGACAGAGCTGTCTCAAAAAAATAATAATTAAAAAA"
"chr1","20705924","20706203","chr1","88859712","88859991","70","68153788","CTGGGCACAGTGGCTCATGCCTGTAATCCCAGCACGTTGGGAGGCCAAGGCAGGATGATCACTTGAGGCCAGCAGTTCGAGACCAGCCTGGGCAACATAGGGACACCGTATCTCTAAAAAGAAAGAAATTAGCCAGGCGTGGTGATGTACGCCTTCAGTCCCAGCTACTCGGGAGACTGAAGCAGGAGGATTGCTTGAGCCTGGGAGTTCGAGGCTGTATTGAGCTAGGATTGCACCACTGCACTCCAGCCTGGGCGACAGAGTGAGACCCTGTCCCAAA","CCAGGCACAGTGGCTCACACCTGTAATCCCAGCACTTTGGGAGGCCAAGGCAGGAGGATTGCTTGAATCCAGGAGTTTGAGACCAGCCTGGGCAGCATAGTGAGACTTGGCCTCTACAAAAAAAAAAAAAAAAAAAAAAAAAAGTTACCTGGGAAGTCTCAGCTACTTGGAAGGCTGAGGTCGGAAGGTTGCTTGAGTACAGGAGGTCAAGGCTGCAGTGAGCTATGATTGTACCACTGCACTCCAGCGTGGGCAACAGAGTGAGACCTTATCTCAAAAA"
"chr1","20706948","20707116","chr18","55799233","55799394","69","35092285","GCTGGGTGTGTAGTGTCGTGTGCCTGTTGTCCCAGCTACTCAGGAGGCTGAGGTGGGAGGGATGCTTGAGCCCAGAAGTTCAAGGCTACAATGAGCTATGATTGCACCACTGCACTCCAGCCTAGGTGGCAGAGTGAGACTCTGCCTCTCAAAAAAGGACAGGAAGGAA","GGCTGAGAGAGGTGGCTCATGCTTGTAATCCCAGCACATTGGGAGGCAAAGGTGGGAAGATTGCTTGAGGCCAGGAGTTCAAGACCAGCCTGGGCAACATGAAAACACTTTGTCTCTACAATAAATAAATAAATAAATAAATAAATAAAAGAAACAAGAAAA"
"chr1","20707493","20707781","chr8","25360790","25361095","70","4653297","GGCTGGGCGCAGTGGCTCATGTCTGTAATCCCAGCAGTTTGGGAGGCTGAGGTGGATTGCTTGAATCCAGGAGTTCGAGACCAGCCTGGGCAACATGGCGAGATCCTGTCGCTACAAAACATAAAAATTAGCTGGGTGTGGTGGTGCATGCCTGTAGTTCCAAGCTACTTGGGAGGCTGAGGTGGGAGGATTGGTTGAGCCTGGGAGACCAAGGTTGCAGTGATCTGAGATTGCACCACTGCACTCCAGCCTGGGCAACAGAGCTGTCTCAAAAAAAAAAACAAACCAA","GGCTGGGAGCAGTGGCTCATACCTGTAAGCCCAGCACTTTGGGAGGCTGAGGTGGGAGGATTGCTGAAGCCCAGGAGTTTGAGACCAACCTGGGCAATGTAGGGAGACCCCGTCTCTACTAAATAAATAAATAAATAAATAAATAAAGTCGGGCATGGTGGCATGTGCCCTGTAGTCCCAGCTTCTTGGGAGGCTGAGGTGGGAGGATTGCTTGGGCCCAGGAATCAAGGCTGCAGTGAGCTGTGATTGTGCCACTGTACTACAGCCTGGGTGACAGTGCAAGACTGTCTCAAAAGAAAAACAAAA"
"chr1","20736546","20736828","chrX","74550972","74551283","83","53814426","CCAGGCACAGTGGCTCATACTTGTAATCTCAACGTTTTGGGAGGCTGAGGTGGGAGGATCACCTGAGGCCAGGAGTTCCAAACCAGCCCGGGCAACACAGCAAGAATCTCCAAAAAAAGAAAAGAAAATTTAGCAATTAGCATTTGGAAGATTTGGAAGGCAGAGGTGGAAGGATTGCTTGAGCCCAGGAGTTTGAGGCTGCAGTGAGCTATGATTGTGCCACTGCACACCAGCCTGGGTGACAGAGCAAGATCCCGTCTCCAAAAATAAAATATAAAAAAAA","GGCCAGGCATGGTGGCTCACACCTGTAATTCCAGCACTTTAGGAAGCTGAGGTGGGAGGATCACTTGAGGCCAGGAGATGGAGATCAGCCTGGACAACAAAGCAAGACCTAATCTCTACAAAAAAAAAAAAAAAAAAAAAAAAAAAGGAGCCACATGTGGTGGCACACAACTCGCACCTACTCAGGAAGCTGAGGTGGGAGGAGCGCTTGAGCCAGGAGTAGGAGACTACAGTGAGCTGTGATTGTGCCATTGCACTCCAGCCTGTGTGACAGAGTGAGACTCTGTCTCAAAAATAAATAAATAAAATAAAA"
"chr1","20740539","20740838","chr3","56709786","56710088","83","35969247","GGCCAGGTATGGCGACTCACGCCTGTAATCCTGGCACTTTGGAAAGCCCAGGTGGGAAGATCACGTGAGGCCACGAGTTCAAGACCAGCCTGGGCAACACAGTGAGGCCCCATCTCTAGAAAAGATAAATTAGCCAGGCATTTATTAGCTTGCCTGTAGTCCTGGCTACTTGGGAGGCTGAGGTGGGGAGAACTGCTTGAGCACACGAGTTCAAAGCTGCAGTGAGCCAAGATCACACCACTGCGCTGCAGCCTTAGTGACACAGCAAACTCCATCTCAAAAAAATAATAAGTAAAAGAA","GGCCAGGCATGATGGCTCATGCATGTAATCTCAGCAATTCGGGAGGCCCAGGCAGGAAAATTGCTTGAGGCCAGGAGTTCGAGACCAGCCTGGACAAAACAGGGAGACACCTGTCCCTGCAAAAATAAAAATAAAAATAAAAATAAACAGCCAGGGGTGGTAGTCCCAGCTACTGTGGAGGCTGAGGTGAGGGGATTGCTTGAGCCCACCAGGAAGTGAAGGCTACAGTGAGCCATAAACGCACCACTGCACTCCAGCCTGGGTGACAGAGCAAGACCCCATCTCAAAAAAAAAAAGAAAAAA"
"chr1","20751447","20751754","chr9","68878569","68878883","84","48127122","GAGCACGGTAGTTCATATCTGTAATCCCAGTACTTTGGGAGGCTAATGGGGGAGGACTGCTTGAGGCCAAGAGTTCAAGACCAACCTCGGCAACATAGTGAGACTCTCTCTCTACTAAAAATAAAAAAACTAGCTATGAATGGCGGCATGCCTGTAGCCTACCTACATGAAAGGGTGAGGGGGGAGGATGGCTTAAGCCCAGGAAGTTGAGGCTATTAGTGAGCTATGATTACATCACTATACTCCAGCCTGAGTGACAGACCAAGACTCTGTCTCTAAAAATAAATAATAAACTAAAAAAAAAAAAA","GGCTGGGCACGGCAGCTCATGTCTGTAATCCCAGCACTTTGGGAGGCCAAGGTGGGAGGATTGCTTGAGTCCAGGAGTTCAAGACCAGCCTGGGCAACATAGTGAAACCCCAGTCTCTACAAATAAATAAATAAATAAATAAATAATTAGCTGGGCATGTTGATGCATGCCTGTAGTCCTAGCTACTCGGGGGGTGAGGTGAGAGGATTGCTTGAGTCCAGAAGGTGGAGGCTGCAGTGAGCTATGATCACACCACTGCACTCCAGCCTGGAAGACAGGGTGAGACGCTGTCTTTAAAAAAAAAAAAAGAAAAGA"
"chr1","20760259","20760554","chr1","207218281","207218584","84","186458022","CTGGACACAGTGGCTCACACCTGTAATCCCAACACCTGGGTGGCCGAAGCAGGAGGATCACTTGAGGCCAGGAGTTAAAGACCAGTCTGGGCAATGTAGGGAGATTCTGTCTCTATTAACAATTTAAAAACTACTAGCTGTGTGTGGTGACACATTCCTGCAGTCCCAGCTACTTTTGAGGCCACAGTGGGAGGATCGTTTGAGCCTAGGAGTTCGAGGTTGCCATGAGCCACGATCTTGCCACTATACTCCAGTCTGGGCAACAGAGCAAGACCCCAGCTTGGAAAAAAAAAAAA","GCCAGGCACAGAGGCTCATGCCTGTAATCCCAACACTTTGGGAGGCCGAGACAGGAGGATCACTTCAGGCTAGGAGTTGAGACCAGTCTGGGCAATATAGTAAGACCCTATCTCTATTAAAAAAAAAAAAAAAAAAAAAAAAAAGCTGGGTATGGTGGCACATGCCTGTGTTCCCAGCTACCTGGGAGACTAAGGTGGGAGGACTGCTTGATCCCAAGAATTTGAGGCTGCAGTAAGCTATGACTGCACCACTGCACTCCAGCATGGGCGACAGAGCGAGACCTTGTCTCAAGAAAACAAAAAA"
"chr1","20769093","20769275","chr14","51003183","51003398","78","30234090","TTTACAAAAAACTTAAAAATTAGCCAAATGTAGGGGTGCATGCCTCTAGTCCCAACTCATGAGGCTGAGGCAGGAGGATCGCTTGAGTTGAGCTATGAGCTAACATAGCAATGAGCTATGATTGTGCCACTGCACTCCAGCATGGGTGACAGAGTGAGACCCTGTCTCTAAAATAAAACAAAA","AGCCTGGGCAAGATAGTGAGACCTCATCTCTTAAAATAAATAAATAAATAAATAAATAGCAGGATGTGGTGGCGTGCATCTGTAGTCCCAGCTACTCAGGAGGCTGAGATGGGAGGATTACTTGAGCTCAGGAGGTCGAGGCTGCAGTGAGCTATGATCACGCCACTGTACTCCAGCCTGGGTGAGAGTGATACCCTGTCTCTAACAAAAAAAAAA"
"chr1","20769585","20769701","chr8","58489091","58489211","67","37719506","GGCCAGGCACAGTGGCTCATACCTGTACGCTGAGGTGGGAGGGTTGCTTCAGGCCAGGAGTTTGAGACCAGCCTGGGCAACATAGCAAGGTGAGGCCCTGTCTCTACAAAAAAATTA","TTGAGACCAGGAGTTTGAGACCAGCTTGGACAACATAGTGAGACCCTGTCTAAAAGAAAGAAAGAAAGAAAAGAAAGAAAGAAAGATGTAGCCAAGTGTGGTGGTGCACATCTGTGTCTCA"
"chr1","20774222","20774339","chr5","32595015","32595178","64","11820793","GGCTGGGTGCAGTGGCTCATGCCTGTAATCCCAGCAATTTAGGAGGCTGAGGAGGGAGGACAGCTTGAGGCCAGGAGTTCAAGCCCAACCTAGCCAACATAGTGAGACGCCATCTCCA","GGCCGGGTGTGGTCCCTCATGCCTGTAATCCCAACACTTTGGGAGGCTGAGATAGGAGGACTGCTTGAGGCCAGGAGTTCAAGACCAGCCTGGTCAACATAGTGAGACCCCATCTCTATAAAATAATAATAATAATAATAATAATAATAATAAATAAATAAATA"
"chr1","20788537","20788817","chrX","46692258","46692555","85","25903721","GGCCGAGCATGGTGGTTTACGCCTGTAGTCCCTGCACTTTGGGAGGCCGAGGTGGGAGGATTGCATGAGGCTTGGGGCCAGGAGTTCGAGGCCAGCCAGGGCAACATAATTAGACCCCATCTCTAAATAAATAAATAAGCCAGGAATGGTGGCAAAGGCCTTTAGTCCCAGCTACTCGGGAGGCTGAGGCAGGAGGATCGCTGAAGCCGAGGATTTGAGGCAACAGTGAGCTATGATCACCACTGCGCTCCACCCAGAGAGAGCAAGACCCTGTCTCAAAA","GGCCAGGCATGGTGGCTCATGCCTGTAATCCCAGCACTTTGGGAGGCTGAGGAAAGATGATCACTTGAGCCAGGAGTTTGAGCCCAGTCTGGGTAACATAGTGAGACCTCCATCTCTACAAAAAAAAAAAAAAAAAAAAAAAAAAGCTGGGCATGGTAGCACACATCTGTAGTGTCAGCTACTCAGGAGGCTGAGGTAGGAGGATTGCTTGGGCCCAGGAGATCAAGACTGCAGTGAGCTATGACTGCACCACTGCACTCCAGCCTGGGCAATGGAGTGAGACCCTGTCTCAAAAAAA"
"chr1","20802195","20802470","chr19","13342110","13342403","74","7460085","TGTAATCCCAGCTCTTTGGGAGACCAAGGCAGGAGGATTACTTGAAGCTAGGAGTTTGAGACCAGCCTGGGCAATATAGGAAGACCCCCCCATCTCTACAAAAATACTTAAAAATTAGCCAGGCATGGTGATGCACACCTGTAGTCCCAGCTGCTCAGGAAGCTAAGGCAGGAGAATCACTTGAGCCCAGGAGATCAAGGCTGCAGTGAGCTATGATCATGCCACTGCATTTCAGCTTGGGCAGCAGAATGAGACCCTGTCTCTAAAAAATAAAAA","TCATGCCTGTAATCCCAGCACTTTGGGAAGCCAGGGCAGGAGGATCACTTGAGACCAGGAGTTTGAGACCAGCCTGGGCAACATAGCCAGACCCCCATCTCAACAACAACATCAACAACAACAACAACAAATTAGCTGGGTGTGGTGGTGCCTGTAGTCCCAGCTACTTGGGAGGCTAAGCTGGGAGGATCGCTTGAGCCCAGGAGCTCCAGGCTGCAGAGAGCTATGATCATATCACTGCACTCCAGCCTGAGTGACAGAGCAAGAACCTGCCTCTAAAAACAATAAACAAAA"
"chr1","20813283","20813582","chr1","207218281","207218584","11","186404998","GCCAGGCACAGAGGCTCATGCCTGTAATCCCAACACTTTGGGAGGCCGAGACAGGAGGATCACTTGAGGCTAGGAGTTGAGACCAGTCTGGGCAATATAGTAAGACCCTATCTCTTAAAAAAAAAAAAAAAAAAAAAAAAGCTGGGTATGGTGGCACATGCCTGTGTTCCCAGCTACCTGGGAGACTAAGGTGGGAGGACTGCTTGATCCCAAGGGTTTGAGGCTGCAGTAAGCAATGACTGCACCACTGCACTCCAGCATGGGTGACAGAGCGAGACCTTGTCTTGAGAAAACAAAAAA","GCCAGGCACAGAGGCTCATGCCTGTAATCCCAACACTTTGGGAGGCCGAGACAGGAGGATCACTTCAGGCTAGGAGTTGAGACCAGTCTGGGCAATATAGTAAGACCCTATCTCTATTAAAAAAAAAAAAAAAAAAAAAAAAAAGCTGGGTATGGTGGCACATGCCTGTGTTCCCAGCTACCTGGGAGACTAAGGTGGGAGGACTGCTTGATCCCAAGAATTTGAGGCTGCAGTAAGCTATGACTGCACCACTGCACTCCAGCATGGGCGACAGAGCGAGACCTTGTCTCAAGAAAACAAAAAA"
"chr1","20823372","20823674","chrX_NW_019937303v1_random","2630481","2630786","85","18192891","GGTTGGGTGCAGTGGCTCATGCCTATAATCCTAGCACTTTGGGAGGCTGAAGCAAGAGAATCTCTTGAAGCCAGGAGTTGGAGATCAGCCTGAACAACATAGTGAGACCTGTCTCTACTAAAAAAAAATAGCTAGGTGTATTGGTGCACCTGTAGTCGTAAGCTACTCGAGAGACTGAGGCAGAAGGATCACTAGAGCGTGGGAGTTTAAGGCTGCAGTGAGATACGATCACACCACTGCACTCCAACCTGAGAGACAAAGTGAGAGCCTATCAAAAATAAAAAATAAAATAAATAAACAAAA","GCTGGGCGTGGTGGCTCACGTCTCAAATCCCAGCACTTTGGGAGGTCAAGCAGTGAGGATTACTTAAGGCCAGGAGTTTGAGACCAGTCTGGGAAACATAGTGAGAGTCTGTCTCTACAAAACACACACACACACACACACACACACACACCTGTAGTCCCAGGTACTCAGTAGGCTGAGGCAGGAGGATTGCTTGATCCCAGGAGTTCAAGGCTGCAGTGAGCTGAGATTGCACCACTGCACTCCAGCCTGGGCAACAGAGCGAGACTCCATCTCAAAAAAAAAAAAAAAAAGAAAAGAAAAGAA"
"chr1","20836249","20836546","chrX","16155635","16155942","79","4680614","GGCTGGACACAGTGATTCATTCCTGTAATCTCAGCTACCAGGGAGGCTAAGATGGGAGGATGGCTTAAGGCCAGGAGTTCAAGACCAGCCTGGGCAACATAGCAAGACCCCATCTGTAAAAAAAATTAACAAAAAAATTGGCTGTGCATGGTGGCACGTGCCAATAATTACAGCTACTTGGGAGGCTGAGGCAGGAAGATTGCTTGAGCCCGGGAGTTCAAGCTGTAGTGAACTGCGAGAGCATCACTGCACCCCAGCCTGGGCAACAGAGTGAGATCCTATCTTTAAAAATAAAAAA","GGCCAGGCACAGTGGCTCACACCTGTAATCCCGGTACTTTGGGAGGCTGAGGCGGGAGGATCACTTGAGCCCAGGAGTTCAAGACCAGCCTGGGCAACATAACAAGACCCTGTCTCTACCAAAAAAAAAAAAAAAAAAAAAAAAAATAGCCAGGCCTGGTGGCCTGTGTCCATAGTCCCAGCTACTTTGGGAGACTGAGGTGGAAGGATCACTTGAGTCTGGAAATCAAGACTGCTGTGAGCTGTGATCATGCCACTGTACTCCAGCCTGAGCAACAGAGTGAGACCCTGTCTAAAAAAAAAAAAAAA"
"chr1","20842845","20843138","chr6","44061836","44062146","77","23218991","GGCCAGGTATGGTGGCTCACACCTGTAATCCCAGCACTTTTGGAGGCTAAGGCTAGAGGATCACTTGAGCCCAGGAATTTGAGACCAGCCTGGGCAAGATATCCATCTTTACAAAAAAATTTTTTTAAATTAGCCGGGCATGGTGGCATGCCTGTGGTCCCAGCTACTTGGGAGGCTGAGGCGGGAGGATTGCCTGAGCCTGGGAATTTGAAGCAGCAGTGATCTATAATCATGCCACTACACTCTAGCCTGGGTAACTAAGTGAGACCTTCTCTCTTTAAAAAAAAAAAAAAA","GGCCAGGCATGGTAGCTCATGCCTGTAATCTCAGCACTTTGGAGGCTGAGGCATGAGGATCAGTTGAGGCCAGGAGTTTGAGACCAGCCTGGATAACATAGTGAGACCCCATTCAACAACAACAACAACAACAACAACAAATTTAAAATTAGCTGGGCATGGTGGTGCATGCCTGTAGTCTTACGTACTTGGGAGGCTGAGGTGGGAGAATCTCTTGAGCCTAGGAGGTTGAGGCCTCAGTGAGCTGTGATTGTGCCACCACTCCAGCCTGGGTGACAGAGTGAGACCTTGTCTTTAAAAAAAATAAATAA"
"chr1","20863251","20863385","chr5","32595015","32595178","57","11731764","GGCCAGGCATAGTGACTGATACCTGTAATCCTAGCAATTAGGGAGGCCAAGGCAAAAGGACTGCTTGAAGCCAGGAGTTTAAGACCAGCCTAGGCAACTAAGTGAGACCCATCATCTCTACAAAAAGTAAAAAAA","GGCCGGGTGTGGTCCCTCATGCCTGTAATCCCAACACTTTGGGAGGCTGAGATAGGAGGACTGCTTGAGGCCAGGAGTTCAAGACCAGCCTGGTCAACATAGTGAGACCCCATCTCTATAAAATAATAATAATAATAATAATAATAATAATAAATAAATAAATA"
"chr1","20875633","20875903","chr3","127123230","127123510","82","106247597","GTCAGGTGCAATGGCTAACGCCTATAATCCCAGCACTCTGGGAAGGAGGCAGGAAGATTGCTTGAGCCCAGGAGTTTACGACCAGTCTGGGCAACATATTGAGATTCTGTCTCTATAAAAAATTTAAAGATTAACTGGACATGGTGGTGCATGTTTATGGTCCCAGCTACTCAGGAAGCTGAGGTGGGAGGATCATGTGACCTCAGAAGGTTGAGGGTGCAGTAAGCCCAGATCCTGCCACTGCACTCTAGCCTGGGTGACAGAGCAAGAC","GGCCGGGCATGATGGCTCATGACTATAATCCTAGCACTTTGGGAGACCAAGGCAGGAGGAGTGCCTGAGCCCAGGAGCTGGAAACCAGCCTGGGAAAAATAAAAAGACCCTGTCTCTACAAAAATAAAAATAAAAATAAAAATAAGCCTGGTATGTTGGTGTGTGCCTGTTGTCCCAGGTTCTCAGGAGGCAAAGGTGGGAGAATTGACTGAGTCCAGAAGTCGAGGCTGCGACAAGCCATGATCATGCCATGGCACTCCAGCCTGGGTGACAGAGAGGGA"
"chr1","20882243","20882339","chr20","87144","87254","62","20795099","GCTCATGCCTGTAATCCCAACACTTTGGGAGGCCAAGGCAGGAGGACTGCAGGAGGCCAGGAGTTTGGGCAACACTGCCTCTAAAAAATTTTTAGGC","CCTGGGCAACATAGTGAGACTACATCTCTACACTCACGCACACACACACACACACACACACACCCCCCAAATTAGCCAGGCATGCTGATGTGCACCCATAGTCTCAGCAAC"
"chr1","20882650","20882807","chr19","13525969","13526165","75","7356681","TTAACAAATTAGCCAGGTATAGTGGTCCATGCCTATAGTCCCAGCTACTTGGAAGGCTGAGGTGGGAGCCCAGGAGGTTGAAGCTTCAGCGAGCCATCATTGTGCCACTGCACTCCAGCCTGGGCAATAGATTTAAGACCCTCTTTCAAAAAAAAAAA","AAGAAATAAATTAGTTGAGCATGGTGGTGCATGCCTATAGTCCCAGCTACTGGGGAGGCCAAAGTGGGAGGATTGTGTGAGCCCAGGAGTTTGAGGCTGCAATGAGCCAAGATTATGCACACCAGTGTGGGAGACAGTCAAGTCTCAAAAAATAAACAACAACAACAACAACAACAACAAACACATAAAAAGAAAAA"
"chr1","20892935","20893231","chr15","79168075","79168378","76","58275140","GGCCAGGGATGGTGGCTCAGGTCTGTAATGCTAGCACTTTGTGGGGTCAAGGCAGGAGGATCACTTGAGGTCAGGAGTTCAAGGTCAGCCTGACAACAAAGAGAGACCCTGTCTCTACCACAAAAAAAAAAAAAAAAAGAAAAGAAAAAAATAGGCCAGGCATGCTGGCGCATGCTTATAGTCCTAGTCCCAGCTACTCGGGAGACTGAGGTGAGAGAATTACTTGACCCCAGGAGGTCCAGGCTACAGTGAGCCATGATCATGCCACTGCACTCCAGTCTGGGTGACAAAACAAGA","GGCCAGGCATAGTGGCTCACATCTGTAATCCTAAAACTTTGAGAAGCCAAGGCAGGTGGATCGCTTGAGGCCAGGAGTTCGAGACAAGCCTGGGCAACACAGAACGACCCCGTCTCTACAAAAAATTTAAAAAAAATAAATAAATAAATAAATAAATAAATAAGCCAGGTATGGTGGTGCATACTTGTGGTCCCAGCTACCTGGGGAGCTCAGGCGGGAGGATCGCTTGAGCTGAGGAGGTGAAGGCTGCAGTGAGCCGAGATCATGCCACTGCACTCCATCCTGAGTGACAGAGTGAGACCCT"
"chr1","20896175","20896464","chr1","116143795","116144109","77","95247620","GGCCAGGGATGGTGGCTCACACCTATAATCCCAGTACTTTGGGAGGCCAAGAGTTTGAGACCAGCCTGGGCGATGTAGTAAGACCTAATCTCTAGAAAAAAAATTTTAAAAAATTAGCTGGGCATGGTGACATGCAACTGTAGTCCCAGCTATCAGGTGGCTGAGGTGGGAAGATCACTTGAGTCCAGGAGGCTGAGGCTGCAGTGAGCTATGATTGCACCACTGCACTCTAGCCTGGGTAACAGAGTGAGATTCTATCTCAAAAAAAAAAAAAAAAAGAAAAAGAAAAA","GGCCAGGCACCGTAGATCAGGCCTGTAATCCCAGCACTTTGGGAGTCCGAGGCCTATGAGTTTGAGAACAGCCTGGGCAGCATGGCAAAAACTTGTCTCTACAAAATATATATATATATATATATATATATAATTAGCCAGGCATGGTGGTGCATGCCTGTGGTTCCAGCTACTCAGGAGGCTGAGGTGGGAGGATCACCTGAGCCCAAGAAAGTGAGGGCTGCAGTGAGCCATGATCGCACCACTGCACTCCAGCCTGGGCAGCAGAGTGAGACTCTGTCTCAAAAAATAAAAATTGTTTTAAAGAAAAAGAAA"
"chr1","20925555","20925831","chr5","6598042","6598342","85","14327513","GGCTGGCTGCTGTGGCTCACACGTATAATCCCAGCACTTTGCAAGGCTGAGGTGAGAAGATCACTTGAGGCCCAGAGTTCATGATCAGCCTTGGCAACAGAGAGACCCTTTCTCTACAAAAAATTTAAACATTAGCCAGGCTTGGTGGCGCATGCCTGTAGTCGCAGATACTCAGGAATCTGGGACAGAAAGATTGCTTGAGCCCAGGAGTTCGAGGCTGCAGTGAGGTATGATGGTGTCACCACACTCCAACTTGGGCAGCATAGCAAGACCCTGT","GGCTGGATACAGTGACTCACACCTATAATCCCAACATTTTGGGAGGACAAGGCAAGAAGATCACTTGAGGCCGAAGTTTGAGACCAGCCTGAGCAACAGAGTGATACCTGGTCTTTACAAAATAATAATAATAATAATAATAATAACAAGTGTGGTGGCACATGCTTGTAGTCCCAGCTACTCGAGAGGCTGGGACAGGAAGATCGCTTAAGCCCTGGAACTCAAGGCTGCAGTGAGCCATGATCATGCCACTGCACTGCAGCCTGGGCAACACAGCAAGAACCTGTCTCGAAAAATAAAA"
"chr1","20926398","20926695","chr11","95987071","95987386","82","75060673","GGCCAGGCATGGTAGCTCATGCCTGTAACCCCAGCACTTTGGAAGGCCAAGGCAGGAGGACTGCTTGAGGCCAGGAGTTAAAGACCAGCTGGGCAATATGGCGAGACTCTATCTCTACAAAAAGTTAGCTGGGTGTGGTGTCACGCATCTGTGGTTCCAGCTACTCAGGTGGCTGAGGTGGGAAGACTGAGACCAGGAGGTCAACTCTGCAGTGAGCCATGTTTATGCCACTGCACTCTAGTCTGGGTGACAGAGCAAGACCCTGTCTCAGAAAAAAGAAAAGAAAAAAAAAAAAAAA","GACCAGGCACGGTGGCTCATACCTGTAATCCCAGCATTTTGGGAAGCCAAGACAAGAGAATTGCTTGAGCCTAAGGAGTTCAGGACCAGCCATGGCAACACAGTGAGGCCTCGTCTCTCAAAAAAAAAAAAAAAAAAAAAAAAATTAGCTGGGTGTGGTGAAGCACCTGTAGTTCCAGCTACTCAGAAAGCTGAGGTGGGAGGATTGCTTGAGCCCAGCAGGTCGAGACTGCAGTGAGCTGTTATAGCATCACTGCACTCCAGCCTGGGTAACACAGCGAGACCCTATCTCACAAAAAAAAAAAAAAAAAAAAAAA"
"chr1","20927859","20928085","chr14","51003183","51003398","62","30075324","GAGTTCAAGACCAGCCTGGGCAACATATGGAGACCTTTCGTCCCTACAAAAAAATAAAAAATTAGCCAAGCATGGTGGTGTGTGCTTGTAGTCCCAGCTACTCTGGAGACTGAGATGGGAGGATTGCTTGAGCCTTTGAGATTGAGGCCGCACTGAGCCATGTTCACACCACTGCTCTCCAGCCTGGGTGACAGAGTAAGACCCTGTCAAAAAAACAAAACAAAAAA","AGCCTGGGCAAGATAGTGAGACCTCATCTCTTAAAATAAATAAATAAATAAATAAATAGCAGGATGTGGTGGCGTGCATCTGTAGTCCCAGCTACTCAGGAGGCTGAGATGGGAGGATTACTTGAGCTCAGGAGGTCGAGGCTGCAGTGAGCTATGATCACGCCACTGTACTCCAGCCTGGGTGAGAGTGATACCCTGTCTCTAACAAAAAAAAAA"
"chr1","20943017","20943180","chr18","55799233","55799394","62","34856216","GCTGGGCTTGGTGGCACATGCCTGTAATCCCAACTACTCAAAAGGCTGAGGTGGGAGGATCACTTGAGCCCAGGAGTTTGAGGTTGCATTGAGCTACGAATGCATCACTGCACTCCAGCCTGGGCAACTGAACAAGATCCTGTCTCTAAACAAAACAAAAAAAA","GGCTGAGAGAGGTGGCTCATGCTTGTAATCCCAGCACATTGGGAGGCAAAGGTGGGAAGATTGCTTGAGGCCAGGAGTTCAAGACCAGCCTGGGCAACATGAAAACACTTTGTCTCTACAATAAATAAATAAATAAATAAATAAATAAAAGAAACAAGAAAA"
"chr1","20960484","20960780","chr8","25360790","25361095","85","4400306","GGTGCAGTGGCTCATAGCAGAAATCTGGGAGGCTGAGGCAGGATTATCGCTTGAATTCAGGAGTTTGAGACCAGTCTGGGCAACATAACGAGACCTCATCTTTACTGAAAATAAAAAACATTAGCCAGGCATGGTGGCATGTGCATGTAGTCCCAGCTACTCAGAAGGCTGAGGTGGAGGTGGGAGGATTGCTTGAGCCCAGGATGTCAAGGCTGCAGTGAGCTGTGACTGTGTCACAGCACTCCAGCCAGGGCAACAGACAAGACCCTGTCTCAAAAAAATAAATGAAACAGAAAA","GGCTGGGAGCAGTGGCTCATACCTGTAAGCCCAGCACTTTGGGAGGCTGAGGTGGGAGGATTGCTGAAGCCCAGGAGTTTGAGACCAACCTGGGCAATGTAGGGAGACCCCGTCTCTACTAAATAAATAAATAAATAAATAAATAAAGTCGGGCATGGTGGCATGTGCCCTGTAGTCCCAGCTTCTTGGGAGGCTGAGGTGGGAGGATTGCTTGGGCCCAGGAATCAAGGCTGCAGTGAGCTGTGATTGTGCCACTGTACTACAGCCTGGGTGACAGTGCAAGACTGTCTCAAAAGAAAAACAAAA"
"chr1","21002982","21003271","chr3","9052682","9052970","71","11950300","CTTTGGGAAGCCAAGGCAGGAGTATTGCTTGAGGCCTGGAGTTTGAGCCCAGCCTGGGCAACAAAGTGAGACCCTGTCTCTGAAAAAAAAAAAAAAAAAAGAAAAAAATTAGTCCGGCACAGTGCTGCGTGCCGGTAGTCCCAGCTACTCCAGAGGCTGAGGTGGGAGGATCCACTTAAAACCATGAGTTTGAGGCTGCAGTGAGCCGTGATTGTGCCACTGCACTCTAGCCCGGGTGACAGAGCAAGACCCCAGTTCATTAATTTAAAAAAAAAAAAAAAGAAAGAAAA","ACTTTGGGAGGCTGAGTCGGGAGGATTACTTGACACCAGGAGTTCAAGACCACCTGGGTAACATAGTGAAAACTTCTCTTAACAAAAAAAAAAAAAAAAAAAAAAAAAAAATTAGCCAGCCATAGTGGTGCATGCCTGTGGTCTCAGCTACTCAGGAGGCTGAGACAGGAGGATCACTTGAGCCCAGAACTTCAAGGCTGCAGTAAGCCCTGATTATGCCACTGCACTCCAGCATGGGCAACAGAGCAAGACCTTGTCTCAAAAAAAAAAAAGAAAAAACAGGAGAAAA"
"chr1","21015495","21015601","chr20","87144","87254","60","20928351","GGCTAGGTACAGTGGCTCATGCTTGTAATTGCACCACTTTGGAGGGATCAAGACAGGAGTTCAAGAACAGCCTGGGGAACACAGCAAGAACCTGTCTATACAAAAAA","CCTGGGCAACATAGTGAGACTACATCTCTACACTCACGCACACACACACACACACACACACACCCCCCAAATTAGCCAGGCATGCTGATGTGCACCCATAGTCTCAGCAAC"
"chr1","21017944","21018245","chr8","25360790","25361095","78","4342846","GACTGGGCACATTGGCCCATACCTGTAATCCCAGTATTTAGGGATGTCAGTACAGGGGCATTGATTGAGCCCAGGAATTTGAGACCAGCCTGGGTGACATAGCAAGAATGTGTCTCTATAAAAGATTTTTTTTTTTTTTAATTACTGGGCATGGTGGCACATGCCTGTAGTCACAACTACTTGGGAGGCAGAGGTGGGAGGATCGCTTGAGCCTGGGAGATCAAGGCTGTGGTGAGCTATGGTTATGCCACTGCACTCCAGCCTGGGTAACAGAGTGAGACCTTGTCTCAAGGAAAAAAAAA","GGCTGGGAGCAGTGGCTCATACCTGTAAGCCCAGCACTTTGGGAGGCTGAGGTGGGAGGATTGCTGAAGCCCAGGAGTTTGAGACCAACCTGGGCAATGTAGGGAGACCCCGTCTCTACTAAATAAATAAATAAATAAATAAATAAAGTCGGGCATGGTGGCATGTGCCCTGTAGTCCCAGCTTCTTGGGAGGCTGAGGTGGGAGGATTGCTTGGGCCCAGGAATCAAGGCTGCAGTGAGCTGTGATTGTGCCACTGTACTACAGCCTGGGTGACAGTGCAAGACTGTCTCAAAAGAAAAACAAAA"
"chr1","21020207","21020491","chr1","47533839","47534134","70","26513632","GGCCAGGCACAGTGATCATATCTGTAATCTTAGCACTTTGGGAGGCGGAGGTGAGAAGATTGCTTGAGCTTAAAAGTTCAAGACCAGCCTGGGTAACACAGCAAGACTCCGTCTCTACAAAAAAAATTTAAAAATTACCCAGGCATGGTGGTGCATGCCTGTGGTCTGAGCTACTTGCAAGGCTGAGGTGGAAGAACTGCTTCAGCCTAGGAGGAGGAGGTTGCAGTGAGCCAAGATCATGTCACTGCACTCCAGCCTGGGCAACAGAGTGAGACCCTGTCTCAA","GGCTGGGCACGGTAGCTCACACCTGCAATCCCACCACTTTGGGAGGCTGAGGTGGGTGGATTGCTTGAGCCCAGGAGTTCTAGACCAGCCTGGGTGATACAGGCAGACCCTATCTCTACCAAAAAAAAAAAAAAAAAAAAAAAAAAAGGCTGGGCATGGTGGCATGTGCCTGTGGGCTCAGCTACTTAGGAGGCTGAGGTGGGAGGATCAGTTGAGCCCAGGAGGAGTTGAGGCTGCAGTGAGCCTAGATCCTGCCACTGCACTCCAATCTGGGCAACAGAGCGAGACCCTGTCTC"
"chr1","21029488","21029610","chr1","217544386","217544536","59","196514898","GGCCAGGTGCAGTGGCTCACGCCTGTAATCCTAACACTTTGGGAGGCCAAGGCAGAAGGATCACTTGAAGCCAGGAGTTTGAGACAAGCCTGCACAACATAGCAAGACCTCATCACTACAAAA","GGCTGGGCGTGGTGGCTCATGCCTCTAATCCCAGCACTTTAGGAGGCCAAGGCAGGAGGATAACTTAAGACCAGGCTGGGTGACACAGTGAGACTTTGTCTCTAAAAAAAAAAAAAAAAAAAAAAAAAAAAAAAACCTACAAAAACATATA"
"chr1","21029848","21030167","chr6","44061836","44062146","91","23031988","GCCCAGTGGCTCATACCTGTAATTCCAGCACTTTGGGAGGTTGAGGCAGGATGATCACTTGAAGCGAGGAGTTTGAGGCCATCCTGGGCCTCAAACATCTGGTCCAGCAAAGCAAGACCCTGTCTCCACAAAAAATTTTTAAAAATTAGTTGGGCATGGTGTTTTACACCTGTAGTCTCAGCTACTTGGGAGGCTGAGGTAGGAGGATCCCCTGAGCCCAGGAGTTCATGGCTCACTGCAGCATGATTGTGCCACTGTGCTCCAGCCTGGCAACAAAGTGAGACCCTGTCTCAAGAATAAAAAATAAAATAATAAATAAA","GGCCAGGCATGGTAGCTCATGCCTGTAATCTCAGCACTTTGGAGGCTGAGGCATGAGGATCAGTTGAGGCCAGGAGTTTGAGACCAGCCTGGATAACATAGTGAGACCCCATTCAACAACAACAACAACAACAACAACAAATTTAAAATTAGCTGGGCATGGTGGTGCATGCCTGTAGTCTTACGTACTTGGGAGGCTGAGGTGGGAGAATCTCTTGAGCCTAGGAGGTTGAGGCCTCAGTGAGCTGTGATTGTGCCACCACTCCAGCCTGGGTGACAGAGTGAGACCTTGTCTTTAAAAAAAATAAATAA"
"chr1","21039516","21039683","chr6","36141662","36141829","68","15102146","AGCGAGGCATGGTGGCACATGCCTGTCGTCCCAGCTACTTGGGAGGATAAGCTGGGGGGATCCCTTGTATCCCAGAGACGGAAGCTACAGTGAGTTATTTCCAACACCCTGAACTCCAGACTGGTGTACAGAATGAGACCTGTCTCAAAAAAATCCAAAAATTAAAAA","GGGCAGGCGCAGTGGCTCATTCCTGTAGTCCTAGCACTTTGGGAGGCCAAGGAGACGGGATTGCTTGAGGCCAGAAGTTCAAGACTTCAAGACCAGCCTGGACAACATAGTGAGACCCTATCTCATATATATATATATATATATATATAAATTAAAAATAATAATAAA"
"chr1","21044852","21045144","chr9","68878569","68878883","94","47833717","GGGCACCATGGCTCAAGCCTATAATCCCACTACTTTGTGAGGCTGAGGCTGGAGGACTGTATGAGGCCAGGATTTAGAAACAAAACCTGCCTTGGCAACAAAGCAAGTCCCATCTCTGCAAAAAATTAAAAAATTAGTCAGCCATCATGGAGCTCGCATACAGTCCCAGCTACCTGAAGAACTGCTTGAGTCCAGGGGGTCAAGGCTGCAGTGAGCTATGATCACACTGCTGCACTCCAGCCTGGGTGACAGAGTGAGGTCCTGTCTCTAAAAATAAAAAATAAATAAAAAAA","GGCTGGGCACGGCAGCTCATGTCTGTAATCCCAGCACTTTGGGAGGCCAAGGTGGGAGGATTGCTTGAGTCCAGGAGTTCAAGACCAGCCTGGGCAACATAGTGAAACCCCAGTCTCTACAAATAAATAAATAAATAAATAAATAATTAGCTGGGCATGTTGATGCATGCCTGTAGTCCTAGCTACTCGGGGGGTGAGGTGAGAGGATTGCTTGAGTCCAGAAGGTGGAGGCTGCAGTGAGCTATGATCACACCACTGCACTCCAGCCTGGAAGACAGGGTGAGACGCTGTCTTTAAAAAAAAAAAAAGAAAAGA"
"chr1","21126411","21126669","chr10","96412023","96412287","91","75285612","TCCCATTACTTTGGGAGGCCGAGGTAGGTTGCTTGAGGCCAGTAGTTCAAGATCAGCCTGGGCAACACAGCAAGCCGCCATCTCTACAAAAAGTAAACAGCTAGGCAGGGTAGCACCTGCCTGTAGTCACAGCTACTCCCGAGAATGGCATGGGAGGATCCCTTGATCCCAGGAGTTTCAGGTTACAGTGATCTATGACCATGCCACTGCATTCCTCCAACCTGGGCTACCACAGAATCAGACCCTTTAAAAAAAAAAA","CTTTGAGAGGAAGACGTAGGAGGATTGCTTGAGCCCAGCAGTTTGAGACTAGCCTGGGCAACATAGGAAGACTCCCATCTCTACACACACACACACACACACACACACACAATTATCCAGGGTGGTGGTGCATGCCTGTGGTCCCAGCTACTTGGGAGGTTGAGGTGGGAGGATTGCTTGAGCCCAGGAGGTCCAGGCTGTAGTGAGCCATGATCATACCGCTGCACTCCAGCCTGGGCAACAGAGTGAGACCCTGTCTCAAAAA"
"chr1","21132448","21132738","chr8","25360790","25361095","80","4228342","GCTGGGCATGGTAGCTCATGCCTGTGCTTCTAGCATTTTGGGAGGCTGAGATGAGAGGATTGCTTGAGCCCAGGAGTTTGACACCAGCCTACACAACATAGTGACACCCCATCTCTACAAAAAAATAAAAAATATGCTTGGTGTGGTGGCATATGCCTGTGGTCCTAGCTATAATACTTGGGAGGCTGAGGTGGGAGGATCAGTTGAGCCCAAGAAATCCAGGCTCTGGTGAGCACCACTGCACTCTAGCCTGGGTGACAGAGCAAGACTCTGTTTCAAAAACAAATAAAA","GGCTGGGAGCAGTGGCTCATACCTGTAAGCCCAGCACTTTGGGAGGCTGAGGTGGGAGGATTGCTGAAGCCCAGGAGTTTGAGACCAACCTGGGCAATGTAGGGAGACCCCGTCTCTACTAAATAAATAAATAAATAAATAAATAAAGTCGGGCATGGTGGCATGTGCCCTGTAGTCCCAGCTTCTTGGGAGGCTGAGGTGGGAGGATTGCTTGGGCCCAGGAATCAAGGCTGCAGTGAGCTGTGATTGTGCCACTGTACTACAGCCTGGGTGACAGTGCAAGACTGTCTCAAAAGAAAAACAAAA"
"chr1","21137527","21137832","chr20","46003702","46004015","65","24866175","GGCTAGGCATGGTGGCTCATGCCTGTAATCCCAACACTTTGGGAGTTAGAGGCAGGAGGATCACTTGAGCCTTGGAGTTTGAGACCAGCCTGGGCAACATAGTAAGACCTTATCTTTACAAAATTAAAAAATAATAATAACAATAATAGCCAGGCATGGTGGTACACACTTGTACTCCCAGCTACTCAGGAAGCTGAAGTGGGAGGATCACTTGAGCCTGGTGGTCAAGGCTGCAGTGAGCTACAATGGGCCACTGCACTCCAGCCTAAGCAACAGAAGACCCTGTCTCAAAAAAAAAAAAAAAAA","GGCTGCGCACAGTGGCTCACACCTGTAATCCAGCACTTTGGGAGGCCAAGGCAGGAGAATCATTTTCGTTCAGGAGTTTGAGGCCAGCCTGGGCAATATAGAGAGATCTTCTCTCTACAAAATATAATAATAATAATAATAATAATAAGCCAGTTGTGGTGGCTCACACCTGTAGTCTCAACTACTCAGGAAGCTGAGGTGGGAGGATCACTTGAGCCCAGGAGGTTGAGGCTGCAGTGAACCAGACTACACCACTGCACTCCAGCCTGAGTGACAGAGCAAGACCTTGTCTCAAAAGAAAAAAAACAACAAAA"
"chr1","21141647","21141951","chrX","16155635","16155942","81","4986012","GGCCAGAAACAGTGGCTCATGCCTGTTATCCCAACACTTTGGGAAGCCAAGACAGGAAGATCGTTTGAACCTAGGAGTTCAAGACTAGCCTGGACAACATAGTGAGACCCTGACTCTACCAAAAATTTTTATAACTTAGTCAGCCGTGGTAGTGTGGGCCTGTAGTCCCAGCTACTAGAGAGGTTGAAGGGGAAGAATCGCTTGAGCCTGGGAAATCGACGCTGCAGTGAGCTGTGATTATGCCACCACGCTCCATCCAACCTGTGCAACAGAGCAAGACCCTGTCTCCAAAAAAAAAAACAAAA","GGCCAGGCACAGTGGCTCACACCTGTAATCCCGGTACTTTGGGAGGCTGAGGCGGGAGGATCACTTGAGCCCAGGAGTTCAAGACCAGCCTGGGCAACATAACAAGACCCTGTCTCTACCAAAAAAAAAAAAAAAAAAAAAAAAAATAGCCAGGCCTGGTGGCCTGTGTCCATAGTCCCAGCTACTTTGGGAGACTGAGGTGGAAGGATCACTTGAGTCTGGAAATCAAGACTGCTGTGAGCTGTGATCATGCCACTGTACTCCAGCCTGAGCAACAGAGTGAGACCCTGTCTAAAAAAAAAAAAAAA"
"chr1","21144252","21144547","chr2A","88638728","88639031","88","67494476","CAGTGGCTCATGCCTGTAAGTCTAGCACTTTGGGAGGCCAAGGTGGAAGGATTGCTTGAGGCCAGGAGTTTGAGACCAGCCTAGGCAACACAGCGAGACCCCATCTCTACGAAAAAAAAAAAAAAGATGGGTGTGCTGCTGTAGTGTTAGTTTATAGTCCTAGCTGCTCAAAGAGCTGAGGTGGGAGGCTCCCTCAAGGGGATCCCTCAAGATTGAGGCTAGAATGAGTTATGATTGTGCCAGCGCACTTTAGCCTGCACAACAGTGAGACTCTGTCTCCAAAATAAATAAATAAA","GGTGCAGTGGCTCATGCCTGTAATTCCAGCGCTTTGGGAGGCAAAGGTGGGAGGACTGCTTGAGCCCAGGAGTTTGAAACCAGCCTGGGCAACATAGGGAGACTTCATCTGTATAAATAAATAAATAAATAAATAAATAAATAAGCTGGGCATGGTGGCATGCACCTGTGGTCCCAGCTACTTGAGAGGCTAAGGTGGGAGGATCACTTGAGCCCAGGAGGTTGAGGCTGCAATGAGTCATGATCACGCCACCACACTCCAGCCTGAGCTACAGAGTGAGGTCTTGTCTCAAAAAAAAAAAAAA"
"chr1","21144996","21145103","chr20","87144","87254","61","21057852","GGCCAGGCATGGTGGCTCATGCCTGTAATTCTAGCACTTTGGGAAGCCAAGGTGGGAGGACTGCTTGAGGCCAGGAGTTAAGAGACCAGCCTGGGCAACATAGCAAGA","CCTGGGCAACATAGTGAGACTACATCTCTACACTCACGCACACACACACACACACACACACACCCCCCAAATTAGCCAGGCATGCTGATGTGCACCCATAGTCTCAGCAAC"
"chr1","21159151","21159455","chr10","125157322","125157641","78","103998171","GGCTGGGTGCAGTGGCTCAGGCCTATAATCCCAACACTTTGGGAGGCCGAGGCAGGAGGATTGCTTAAGCCCAGGAGTTTGGGATCAGACTGGACAACAAAGTGAGACCCCTATCCCTATCTCTCCAAAAATTTTAAAAATTAGCTGGGCACAGTGGTGTGTGCCTGTAGTCCCAGCTACTTAGGAGGCTAAAATGGGAGGATCCCTTGAGTCCAGGAGTTTGAGATTGCAGTGAGCTATGATCAAACTTCACTTCAGCCTGGGTGACAGAGCAAGGGTTTAAAAAAAAAAAAAAGAAAAAAAAA","GGCTGGGTGCAGTGGCTCATGCCAGCAATCCCAGCCCTTTGGGAGGCTGAGGTGAGCAGATCGCTTGAGCCCAGGAGTTTGAGACCAGGTGAGGCAACATGGCAAGATCCCCTCTCTACCAAACAAACAAACAAACAAACAAAAAACAACTAGCTAGGGATGGTGGTGCGTGCCTGTAGTCCCAGCTACTTGGGAGGCTGAAGTGGGAGGATCGCTTGAGCCCAGGAGTTCAAAGCTGCAGTGAGTCATGATAGCACCACTGCACTCCAGCCTGGGTGACAGAGTGAGACCCTGTCGCAAAAAAAAAAAAAAAAAAAGAA"
"chr1","21183526","21183837","chr14","31798968","31799292","84","10615442","GCTGGGCACTGTGGTCCACACCTGTAATCTCAATGCTTTGGGAGGCCTAGGGGGTAGGATCACTTGAAACCAGGAGTTCAAGACCAGCCTGGGCATCCTAGTGAGTTGCTCTCTCTACAAAAAGAGTTTACAAATTAGCTGAGTATGATGCCACGTGTCTGTAGTCCCATCTATTGGGAAGGCTGAGGCAGGAAGATCACTTGAGCCTACGAGTTTGAGGCTGCAGTGAGCTATGATGGCACCACTGCACTCCAGCCTGAGCAACAGAACAAGACCCTGTCTCAAAAATAAGTAAATAAGTAAATAATAAAA","GGCTGGGCACAGTAGCTTACACCTGTAATCCCAGTACTTTGGAAGGCTGAAGTGGGAGGATCCCTTGAGGCCAGGAGTTTGAGACCAGCCTGGGCAACATAGTGAGACCCTGTCTCTACAACAAACAAACAAACAAACAAACAAAACTTAGCCAGTTGTGGTGGCACATCCTATAGTCCCAGCTACTCAGGAGGCTGAGGAGGGAGGATCTCTTGAGCCCAGGAGTTTGAGGCTGCAGTGAGCTATGATCATGACACTGCACTCCAGCCTGGATAACACAGCAAAATCCTGTCTCAAAAAAAAAAAAAAAAAAAAAAAAAAAGAA"
"chr1","21197209","21197512","chr2A","88638728","88639031","82","67441519","GCCAGTTGTAGTGGCTCATACCTGTAATCCCAATACTTTGGGAAGTCAAGGTAGGAGAACCACTTGAGGCCAGGGGTTCAAGACCAGCCAGTACAACATAGGGAGACCCCCGTCTCTACAAAATCTTTTTAAAATATTAGCCAGGAATAGTGGCATGCACCTATGATCCCAGCTACACAGAAGGCTGAAGTGGGAGAATCACTTAAGCCTGAGAGGTTGAGGCTGCAATGAGCCATGATCACACCATTGCACCCCAGCCTGGGTGAAGAGTGAGAACCTATCTCAAAAATTAAAAAAAAAAAAA","GGTGCAGTGGCTCATGCCTGTAATTCCAGCGCTTTGGGAGGCAAAGGTGGGAGGACTGCTTGAGCCCAGGAGTTTGAAACCAGCCTGGGCAACATAGGGAGACTTCATCTGTATAAATAAATAAATAAATAAATAAATAAATAAGCTGGGCATGGTGGCATGCACCTGTGGTCCCAGCTACTTGAGAGGCTAAGGTGGGAGGATCACTTGAGCCCAGGAGGTTGAGGCTGCAATGAGTCATGATCACGCCACCACACTCCAGCCTGAGCTACAGAGTGAGGTCTTGTCTCAAAAAAAAAAAAAA"
"chr1","21202175","21202342","chr2A","60286019","60286209","59","39083844","GCATGGTGGTATATGCCTACAGTCCCAGGTGCTTGAGAGACTGAGGTGGGAGGATCACTTCAGCCCAGGAGGTGGAGGCTGCAGTGAGCTATGATCGTGCCATTGCACTCCAGCCTGGGCAACAGAGTGAGATCCTGTCTCAAAAAATAATAATAATAACAAAATAAA","AAAATTAGCCAGGTGTGATGGCACCTGTAGTCCTAGCTACTTGGGAGGCTAAGGTGGGAAGAGGGCTTGAGCCCAAGATTGTGAGGCTGTGGTGAGTCATGACTGTGCCATTGCCCTCTGGCCTGGGTGACAGAGTGAGAAGCTGTCTCAAATAAATAAATAAATAAATAAATAAATAAAAATAAACAAAA"
"chr1","21207574","21207719","chr19","6391716","6391877","55","14815858","GTGCAGTGGCTCATGCCTGCCTGTAGCCCCCAACACTTTGGGAGGCCAAGGCGGGAGGATCAGTTGAGGCCAGGAGTTTGAGACCAGCCTGATAAATAAAGTAAGACCCTGGCTCTACAAAATATATATAAAAATTAGTGGCCGGG","CCAGGCGCAATGGCTCACGCCTGTAATCCCAACACTTTGAGAGGCCGAGGCAAGAGGATTGCTTGAGGCCAGGAGTCCGAGACCAGCCTGGGCAACACAGCGAGGCCTCATTCTCTACAAAAAATAAATATATAAATAAATAAATAAATAAGAAGAAGAAAA"
"chr1","21209383","21209462","chr20","87144","87254","60","21122239","GCTGGGTGTGGTGGCTCACGCCTGTAATCCTAGCACTTTGAGAGGCTGAGGCAGGAGGACTGCCTGAAGCCAGAATTTTG","CCTGGGCAACATAGTGAGACTACATCTCTACACTCACGCACACACACACACACACACACACACCCCCCAAATTAGCCAGGCATGCTGATGTGCACCCATAGTCTCAGCAAC"
"chr1","21229182","21229363","chr19","13525969","13526165","68","7703213","AAAAAAAAAAAAATTAGCCAGGCATGGTCACGAGTGCTTGTAGTCCCAGCTACTTGAGAGGCTGAGGTGGGAGGATAGCTTGAGCCCAGGAGTTTGAGGCTGTAGGGAGCCATGATCATGCCACCGCACTCTAACCTGGGTGTCACAACAAGATCTTGTCGCTTAAAAAGAAAAAAAAAAAA","AAGAAATAAATTAGTTGAGCATGGTGGTGCATGCCTATAGTCCCAGCTACTGGGGAGGCCAAAGTGGGAGGATTGTGTGAGCCCAGGAGTTTGAGGCTGCAATGAGCCAAGATTATGCACACCAGTGTGGGAGACAGTCAAGTCTCAAAAAATAAACAACAACAACAACAACAACAACAAACACATAAAAAGAAAAA"
"chr1","21232289","21232591","chr3","180847740","180848052","81","159615451","CACAGTAGCTCAGGCCTGCAATCCCAGCACTTTGCAGGCTGAGGTGGGCAGATCGCTTGAGCCTAAGACTTCAAGACCAGGTTGGGCGACATAGGGAGATGTGGTCTCTACAAAAAATTTTTAAAATTAGCTGGACGTGGTGGCACGAACCTGTAGTCCCAGCTACTGGGGAGGCAGAGGTGGGAGGATCACTAGAGCCCAGGAGGTCGAAGCTGCAGTGAGTCAAGATCATGCCACTGTACTCCAGCCTGGGCAACAGAGCGAGACCCTGCCTGAAAAAAAAGAAAGAAAGAAAAAAAAAAA","GCCGTGGGCCGTGGCTTACACCTGTAATCCCAATGGTTGGCTAACGCAGGAGGATCGTTTGAAGCCAGGAACTCGAGACCAGCCTGGGCAACACAGTGAGACCTCCTCTCTACATAAAATAAAATAAAATAAAATAAAATAGCTGGGTGTGGTGGCACGCGCCTTTGGTCCCAGCTACTCAGGAGGCTGAGGTGGGAGACTCACTTGAGGCCAGGAGGTCGAAGTTGCAGTGAGCCGAGATCACGCCACTGCACTCCAGCCTGGGTGACAGAGCGAGACCCTGACTCCAAAAAAAAAAAAAAAAAAAAAAAAA"
"chr1","21234480","21234777","chr8","25360790","25361095","69","4126310","GCCAGGCGCAGTGGCTCATGCTTGTAATGCCAACACTTTGGGTGGCTGAGGTGGGGGGATTGATTGAGCTCAGGAGTTTAAGACCAGCCCGGGCAACATAGTGAGACCTCATCTCTACAAAAAATGTAAAGATTAGCTGGGCATGTTGGCATGTGCCTATAGTCCCAGCTACATGGGAGGCTGAGATGGGAAGATCACTTATGCTCAAGAAGACAAGGCTGCAGCAAGCTGTGATTGCACCACTGCACTCCAGCGTGGGCGACAGAGCAAGACCCTGTCTCAAAAAAGCAGAAAAAAA","GGCTGGGAGCAGTGGCTCATACCTGTAAGCCCAGCACTTTGGGAGGCTGAGGTGGGAGGATTGCTGAAGCCCAGGAGTTTGAGACCAACCTGGGCAATGTAGGGAGACCCCGTCTCTACTAAATAAATAAATAAATAAATAAATAAAGTCGGGCATGGTGGCATGTGCCCTGTAGTCCCAGCTTCTTGGGAGGCTGAGGTGGGAGGATTGCTTGGGCCCAGGAATCAAGGCTGCAGTGAGCTGTGATTGTGCCACTGTACTACAGCCTGGGTGACAGTGCAAGACTGTCTCAAAAGAAAAACAAAA"
"chr1","21246664","21246941","chr19","13342110","13342403","86","7904554","ACGCCCGTAATTGCGGGACTTTTGGGAGACAGAGGCAGGAGGATCCCTTGAGTCCCTGCGTTTGAGACCAGCCTGGGCAACATGGCGAGACGGTGTCTCTACAAAAAATAAAAAATTAGCCAGACATGGTGTCGCGTGCCTGTCACCCAGCTCCTTGAGAGGGAGGCTGAAGTGGAAGGATCTCTTGAGCTCAGGAGGCAGAGGTTGTAGTGAGCTGTGATTGCACTGTTGCACTCCAGCGTGGGAGACAGAGTAAAACCCTGTCTCAAACAAAAAAA","TCATGCCTGTAATCCCAGCACTTTGGGAAGCCAGGGCAGGAGGATCACTTGAGACCAGGAGTTTGAGACCAGCCTGGGCAACATAGCCAGACCCCCATCTCAACAACAACATCAACAACAACAACAACAAATTAGCTGGGTGTGGTGGTGCCTGTAGTCCCAGCTACTTGGGAGGCTAAGCTGGGAGGATCGCTTGAGCCCAGGAGCTCCAGGCTGCAGAGAGCTATGATCATATCACTGCACTCCAGCCTGAGTGACAGAGCAAGAACCTGCCTCTAAAAACAATAAACAAAA"
"chr1","21259278","21259540","chr1","94172177","94172465","81","72912899","AATCCCAACTTTCTCGGGAGGCTGAGGCAGGAGGATCACTTGAAGCCAGGAGTTTAAGACCAGCCTGGGCAGCATAGCAAGACCCCATCTCCAAAAAATTTAAAAATTAGCCAGGTGTGGTGATACACACCTGTAGTCATAGCTACTTAGGAGGATGAGGTGAGACAATCACCTGAGCCCAGGAGGTGGAGGCTGCAGTGAGTTGTGATGGCCCCACTGCACTTCAGCCTGGGAATCAGAGCAAGACTCCATCTCAAAAAAAA","GTCTGTAATCCCAACACTTTGGGAAGCCAAGGCAGGAGAATCATTTGAGCTCAGGAGTTTGAGACCATCCTGGGCAACATATCAAAACCCCATCTCAATAATAATAATAATAATAATAATAATAATAATAAGCCAGATGTGGTGGCACATGCCTGTGGTCCCAGCTACTTGGGAGGCTGAGGTGGGAGGATCGATTGAGCCCAGGAGGTAGAGGCTGCAGTGAGCTATGATCATTTAGGCACTTCAGCCTAGATGACAGAGCAAGATTCTGTCTCAAAAAAAAAAACAA"
"chr1","21285544","21285709","chr19","6391716","6391877","59","14893828","GCCAGGCATGACGGCTCATATCTGTAATCCCAGCACTCTGGGAGGCCAATGTGAGAGGATCGCTTGAGCCCAGGAATTCAAGGCTGCAGTGAGCCATGATCACGCCACTGCACTCCAGCCTGGGCAACAGAGCAAGACCCTGCCTCAAAAAAAAAAAAAAAAAAAA","CCAGGCGCAATGGCTCACGCCTGTAATCCCAACACTTTGAGAGGCCGAGGCAAGAGGATTGCTTGAGGCCAGGAGTCCGAGACCAGCCTGGGCAACACAGCGAGGCCTCATTCTCTACAAAAAATAAATATATAAATAAATAAATAAATAAGAAGAAGAAAA"
"chr1","21312161","21312466","chr9","2736689","2737010","82","18575472","GGTGTGGTGGCACATACCTATCGTCCTAGCTACTCAGGAGGCTAAGGCGGGAGGATCGCTTGAGCTCAGGAGTTCAAGACCAGCCTGGAAAACAATGCAAAACCTTGTCTCTACAAAAAATATAAAAATTAGCTGGGCATGGTGGGGGGCACCTGTAGTCCCAGCTACTCAGGAGGCTGAGGTGGGAGGATTGCTTGAGCCCCAGGAGGCTGAGGCTGCAGTGAGCTGTGATTGCATCCCTGCACTCCAGCCTGAAAGACAGAGTAAAATCCTGTCTCAAAAAAATAATTTTAAAAATTTAAAAAA","GCCTGGTGCAGTGGCTCACACCTAGTATTCCCAGCACTGTGGGAGGCCAAGGCAAGAGGACTGCTTGAGCCCAGGAGTTCAAGACCAGCCTGGGTAACATAGCAGGACCTTGTCTCTACAAACAAACAAACAAACAAACAAACAAATTAGCTGGGCATGGTGGCATGCACCTGTAGTCCCAGCTGCTTGGGAGGCTGAGGTGGAAGGATCATTTGAGCTTGGGAGGTTGAGGCTGCAGTGAGTCATAATCACATCACTGTACTCCAGCCTGAGTGACAGAGTGAGACCCTGTCTCTAAATACAGAAATAAATAAAAGAAAAA"
"chr1","21336107","21336402","chr16","32352979","32353289","73","11016872","GCAGTGTCTCATACCTGTAATCCCAGCACCATGGAAGGCTAAGGTGGATGAATCACTTGAGCCCAGGAGTTCAATACCAGCCTTGGCAACTAGTGAGACCTTGTCTCTACAAAAAAATATCAGAAAATTAGCTGGGTGTAGTGGTGCACCTGTGGTACCAGCTACTCAGGAGGCTGAGGTGGGAAGATCACTTGAGCCCATAAGTTCAAGGCTGCAGTGAGCTGTGTTCATGCCACTGTACTCCAGCCTGGGTGACAGAGTGAGAGACCCTGTCTCAAAACCAAAACAACAAAAAA","GGCTGGACACGGTGGCTGCTGCCTGTAATCCCAGCACTTTGGGAGGCCAAGGCAGGAGAATGGCTTGAGCCCAGGAGTTCAAGACCAGCCCGGGCAACAGAGTGAGACCTTGTCTCTACAAAAATAAAAATAGAAATAAAAATAAAAATTAGCCAAGTGTGGTGGCATGCACCTGTGGTCTCAGCTACTCAGGAGACTGAGGTGGGAGGATCCCTTGAGCCCAGGAGGTCGAGGCTGCAGTGAGCTGTGATCATGCCACTACACTCCAGCCTGGGTGACAGAGCTGTCTCAAAAAAATAATAATTAAAAAA"
"chr1","21351065","21351205","chr19","6391716","6391877","42","14959349","GGCACCATGGCTCAGGCCTGTAATCCCAAAACTTTGGGAGGCCGAAGCAGGAGAACTGCTTGAGGTCAGGTGTTCACCAGCCTGGGCAACACAGTGAGACCTTGTCTCTACTAAATATAAATATATATATACATACATATA","CCAGGCGCAATGGCTCACGCCTGTAATCCCAACACTTTGAGAGGCCGAGGCAAGAGGATTGCTTGAGGCCAGGAGTCCGAGACCAGCCTGGGCAACACAGCGAGGCCTCATTCTCTACAAAAAATAAATATATAAATAAATAAATAAATAAGAAGAAGAAAA"
"chr1","21351516","21351547","chr20","87144","87254","82","21264372","TCTACTAAATATATTTTTAAAAAATTAGTTGG","CCTGGGCAACATAGTGAGACTACATCTCTACACTCACGCACACACACACACACACACACACACCCCCCAAATTAGCCAGGCATGCTGATGTGCACCCATAGTCTCAGCAAC"
"chr1","21351855","21351985","chr18","55799233","55799394","53","34447378","GTCATGCATGGTGGCACAAGCCTGTATCCCAGCTACTGGGGAGGCTGAGGTGGGAAGATCACTTGAGCCCAGGAGTTCAAGACTGCTGCACGACACCCTGTCTCAAAAAGAAAAAAAAAACAGAGAAAAAA","GGCTGAGAGAGGTGGCTCATGCTTGTAATCCCAGCACATTGGGAGGCAAAGGTGGGAAGATTGCTTGAGGCCAGGAGTTCAAGACCAGCCTGGGCAACATGAAAACACTTTGTCTCTACAATAAATAAATAAATAAATAAATAAATAAAAGAAACAAGAAAA"
"chr1","21357126","21357272","chr5","32595015","32595178","74","11237889","CCAGGCGTGGTGGTGCCAGTTACTCAGGAGGCTGAGGTAGGAGGATCGCTTGAGCCCAGAAGTTTGAGGCTGCAGTGAGCTGTGATTGCACCACTGCACTCTAGCCTGGGTGACAGAGTGAGACCTTGTCTCTCAAAGAGAGAGAGA","GGCCGGGTGTGGTCCCTCATGCCTGTAATCCCAACACTTTGGGAGGCTGAGATAGGAGGACTGCTTGAGGCCAGGAGTTCAAGACCAGCCTGGTCAACATAGTGAGACCCCATCTCTATAAAATAATAATAATAATAATAATAATAATAATAAATAAATAAATA"
"chr1","21357613","21357754","chr19","6391716","6391877","49","14965897","GTCGGGTGCAGTGGCTCATGCCTATAATCCCAGCACTTTGGGAGGCCAAGGAGGGAGGATCACTTGAGGCCAGGAGACAGAGACAAGCCTGAGCAGCACACTGAGTCCTCGTCTTTACTAAAAATTAAAAAATTAGCCAAGT","CCAGGCGCAATGGCTCACGCCTGTAATCCCAACACTTTGAGAGGCCGAGGCAAGAGGATTGCTTGAGGCCAGGAGTCCGAGACCAGCCTGGGCAACACAGCGAGGCCTCATTCTCTACAAAAAATAAATATATAAATAAATAAATAAATAAGAAGAAGAAAA"
"chr1","21358329","21358458","chr6","36141662","36141829","59","14783333","GCCAGGTGCGGTGGCTCATGCCTGTAATCCCAGCACTTTGGGAGGCCAAGGCAGACAGATCATCCAAGGTTAGGAGTTTGAGACCAGCCTGGCAACATAGTGGGACCCTGTCTCTATAAAAAATTAGCCG","GGGCAGGCGCAGTGGCTCATTCCTGTAGTCCTAGCACTTTGGGAGGCCAAGGAGACGGGATTGCTTGAGGCCAGAAGTTCAAGACTTCAAGACCAGCCTGGACAACATAGTGAGACCCTATCTCATATATATATATATATATATATATAAATTAAAAATAATAATAAA"
"chr1","21358760","21358875","chr8","58489091","58489211","64","37130331","TTGGCTGGGGCAGTGGTGCATGCCTGCAGTTCCAGCTACTTAGGAGGTTGAGGTGAGAGGATTGCTTGAGCCCAGGAGGCCGAGGCTGCAGTGAGCCATGTTTGTACCACTGCACT","TTGAGACCAGGAGTTTGAGACCAGCTTGGACAACATAGTGAGACCCTGTCTAAAAGAAAGAAAGAAAGAAAAGAAAGAAAGAAAGATGTAGCCAAGTGTGGTGGTGCACATCTGTGTCTCA"
"chr1","21374224","21374522","chr10","65849492","65849800","62","44475268","GGCTAGGTGTGGTGGCTCATGCCTATAATCCCAACACTTTGGGAGGCCAAGTGGGGAGGATTGCTTGAGGCCAGGAGTTTGAGACCAGCCTGGGCAACATAGTGAGACCCTGTTTCTACATAAAGTAAATTTTAAAAATAGCTGGGTGTGGTGGTGCACACCTGTAGTCCCAGCTACTTAGGAGGCTGAGGTGAGAAGATAGCTTGAGCCCAGGAGTTGGAGGTTGCGGTGAGCTGTGTTCATGCCTCTGCACTCCAACCTGGGCGACAGAGTAATATCCTGTTTCAAAAAAAAAAAGA","GGCCAGGTGTACTGGCTCATGCTTATAATCCCTGCACTTTGGGAGGCTGAGGTGGGAGGATTGTCTGAGGCCAGGAGTTTGAGACCAGCCTGGGCAACAGAGTGAGACCTTGTATCTTAAAAAAAAAAAAAAAAAAAAAAAAAAGCAGGGTATGGTGGTGCACACCTGTGGTCCAAGCTACTCGGGAGGCTGAGTGTTGGAGGATTGCTTGGGCCCAGGAGGTCGAGGCTGCAGTGAGCTGTATTCATGCCAGTGCACTCCAGGTTGGGTGACAGGGTGAGATTCTGTCTCAAAAAACAAACAACAAAA"
"chr1","21464726","21465028","chr1","136656911","136657239","80","115192185","GGCCAGGTTCAGTGGCTAACTTCTGTAATCCCAGCACTTTTGGAGAACTAGGTGGAAGGATCGCTTGAGGCCAGAAGTTCAAAACCAGCCTGAGCAACATAGCAAGACCTTGTCTCTATGAAAAATAAAAAATTAGCCAGAAATGGTGATGTGTGCCTAGAGTTCCAACTACTTGGAAAGCTGAGGCAGGAGGATCGCTTGAGCCCAGAAGTTCAAGGTTGCCGTGATCTATAATCACCAGTGCACTCCAGCCTGGGTGACAGAATAAGACCCTGTCTCAAAAAAAAAAAAAAAAAAAAAAAA","GCCAGGCACAGTGGCTCACACCTATAATCCCAACACTTTGGGAGACCAAGGCAGGAGAATCACTTGAGGCCAGGAGTTTGAGACCAGCCTGAGCAACATAGCAAGACCTTGGCTCTACTAAAAAAATAATAAAATAAAATAAAATAAAATAATTAGCCAGGCATGGTGGCATGCACCTGTAGTCCCAGCTACTCAGGAGGCTGAGGCAGGAGGATGGCTTAAGTCCAGGTGTTCAAGGTTGCAGCAAGCTATGATTGCCACTGCACCCCAGCCTGGGTGACAGAGCAAGTCCCTGTCTCAAAAAAATAGATAAATAAATAAAAATAAAA"
"chr1","21506283","21506440","chr5","32595015","32595178","62","11088732","GCCAGGCATGGTGGCTCACGCCTGTAATCCCAGCACTTTGGGAGGCCAAGATGGGAGGGTCTCTTGTGTCCAGGAGTTAGAGTCTGCAGTGAGCTATGATCACACCCCTGCACTCCAGCCTGGCCAACAGAGTGAGACTTTGTCTTGGGAAAAAAAAA","GGCCGGGTGTGGTCCCTCATGCCTGTAATCCCAACACTTTGGGAGGCTGAGATAGGAGGACTGCTTGAGGCCAGGAGTTCAAGACCAGCCTGGTCAACATAGTGAGACCCCATCTCTATAAAATAATAATAATAATAATAATAATAATAATAAATAAATAAATA"
"chr1","21529257","21529515","chr7","7616254","7616509","78","13913003","GGCCAGGCTTGGTGGCTCATGACTGGAATTCCAACACTTTGGAAGGTCCAGGAAACATGGCAAGAACCTCATCTCTACAAAAAAAATTATTTTTTAATTAGCCAAGTGTGGTGTGCACCTGTGGTCCCTGCTATTTGGGAGGCTGGGGTGGGAGCGTTGCTTAAGGCCAGGGGTTGAGACTGAAGTGAGCCATGTTCATGCCACTGCACTCCAGCCTGGGTGACAAAGTAAGACCCTGTCTCAGAAAAAAAAAAAGAAA","GGCCATGCACGGTGGCTCACACTTGTAATCCCAAAACTTTGGGAGGCTGAAGCAGATTTCATCTCTACAAAAAAAAAAAAAAAAAAAAAAAAATTGGCCAGGTGTGGTGGCATGAGCCTGTAGTCCCAGCTACTAGGGAGGCTGAGGTGGGAGGATCGCTTTGGCCCAGGAGTTTGAGGCTGCAGTGAGTTACGACTGTGCCTCTGCACTCCAGCCTGGGTGACAGAGCGAGATCCTGTCTCTAAAAATATATAAA"
"chr1","21557605","21557746","chr8","58489091","58489211","74","36931486","AAGAAAAAAAAGAAGGCTGAAGAAGTGGCTCATCCTGTAATCCCAGCACTTTTGGAGGCCATGGTGGGAGGACTGCTTGAGGCCAGGAGTTTGAGGCTACAGTAAGCCATGATTGTGCCACTGCACTCCAGCCTGGCAACAG","TTGAGACCAGGAGTTTGAGACCAGCTTGGACAACATAGTGAGACCCTGTCTAAAAGAAAGAAAGAAAGAAAAGAAAGAAAGAAAGATGTAGCCAAGTGTGGTGGTGCACATCTGTGTCTCA"
"chr1","21572015","21572158","chr15","37343640","37343763","74","15771625","ATTAGCCAGGTGTGGTGGTGCCAGCCACTCAGGAAGCTGACGTGGGAGGCTTGCTTGAGCCCAAGAGTTTGAGGCTGCAGTGAGCTATGATCATGCCACTGCACCAGTTTGGGCAACAGAGTGAGACCCTGTCACAAAACAAAA","AAGATCCCTGGCCAGGATTTCAAGACCAGCCTGGGCAACACAGTGAGACCATACATACATACATACATACATACATACATCATACATACATACATACATACATACATACACAGTCTTACAAAGA"
"chr1","21580140","21580439","chr8","25360790","25361095","72","3780650","GGCCAGGCACAACGGTGCATACCTGTAATCCCAGCACTTCGAAAAGCTGAGGTGGGAGGATTGCTTGAGGGCAGGAGTTCAATACCAACCTGGGCAACATAGCGAGACCCTGTCTCTACAAAAAATAAAAAAATTAGCCAGGTATGGTGATATGTGCCTGTAATCTAGCTACTTGGGAGGCTGAGGCGGGAGGATCACTAGAGCCCAGGAGTTAGAGGCTGCAGTGAGCTATGATCATGCCACTGCACTCCAGGCTGGGTGAAGGAGCAAGACCTTGTCTCTAGTTAAAAAGAAAATAAA","GGCTGGGAGCAGTGGCTCATACCTGTAAGCCCAGCACTTTGGGAGGCTGAGGTGGGAGGATTGCTGAAGCCCAGGAGTTTGAGACCAACCTGGGCAATGTAGGGAGACCCCGTCTCTACTAAATAAATAAATAAATAAATAAATAAAGTCGGGCATGGTGGCATGTGCCCTGTAGTCCCAGCTTCTTGGGAGGCTGAGGTGGGAGGATTGCTTGGGCCCAGGAATCAAGGCTGCAGTGAGCTGTGATTGTGCCACTGTACTACAGCCTGGGTGACAGTGCAAGACTGTCTCAAAAGAAAAACAAAA"
"chr1","21630556","21630856","chr4","139746214","139746515","75","118115658","GGCCAGGTGCAGTGGCTTATGCCTGTAATCCTAGTGCTTTGGGAGGCCAAGGTGGGAGGCTTATTTGAGGCCAGGAGTTCCAGACCAGCCTGGGCAACACAGCAAGACACCCATCTCAACAACAACAACAAAAAATTTATTTTTAATTAGCCGAGCACACACCTGTAGTCCCAGCTACTAGGAGGCCGAGGGGGAAGGATCACTTGAGCCCAGCAGTTCAAGGCTGCAGTGAGCCATGATCATGCCACTGCACTCCAGCTTGGGTGACAGAGCAAGACCCCATTTCTTAACAACAACAAAA","GGCCAGGCACAGTAGTTTATGCCTGTAATCCCAGCACTTTGGAAGGCTGAGGCAGAAAGATCCCTTGAGCTCAGGAGTTTGAGATCAGCTTGGGCAACATAGCGAGACCCCATCTCCTAAAAAAAAAAAAAAAAAAAAAAAAACTAGCTGAGCATGGTACACACACCTGTAGTCCCAGCTATTTGGAGGTGCTGAGGTGGGAGGATCACTTGAGTCCAGGAAGTTGAGGCTGCAGTGAGCCAAGATCATGCCACTGCACTCCAGCCTGCACAACACAGCAAGACTCTGTCTCAAAAAACAAA"
"chr1","21632620","21632898","chr1","88859712","88859991","79","67227092","CCAGGCTCAGTGGTTCATGTCTGTAATCCCAGCACTTTGGTAGGCTGAGGTGGGAGGAACACTTGAAGCCAGGGGTTCGAGACCAGCCTGGGCAGCAAAGTGAGCCCTCATCTTTACAAAAAAATTAAAAACCCAGCCCACTGCAGTGGCTCACACCTATAGTCTCAGGCACTCAGGAGGCTGAGGTGGGAGGATCACTTGAGCCAGAAGTTCCAGGCTACAGTGAGCCATGATGGTACCACTGCATTCCAGCCCTGGCGACAGAGCAAGACCCCATCT","CCAGGCACAGTGGCTCACACCTGTAATCCCAGCACTTTGGGAGGCCAAGGCAGGAGGATTGCTTGAATCCAGGAGTTTGAGACCAGCCTGGGCAGCATAGTGAGACTTGGCCTCTACAAAAAAAAAAAAAAAAAAAAAAAAAAGTTACCTGGGAAGTCTCAGCTACTTGGAAGGCTGAGGTCGGAAGGTTGCTTGAGTACAGGAGGTCAAGGCTGCAGTGAGCTATGATTGTACCACTGCACTCCAGCGTGGGCAACAGAGTGAGACCTTATCTCAAAAA"
"chr1","21683383","21683643","chr7","7616254","7616509","84","14067129","AGGCCGGGCGCAGTGGATCACTTGAACCCAAGAGTTCAGGACCAACCTGGGCAACATAGTGAGACCCTGTCTCTACTACAAATTTTAAAAAAAGAGCCAGGCATGGTGGCTCGCACCTGTGGTCTCAGATACTTGGGAGGCTGAGGTGGGTGGATTGCTTGAGCCGGGGAGTTGGAGGCTGCAGTGAGCTGTCATCATGCCACTACACTCAAGCCTGGGTGACAGATTGAGACCCTGTCTCAAAAAAGAAGAAATAATAAA","GGCCATGCACGGTGGCTCACACTTGTAATCCCAAAACTTTGGGAGGCTGAAGCAGATTTCATCTCTACAAAAAAAAAAAAAAAAAAAAAAAAATTGGCCAGGTGTGGTGGCATGAGCCTGTAGTCCCAGCTACTAGGGAGGCTGAGGTGGGAGGATCGCTTTGGCCCAGGAGTTTGAGGCTGCAGTGAGTTACGACTGTGCCTCTGCACTCCAGCCTGGGTGACAGAGCGAGATCCTGTCTCTAAAAATATATAAA"
"chr1","21690512","21690828","chr3","99347730","99348048","70","77657218","GGCCAGATGCAGTGGCTCATGCCTGTAATCTCTGCACTTCGGGAGGCTAAGCTGGGAGGATTGCTTGAGTCTAAGAATTCGAGACCAGCCTGGGCAACATAGCAAGACCTCATGTCTACAAAAATAAAAAATAAAAAATCCGCCAGACATGGTAGCACACATCTGTAGTCTCAGCCACTCAGAAGCCTTAGGTGGGAGGATCCCTTGAGCCTGGGAGTTCAAGGCTGCAATGAGCCATGATCGCGCCACTGCACTCCAGCCTGGGTGACAGAGTGAGACCCTGTCTCAACAACAACAAAAAAAAAAGAAAAAGAAAA","GGCTGAGCATGGTGGCTCATACTTCATCCCAGCACTTTGGGAGGCTGAGGTGGGAGGACTGCTTGAGTCCAAGAATTTGAGACCAGCCTGGGCAACACAATGACACCCCATCTCTCAAAAAAAAAAAAAAAAAAAAAAAAAAAAAGCCAGGCATGGTGGCACACACCTGTGGTCCCAGCTACTTGGGAGTCTGAAGTGGGAGGATCACTTGAGCTCAGGAGATCAAGGCTGCGTGAGCTGTGACTGCATCACCACACTCCAGCCTGGGTAACAAAGTGAGACCCTGTCTCAAAAAAAAAAAAAAGAAAAGAAAAGAAAA"
"chr1","21722273","21722558","chr4","74884752","74885058","77","53162479","GTGGCTCATACCACCAAGAGCTTTGGGAAGCCAAGCAGGGAGGGTAGCTTGAGGACAGGAGTTTGAGACCAGCCTGGGCAACATAGTGAGACCCTGTCTCTACAAAAAGTGTAAAAATTAGCAAGCCATGGTGATGTGTGCCTGTAGTCCTAGCTACTTGGGAAGCTGAGGTGGGAGGACTGCTTAAGCCTAGAAGTTCTAGGCTGTAGTGCACTACGATTCCACCACTGTACTCCAGCTGGGGCAACAGAATAAGACTCTGTCTCAGAGAAAAAAAAAAAAAAAA","CAGTGGCTGACACCTTAATCCCAGTGTTTTGGGAGGCCAAGGTGGGAGGATCACTTGAGGCCAGGAATTTGAGACCAGTCTGGGCAACACAGTGAGACCTCATCTCTTACCAAAAATAAAAATAAAAATAAAAATAAATTAGCTGGGTGTGGTGGCATGTGCCTGTGGTCCTAGCTACTCAGGAAGCTGAGGTGGGAGGATTGTTTGAGCCCAGAAGTTCGAGGTCGTGGTGAGATATGATTGCACCACTGCACCCCACTTGGGCAACAGAACAAGACCCTGTCTCTTATAAAAACAACAACAAAAA"
"chr1","21734117","21734428","chr14","31798968","31799292","86","10064851","GGTTGGGCACGGAAGCTCATGTCTGTAATGCCAACACTTTTGGGAGGCCAAGTGCAAGGATCGTCTAAGGGCAGGAATTCAAAAGCAACCTGGGGAACCCAGGGAGACTCTGTCTCTGTAACAAATTACAAAATTAGCCAGGTGTGGTGGATCACACCTGTGGTCTCAGTTACTTGGGAAGCTGAGGCAGGAGGATTATTTGAGTCCAGGAGTTCGAGGCTGCAGTGAGCCATGTTCATGCCACTGTACTCCAGCCTGGGCAACAGAGCAAGACTCTGTCTCAAAAAAATATATAAATAAAAGGAAAGAAAA","GGCTGGGCACAGTAGCTTACACCTGTAATCCCAGTACTTTGGAAGGCTGAAGTGGGAGGATCCCTTGAGGCCAGGAGTTTGAGACCAGCCTGGGCAACATAGTGAGACCCTGTCTCTACAACAAACAAACAAACAAACAAACAAAACTTAGCCAGTTGTGGTGGCACATCCTATAGTCCCAGCTACTCAGGAGGCTGAGGAGGGAGGATCTCTTGAGCCCAGGAGTTTGAGGCTGCAGTGAGCTATGATCATGACACTGCACTCCAGCCTGGATAACACAGCAAAATCCTGTCTCAAAAAAAAAAAAAAAAAAAAAAAAAAAGAA"
"chr1","21737900","21738048","chr9","47045786","47045941","71","25307886","TGTACACCTGTCATCCCAGCTACTCCTGGAGGTTGAGGTGGGAGGATTGTTTAAGCCCAGGAGGTTGAAGCTGCAGTGAGCTATGATTGTGCCACTGCACCCTAGTCTGGTGACAGAACAAGACCCCGTCTCAGGGAAAAAAAAAAAAA","GCTGGGCGCAGCAGCTCACACCTGTAATCCCAGTGCTTTGGAGGTCCAAGGTAGGAGGATTGCTTAAGACTAGGTGTTCAAGACCAGTCTTGGCAACATAGTGAGAACTCATCTCTACAATAAATAAATAAATAAATAAATAAATGAAAATAAAAA"
"chr1","21738658","21738704","chr20","87144","87254","73","21651514","CTAGCCTGGGCAAGACAATGAGACCCTGTCTATAAAAAAAAAAAATG","CCTGGGCAACATAGTGAGACTACATCTCTACACTCACGCACACACACACACACACACACACACCCCCCAAATTAGCCAGGCATGCTGATGTGCACCCATAGTCTCAGCAAC"
"chr1","21741695","21741977","chr8","15910614","15910909","76","5831081","GGCCAGGTGTGGTGGTTCACGCCTGTAATCCCAGGACTTTGTGAGCCGAGGCAAGAGGACTGCTTAAGGCCGTAAGTCCGAAACCAGCCTGGGCAACACAGAGAGACCCAGTCTATAAAAACTTAAAAAATTAACCAGACATGGTACTATACACCTGTGGTCCCAGCTACTCAGGAGGCTGAGGTGGGAGGATTGCTTGAGTCTGGGAGGTCAAGGCTGCAGTGAGCCATGATCGTGCTACACTGCACTCCAGCCTCGGTGACAGAGCAAGACCATCTTAAAA","GGCCAGGCGAAGTGGCTCACACCTGTAATCCCAGCACTTTGGGAGGCCAAGGCAGGAGGATCATTTGAAGCCAGGAGTTCAAGGCCAGCCAGAGAAACATAGTGAGAACCTGTCTTTACAAAAATTAAAATTAAAATTAAAATTAGCCAGGAGTGGTGGTGCATGCCTGCAGTCCCAGCAGCTCAGGAGGCTGAGGTGGGATGATTGCTTGCACCAGGAGTTCGAGGCTGCAGTGAGCTGTGATCGTGCCACTGCACTCCAGCCCCTGGGTGACAAAGCAAGATCCTCTAAAAAAA"
"chr1","21749123","21749163","chr20","87144","87254","80","21661979","GCTTGAGCTCAGGAGTTTGAGTCTTCGGTTAGCTATGATTG","CCTGGGCAACATAGTGAGACTACATCTCTACACTCACGCACACACACACACACACACACACACCCCCCAAATTAGCCAGGCATGCTGATGTGCACCCATAGTCTCAGCAAC"
"chr1","21749596","21749901","chrX_NW_019937303v1_random","2630481","2630786","86","19119115","GCCAGATGTGGTGGCTCATGTCTATAATCCCAGCACTTTATGAGACTGAGACAGTAGGATCATTTGAGAACAGTAGTTTGAAACCAGCCTAGGCAACATAGTGATAGACCGTCTTTGCAAAAAATAAAAAAATTAACCAGGCTTGGTGTTGAACAGCCATAATCCCAGCTACTCAGGAGGCTGAGGCTGGAGAATTGCCTGAGCTCAGGAGTTTGAGGCTGTAGTTAGCTATGATTGGACCACTGCACCCCAGCCTTGGTGACAGAGCAAGACCCTGTCTGTAAAAATAAAATAATGAAAAAAAAA","GCTGGGCGTGGTGGCTCACGTCTCAAATCCCAGCACTTTGGGAGGTCAAGCAGTGAGGATTACTTAAGGCCAGGAGTTTGAGACCAGTCTGGGAAACATAGTGAGAGTCTGTCTCTACAAAACACACACACACACACACACACACACACACCTGTAGTCCCAGGTACTCAGTAGGCTGAGGCAGGAGGATTGCTTGATCCCAGGAGTTCAAGGCTGCAGTGAGCTGAGATTGCACCACTGCACTCCAGCCTGGGCAACAGAGCGAGACTCCATCTCAAAAAAAAAAAAAAAAAGAAAAGAAAAGAA"
"chr1","21755750","21755873","chr20","87144","87254","60","21668606","GGCCTGGCACCATGGTTCATGCCTGTAATCCAGCACTTTTGGAGACCGAGACAGGAGGACTGCTTAAGGCCAGAAGTTCAAGACCAGCCTGGGCAACAGAGCAAGACACTGTCTCTATAAAAAA","CCTGGGCAACATAGTGAGACTACATCTCTACACTCACGCACACACACACACACACACACACACCCCCCAAATTAGCCAGGCATGCTGATGTGCACCCATAGTCTCAGCAAC"
"chr1","21761295","21761484","chr14","51003183","51003398","63","29241888","CAGCCTGGGGCAACATGGCAAGACCCTGTTTTTACAAAAAATAAAATAAAAAATTATCCAAGTATGGTGGCATGCACCTCCCAGCTACTCCAGAGGCTGAGGCTGGAGGATTACTTGAGTCCAGGATGTAGAGGCTGCAGTGAGCCATGAACATGCCACTTCAGTATGGGAGTCTCAAAAAAAAAAAAAA","AGCCTGGGCAAGATAGTGAGACCTCATCTCTTAAAATAAATAAATAAATAAATAAATAGCAGGATGTGGTGGCGTGCATCTGTAGTCCCAGCTACTCAGGAGGCTGAGATGGGAGGATTACTTGAGCTCAGGAGGTCGAGGCTGCAGTGAGCTATGATCACGCCACTGTACTCCAGCCTGGGTGAGAGTGATACCCTGTCTCTAACAAAAAAAAAA"
"chr1","21778654","21778752","chr20","87144","87254","62","21691510","TGCAATCCAAGCATTTCAGGGGGCCAAGGCAGGAGGATCACTTGAAGCAAGGAGTTCAAGACCAGCTTGGGCACCAAAGTGGGACTCCATTTCCACAAA","CCTGGGCAACATAGTGAGACTACATCTCTACACTCACGCACACACACACACACACACACACACCCCCCAAATTAGCCAGGCATGCTGATGTGCACCCATAGTCTCAGCAAC"
"chr1","21779080","21779254","chr19","13525969","13526165","72","8253111","AAAAAAATTTTGTTTAATTAGCCTCGTGTTGTGGCATGTGCCTGTAGTGGCAGGAGGCTGAGGCGGGAGGATTGCTTGAGCCCAGGAGTTCAAGGCTGCAGTGAGCCATGATTGCACTGCAATACAGTCTGTGTTACAGAGTGAGACCTCATTAAAAATAAATAAATAAATAAAA","AAGAAATAAATTAGTTGAGCATGGTGGTGCATGCCTATAGTCCCAGCTACTGGGGAGGCCAAAGTGGGAGGATTGTGTGAGCCCAGGAGTTTGAGGCTGCAATGAGCCAAGATTATGCACACCAGTGTGGGAGACAGTCAAGTCTCAAAAAATAAACAACAACAACAACAACAACAACAAACACATAAAAAGAAAAA"
"chr1","21790517","21790714","chr1","9000895","9001091","53","12789622","GGCTGAGCACAGTGGCTCATGCCTGTAATCTCAGCCTTTTGGAAGGCTGAGGCTAGAGGATTGCTTGCTTGAGGACAAGAGTTTGAGACCTATCTGAGCAACATAGTGAGACCCTGTCTCTACCAAAAAAAAAAAAAAAAAAAATTGCCAGGTGTGGTGGTGTGTGCCTGTGGTCCCCAACTACTCTGAAGGCTGAGG","GGCCAGACGTGGTGGCTCACTCCTGTAATCCTAGCACTTTATGAGCCTGAGGCAGGAGAATCACTTGAGGCTAGGAGTTTGAAACCAGCTGAGGCAACATAGTCAGACTCTGTCTCTACTAAAAAAAAAAAAAAAAAAAAAAAAAGCCAGGCACAGTGGTGCACACCTATAGTCCCAGCTACTTGGAAGGCTGAGGC"
"chr1","21806475","21806779","chr5","104248312","104248604","76","82441837","CCAGGCACAGTGGTTCATGCTTGTAATCCCAGCACTTTGGGAGGTGGAAGTGGGAGGATCGCTTGAGGCTGGGAGTTCGGGACCAACCTGGGCAACAGAGTGACCAAACCCCATCTCTACAAAAAACATAAAAATTAACCAAGCGTGGTGGTATGCATCTGTAGTCCCAGCTCCTTGGGAGGCTGCAGCAGGAAGGTTGCTTGAGCCCAGGAGCTCAAGGCTGCAGTGAGCTATGATCGTTCCACTGCACTCCACCCTGGGCAACAGAGCAAGACTCCATCTAGCAAAAAAAAAAATAGAGAAAA","GGCACAGTGCCTCACACCTATAATCCCAGCAATTTGAGAGGCTGAGAGGGTGGATTGCTTGAGGCTAAGAGTTTGAGACCAACCTGGACAACACTGTGAAACCTTGTCTTTACCAAAAAAAAAAAAAAAAAAAAAAAAAGTGGTGTGTGTGCCTTTAGTCTCAGCTACTTGGGAGACTGAAGTGGGAGGATTGCTTAAGCCCAGGAGTTCAAGGCTACAGTGAGCTATGATCACGCCACTGCACTCCATCCTGGGTGACAGAGCAAGATTCTGTCTCTAAGAAGAGAGAGAAA"
"chr1","21867121","21867382","chr1","134143156","134143417","93","112276035","CTGGGTACAATGGCTCACACCTATAATCCCAGCACTTTGGGAGACTGAGGCTGAAAAATCGCTTCAGGCCAGGAGTTGAGACCAGCTTAAGCAACATAGCGAAATGCTGTCTCTAAAAAAATAAATCGGCCGGGCATGGTGGCTCATTCCTGTAATCCCAGCATTTTGGGAGGCTGAGGCAGGACAATCGCTTGAGTCCAGGAGTTTGAGACCAGCCTGAGCAACATAGGGAGACCCCATCTCTATTTAAAAAAAAAAAAAA","GCCAGGCTTAGTGGCTCACACCTATAATCCCAGCACTTTTCTTTGGGAGGCCAAGGCAAGAGGATAGATTGAGTCCAGTAGTTTAAAACTAGCCTGGGCAACATAGTGAAATCCCATCTCAATAAATAAATAAATAAATAAATAAATAAAAATAAAAAGAGGCTGAGTGTGGTGCCAAAGTGGGAAGATCACTTGAGCCCAGGAGTTCAAGACCAGCCTGGGAAACATAGTGAGACTTCATCTCTATAAAAACAAAAATAAA"
"chr1","21905770","21906018","chr10","96412023","96412287","71","74506253","GAAGGCTGAGACAGGAGGATTACTTGAGGCCAGGCGTTCAAGACCAGCCTGGACAACATAGTGAGACTCTGTCTCTACAAAAAAATTAAAAATCAGCCCGTTGTGGTGGTGCACACCTGTAGTCCCAGCTACTTAGGAGGCTGAGGCAGGAGGACTGCTTGAGCCAGGAGCTCGAGGCTGCAGTGAGCTATGATTGCACCACTGTACTCCAGTCCGGATAAAAGAGTGAGACCCTGTCTCTAAAAACAA","CTTTGAGAGGAAGACGTAGGAGGATTGCTTGAGCCCAGCAGTTTGAGACTAGCCTGGGCAACATAGGAAGACTCCCATCTCTACACACACACACACACACACACACACACAATTATCCAGGGTGGTGGTGCATGCCTGTGGTCCCAGCTACTTGGGAGGTTGAGGTGGGAGGATTGCTTGAGCCCAGGAGGTCCAGGCTGTAGTGAGCCATGATCATACCGCTGCACTCCAGCCTGGGCAACAGAGTGAGACCCTGTCTCAAAAA"
"chr1","21959154","21959467","chr14","31798968","31799292","70","9839814","GCCAGGCACAGTGGCTCATGCCTGTAATCCCAGCACTTTGGGAGGCCGAGGTGGGAGGATCACTTGAGTCCAGGAGTTCAAGACCAGCCTGGGCAACATAGTGAGACCCCATCTCTACAAAAAAGAAACAAAATTAGTCGGGTGTGGTGGTGTCCACCTGCAGTCCCAGCTACTCTGAAGGCTAAGGGGGGATAGGGTGACTTCAGCCTGGGAGTTTGAGGCTGCAGTGAGCTATGATCATGCCACTGTACTCCAACCTGGGCAACAGAGCAAGACCTTGTCTCAAAACAAACAAGCAAACAAAGAAACAAAAA","GGCTGGGCACAGTAGCTTACACCTGTAATCCCAGTACTTTGGAAGGCTGAAGTGGGAGGATCCCTTGAGGCCAGGAGTTTGAGACCAGCCTGGGCAACATAGTGAGACCCTGTCTCTACAACAAACAAACAAACAAACAAACAAAACTTAGCCAGTTGTGGTGGCACATCCTATAGTCCCAGCTACTCAGGAGGCTGAGGAGGGAGGATCTCTTGAGCCCAGGAGTTTGAGGCTGCAGTGAGCTATGATCATGACACTGCACTCCAGCCTGGATAACACAGCAAAATCCTGTCTCAAAAAAAAAAAAAAAAAAAAAAAAAAAGAA"
"chr1","21971714","21971880","chr18","55799233","55799394","66","33827519","GCCAGGTGTGGTGACGTGAACCTGTAGACCCAGCTATGAGGAGGCTGAGGTGGGAGGATAGCATGATCCCGAGTTGGAGACTGCTCTGAGCTATCATCACAGCACTGCACTCCAGCCTAGGCTACAGAGTGAAACACTACCTCTCTTAAAAAACAAAACAAAACAAA","GGCTGAGAGAGGTGGCTCATGCTTGTAATCCCAGCACATTGGGAGGCAAAGGTGGGAAGATTGCTTGAGGCCAGGAGTTCAAGACCAGCCTGGGCAACATGAAAACACTTTGTCTCTACAATAAATAAATAAATAAATAAATAAATAAAAGAAACAAGAAAA"
"chr1","22002373","22002412","chr20","87144","87254","74","21915229","CAGTCTGGGCAACAAAGCAAGACCCCATCTCTACAAAAAA","CCTGGGCAACATAGTGAGACTACATCTCTACACTCACGCACACACACACACACACACACACACCCCCCAAATTAGCCAGGCATGCTGATGTGCACCCATAGTCTCAGCAAC"
"chr1","22021970","22022270","chr6","157423301","157423612","72","135401331","GCTGGGCGTGGTGGCTCACACCTGTAATCCCAACACTTTTGGAGGCTGAAGCAGGAGGATCCCTTGAGCCCAGGAGTTTGAGACCAACCAAGGCAACATAGTGAGACCCATCTCTACAGAAATTTTTTAAAAATCAGCCTGGTGTGGTGGTGCACATCTGTGGTCCCAGCTACTTGGGAGGCTGAAGTGGGAGGATCACTTTAGCCCAGTAGATTGAGGCTGCAGTGAACTGTGATTGAGCCACTGCACTCCAGCCTGGGCGGATAGAACAAAACTCAGTCTCAAAAAAAAAAAAAAAAAA","GGCTGGGCGTGGTGGCTCACACCTGTAATCCTAGCACTTTAGGAGGCCTAGGTGGGAGGACTGCTTGAGCCCAGGAGTTTGAGACCAGCCTGGGCAACACAGTGAGACCTCATCTCTACTAAAAAAAAAAAAAAAAAAAAAAAAAATCAGCCAGGTATGGTGCCATATCCCTGTAGTCTCAGCTACTTGGGAGGCTGAGGTGGGAGGATCACTTAAGCCTGGGAGATGGAGACTACAGTGACCCATGATAGCACCACTGCACTCCAGCCTGGGCAAGAGAGCGAGACTTGGTCTCAAAATGAAACAAAGAAA"
"chr1","22036471","22036738","chr19","13342110","13342403","79","8694361","CATGCCTGTAATCCCAGCAGTTTGGGAGGCCAGAATGGGAGGATCACTTGAGGCCAGGAGTGCACGACCAGCCTGAGCAACATAGCAAGACCTGTCTCTACAAAAAAATTAGCTGGGTGTGGTGGTGTATGCCTGTAGTTCCCAGCTTCTCAGGAGGCTGAGGCGGGAGGATCCTTTGAGCCCAGGAGGTCAAGGCTGCAGTGAGCTGTGATTGTGCCATTGCACTCCAACTTAGGTGGCTGAGTGAGACCCTGTCTCAAAAAAAGAA","TCATGCCTGTAATCCCAGCACTTTGGGAAGCCAGGGCAGGAGGATCACTTGAGACCAGGAGTTTGAGACCAGCCTGGGCAACATAGCCAGACCCCCATCTCAACAACAACATCAACAACAACAACAACAAATTAGCTGGGTGTGGTGGTGCCTGTAGTCCCAGCTACTTGGGAGGCTAAGCTGGGAGGATCGCTTGAGCCCAGGAGCTCCAGGCTGCAGAGAGCTATGATCATATCACTGCACTCCAGCCTGAGTGACAGAGCAAGAACCTGCCTCTAAAAACAATAAACAAAA"
"chr1","22058809","22059124","chr15","38618928","38619254","76","16560119","GGCCCGGTGCAGAGGCTCACAACTGTAATCCCACAGCTCTGGGAGGCCAAGGTGGGAGGTCACTTGAGGCCAGGAGTTCAAGAACAACCTGGGCAACATAAAAAGGCCCCATTCTCTACAAAAATATATATATATATTTACAATTAGCCAAGTGTGGTGGTGCGTGCCTGCAATCCCAGCTACTTGGGAGGCTGAGGTTGGAGGATCCTTTAAGCCCAGGAGTTCAAGGTTACAGTGAGCTATAATCACACCACGCACTGCAGCCTGGTGACATAGCAAGACTCTATCTCTAAAAAATAAAAATAAAATTAAAAAA","GGCCAGGCACAGAGGCTCACACCTATAAACCCAACACTTTGGGAGCCCGAGGCAGGAGGATCACTTGAGGCCAGGAGTTTGAGACCAGCCTGAGCAACACAATGAGGCCCTGTCTCTATGATAAATAAATAAATAAATAAATAAATAAGCTAGCAGAGTGGGGCTGGTGGCATGTGCCTGCAATCCCAGCTACTTGAGAAGCTGAGGAGGGAGGATCGCTTGAGCCCAGGAGTTCAAGGCTGCAGTGAGCTATGATCACTGCACTCCAGCCCAGGCAACAGAGCCAGACCTTGTCTCTAAAAATATAAAGAAATAAAAGAAAAGAAA"
"chr1","22167573","22167870","chr18","16899958","16900260","78","5267615","GGCTGGGCGTGGGGGCTCATGTCTATAACCCCAGCACTTTGGGAGGCCGAGGCAGGAGGATCACTTGAGGCCAGGAGTTCAAGACCACCCCAGGCAACATAGCAAGACTCCTTCTTTACAAAAAATTAGCCAGGCATGGTGGTGCGTGCCTGTTGTAGTCCCAGCTACTTGGAAGGCTGAGGCAGAAGGATCAGGAGGATCCCTTGAGCCCAGGAGTTGGGGGCTGCAGTGAGCCATGATTGTGCCGCTGCACTCTAGCCTGGGTGACAGAGCAAGACCCTGTCGCTAAAAAAAAGAA","GTCAGGCGCGGTGGCTCACACCTGTAATCCCAGCACTTTGGGAAGCCGAGGCAGACGGATCACCTGAGGCCAGGAGTTCAAGACCAACCCCGGGCAACAAAGCAAGACCCTGTCTCTATAAAAAAAAAAAAAAAAAAAAAAAAATTAGCCGAGCATGATGGCAAGTGCCTGTAGTCCCAGCTACCTAGGATGTTGAGGTAGGAGGATTGCTTGAGCCCAAGAGGTTGAGGCTGCAGTGAGCCATGATCTCACCACTGCACTCCAGCCTGGGTGACAGAGCGAGACCCTGTCTCAAAAAATAAA"
"chr1","22211421","22211697","chr9","68878569","68878883","77","46667148","TGGCTCATTCCTATAATCCCAACACTTTGGAGGCCAAGGTGGGAGGATAGCTTGAGGCCAGGAGCTCAAAACCAGCCTGGGCAACATAGCAAGACCCCATCTCTCAGAAAAAAATAAAAGGCTTAGCTGGGCATGGTGACACATGCCTGTAGTTCTAGCTACCTGGGAGGCTGAGGCAGGATTCCTTGAGCCCGGGAGTTCGAGGCTGCAGTGAGCTAGGATCACATCACTGCATTCCAGCCTGGGAGACCCTGTCAAAAAAAAAAAAAATGGAAAA","GGCTGGGCACGGCAGCTCATGTCTGTAATCCCAGCACTTTGGGAGGCCAAGGTGGGAGGATTGCTTGAGTCCAGGAGTTCAAGACCAGCCTGGGCAACATAGTGAAACCCCAGTCTCTACAAATAAATAAATAAATAAATAAATAATTAGCTGGGCATGTTGATGCATGCCTGTAGTCCTAGCTACTCGGGGGGTGAGGTGAGAGGATTGCTTGAGTCCAGAAGGTGGAGGCTGCAGTGAGCTATGATCACACCACTGCACTCCAGCCTGGAAGACAGGGTGAGACGCTGTCTTTAAAAAAAAAAAAAGAAAAGA"
"chr1","22258268","22258568","chr9","68878569","68878883","72","46620301","GGCCAGGCACAGTGGCTCACGCCTGTAATCCCAGCACTTTGGGAGTCCAAGGCAGAAGGATCTCTCCAGCCCAAGAGTTCAAGGGCAGCCTGGTTAACATAGCGAGACCCTGTCACTACAAAAAATTTTTAAAAATTAGCTGGGCATGGTGGCATGTGCCTGCAGTCCCAGCTACTCGGGAGGCTGAGGTGGAGGGATGGCTTGAGCCTGGGAGTTGAGGTTGCAGTGAGCTAGGATCACACCACTGCACTCCAGCCTGGGCGACACAGCAAGACCCTGTCTCAAATAAACAAACAAATAA","GGCTGGGCACGGCAGCTCATGTCTGTAATCCCAGCACTTTGGGAGGCCAAGGTGGGAGGATTGCTTGAGTCCAGGAGTTCAAGACCAGCCTGGGCAACATAGTGAAACCCCAGTCTCTACAAATAAATAAATAAATAAATAAATAATTAGCTGGGCATGTTGATGCATGCCTGTAGTCCTAGCTACTCGGGGGGTGAGGTGAGAGGATTGCTTGAGTCCAGAAGGTGGAGGCTGCAGTGAGCTATGATCACACCACTGCACTCCAGCCTGGAAGACAGGGTGAGACGCTGTCTTTAAAAAAAAAAAAAGAAAAGA"
"chr1","22292910","22293236","chr1","135236320","135236644","87","112943410","GGACAGGCATGGTGGCTCATGCCTGTAATCCCAGCACTTTGGGAGGCTGAGGTGGGAAGAGCACCTGAGCCTGGACAACAGAGTTCAGGAGTTCAAGGCCAGCCTGGGCAACAGAGCAAGACCCTGTCTCTACAACAATTTTAAAAATTAGCTGGGTGTGGTCATGCATGTGCCTGTAGTCCTAGCTACTCAGGAGGCTGAGGTGGGAGGATTGCTTGAGCCCAGGAGGTTGAGGCTGCAGTAAGCTGAGATCACACCATGGCACTCAAGCCTGGGCAACAGACCCTGTCTCAAAAAATGCAAAAACAAGAACAAAAAATTAAAAAA","GGCTGGGTGTGGTGGCTCGTGCCTATAATCCCAGCACTTTGGGAGGCCAAGGTAGGAAGATCACTTGAGCCCAGGAGTTTGAGACCAGCCTGGGCAAAATGGCAAGACCCTGTCTCTATAAAAATTTAAAAAAATTAGCCAGCTGTGTTTGTATGCGTCTGTCATCTCAGCTACTAGGGAGGCTGAGGTGGGAGGATTGCTTGAGTCCGAGAGTTTGAGGCTGCAGTGAGCTATGATCATGCCACTGTACTCCAGCCTGAGTGACAGAGTGAGACCCTGTCACACACACACACACACACACACACACAAAAGAAAAGGAAAGAAA"
"chr1","22310687","22310806","chr1","217544386","217544536","63","195233699","GGCCGGGTGTGGCGGCTTATGCCTGTAGTCCCAGAACTTTGGGAGGCCAAGGAGGGAGGATCACTTGAGGCGAGGAGTTTGAGACCAGCCTGAGCAACAGCGACCCTGTCTCTACAAAAA","GGCTGGGCGTGGTGGCTCATGCCTCTAATCCCAGCACTTTAGGAGGCCAAGGCAGGAGGATAACTTAAGACCAGGCTGGGTGACACAGTGAGACTTTGTCTCTAAAAAAAAAAAAAAAAAAAAAAAAAAAAAAAACCTACAAAAACATATA"
"chr1","22317572","22317722","chr9","47045786","47045941","67","24728214","TGGTGGCTCACACCTGCAGTCTACCTCAGTACTTTGGGAGGCCGAGGCCAGAGGATCGTTTGAGCCCAGGAGTTCAAGGCTGCAGTGAGCTATGATTGCACCACTGCACTCCAGCCTGGGTGACAGATGAGACCCTGTCTCAAAAAAAGAA","GCTGGGCGCAGCAGCTCACACCTGTAATCCCAGTGCTTTGGAGGTCCAAGGTAGGAGGATTGCTTAAGACTAGGTGTTCAAGACCAGTCTTGGCAACATAGTGAGAACTCATCTCTACAATAAATAAATAAATAAATAAATAAATGAAAATAAAAA"
"chr1","22338002","22338280","chr3","15191824","15192108","96","7146178","GGCCGGGCAGGGTGGCTCATGCCCATCCTCCTAGTGCTTTGGGAAGCCCAGGAGGAGGATCACTTGAGGCCAGGAGTTTGAGATCAGCCTGGACAGTGTAGTGAGACCTCATCTCTACCCAAAGAAAAAAAATTAGCTGGGTGGTGATGTGCACCTATAGTCCCAGCTACCCTGGAGGTTGAGGTGGGAGGATCACTTGAGCCCAAGAGTTTGAGGTGAGCCCAAGAGTTCGAGGCCACAGTGAGCTGAGATCATGCCACTACACTCCAGTCTGGGTGA","GGCTGGGCACAGTGGCTCACACCTTTAATCCCTGCACTTTGGGAGGCCAAGGCAGGAGGATCACTTGAGGCCAGAAGTTCAAGACCAGCTTGAGCAACATAGGGAGACACTGTTTCTACAAACAACAACAACAACAACAACAACAACAAAACGTAGCTGGGTGTGGTGCCATATACTTATAGTCCCAGCTACTTGGGAGGCTGAGGTGGGAGAATTGCTTAAGCCCAGGAGGTCGAGGCTGCAGTGAACTGTGATCACGCCTCTAGCGCTCCAGCCTGGGCGACA"
"chr1","22355340","22355640","chr4","81732695","81733000","80","59377355","GCCAGGTGCGGTGGCTCATGCCTGTGATCCCAGCATTTTGGGAGGCCAAGGTAGGAGGATCACTTGAAGCCAGGTGTTCAAGACCAGCCTGGACAGTAAAGTGAGACCCCAGCTCTACATAAAATTTAAAAGTTAGCTGGGCACAGTGGTGTGCACTTGTAGTCCCAGCTATTATACTTGGGAGGCTGAGGTGGGAGAATTTCTTGAGCATAGGAGTTCAAGGCATAGCAGCGAGTTATGATTACATCATTGCACTCCAGTCTGGGCAACAGAGTGAAATCCTATTTAAAAAAAAAAAAAA","GCCAGGCTCAGTGGCTTATGCCTGTAATCACAGCACTTTGGAGAGCTGATGTGGGAGGTTTGCTTGAGTCCAGGAGTTTGAGACCAGCTTGGGCAATATAGTGAGATGCAGTCTCTACAACAACAACAACAACAACAACAAAAAACTGGCTGGGCATGGTGGTGTGCCCCTGTAGTCCCAGATACTTGGGAGGCTAAGGTGGGAGGATCACTTGAGCCTAGGAGGTTGAGGCTGCAGTAAGTCGTGATTACATCACTGCACTCCAGCCTGGGCAACAGAGTGAAACCCCATCTCTTAAAAAAAAAA"
"chr1","22430308","22430533","chr13","83255168","83255404","68","60824860","GGCCAGGTGCAGTCGCTCACACCTGTAATACCAGCACTTTGGGAGGCTGAGAGGGCAGATCACTTGAGTTCAGGAGTTGGAGACCAGCCTAGGTAACATAGCAAGACCCTGTCTTTACAACAAATTTTTAAAAATTAGCTGGCTGTGGTGGCACACACCTGTAGTTTCAGCTACACTAGAGGCTGAGGTGGGAGGATTGCTTGAGCCTGGGAGGCCAAGGCTGCAG","GCCAGGCCTGGTGGTTCACACCTGTAATCCCAGTAATTTCAGAGGCCAAAGCAGGTGAATGGCTTGAGCTCAGGAGTTTGAGACCAGTCTGGGCAACATGGCAAAACTCTGTTTCTACAAAAACAAAAACAAAAACAAAAAAAATTAGCTGGGCATGGTGGCACATGCCTGTAGTCCCAGCTATTTGGGGGACTGATGTGGAAGGATCACTTAAGCCCAGGAGGTCAAGGCTGCAGT"
"chr1","22458749","22458889","chr9","47045786","47045941","44","24587037","GCCTGGCACAGTGGCTCACACTTGTAATCCCAGCACTTTGGGAGGCCGAGGCAGGTGGATTGCTTGAGGCCAGGAGTTCAAGACCAGCCTGGGCAACATGGTGAAACCCCATCTCTACCAAAAATCATAAAAATTGGCCAG","GCTGGGCGCAGCAGCTCACACCTGTAATCCCAGTGCTTTGGAGGTCCAAGGTAGGAGGATTGCTTAAGACTAGGTGTTCAAGACCAGTCTTGGCAACATAGTGAGAACTCATCTCTACAATAAATAAATAAATAAATAAATAAATGAAAATAAAAA"
"chr1","22468822","22469127","chr1","213591659","213591963","83","191122837","CCAGGCACAGTGGCTCAATGCCTATAATCCCAGCACTTTGGGAGGCCAAGGCAGGAGGATCCCTTGAGACAAGGAATTCAAGACTAGCCTGGGCAACATAGTGACACTCCATCTCTAAAAAAAATACCAAAAAATTAGCCAAGTGTGGTGGAGTACACCTGTAGTCCTCGCTGTTCAGGTAGCTGAGGTGGGGACATTACTTGAGCCTAGGCAGTCAAGGCTATAGTGAGCTATGATTGTGCCACTGTATTCCAGCCTGAGTGATAGAGCAAGACCCTGTCCCTACTAAACAAACCAAAAAAGAAA","GTGCAATGGCTGATGTCTGTAATCCCAGCACAGTGGGAGGCCAAGGCAGGAGGATTGCTTGAGGCCAGGGATTCAAGACCAGCCTGGGCAACCTAGTGAAACCTCATCTCTATTAAAAATAAAAATAAAAATAAAAATTAGTTGGGCATGGTGGCACACACCTGTGGTCCCAGGAGTCCTCAGGAGGCTGAGGTAGGGGGATCACTTGAGCCCAAGAGTTGAGGTTGCAGTGAGCTATGATTGCACCACTGCACTCCAGCATGGGCAACAGAGTGAGACTTTGTCTCAAAACAAAACAAACAAAA"
"chr1","22546242","22546405","chr18","55799233","55799394","61","33252991","GCTGAGTATGGTGGTTCATACTTGTAGTCCCAGCTACTCATGAGGCTGAGTCGGGAGGATCACTTGGGCCCAGGAGTTCAAGGCTGCAGTGAGCTGTGAATTCACCACTGCGCTCCAGCCTGGGCAATAGAGCAAGACCCTGTCTCAAAAAAAAAAAAAAAAAA","GGCTGAGAGAGGTGGCTCATGCTTGTAATCCCAGCACATTGGGAGGCAAAGGTGGGAAGATTGCTTGAGGCCAGGAGTTCAAGACCAGCCTGGGCAACATGAAAACACTTTGTCTCTACAATAAATAAATAAATAAATAAATAAATAAAAGAAACAAGAAAA"
"chr1","22591108","22591232","chr1","217544386","217544536","56","194953278","GGCTGGGTGTGGTGGCTCACGCCTGTAATCCCAGCATTTTGGGAGGCCAAGGCGGGAGGATCACTTGAGGCCAGGAGTTTGAGATCAGCCTGGGCAACATGGCAAGACCCCATCTCTACAAAAAA","GGCTGGGCGTGGTGGCTCATGCCTCTAATCCCAGCACTTTAGGAGGCCAAGGCAGGAGGATAACTTAAGACCAGGCTGGGTGACACAGTGAGACTTTGTCTCTAAAAAAAAAAAAAAAAAAAAAAAAAAAAAAAACCTACAAAAACATATA"
"chr1","22607697","22607865","chr18","55799233","55799394","66","33191536","ATTAGCCAGGTGTGGTGGCATGCGCCTGCGGTCCCAGCTACTTCAGAGGCTTAGGAGGAAAGACTGATTGAGCTCAGGAGGTTCATCCAGACTGCAGGGAGTCGAGATCATTCCACCCTGGGTGACAGAGCAAGACCTTGTCTTTAAATAAATAAATGAAAGAAAAGAA","GGCTGAGAGAGGTGGCTCATGCTTGTAATCCCAGCACATTGGGAGGCAAAGGTGGGAAGATTGCTTGAGGCCAGGAGTTCAAGACCAGCCTGGGCAACATGAAAACACTTTGTCTCTACAATAAATAAATAAATAAATAAATAAATAAAAGAAACAAGAAAA"
"chr1","22607905","22608024","chr1","217544386","217544536","66","194936481","GGCCAGGCACCATGGCTTATGCCTGTAATCCCAGCACTTTGGGAGGCTAAGGTGGGGAGATCACTTGAGATCAGGAGTTTGAGGACAGCCTGGGCAACATAGCAAAACCCCGTCTCTACA","GGCTGGGCGTGGTGGCTCATGCCTCTAATCCCAGCACTTTAGGAGGCCAAGGCAGGAGGATAACTTAAGACCAGGCTGGGTGACACAGTGAGACTTTGTCTCTAAAAAAAAAAAAAAAAAAAAAAAAAAAAAAAACCTACAAAAACATATA"
"chr1","22610104","22610400","chr8","25360790","25361095","68","2750686","GGGTTCGGTGACTCACACCCGTAATCCCAGCACTTTGGGAGGCTGACATGGGAGCATCACTTGAGGCCAGGAGTTTGAGACCAGCCTGGACAATGTGGTGAGACCCAGTCTCTACAAAAAATAATTTAAAAAGTTAGCCAGTCACGGTAGTGCACGCCTGTAGTCCTGGCTACTTGGGAAGCTGAGGTGAGAGGATCACTTGAGCCCAGGAGTTCGAGGCTGCAGTAAGTTGTGAGGGTGCCACTGCACTTCAGCCTGAGTGACAGAGCAAGACGCTGTCTGAAAAAAAAAAGAAAA","GGCTGGGAGCAGTGGCTCATACCTGTAAGCCCAGCACTTTGGGAGGCTGAGGTGGGAGGATTGCTGAAGCCCAGGAGTTTGAGACCAACCTGGGCAATGTAGGGAGACCCCGTCTCTACTAAATAAATAAATAAATAAATAAATAAAGTCGGGCATGGTGGCATGTGCCCTGTAGTCCCAGCTTCTTGGGAGGCTGAGGTGGGAGGATTGCTTGGGCCCAGGAATCAAGGCTGCAGTGAGCTGTGATTGTGCCACTGTACTACAGCCTGGGTGACAGTGCAAGACTGTCTCAAAAGAAAAACAAAA"
"chr1","22692214","22692378","chr5","32595015","32595178","66","9902801","ATAGCTGGGCATGGTGGCACATACCCATAGTCCCAGCAATTTGGGAGGCTGAAGTGGGAGGATCACCTGAGCTCAGGAGTCAAGGCTGCAGTGAGCCCTGATCATGTCACCGCATTCCAGCCTGGGTAAAGAGAGTAAGACCCTGTCTCAAAAAATGAAATAAAA","GGCCGGGTGTGGTCCCTCATGCCTGTAATCCCAACACTTTGGGAGGCTGAGATAGGAGGACTGCTTGAGGCCAGGAGTTCAAGACCAGCCTGGTCAACATAGTGAGACCCCATCTCTATAAAATAATAATAATAATAATAATAATAATAATAAATAAATAAATA"
"chr1","22692416","22692571","chr18","55799233","55799394","58","33106817","CTGGGTGCAGTGGCTCATGCCTGTAATCTCAGCATTTTGGGAGGCTGAGGCGGGTAGATCACTTGAGGTGAGGAGTTCAAGACATGTGACTTATATGTGTGTGTGTGTACATATATGTATATATATGCTTGTATGTATGTATGATGTATGTATGTA","GGCTGAGAGAGGTGGCTCATGCTTGTAATCCCAGCACATTGGGAGGCAAAGGTGGGAAGATTGCTTGAGGCCAGGAGTTCAAGACCAGCCTGGGCAACATGAAAACACTTTGTCTCTACAATAAATAAATAAATAAATAAATAAATAAAAGAAACAAGAAAA"
"chr1","22701455","22701771","chr2B","83001661","83001979","61","60300206","GGCTGGGCGTGGTGGCTCACACCTGTAATCCCAGCACTTTGGGAGGCCAAGGTGGGAGGATCACTTGAGGCCGGGAGTTCAAAATGAGCCTGGGCAACATAGCAAGATCCTGTCTCTACAAAAATAAAAATAAAAAAATTAGTGGGGCGTGGTAGTGCACACCTGTAGTTCTAGCTACTTGGGAGGGTGAGGTGAGAGAATCCCTTGAGCCCAGGAGGTTGAGGCTGCAGTGAGTTATGATTGCACCACTACACTCCAGCCTGAGCAACAGAGCAAGACCCTGTCTCAAAACAAACAAACAAACAAAAACAAAACAA","GGCTGGAGATGGTGGCTCACACCTGTAATCCTAGTACTTTGGGAGTCCGAGGTAGGAGGATCACTTGAGGCCAGAAGTTTAATACCAGCCTGGGCAACATAGTGAGAGCCTATCTCTACAAAAAAAAAAAAAAAAAAAAAAAAAGCCAGGTGTGGTGGTGCATGTTTGTAGCCTCAGTTACTTGGGAGGCTGAGGTGGGAGGATCATTTGAGCCCAGGAGGTTAAGGCTGCAGTGAGCCAGTTATGGCACCACTGTACTCCAGCCTGGGCGACAGGGCAAGACCCTGTCTCACAAACAAAAACAAAACAAGACAAAAAA"
"chr1","22735142","22735466","chr7","2927945","2928268","88","19807197","GCTGGGTACGGTGGCTCACTCCTATAATCCCAGCACACTTTGGGAGGGTGAGGCAGGAGGGTGAGGCAGGAGGATTGCTTGAGGCCAGGAGTTCGAGACCAGCTTGGGCAACACAGTGTGACCCCATCTCTACTAAATTTTTTTTTAATTAGTCAGGCATGGTGGCATGTGCCTATAGTCCCAGCTACTTGGGAGGCTGAGGTGGGAGGATCGCTTGAGCCCAGGAGGTCAAGGCTGTAGTGAGTCATGGTCATGCCACTGCACTGCAGCCTAAACAACAGAGTGAGACCCGGTATCAAAAAAAAAAAAAGAAGAAGAAGAAGAA","GGCAGGGCACAGTGGCTCACACCTGTAATCCTAGCATCTTGGTAGGCCAAGGAGAGAGGATAGCTTCATATCAGGAGTTCGAGACCAGCCTGGGCAACAGAGTGAGACCCTGTCTCTAAAAAAAAAAAAAAAAAAAAAAAAAAATTAAATTAGCCGGGCGTGGTTGTGTGGGCCTGTAGTCCCAGCTACTTGGGAGGCTGAGGTGAGAGAATCACCTGAGCCCACGAGGTCGAGGCTGCAGTGAGTTATGATCATGCCATTGCACTCCAGTCTGAGCAACAGAGTGAGACCCTGTCTCCAAAAAAAAAAAAAAAAAAGAGAGAA"
"chr1","22742482","22742764","chr5","69395086","69395381","86","46652604","TTGGGAGGCTGAGGTGGGAGGATCACTTGAGGTCAGGAGTTTGAGACCAGCCTGGGCAACTTAGTGAGTCCCCTCTACAAAAAATAAAAAACTAGCTGGGCATGGTGGCATATACCTTTAGTCCTAGCTACTCAGGAGGCTGAGGTGGGGGGATCGCTTGAGCCCAGGAGGTCAAGGCTGCAGCAGTGAACTATGATTGCTTCTGCGAATAGCCATTGCACTCCACTCCAGCCTAAGCAACACAGTGAGACACTCGGAAGAAAGAGAGAAAGGAAGGAAGGAA","GGGGCCAAGGCAGGAGGATCACTTGAGTCCAGGAGTTTGAGACCAGCCTGGTCAACATAATGAGACCCTATCTCTACAAAAAATTTTAAAAAGTAGCTGAGCATTGTGATGTGTGCCTGTAGTCCTGGCTACTGGAGAGGATGAGGTGGGAGGATCGCTTGACCCAGGAGGTTGAGGCTGCAGTGAGCTATCATTGTGCCACTGCATTCCAGCTGGGTGACAGACTGAGACCCACACCCTAAACAAACAAACAAACAAACAAACAAAAAAAAAAAGAAAAGAAAAAGAAAGAGAAA"
"chr1","22742894","22743191","chr2A","88638728","88639031","73","65895834","GGCCAGGTGTAGGGGCTCATGCTTGTACTCCCACTGTTTCAGGAGGCTGAGGTTGAAGGACCGTTTGAGCCCAGGAGTTCAAGACCAGCCTGGGCAACATAGTGAGACTCGATCTCTACTAAAAATTTAAAAATTAGCTGGGCGTGGTGGCACAAGCCTGTAGTCCCAGCTACTCAGGAGGCTGAAGTGGGAGGATCGCTTGAGCCAAGGAAGTTGAGGCTGCAGTGAGCCATGATAAGACCACTGCACTCCAACCTGAGTGACAGAGTATGAGACCCTGTCTCAGAAAAAAAAAAAA","GGTGCAGTGGCTCATGCCTGTAATTCCAGCGCTTTGGGAGGCAAAGGTGGGAGGACTGCTTGAGCCCAGGAGTTTGAAACCAGCCTGGGCAACATAGGGAGACTTCATCTGTATAAATAAATAAATAAATAAATAAATAAATAAGCTGGGCATGGTGGCATGCACCTGTGGTCCCAGCTACTTGAGAGGCTAAGGTGGGAGGATCACTTGAGCCCAGGAGGTTGAGGCTGCAATGAGTCATGATCACGCCACCACACTCCAGCCTGAGCTACAGAGTGAGGTCTTGTCTCAAAAAAAAAAAAAA"
"chr1","22757580","22757877","chr7_NW_019937272v1_random","2134063","2134360","71","20623517","GACCAGGCGTGGTGCCTCATGCCTATAATCTCAACACTTTGGGAGGCTGAGGCAGGTGGATTGCTTGAAGCCGGGAGTTCAAGACCAGCCTGGGTAACATGGCAAGACCCTGTCTCTACAAAAAATAAAAATAAATTAGCCAGGCATGCTGGCACACACCTATAGTCCCAGCTACTTGGGAGCTGAAGTGGGAGAATCGCTTATGCCTGGGGAGTTGAGGCTGCAGCAAACCATGATTGTGCCACTGCACTCCAGCCTGAGTGACATAGTGAGACCCTTTCCCCCCAGCAAAAAAAAA","GCTGGGCTGGTCTTGCACCTATAATCTCAGCACTTTGGGAGGCCGAGGCAGGAGGATCACTTGAGCCTGGAAGTTCAAGACCGGCCTGGGCAACATAGCAAGACCTTATTTCTAAAAAAAAAAAAAAAAAAAAAAAAATTAGCCAGGCATGGTGGCATGCACCTGTAGTCCCAGCTACTCAGCAGGCTGAGGTGGGAGGATCACTTGAGCCAGGGAGGTCAAGGCTGCAGTGAGCCATGATCATGCCGCTGCACTCCAAACTGGGGGACAGAATGAGACCCTATATCAAAAAAAAAAA"
"chr1","22768405","22768711","chr9","68878569","68878883","69","46110164","GGCCAGGCACAGTGGCTCACACCTGTAATCCCAGCACTTTGGGAGGCCGAGGTGGGAGGATCACATGAGACCAAGAGTTCAAGACCAGCATGGGGAACATAGCTAGACCCCAGTCTCTACTAAATAAATAAATAAGCAAGCAAGCAGGGCATGGTGATCACACGTGTAGTCCCAGCTTCTCAGGAGGCTGAGGTGGGAGGATCAGTTGAGCCCTGGAGGTTGAGGCTGCAGTGAGTCATGCTGCCACTGCACTCTGGCCTAGGTAACAGAGAGAGATCCTGTCTCCATTAAAAAAAAAAAAAGAAGA","GGCTGGGCACGGCAGCTCATGTCTGTAATCCCAGCACTTTGGGAGGCCAAGGTGGGAGGATTGCTTGAGTCCAGGAGTTCAAGACCAGCCTGGGCAACATAGTGAAACCCCAGTCTCTACAAATAAATAAATAAATAAATAAATAATTAGCTGGGCATGTTGATGCATGCCTGTAGTCCTAGCTACTCGGGGGGTGAGGTGAGAGGATTGCTTGAGTCCAGAAGGTGGAGGCTGCAGTGAGCTATGATCACACCACTGCACTCCAGCCTGGAAGACAGGGTGAGACGCTGTCTTTAAAAAAAAAAAAAGAAAAGA"
"chr1","22803755","22803929","chr2A","60286019","60286209","73","37482264","ATATATAAATTAGCTGGGGTGTGACGATGCATGTTTGTGGTTCCAGCTACTAGGGAGGCTGAGGTGGGAAGATCACTTGAGCCTAGGGGTTCTAGGCTGCAGTGAGCTGTGATTGCACCAGTGCACTCCAGCCTGGGCAACAGAGTGAGACCCTGTCTCAAGAGAAAAAAAAAAA","AAAATTAGCCAGGTGTGATGGCACCTGTAGTCCTAGCTACTTGGGAGGCTAAGGTGGGAAGAGGGCTTGAGCCCAAGATTGTGAGGCTGTGGTGAGTCATGACTGTGCCATTGCCCTCTGGCCTGGGTGACAGAGTGAGAAGCTGTCTCAAATAAATAAATAAATAAATAAATAAATAAAAATAAACAAAA"
"chr1","22899711","22900011","chr7_NW_019937272v1_random","2134063","2134360","68","20765648","GGCCAGGTGCCATGGTTCATGCCTGTATTCCCAGCACTTTGGGAGGCTGAGGTGGGAGGATCACTTGAGTCCAGGAGTTCGAGACCAGCCTGGGCAACATAGCAAAACCCCATATCTACAAAAAATGTAAAAATTAGCCAGGCATGGTGGCACACACCTGTAGTCCCAAGCTACTCAGGAGGCTGAGGTGAGAGGATCATTCAAGCCCAGGAGGTCAAGGCTGCAGTGAACCATGGTCTCACCACTGCACTCCAGCCTGGGTGACAGAGTGAGACCCTGTCCCAAGAAAAATGAAAAATAA","GCTGGGCTGGTCTTGCACCTATAATCTCAGCACTTTGGGAGGCCGAGGCAGGAGGATCACTTGAGCCTGGAAGTTCAAGACCGGCCTGGGCAACATAGCAAGACCTTATTTCTAAAAAAAAAAAAAAAAAAAAAAAAATTAGCCAGGCATGGTGGCATGCACCTGTAGTCCCAGCTACTCAGCAGGCTGAGGTGGGAGGATCACTTGAGCCAGGGAGGTCAAGGCTGCAGTGAGCCATGATCATGCCGCTGCACTCCAAACTGGGGGACAGAATGAGACCCTATATCAAAAAAAAAAA"
"chr1","22940174","22940359","chr8","53067733","53067939","70","30127559","GGCCAGACACAATGGCATATGTCTGTAATCCCAGCACTTTGACAGGCCAAGGCCCAGGAGTTTGAGACCAGCCTAGGCCACATAGTGAGACCCTGTGTCTAGAAAATTAAAAAAAAATTTAGCTGGGTGTGGTGATGCACACCTGTGGTCCCAGCTATTAGGAAGTCTAAGGTGGGAGGACTGCTT","GGTTGGGCACAGTGGCTTATGGCTCTAATTCCAGCATTTTGAGAGGCTGCTTGAGGCCAGGAGTTTGAGACAAGCCTGAGCAACACAGCGAGACCGTGTCTCTACAAACAAAACCAAAAACCAAAAACCAAAAAACAAACTACCCTGGTGTGGTGGCGCCTGTAGTCCCTGCTACTTGGGAGGCTGAGGTGAGAGGGATGCTTAAGC"
"chr1","22949023","22949319","chr9","57029965","57030284","73","34080942","GCTGGGCATGGTGGTTCATGCCTGTAATCGCAGTACTTTGGGAGGCTGAGGCAGGAGGATCACTTGAGCCCAGGAGTTCGAGACCAGCCTGGGCAACATAGCAAGACCCAGTCTCTACAAAAAAATTTTAAAATTTTAGCCAGGCATGGTGGTGCCCACCTGTAGTCCCAACTACTCAGGAGGCTGGCGTGAGAGGAACGCATAAGCCTGAGGTTGAGGCTGCAGTGAGCTGCAGCTGCACCATTGCACTCCAGCCCGAGTGACAGAGTAAAACCCTATCAAAAAAAAAAAAAAAAA","GGCTGGGCATGGTGGTTCATGCGTGTAGTCCCAGCACTTTTTCAGGCCAACGTAGGAGGATCACTTGAGGCCTGGAGTTTGAGACCAGCCTGGGCAACAAAGGGAGACCTTGTCTTTACAAATAAATAAATAAATAAATAAATAAAAATTTAGCTGGGCATGGTGGTGCACACCTGTGGTCTCAGCTACTCAGGAGGCTGATGTGGGAGGATCACTTGAGCCCCAGAAGTTTGAGGCTTGCGGTGAGCTATGATCATACCACAGCACTCCAGCCTGGGTGACAGAGCAAAACCCTGTCTCTAAAATTAAAAAAAAAAAAA"
"chr1","22958150","22958384","chr12","71868675","71868924","72","48910525","GGCCAGGCTCAGTGGCTCATGCCTGTCACCCCAGTGCTTTGGGAGGCCGAGGTGGGAGGATCACTCGAGCCCAGTAATTCTAAGCCAGTCTGGGCAACATAGTAAGACCCCGTCTCTAAAAATTTTAAAAAATAGCCCAGGCATGGTGGTACACACTTGTAGTCTTAGCTACTCGGGAGGCTGAGGTGGGAGGATCACTTGAGCCCAGGAGTTGAAGGCTGCACCGAGCTATGAT","GCCAGGCATGGTGATTCGCGCTTGTGATTCCAATGCTTTGGGATGCCGAGGTGGGTGGATCACCTGAGGCCAGGAGTTCAAGACCCGCCTAGGCAGAAAAGCAAGATGTCATCTCTAACAACAACAACAACAACAACAACAAAAAGTTAGCCAGGCATGGTGGTATGCACCTATAGTCCCAGCTACTTGGGAGGCAAAGGCGAGAAGATCACTTGAGCCCAGGAGTTCAAGGCAGCAGTGAGATATGATC"
"chr1","22970558","22970830","chr3","9052682","9052970","74","13917876","AGAACTCTGGGAGGCCGAGGCAGGAGGATCACTTGAGTCCAGGAGTTCAAGACCAGGCTGGGCAACATAGCAAGACTCTGCCTGTACAAAAAAATAGAAAAAAATTGCCAGGCATGCTGGCATGCACCTGTAGTCCCAGCTACTTGGAAGGCTGAGGTGTGAGGATTGCTTGAGCCCAGGAATTAGAGGCCGTAGTGAGCTATGATCATGCCACTGCACTCCAGCCTGGGCAACAGCGCAAGACCCTGTCTCAAAAAAAAAAAAAAAAAACAA","ACTTTGGGAGGCTGAGTCGGGAGGATTACTTGACACCAGGAGTTCAAGACCACCTGGGTAACATAGTGAAAACTTCTCTTAACAAAAAAAAAAAAAAAAAAAAAAAAAAAATTAGCCAGCCATAGTGGTGCATGCCTGTGGTCTCAGCTACTCAGGAGGCTGAGACAGGAGGATCACTTGAGCCCAGAACTTCAAGGCTGCAGTAAGCCCTGATTATGCCACTGCACTCCAGCATGGGCAACAGAGCAAGACCTTGTCTCAAAAAAAAAAAAGAAAAAACAGGAGAAAA"
"chr1","22973505","22973529","chr20","87144","87254","88","22886361","TGTTCTTGTCTTTAAAAAAAAAAAA","CCTGGGCAACATAGTGAGACTACATCTCTACACTCACGCACACACACACACACACACACACACCCCCCAAATTAGCCAGGCATGCTGATGTGCACCCATAGTCTCAGCAAC"
"chr1","22973835","22974106","chr12","123567621","123567908","76","100593786","TGGTTTACACTTATAATCCCAGCACTTTGGGAGGCAGAGATGGGAGGATCACTTGAGGCCAAGAGTTTAAGACTAGCCTGGGCAAAAAAGGGAGACCCCCATCTGTACCAAAAGCAATTAAAAAATAATAATTAGCTGGGCATAGTAGTGCATGCTTGTAGTCTCAGATACTCAGGAGGCTGAGGCAGGAGGGTCGCTTGAGCCCAGGAGTTGGAGGCTGCAGTGAGTTTTGATTGCACCGCTGCACTCCAGCCTAGGTGACAGAGCACAAC","GCATGGTGGCTCAAACTTGCAATCCCAGCACTTTATGGGGCTGAGGTGGGAGGGTCACTTGAAGCCAAGAGTTCAAGACTAGCCTGGGCAGCATAGTGAGACCCCCATCTCTACAAAAAAAAAAAAAAAAAAAAAAAAAAAAACTAAGCTGGAGCATGGTGGCATGCACCTATAGTCCTAGCTACTGGAGAGGCCGAGGTGGGAGGATCTCTTGAGCCCAGAAGCTCGAGGCTGCAGTGAGCTGTGTTTGTGCCACTGTACTCCAACCTGGGCAACAGAGTGAAATCC"
"chr1","22978752","22978898","chr19","6391716","6391877","45","16587036","GACCAGGCACAGTGGCTCACGCCTGTAATCTCAATACTTTGAGAGGCTGAAGCAGGTGGATCACTTGAGGCCATGAGCTCCAGACCAGCCTAGGCAACACAGGGGAGACTCTGTCTCTATACAACATTTTTTTAAAAAAACAAAATT","CCAGGCGCAATGGCTCACGCCTGTAATCCCAACACTTTGAGAGGCCGAGGCAAGAGGATTGCTTGAGGCCAGGAGTCCGAGACCAGCCTGGGCAACACAGCGAGGCCTCATTCTCTACAAAAAATAAATATATAAATAAATAAATAAATAAGAAGAAGAAAA"
"chr1","22979216","22979413","chr19","13525969","13526165","76","9453247","CAAAAAAAAGAAACAACAAAATTAGCCAGGCGTGGTGGCGCATGCCTGTAGTCCCAGCTACTCAAGGAAGCTAATGAGTGAGGATCACTTGAGCCTAGGAGGTCAAGGCTTCAGTGAACCATGAGCACGCCACTGCAATCCAGCCAGGGTAGCAGAAGAAAACCTGTTTCCAAAAATAAAAATAAATTAAAAATAAAA","AAGAAATAAATTAGTTGAGCATGGTGGTGCATGCCTATAGTCCCAGCTACTGGGGAGGCCAAAGTGGGAGGATTGTGTGAGCCCAGGAGTTTGAGGCTGCAATGAGCCAAGATTATGCACACCAGTGTGGGAGACAGTCAAGTCTCAAAAAATAAACAACAACAACAACAACAACAACAAACACATAAAAAGAAAAA"
"chr1","23014542","23014811","chr3","9052682","9052970","82","13961860","AGGAGGGAGAATTGCTTGAGGCTAGGAGTTTGAGACCAGCCTGGGCAATATAGCAAGACCTTGTCTCTAAAAAAATAATTTTTTTTTTTAATTAGCTGGGCATAGTGGCACATGCCTGTAGTCTTAGCTACTCAGGAGGCTGAGGCAGGAGGATCACTTGAGCCCAGGAGTTGGAGGCTTCAGTGAGCCACAATCACACCACTGCACTCCAACCTGGGCAACACAGTGAGACCTTGTCTCAAAAATAAAATAAAATAATAATAAATAAAA","ACTTTGGGAGGCTGAGTCGGGAGGATTACTTGACACCAGGAGTTCAAGACCACCTGGGTAACATAGTGAAAACTTCTCTTAACAAAAAAAAAAAAAAAAAAAAAAAAAAAATTAGCCAGCCATAGTGGTGCATGCCTGTGGTCTCAGCTACTCAGGAGGCTGAGACAGGAGGATCACTTGAGCCCAGAACTTCAAGGCTGCAGTAAGCCCTGATTATGCCACTGCACTCCAGCATGGGCAACAGAGCAAGACCTTGTCTCAAAAAAAAAAAAGAAAAAACAGGAGAAAA"
"chr1","23058500","23058643","chr18","55799233","55799394","63","32740733","GGGCAAGCTGGCTAATGCCCACAACCTCAACCTTCTGGAAGGCTAAGGCAGAAGAATCTCTTGAGGCCAGGAGTTCAACATCAGCCTGGGCAACAGAGCAAGACCCTGTTTCTATTAAAAACAAACAAGGCCGGGCGTTGTGGC","GGCTGAGAGAGGTGGCTCATGCTTGTAATCCCAGCACATTGGGAGGCAAAGGTGGGAAGATTGCTTGAGGCCAGGAGTTCAAGACCAGCCTGGGCAACATGAAAACACTTTGTCTCTACAATAAATAAATAAATAAATAAATAAATAAAAGAAACAAGAAAA"
"chr1","23063895","23064189","chr8","25360790","25361095","70","2296895","GGCTGGGAGCAGTGGCTCACATCTATAAATCCCAGCACTGTGGGAGGCTGAAGCAGGAGGATCACTTGAGCCCAGGAGTTTGAGACCAGCCTGGGCAATATAGTGAGACTCCATTTCTACAAAAAATTATTTTAAATTAGCCAGGTGTAGGGGTGTGTGCCTGTGGTCCCAGCTACTCACGAGGCTGAGGGGGAGAATCACTTTAGCCCAGGAGGGCAAGGCAACAGTGAGCCATGTTTGTGCCACTGCACTTCAGCCTGGGCAACACTGCAAGATCTGTCTCCAAAAACAAAAA","GGCTGGGAGCAGTGGCTCATACCTGTAAGCCCAGCACTTTGGGAGGCTGAGGTGGGAGGATTGCTGAAGCCCAGGAGTTTGAGACCAACCTGGGCAATGTAGGGAGACCCCGTCTCTACTAAATAAATAAATAAATAAATAAATAAAGTCGGGCATGGTGGCATGTGCCCTGTAGTCCCAGCTTCTTGGGAGGCTGAGGTGGGAGGATTGCTTGGGCCCAGGAATCAAGGCTGCAGTGAGCTGTGATTGTGCCACTGTACTACAGCCTGGGTGACAGTGCAAGACTGTCTCAAAAGAAAAACAAAA"
"chr1","23102678","23102795","chr20","87144","87254","64","23015534","GGCAGGGCATGGTAGCTCATGCCTGTAATCCCAGCACTTTGGTAAGATGAGCGGGGAGGATTGCTTGAGGCCAGGAGTTCAAGGCCAGTCTTGGCAATACTGCAAGACCCTGTCTCTA","CCTGGGCAACATAGTGAGACTACATCTCTACACTCACGCACACACACACACACACACACACACCCCCCAAATTAGCCAGGCATGCTGATGTGCACCCATAGTCTCAGCAAC"
"chr1","23102887","23102902","chr20","87144","87254","95","23015743","ATAAAATAAAATAAAA","CCTGGGCAACATAGTGAGACTACATCTCTACACTCACGCACACACACACACACACACACACACCCCCCAAATTAGCCAGGCATGCTGATGTGCACCCATAGTCTCAGCAAC"
"chr1","23102950","23103244","chr8","25360790","25361095","81","2257840","GGCCAGGGGCGGTGGCTCGCGTCTGTAATCCCAGTACTTTAGAAGGCTCGAAGGGCGAAGTGGGAGGATGGCTTGAGTCCAGGAGTTTGGGACCAGCCTGGTCAGCATAGAGACCCCTTCTCTACAAAAAAAAAAAATGAGAAAAATTAGCCAGGCATGGTGGCATGTGTCTGAGTCCCAGCTGCTTGGGAGACTTAAGGTGGGAGGATTGCTTGAGGCTAGAAGGTAGAAGCTGCAGTGAGCTGTGATTGCTCCACTGCATGACAGCCTGGTAGACCCTGTCTCAATAAAAAAA","GGCTGGGAGCAGTGGCTCATACCTGTAAGCCCAGCACTTTGGGAGGCTGAGGTGGGAGGATTGCTGAAGCCCAGGAGTTTGAGACCAACCTGGGCAATGTAGGGAGACCCCGTCTCTACTAAATAAATAAATAAATAAATAAATAAAGTCGGGCATGGTGGCATGTGCCCTGTAGTCCCAGCTTCTTGGGAGGCTGAGGTGGGAGGATTGCTTGGGCCCAGGAATCAAGGCTGCAGTGAGCTGTGATTGTGCCACTGTACTACAGCCTGGGTGACAGTGCAAGACTGTCTCAAAAGAAAAACAAAA"
"chr1","23110808","23110896","chr20","87144","87254","60","23023664","CTTTGGGAGGCCAAGGTGTGAAGATTGCTTGAGGTCACGAGTTTCAGACCAGCCTGGGTGACATAGTGTGACCCCATCACTACAAAAAA","CCTGGGCAACATAGTGAGACTACATCTCTACACTCACGCACACACACACACACACACACACACCCCCCAAATTAGCCAGGCATGCTGATGTGCACCCATAGTCTCAGCAAC"
"chr1","23116099","23116371","chr3","83975049","83975347","75","60858950","GGCCAGGTGCAGTGACTCACGCCTACAATCCCAGCACTTTGGGAGGCTGAGATGGGAGGATCACTTGAGCTCAGGAGATCGAGACCAGCCTGGGCAACATAGTGAGACCTTGTCTCTTAAAACAATTTAAAAATTAGCCAGGTGTGGTGGCGTATGCCTGTAGTCCCAGCTACTCGGGTGGCTGAAGTGGGAGGATCACTTGATCTAGGAGACTGAGGCTGCAGTGAGTGGAGCCACTATACTCCAGCCTGGACAGAGTGAGACACTGTTTCA","GGCTGGGTGCAGTGGCTCATGGCTGTAATCCCAGGACTTTGGGAGGCTGAGGCAGGAGAATCACTTGAGGCCAGGAGTTTGAGACCAACCTGGGCAACAAAGTGAGGCATGTCTCTACAAAAACAAAACAAAACAAAACAAAACAATTAGCTGTGTGTGGTGATGCCTGCCTGTCGTCCCAGCTACTCGGGAGGCTGTGGTGGGAGGATCTCTTGAGCCTGGGAGGTTGAGGCTGCAGTGAGCTGTGATTGCCCACTGTACTCTAGCATGGGTTACAGAGCAAGACTCTGTCTCAAAAA"
"chr1","23120383","23120656","chr1","88859712","88859991","69","65739329","GTCAGGCGTAGTGGCTCATGCCTGTAATCCTAGCACTTTGGGAGGTCGAGAGAAGAGGATCGTTTGAGGCCAGGAGTTCAAGACCAGCCTGGGCAACATAGCAAGACCCTGTCTCTACAAAAAAATAAAAATAAAAAAAATTAGCTGGGCATTTTGGTGCACAGATACTTGGGAGGCTGAGGTGGGAGGGTCTCTTGAGCCCAGGAGCTTAAGGCTGCATTAAGCCATGATTGCACCATTGCACTCCTGCCTGGGTGACAGAGAGACCTGTCTC","CCAGGCACAGTGGCTCACACCTGTAATCCCAGCACTTTGGGAGGCCAAGGCAGGAGGATTGCTTGAATCCAGGAGTTTGAGACCAGCCTGGGCAGCATAGTGAGACTTGGCCTCTACAAAAAAAAAAAAAAAAAAAAAAAAAAGTTACCTGGGAAGTCTCAGCTACTTGGAAGGCTGAGGTCGGAAGGTTGCTTGAGTACAGGAGGTCAAGGCTGCAGTGAGCTATGATTGTACCACTGCACTCCAGCGTGGGCAACAGAGTGAGACCTTATCTCAAAAA"
"chr1","23139677","23139966","chrX","16155635","16155942","85","6984042","GTGGTTCACACCTGGAATTCCAACACTTTGAGAGGCTGAAGCAAGAGGATTGCTTGAGGCCAGGAGTTCGAGACCAGCCCTGGCAACATAGCAAGACCTCGTCTCTACAGTGAAATTTTAAAAATTAGCTGGGCTTGGTGGCACGTACCTATAGACCCAACTACTTAGGAGGCTGAGGTGGGAGGATCACTTGAGCCTGGGAGGCTGAGACTGCTGTAAGCTGTGCTCATGCCACTGTATACCAGTCTGGAGGGCAGAGCAAAATTCTGTCTCAAGAAAAAAAAAAAAAA","GGCCAGGCACAGTGGCTCACACCTGTAATCCCGGTACTTTGGGAGGCTGAGGCGGGAGGATCACTTGAGCCCAGGAGTTCAAGACCAGCCTGGGCAACATAACAAGACCCTGTCTCTACCAAAAAAAAAAAAAAAAAAAAAAAAAATAGCCAGGCCTGGTGGCCTGTGTCCATAGTCCCAGCTACTTTGGGAGACTGAGGTGGAAGGATCACTTGAGTCTGGAAATCAAGACTGCTGTGAGCTGTGATCATGCCACTGTACTCCAGCCTGAGCAACAGAGTGAGACCCTGTCTAAAAAAAAAAAAAAA"
"chr1","23141684","23141846","chr18","55799233","55799394","68","32657549","TTAGCTGGGCATTGTGGTGTATGCCTGTGGTCCCAGCTGCCTGGGAGGCTGAGGTGAGAGGATCGCTTGAGCCCAGGAGGTCAAGGCTCCAGTGAACTATGATCTTGCCCCTGCTCTCTAGCCTGGGGGACATTGGGACCCTGTTTCCAAAAAAACACAAAAA","GGCTGAGAGAGGTGGCTCATGCTTGTAATCCCAGCACATTGGGAGGCAAAGGTGGGAAGATTGCTTGAGGCCAGGAGTTCAAGACCAGCCTGGGCAACATGAAAACACTTTGTCTCTACAATAAATAAATAAATAAATAAATAAATAAAAGAAACAAGAAAA"
"chr1","23142145","23142293","chr5","32595015","32595178","51","9452870","GGCTAGGTGTGGTGGTTTATGCCTGTAATCCCAGCACTTTGGGAGTCTAAGGCAGGAGGATTACTTGAGTCCAGGAGTACGAGACCAGCCTGGGCAATGTAGCAAGATCCTGTTTCTACAAAGTATTTTTAAAAATTAGCTGGGCTTTT","GGCCGGGTGTGGTCCCTCATGCCTGTAATCCCAACACTTTGGGAGGCTGAGATAGGAGGACTGCTTGAGGCCAGGAGTTCAAGACCAGCCTGGTCAACATAGTGAGACCCCATCTCTATAAAATAATAATAATAATAATAATAATAATAATAAATAAATAAATA"
"chr1","23154278","23154537","chr10","96412023","96412287","75","73257745","TCACAGAACTTTGGGAGGCCACAGTGGGAGGATCATTTGAGGCCAAGAGTTCAACACCAGCCTGGGCAACATAGCCAGACCCCCATCTCTACAAAAAAAAAATTTTTTTTTAATTACCAGGCATGGTGGTTTGTGCCTGTAGTCCCAGCTACTTGGGGAGGCTGAGGTGGAAGGACTGCTTGAGCCTGGGAGATCAAGGCTGCAGTGAGTCATGATCACATACTGCATTCCAGCCTAGGGAACAGAGTAAGACCCTGTCT","CTTTGAGAGGAAGACGTAGGAGGATTGCTTGAGCCCAGCAGTTTGAGACTAGCCTGGGCAACATAGGAAGACTCCCATCTCTACACACACACACACACACACACACACACAATTATCCAGGGTGGTGGTGCATGCCTGTGGTCCCAGCTACTTGGGAGGTTGAGGTGGGAGGATTGCTTGAGCCCAGGAGGTCCAGGCTGTAGTGAGCCATGATCATACCGCTGCACTCCAGCCTGGGCAACAGAGTGAGACCCTGTCTCAAAAA"
"chr1","23172377","23172505","chr9","47045786","47045941","50","23873409","GGCCAGGCGCAGTGGCTCACACCTGTAATCCCAGTGCTTTGGGTGGCCAAGGTGGGAAGATTACTTGAGACCAGGAGTTTGAGACCAACCTGGGCAACATAGTGAGACCCCTGTCTTTACAAAAAAAAA","GCTGGGCGCAGCAGCTCACACCTGTAATCCCAGTGCTTTGGAGGTCCAAGGTAGGAGGATTGCTTAAGACTAGGTGTTCAAGACCAGTCTTGGCAACATAGTGAGAACTCATCTCTACAATAAATAAATAAATAAATAAATAAATGAAAATAAAAA"
"chr1","23173113","23173279","chr19","6391716","6391877","60","16781397","CAGGCATGGTGGCTCACACCTGTGGTCCTAGTTACTCAGGAGGCTGAGGAGGGAGGATTGCTTGAGCCCAGGAGTTGGAGGCTACAGTGAGCTATGATCTCTGCACTGCACTCCAGCCTGAGTGACAGAGAAAGACACTGTCTCTAAAAAAATAAATAAATAAAAAA","CCAGGCGCAATGGCTCACGCCTGTAATCCCAACACTTTGAGAGGCCGAGGCAAGAGGATTGCTTGAGGCCAGGAGTCCGAGACCAGCCTGGGCAACACAGCGAGGCCTCATTCTCTACAAAAAATAAATATATAAATAAATAAATAAATAAGAAGAAGAAAA"
"chr1","23199127","23199405","chr1","88859712","88859991","70","65660585","GGCGGCTCACACCTGTAATCCCAGCACTTTAGAAGGCCAAGGTGGGAGAATTGCTTGAGTCCAGGAGTTTGAAGACAAGCCTGGACAACATAGGGAGACCCCACCTCTACAAAAAAATTTAAAAATCACTTGGGAGTGGTAGTGTGTATCTGTGGTCCCAGCTACTCAGGAGGCTGAGGTGGGAGGATCACTTAAGCCCAGGAGGTCAAGACTGCAGTGAGCTGTGATCATGCCCCTGCACTCCAGCCTAGGTGACAGAGTGAGACCCTTTCTCAAAAA","CCAGGCACAGTGGCTCACACCTGTAATCCCAGCACTTTGGGAGGCCAAGGCAGGAGGATTGCTTGAATCCAGGAGTTTGAGACCAGCCTGGGCAGCATAGTGAGACTTGGCCTCTACAAAAAAAAAAAAAAAAAAAAAAAAAAGTTACCTGGGAAGTCTCAGCTACTTGGAAGGCTGAGGTCGGAAGGTTGCTTGAGTACAGGAGGTCAAGGCTGCAGTGAGCTATGATTGTACCACTGCACTCCAGCGTGGGCAACAGAGTGAGACCTTATCTCAAAAA"
"chr1","23228329","23228670","chr4","183620088","183620430","82","160391759","GGCCAGGCGCAGTGGCTCACACCTGTAATACCAACACTTTGGGAGGCAGAGCGGGGAGGATTGCCTGAGGCCAGGGGTTCAAGACCAGCTTGGACAACATGGGGAGACCTCATCTCTACAAAAAATAAAAAATTAGCTGGGTGTGGTGGCATGCACCTATATAGTTTTAACTACTCAGGAGGCAGAAGCAGGAGGATCGCTTGAGCCCAGGAGTTAGAGGCTGCAGTGAGCTATGCAGTGAGCTGCAGTTCAAGACCAGCCTGTGTGACAGAGTGAGACCCTATCTCTAAAAAAAAAAAAAAAAAAAAAAAAAAAAAAAAAAAAAAAAAAAAAAAAAAAAAA","GGCCAGGTGCAGTGGCTCATGCCCGTAATCCCAACACTTTGGGAGACCGAGGTGAGAGGATTGCTTGAGCTCAGGAGTTTGAGAACAGCCTGGTCAACATAGTGAGACCTCATTTCTACAAAAAATTGAAAAGAAGTTAGCTTGGCATGATGGTTTGTGCCTAAAGTCCCAGCTACTCAGGAGGCTGAGGTGAGAAGAGTTCTGGAGACTGGAAGTCTGAGGCTGCAGTGAGCTATGATCATGTACTAAATTCCAGCCTGGTGACAGAGTGAGACCCTGTCTCAAAACAAACAAACAAACAAACAAAAAAAAAACAAAAAACAAGAAGAAGAAAGAAAAGAAA"
"chr1","23237086","23237257","chr14","51003183","51003398","79","27766097","TTAAAATTAAAATTAAATAATTAGCCAGGTGTAGTGGTGCACACCTGTAGTACTAGCTCCTCAGGAGGGTGGGGTTGAGCCCAGGAGTTTAAGGCTGCAGTGAGCTATGATCGTGCTACTGCATTGCAGCCTGGGTGACAGAATGAGATCTTGCCTATTAAAAGAAAGAAAA","AGCCTGGGCAAGATAGTGAGACCTCATCTCTTAAAATAAATAAATAAATAAATAAATAGCAGGATGTGGTGGCGTGCATCTGTAGTCCCAGCTACTCAGGAGGCTGAGATGGGAGGATTACTTGAGCTCAGGAGGTCGAGGCTGCAGTGAGCTATGATCACGCCACTGTACTCCAGCCTGGGTGAGAGTGATACCCTGTCTCTAACAAAAAAAAAA"
"chr1","23237527","23237654","chr1","217544386","217544536","63","194306859","GGCTAGGCACAGTGGCTCACGCCTGTAATTCTAACACACTGGGAGGCTAAGACAGGAGGATCATTTGAGGCCAGCAATATGAGATCATTTGGGGCAATATAGAGAGACCTATCTCTTAAAAAAAAAAT","GGCTGGGCGTGGTGGCTCATGCCTCTAATCCCAGCACTTTAGGAGGCCAAGGCAGGAGGATAACTTAAGACCAGGCTGGGTGACACAGTGAGACTTTGTCTCTAAAAAAAAAAAAAAAAAAAAAAAAAAAAAAAACCTACAAAAACATATA"
"chr1","23238229","23238394","chr9","47045786","47045941","57","23807557","GCTGGGCATGGTGGCTCACTCCCGTAATCCCAGCAGTTTGGTAGGCCAAGGTGGGAGGATTGCTTGAGCCCAGGAGTTCAAGGCTACAGTGAGCTATGATTGTGCCACTGCACTCCAGCCTGGGTGACAGAGCAAGACCCTGTCTCAGAAAAAGATAAAAGAAAAA","GCTGGGCGCAGCAGCTCACACCTGTAATCCCAGTGCTTTGGAGGTCCAAGGTAGGAGGATTGCTTAAGACTAGGTGTTCAAGACCAGTCTTGGCAACATAGTGAGAACTCATCTCTACAATAAATAAATAAATAAATAAATAAATGAAAATAAAAA"
"chr1","23239754","23239978","chr7","137245286","137245521","62","114005532","CCTGGACAACACAGTGAGACCCCTCTGTCTCAAAAAAAAAAAAAAAATTAGTGGGGCATGGTGGAGTACGCCTGTAGTCCCAGTCACTCAGGAGGTTGAGGTGGGAGGCTGACTTGAGCCCAGGAATTCAAGGTTACAGTGAGCTATGATTGTGCCACTGCACTCCAGCCTGGACAACAGAGCCAGATGCTGTCTCTAAATAAATAAATAAAAAGGTACAAAAAA","AGCCTGGGCAATATAGTGAGACTCTGTCTCTACAAAATAAATAAATAAATAAATAAATAAAATTAGCCAGATGTGGTGGTGCATGCCTGTAGTCCCAGCTACTAGTGAGGCTGAGGTGGGAGGATCACTTGAGTTCGGGAAGTCGAGGTTGCAGTGAGATATGATCATGCCACTGCACTCCAGCCTGGATGACAGAGTGAGACCCTGCCTCAAAAAAATTAAAAAAGAAAAGAAAA"
"chr1","23248970","23249288","chr14","31798968","31799292","78","8549998","GCCAGGTACAGTGGCTCACACCTGTAATCCCAACACTTTGGGAGGCCAAGGTGGGAAGATACTTGAGCTCAGGAGTTCAAGACCAGCCTGGGCAACAAACACAGCAAAACCCTGTCTTTACAAAAAATTTTAAAAATTAGCCAGACATAATGGTGCACACCTGTAGTTCCAGCTACTCAGGAGGCCGAGGTGAGAGGATTGCTTGAGCCCAGGAATTTTAGGCGGCAGTGAGCTTTGATCAACCGTGCCACTGCGCTCCAGCCTGGGTAACAAAATGAGACCCTGTCTCTAAAAAAAAAAAAATAAAATAAATAAAGAA","GGCTGGGCACAGTAGCTTACACCTGTAATCCCAGTACTTTGGAAGGCTGAAGTGGGAGGATCCCTTGAGGCCAGGAGTTTGAGACCAGCCTGGGCAACATAGTGAGACCCTGTCTCTACAACAAACAAACAAACAAACAAACAAAACTTAGCCAGTTGTGGTGGCACATCCTATAGTCCCAGCTACTCAGGAGGCTGAGGAGGGAGGATCTCTTGAGCCCAGGAGTTTGAGGCTGCAGTGAGCTATGATCATGACACTGCACTCCAGCCTGGATAACACAGCAAAATCCTGTCTCAAAAAAAAAAAAAAAAAAAAAAAAAAAGAA"
"chr1","23262658","23262760","chr20","87144","87254","61","23175514","GGCTGTGTGTGGTGACTCATGCCTGTAATCTCAGCACTTTGGCAGGTTCACTTGAGGCTAGGAATTCAAGACCAGTCCGGGCAACACAGTGAGCCCCGACTCT","CCTGGGCAACATAGTGAGACTACATCTCTACACTCACGCACACACACACACACACACACACACCCCCCAAATTAGCCAGGCATGCTGATGTGCACCCATAGTCTCAGCAAC"
"chr1","23263030","23263195","chr18","55799233","55799394","74","32536203","TTATCAGACATAGTAGTGGCTCCCGTCTGCAGTCCCAGCTACTTGGGAAGCTTAGGTGGAAGGATCCCTTGAGCCCAGGAATTGGAGGTTGCAATGAGCCATGGTTGAGCCACTGCACTCCAGCCTTGGGGTGACAGAGCAAGACCCCCTCTCTAAAAAAAAAAAA","GGCTGAGAGAGGTGGCTCATGCTTGTAATCCCAGCACATTGGGAGGCAAAGGTGGGAAGATTGCTTGAGGCCAGGAGTTCAAGACCAGCCTGGGCAACATGAAAACACTTTGTCTCTACAATAAATAAATAAATAAATAAATAAATAAAAGAAACAAGAAAA"
"chr1","23267870","23268180","chr9","68878569","68878883","74","45610699","GGTCAGGCACAGTGGCTCACACCTGTAATCCCAGCACTTTGGGAGGCCAAGGCAGGTGGATTGCTTGAGGCCAGGAGTTCAAGACGAGTCTGGGCAACATAAGGAGACCCCATCGCTACCAAAAAAAAAAAAAAAAGAATTAGCCTGGCATGGTGATGCACGTCTGCATTCCCAGCTACTTGCGAGGCTAAGGAAGGAGGATCCCTTGAACCCAGGAGTTCGAGGATACAATGAACTGTGATTGCAACACTAGACCCCAGGCTGGACCACAGAGTGAGACCCCTATCGCTTACAAAAAAAAAAAAAAAAAA","GGCTGGGCACGGCAGCTCATGTCTGTAATCCCAGCACTTTGGGAGGCCAAGGTGGGAGGATTGCTTGAGTCCAGGAGTTCAAGACCAGCCTGGGCAACATAGTGAAACCCCAGTCTCTACAAATAAATAAATAAATAAATAAATAATTAGCTGGGCATGTTGATGCATGCCTGTAGTCCTAGCTACTCGGGGGGTGAGGTGAGAGGATTGCTTGAGTCCAGAAGGTGGAGGCTGCAGTGAGCTATGATCACACCACTGCACTCCAGCCTGGAAGACAGGGTGAGACGCTGTCTTTAAAAAAAAAAAAAGAAAAGA"
"chr1","23275238","23275510","chr8","37744776","37745066","77","14469538","GCTGGATGTGGTGGCTCACACCTGTAATCCCAACACTTTCAGAGGCTAAGGTGGGCAGATCGCTTGAGGCCAGGAGATCAAAACCAGCCTGGGCAACAAAGTGAGATGGCATCTCTACATAAAATTAAAAATTTGCTGGGCGTGGAGGCGCGTGCCTGAGGTCCCAGCTACTTGGGGGGCTGAGGTGGGAGGATCGTTTGAGCCCAAGAGGTGGAGGCTGCAGTGATCTATGATCACCCCACTGCACTCCAGCCTGGGCAATAGAGCAAGACC","GGCTGGGTGAGGTAGCTCACGCCTGTAATCCCAGAGCTCTGGGAGGCTGAGGCAGGAGGATTGCTTGAGGCCAGGAGTTCAAGACCATCCTGGGCAACATAGGGAGACCCCCACCTCTACAAAAACAAACAAACAAACAAACAAAAAAACAAACCTGGACATGGTGGTGCTGCCTTTAGTCCTAGCTACCGGGGAGCTGAGTTGGGAGGATTGCTTGAGCCCAGGAGGTGGAGGCTGCAGTGAGCTGCGATTATACCACTGTACTCCAGCCTGGGTGATAGAGCAAGACTC"
"chr1","23278045","23278335","chr8","15910614","15910909","71","7367431","GGCTGGGTGCGGTGGCTAACACCTGTAATCCCAGCACTTTGGGAGGCCAAGGTAGGAGAATCGCTTGAGCTCAGGAGTTCAAGACCAGCCTGGGCAACAATAGTGAGACCTCGTCTCTACAAAAAAATTTAAAAATTAGCCAGGCATGGTGGCACACACTTGTAGTCCCAGCTGCTCGGGAGGCTGAGGTGGGAGGACTGCTTGAGCCCAGCAGATCGACAGGTTGAGGCTTCAGTGAGCTGTGGTTGTGCCACTGCATTCCAGCCTGGGTGACAGAGGAAGACCATGTCT","GGCCAGGCGAAGTGGCTCACACCTGTAATCCCAGCACTTTGGGAGGCCAAGGCAGGAGGATCATTTGAAGCCAGGAGTTCAAGGCCAGCCAGAGAAACATAGTGAGAACCTGTCTTTACAAAAATTAAAATTAAAATTAAAATTAGCCAGGAGTGGTGGTGCATGCCTGCAGTCCCAGCAGCTCAGGAGGCTGAGGTGGGATGATTGCTTGCACCAGGAGTTCGAGGCTGCAGTGAGCTGTGATCGTGCCACTGCACTCCAGCCCCTGGGTGACAAAGCAAGATCCTCTAAAAAAA"
"chr1","23346329","23346433","chr20","87144","87254","64","23259185","CGCCTGTAATCTCAGCACTTTGGGAGGCCGAAGCAGAAGGATCATTTGAGGCCAGGAATTCAAGACCGGCCAAGACCGGCCTGGGCAACATAGCGAGATTCCCTC","CCTGGGCAACATAGTGAGACTACATCTCTACACTCACGCACACACACACACACACACACACACCCCCCAAATTAGCCAGGCATGCTGATGTGCACCCATAGTCTCAGCAAC"
"chr1","23352332","23352479","chr18","55799233","55799394","55","32446901","GCTGGGCGTGGTGACTCATGCCTGTAATCCCAGCACTTTGGGAGGCTGAGGTGGGAAGATCACTTGAGCCCAGGAGTTCAAGGCTGCAATAAGCCTTGATTGTACCACTGCAGCCTGGATGACAGAGTGAGTCCCTGTTTCAAAAGAA","GGCTGAGAGAGGTGGCTCATGCTTGTAATCCCAGCACATTGGGAGGCAAAGGTGGGAAGATTGCTTGAGGCCAGGAGTTCAAGACCAGCCTGGGCAACATGAAAACACTTTGTCTCTACAATAAATAAATAAATAAATAAATAAATAAAAGAAACAAGAAAA"
"chr1","23363758","23364053","chr8","15910614","15910909","72","7453144","GGCCAGGTGCCGTGGCTCACGCATGTAATCCTAACACTTTAGGAGGCCAAGTCAGGAGGAACACTTAAGGCCAGGAGTTCAAGACCAGCCTGGGCAATATAGGGAGAACCCATCTCTACAAAAAAATTTAAAAAATTAGGTGGATGTGGTGGCATGCAACTGTAGTCCCAGCTACTCAGGAGGCTGAGGTAAGAGGATCACTTGAGCCCAGGAGTTCAAGGCTGCAATAAGCTGTGATTGTGCCACCGCACACCAATATGGGTGACAGAACGAGACCCTGTCTCTTAAAAAAAAAA","GGCCAGGCGAAGTGGCTCACACCTGTAATCCCAGCACTTTGGGAGGCCAAGGCAGGAGGATCATTTGAAGCCAGGAGTTCAAGGCCAGCCAGAGAAACATAGTGAGAACCTGTCTTTACAAAAATTAAAATTAAAATTAAAATTAGCCAGGAGTGGTGGTGCATGCCTGCAGTCCCAGCAGCTCAGGAGGCTGAGGTGGGATGATTGCTTGCACCAGGAGTTCGAGGCTGCAGTGAGCTGTGATCGTGCCACTGCACTCCAGCCCCTGGGTGACAAAGCAAGATCCTCTAAAAAAA"
"chr1","23375473","23375611","chr9","47045786","47045941","57","23670313","GGGTGCAGTGGCTCACGCCTGTAATCTCAACACTTTGGGAGGCCCAGGTGGGAGGATCGCTTGAGGTCAGTCAGGAGTTGGAGACCAGGCTTGGTAACATAGGGAGACCCCCCTCGCATGCCCATCTCTACAAAAAAAA","GCTGGGCGCAGCAGCTCACACCTGTAATCCCAGTGCTTTGGAGGTCCAAGGTAGGAGGATTGCTTAAGACTAGGTGTTCAAGACCAGTCTTGGCAACATAGTGAGAACTCATCTCTACAATAAATAAATAAATAAATAAATAAATGAAAATAAAAA"
"chr1","23375891","23376076","chr12","23162528","23162744","71","213363","AAAAAAAAAAAAAATTAGCCAGATGTGGTGGCATGTGCCTGTAGTCCCAGCTACTCAGGAAGCTGAGGTGGGAGGATCACTTAAGCCTAGGAGTTCAAGACTGCAGTGAGCTATGATCACACCACTGCACTCTAGCCCAGGCAACAGAGTCAGACCCTGTCTCTCAAAAAACAAACAAACAAACAA","TCTCTACAGAAAATAATAAAAACTTGGCTGGGCATGGTGGCATGTTCTTGTAGTCTCAGCTACTCAGGAGGCTGAGGTGAGAGGATTGCTTGAGCCCAGAAGGTTGCGTTAGGGTTAGGGTTAGGTTTAGGGTTAAGGTTAGCCATGATTGCACTCTTGCCTGGGCAACAGAGCAAGACCCTGTCTCAAAAAAAAAAAAAAAAAAAAAAAAAAAAAA"
"chr1","23398751","23399067","chr12","108570006","108570305","79","85171255","GGCTGGGTGTGGTGGCTCACACCTGTAATCCCAGCACTTTGGGAGGCCAAGGCAGATGGATTGCTTGAGTCCAGGAGTTTTAGATCAGCCTGGGAAACATGGTGAGATCCCATCTCTGCAAAAAAAGGTAAAAATTAGCCAGGCATGATGGCGTGCTCCTGTGGTCCCAGCTCCTTGGAGGCTAAGGTGGGAGGATTGCCTGAGCCCAGGAGGTCAAGGCTGTAGTGAGCCATGACTGCACCACTGCACTCCAGCCTGGGTGACAGAGAGAGAGAGAGAGACCCTGTCTCAAAAAATAAAATAAATTAATAAAAAGA","GGCAGGGCGTGGTGGCTCACACCTGTAATCCCTGTATTTTGGGAGGCTGAGGCAGGACGATTGCTTGAGGCTAGGAGTTTGAGACCAGTCTGGGCAACATTTAAATAAATAAATAAATAAATAAATAAATAAATAAATCAGCCAGGCATGGTAGCATGAACCTGTAGTCCCAGCTCCTCAGGAGGCTGAGGGAGGATTGCTTGAGCCCAGGAGTTCAAGGTTGCATTGAGCCATGATTGCACCACTGTACTCCAGCCTGGGAAACAGAGTAAGACCCTGTCTCAGAAACAAACAAAAAAA"
"chr1","23412271","23412419","chr2A","60286019","60286209","74","36873748","GCACCCATAGTCCCAGCTACTCAGGAGGCTGAGGTGAGAGGATCACTTGAGCCTAGGAGTTGCAGGCTGCAGTGAGCTGTGATTGCGCCACTGCACTCCAGCCTGGGCAACATGGTGAGACTCTGTCTCAAAAAAAAAAAAAAAAAAAA","AAAATTAGCCAGGTGTGATGGCACCTGTAGTCCTAGCTACTTGGGAGGCTAAGGTGGGAAGAGGGCTTGAGCCCAAGATTGTGAGGCTGTGGTGAGTCATGACTGTGCCATTGCCCTCTGGCCTGGGTGACAGAGTGAGAAGCTGTCTCAAATAAATAAATAAATAAATAAATAAATAAAAATAAACAAAA"
"chr1","23427926","23428075","chr15","37343640","37343763","77","13915714","AAAGATAAAGAGCTGTGCGTGTTGGTGAGAACCTATACTCCAGCTACTCGGGTGGGAGAATTGCTTGAGCCCAGGAGTTCAAGGCTGCAGTGAGCCATGATGGCGCCACTGCACTCCAGCCTGAACAACAGAGCGAGACTCTGTCTCTAA","AAGATCCCTGGCCAGGATTTCAAGACCAGCCTGGGCAACACAGTGAGACCATACATACATACATACATACATACATACATCATACATACATACATACATACATACATACACAGTCTTACAAAGA"
"chr1","23445691","23446001","chr10","125157322","125157641","65","101711631","GGCCAGGTGCAGTGGCTCATGCCTGTAATCCAAGTGCTTTGGGAGGCTGAGGTGGGAGGATCATTTGAGGCCAGGAGTTCAAGACCAGCCTAGGCAACATAGCAAGACCCCGTTTCTACTTTAAAACAAAATTTTAAACCATTATCCAGGCATGGTAGCATGGTCCTGTAAGTCCCAGCGACATGGGAGGCTGAGGTAGGAGGATCACTTGAGCCCAGGAGTTCAAGGCTGCAGTGAGCCATGATTGCACCACTGCACCCCAGCCTGGGCAACAGAGTAGACTCTGTCTCAAGAAAAAAAAAAAAGAAGAA","GGCTGGGTGCAGTGGCTCATGCCAGCAATCCCAGCCCTTTGGGAGGCTGAGGTGAGCAGATCGCTTGAGCCCAGGAGTTTGAGACCAGGTGAGGCAACATGGCAAGATCCCCTCTCTACCAAACAAACAAACAAACAAACAAAAAACAACTAGCTAGGGATGGTGGTGCGTGCCTGTAGTCCCAGCTACTTGGGAGGCTGAAGTGGGAGGATCGCTTGAGCCCAGGAGTTCAAAGCTGCAGTGAGTCATGATAGCACCACTGCACTCCAGCCTGGGTGACAGAGTGAGACCCTGTCGCAAAAAAAAAAAAAAAAAAAGAA"
"chr1","23458199","23458331","chr5","32595015","32595178","54","9136816","GGCTGGGCATGGTGGCTCATGCCTATAATCCCAGCACTTTGGGAGGCAGAAACAGGAGGATCACTTGAGGCCAGGAGTTCAAGACCAGCCTAGGCAATATAGTGAGACCTTGTCTCTACCGAAAAGAAAAAAT","GGCCGGGTGTGGTCCCTCATGCCTGTAATCCCAACACTTTGGGAGGCTGAGATAGGAGGACTGCTTGAGGCCAGGAGTTCAAGACCAGCCTGGTCAACATAGTGAGACCCCATCTCTATAAAATAATAATAATAATAATAATAATAATAATAAATAAATAAATA"
"chr1","23461393","23461700","chr17","27143484","27143812","76","3682091","GGGTGGGGTGGCTCACGGCTGTAATCTCACACTTTGGGAAGCTGGGGCGGGAGGATTGCTTGAGCCTAGTTCGAGGCCAGCCTGGGCAACATAGTGAGAGTCTGTCTCTACAAAAAATTAAAAACCAGGCATGGGGCATGGGCCTATAATTCCAGCTACTCAGGAGGCTGAGGTGGGAGGACTGTTTGACCCCAGGGAGTTGAGGCTATAGTGAGCTGTGATCGTGCCACTGCACTCCAGCCTGGGCAACAGAGCAAGACCCTGTCTCAAACGCACCCCCCCACAAAAAAAAAAAACAAAAGAAAAAA","GGCTGGGCTTGGTGTCTCATGCCTGTAATCCCAGCACTTTGAGAAGCTGAGGCAGGAAGACTGCTTGAGCCCAGGAGTTCAAGACCAGCCTGGGCAATATGGCAAGACTTCATCTCTAGAAAAAATAAAAAATTAGCCAAGCATGGTAGCATGCACCTACAGTCCCAGCTACTCGGGAGGCTGAGGTGGGAGGAGCGCTTAAGCCCAGGAGTTCAAGGTCATAGTGAGCTTTGATTGTGCCACTGCACTCCAGCCTGGGTGACAGAGCAATACCCTGTCTCTAAAACAAAAACAAAAACAAAACAAAACAAAACAACTAAAAAGAAGAA"
"chr1","23490532","23490696","chrX","12200542","12200707","68","11289990","TGGGCAACATAGTGAGACTTCACTTCTACAAAAAATTTAAAAATTAGTCAGGTGTGATGGCACGTGTCTGTAGTCCTGCTACGTTCTGCTACTTGGGAGGCTGAGGTGGGAGGATTGCTTGAGCCCAGGAGTGTGAGGCTATACACAGCTTTGATCACGCCACTG","CCAGCCTGGGCAATATAGCAAGACCCTGTTTACACACACACACACACACACGCACACACACACACGTGTGGTGGCACACACCTGTGGTCCTAGCTACTTGGGAGGTTGATGCAGGAGTATTGCTTGAGCCCAGGAGTTTGAGGCTGCAATGAGCCATGATCGTTCC"
"chr1","23501431","23501708","chr3","9052682","9052970","73","14448749","ACTTTGAGAGGTGAGGCAGGAGGATCACTTGAGGCCAGGAGTTCAAGACCAGCCTGAGCAACACAGGAAGAACCTGTCTCTATAAGAAATTTAAAAATTAACTAAGCATGGTGGCAGGCAAGTGCCTGTAGTCCCAGCTACACAGGAGGCTGAGGCAGGAGGATTGCTTGATCCCAGGAGGTCGAGGCTGCCGTGAGTTTTGTTCACACCACTGCACTCCAGCCTGGGCGACAGATGAGACCTTGTCTCAAAAAAAAAAAAAAAAAAAAAGTAAGAAA","ACTTTGGGAGGCTGAGTCGGGAGGATTACTTGACACCAGGAGTTCAAGACCACCTGGGTAACATAGTGAAAACTTCTCTTAACAAAAAAAAAAAAAAAAAAAAAAAAAAAATTAGCCAGCCATAGTGGTGCATGCCTGTGGTCTCAGCTACTCAGGAGGCTGAGACAGGAGGATCACTTGAGCCCAGAACTTCAAGGCTGCAGTAAGCCCTGATTATGCCACTGCACTCCAGCATGGGCAACAGAGCAAGACCTTGTCTCAAAAAAAAAAAAGAAAAAACAGGAGAAAA"
"chr1","23515688","23515989","chr4","25770742","25771056","82","2255054","TAGCTCACGCCTATAATCCCAGCAGTTTGGGAGACTGAGGCAGGAGAATCATTTGAGACCAGGAGTTCAAGAGCAGCCCGGGCAACATAGGGATACCCTGTCTCTATAAAAAAATTTACAAATTAGCCGAGTGTGGTGGCACACGCCTGTAGTCCAGCTACTCGGGAAGCTGAGGTGGGAGGAACACTTGAGCCATGGAGGTTGAGGCTACAGTGAGCTCTGATCATGCCACTGCACTCCAGCGTGGGCAACAGAGGGAGACCCTGTCTCAAAAATAAAAATAAGAATAAAATTTTAAAAAA","GGCCAGGCATGGTGGCTCACACCTGTAATTCCAACACTGAGAGCCTGAGGCAGGAGAATCACTTAAGCCCAGGAGTTCAAGAACAGCCTGGACAACATAGGGAGGCCCCGTCTCTACAAAAAAAAAAAAAAAAAAAAAAAAAATTAGCTGGGTGCGATGGCTCACACCTGCAGTCCCAGCTACTTGGGAAGCTGATGTGGGAGGTTCATTTGAGCCCAGGAGGTCTAGTCTACAGTGAGCAGAGTCACACCACTGCACTCCAGCCTGGGCAACAGAGCAAGACCCTGTCTCAAAAAAAAAAAAAAAAAAAAAAAA"
"chr1","23520462","23520762","chr16","32352979","32353289","78","8832517","GGCCAGGCACAGTGACTCATGCCTGTAATCTCAGCACTTTGGGAGACTGAGGCAGGAGGATCGACTGAAGCCAAGAGTTAGAGACCAGCCTGGGCAACAAAGCGAGACCCTGTCTATACAAAAAATAAAGAATTAGCCAGGCATGGTGGCACATGACTGTAGTTCCAGCTATTCAGGAGGCTGCGGTGGGAGGATCACTTGAACCCAGGAGGGCGAGGCTATAGCGAGCTATGATCATGCCATTGTACTACAGCCTGGATGACGGAATGAGTCCTTGTCTCTAAAAAAAATAAATAAATAA","GGCTGGACACGGTGGCTGCTGCCTGTAATCCCAGCACTTTGGGAGGCCAAGGCAGGAGAATGGCTTGAGCCCAGGAGTTCAAGACCAGCCCGGGCAACAGAGTGAGACCTTGTCTCTACAAAAATAAAAATAGAAATAAAAATAAAAATTAGCCAAGTGTGGTGGCATGCACCTGTGGTCTCAGCTACTCAGGAGACTGAGGTGGGAGGATCCCTTGAGCCCAGGAGGTCGAGGCTGCAGTGAGCTGTGATCATGCCACTACACTCCAGCCTGGGTGACAGAGCTGTCTCAAAAAAATAATAATTAAAAAA"
"chr1","23544010","23544308","chr9","68878569","68878883","76","45334559","GTCGGGCACAGTGGCTCACTCCTATAATCCCTGCACTTTGAGAGGCCAAGGCGGGAGGATGGCTTGAGTCCAGGAGTTCAAGGCCAGTCTAGGCTACCTGGCGAGACTCTGTCTTTACAAAAATATTTAAAAATTAGCTGGGCGTAGTGGTATATGCCTGTAGTCACAGCTCCTCAAGAGGCTGAGACTGGAGGATCTCTTGAGCCCAGGAGGTCATGGCTGCAATGAGCTGTGATTGTGTCACTGCATTCCAGCCTGGATGACAGAGGGAAACCCTGTCTAAAAAAAAAAAAAAAAAA","GGCTGGGCACGGCAGCTCATGTCTGTAATCCCAGCACTTTGGGAGGCCAAGGTGGGAGGATTGCTTGAGTCCAGGAGTTCAAGACCAGCCTGGGCAACATAGTGAAACCCCAGTCTCTACAAATAAATAAATAAATAAATAAATAATTAGCTGGGCATGTTGATGCATGCCTGTAGTCCTAGCTACTCGGGGGGTGAGGTGAGAGGATTGCTTGAGTCCAGAAGGTGGAGGCTGCAGTGAGCTATGATCACACCACTGCACTCCAGCCTGGAAGACAGGGTGAGACGCTGTCTTTAAAAAAAAAAAAAGAAAAGA"
"chr1","23546677","23546972","chr18","52960987","52961280","75","29414310","GGCCGAGCACAGTGGCTCATACCTGTAATCCAAGCACTGTAGGAGGCTGAGGCAGGAGGATCACAAGGTCAGGAGCTCAAGACCAGCCTGGGTAACACAGCAAGACCTCCCAATCTCTACACATTTTTTTTTTTAAAGTAGCTGGGTATGGTGGTGTGCACCTGCAGTCTCAGACTTAGGAGGCTGAGGTGGGAGGATCTCTTGAGCCCAGGGGTTTGAAGCTACAGTAAGCTATGACTGCACCACTGCACTCCAGCCTGGGTGACAGATTGAGACCCTGTCTCAGAAAGAAAAGA","GGCCAGGCACGGTGACTCACACCTGTCATCTCAACACTAGGAGGCCAAGGCAGGAGGCTAGCTTGAGCCCTGGAGTTCAGCCTGGGCAACATATCGAGACACACACACACACACACACACACATTTTTTTTTCTTTTATTAGCTGGGTGTGGTGGTGAGTGCCTACAGTCCCAGACATTTGGGAGGCTGAGGCGGGAGGATGGCTTGAGTCCAGGAGTTCAAAGCTGCAGTAAGCTATGATCACACCACTGCACTCCAGCCTGGGCAACAGAGTGAGACCTTGTCTTAAAAAAA"
"chr1","23570085","23570376","chrX","46692258","46692555","71","23122173","GGCCAGATACAGTGGCTCACACCTGTAATCCCAACACTTTGAGAGGTTGAGGTGGGAGGATAGCTTGAGTCCAGGGTTTTGAGACCAGCCTGGGCAACATAGTGAGACCCTGTCTCTACAAATAATTTTAAAATGAGCCGGGCTTGGTGGCACGCATCTGTGGTTCCAGTTACTCAGGAGGCTGAGGTGGGAGGATCACTTGAACCCAGGACATCGAGGCTGCAGTTTGAACATGATCACACCACTGCACTCTAGCCTGGGCAACAGAGCAAGACCCTATCTCAAAAAAAAA","GGCCAGGCATGGTGGCTCATGCCTGTAATCCCAGCACTTTGGGAGGCTGAGGAAAGATGATCACTTGAGCCAGGAGTTTGAGCCCAGTCTGGGTAACATAGTGAGACCTCCATCTCTACAAAAAAAAAAAAAAAAAAAAAAAAAAGCTGGGCATGGTAGCACACATCTGTAGTGTCAGCTACTCAGGAGGCTGAGGTAGGAGGATTGCTTGGGCCCAGGAGATCAAGACTGCAGTGAGCTATGACTGCACCACTGCACTCCAGCCTGGGCAATGGAGTGAGACCCTGTCTCAAAAAAA"
"chr1","23570593","23570760","chr5","32595015","32595178","54","9024422","GGCTGGGCATGGTGGCTCATGACTGTAATTCCTTTGGGAGGCTGAGATGATAGGACTGCTTGAGGCCAAGAGTTTGAGACCAGCCTGGGCAACATAGCAAGACCTCATCTCTACACAATTTTTTAAAAAAAATTAGCCAGGTGTGGTGGCACACATCTGGAGTACCAG","GGCCGGGTGTGGTCCCTCATGCCTGTAATCCCAACACTTTGGGAGGCTGAGATAGGAGGACTGCTTGAGGCCAGGAGTTCAAGACCAGCCTGGTCAACATAGTGAGACCCCATCTCTATAAAATAATAATAATAATAATAATAATAATAATAAATAAATAAATA"
"chr1","23579076","23579367","chr5","83677678","83677973","74","60098602","CAGGCGTGGTGACTCACGCCTATAGTCCCAACACTTTGGGGAGGCTGAGGCGGGTAGATTGCTTGAACTCAGGAGTTCGACATCAGCCTGAGCAACATGGCAAAACCCCATCTCTACAAAAAAATGAAAAATTAGCCAGGCCTGGTAGTGCACATCTGTGGTCTCAGCTACTGGGGAGGCTGAGGTGGGAGGATCATTTGAGCCCAAAAGGTGGAGGCTGCATTGAGCGAAGATTGTGCCACTGTACTCCAGCCTGGGTGACAGAGTGAGACCCCATCTCAAATAAAAAAAA","CTGGGTGTGGTGGCTCACACTTGTAATCCGAACACTTTGGGAAGCCAAGGCAGGAGGATTGCTTGAGCCCAAGAATTTGAGATCAGCCTGGGCAACATGACAAGACTCCATCTCTAAAAAAAAAAAAAAAAAAAAAAAAAATCTAGCCAGGTGTGGTAGCATGCACCTGTGGTCTCAGCTACTCAGGAGTCTGAGGTGGGAGAATTGCTTGAGCCCAGCAGGTCAAGGCTGCAGTGAGCCATGTTTGTGTACTGCACTCCACCCAGGGTGACAGAGTGAGACCCTGTCTCAAAAAA"
"chr1","23595979","23596286","chr9","68878569","68878883","55","45282590","GGCTGGGCCTAGTGGCTCATGCCTGTAAACCCAGCACTTTGGGAGGCCGAGTGGGAGGATCATTTAAGGCCAGGAGTTCAAGGCCAGCCTGGGCAACATAGCGAGACCCTCTCTCTACAAAAAAAAAAAAAAAAAAAAGTTAGGTGGGCATGGTGGCACATGCCTGTAGTCCCAGATACTCAGGAGGCTGAGGAGGGAGGATTGCTTGAGCCCAGGAGTTTGAGGCTGCAGTGAGCTATGATCACACCACTGCACTCCAGCCTGGGTGACAGGGAGACCCTATCCCAAAAAAAAAAAAAAAAAAAAAA","GGCTGGGCACGGCAGCTCATGTCTGTAATCCCAGCACTTTGGGAGGCCAAGGTGGGAGGATTGCTTGAGTCCAGGAGTTCAAGACCAGCCTGGGCAACATAGTGAAACCCCAGTCTCTACAAATAAATAAATAAATAAATAAATAATTAGCTGGGCATGTTGATGCATGCCTGTAGTCCTAGCTACTCGGGGGGTGAGGTGAGAGGATTGCTTGAGTCCAGAAGGTGGAGGCTGCAGTGAGCTATGATCACACCACTGCACTCCAGCCTGGAAGACAGGGTGAGACGCTGTCTTTAAAAAAAAAAAAAGAAAAGA"
"chr1","23603084","23603358","chr4","152016924","152017215","78","128413840","GGCTGGGTGTGGTGGCTCACGCCTGTAACCCTAGCACTCTGGGAAGATTGCTTAAGCCCAGGAGTTTGAGACCAGCCTGGGGAACATAGTGAGACCTCATCTCTACAAACATTTTTTAAACATAGCTGAGTGTGGTGGCACGCACCTATAGTCCCAGCTACTCAGGAGGCTGAGGTGGGAGGATTGCTTGAGCCGGGGAAATGGAGGCTGTAGTGAGCAATGATCACGCCACTGCACTCTGGCTTGGAAACATAGTGATACTGTCAAAAAAAAAA","GGCTGGGTGTGTTGACACTCACCTGTAATCCCAGCACTTTGGGAGGGACTACTTGAGCTTAGGAGTTCAAGACCAGCCTGAGCAACATAGCAAGACCCTGTCTCTACTAATCAATCAATCAATCAATCAATCAATCAATAGCTGGGCATGGTGGCACATGCCTGTAGTCCCAGATACTCAGGAGGCTGAGGTGGGAGGATCACTTGAGCTTGAGAGGCCGAGGCTGCAGTGAGCTGATTGTACCACTGCACTCCCACCTGGACGACAGAGCGAGACTTATCTAAAAAAAAAA"
"chr1","23606291","23606533","chr10","4573653","4573905","83","19032638","GGAGGCCCACACCCGTTATCCTAGCACTTTGGGAGGCTGAGGTGGGAGGATCACTTAAGGCCAAGAGTTTCAGACCAGCCTGGGCAACATTGCGAGACCCCATCTCTACAAAAAATTTAAACATTAGCCAGGTGTGGTGTCATGTGCCTGTAGTCCTAGCTACTGTGGAGTCTGAGATGGGAGGATCACCTGAGCCCAGGAGTTTGAAACTGTAGCGCACAATGATCGTGCTACTGCATTCTA","GGCATGGTGGCCCATGCCTGTAATCCCAGTTCTTTGGGAGGCTGAGGCGGGAGGATGGCTTAAAGCCAGGAGTTAAAGATGAGGTTGGAAAACATAGTGAAAGCCCATATCTAAAAAAAAAAAAAAAAAAAAAAAAAATTAGCCAGTTGTGGCATCACGCACCTGCAGTCTCAGCTACTCCAGAGCCTGTGGTGGGAGGATTATTGAAGCCCAGGGGCTGGAGGCTGCAGTGAGCTGTGTTCATGCCACTGCA"
"chr1","23631189","23631519","chr14","85575670","85576007","81","61944481","GTCAGGTGTGGTGGCTCATGCCTGTGGTCTCAGCACTTTGGGAGGCTGAGGCAGGAGAACCACTTGAGGCTAAGAGTTTGAGACTGGCCTGGGCAACGTAGTGAGATCCAGCCTCTAAAAAAAAAAATTAGCCAGATGTGGTGGCAAACGCCTGTGGTCCCAGTAGCTCTGGAGGCTGAGGTGAGAGGATTGCTTGAGCCCAGGAGGTCAAGGCTGCAGTGAGCTCTGATTGTGCCATTGCACTCCAGCCTGGGTGACAGAATGAGACCCTGTCAAGAAAGAAAGGAAGAAGGGAAAGGGAAAGGGAAAGAAAGAGAGAGAGAAAGAAAGA","GGCCAGGAATGGTGGCTCATGCCTGTAATCCCAGCACTTTGGGAGGCCAAGGGTGGCAGATTGCTTGAGCTCAAGAGTTCAAGACCAGTCTGGGAAACATAACAAAACCCCGCCTCTACAAAAAATTTAAAAAGTAGCTGGACATGGTGGCACACGCCTATAGTCCCAGCTACTCAGGAAGCCTAGGTGTGAGGATTGCTTGAGCTCACGAGGTCAAAGCTGCAGTGAACTGTGATCATGCCACTGCACTCCAGCTTGAGTGACAGAGCGAGATGCTGTCTCAAAAAAAAAAAGGAAGGAAGGAAAGAAGGAAGGAAGGAAGGAGAGAGAAAAGGAAA"
"chr1","23659368","23659484","chr1","217544386","217544536","63","193885018","GGCTGGGCATGGTGGCTCACGCATGTAATCCCAGCAATTTAAGAGGCCAAGGTGAGAGGATTGCTTGAAGCCGGGAGTTCAAGACCAGCCTGGGCAACATAACAAGACTCCCCCTCT","GGCTGGGCGTGGTGGCTCATGCCTCTAATCCCAGCACTTTAGGAGGCCAAGGCAGGAGGATAACTTAAGACCAGGCTGGGTGACACAGTGAGACTTTGTCTCTAAAAAAAAAAAAAAAAAAAAAAAAAAAAAAAACCTACAAAAACATATA"
"chr1","23678161","23678453","chrX","113487188","113487493","81","89809027","GGCTGAGCGCAGTGGCTCATACCTGAAATCCTAGTGCTTTGGGAGGCTGAGGCAGGAGGATTGCTTGAGGCCAAGAGTTTGAGGCCAGCCTGAGCAAAATAGCGAGACCCCCATCTCTATAAAACATTTTAAAAATTGGCTGGGCATGGTGGTGCTTGGGGATACTGAGGTGGGGGGATGGCTTGGGCACAGGAGTTTGAGGCTGCAGTGAGCTATGATCACGCCACTGCACTCCAATCTTGGAGACACAGCAAGACCCTGTCTCAAAAAAAAAAAAAAAAAAAAAAGAAAAA","GCGTGGTGGCTCACACCTGTAATCCCAGTACTTTGGGAGGCTGAGGTGGGAGGATTGCTTGAGCTCAAGAGTTCAAGCCCAGCCTGGGCAAAACAGTGAGACCCCGTCTCTACAGATAATAATAATAATAATAATAATAATAAAATAGCCAGGCATGGTGGTGCATTCCTGTAATCTGAAATGAGAGGATCACTTGAGCCCAGGAAGCAGAGGCTGCGGTGAGCCATGATTGTGCCACTGCACTCCAGTCTGGGTGACAGAGTGAGAACCTGTCTCAAAAAAGAAAACAACACACAAAAAAACAAA"
"chr1","23686941","23687216","chr1","47533839","47534134","80","23846898","GCCAGGTGCAGTGGCTCATACCTGTAATCCCAACAGTTTGGGAGGCCAAAGTGGGAGGGTTTCTTGAGCCTAGGAGTTTACGACCAGCCTGGGCAACATGGCAAGACCCTGTCTCTGCAAAAAATTTATTAGCCTGGCATGATGGTGTATGTGTGTGTGTTCCCAGCTACTTGGGAGGCTGAGGTGGGAGGACTGCTTGAGCCTAGGAGGCTGAGTCTGCAGTGAGCCATATTTATGTCACTGCACTCCAGCCTGGGTAATAGAGTGAGACCTGTC","GGCTGGGCACGGTAGCTCACACCTGCAATCCCACCACTTTGGGAGGCTGAGGTGGGTGGATTGCTTGAGCCCAGGAGTTCTAGACCAGCCTGGGTGATACAGGCAGACCCTATCTCTACCAAAAAAAAAAAAAAAAAAAAAAAAAAAGGCTGGGCATGGTGGCATGTGCCTGTGGGCTCAGCTACTTAGGAGGCTGAGGTGGGAGGATCAGTTGAGCCCAGGAGGAGTTGAGGCTGCAGTGAGCCTAGATCCTGCCACTGCACTCCAATCTGGGCAACAGAGCGAGACCCTGTCTC"
"chr1","23687683","23687994","chr1","135236320","135236644","73","111548637","GCCTGGTGTGGCAGTTCATGCCTGTAATCCCAGCACTTTGGAAGGCAAAGGTGGGAGGATCGCTTGAGTCCAGGAGTTGGAGACCAGCCTGGGCAACATGGCAAGACCCCATCTCTACAAAAAATTTAAAAAATTAGCTGGGCATGGTAGTGTGCACCTGTGGTCCCAGCTACGTGGGAGGCTGAGGTGGGAGGATCATGTGAGCCCGGGAAGTCATGGCTGCAGTGAGCCAAGATCACACCACTGCACTCCAGCCTGGGCAACAGAGCAAGACCCTGCCACAAAACAAAACAAAAAACAAAAAACAAACAA","GGCTGGGTGTGGTGGCTCGTGCCTATAATCCCAGCACTTTGGGAGGCCAAGGTAGGAAGATCACTTGAGCCCAGGAGTTTGAGACCAGCCTGGGCAAAATGGCAAGACCCTGTCTCTATAAAAATTTAAAAAAATTAGCCAGCTGTGTTTGTATGCGTCTGTCATCTCAGCTACTAGGGAGGCTGAGGTGGGAGGATTGCTTGAGTCCGAGAGTTTGAGGCTGCAGTGAGCTATGATCATGCCACTGTACTCCAGCCTGAGTGACAGAGTGAGACCCTGTCACACACACACACACACACACACACACAAAAGAAAAGGAAAGAAA"
"chr1","23693108","23693177","chr20","87144","87254","57","23605964","CGGGAGCATGAGGCTTCAGTGGCCTATATTAGTGCCACTGCACTCCAGCCTGGTTGACCCTATCTCAAAA","CCTGGGCAACATAGTGAGACTACATCTCTACACTCACGCACACACACACACACACACACACACCCCCCAAATTAGCCAGGCATGCTGATGTGCACCCATAGTCTCAGCAAC"
"chr1","23703150","23703291","chr15","37343640","37343763","72","13640490","CCTGTAGTCCCAGCTACTCAAGAGGCTGAGGGGTGAGGATCACTTGAGCCCAGGAATTTGAGGCTGCAGTGAGTCGTGATCACATCACTACACTCCACACCGGGTGACAGAGTAAGACCCTCTCTAAAGGAAAAAAAAAAAA","AAGATCCCTGGCCAGGATTTCAAGACCAGCCTGGGCAACACAGTGAGACCATACATACATACATACATACATACATACATCATACATACATACATACATACATACATACACAGTCTTACAAAGA"
"chr1","23705650","23705740","chr20","87144","87254","54","23618506","GGAAGGATTGCATGAAGCCAGAAGTTTGAGACCAGCCTGGGCAACATAGCAAGACCCCCCATTGCTACATATTTTTTTATCTAAATTAGCC","CCTGGGCAACATAGTGAGACTACATCTCTACACTCACGCACACACACACACACACACACACACCCCCCAAATTAGCCAGGCATGCTGATGTGCACCCATAGTCTCAGCAAC"
"chr1","23706347","23706515","chr5","32595015","32595178","64","8888668","TTAGCCAGGTGTAGTGGTGCATGTCTTTGGTCCCAGCTACTTGGGAGGCTGAGGCAGGAGGATTGCTTGATCTCAGGAGTTGAAGGCTGCAGTGAGCTGTGATCACACCACTGCACTTCATCCTGGGTAAGAGTGGGACACCTGTGTCTTAAAAAAAATAAAATAAAAA","GGCCGGGTGTGGTCCCTCATGCCTGTAATCCCAACACTTTGGGAGGCTGAGATAGGAGGACTGCTTGAGGCCAGGAGTTCAAGACCAGCCTGGTCAACATAGTGAGACCCCATCTCTATAAAATAATAATAATAATAATAATAATAATAATAAATAAATAAATA"
"chr1","23708618","23708910","chr9","72062542","72062841","82","48353924","GGCCGGGCACAGTGTCTCACACCTGTAATCCCAGCACTTTGGGAGGCCAAAGTGCGAGGATTGCTTGAGGCCAGGCATTCGAGACCAGCCTGGGCAACATAGCAAAGCCTCATAGTGAGTCTCTATTAAAATTGTTTTAAAAAAACTAGCCAGGCATGGTGGTGCATACCTGTAGTCCTAGCCACTTGGGAGGCCAAGACAGGAGGATTGCTTGAGTCCAGCAGTACAACACTGCACTGAGCTGAAATCACACCACTGGACTCCAGCCTCAGCAAAAGAACAAGACCCTGTCT","GGCTGGGTGCGGTGGCTCACACCTGTAATCCCAGCATTTTAGGAGACTGAGACAGCGGGAGGATCGCTTCAGGCCACGAGTTTGAGACCTGCTTGGGTAACATAGCAAGACTGCCACTTCCATGAAAACAAAAACAAAAACAAAAACAAAACCTAGCCAGGCATGGTGGTGCACTCCTGTAGTTCCAGCTACTTGGGAGGCTGAGAAAGGAGGATGGCTTACACCTGGGAGTTCAAGGCTGCAATGAGCTATGATTGTGCCACTGTACTCCACCCCAGGCAACAGAGGGAGACCCTGTCT"
"chr1","23752575","23752662","chr20","87144","87254","57","23665431","GGCAGGGTACAGTGGCTCACACCTATAATTCCAGCACTTTGGGAGGCCGAGGTAAGAGGATTGCTTGCGGCCAAGGGTTCTAAACCAA","CCTGGGCAACATAGTGAGACTACATCTCTACACTCACGCACACACACACACACACACACACACCCCCCAAATTAGCCAGGCATGCTGATGTGCACCCATAGTCTCAGCAAC"
"chr1","23752952","23753164","chr13","61075674","61075894","75","37322722","GGAGTTCTAAACCACCCTGGTCAACACAGCAAGATGCTGTCTCTACAAGAGAAAAAAAGTAGCCAGGCATGGTGGCACATCCCAGGTACTCGGTAGGCTGAGGTGGGAGTATCACTTGAGCCCAGGAGTTCAAGGCTGCAGTGAGCTCTGATTGCATCACTGCACTCTAGCTTGGGTGACAGAGCAAGACTGTTTCAAAAACAAACAAAAAAA","CAGCATAGTGAGACCCTGTTTCTACAAAAAAAAAAAAAAAAAAAAAAAAATTTAATTAAACAAGCATGGTGGTGCACACCTGTAGTCCTGGCTACTTGGAAGGCTGAGACAAGAGGATCACTTGAGCCCAGGAGGTCAAGGCTGGCAGTGAGCTGTGGCTGCACCACTGCACTGCGGTCTGGGTGACAGAGCAAGGCCCTATCTCTAAAAACAAAACAAAA"
"chr1","23815932","23816224","chr3","83975049","83975347","72","60159117","GGCTGGGCACAGTGGCTCACACCTATAATCCCAGCACTTTGGGAGGCTGAGGCCGGAGAACAGCTTGAGGCCAGAAGCTTGAGACCAGCCTGAGCAACATAAGGAGACCTTGTCTCTACAAAAAAAAAAAAAAAAATCAATTAGCTGGCTGTGATGGCATGCACCTGTAGTCCTAGCTACTCGGGAGACTGAGGCACAGGATGGCTTGAGACTAGGAGTTCGAGGCTGCAGTGAGCCATGATAATACCGCTGCACTCTTCCAGCCTGGGTGACACAGCAAGAAAAAAAAAAAA","GGCTGGGTGCAGTGGCTCATGGCTGTAATCCCAGGACTTTGGGAGGCTGAGGCAGGAGAATCACTTGAGGCCAGGAGTTTGAGACCAACCTGGGCAACAAAGTGAGGCATGTCTCTACAAAAACAAAACAAAACAAAACAAAACAATTAGCTGTGTGTGGTGATGCCTGCCTGTCGTCCCAGCTACTCGGGAGGCTGTGGTGGGAGGATCTCTTGAGCCTGGGAGGTTGAGGCTGCAGTGAGCTGTGATTGCCCACTGTACTCTAGCATGGGTTACAGAGCAAGACTCTGTCTCAAAAA"
"chr1","23828697","23829000","chr5","152110395","152110709","84","128281698","GGCTGGGTGCTGGGACTCACATCTTTAATCTCAACACTTTGGGGCACCAAAACAAGAAAGATCACTTGAGCCCAGGAGTTCAAGACCAGCCTGGGCAACATGGCAAGACCATTGTCGGCCAAAAAATTTAAAACTTAGCTGGTTGTGATGGTGCATGCACCAGTGGTCCCGGCTACTCAGGAGGCTGAGGTGGGAGGATGGCTTGAGTGCAGGAGGCTGAGGCTACAGTGAGCTATGATTGCACTATTACACTCCAGCCTGGGCAAGAGAATGAGTGAGACCCCATCTAAAAAAAAAAAAAAAA","GGCTGGGAGTGGTGGCTCATGCCTATAATACCAGCACTTTGGGAGGCCAAGGTGGGAAGATCACTTGAGGCCAGGAGTTCAAGATCAGCCTAGGCAACATAGCAAGACCCTGTCTCTACAAAACAAACAAACAAACAAACAAACAAAATTAGCTGGGCATGGCGGTATGCACCTGTAGTCCCAGCTACTTGGGAGGCTGAGGCAGGAGGATTGTTTGAGCCCAGAAGGTTGAGGCTGCATTGAGCCATGATTATGCCACTTTACTCCAGCCTGGGCAACAGAGGGAGACCCCATTCTCAAAAACAAAACAAAAAA"
"chr1","23863571","23863881","chr2B","57359864","57360185","70","33496293","GCTGGGCGCAGTGGCTCATGCCTGTAATCCCAGCACTTTGGGAGGCTGAGGTGGGAGGATCCCTTGAGTCCATGAGTTTGAGACCAGCCTGGGCAACATAGTGAGACCTTGTCTCCACAAAAACTGTAAAAATTAGCTGAGTGTGGTGGTGCGAGCCTGTAGTCCCAGCTACTTGGGAGGCTAAAGTGGGAGGATGGCTTGAGCCCAGGAGGTAGAGATTGCAGTGAGCTAAGATTGTGCCACTGGAGTCTAGCAAAGGCGACAGAGTGAGACCCTGTCTCAAAACAAAAACAAAACAAAACAAAACAAAA","CCGGGCATGGTGGCTCATGCCTGTAATCCTAGCACTTTGGGAAGCTGAGGTGGGAGGGTTGCTTGAGCCCAGGAGTTCAAGACCAGCTTGGGCAACACAGTGAGTCCCCTGTCTCTACAAAAAAAAAAAAAAAAAAAAAAAAATTAGCTGAGCATGGCAGTGTGTGTCTATAGTCCCAGCTACTTAGGAGGCTGGTGTGGGAGGATCGCTTGGGCCTTGGAGGTCAATACTGCAGTGAGTTGTGATCGCACCACTGCACTCTAGCCGGGGTGACAGAGTGAGATCCTGTCTCAAAACAAAAAACAAAACAAAACAAAACAAA"
"chr1","23889506","23889623","chr8","58489091","58489211","63","34599585","GGTCAGGCAAGGTGGCTCATGTCTATAATCCCAACATTTTGGGAGGCTGAGGTGGAAGGACTGCTTGAGGCCAGGAGTTTGAGACCAGCCTGAGCAATATAGCAAGACACTATCTATA","TTGAGACCAGGAGTTTGAGACCAGCTTGGACAACATAGTGAGACCCTGTCTAAAAGAAAGAAAGAAAGAAAAGAAAGAAAGAAAGATGTAGCCAAGTGTGGTGGTGCACATCTGTGTCTCA"
"chr1","23896037","23896167","chr1","217544386","217544536","61","193648349","GGCAGGGTGTGGTGGCTCATGCCCGTAATCTGAGCATGAACTTTGGGAGACCAAGGCGGGAGGATCACTTAAGGCCAGGAGTTTGAGACAAGCCTGGGTGATATAGTGAGACCCCATCTCTACAAAAAGTA","GGCTGGGCGTGGTGGCTCATGCCTCTAATCCCAGCACTTTAGGAGGCCAAGGCAGGAGGATAACTTAAGACCAGGCTGGGTGACACAGTGAGACTTTGTCTCTAAAAAAAAAAAAAAAAAAAAAAAAAAAAAAAACCTACAAAAACATATA"
"chr1","23909966","23910260","chr1","89562448","89562757","69","65652482","GGCCGGGCATGGTGGCTCATACCTGTAAGCTTGGCACTTTGGGAGGCCCAGGCAGGAGGATAGCTTGAGCTCAGCACTTCAAGACCAGTCTAGGAAACATAGTGAGACCCTATCTCTACAAAAAAAAAAAAAAAAAAATTAAAAATTAGCCAGGCATGGTGGCACATGCCTGTGGTCCCAGCTACTCAGGGGGCTGAGGTGGAAGGATTGTTTAAGCCTGGGAGATTGAGGCTGCAGTGAGCTATTATTGCCTGGGTAACTGAGCAAGATACTGTTTCAAAAAAAAAAAAAAGAA","GGCCAGGCATGGTGGCTCACACCTGTAATCCCAGCACTTTGGGAGGCTGAGGTAGGAGGGCTGCTTGAAGCCAGGAGCAGAACTTGAGACCAGCCTGGGAAATATAGTGGGACCCCATTTCTACAAAAAAAAAAAAAAAAAAAAAAAAATTAGCCAGGCATAATGGTGCATGTCTGTGGTCCCAGCTACTTGGAAGGCTAAGGTGGGAGAACTGCTTGAGCCCAGGAGGTTGAGGCTACAGTGAGCCAGTGCATTCCAGCCTGGATGACAGAGCAAGACTCTGTCTCAAAAAAAAACAAAAAACAAAAAA"
"chr1","23916493","23916654","chr1","217544386","217544536","66","193627893","GCCGGGTGAGGAGGCTCATGCCCGTAATCCCAGCATTCTGGGAGGCTGAGGCGGGAGGAGGTCTTGCCTGAACTCAGGAGTTTGAGGTTATAGTGAGCTCTGATTATGCTACTGCACTCCAGGCTGGGTGACAGAGAGAGAACCTTGACTTGAAAAACAAAA","GGCTGGGCGTGGTGGCTCATGCCTCTAATCCCAGCACTTTAGGAGGCCAAGGCAGGAGGATAACTTAAGACCAGGCTGGGTGACACAGTGAGACTTTGTCTCTAAAAAAAAAAAAAAAAAAAAAAAAAAAAAAAACCTACAAAAACATATA"
"chr1","23921777","23921909","chr5","32595015","32595178","52","8673238","GGCCAGGTGTGGTGGCTCATATCTGTCATCCTAGTGCATTGGGAGACTGGGATGGGAGGATCGCTTGAGGCCAGGAGTTCGAGACCAGCCTGGCCAACATGGTAAGACCTCATCTCTATAAAAAATAAAAAAT","GGCCGGGTGTGGTCCCTCATGCCTGTAATCCCAACACTTTGGGAGGCTGAGATAGGAGGACTGCTTGAGGCCAGGAGTTCAAGACCAGCCTGGTCAACATAGTGAGACCCCATCTCTATAAAATAATAATAATAATAATAATAATAATAATAAATAAATAAATA"
"chr1","23939501","23939804","chr17","22156955","22157271","80","1782546","GGCTAGGCGTGGTCACTCATCCTTGTAATCAGAGCACTTAGTGGGGGCCGAGGCAGGAGAATTGCTTGAGTCTAGGAGTTCCAGACCAGCCTGGCCAATATAGTAAGACCCCATCTCTACAAAAAACAAAAAATTAGCCAGGCGTAGTGGCACATGCCTGTAGTTACTCAGGAGGCTGAGGTGGGAGAATCACTTGAGCCTAGGAGGTTGAGGCTGTAGTGAGCCATGGTTTTACCACTGCACTCTAGCCTGGGCGACAGAGAAAGGCCCTATCTCAAGAAAAAAAAAAAGAAAGAAAGAAAAA","GGCTGGGGACAGTGGTGCACACCTGTAATCCCAGCACTTTGGGAGGCTGAGGCGGGAGGATCGCTTAAGCTCAGGAATTCAAGACCAGCCTGGGCAACAAAGCAAAACTCCGTCTCTATAAAAAAAAAAAAAAAAAAAAAAAAATTAGCCAAGAGGGTGGTGCACTCCCATAGTCCCAGCTACTCGGGAAGCAGAGATGGGACAATCACTTGAGCCCAGAAGGTTGAGGCTGTAGTGAGCCAGGATTATGCCACTGCACTCTAGCCTGGGTGACAGAATGAGACCCTGTCTCAAGAAAAGAAAAAACAGAAAAAGAA"
"chr1","23945001","23945301","chr8","25360790","25361095","80","1415789","GCTGGGTGTAGTGGCTTATGCCTGTAATCCCAGCACTTTGGGAGGCTGAGATAGAAGGATCACTTAAACCTAGGAGTTCAAGACCAGCCCTGGCAACGCAGTGAGAACCCCATCTCTATAAAAAAATTAAAAGTTAGCTAGATGTGGTATGCATGCCTGTATTCCCAACTACTTGAGAGGCTGACATGGGAGGATCGCTTGAGCCCAGGAGTTCAAGGTTGCGGTGAGCTATTATCATTGCGCTGCACTCCAGCCAGGGTGAAAAAGCAAGACTCTGTCTCTTTAAAAAAAATAAAGAAAA","GGCTGGGAGCAGTGGCTCATACCTGTAAGCCCAGCACTTTGGGAGGCTGAGGTGGGAGGATTGCTGAAGCCCAGGAGTTTGAGACCAACCTGGGCAATGTAGGGAGACCCCGTCTCTACTAAATAAATAAATAAATAAATAAATAAAGTCGGGCATGGTGGCATGTGCCCTGTAGTCCCAGCTTCTTGGGAGGCTGAGGTGGGAGGATTGCTTGGGCCCAGGAATCAAGGCTGCAGTGAGCTGTGATTGTGCCACTGTACTACAGCCTGGGTGACAGTGCAAGACTGTCTCAAAAGAAAAACAAAA"
"chr1","23988663","23988901","chr10","102878352","102878592","77","78889689","AGGCCGAGGTGGGAGGACTGCTTAAGGCCAGGAGTTCAAAACCAACCTGGGCAACATACTGAGACCCTACCTCTGAAAAAATAATTAGGCACGGTGGCACACACCTGTAGTCCCCCCTACTAGGAAGGCTGAGGTGGGAGGATCACTTGAGCTCAAGAGGTTGAAGCTGCAGTAAGCCATGATTGTACCACTATGCTCCAGCCTGCGTGACAGAGGGAGACCCTGTTTTTAAAAAAAAA","AGGCCAGGAGTTCAAGACTAGCCTGGGCAATACAGTTACACCCCCATCTCTACAAACAATAATAATAATAATAATAATAATAATAATTAACTGGGCATGGTGGCATGCTCCTGTAGTCCCATCTACTTGGGAGGCTGAGGCAGAAGGATCACTTGAGCCCAGGAGGTTGAGGCTGCAGTGAGCTATGATCATCCCACTGCCTCCAGCATGGGTGGCAGAGTAAAACTGTGTCTCTAAAAAA"
"chr1","23996995","23997193","chr19","13525969","13526165","83","10471026","AAAATTTTTTTTTTTTAGTTAGCCAGGCATGGTGGTGATTCAAGGCTGTAATTCCAGCTACTCAGGAGGCTAAGGGGGGAGGATCACTTAAGCCCTAGATTTTGAGGCTCCCATGAGCAGCCTACTGCTGTATCATATGATCATAGCACTGTACTCTAGCCTAGGCGACAGAGCGAGACCTTGTGTCTTAAAAAAAAAA","AAGAAATAAATTAGTTGAGCATGGTGGTGCATGCCTATAGTCCCAGCTACTGGGGAGGCCAAAGTGGGAGGATTGTGTGAGCCCAGGAGTTTGAGGCTGCAATGAGCCAAGATTATGCACACCAGTGTGGGAGACAGTCAAGTCTCAAAAAATAAACAACAACAACAACAACAACAACAAACACATAAAAAGAAAAA"
"chr1","23997497","23997624","chr9","47045786","47045941","55","23048289","GGGTGCAGTGGCTCATTCCTGTCATCCCAACTCTTTGGGAGGCCAACGCAGGAAGATTGCTTTAGGCCAGGAGTTCAAGGCCAGCCTGGGCAACATAGTGAGACACCCCCCCATCTCTAAAAAAAAAA","GCTGGGCGCAGCAGCTCACACCTGTAATCCCAGTGCTTTGGAGGTCCAAGGTAGGAGGATTGCTTAAGACTAGGTGTTCAAGACCAGTCTTGGCAACATAGTGAGAACTCATCTCTACAATAAATAAATAAATAAATAAATAAATGAAAATAAAAA"
"chr1","24007457","24007748","chr1","204014078","204014404","56","180006621","GGCTGGGTGTGCTGGCTTATGCCTGTAAACCCAACCCTTTGGAGACTAAGATGGGAGGATCACTTGAGGCCTGGAGTTTGAGACCAGCCTGGGCATCAAAGTGAGACCCATCTCCACACACACAAAAAAAATAGCTGGTGTGGTGGCATGCACCTGTAGTCCCAGCTACTTTGGTGTCTGAAGCAGGAGAATTGCTTGAGCCCAGGCATTCAAGGCTGCAGTGGACTATAATGGCACCATTGCATGCTAGCCTGGGTGACCAGAGCCAGACCCTATCTCAAAAAAAAAAAAA","GGCCGGGTGTGTTCGCTTATGCCTGTAAACCCAGCACTTTGGAGACTAAGATGGGAGGATCACTTGAGACCTGGAGTTTGAGAGCAGCCTGGGCATCAAAGTGAGACCCATCTCCACAAAAAAAAAAAAAAAAAAAAAAAAAAAAAAATTGCTGGTTTGGTGGCATGCGCCTATAGTCCCAGCTACTTTGGAGTCTGAAGCAGGAGAATTGCTTGAGCTCAGGCATTCAAGGCTGCAGTGGGCTATAATGGCACCATTGCATGCCAGCTTGGGTGACAGAGCCAGACCCTATCTCAAAAAAATAGAAAATAAATTAATAAAAATAAA"
"chr1","24027783","24028054","chr8","15910614","15910909","75","8117169","GGCCGGGTACAGTAGCTCATGCCTATAATCCCAGTGCTTTGCGAAGCTGAAGCCAGAGGATCATTTGAGGCCAGGAGTTCAAGACCAGCTTGGGCAACACAGTGAGACTCTGTCTCTACAAAATTAATAATAAAATTAGCCGGGTGTGATGGTACCCGCTTATAGCTTCTTCAGGAGGCTGAGGTGGGAGGATTGCTTGAGCCTAGGAGTTCAAGGGTGCAGTGAGCCATGATTGTGCCACTGCACTCCAGGCTGGGTGACAGAGTGAGATC","GGCCAGGCGAAGTGGCTCACACCTGTAATCCCAGCACTTTGGGAGGCCAAGGCAGGAGGATCATTTGAAGCCAGGAGTTCAAGGCCAGCCAGAGAAACATAGTGAGAACCTGTCTTTACAAAAATTAAAATTAAAATTAAAATTAGCCAGGAGTGGTGGTGCATGCCTGCAGTCCCAGCAGCTCAGGAGGCTGAGGTGGGATGATTGCTTGCACCAGGAGTTCGAGGCTGCAGTGAGCTGTGATCGTGCCACTGCACTCCAGCCCCTGGGTGACAAAGCAAGATCCTCTAAAAAAA"
"chr1","24041541","24041843","chr11","95987071","95987386","69","71945530","CCAAGCATGATGGTTCATGCCTGTAATCCCAGCACTTTGGGAGGCCAAGGCAGGAGGATTGCTCGAGGCCAGGAGTTCAAGACCAGCTTGATCAGCAAGGTGAGACCTTGTCTCCACAAAAAAAATTTTAAAGTTAGCTGGGTAGGATGGCATACACCTGTAGTCCCAGCTACTCAAGAGGCTGAGGTGGGAGGATTGCTTTAGCCCAGAAGTTCGAGACTCCAGTGAGCTATGATTGCACCACTGTACTCCAGCCTGGATGACAAAGACCTTGTCTCAAAAAAAAAAAAAAAAAAAAAAAAA","GACCAGGCACGGTGGCTCATACCTGTAATCCCAGCATTTTGGGAAGCCAAGACAAGAGAATTGCTTGAGCCTAAGGAGTTCAGGACCAGCCATGGCAACACAGTGAGGCCTCGTCTCTCAAAAAAAAAAAAAAAAAAAAAAAAATTAGCTGGGTGTGGTGAAGCACCTGTAGTTCCAGCTACTCAGAAAGCTGAGGTGGGAGGATTGCTTGAGCCCAGCAGGTCGAGACTGCAGTGAGCTGTTATAGCATCACTGCACTCCAGCCTGGGTAACACAGCGAGACCCTATCTCACAAAAAAAAAAAAAAAAAAAAAAA"
"chr1","24070625","24070721","chr20","87144","87254","60","23983481","TTTGGGAGACTGAGGCAGAAGGAGTACTTAAGGCCAGGAGTTCAAGACCAACCTGGTCAACATAGTGAGTCCCCATCTCTAATTAAAAAGATAAAAA","CCTGGGCAACATAGTGAGACTACATCTCTACACTCACGCACACACACACACACACACACACACCCCCCAAATTAGCCAGGCATGCTGATGTGCACCCATAGTCTCAGCAAC"
"chr1","24139542","24139751","chr14","51003183","51003398","44","26863641","CATCCTGGACAATATATGAGACCCCATCACTACAAAAAATTTAAAAATAAATTAGACGGATGTGGTGGTGCATGTCTGTAGTCCCAGCTACACAGGAGGCTGAGGTGCGAGGATTGCTTAAGCCCAGGAAGTCGAGGCTGCAGTGAGCCATGATCACGCCACTGCACTCCAGCCTGGGGGACAGAGCAAGACCCTGTCTCAAAGACCAAA","AGCCTGGGCAAGATAGTGAGACCTCATCTCTTAAAATAAATAAATAAATAAATAAATAGCAGGATGTGGTGGCGTGCATCTGTAGTCCCAGCTACTCAGGAGGCTGAGATGGGAGGATTACTTGAGCTCAGGAGGTCGAGGCTGCAGTGAGCTATGATCACGCCACTGTACTCCAGCCTGGGTGAGAGTGATACCCTGTCTCTAACAAAAAAAAAA"
"chr1","24159728","24160000","chr11","5677352","5677639","81","18482376","CAAGGAGGGAGGATCACTTGAGGCTGGGAGTTCGAGACCAGCCTGGGCAACAGCAAGACCTTGCCTATACAAAAAATAATTTTAAAAAATTACCCAGGTATGGTGGTGTGGATCTGTAGTCCCTAGTTACTTGGAGAGCTGAGGTAGGAGGATCGCTTGAGCCCAGGAGTTTGAGGCTGCAGTGAGCTGTGATCACACCACTGCACTTTGGCCTGGGTGACAGAACCAAACCCTATCCCCTACAAAAAAACAAAAAAAAAAAACAAAAAAAAA","AAGCTGAGGTGGGAAGATTGCTTGAAACCAGGAGTTTGAGACCAGCCTGGGCACCAAAGCCAGACCTTGTCTCTACCAAAAAAAAAAAAAAAAAAAAAAAAAAAAATTACCTGGTGGTGTGCCTGTTGTCCCAGCTACTTGAAAGGCTGAGGTAAGAGGATGACTTGAGCTTGAGCCTAGGAGTTCGAGGCTGCAGTGAGCTATGATCGCACCACTGCACTCCAGCCTGGGTGACAGAGCTCTCGGGACTCTGTCTCCAAAATAAATAAGTACATAAAATTAAAAAAA"
"chr1","24171501","24171653","chr1","217544386","217544536","68","193372885","TTAGCTGGGTGTAGTGGCAGGTACCTGTGGTCCCAGTGACTCAGAGACTGAGGCAGGAGGATCACCTGAGCCCAGGAGTAGAGGCTGCAGTGAGCTATGTTTGTGCCACTGCACTCCAGCCTGTGCAACAGAGCAAGACGCTGTCTCAAAAAA","GGCTGGGCGTGGTGGCTCATGCCTCTAATCCCAGCACTTTAGGAGGCCAAGGCAGGAGGATAACTTAAGACCAGGCTGGGTGACACAGTGAGACTTTGTCTCTAAAAAAAAAAAAAAAAAAAAAAAAAAAAAAAACCTACAAAAACATATA"
"chr1","24171962","24172104","chr5","32595015","32595178","46","8423053","GGCCAGGTGTGGTGACTCACATCTGTAATCACAGCACTTAGGGAGGCTGAGGTGGGAGGATTGCTTGAGGCCAGAAGTTTGAGACCGGCCTAGGCAACAAAGTGAGACCCCCTCTCTACAGAATATTTTTTTAAAATTAGCTG","GGCCGGGTGTGGTCCCTCATGCCTGTAATCCCAACACTTTGGGAGGCTGAGATAGGAGGACTGCTTGAGGCCAGGAGTTCAAGACCAGCCTGGTCAACATAGTGAGACCCCATCTCTATAAAATAATAATAATAATAATAATAATAATAATAAATAAATAAATA"
"chr1","24173658","24173874","chr14","51003183","51003398","59","26829525","CTAGGAGTATCAGCCTGGGCAACATAGTGAGACCCCATCTTTACAAAAAATTTTCAAAATTAGCCAGGCATGGTGGCGTACACCTGTAGCCCTGCCATCTCAGGAGGCTGAGGTGGGAGGATCCCTTGAGCCCAGGGGTTTTAGACTGCAGTGAACTATGATTGCACCACTGCACCCCAGCCTGGGTGACAGAGTGAGACTCTGTCTCTAAAAAAAA","AGCCTGGGCAAGATAGTGAGACCTCATCTCTTAAAATAAATAAATAAATAAATAAATAGCAGGATGTGGTGGCGTGCATCTGTAGTCCCAGCTACTCAGGAGGCTGAGATGGGAGGATTACTTGAGCTCAGGAGGTCGAGGCTGCAGTGAGCTATGATCACGCCACTGTACTCCAGCCTGGGTGAGAGTGATACCCTGTCTCTAACAAAAAAAAAA"
"chr1","24183316","24183603","chr13","11426887","11427206","91","12756429","GGTCGGGCATGGCAGCTGACACCTGTAATCCCAGCACTTTGGGACATCGAGGCAGGAGAATCATTTGAGACCAGGAATTTAAGACTTGCCTAGGCAACATAGTGAGACCACATCTCTACAAAATAAATTTTTTAAAAAATTAGCAGGGCACAATGGTGAGAGTAAGGAGGCTGAGGTGGGAGTTTCGCCTGAGCCCAGGAGTTCAAGGCTGCCGTGATTGTGCCACTGCACTTCAGTCTGGCCAACAGAGCAAGACCCTGTCTCTACGAAACAGACAAATATACAAAA","GCCAGGTGCAGCGGCTCGTGCCTGTAATCCCAGCACTTTGGGAAGCTGAGGCAGGAGGATCGCTTGACCCCAGGAGTTCAAGACCAGCCTGGGCAACAAAGTGAGACACTGTCTCTACAAAATAATAATAATAATAATAATAATAATAATAAATTAGCTGGGCATGAAGTCTGCTGGTTACACTGGAGGCTGAAGTGGGAGGATCACTTGAGCTCAGGAGTTCAAGGCTACAGTGAGCTGTGATTATTCCACTGCACTCCAGCCTGGGTAACAGCGCAAGACCCTGTCTAAAGAAAAACAAAAAACAAAAAACAAAAAAA"
"chr1","24198627","24198876","chr10","96412023","96412287","74","72213396","TTGGGAGGCCAAGGTGAGAGGATCACTTGACACCTGGAGTTTGAGACTAGTCTGGACAACATCACAAGACTCCATCTCTTAAAAAATTAAAATACTTAGCCGGGTGTGAAGGTGCATGCCTGCAGTCCCAGCTACTTGGGTGGCTGAGGCTGGAGGATCGCCTGAGCCCAGTTCAAGGCTTCAGGCAGCCATGATTGTTCTGCTGCACTCCAGCCTGGGTGACAGAGCGAGAACCCATCTCTAAAACAAA","CTTTGAGAGGAAGACGTAGGAGGATTGCTTGAGCCCAGCAGTTTGAGACTAGCCTGGGCAACATAGGAAGACTCCCATCTCTACACACACACACACACACACACACACACAATTATCCAGGGTGGTGGTGCATGCCTGTGGTCCCAGCTACTTGGGAGGTTGAGGTGGGAGGATTGCTTGAGCCCAGGAGGTCCAGGCTGTAGTGAGCCATGATCATACCGCTGCACTCCAGCCTGGGCAACAGAGTGAGACCCTGTCTCAAAAA"
"chr1","24204485","24204659","chr18","55799233","55799394","66","31594748","TCAGCTGAGCATGGTGGAGCATGCATGTATTTTGAGCTACTCAGGAGGCCGAGGTGGAAGGATTACTTGAGCCCAGGAGGCTGAGCCTGCAGTGAGCTGTGACTGCACCACTGTACTCTAGCCTGGGCAACAAAGCAAGACCCACTCTCTAAAAAAATTAAAAAGAAAGAAAGAA","GGCTGAGAGAGGTGGCTCATGCTTGTAATCCCAGCACATTGGGAGGCAAAGGTGGGAAGATTGCTTGAGGCCAGGAGTTCAAGACCAGCCTGGGCAACATGAAAACACTTTGTCTCTACAATAAATAAATAAATAAATAAATAAATAAAAGAAACAAGAAAA"
"chr1","24204943","24205084","chr18","55799233","55799394","46","31594290","GGCCAGGTGCAGTGGCTCATGCCTGTAATCCCAGAGTTTTGGGAGGCCAAGGTGAGAGACTTGCTTGAGGCCAGGAGTTCAAGACCAACCTGGGCAACATAGCAAGACCCTGTTTCTACAAAAATAAAAAAAAGTTAGCTGG","GGCTGAGAGAGGTGGCTCATGCTTGTAATCCCAGCACATTGGGAGGCAAAGGTGGGAAGATTGCTTGAGGCCAGGAGTTCAAGACCAGCCTGGGCAACATGAAAACACTTTGTCTCTACAATAAATAAATAAATAAATAAATAAATAAAAGAAACAAGAAAA"
"chr1","24209409","24209554","chr5","32595015","32595178","47","8385606","GGCCGGGCTCCATGGTTCGCACCTGTAATTCCAGCATTTTGGGAGGGCGATGCGGGAGGATAGCTTGAGGCCAGGAGTTCAAAACCAGCCTGGGCAACATAGTGAGACTCCTGTCTCTACAAAAAAATTTTTAAAAAAATTAGCCA","GGCCGGGTGTGGTCCCTCATGCCTGTAATCCCAACACTTTGGGAGGCTGAGATAGGAGGACTGCTTGAGGCCAGGAGTTCAAGACCAGCCTGGTCAACATAGTGAGACCCCATCTCTATAAAATAATAATAATAATAATAATAATAATAATAAATAAATAAATA"
"chr1","24209855","24210017","chr18","55799233","55799394","67","31589378","TTAGCTGAGGGCGGTGGGACAGACCTGTGGTACCAGCTACTTGGGAGGCTGAGGCGGGAGGATCTCTTGAGCCTAGAGTTCGAGGCTGCAGTGAGCTGTGATTGCATCACTGCACTCAGCCTGGGCAACAGAGTGAGACCCTGTCTTAAAAAAAAAAAGCAAA","GGCTGAGAGAGGTGGCTCATGCTTGTAATCCCAGCACATTGGGAGGCAAAGGTGGGAAGATTGCTTGAGGCCAGGAGTTCAAGACCAGCCTGGGCAACATGAAAACACTTTGTCTCTACAATAAATAAATAAATAAATAAATAAATAAAAGAAACAAGAAAA"
"chr1","24262109","24262416","chr14","31798968","31799292","77","7536859","GGCTGGGTGCGGTGACTCATGCCTGTAATCCCAGCACTTTAGGAGGCTGTGGCAGGAGGATCATTTGAGGCCAGGAATTTGAGACCAACCTGGACAACATAGTGAGACCCCATCTCTACAAAAAGTAAAAAAATTAACCAAGTGTGGTGGTGCGTGCCTGAAGTCCCAGCTGGTCAGGAGGCTGAGGTAGGAGGATTGCTTAAGCCCAGGAGGTCGAAGCTGCTGTGAGCTATGACTGTGCCACTGCACTCTAGCCTGGGTGACAGAGACCTTGTCTCAAAGAGATAAAAATAAATAAAAATAAAGAA","GGCTGGGCACAGTAGCTTACACCTGTAATCCCAGTACTTTGGAAGGCTGAAGTGGGAGGATCCCTTGAGGCCAGGAGTTTGAGACCAGCCTGGGCAACATAGTGAGACCCTGTCTCTACAACAAACAAACAAACAAACAAACAAAACTTAGCCAGTTGTGGTGGCACATCCTATAGTCCCAGCTACTCAGGAGGCTGAGGAGGGAGGATCTCTTGAGCCCAGGAGTTTGAGGCTGCAGTGAGCTATGATCATGACACTGCACTCCAGCCTGGATAACACAGCAAAATCCTGTCTCAAAAAAAAAAAAAAAAAAAAAAAAAAAGAA"
"chr1","24289498","24289779","chr19","13342110","13342403","86","10947388","GATGGCTCATGCCTGTAATCCCAGTGCTTTGGGAGGCCAAGGTGGGAGGATCACTTGAGGCTGGAAATTCAAGAGCAACCTAAGCAACATAGCAATATCCCCTCTCTAGAAAAAAAAAGTTTTAAACATTAGCTGGGTGTGGTGGTGTATGTCTGTAGTTCCAGCTACTTGGGAAGCTGAGGCAGGAGGATCACTTGAGCTTGGGAGCTGGAGGCTGCAGTGAATCATGATCATACTGGTGACACAGTGAGACCCTGTCTCATAAAAACAAAAAACAAAAAA","TCATGCCTGTAATCCCAGCACTTTGGGAAGCCAGGGCAGGAGGATCACTTGAGACCAGGAGTTTGAGACCAGCCTGGGCAACATAGCCAGACCCCCATCTCAACAACAACATCAACAACAACAACAACAAATTAGCTGGGTGTGGTGGTGCCTGTAGTCCCAGCTACTTGGGAGGCTAAGCTGGGAGGATCGCTTGAGCCCAGGAGCTCCAGGCTGCAGAGAGCTATGATCATATCACTGCACTCCAGCCTGAGTGACAGAGCAAGAACCTGCCTCTAAAAACAATAAACAAAA"
"chr1","24299621","24299915","chr8","15910614","15910909","76","8389007","GCCAGGCGTGGTGGTTCACACTTATTATTGCAACACTTTGGGAGGCTAAGGCAGGAGGATTGCTTGAGCCCAGGAGTTTGAGACCAGCCTGGGCAACACAGTGATGTCTTGTCTTACTAAAAGTTTTTTTAAAAATTAGCCAGGCGTGGTGGCTCACACCTGTGGTCCCAGCTCCTCAGGAGGCTGAGGTGGGAGGATCCCTTGAGCTGGGGAGTTTGAAGCTGCAGTCAGTTGTGATGGTGCCGCTGCATTGCAGCCTGGGTGACAGAGCCAGACCCTGTCTCAATTTAAAAAA","GGCCAGGCGAAGTGGCTCACACCTGTAATCCCAGCACTTTGGGAGGCCAAGGCAGGAGGATCATTTGAAGCCAGGAGTTCAAGGCCAGCCAGAGAAACATAGTGAGAACCTGTCTTTACAAAAATTAAAATTAAAATTAAAATTAGCCAGGAGTGGTGGTGCATGCCTGCAGTCCCAGCAGCTCAGGAGGCTGAGGTGGGATGATTGCTTGCACCAGGAGTTCGAGGCTGCAGTGAGCTGTGATCGTGCCACTGCACTCCAGCCCCTGGGTGACAAAGCAAGATCCTCTAAAAAAA"
"chr1","24382907","24383212","chr9","68878569","68878883","71","44495662","GGACAGGCACGGTGGCTCATGCCTATAATGCCAGCATTTCGGAAGGCCAATGCGGGAAGATCACTTAAGCCCAGGAGTTCAAGACCAGCTCGGGCAACATAGTGAGACCCCATCTCTACAAAATAATTTAAAAATTAGCCAGGAGTGGTGATGTGTGTCGATAGTCCCAGCTACTCGGGAGGCTGAGGTGGGAGGATCACTTGAGCCCAGGAGGTTGAGGCTGCAGTGAACTATGATTTCACCATCACACTCCAGCCTGGGTGACAGAGGCAGACTCTGTCCAAAAAAAAAAAAAGTGAAAAGAAA","GGCTGGGCACGGCAGCTCATGTCTGTAATCCCAGCACTTTGGGAGGCCAAGGTGGGAGGATTGCTTGAGTCCAGGAGTTCAAGACCAGCCTGGGCAACATAGTGAAACCCCAGTCTCTACAAATAAATAAATAAATAAATAAATAATTAGCTGGGCATGTTGATGCATGCCTGTAGTCCTAGCTACTCGGGGGGTGAGGTGAGAGGATTGCTTGAGTCCAGAAGGTGGAGGCTGCAGTGAGCTATGATCACACCACTGCACTCCAGCCTGGAAGACAGGGTGAGACGCTGTCTTTAAAAAAAAAAAAAGAAAAGA"
"chr1","24402491","24402775","chrX_NW_019937303v1_random","2630481","2630786","77","21772010","GTGGCTCACACCTATAATCCCAACACCTTGGGAGGCTGAAGCGGGAGGATTGCTTGAAGCGAGGAGTTTGAGACTAGCCTAAGCAACATAGTGAGACCCCATCTCTACGAAAAATAAAAAATTAGCCAGCCTGTAGTCCCAGCTACTCTGGAGGCTGAGGTGGGAGAACTGCTTAAGCCCAGGAGATCAAGGCTGCACTGAGCCATGACAGCACCACTGCACTCCAGAATGGACAACAGAGCAACAGCCTATCTCAAAAAAAAAAAACAAAAAAAAACAAAAAAA","GCTGGGCGTGGTGGCTCACGTCTCAAATCCCAGCACTTTGGGAGGTCAAGCAGTGAGGATTACTTAAGGCCAGGAGTTTGAGACCAGTCTGGGAAACATAGTGAGAGTCTGTCTCTACAAAACACACACACACACACACACACACACACACCTGTAGTCCCAGGTACTCAGTAGGCTGAGGCAGGAGGATTGCTTGATCCCAGGAGTTCAAGGCTGCAGTGAGCTGAGATTGCACCACTGCACTCCAGCCTGGGCAACAGAGCGAGACTCCATCTCAAAAAAAAAAAAAAAAAGAAAAGAAAAGAA"
"chr1","24412577","24412699","chr15","37343640","37343763","65","12931063","GGCCAGGCATGGTGGCCCACACCCGTAATCCCAGCACTTTGAGAGGCTGAGGGGGAAGGATGGCTTGAGACAGAAGTTCAAGACTACCCTGGGCAACATAGCAAGGCCCTGTCTCTACAAAAA","AAGATCCCTGGCCAGGATTTCAAGACCAGCCTGGGCAACACAGTGAGACCATACATACATACATACATACATACATACATCATACATACATACATACATACATACATACACAGTCTTACAAAGA"
"chr1","24420220","24420514","chr3","83975049","83975347","75","59554829","GGCCAGTTGTGGTGGCTCATGGCTGTAATTCCAGCACGTTGGGAGGCCAAGGCGGGAGGATCTCTTGAGGCCAGAAGTTTGAAACCAGCCTGGGCAACATAGTGATACCCCGCCTGTACAAAACAATTGAAAATTAGCCAGGTGTGGTGGCATGTGCCTGTAGTCCTAACTACTCAGGAGGCTGAGACGGGAGGATTGCTTGAGCCTAAGAGTAGTTTGAGGGTGCTGTGAGCTATGATTGCACCACTGCACTCTAGCCTGGGTGACAGAGCAAGACCCTGATGCCAAAAAAAAA","GGCTGGGTGCAGTGGCTCATGGCTGTAATCCCAGGACTTTGGGAGGCTGAGGCAGGAGAATCACTTGAGGCCAGGAGTTTGAGACCAACCTGGGCAACAAAGTGAGGCATGTCTCTACAAAAACAAAACAAAACAAAACAAAACAATTAGCTGTGTGTGGTGATGCCTGCCTGTCGTCCCAGCTACTCGGGAGGCTGTGGTGGGAGGATCTCTTGAGCCTGGGAGGTTGAGGCTGCAGTGAGCTGTGATTGCCCACTGTACTCTAGCATGGGTTACAGAGCAAGACTCTGTCTCAAAAA"
"chr1","24442671","24442982","chr5","93301689","93301993","69","68859018","CTGAGTGCAGTGGCTTGTACCTGTAATCCCAGCTACTTGGGAGGCTGAAGTGGGAGGATCGCTTGAGGCCAGGAGTTTGAGACCAGCCTGGGCAACATGGAGAGACCCCATCTCTACAAAATGAAACAAACAAACAAAAAAGAAAAACAATTAGCTGGGCATGGTGGTATGCATCTGTGGTCCTAGCTACTTGGGAAACAGAAGCAGGAGGATCCCTTAAGTCCAGTGTTTGAGTGCTGCAGTGAGCTTTGATTACACAATTGCACTCCAGCCTGGGTGACAGAGCAAGACCTCATCTATTGAAAAAACAAA","CGGGCATGGTGGCTCATTCCTGTAATCCCAGCACTTTGGGAGGCCCAGGTGGAATGATCGCTTCAGCCCAGGAATTTGAGACCAGCTTGGGCAACACAGTGAGACCCTGTCTTTACAAAAACAAACAAACAAACAAACAAAAAAACAATTAGCTGGGCATGGTGGTGTGCCTCTGTAGCCCCAGCTACTCAAGAGGCCGAGATGGGAACATCGCTTGAGTCCAGGAGGTTGAGGCTGCAGTGAGTGTAACCACACCACTATACTCCAGCCTGGGTGACAGAGCAAGACCCTGTCTCAAAACAAAA"
"chr1","24471293","24471598","chr9","68878569","68878883","63","44407276","GCTGGGCACAGTGGCTCATGCCTGCAATCCCAGCACTTTGGGAGGCCAAGGCTGGAGGATCACTTGAGCCCAGGAGTTTTATATCAGCCTGGGCAACATAGCAAGACCTCATCTCTGCTAAAAATTAAAAATAAATAAATTAGCTGGGTGTGGTGGTGCATGCCTGTGATCCTAGCTACTCAGGAGGCTGAGGTGGGAGGATCGCTAGAGCCCAGAGAGCCAAGGCTACAGTGAGCCATGATCATGCTACTGCACTCCAGCCTGGGTGACAATGAGACCATGGCTCAAAAAAAAAAAAAAAAAAAA","GGCTGGGCACGGCAGCTCATGTCTGTAATCCCAGCACTTTGGGAGGCCAAGGTGGGAGGATTGCTTGAGTCCAGGAGTTCAAGACCAGCCTGGGCAACATAGTGAAACCCCAGTCTCTACAAATAAATAAATAAATAAATAAATAATTAGCTGGGCATGTTGATGCATGCCTGTAGTCCTAGCTACTCGGGGGGTGAGGTGAGAGGATTGCTTGAGTCCAGAAGGTGGAGGCTGCAGTGAGCTATGATCACACCACTGCACTCCAGCCTGGAAGACAGGGTGAGACGCTGTCTTTAAAAAAAAAAAAAGAAAAGA"
"chr1","24474132","24474442","chr5","63802202","63802507","64","39328070","GACTGGGCATGGTGGCTTATGCCTGTAATGCCACCACTTTGGGAGGCCAAGGTAGGAGGATCACTTGAGCTCAGCAATTTGAGACCAGCCTGCACAACATAGCAAGACCCCATCTCTACTAAAAAAAAAATTAAAAATTAAAATAAAAATTAGCAGGCATGGTGGTGTGTGCCAGTAGTCCCAGCTACTCAGGAGGCTGAGGTGAAAAGATTGCTTGAGCCCAGGAGACTGAGGCTGCAGTGAGCCATGATTGCACCTCTGCATTCCAGCCTGGGCAACAGAGCAAGACCCTATCTCAAAAAGAAAAGAAA","GACTAGGGGTGGTGGCTCATGCCTGTAATCCCAGCACTTTGGGAGGCTGAGCTGGGAGGATTGCTTGAGCCCAGAAGTTCAAGACCAGCCTGGGCAACATAGCAAGACTCCATCTCTAAAAAAAAAAAAAAAAAAAAAAAAAAAAAATTAGCCCCGAGTGGTGGTGTGCACTTGTAGTCCCAGCTACTCAGGAGGCTGAGGTGGGAGGATCTCTTGAGCCTGGGAGGTCCAGGCTGCAGTGAACCATGATTGTGCCACTGGACTCCAGCCTAGGCAATAGAGTGAGACCTTGTCTCAAAAATAAAA"
"chr1","24484652","24484954","chrX_NW_019937303v1_random","2630481","2630786","79","21854171","GGCCAGGCAAGGTGGCTCAGGCCTATAATCCCAGCACTTTGGGGAGGCTGAGGCAGGAGGATCACTTGAGGCCAGGAATTTGAGACCAGCCTGAAAACATAGCGAGACCCTGTTTCTATAAAAAATAAAAAGCTAGCCGGGTGAGGTGGCTCACACCTATAGTCTCAGCTACCTGAGAGGCTGAGGTGGGAGGACAGCTAGAGCCCAGGACTTGGAGGTTAAAGTGAGCTATGATTGCGCCACTACACTCCAGCCTGGGCAACAGAGTGAGACTCTGTCAAAGAAAAAGAAAGGAAAGAAAAA","GCTGGGCGTGGTGGCTCACGTCTCAAATCCCAGCACTTTGGGAGGTCAAGCAGTGAGGATTACTTAAGGCCAGGAGTTTGAGACCAGTCTGGGAAACATAGTGAGAGTCTGTCTCTACAAAACACACACACACACACACACACACACACACCTGTAGTCCCAGGTACTCAGTAGGCTGAGGCAGGAGGATTGCTTGATCCCAGGAGTTCAAGGCTGCAGTGAGCTGAGATTGCACCACTGCACTCCAGCCTGGGCAACAGAGCGAGACTCCATCTCAAAAAAAAAAAAAAAAAGAAAAGAAAAGAA"
"chr1","24517711","24517835","chr18","55799233","55799394","58","31281522","GGCCAGATATGATGGCTCATGCTTGTAATCCCAGCACTTTGGGAGGCCAAGGCAAGAGGATCGCTTGAGACCAGGAGTTTGAGACCAGCCTGGGCAACAGAGTGAGACCTCGTTTCTATTAAAGA","GGCTGAGAGAGGTGGCTCATGCTTGTAATCCCAGCACATTGGGAGGCAAAGGTGGGAAGATTGCTTGAGGCCAGGAGTTCAAGACCAGCCTGGGCAACATGAAAACACTTTGTCTCTACAATAAATAAATAAATAAATAAATAAATAAAAGAAACAAGAAAA"
"chr1","24526110","24526362","chr10","21907346","21907618","81","2618764","GGCCAGGCACAGTGGCCCATTCATCCTAGCACTGTGGGATGCCAGGAACTTGAGACCAGCCTGGACAACACTGCAAGACCCCATCTCTACAAACAATTAAATAATTAGCCAGGCATGGTGGCATACGCTTGTAGTCTTATCTACTCGGTTGGCTAAGGTGGGAAGATTGCTTGAACCCAGGAGTTCGAGGCCGCAGTGAGCCACAATCTCACCACTGTACTCCAGCCTGGGCAACAGAGTGAGACCCTGTCTC","GGCCAGGTGCACTGGCTCACACCTGTAATTCCAGCGCTTTGGGAGGCCAAGGCAGGATTGTTTGAGAGCAGCCTGGGCAACATGAGACCCTGTCTCTACAAAAAAAAAAAAAAAAAAAAAAAAACTTAGCCAGACACGGTGGCACATGCCTGTAGTCCCAGCTACTCAGGAGACTGGGGTGGGAGGATCGCTTGAGCCCAGGAGTTTGAGGTTGCACAGAGCTGATTGCACCACTGCCATCTAGCCTGGGTGACAGAGTGAGACCCTGTCTTA"
"chr1","24554793","24554951","chr1","217544386","217544536","61","192989593","AGCTGGGCATGGTGGCTCATGCCTGTAATTCCAGTACTTTGGGAGGCCAAGGTGGGAGGATCGCTAGAGCCCAGGAGTTAGAGGCTGCAGTGAGCCGAAATCCCGCCACTGCACTCCAGCTGGGGCAGGAGAGCAAGACCCAGTCTCCATAAAATAAAA","GGCTGGGCGTGGTGGCTCATGCCTCTAATCCCAGCACTTTAGGAGGCCAAGGCAGGAGGATAACTTAAGACCAGGCTGGGTGACACAGTGAGACTTTGTCTCTAAAAAAAAAAAAAAAAAAAAAAAAAAAAAAAACCTACAAAAACATATA"
"chr1","24577453","24577574","chr20","87144","87254","62","24490309","GGCCGGGCATGGTGGTTCAAGCCTGTAATCCCTGCACTTTGGGAGGCCGAAGTGGGAGGATCACTTGAGGCCAGGAGCTGGAGGCCAGCCTGGGCAACGTAGTGAGAACCCATCTCTACAAA","CCTGGGCAACATAGTGAGACTACATCTCTACACTCACGCACACACACACACACACACACACACCCCCCAAATTAGCCAGGCATGCTGATGTGCACCCATAGTCTCAGCAAC"
"chr1","24578553","24578865","chr13","11426887","11427206","74","13151666","GTCAGGTGTAGTGGCTCTTGTCTGTAATCCCAGCACTTTGGGAGGCTGGGGCAGGAGGATTGCTTGAGGCCAGGAGCTTGAGGCCAGCTTGAACGGTATAGTGGGACCCAATCTCTACAAGAAATAAAAATAAAAATTTGCTGGGCATGGTAGCATGTGCCTGTAGTCCCAGCTATTTAGGAGGCTGATGTGGGAGGATCACTTGAGCCCAGGACGTTGAGGCTGCAGTGAGCTGTGATTGTACCACTGCACTCCAGCCTGGGAGACAGAGCAAGAAACCGTCTCAAAAAAAAAAAAAAAAAAAAGAAAGAAA","GCCAGGTGCAGCGGCTCGTGCCTGTAATCCCAGCACTTTGGGAAGCTGAGGCAGGAGGATCGCTTGACCCCAGGAGTTCAAGACCAGCCTGGGCAACAAAGTGAGACACTGTCTCTACAAAATAATAATAATAATAATAATAATAATAATAAATTAGCTGGGCATGAAGTCTGCTGGTTACACTGGAGGCTGAAGTGGGAGGATCACTTGAGCTCAGGAGTTCAAGGCTACAGTGAGCTGTGATTATTCCACTGCACTCCAGCCTGGGTAACAGCGCAAGACCCTGTCTAAAGAAAAACAAAAAACAAAAAACAAAAAAA"
"chr1","24593202","24593525","chr9","68878569","68878883","74","44285367","GGCTGGGCATAGGGGATCATGCTTGTAATCCCAGCACTTTGGGAGACCAAGGTGGGAGGATCGCTTTGAGTCCAGGAGTTTGAGACCAGTCTGGGCAACATAATGACATCTAGCCTCTATAAAAAAAAAAGAGTTTTTTTAATTAGCCAGGCATGGTGGTGAATGCCTGTAGTCCCAGCTATTCAGGAGGCTGAAGTGGGAGGATTACTTGAGCCTGGGAGGTTGAGGCTGCAGTGAGCTATGATTACATCACTGCACTCCAGCTGGGGCAACAGAGTGAGACTCCATCTCAAATAAATAAATAAATAGAAAAACTGAAGAAAA","GGCTGGGCACGGCAGCTCATGTCTGTAATCCCAGCACTTTGGGAGGCCAAGGTGGGAGGATTGCTTGAGTCCAGGAGTTCAAGACCAGCCTGGGCAACATAGTGAAACCCCAGTCTCTACAAATAAATAAATAAATAAATAAATAATTAGCTGGGCATGTTGATGCATGCCTGTAGTCCTAGCTACTCGGGGGGTGAGGTGAGAGGATTGCTTGAGTCCAGAAGGTGGAGGCTGCAGTGAGCTATGATCACACCACTGCACTCCAGCCTGGAAGACAGGGTGAGACGCTGTCTTTAAAAAAAAAAAAAGAAAAGA"
"chr1","24606985","24607300","chr14","31798968","31799292","64","7191983","GGCTGGGCACCATAGTCCATGCCTGTAATCCCAGCACTTTGGGAGGCCAAAGCAGAAGGATCACTTGAGGCCAGGGGTTCAAGACCAGCCTGGGCAACACAGCGAGACCCCATCTCTACAAAAATAAAAAATAAAAAAATTAGCCTGGTGAGGTGACACATACCTGTAGTCCCAGCTACTCTGGAGGCTGAGGAGGGAGCATCCCTTGAGCCCAGGAGTTCAAGGCTGCAGCGAGCTGTGAGCGTGCCACTGCACTCCAGCCCAGGTGACAGATTGAGGCTCTGTCTCAAAAAAAAAAAAAAAAGAAAAGAAAAAA","GGCTGGGCACAGTAGCTTACACCTGTAATCCCAGTACTTTGGAAGGCTGAAGTGGGAGGATCCCTTGAGGCCAGGAGTTTGAGACCAGCCTGGGCAACATAGTGAGACCCTGTCTCTACAACAAACAAACAAACAAACAAACAAAACTTAGCCAGTTGTGGTGGCACATCCTATAGTCCCAGCTACTCAGGAGGCTGAGGAGGGAGGATCTCTTGAGCCCAGGAGTTTGAGGCTGCAGTGAGCTATGATCATGACACTGCACTCCAGCCTGGATAACACAGCAAAATCCTGTCTCAAAAAAAAAAAAAAAAAAAAAAAAAAAGAA"
"chr1","24623681","24623997","chr3","54066100","54066414","76","29442419","GTGTAGTTGCTCACACTTATAATCCTAACACTTTGGGAGGCTGAGGCAGGAGAATCGCTTGAGCCCAGGAGTTCAGACCAGCTTGGGCAACATTAGAGAGACCCTGTCTCTACAAAAAGAAAAAAAAAGGAAAAAATATATATATATAATATTAGATGAGTGCAGTGATGTGGGCTTGTAGTCCCAGAACTTTGGGAGGCTGAGGTGAGAGGATTCCTTGAGTTCAGGAGTTTCAGGCTGCGGTGAGCTATGATCATGCCACTGCACTCCAGCTTGGGTGACAGAGCAAGACCCTGTCTTGAAAAAAGAAAAAAAAA","GGATGTAGTAGTTCACGCCTATAATCCTAGCATTTTTGGGAGGCCAAGGCAGGAGGATCACCTGAGGCCAGGAGTTCCAGACCAGCCTGGGCAAGATAGTGAGACCCTATCTCTAAAAAAAAAAAAAAAAAAAAAAAAAATTTAGCTGGGTTTGGCAGCTCATGTCTGTAGTCCTAGCTACTTGGGAGGCTGAGGTGAGAGGATCACTTGAGGCCAAGAGTTAGAGGCTGCAGAGAGCTATAATTGTGCCATTGTACTCCAGCCTGGGTGACAGAACAAGACTCTGTCTCTAAAAACAAAAATAAAGTAGAAAAA"
"chr1","24638083","24638195","chr20","87144","87254","61","24550939","GGCTGGGCATCATGGTTCATGCCTGTAATCCCAGGACTTTGGGAGGCCAAGGCGGGAGGATTGCTCCAGGCCAAGGGTTTGAGACCAGCCTGGACAACATAGTGAGATACCCC","CCTGGGCAACATAGTGAGACTACATCTCTACACTCACGCACACACACACACACACACACACACCCCCCAAATTAGCCAGGCATGCTGATGTGCACCCATAGTCTCAGCAAC"
"chr1","24670500","24670755","chr1","181746874","181747121","83","157076374","GAGGCCACAGCAGGAGGATCACTGGAGGCTAGGAGTTCAAGATCAGCCTGGTCAACACAGCAAGACCCTGTCTCTACAAAAAGTTAAAAACAAAAAACCAGCCAGGTGTAGCAGCATGTGCCTATAATCCCAGCTACTTGGGAGGCTGAGGCGAAGGGATCACCTGCGTCCAGGAAGGCTGCTGTGAGCTATGATCATCCCACTGCACTCAGCGTGGGTGACAGCATGAGACCCTGTCTCAAAAACAAACAAAAAA","TATAATCCCAGCACTTTAGGGGGCTGAGGAGTTCAAGATCAGCCTGAGCAACTTAGTGAGACCCCATTTCTTAAAAAAAAAAAAAAAAAAAAAAAAAAAGGCCAAGTGCGGCAGCACATGCCTGTAGTCCCAGCTACTCAGGAGGATCATTTAAGCCCAGGAGTTCAAGGTTGCAGTGAGTTATGATCACATCACTGCACTCCAGCCTGGGCAACAGAGCAAGACCCTGTCTGTTAAAAAAAAAAAAA"
"chr1","24674760","24675023","chr9","79131976","79132248","71","54457216","GCCAGGCATGGTAGATCATGCCTGTAATTCCAACACTTTGGGAGGCCGAGGCAAGAGGATTGCTTGAGCCCAGGAATTTGAGACCAGCCTGGACAACAATAGCGAGACCTCATCTCCAAAAAACTTTTTTTAAAAAAGCCCTAGGCATGGTGGTGTGTGCCTATAGCCTCAGCTACCCATGAGGCTGAGGTGGGAGGTTCACTTGAGCCTTGGAAGTTGAGGCTGCTGTGAGCCATGATCACACCACTGCACTCCAGCCTGGGC","GGCTGGGCATGGTGGCTCACACCTGTAATCTCAGCACTTTGGGAGTCTGAGTTGGGAAGATTGCTTGAATCCAGGAGTTGGGAGACCAACCTGGGCAACAAAGCGAGACCCTGCCTCTCCAAAAAAAAAAAAAAAAAAAAAAAAAAAAAGCTGGGTGTGAAGGTGCATGCCTGTAGTCTCAGCTATTCTAGAGGCTGAGGTGGGAGGATCGCTTGAGCTATGGAGTTTGAGGCTGCAGTGAGCTATGATGGGATCACTGCACTCCAGCCTGGG"
"chr1","24681351","24681470","chr9","47045786","47045941","63","22364435","GCAGGGTGGGTGACTCACATATGTAGTCCCAGCACTTCAGGAGGCCAAGGCAGAATTGCTTGAGGCCAGGAGTTCAAGATCAGTCTGGAAGACATAAAGAGACCCCTTCTCTATAAAAAA","GCTGGGCGCAGCAGCTCACACCTGTAATCCCAGTGCTTTGGAGGTCCAAGGTAGGAGGATTGCTTAAGACTAGGTGTTCAAGACCAGTCTTGGCAACATAGTGAGAACTCATCTCTACAATAAATAAATAAATAAATAAATAAATGAAAATAAAAA"
"chr1","24718981","24719275","chr19","8207092","8207388","95","16511889","GGCTGGGTGCAGTGGCTCATGCCTGTCATCCTCATGCTTTGGAAGGCTGAGGTGGAAGTATCCTTGAGGCAGGAATATCCTTGAGGCCAAGAGTTCAAGACCAGCCTGGGCAACATGGTGAGACCCCTATCTCTACCAAGAAAAATTAAAATCAGCTGGGTGTGGTGGTACATGCCTGTAGTCCTAGCCACTCAGGAGATTGAGGCGGAAAGATTCCTTGAGCCCAGGAGCTATGATTGCACCACTGCATTCCATCCTGGTGACAGAGCCCAACCCTGTCTCTATTTTAAAAAAA","GGCCGGGTGTGGTAACTCATGCCTATAATTCCACTGCTTCGGGAGGCTGAGATGGGAGGATTACTTGAGGCTAGGAGTTTGAGACCGGCTTTGGCAACATAGTGAGACCCTGTCTCTACCAAAAAAAAAAAAGAAAAAGAAAAAGAAAAAGCTGGGTGAGGTGGTACATGCCTGTAGTCCCAGCTACTCAGGAGGCTGAGGTGGGAGGATCCTTTGAGTCCAGAAGCTATGATTGCACCACTGCACTCCAGCCTGGGGAGACTGTCTCTGGAAAAAAAAAAAAAAAAAAAAAAAAGA"
"chr1","24734742","24734893","chr1","217544386","217544536","73","192809644","ATTAGCTGGGTATGGTGGTGCACACCTGTAGTGCCAGATAATTGGGAGACTGTGGTGGGAGGATCACTCGAGCCTAGAAAGTCAAGACTGCAGTGAGCCGTGGCTGTGTCACTGCACTCCAGCCTGAGTGACAGAGAACCTCTCTCAAAAAA","GGCTGGGCGTGGTGGCTCATGCCTCTAATCCCAGCACTTTAGGAGGCCAAGGCAGGAGGATAACTTAAGACCAGGCTGGGTGACACAGTGAGACTTTGTCTCTAAAAAAAAAAAAAAAAAAAAAAAAAAAAAAAACCTACAAAAACATATA"
"chr1","24735210","24735345","chr5","32595015","32595178","58","7859805","GGCCAGATGTGGTGGCTTAAGCCTGTAATCCCAGCATTTAGGGGGTTTGAGGCAGGAGGATTGCTTGAGTCCAGGACATCGAGACCAGTCCCAGCAACATAACGATCCGTCTCTACAAATACTAATAAAATATTAG","GGCCGGGTGTGGTCCCTCATGCCTGTAATCCCAACACTTTGGGAGGCTGAGATAGGAGGACTGCTTGAGGCCAGGAGTTCAAGACCAGCCTGGTCAACATAGTGAGACCCCATCTCTATAAAATAATAATAATAATAATAATAATAATAATAAATAAATAAATA"
"chr1","24749676","24749813","chr9","47045786","47045941","51","22296110","GCTGGGCTGTGGTGGCTCACGCCTGTAATCCTAGCACTGTAGGAGGCCAAGGAGGATGAATCTTTTGAGCGCAGGAGTTCTAGACCAGCCTGGGCAACATGGCGAGACCCTGTCTCTACAAAAACTATTAAAAAAATT","GCTGGGCGCAGCAGCTCACACCTGTAATCCCAGTGCTTTGGAGGTCCAAGGTAGGAGGATTGCTTAAGACTAGGTGTTCAAGACCAGTCTTGGCAACATAGTGAGAACTCATCTCTACAATAAATAAATAAATAAATAAATAAATGAAAATAAAAA"
"chr1","24750085","24750261","chr19","13525969","13526165","76","11224116","TAAGTAAGTAACTAAGCTGGGCCTGGTGGCCCACGCCTGCAGCCCTAGCCCTAGAGGCTGCGGGTGGGAGGATTGTTTGAGCCCAGGAGTTCGAGGCTGCAGTGAGCTTATGATCATGTACCTGCACTCCAATCTGGGTGACAGAACAAGACCCTGTCTCGGGAGGAAAACAACAAA","AAGAAATAAATTAGTTGAGCATGGTGGTGCATGCCTATAGTCCCAGCTACTGGGGAGGCCAAAGTGGGAGGATTGTGTGAGCCCAGGAGTTTGAGGCTGCAATGAGCCAAGATTATGCACACCAGTGTGGGAGACAGTCAAGTCTCAAAAAATAAACAACAACAACAACAACAACAACAAACACATAAAAAGAAAAA"
"chr1","24755472","24755630","chr6","36141662","36141829","69","11386190","GTGGTGGTGAGTGCCTCTAGACCTAGCTTTGGCAGGCTGAGGCCGGAGGATCACTTGAGCCTAGAAGTTCAAGGCTGCAATGAGCTATGATTGTGCCACTGCACTCTGGCCTGGGTGACCGACGGAGATCCTATCTCTTAAAAAAAAAAAAGAAAAGAA","GGGCAGGCGCAGTGGCTCATTCCTGTAGTCCTAGCACTTTGGGAGGCCAAGGAGACGGGATTGCTTGAGGCCAGAAGTTCAAGACTTCAAGACCAGCCTGGACAACATAGTGAGACCCTATCTCATATATATATATATATATATATATAAATTAAAAATAATAATAAA"
"chr1","24773592","24773898","chr14","31798968","31799292","77","7025376","GGCTGGGTGCAATGGCTCACACCTGTAATCCCAACACTCTGGGAAGCCAAGGTGGGAGGATCACTTGAAGCTGGGAGTTTTGAGACCAGCCTGGACAACACAGTGAGACCCCCATCTCTATGAAAAATAAGAAAATTAGCCAGATATGGTAGTACACACCTTTAGTCCTAGCTACTCAGAAGGCTTAAGCAGGAGGATCACTTGAGCCCAGGAGGTCAAGGATGTAGTGAGCTATGATCTTACCACTGCACTCTAGCCTGGATGACAAAGTGAGGCCCTGTCAAAAAAAAAAAAAAAAAAAAAAAAA","GGCTGGGCACAGTAGCTTACACCTGTAATCCCAGTACTTTGGAAGGCTGAAGTGGGAGGATCCCTTGAGGCCAGGAGTTTGAGACCAGCCTGGGCAACATAGTGAGACCCTGTCTCTACAACAAACAAACAAACAAACAAACAAAACTTAGCCAGTTGTGGTGGCACATCCTATAGTCCCAGCTACTCAGGAGGCTGAGGAGGGAGGATCTCTTGAGCCCAGGAGTTTGAGGCTGCAGTGAGCTATGATCATGACACTGCACTCCAGCCTGGATAACACAGCAAAATCCTGTCTCAAAAAAAAAAAAAAAAAAAAAAAAAAAGAA"
"chr1","24782707","24783011","chr13","11426887","11427206","83","13355820","GGACACAGTGGCTCTGTAATCCCACCGCTTTCGGAGGCTGAGGCAGGAGGATTGCTTGAGGCCAGGAGTTCAAGACTAACCTGGACAACAGAGCAAAACTGTCTCTACAAAAAAGTAAAAAAATTAGCCAGGCATAGTGATGTTTGCCTGTATTCCTAGCTACTGCAGAGGCTGTGGTGGGAGGATCACTACAGCCTGGAGAGTTCAAGGCTGCAGTGAGCTATGATGGCACCACTACATTCCAGCCTGGGCAGCAGAGCAAGACCCTGTCTCAAAAAAAACCCAACAAAACAAAAACAAAAAAA","GCCAGGTGCAGCGGCTCGTGCCTGTAATCCCAGCACTTTGGGAAGCTGAGGCAGGAGGATCGCTTGACCCCAGGAGTTCAAGACCAGCCTGGGCAACAAAGTGAGACACTGTCTCTACAAAATAATAATAATAATAATAATAATAATAATAAATTAGCTGGGCATGAAGTCTGCTGGTTACACTGGAGGCTGAAGTGGGAGGATCACTTGAGCTCAGGAGTTCAAGGCTACAGTGAGCTGTGATTATTCCACTGCACTCCAGCCTGGGTAACAGCGCAAGACCCTGTCTAAAGAAAAACAAAAAACAAAAAACAAAAAAA"
"chr1","24790887","24791011","chr1","217544386","217544536","57","192753499","GGCCGGGCGTGGTGGCTCACACCTGTAATCCCAGCACTTTGGGAGGCCAAGGTGGGAGGATAACTTGAGGCCAGGAGTTTGAAACCAGCCTGGGCAACATAGTTAGAACCCCATCTCTATTAAAA","GGCTGGGCGTGGTGGCTCATGCCTCTAATCCCAGCACTTTAGGAGGCCAAGGCAGGAGGATAACTTAAGACCAGGCTGGGTGACACAGTGAGACTTTGTCTCTAAAAAAAAAAAAAAAAAAAAAAAAAAAAAAAACCTACAAAAACATATA"
"chr1","24811461","24811779","chr9","68878569","68878883","77","44067108","GGCTGGGTGCAGTGGCTCATACCTGTAACATTAGCACTTTGAGAGGCCAAGGCAGGAGGATTGCTTGAGTCCAGGAGTTCAAGCGAGACCAGCCTGGGCAACATAGTGAGATCCCATCTCTATAAAAAAATTTTTTTTAATTAGCTGGGTGTGGTGGCATGTGCCTGTAGTCCCAGCTACTTGGGAGGCTGAGATGGGAGGATTGGTTGAGCCCAGGCGGTCGAGGCTGCAGTGAACAGTGATCATATCACTGCACTTCAGCCTGGGCAACAGAGTGAGACCCTGTCTCAAAACAACAACAACAACAAACCAAAACAAA","GGCTGGGCACGGCAGCTCATGTCTGTAATCCCAGCACTTTGGGAGGCCAAGGTGGGAGGATTGCTTGAGTCCAGGAGTTCAAGACCAGCCTGGGCAACATAGTGAAACCCCAGTCTCTACAAATAAATAAATAAATAAATAAATAATTAGCTGGGCATGTTGATGCATGCCTGTAGTCCTAGCTACTCGGGGGGTGAGGTGAGAGGATTGCTTGAGTCCAGAAGGTGGAGGCTGCAGTGAGCTATGATCACACCACTGCACTCCAGCCTGGAAGACAGGGTGAGACGCTGTCTTTAAAAAAAAAAAAAGAAAAGA"
"chr1","24820268","24820549","chr11","34622326","34622621","85","9802058","GCTTACATGTGTAATCCCAGCAATTTGGGAGGCTGAGGCAGGAGGACTGATTGTGTCCATGAGTTTGAGACCAACCTGGGCAACATAGCAAGACCCCATCTCTACAAAAATTTTTTTAAACTTAGCTGGGCATGGTGGCACACACCTGTACTCCCAGTGCCTCAGGGGAATTGCTTGAGCCCAGGAGGTCGAGGCTGTGGTGAGCCATAATCACACCACTGCACTCCAGCCTGGGCAACAGAGCAAGACCATGTCTCAAAAAAAAAAAAAAAAAAAAAAAAA","ATGCCTGTAGTCCCAGTTACTTGAGAGGCTGAGGCAGGAGGATCACTTGAGGCAAGGAGTTTGAGATCAGCCTGGGTAACATAGTGAGACCCTATCTTTACAAATAAAATAAAATAAAATAAAATAGCCAGACATGGTGGTGTGCACCTGTAACCCTAGCTAATGGGGAGGCTGAAGCAGGAGGATCGCTTGAGCCCAGGAGTTGGAAGCTGTAGTGAGCTGATTACACCACTGCACTCCTGCCTGGGCAACACAGCAAGACTCTGTCTCAACAACAACAGAATAAAAAGAGAGAA"
"chr1","24847790","24847908","chr1","217544386","217544536","64","192696596","GGCCGGGCGCGGTGGCTCACGCCTGAAATCCCAACAGTTTCGGAGGCTACGACAGGAGGATTGCTTGAGGCCAGGGGCTTGACACCAGCCTGGGCAACAGAGCTAGAATCCTGTCTCTA","GGCTGGGCGTGGTGGCTCATGCCTCTAATCCCAGCACTTTAGGAGGCCAAGGCAGGAGGATAACTTAAGACCAGGCTGGGTGACACAGTGAGACTTTGTCTCTAAAAAAAAAAAAAAAAAAAAAAAAAAAAAAAACCTACAAAAACATATA"
"chr1","24858065","24858363","chr14","31798968","31799292","81","6940903","GGCCGGGCATGCTGGCTCACTCCTGTAATCCCATTGCTTTGGGAGGATCATTTGAGACCAGGAGTTGGAGACCAACTTGGACAACATATTGAGATCCCGTATCTACAAAATATTTGAAAATTAGCCAGTTGTGGTAGCACTCACCTGTAGTCCCAGCTACTTGGGAGGCTGAGGTGGGAGGATCGATTGAGCCCAGGAGGTCAAGGCTGCTGTGAGCCATGATGGGGCCACTGTACTCCAGCCTGGGCAATAGAGCAAGACCTTGTCTCAAAAAAAAAAAAAAAAAAAAAAGAAAGAAA","GGCTGGGCACAGTAGCTTACACCTGTAATCCCAGTACTTTGGAAGGCTGAAGTGGGAGGATCCCTTGAGGCCAGGAGTTTGAGACCAGCCTGGGCAACATAGTGAGACCCTGTCTCTACAACAAACAAACAAACAAACAAACAAAACTTAGCCAGTTGTGGTGGCACATCCTATAGTCCCAGCTACTCAGGAGGCTGAGGAGGGAGGATCTCTTGAGCCCAGGAGTTTGAGGCTGCAGTGAGCTATGATCATGACACTGCACTCCAGCCTGGATAACACAGCAAAATCCTGTCTCAAAAAAAAAAAAAAAAAAAAAAAAAAAGAA"
"chr1","24895557","24895831","chr2A","53703644","53703928","90","28808087","CTGGGCATGGTGGCTCATCCTGTAATCCCGACACTTTGGGAGGCCAAGGTGGAAGGTTTGCTTGAGGCCAAGAGTTTGAGGCCAGCCTGGGAAACGTAACGAGGCCCTGCCTCTAAAAAAAAAATTAGCCAGGTGTGGTGGTGCACACCTGTAGTTCTAGCTCCTTGAGAGGCCAAGGCAGGAGGGAGGATCACTTGAGCCCAGGAGTTGGAGGCTGCAATGCACTCCAGTCTGGGTGACAGAGTGAGACCCTGTCTAAAAATAAAAACTAAAAA","GACCAGGCACAGTGGCTCATTCCTATAATCCCGATGCTTTGGGAGGACGAGGTGGGAGCATCACTTGAGGCCAGGAGCTTGAGACCAGCCTAGTTAACATGGTCTCTGTATCTACCAAAAAAAAAAAAAAAAAAAAAAAAATGCTGGGCATTTGCCTATAGTCCCAGCTTCTCAGGAAGCTGAGGTGGGAGGATTGCCTGAGCCCAGGAGTTCGAGGGCTACACACCACTGTACTCCAGTCTGGGCAACAGAGCAAGACCCTGTCTCTAAGAAAAATAAATAAAA"
"chr1","24924085","24924384","chr9","68878569","68878883","77","43954484","GGCTGGTCGCAGTGGCTCATGCCTGTAATCCCAACACTTTGAGAGGCTGAGGCAGGAGGATCGCTTGAGTCCAGGAGTTCAAGACCAGCCTGAGCAACACAGTGAACAACACCCCCATCTCTACAACAAATAATTTTAAAAAATCAGCTGAGCATGGTGGCGCATGCCTATAGTCCCAGCTATTGAGGTGGGAGGACTGCTTGAGACCAGGAGGTTGAGACTGCAGTGATCGCACCACTGCACCCTGGCCTGGGCGACAGAGCGAGACCTTGTCCCAAAAAAAAGTAAAAGAAAAAAAAA","GGCTGGGCACGGCAGCTCATGTCTGTAATCCCAGCACTTTGGGAGGCCAAGGTGGGAGGATTGCTTGAGTCCAGGAGTTCAAGACCAGCCTGGGCAACATAGTGAAACCCCAGTCTCTACAAATAAATAAATAAATAAATAAATAATTAGCTGGGCATGTTGATGCATGCCTGTAGTCCTAGCTACTCGGGGGGTGAGGTGAGAGGATTGCTTGAGTCCAGAAGGTGGAGGCTGCAGTGAGCTATGATCACACCACTGCACTCCAGCCTGGAAGACAGGGTGAGACGCTGTCTTTAAAAAAAAAAAAAGAAAAGA"
"chr1","25073120","25073444","chr9","2736689","2737010","83","22336431","CCAGGGGCAGTGGCTTGCACCTGTAATCCCAGCACTTTGGGAGGCCGAGGCAGGAATGCTGCTTAAGGCCAGCAGTTTGAGCAGCCTGTGCAACAGGGCAAAATCTCACCTCTATAAAAAAGAAACAATTTTTTAAAAAATTAGCTGGGCACAGTGGTGCACACCTGTAGTCCCAACTACTTGGGAGGCTGAAGTGGGAGGACTGTTTGAGGCCAGGAGGTTGAGGCAGCAGTGAGCCATAATCATGCCACTGCACTCCAGCCTGGGCAACAGAGAGAGGGCCTGACTTTTAAAAAATAATAGTAAAAAATAAAATAAAAAAAAA","GCCTGGTGCAGTGGCTCACACCTAGTATTCCCAGCACTGTGGGAGGCCAAGGCAAGAGGACTGCTTGAGCCCAGGAGTTCAAGACCAGCCTGGGTAACATAGCAGGACCTTGTCTCTACAAACAAACAAACAAACAAACAAACAAATTAGCTGGGCATGGTGGCATGCACCTGTAGTCCCAGCTGCTTGGGAGGCTGAGGTGGAAGGATCATTTGAGCTTGGGAGGTTGAGGCTGCAGTGAGTCATAATCACATCACTGTACTCCAGCCTGAGTGACAGAGTGAGACCCTGTCTCTAAATACAGAAATAAATAAAAGAAAAA"
"chr1","25122067","25122290","chr17","17826312","17826529","56","7295755","GGCCAGGTGCAGTGGCTCATGTCCGTAATCCCAGCACTTTGGGAGGCCAAGGCAGGAGGATTGCTTGAGCCAGAAGTTCAAGACCAGCCTGGGCAACATAACAATACCTGGTCTCTACAAAAAATAATAATAATAAAAATTAGCTGGGCGTGGTGGCAAACACCTGTGGTCCCAGCTACTCAGGAGACTGAGGTGGGAGGATCTCTTGAGCCCGGGAGTTTGAG","GGCCAGGCGCGGTGGCTCACACCTGTAATCCCAGCACTTTGGGAGGCCGAGGCAGGAGGATTGCCTGAGGCCAGGAGTTTGAGATCAGCCTGGCCAACATGGTGAAACCCCGTCTCTACTTAAAAAAAAAAAAAAAAAAAAAAAAATAGCCAGGCTGGTGATGTACACCTGTAGTCCCAGCTACTCAGGAGGCTGAGGCAGGAGAATCACTTGAGCTC"
"chr1","25139701","25140029","chr2B","57359864","57360185","87","32220163","GGTCAGGCACGGTGGCTCATGCCTGTAATCCCAACACTCTGGGAGGCTGAGGTGGGACGATCGCTTGAGCCCAGGAGTTCAAGACTAGCCTGGGCAACATAGTGAGACCTCGTTTCTGCAAAAAAATTTAAAAATTAGCTTGGCATGGGTGGATGGCTCTGGTCCTAGCTTCTCAGGAGGCTGAGGTGGGAGGATCGCTTAAGTCCAGGCAGTTGAAGCTGAGGCTGCAGTGAGCTGTGATCACACCATTCGGCGGACAGAGCTAGATCTGGGCTGGGTAATGGAGCTAGATCCTGTCTCAAAACAAACAAACAAACAAACAAAAAAAA","CCGGGCATGGTGGCTCATGCCTGTAATCCTAGCACTTTGGGAAGCTGAGGTGGGAGGGTTGCTTGAGCCCAGGAGTTCAAGACCAGCTTGGGCAACACAGTGAGTCCCCTGTCTCTACAAAAAAAAAAAAAAAAAAAAAAAAATTAGCTGAGCATGGCAGTGTGTGTCTATAGTCCCAGCTACTTAGGAGGCTGGTGTGGGAGGATCGCTTGGGCCTTGGAGGTCAATACTGCAGTGAGTTGTGATCGCACCACTGCACTCTAGCCGGGGTGACAGAGTGAGATCCTGTCTCAAAACAAAAAACAAAACAAAACAAAACAAA"
"chr1","25170221","25170522","chr12","108570006","108570305","76","83399785","GGCTGGGCGGGTGGCTCATACCTGTAATCCCAGCACTTTGGAAGCCTGAGGCTGGAGGATCGCTTGAGGCCAGGAGTTCGAAACCAGCCTGCGCAACAGAGCAAGATCCTGCCTCTATAAAAAATAAATTTAAAAATTAGCCAGGTGTAGTGGCATGCACCTATGGTCCCAGATACCTGGGAGGCTAAGATGGAGGATTGCTTGAGACTGAGAAGACTGCAGTGAGCCACAGTAGTCCCACTGCACTCCAGCCTGGGCAACAGAGAGAGACCCTGTCTCAGAAAAAAAAAAAAAAAAAAAAA","GGCAGGGCGTGGTGGCTCACACCTGTAATCCCTGTATTTTGGGAGGCTGAGGCAGGACGATTGCTTGAGGCTAGGAGTTTGAGACCAGTCTGGGCAACATTTAAATAAATAAATAAATAAATAAATAAATAAATAAATCAGCCAGGCATGGTAGCATGAACCTGTAGTCCCAGCTCCTCAGGAGGCTGAGGGAGGATTGCTTGAGCCCAGGAGTTCAAGGTTGCATTGAGCCATGATTGCACCACTGTACTCCAGCCTGGGAAACAGAGTAAGACCCTGTCTCAGAAACAAACAAAAAAA"
"chr1","25200709","25201019","chr2B","83001661","83001979","74","57800952","GGTCAGATATGGTGGCTCATACCTGTAATCCTCGTGCTTTGGGAGGATAAGGCAGGAGGATGGCTTGAGGCTGGGATTTTGAGACCAGCCTGGGCAACATAGTGAGACCTCATCTCTATAAAAAGTAAAAAAAATTAGCCAGGTGTGGTGGCGCCTGCCTGTAGTTCTAGCTACTTGGGAGGCTGAGGTGGGAGGAACACTTGAGCCTGGGAGGTTGAGGCTGCAGTGAGCCATGATCACGTCACTGCACTCCAGCCTTGGCCTGGATGATAGAGAGAGACCCTGTCTCAAAAAGCAAACAGACAAACAAA","GGCTGGAGATGGTGGCTCACACCTGTAATCCTAGTACTTTGGGAGTCCGAGGTAGGAGGATCACTTGAGGCCAGAAGTTTAATACCAGCCTGGGCAACATAGTGAGAGCCTATCTCTACAAAAAAAAAAAAAAAAAAAAAAAAAGCCAGGTGTGGTGGTGCATGTTTGTAGCCTCAGTTACTTGGGAGGCTGAGGTGGGAGGATCATTTGAGCCCAGGAGGTTAAGGCTGCAGTGAGCCAGTTATGGCACCACTGTACTCCAGCCTGGGCGACAGGGCAAGACCCTGTCTCACAAACAAAAACAAAACAAGACAAAAAA"
"chr1","25214134","25214430","chr9","68878569","68878883","82","43664435","GGCCAGGCAAGGTGGCTCAAGCTTGTAATCCCAGCACTTTGGGAGGCCAAGGTGGGAGGATGGCCTGAGACCAGGAGTTCAAGACCAGCAAGACCGCATCTCTAAGAAAAAAAAAAAAAAACTTTGCTGGGCATGATGGTGCGTGCGTGCCTGCAGTCCAATCTGCTCGGGAGGATGAAGTGGAAGGGTCACTTGCGCCCAGAAGTTCAAGGTTATGGTGAGCCATGATTGTGCCAATGAACTCCAGCCTGAGTGACAGAGTGAGATCCTGTCTCTAAAAAAAAAAAGAAAAAAAAA","GGCTGGGCACGGCAGCTCATGTCTGTAATCCCAGCACTTTGGGAGGCCAAGGTGGGAGGATTGCTTGAGTCCAGGAGTTCAAGACCAGCCTGGGCAACATAGTGAAACCCCAGTCTCTACAAATAAATAAATAAATAAATAAATAATTAGCTGGGCATGTTGATGCATGCCTGTAGTCCTAGCTACTCGGGGGGTGAGGTGAGAGGATTGCTTGAGTCCAGAAGGTGGAGGCTGCAGTGAGCTATGATCACACCACTGCACTCCAGCCTGGAAGACAGGGTGAGACGCTGTCTTTAAAAAAAAAAAAAGAAAAGA"
"chr1","25240620","25240880","chr7","7616254","7616509","97","17624366","GGCCAGGCACAGTGGCTCACGCCTGTAATGCCTACACTTTGGGGGCGCCGAAGCAGGAGGACTGCTTGAAGACCAGCCTAGGGTAACAGAAATCCCACTCATCTTTACCCCCAAAAAATTAGCCAGGTGCGATGGCATAAGCCTGTATGGTAGAGGCTGTGGCAGGATTCCCTGAGCCCTGGAGTTCAAGGTTGCAGCAAGCTGTGACTGTGCACTACAGCCTGGGTGATGGAGCAAGAAACCCCTTCTCTAAAAAATAAA","GGCCATGCACGGTGGCTCACACTTGTAATCCCAAAACTTTGGGAGGCTGAAGCAGATTTCATCTCTACAAAAAAAAAAAAAAAAAAAAAAAAATTGGCCAGGTGTGGTGGCATGAGCCTGTAGTCCCAGCTACTAGGGAGGCTGAGGTGGGAGGATCGCTTTGGCCCAGGAGTTTGAGGCTGCAGTGAGTTACGACTGTGCCTCTGCACTCCAGCCTGGGTGACAGAGCGAGATCCTGTCTCTAAAAATATATAAA"
"chr1","25256148","25256444","chr10","17312040","17312333","91","7944108","GCATGGTGGCTCATGCCTGTAATCGCAGTGCTTTAGCTGACTGGGATGGAAGATCTTGCCTGAGGCCAGGAGTGTGAGAACAGCCTGGGCTACATGGACTTTACCAAACACTCTTTTTAAAAATTAGTCAGGTGTAGTGGCGCATGCCTGTAGTCCTAGCTACTCAGTAGGCTGAGGCGGGAGGATCGTTTGAGCCCAGGAAGTTGAGGCTGCAGTGAGCTAGGATGGCGCCACTGCACTCCGGCCTGGACAACAGAGCTAGTGAGACTCTGTCTCTTAAAAAAAAAAAAAAAAAAA","GTGCAGTAGCTCATGTCTACAATCCCAGTGTTTTGGGAAGCCAGAACAGCAGGATCCCTTGAGGCCAGAAGTTAAAGACCAGCCTTTAAACAAAACAAAACAAAACAAAACAAAAAAATTTAATTAGCCAGGTGTGGGGGTGTGTGCCTGTAGTCCAAGGCACTCAGGAGGCTGAGGCAGGAGGATCACTTGAGCCAAGGAGTTTGAAGCTGCAGTGAGCCATCATTGTACCACTGCACTCCAGCCTGGGTGACTAGTGAGAACTGTCTCTCAAAAAGAAAAAGGAAAAAAAAA"
"chr1","25273138","25273442","chrX","16155635","16155942","64","9117503","GCTGGGCACAGTGCTTCACGCCTGTAATTCCAGCACTTTGGGAGACTGAGGCTGGAGGATCGCTTGTGTCCAGGAGTTTGAGACCAGTCTGGGAAACACAGGGAGACCCACATCTCTACCAAAAAAAAAAAAAAAAAAAATTAGCCAGGCATGGTGGTGCCCTCCTGTGGTCCCAGCTTCTTGGGAGGCTGAGGTGGGAAGATTGCTTGAGACTAGGAGGTCAAGGCTGCAGTGAACCATGATCATGCCACTGCACTTCAGCCTGGGCAACAGAGTGAGACCCTGCCTCAAAAAGAAATAAGAAA","GGCCAGGCACAGTGGCTCACACCTGTAATCCCGGTACTTTGGGAGGCTGAGGCGGGAGGATCACTTGAGCCCAGGAGTTCAAGACCAGCCTGGGCAACATAACAAGACCCTGTCTCTACCAAAAAAAAAAAAAAAAAAAAAAAAAATAGCCAGGCCTGGTGGCCTGTGTCCATAGTCCCAGCTACTTTGGGAGACTGAGGTGGAAGGATCACTTGAGTCTGGAAATCAAGACTGCTGTGAGCTGTGATCATGCCACTGTACTCCAGCCTGAGCAACAGAGTGAGACCCTGTCTAAAAAAAAAAAAAAA"
"chr1","25288296","25288479","chr1","9000895","9001091","51","16287401","GGCCAGGAATGGTGGCTCACACCTGTAATCTTCGCACTTTGGGAGGCTGAGGTGGGAGGATTGCTTAAGGCCTGGAGTTTGAGACCAGCCTGGGCAACATAGTGAGACTCCATCTCTACAAAAAGCAAAAAAAAAAAAAGCTAGGTGTGGTGGTGTGTGCCTGTGGTCTCAGCTACTCAGGAGG","GGCCAGACGTGGTGGCTCACTCCTGTAATCCTAGCACTTTATGAGCCTGAGGCAGGAGAATCACTTGAGGCTAGGAGTTTGAAACCAGCTGAGGCAACATAGTCAGACTCTGTCTCTACTAAAAAAAAAAAAAAAAAAAAAAAAAGCCAGGCACAGTGGTGCACACCTATAGTCCCAGCTACTTGGAAGGCTGAGGC"
"chr1","25290883","25291085","chr11","89572983","89573210","74","64282100","CCTGTAATCCCAGCTACTTGGGAGGTTGAGGAGGGAAGATCACTTGAGGCCAGGAGTTTGAGACCAGCCTGGGCATCATAGCAAGATCCTCATCTCTAAAAAGTAATTTTTTCTAAATTATCCAGTTGTGGTGGCATGCACCTGTAGTCTCAGTTACTCAGGAGGCTGAGGTGTGAGTTGGAAGGATTGTTTGAGCCCAGGAG","GGCACGATGGCTCATGCCTGTAATCCCGACTACTCAGGAAGCTAAGCCAGGAGGATTGCTTGAGGCCAGGAGTTTGAGATCAGCCTGGGCAACAAAGCAAGATCCTCATCTCTAAATATATATATATATATATATATATATATCTCCATCCAGGGTGACAGGTACCTGCAGTCTCAGCTACTCAGGAAGCTGAGGTGGGAAGATCCCTTGAGCCTAGCAGTTTGAGAC"
"chr1","25300238","25300527","chrX","46692258","46692555","77","21392020","GGCCGGGTGTGGTGGCTCATGCCTGTAATCTCAGCACTTTGGGAGGGAAGGATCTCTTGAGCCCAGGAGTTCAAGACCAGCCTGAGCAACATAGCAAGATTCCATCTTTACACAAAATTTAAAAATTGGCCAGGCATGGTTGTACATTCCTGTAATCCCAGCTACTCAGGAGGCTGAGGTGGGAGGATTGCTTGAGCCTGGGAGTTGGAGACTACAGTGAGCTGTGGCCACACCACTGCACTCCAGCTTGAGCAATGGAGCAAGACTCTGTCTCAAAAAAAAAAAAAAAA","GGCCAGGCATGGTGGCTCATGCCTGTAATCCCAGCACTTTGGGAGGCTGAGGAAAGATGATCACTTGAGCCAGGAGTTTGAGCCCAGTCTGGGTAACATAGTGAGACCTCCATCTCTACAAAAAAAAAAAAAAAAAAAAAAAAAAGCTGGGCATGGTAGCACACATCTGTAGTGTCAGCTACTCAGGAGGCTGAGGTAGGAGGATTGCTTGGGCCCAGGAGATCAAGACTGCAGTGAGCTATGACTGCACCACTGCACTCCAGCCTGGGCAATGGAGTGAGACCCTGTCTCAAAAAAA"
"chr1","25319344","25319627","chr11","66027987","66028285","79","40708643","GGTGGCTCATACTTGTAATCCCAGCACCTTGGGAAGCTGAGGTGGGAGAATAGCTTGAGGCCAGGAGTTCAAGCCAGGGCAACATAGTGAGACCCCATCTCTACAAAAGATACAAAAATTAGCCAGGCGTGGTGGTACACCTGTAGTCCCAGCTGCTCTGGAGGCTGAGATGGGAGGATCAGTTGAGCTTGGGAGGCAGAAGTTGCAGTGAGCTGAGATCATGCCACTGCACTCCAGCCTGGACAACAGAGCAAGACCCTGTCTCAAAAAAGGAAACAAAACAA","GGTGGCTCATGCATGTAACCCCAGCACTTTGGGAGGTTGAGGAGGGAGGATTGCTTAAGGTCAAGAGTTCGAGACCAGTCTGGGGAACATAGCATGACCCCATCTATAAACAAAACAAAACAAAACAAAACAAAATTTGTGGGGTATAGTGGTGCATGTCTGTAGTCCCAGCTACTTGGAAGGCTGAGGTGGGAGGACTGCTTGAGCTCAGGAGTTCACAGCTGCAGTGAGCATAATCCTACCACTGTACTCCGGCCTGGGAAACAAAGTGAGATCTTGTCTCAAAAAAGAAAAAAAAA"
"chr1","25346409","25346694","chr8","15910614","15910909","78","9435795","GAGCACAGTGACTCACACCTATCATGCAGCACTCTCGGAGGCCAAGGCAGGAGAATCACTTGAGACCAGGAGTTCAAGAACAGCCTGGGCAACATAGTGAGATCCTGTCTTTACAAAAAAACTGTTTAAAAAATAGCTGGGTGTGGTGGTATGTGCAAGTAGTCCTAGCTACTGGGGAGGCTGAGGCCAGAGGACTGCTTAAGCCCAGGATTTTGAGACAGTAGTGTGTTATGATCACACCATTTGCACTCCAGCCTGGGTGACAAGCGAGGCCCTACTTCTAAAA","GGCCAGGCGAAGTGGCTCACACCTGTAATCCCAGCACTTTGGGAGGCCAAGGCAGGAGGATCATTTGAAGCCAGGAGTTCAAGGCCAGCCAGAGAAACATAGTGAGAACCTGTCTTTACAAAAATTAAAATTAAAATTAAAATTAGCCAGGAGTGGTGGTGCATGCCTGCAGTCCCAGCAGCTCAGGAGGCTGAGGTGGGATGATTGCTTGCACCAGGAGTTCGAGGCTGCAGTGAGCTGTGATCGTGCCACTGCACTCCAGCCCCTGGGTGACAAAGCAAGATCCTCTAAAAAAA"
"chr1","25351258","25351525","chr13","35789832","35790100","80","10438574","GCACTTTGGGAGGTCAAGGCAAGGAGGATCTCTTGAGGCCAGGAGTTTGAGACCAGCCTGAGCAACATAGCAAGACTTTGTCTCTACAAAAATTTTTAAAAATTAGCTGGGTGTGGTGGTGCACACCTGTAATCCCAGCTACTCAGGAGGCTGAAGTGGGAGGATCACTTGAGCCTGGGATTTCAAGGCTGCAGTAAGCCATGGTTGTGCCACTGCATTCTAGCTTGAGCAACAGAGTGAGACCCTGTATCTTTAAAAAAAAAAAAAA","TAGGTGGCCAAAGCAGGGAGATCACTTGAGCCCAGGAATTCAAGACCAACCTGGGCAACGTAGCGAGACCTTGTGTCTAAAAAAAAAAAAAAAAAAAAAAAAAATTAATTAGCTTGGTATGGTGTCGTACACCCATGATCCCAGCTACTAGGGAGGCTGAGATGGGATAATCGCTTGAACACAGGAGGTCAAGGCTACAGAGAACCATGATTGTGCCACTGCATTCCAGCCTGGCCAACAGAATGAGACCCTGTCTCAAAAAAAATAAA"
"chr1","25353287","25353518","chr14","51003183","51003398","66","25649896","CTTGAGGCCAGGAGTTCAAGGCCAGCCTTAGCAACATAGCAAGATCCATCTCTATAAAAAATTTAAAAATTAGCTGGGTGTGGTTGTGTGTGCTTGTGGCCCTAGCTACCTGGGAAGCTGAGGTGTGAGGATGGCTTGAGCCCAGGAGGTTGAGGCTGCAGTGGGCCATGATCATGCCATTGCACTCCAGCCTGGGTGATAGTGAGACTCTTGTCTCTAAAAAAGAAACAAA","AGCCTGGGCAAGATAGTGAGACCTCATCTCTTAAAATAAATAAATAAATAAATAAATAGCAGGATGTGGTGGCGTGCATCTGTAGTCCCAGCTACTCAGGAGGCTGAGATGGGAGGATTACTTGAGCTCAGGAGGTCGAGGCTGCAGTGAGCTATGATCACGCCACTGTACTCCAGCCTGGGTGAGAGTGATACCCTGTCTCTAACAAAAAAAAAA"
"chr1","25354354","25354641","chr6","20439531","20439829","85","4914823","TGTAATCCCAGCACTTCAGGAGGCCAAGGAGGGAGTACTGCATGAGGCCAGGATTTTGAGACCAGCTTGGACAACATAGGGAGACACCATCTCTACAAATAATAAATATTTAGCCGACTATGGTGACGTGCATGTGTGGTCCCAGCTACTCGGGAGACTGACGTGAGAGGATCACCTGAGCCCGGGAGGCAGAGATTGCAGTGAGCTGTGATTGTGCCACTGTACTCCAGCCTGGGTGACAAAGTGAGACGCTGTCTCAAAAAAAGAGAAAAGAAAAGAAAAAAAGAA","CCGTAATTCCAGTACTTTTGGGGGCTGACGGGGGAGGATTGCTTAAGGACAGGAGTTTGAGGCCAGCCTGGGCAACATTACAAGACCCCATCTCCACAAAAAAAAAAAAAAAAAAAAAAAAATTAGCCAGGCTTGGTGGTGCACGCCTACTAGTCCCACCTACTCAGGAGACTGAGACGGGAAGGACCACTGGAGCCCAGGAGTCTGAGGCTGCAGTGAGCCATGATGGTGCCACTGTACTCAAGCCTGGGCAACAGAGTGAGATCCTGTCTCTAAACAAAAACAAAAACAAAACAAAA"
"chr1","25372807","25373090","chr15","50439849","50440151","80","25067042","GGTGGCTCATACTTGTAATCCCAGCACTTTGGAAAGCTGAGGTGGGAGAATAGCTTGAGGCCAGGAGTTCAAGCCAGGGCAATCCTATAGTGAGACCCCATCTCTACAAAAGATACAAAAATTAGCCAGGTGTGGTGGTACACCTGTAGTCCCAGCTGCTCCGGAGGCTGAGATGGGAGGATCAGTTGAGCTTGGGAGGCAGAAGTTGCAGTGAGCTGAGATCGTGCCACTGCACTCCAGCCTGGACAACAGAGCAAGACCCTGTCTCAAAAAAGGAAACAAAA","GCTGGGTGCAATAGCTCTGTAATCCCAATACTCTGGGAGGCCAAGGCTGGAGGATTGCTTGAAGCCAGGAGTTTGAGACCAGCCTGGGCCACAGAATGAGACCCCATCTCAATCAATCAATCAATCAATCAATCAATCAGTCAATCAGGTGTGGTGGCGCACGCCTGTAGTCCCAGCTGCTTGGGAAGCTGAGGCAAAAGGATCACTTGAGCCCAGGAGGTTTGAAGTTGCAGTGAGCTGTGATTGTGTCACTGCACTCCAGCCTGGGAGCAGAGTAAGACCCTGTCTCAACATAAAAAGAAA"
"chr1","25379693","25379971","chr1","47533839","47534134","66","22154146","GTGTGGTGTTTCATGCCTGTAATCCCAGTGATTTGGGAGGCTGAGGTGGGAGGATTGCTTGAGCCCAGGAGTTCAAGACCAGCCTAGGCAACATAGTGAGACCTGTCTCTACAAAAATAAAAATAAAAAGTTAGCCAGGTATTGTGGCATGTGCCTGTAATTCTAGCTACTCAGGAGGCTGAGGTGAGAGGATCACTTGAGCCCAGGAGTTTGAGGCTGCAGTGAGCTATGGTCGTGCCACTGCATTCCAGCCAGGGCAACAGAGTGAGACTCTGTCTC","GGCTGGGCACGGTAGCTCACACCTGCAATCCCACCACTTTGGGAGGCTGAGGTGGGTGGATTGCTTGAGCCCAGGAGTTCTAGACCAGCCTGGGTGATACAGGCAGACCCTATCTCTACCAAAAAAAAAAAAAAAAAAAAAAAAAAAGGCTGGGCATGGTGGCATGTGCCTGTGGGCTCAGCTACTTAGGAGGCTGAGGTGGGAGGATCAGTTGAGCCCAGGAGGAGTTGAGGCTGCAGTGAGCCTAGATCCTGCCACTGCACTCCAATCTGGGCAACAGAGCGAGACCCTGTCTC"
"chr1","25392563","25392862","chr11","113329688","113329999","76","87937125","GGCCGGGCGTGGTGGCTCATGCCTGTAATCTCAGCACTTTGGGAGGGAAGGATCTCTTGAGCCCAGGAGTTCGAGACCAGCCTGAGCAACATAGTGAGATTCCATCTTTACACAAAATTTAAAAATTGGCCAGGCATGGTTGTGCACTCCTGTAATCCCAGCTACTTAGGAGGCTGAGGTGGGAGGATTGCTTGAGCCTGGGAGTTGGAGACTACAGTGAGCTGTGGCCACACCACTGCACTCCAGCTTGAGCAATGGAGCAAGACTCTGTCTCAAAAAAAAAAAAAAAAAAAAAAAAAA","GGCTGGGCATAGTGACTCATGCCTATAATCACAGCACTTTGGGAGGTGGGAGGACTGCTTGAGGCCAGGAGTTTGAGACAGGCCTGAGCAACATAGTGAGACCCTTGCTTTTAAAAAAAAAAAAAAAAAAAAAAAAAAAGCCAGGTGTGGTGGTGTACACCTGTAGTCCCAGCTGTTCGGGAAGCTGAGGTGGAAGGAATGCCTGAGCCCAGGAGTTTGAGGTTGCAGGAAACTATGATTGTGCCACTGCACTCCAGCCTGCACAACTGAGTGAGACCCTGTCTCAAAAAAGAAAAAAAAAAAAAAAGAAAA"
"chr1","25402296","25402504","chr11","89572983","89573210","72","64170687","CCTGTAATCCCAGCTACTTGGGAGGTTGAGGAGGGAAGATCACTTGAGGCCAGGAGTTTGAGACCCGCCTGGGCATCATAGCAAGATCCTCATCTCTAAAAAGTAATTTTTTCTAAATTATCCAGTTGTGGTGGCATGCACCTGTAGTGTCAGTTACTCAGGAGGCTGAGGTGTGAGTTGGAAGGATTGCTTGAGCCCAGGAGTTAGAG","GGCACGATGGCTCATGCCTGTAATCCCGACTACTCAGGAAGCTAAGCCAGGAGGATTGCTTGAGGCCAGGAGTTTGAGATCAGCCTGGGCAACAAAGCAAGATCCTCATCTCTAAATATATATATATATATATATATATATATCTCCATCCAGGGTGACAGGTACCTGCAGTCTCAGCTACTCAGGAAGCTGAGGTGGGAAGATCCCTTGAGCCTAGCAGTTTGAGAC"
"chr1","25404909","25405097","chr1","9000895","9001091","44","16404014","GGCCAGGAATGGTGGCTCACACCTGTAATCTTAGCACTTTGGGAGGCTGAGGTGGGAGGATTGCTTAAGGCCTGGAGTTTGAGACCAGCCTGGGCAACATAGTGAGACTCCATCTCTACAAAAAGCAAAAAAAAAAAAAAAAAAGCTAGGCGTGGTGGTGTGTGCCTGTGGTCTCAGCTACTCAGGAGG","GGCCAGACGTGGTGGCTCACTCCTGTAATCCTAGCACTTTATGAGCCTGAGGCAGGAGAATCACTTGAGGCTAGGAGTTTGAAACCAGCTGAGGCAACATAGTCAGACTCTGTCTCTACTAAAAAAAAAAAAAAAAAAAAAAAAAGCCAGGCACAGTGGTGCACACCTATAGTCCCAGCTACTTGGAAGGCTGAGGC"
"chr1","25416620","25416903","chr6","43509832","43510110","83","18093212","AGCACTTAGGGAGGCCAAGTGGGGAGGATTGCTTAAACCAAGAAGTTCAAGACCAGCCTAGGAAACATAGGGAGACCCCCCCCCGCCATCTCTAAAAAAAAAAAAAAAAAACTGTAAAATTTAACCCAGTGTGGTGGCACATGCCTGTAGTCCCAGCTACTCAGTAGGCTGAGGTGAGAGGCTTGCTTGAGCCTGGGAGCTTGAGGCTGCAGTGGGACGGGATTGTACCACTTCACTCCAGCATGGGCGACAGAGCAAGACCCTGTCTCAAAAAAAAATGAAAA","GACTGAGGTGGGAGGATTGCTTGAGGCCAAGAGTTTGAAACCAGCCTGGGCAACATAGTGAGACCCCATCTCTACAAAAAGTAAAAAAAAAAAAAAAAAAAAAAAAAAAATTAGCTGGGTGTGGTGGCTCATTCCTGTCGTCCCAGCTACTTGGGAGGATAAGCAAGGAGGGTTGCTAGAGGCTAAGAGTTTGAGGCTGTAGTGAGCTATGTGATCTTGCTACTGCACTCCAGCCTGGTCAACAGACTGAGACCCTATCTCTAAAAAAAAAAAAAAAAA"
"chr1","25419897","25420197","chr8","25360790","25361095","67","59107","GCTGGGCACAGTGCTTCACGCCTGTAATTCCAGCACTTTGGGAGACTGAGGCTGGAGGATCGCTTGTGTCCAGGAGTTTGAGACCAGTCTGGGAAACACAGGGAGACCCACATCTCTACCAAAAAAAAAAAAAAATTTAGCCAGGCATGGTGGTGCCCTCCTGTGGTCCCAGCTTCTTGGGAGGCTGAGGTGGGAAGATTGCTTGAGACTAGGAGGTCAAGGCTGCAGTGAACCATGATCATGCCACTGCACTTCAGCCTGGGCAACAGAGTGAGACCCTGTCTCAAAAAGAAATAAGAAA","GGCTGGGAGCAGTGGCTCATACCTGTAAGCCCAGCACTTTGGGAGGCTGAGGTGGGAGGATTGCTGAAGCCCAGGAGTTTGAGACCAACCTGGGCAATGTAGGGAGACCCCGTCTCTACTAAATAAATAAATAAATAAATAAATAAAGTCGGGCATGGTGGCATGTGCCCTGTAGTCCCAGCTTCTTGGGAGGCTGAGGTGGGAGGATTGCTTGGGCCCAGGAATCAAGGCTGCAGTGAGCTGTGATTGTGCCACTGTACTACAGCCTGGGTGACAGTGCAAGACTGTCTCAAAAGAAAAACAAAA"
"chr1","25437645","25437932","chr15","50439849","50440151","71","25002204","GGCCGGGTGTGATGGCTGTAACCCCAGCACTTTGGGAGGCTAAGGCAAGAGGATTGCTTGAGTCCAGGAGTTCAAGACTAGCCTAGGTAACATAGCGAGACCTCATCTCTACTAAAATTCAAAAAAATTAGCTGGGTGTGGTGTCACATTCCTGTAGTCCCAGCTACTTGGGAGGCTGAGGCGGGAGGATCACGTGAGCCCAGGAGTTTGAGGCTGCAGTGTGCCATGATCGTGTCACTACACTCCAGCCTGGGCAATAGAGCAAGACCCTGTGTCAAAAAAAGAGAA","GCTGGGTGCAATAGCTCTGTAATCCCAATACTCTGGGAGGCCAAGGCTGGAGGATTGCTTGAAGCCAGGAGTTTGAGACCAGCCTGGGCCACAGAATGAGACCCCATCTCAATCAATCAATCAATCAATCAATCAATCAGTCAATCAGGTGTGGTGGCGCACGCCTGTAGTCCCAGCTGCTTGGGAAGCTGAGGCAAAAGGATCACTTGAGCCCAGGAGGTTTGAAGTTGCAGTGAGCTGTGATTGTGTCACTGCACTCCAGCCTGGGAGCAGAGTAAGACCCTGTCTCAACATAAAAAGAAA"
"chr1","25439250","25439417","chr18","55799233","55799394","62","30359983","GCCAGGCATGGTGGCTCTTGCCTGTCACCCTTGCTACTTGGGAGGCTGAGGTGGGAGGATCGCTTGAGCTCAGGAGTTGGAGGTTGCAGTGAGTTATGATCACACCACTGCGCTACAGCCTAGGAGACAGAGTAAGACTCTGTCTCTGAAAAAAATAAACAAACAAAA","GGCTGAGAGAGGTGGCTCATGCTTGTAATCCCAGCACATTGGGAGGCAAAGGTGGGAAGATTGCTTGAGGCCAGGAGTTCAAGACCAGCCTGGGCAACATGAAAACACTTTGTCTCTACAATAAATAAATAAATAAATAAATAAATAAAAGAAACAAGAAAA"
"chr1","25457095","25457411","chr3","90264983","90265291","80","64807888","GGCTGGGCATAGTGGCTCATGCCTGTAATCCCTACACTTCAGAAGGTGGAGGTGGGAGGATTGCTTGAGATCAGGAGTTTGAGACTAGCCTGAACAACACAGTGAGACCTCATCTCTACAAAAAAATAATTAAAAAAAATTAGCCAGGCATGGTGGCACGTGCCCATGGTAGCAGCTGCTCAGGAGGCTGAGGAGGGAGGATTACTTTGCTCCCAGGAGTTTGAGGCTGCAGTGGTCCCTAACTGTTATCACTGCACTCCAGCTTAGGCAACAGAGTGAGACCCTCCCTGTCTCAAAAAACTAAATTTAAAAAAAAA","GGCTGGGCCTAGTGGCTTATGCCTGTAATCCAAGCACTTTGGGACACTGAAATGGGAGGATCAGTTGAGATCAGGAGTTTGAGACCAGCCTAGGCAACATAGTGAAGACCTCATTACTACTACAAAAAAAAAAAAAAAAAAAAAAAAAAAGCCAGGCATGGTGTCAAGCACCTGTAGTACCAGTTGCTTAGGAGGCTGAGGTGGGAGGATCACTTGAGCCAGGAGGTTGAGGCTGTAGTGAGTCAACTTTGTGCCACTGCACTCCAGCCTGGGTGACAGAGTGAGACTTTGTCTCAGAAAATAAATAAA"
"chr1","25537848","25538155","chr16","32352979","32353289","64","6815131","GGTTGGGCACGGTGGCTCATGCCTGTAATCCCAGCACTTTGGGAGGCTGAGGTGGGTGGATCATCGCTTGAGCTCAGGAGTTCAAGACCAATCTGGGCAACAAAGCAAAACCTTGTCTCTATAAAACAAAATTTAAAAAATTAGCCGGGTATGGTGGCACACATCTGTGGTCCCAGCTTCTCAGGAGGCTGAGGTGGGAGGATCGCTTGAGCCCAGGAGGCAGAGGTTGCAGTGAGCTGAGACTGCGCCACTGAACTCCAGCCTGGGCGACAGAGACACTGTCTCAAAGAAATAAAAATGAAGATAAA","GGCTGGACACGGTGGCTGCTGCCTGTAATCCCAGCACTTTGGGAGGCCAAGGCAGGAGAATGGCTTGAGCCCAGGAGTTCAAGACCAGCCCGGGCAACAGAGTGAGACCTTGTCTCTACAAAAATAAAAATAGAAATAAAAATAAAAATTAGCCAAGTGTGGTGGCATGCACCTGTGGTCTCAGCTACTCAGGAGACTGAGGTGGGAGGATCCCTTGAGCCCAGGAGGTCGAGGCTGCAGTGAGCTGTGATCATGCCACTACACTCCAGCCTGGGTGACAGAGCTGTCTCAAAAAAATAATAATTAAAAAA"
"chr1","25548674","25548952","chr15","26873577","26873832","85","1324903","CAGGCACAGTGGCTCATGCCTGTAATTCCAGTGTGCTAGGAGGCTGAGAAGGAAGGATTGCTTGAGGCCAGGAGTTCAAGACCAGCCTGGACAACATGGTAAGACCTCGTCTCTACAAAAAATAATTAGCTGGGCGTGGCAGTGTGCACCTGTAGTTCTAGCTACCCAGGAGGATCCCTTGAGCCCAGGAGGTCGAGGCTGCAGTAAGCTATGATCATATCACTGCATTCCAGCCTGGGCAATAGAGTGAGACCTTGTCTCAAATAAATAAATAAATAA","GGTCAGGCACAGTGGCTCACTCCTGTAATCCCAGCACTTTGGGAGGCCAAAGCAGGAGGATTATTTGAGCCCAGGAGTTCAAGGCCAGCCTGGCCAACATAGTGAGATCTTGTCTCTAAATAAATAAATAAATAAATAAATAAATAAATGAGGTGGGAGGATTGCTTGAGTCCCAGGAGGTTGAGGCTGCAGTGAGCCAGGATCATACCACTGCACTTCCACCTGGGTGTCAGAGCAAGACCTTGTCTTAAAAAAA"
"chr1","25580515","25580810","chr8","25360790","25361095","71","219725","GGCCAGGTGCAGTGGCTCACACCTGTAATCCAGCACTTTGGAAGGCCAAGGCAGGAGGACTGCTTGAGACCAAGAGTTCGAGACCAGCCCGGGCAATGTAGTGAGGCTCCATCTCTACAAAAAAAAATTAAAAAGTTAGCCAGGTATGGTGGCTCACACTTGTGGTCCCAGCTACTTGGGGGGCTGAGGAGGGAGGATCACCTGATCCCAGAAACGTCAAGGCTGCAATGAGCTGTGATTGTGCCACCGCACTTCAGCCTGGGCAATGTGAGACCCTGTCTCAAAAATAATAATAA","GGCTGGGAGCAGTGGCTCATACCTGTAAGCCCAGCACTTTGGGAGGCTGAGGTGGGAGGATTGCTGAAGCCCAGGAGTTTGAGACCAACCTGGGCAATGTAGGGAGACCCCGTCTCTACTAAATAAATAAATAAATAAATAAATAAAGTCGGGCATGGTGGCATGTGCCCTGTAGTCCCAGCTTCTTGGGAGGCTGAGGTGGGAGGATTGCTTGGGCCCAGGAATCAAGGCTGCAGTGAGCTGTGATTGTGCCACTGTACTACAGCCTGGGTGACAGTGCAAGACTGTCTCAAAAGAAAAACAAAA"
"chr1","25625535","25625833","chr8","25360790","25361095","78","264745","GCCAGGTACAATGGCTCATGCTTGTAATTCTAGCACTTTGGGAGGCTGAGGTGGGAGGATCACATGAAGATAGAAGTTCAAGACCAGCTTGGGCAACATAGCAAGACCCTGTCGCTCTCTCTTTCTCTATATATAAAATAATCAGGCGTGGTAGTGTACACCTGTGTTCCCAGCTACTCAGGAGGCTGAGGTGGGTGGATTCATTGAGCCCAGGAGTCTGAAGCTGTAGTGAGTTTTGATCAGGCCACTGCACTCCAGACTGGGTGACAGAGGGAGACCCTGTCTCAAAGAAAAAAAAA","GGCTGGGAGCAGTGGCTCATACCTGTAAGCCCAGCACTTTGGGAGGCTGAGGTGGGAGGATTGCTGAAGCCCAGGAGTTTGAGACCAACCTGGGCAATGTAGGGAGACCCCGTCTCTACTAAATAAATAAATAAATAAATAAATAAAGTCGGGCATGGTGGCATGTGCCCTGTAGTCCCAGCTTCTTGGGAGGCTGAGGTGGGAGGATTGCTTGGGCCCAGGAATCAAGGCTGCAGTGAGCTGTGATTGTGCCACTGTACTACAGCCTGGGTGACAGTGCAAGACTGTCTCAAAAGAAAAACAAAA"
"chr1","25669488","25669790","chr4","139746214","139746515","85","114076726","CGGGCACACTGGCTTGTGCTTTTAACCATAGCACTTTGGGAGGTCGAGGCAGGAGGATCACTTGAAGCCAAGAGTTCAAGACCAGCTTGGGCAACGTATCGAGACCCTATCTTTTTTAAAAAAAAATTGTAAAAATCAGCCAAGTGTGGTGGCACACACCTGCTACTTGGAAGTCCCAGCTACTAGGGAGGCTGAGGTGAGAGGATCACTTAAGCCTAGGAGTTTGAGGCTGCAGTGAGCTACTATCATACCACTGTACTGCACTCCTGTCTGGATGACAGAGCAAGACTCTGTCTCTAAAAA","GGCCAGGCACAGTAGTTTATGCCTGTAATCCCAGCACTTTGGAAGGCTGAGGCAGAAAGATCCCTTGAGCTCAGGAGTTTGAGATCAGCTTGGGCAACATAGCGAGACCCCATCTCCTAAAAAAAAAAAAAAAAAAAAAAAAACTAGCTGAGCATGGTACACACACCTGTAGTCCCAGCTATTTGGAGGTGCTGAGGTGGGAGGATCACTTGAGTCCAGGAAGTTGAGGCTGCAGTGAGCCAAGATCATGCCACTGCACTCCAGCCTGCACAACACAGCAAGACTCTGTCTCAAAAAACAAA"
"chr1","25696630","25696945","chr14","31798968","31799292","76","6102338","GTCAGGCATGGTGGCTCACGCCTGTAATCCCAACACTGTGGGAGGCTGAGGCAGGAGGACCCCTTGAGGCCAGGAGTTTGAGACCAGCCTGGGTAACATAGCAAGACCTCATCTCTACAAAAAATTTAAAAAATTAGCCAGGCGTGGTGTCCCGTGCTTGTAGTCCTAGCTACCCAGAGGCTGAGGTGGGAGGATTGTTTGAGCCCAGGAGTTAGAGGCTGCAGTGAGCTATGGTCACACCACTGCACTCCAGTCTGGACAACAGAGCTAGACCCTGTCTATATTTAAAAAAAGAAGGAAAAGAAAAGTAAAAAAA","GGCTGGGCACAGTAGCTTACACCTGTAATCCCAGTACTTTGGAAGGCTGAAGTGGGAGGATCCCTTGAGGCCAGGAGTTTGAGACCAGCCTGGGCAACATAGTGAGACCCTGTCTCTACAACAAACAAACAAACAAACAAACAAAACTTAGCCAGTTGTGGTGGCACATCCTATAGTCCCAGCTACTCAGGAGGCTGAGGAGGGAGGATCTCTTGAGCCCAGGAGTTTGAGGCTGCAGTGAGCTATGATCATGACACTGCACTCCAGCCTGGATAACACAGCAAAATCCTGTCTCAAAAAAAAAAAAAAAAAAAAAAAAAAAGAA"
"chr1","25705665","25705964","chr1","207218281","207218584","81","181512616","GTCAGGCATGGTGGCTCACGCCTGTAATACCAACACTTTAGGAGGCCAAGGCAGGAGGATCATTTGAGGCCAGGAGACCTGGAAAGTCTACGACTTAGGGAGACCCTGTCTCTACAAGAAATTTAAAAATTGGCTGGGTATGGTGGCACATGCCAGTAGTCCTAGGTATTCAAGAGGCTAAGGTGGAAGGATCACTTGAGCCCAGGAGTTTGAGGCTGCAGTGAACTATGATTGCATCACTGCACTCCAGCCTCGGTGACAGAGCAAGACCCTATGTCAGATAAATAAATAAATAAATAA","GCCAGGCACAGAGGCTCATGCCTGTAATCCCAACACTTTGGGAGGCCGAGACAGGAGGATCACTTCAGGCTAGGAGTTGAGACCAGTCTGGGCAATATAGTAAGACCCTATCTCTATTAAAAAAAAAAAAAAAAAAAAAAAAAAGCTGGGTATGGTGGCACATGCCTGTGTTCCCAGCTACCTGGGAGACTAAGGTGGGAGGACTGCTTGATCCCAAGAATTTGAGGCTGCAGTAAGCTATGACTGCACCACTGCACTCCAGCATGGGCGACAGAGCGAGACCTTGTCTCAAGAAAACAAAAAA"
"chr1","25719446","25719727","chr8","15910614","15910909","64","9808832","GGTCAGGTGTAGTGACTGACACCTATAATCCCAGCACTTTGGGAGGCCAAGGCAGGAGGATCACTTGAGGCAAGGAGTTCAAGACCAGCCTGGGTAACATTGTGAAACCCTGTCTCTATAAAAAACTTAAAAATAACTAACCGGGAAAGGTGGCATGTGCCTGTAGTTCCAGCTACTCAGGAGGCTGAGGTGGGAGGATTGCTTGAAACCAGGAGTTCGAGGCTGCAGTGAGCTAAAATGATGCTACTGCACTCCAGCCTGAGCACAGAGAGACCCTATCTC","GGCCAGGCGAAGTGGCTCACACCTGTAATCCCAGCACTTTGGGAGGCCAAGGCAGGAGGATCATTTGAAGCCAGGAGTTCAAGGCCAGCCAGAGAAACATAGTGAGAACCTGTCTTTACAAAAATTAAAATTAAAATTAAAATTAGCCAGGAGTGGTGGTGCATGCCTGCAGTCCCAGCAGCTCAGGAGGCTGAGGTGGGATGATTGCTTGCACCAGGAGTTCGAGGCTGCAGTGAGCTGTGATCGTGCCACTGCACTCCAGCCCCTGGGTGACAAAGCAAGATCCTCTAAAAAAA"
"chr1","25721165","25721270","chr8","58489091","58489211","66","32767926","TTACACCTGTAATCGCAGCACTCTGGGGGGCTAAGAATGAAGGATTGCTTGAAGCTAGGAGTTTGAGACAAGCCTGGGCAGCACAGCAAGAACCTTGTAAAAAAAA","TTGAGACCAGGAGTTTGAGACCAGCTTGGACAACATAGTGAGACCCTGTCTAAAAGAAAGAAAGAAAGAAAAGAAAGAAAGAAAGATGTAGCCAAGTGTGGTGGTGCACATCTGTGTCTCA"
"chr1","25738881","25739150","chr15","26873577","26873832","78","1134696","GCCAGGCACAGTGGCTCACACCTGTAATCCCAGTGCTTTGGGAGACTGAGATGGGAGGATCGCTTGAGGCCAGGAGTTCAAGACCAGCCTGGACAACATAGTGAGACCCCCATCTCTACAAAAAAATTTTAAAAGTTATCCAGGCATGGTGGTGCACTCCTGTAGCCCCTGCTTCTCGGGAGTTCAAGGATGCAGTAAGCTATGATCACACCACTGCACTCCAGCCTGGATGACAGAGCAAGAGACCCTGTCTCAAAAAAATAAAGAAAA","GGTCAGGCACAGTGGCTCACTCCTGTAATCCCAGCACTTTGGGAGGCCAAAGCAGGAGGATTATTTGAGCCCAGGAGTTCAAGGCCAGCCTGGCCAACATAGTGAGATCTTGTCTCTAAATAAATAAATAAATAAATAAATAAATAAATGAGGTGGGAGGATTGCTTGAGTCCCAGGAGGTTGAGGCTGCAGTGAGCCAGGATCATACCACTGCACTTCCACCTGGGTGTCAGAGCAAGACCTTGTCTTAAAAAAA"
"chr1","25792277","25792397","chr5","32595015","32595178","61","6802738","TCACTTGAGGCCAGGAGTCCAAGGCTGCAGTGAGCTATGACTGTGCCCTAGCAAGCCCAGCCTGGGCAACAGAGTGAGACCCTGTCTCAAATAAAATAAAATATAAAATAAAATAATAAAA","GGCCGGGTGTGGTCCCTCATGCCTGTAATCCCAACACTTTGGGAGGCTGAGATAGGAGGACTGCTTGAGGCCAGGAGTTCAAGACCAGCCTGGTCAACATAGTGAGACCCCATCTCTATAAAATAATAATAATAATAATAATAATAATAATAAATAAATAAATA"
"chr1","25812061","25812376","chr16","9702460","9702783","77","16109601","GGCCAGGTGCAATGGCTCATGCCTATAATCCAAAACTTTGGGAGGCTGAGGCAGAGAATCACTTGTGGCCAGGAGTTCAAGAGCAATCTGGGCAACATAGCGAGACCCCATATCTACAAAAGAATTTTTTTAATTACCTGGGGGTGGTGGTAGCACGCACCTGTAGTACCAAAGCTTTGGGGAGGCTGAGGCAGGAGGACTGTTTGAGCCCAGGAGTTCAAGGCTGCAATGAGCTATGATTGCGCCACTGCACTCCAGCCTGGGCAACAGAGTGAGACTCCATCTCAAAATAAAAAATAAATGAAAATAATAATAA","CCGGGCATGATGGCTCATGCCAGTAATCCTAGCACTTTGGGAAGCTGAGGTGGAAGGATCGCTTGAGGCCAGGAGTTCGAAACCAGCCCAGTCAACATAGTGAAACCCCATCTCTACAAAAGAAAAATTAAAAAATTAGCTGGAATGGTGGCACATGCCTGTAGTCCTAGCTACTTGGGAGGCTGAGGCAGGAGAACTGTTTGAGCTCAGAAGTTCAAGGCTGCAGTGAGCCATGACTGTGCCACTGCACTCTAGCCTGGGTGACAGAGTGAGACCCTGTCTCAATAAATAAATAAATAAATAAATAAATAAGAAAACTAAAAA"
"chr1","25833120","25833409","chr2A","88638728","88639031","70","62805608","GTGCGGTGGCTCATGTCTGTAATCTCAACGCTCTGGGAGGCTGAGGTGGGAGGTTTGCTTGAGACCAGGAGTTTAAGACCAGCCTGGGCAACATAGCAAGACCCCATCGCTACAAAAAAATTTAAAAATTTCCTGGGTGTGGTGGTGCATACCTGTAGTCCCAGCTACTCAGGAGGCTAAGGTGGGAGGCTCACTTGAGCCCAGGAGTTTGGAGGCTGCAGTTAGCTAATGATCCCACCACTGCACTCCGGCATGACAGAGCTAGATACTGTTTCTAAAAAAAAGAAAAA","GGTGCAGTGGCTCATGCCTGTAATTCCAGCGCTTTGGGAGGCAAAGGTGGGAGGACTGCTTGAGCCCAGGAGTTTGAAACCAGCCTGGGCAACATAGGGAGACTTCATCTGTATAAATAAATAAATAAATAAATAAATAAATAAGCTGGGCATGGTGGCATGCACCTGTGGTCCCAGCTACTTGAGAGGCTAAGGTGGGAGGATCACTTGAGCCCAGGAGGTTGAGGCTGCAATGAGTCATGATCACGCCACCACACTCCAGCCTGAGCTACAGAGTGAGGTCTTGTCTCAAAAAAAAAAAAAA"
"chr1","25833501","25833789","chr1","116143795","116144109","84","90310294","GGCCAGGCACAGTGGCTCACACCTCTAATCACAGCACTTTGGGAGTTCAAGATCAGCCTGGGCAACAAAGCAAGACCTCATCTCTACAAAATATTTTAAAAATAATTAGCTGGGCATGGTGGCATGTGCCTATAGTTCAGCTACTCGGGAGGCTGAGGTGGGAGAATCACTTGCGCCCAGGAGGTCCAGGCTGCAGTGAACCGTGTTCATGCCACCACACTCCAGCCTGGGCAAGAGAGCGAGACCGTGTCTCAAAAAAATAAAATTTAAGTTAAAAAAAAAAAAAGAA","GGCCAGGCACCGTAGATCAGGCCTGTAATCCCAGCACTTTGGGAGTCCGAGGCCTATGAGTTTGAGAACAGCCTGGGCAGCATGGCAAAAACTTGTCTCTACAAAATATATATATATATATATATATATATAATTAGCCAGGCATGGTGGTGCATGCCTGTGGTTCCAGCTACTCAGGAGGCTGAGGTGGGAGGATCACCTGAGCCCAAGAAAGTGAGGGCTGCAGTGAGCCATGATCGCACCACTGCACTCCAGCCTGGGCAGCAGAGTGAGACTCTGTCTCAAAAAATAAAAATTGTTTTAAAGAAAAAGAAA"
"chr1","25842900","25843186","chr8","25360790","25361095","71","482110","GCTGGGCACAGTGGCTCACACCTGTAATCCCAGAATTTTGGGAGGCTGAGGCAGGCAGATTGCTTGAGCCTAGGAGTTTGAGACCAGCCTGGGCAACATGGTGAGACTCCGTCTCTACAAAAAATTTAAAAATTAGCAAGGTGTGGTGACATGCACCTGTAGTCCCAGCTACTTGGGAGGCCAAAGTGGGAGGATCTCTTGAGCCCAGGCTGGAGTGTAGTGAGCCATGATCATGCCACAGCACTCCAGCCAGGGTGACAGAGACCCCATCTCAAAAAAAAAAAAAA","GGCTGGGAGCAGTGGCTCATACCTGTAAGCCCAGCACTTTGGGAGGCTGAGGTGGGAGGATTGCTGAAGCCCAGGAGTTTGAGACCAACCTGGGCAATGTAGGGAGACCCCGTCTCTACTAAATAAATAAATAAATAAATAAATAAAGTCGGGCATGGTGGCATGTGCCCTGTAGTCCCAGCTTCTTGGGAGGCTGAGGTGGGAGGATTGCTTGGGCCCAGGAATCAAGGCTGCAGTGAGCTGTGATTGTGCCACTGTACTACAGCCTGGGTGACAGTGCAAGACTGTCTCAAAAGAAAAACAAAA"
"chr1","25855312","25855440","chr8","58489091","58489211","66","32633779","CCTGTAATCTCAGCACTTTGGGAAGCTCAGCACTTTGGGAAGCCAGGAATTTGGGACCAGCCTGGGCAATATAATGAGACCCCAACTCCACAAAAAATAAAAAAAGTTTATCATGGGCGGAGGAGTGTG","TTGAGACCAGGAGTTTGAGACCAGCTTGGACAACATAGTGAGACCCTGTCTAAAAGAAAGAAAGAAAGAAAAGAAAGAAAGAAAGATGTAGCCAAGTGTGGTGGTGCACATCTGTGTCTCA"
"chr1","25867031","25867330","chr18","16899958","16900260","65","8967073","GAGCACAGTGGCTCACATTTGTAATCCCAGCACTTTGGGAGGCCGAGTGGGAGGGTCGCTTGAGGCCAGGAGTTCGAGACCAGCCTGGGCAACAAAGTGAGACCCTGACTCTATAATAAAGTAAAAATAAATTTAAAAAATCAGCTGAGCATGGTAACATGTACCTGTAGCCCCAGCCACTTGGGAGGCTGATAGGAGGATTGCTTGAGTCCATGAGGTCAAGGCTGCAGTGAGCTGTGATTATACCACTGTGCTCCAACCTGGGGGACAGAGCAAGACGCTATCTTAAAAACAAAACAA","GTCAGGCGCGGTGGCTCACACCTGTAATCCCAGCACTTTGGGAAGCCGAGGCAGACGGATCACCTGAGGCCAGGAGTTCAAGACCAACCCCGGGCAACAAAGCAAGACCCTGTCTCTATAAAAAAAAAAAAAAAAAAAAAAAAATTAGCCGAGCATGATGGCAAGTGCCTGTAGTCCCAGCTACCTAGGATGTTGAGGTAGGAGGATTGCTTGAGCCCAAGAGGTTGAGGCTGCAGTGAGCCATGATCTCACCACTGCACTCCAGCCTGGGTGACAGAGCGAGACCCTGTCTCAAAAAATAAA"
"chr1","25874181","25874326","chr9","47045786","47045941","73","21171605","ACACTTATAATCCCAGCGCTTTGGGAGGCTGAGGTGAGAGGATGGCTTAAGCCGTGAGTTCAAGGTTGCAGTGAGCTGAGATGGTGCCACTGTACTCCAGCCTGGGGGACAGAGCATAGACCCTGTTTAAAAAAAAAAAAAAAAGT","GCTGGGCGCAGCAGCTCACACCTGTAATCCCAGTGCTTTGGAGGTCCAAGGTAGGAGGATTGCTTAAGACTAGGTGTTCAAGACCAGTCTTGGCAACATAGTGAGAACTCATCTCTACAATAAATAAATAAATAAATAAATAAATGAAAATAAAAA"
"chr1","25876688","25876862","chr18","55799233","55799394","71","29922545","ATATAGTCAGGCCAGGCAAGGTGGCCCATGCCTGTAATGCCAGCACTTTGGAAGGCCAAGGTGGGAGAACTGGTTGAGCCCAGGAGTTCCAGGTTACAGAGAGCTATGATTGTAGCACTGCATTCCAGCCTGGGTGACAGAGTGAGACCCTGTGGAAAGGAAAGGAAAGGGAAAG","GGCTGAGAGAGGTGGCTCATGCTTGTAATCCCAGCACATTGGGAGGCAAAGGTGGGAAGATTGCTTGAGGCCAGGAGTTCAAGACCAGCCTGGGCAACATGAAAACACTTTGTCTCTACAATAAATAAATAAATAAATAAATAAATAAAAGAAACAAGAAAA"
"chr1","25882939","25883093","chr6","36141662","36141829","67","10258723","GCTGGGCATGGTAGTGCATGCCTGAGGTGGAGGACTTGAGGCGGGAGGATTGCTTAAGCCAGGAGTTCAAGGCTGCAGTGAGCTATGATTGCACCACTGTGCTCCAGCCTGGGTGACAAAGCCACACTCTGTCTCTAAGAAAAAAATAATAATAA","GGGCAGGCGCAGTGGCTCATTCCTGTAGTCCTAGCACTTTGGGAGGCCAAGGAGACGGGATTGCTTGAGGCCAGAAGTTCAAGACTTCAAGACCAGCCTGGACAACATAGTGAGACCCTATCTCATATATATATATATATATATATATAAATTAAAAATAATAATAAA"
"chr1","25883841","25884107","chr12","118411877","118412164","90","92528036","TGGGAGGCTGAGGCCAGAGGATTGCTTCAGCCAGGAGTTGGAGAATAGCCTGGGCAACATGGTGAGACACAGTCTCTACAAAACATTTAAATATTAGCTGGGTGTGGTATTATGTGCCTTTAGTCCCAGCTGCTGAGGCTGAGGTGGGAGGTTCACTTGAACCCAGGAATTCCAGACAGCAGTGAGCTTATAGTTGCGCCACTACCCTGCAGCCTGGGCGACGAAGCGAGACCCCGTCTCTAACAAATAAATAAATAAATAAATAAA","TGGGTGGCTGAGGCGTGAGGATTGCTTGAGGCCGAGAGTTTGAGACCAATCTAGGCAACATAGTGAGACCCCATCTCTACAAAAAAAAAAAAAAAAAAAAAAAAAAAAATTAGCCAAGTATGGTGGTGTGCACTTCTAGTCCCATCTACTCAGGAGGCTGAGGTGGGAGGATCACTTGAGCCCAGGTGTTTGAGGCTGCATTGAGCTCTGGTGGTACCACTGCACTATAGCCTGGGTGACAGAGTAAGAGCCTGTCTCAAAATAAAAATGAAAAATTAAAACGAAAAA"
"chr1","25904031","25904340","chr5","6598042","6598342","88","19305989","GGCCAGGTACCATGGCTCATGCCTATAATCCCAGCACCGTGGGAGGCCAACATGGGAAGATCCCTTGAGCCCTGAAGTTTGAGACCAGCCTGGGCAACAAAGGGAAAGCCCATCTCTACAAAAAAAATTTTTTTTGATTAGGTGGGTGTGGTGGCCCATGTCGATAGTCCCAGATGCTATGGAGGCTGAGGTGGGAGAATCGCTTGAGCCCACTTGAGCTCCAGAAGTCAAGGCTGCAATGAGCTATAATTAAGCCACTGCACTCCAGCCTGGGCAACAAGGTGAGACCCTGTCTCAAAAAAAATAAAAA","GGCTGGATACAGTGACTCACACCTATAATCCCAACATTTTGGGAGGACAAGGCAAGAAGATCACTTGAGGCCGAAGTTTGAGACCAGCCTGAGCAACAGAGTGATACCTGGTCTTTACAAAATAATAATAATAATAATAATAATAACAAGTGTGGTGGCACATGCTTGTAGTCCCAGCTACTCGAGAGGCTGGGACAGGAAGATCGCTTAAGCCCTGGAACTCAAGGCTGCAGTGAGCCATGATCATGCCACTGCACTGCAGCCTGGGCAACACAGCAAGAACCTGTCTCGAAAAATAAAA"
"chr1","25911512","25911779","chr16","14985190","14985464","78","10926322","CTGGGTGTGGTAGCTCACACCTGTAATCCCAGCACTTTGGGAAGCCAGGGCAGAATAATCACCTGAGGCTTAGAGTTTGAGACCACCCTGGGCTACATAGCAAGAACCTGTCTCTACAAATAAATGAAAAAATACAAATAAATAAATAAAATTAGCTGGGCATGGTGGCACGGGCCTGTAGTCCTAGCTAAGGTGGGAGGACCACCTGCAGTGAGCCATGATCACGCCGCTGTTCCCCAGCCTGGGTGACAGAACGAGACCCTGTCTC","CTGGGCATGGTGGTTCATGCCTGTAATCCCAGAATTCTGGGAGGCTGAGGCAGAAGGATTGCTTGAGGCCAAGAGTTCAAGACCAGCTTGGGCAACACAGCAAGGCTCTATCTCTACCAAAAAAAATAAATAAATAAATAAATAAATAAATGAAAGCCAGGCATGGCACATGCCTATTGTCCCTGCTATTGATTGAGGCCAGGAGGTCAAGTCTGAAGTAAGCCATGATCACACCACTGCACTCCAGCCTGGGAGACAAAGCAAGACCTCTTCTC"
"chr1","25924844","25924959","chr20","87144","87254","60","25837700","GCTGGGCATGGTGGCTCACGCCTACAGTCTCAGTACTTGGGAGGCTGAGGCAGGGGGATCACTTGAGGCCAGGAGTTTTGAGACCAGCCTGGGTGATATAGGGAGACCCAGTCTCT","CCTGGGCAACATAGTGAGACTACATCTCTACACTCACGCACACACACACACACACACACACACCCCCCAAATTAGCCAGGCATGCTGATGTGCACCCATAGTCTCAGCAAC"
"chr1","25928188","25928368","chr19","13525969","13526165","71","12402219","AAAACAAAAAATCTTAGGTGAGTGCAGAGACAAATGCATGTAGTCCCAGCGACTCGGGAAGCTGAGTTGGGAGGATCGCGTGAGCCCAGGAGTTCCAGGCTGTCATGCATCACCATCACACCTGTGAATAGCCACTACGCTCCAGCCTAGGCAACATAGGCAAAAAAAAAAATCACAAAAA","AAGAAATAAATTAGTTGAGCATGGTGGTGCATGCCTATAGTCCCAGCTACTGGGGAGGCCAAAGTGGGAGGATTGTGTGAGCCCAGGAGTTTGAGGCTGCAATGAGCCAAGATTATGCACACCAGTGTGGGAGACAGTCAAGTCTCAAAAAATAAACAACAACAACAACAACAACAACAAACACATAAAAAGAAAAA"
"chr1","25937648","25937951","chr8","25360790","25361095","81","576858","GGCCATGTGCTGTGGCTCATACCTATAATTTCAGCACTTTGGGATACCAAGGCAGGAGGATTGCTTAAGCCCAGGAGTTTGAGACCAGCCTGGGCAACACAGTAAGACCCCATCTCTACAAAAAATTTAAAAATTAGCTGGGCATGGTGGCATGGGCCTGTGGTCCCAGCCAGGTCCCATCTACTCAGAGGGCTGAAATGGAATGATTGCTTGAGCCCAGGAGGTCGAGGCTGCAGTGAGCTGTGATCATGCCACTGAGCTCCAGCCTAGACAACAAATCAAGACCCTGTCTCAAAAATAATAA","GGCTGGGAGCAGTGGCTCATACCTGTAAGCCCAGCACTTTGGGAGGCTGAGGTGGGAGGATTGCTGAAGCCCAGGAGTTTGAGACCAACCTGGGCAATGTAGGGAGACCCCGTCTCTACTAAATAAATAAATAAATAAATAAATAAAGTCGGGCATGGTGGCATGTGCCCTGTAGTCCCAGCTTCTTGGGAGGCTGAGGTGGGAGGATTGCTTGGGCCCAGGAATCAAGGCTGCAGTGAGCTGTGATTGTGCCACTGTACTACAGCCTGGGTGACAGTGCAAGACTGTCTCAAAAGAAAAACAAAA"
"chr1","25962541","25962836","chr12","108570006","108570305","74","82607465","GGCTGGGCATGGTGGCTTATGCCTGTAACCCTAGTGCTTTGGGAGGCTGAGGCAAGAGGATCACTTGAGGCTAGGAGTTCCTAGACCAGCCTGGGCAACGTAGCAAGACCTCAACTCTACAAAAAAATTAAGAAATTAGCTAGGTATGGTGGTGTGTGCCTGAAGTCCTACCTACTCAGGAGGCCAAGACTGGAGGATTGCTTGAGGCAAGGAGTTGGCGGCAGTGAGCTGTGATAATGCCACTGCACTCCAACCTGGGCAACAGCAAGACCATGTCTCAGAAAAAAAAAAAAAAA","GGCAGGGCGTGGTGGCTCACACCTGTAATCCCTGTATTTTGGGAGGCTGAGGCAGGACGATTGCTTGAGGCTAGGAGTTTGAGACCAGTCTGGGCAACATTTAAATAAATAAATAAATAAATAAATAAATAAATAAATCAGCCAGGCATGGTAGCATGAACCTGTAGTCCCAGCTCCTCAGGAGGCTGAGGGAGGATTGCTTGAGCCCAGGAGTTCAAGGTTGCATTGAGCCATGATTGCACCACTGTACTCCAGCCTGGGAAACAGAGTAAGACCCTGTCTCAGAAACAAACAAAAAAA"
"chr1","25970590","25970889","chrX","16155635","16155942","65","9814955","GGCCGGGTGTGGTAGCTCAACATCTGTAATCCCAGCTACTTTGGGAGGCTGAGATGGGAGGATTGCTTGAGGCCACGGGTTTGAGACCAGCCTGTGCAACATAGTGAGACCCCATCTCAGCAAAAAAATAAATAAAATTAGCCAGGTATGGTGGCATGTGCCTATAGTCCCAGCTACTCGGGAGGCTGGGGTGGAAGGATCACTTGAGCCTGGGAGGTCAAGACTGCAGTGAGCCAAGATCATGCCATTGCACTCCAGCCTGGGCAACAGAGTGATACCGTCTCCAAAAAATAAAATAAA","GGCCAGGCACAGTGGCTCACACCTGTAATCCCGGTACTTTGGGAGGCTGAGGCGGGAGGATCACTTGAGCCCAGGAGTTCAAGACCAGCCTGGGCAACATAACAAGACCCTGTCTCTACCAAAAAAAAAAAAAAAAAAAAAAAAAATAGCCAGGCCTGGTGGCCTGTGTCCATAGTCCCAGCTACTTTGGGAGACTGAGGTGGAAGGATCACTTGAGTCTGGAAATCAAGACTGCTGTGAGCTGTGATCATGCCACTGTACTCCAGCCTGAGCAACAGAGTGAGACCCTGTCTAAAAAAAAAAAAAAA"
"chr1","25972082","25972395","chr16","9702460","9702783","73","16269622","CCAGGTGCAGTGGCTCACGCCTGTAATCCTAGCACTTTGGTGGGTTGAGGTGGGAGGATGGCTTGGGGCCAGGAGTTCGAGACCAGTCTGAGCAACATAGTGAGACTCTATCTTTACCAAAAAAAAAAAAAAATTAGCTGGGTGTGGTGGCACACACCTATAGTCCCAGCTACTCGAGAGGCTACGGTGGGAGGATCAGTTAAGCCTAGGAGGTCTAGGCTGCAGTGAGCCATGATTGCACCACTGAACTCCAGTCTGAGCAACAGAGCAAGACCTTGTTTCTAAATAAATAATTAAACAAATAAATAAGAAAA","CCGGGCATGATGGCTCATGCCAGTAATCCTAGCACTTTGGGAAGCTGAGGTGGAAGGATCGCTTGAGGCCAGGAGTTCGAAACCAGCCCAGTCAACATAGTGAAACCCCATCTCTACAAAAGAAAAATTAAAAAATTAGCTGGAATGGTGGCACATGCCTGTAGTCCTAGCTACTTGGGAGGCTGAGGCAGGAGAACTGTTTGAGCTCAGAAGTTCAAGGCTGCAGTGAGCCATGACTGTGCCACTGCACTCTAGCCTGGGTGACAGAGTGAGACCCTGTCTCAATAAATAAATAAATAAATAAATAAATAAGAAAACTAAAAA"
"chr1","25990121","25990237","chr20","87144","87254","64","25902977","GCCAGGCACAGTGGCTCATGCCTGTAATCCCAGCACTTTGGGAAGCCGAGGTAGGAGAGTCGCTTGAGGCCAGGAGTTAGACATCAGCCTGGGCAACATAGCAAGGCCTCGTCTCTA","CCTGGGCAACATAGTGAGACTACATCTCTACACTCACGCACACACACACACACACACACACACCCCCCAAATTAGCCAGGCATGCTGATGTGCACCCATAGTCTCAGCAAC"
"chr1","26003230","26003531","chr6","32649583","32649885","74","6646353","GAGCGTGGTGGCTCACGCCTGTAATCCCAGCACTTTGAGAAGCTGAGGCAGGTGGATCACTTGAGGCCTGGAGTTTGAGACTGGCCTGGGCAACATAGTGAGACCCTGCCTTATAAAAAATTAAAAAAGAAAATAGCTGGGCGTGGTAGTGCATGCCTGTAGTCCTAATTACTACAAGGCTGAAGTGGGAGGACAATTTGAGCCTAGGAGTTTGAAGCTGCAGTGAGCTACGATTGCGACACCGCATTGCAGCCTGGGTGACAGAGTGAGACCTTGTCTCTAAAGCAAAAACAAAAACAAAA","CTGGGTGTGGTGGTTCATGCCTGAAATCCCAGCACTTTGGGAGGCCAAGGCAAGAGGACTTCTTGAGCCTAGGAGTTCGAGACTGGCCTGGGCAACATAGTGAGACCCTGTCTCTAAAAAAAAAAAAAAAAAAAAAAAAATCAGCTGGATGTGGTGGTGCACACCTGCAGTCCCAGCTACTCAGGAGGCTGAGGTGGGAGGATTGCTTGAGCGCAGGAGTTTGATGCTGCAGTGAGCCACAATCATGCCACTGCTCCACTCTGGGTAACAGAGTGAGATTTTGTCTCAAAAAAAGGGAAAAAA"
"chr1","26007984","26008162","chr18","55799233","55799394","77","29791249","AAAATTGGGGAGAGGGTGGCAGCCCGTGCCTCTAATCCTGGCTACTCAAGAGGCTGAGGTGGGAGGATCGCTTCAGCCCAGGAGGTCAAGGATGAGTGAGCTATGATCACATCTATGAATAGCTATGGTACTCCAGCCTGGGCAACAGAGTGAGACCCAGCCTCTACATTAAAAAATAA","GGCTGAGAGAGGTGGCTCATGCTTGTAATCCCAGCACATTGGGAGGCAAAGGTGGGAAGATTGCTTGAGGCCAGGAGTTCAAGACCAGCCTGGGCAACATGAAAACACTTTGTCTCTACAATAAATAAATAAATAAATAAATAAATAAAAGAAACAAGAAAA"
